사용월,호선명,지하철역,승차총승객수,하차총승객수,승하차총승객수
202101,경춘선,신내,351,354,705
202101,경춘선,갈매,684,622,1306
202101,경춘선,별내,738,774,1512
202101,경춘선,퇴계원,966,951,1917
202101,경춘선,사릉,842,872,1714
202101,경춘선,금곡,430,427,857
202101,경춘선,평내호평,1659,1715,3374
202101,경춘선,천마산,585,569,1154
202101,경춘선,마석,1099,1285,2384
202101,경춘선,대성리,262,205,467
202101,경춘선,청평,627,602,1229
202101,경춘선,상천,141,102,243
202101,경춘선,가평,635,572,1207
202101,경춘선,굴봉산,54,53,107
202101,경춘선,백양리,50,36,86
202101,경춘선,강촌,191,186,377
202101,경춘선,김유정,120,130,250
202101,경춘선,남춘천,952,907,1859
202101,경춘선,춘천,533,502,1035
202101,경춘선,신내,1170,1142,2312
202101,경춘선,갈매,2392,2114,4506
202101,경춘선,별내,2143,2082,4225
202101,경춘선,퇴계원,2910,2718,5628
202101,경춘선,사릉,2844,2678,5522
202101,경춘선,금곡,1248,1113,2361
202101,경춘선,평내호평,4827,4607,9434
202101,경춘선,천마산,1271,1261,2532
202101,경춘선,마석,2947,2928,5875
202101,경춘선,대성리,328,260,588
202101,경춘선,청평,948,906,1854
202101,경춘선,상천,178,147,325
202101,경춘선,가평,924,914,1838
202101,경춘선,굴봉산,52,61,113
202101,경춘선,백양리,82,93,175
202101,경춘선,강촌,178,182,360
202101,경춘선,김유정,160,149,309
202101,경춘선,남춘천,1477,1515,2992
202101,경춘선,춘천,727,650,1377
202101,경춘선,춘천,732,739,1471
202101,경춘선,남춘천,1413,1475,2888
202101,경춘선,김유정,146,130,276
202101,경춘선,강촌,228,213,441
202101,경춘선,백양리,119,114,233
202101,경춘선,굴봉산,55,72,127
202101,경춘선,가평,961,919,1880
202101,경춘선,상천,151,155,306
202101,경춘선,청평,945,916,1861
202101,경춘선,대성리,328,271,599
202101,경춘선,마석,2889,2835,5724
202101,경춘선,천마산,1231,1131,2362
202101,경춘선,평내호평,4659,4601,9260
202101,경춘선,금곡,1210,1138,2348
202101,경춘선,사릉,2695,2615,5310
202101,경춘선,퇴계원,2934,2717,5651
202101,경춘선,별내,2068,2063,4131
202101,경춘선,갈매,2460,2091,4551
202101,경춘선,신내,1178,1224,2402
202101,경춘선,춘천,628,612,1240
202101,경춘선,남춘천,1353,1383,2736
202101,경춘선,김유정,126,138,264
202101,경춘선,강촌,158,170,328
202101,경춘선,백양리,85,79,164
202101,경춘선,굴봉산,51,69,120
202101,경춘선,가평,884,875,1759
202101,경춘선,상천,130,110,240
202101,경춘선,청평,884,922,1806
202101,경춘선,대성리,296,261,557
202101,경춘선,마석,2757,3000,5757
202101,경춘선,천마산,1199,1247,2446
202101,경춘선,평내호평,4732,5021,9753
202101,경춘선,금곡,1236,1162,2398
202101,경춘선,사릉,2671,2784,5455
202101,경춘선,퇴계원,2920,2924,5844
202101,경춘선,별내,2098,2171,4269
202101,경춘선,갈매,2461,2264,4725
202101,경춘선,신내,1171,1246,2417
202101,경춘선,춘천,734,734,1468
202101,경춘선,남춘천,1571,1571,3142
202101,경춘선,김유정,141,142,283
202101,경춘선,강촌,198,211,409
202101,경춘선,백양리,100,105,205
202101,경춘선,굴봉산,63,46,109
202101,경춘선,가평,967,998,1965
202101,경춘선,상천,133,141,274
202101,경춘선,청평,932,911,1843
202101,경춘선,대성리,280,255,535
202101,경춘선,마석,3346,3100,6446
202101,경춘선,천마산,1247,1131,2378
202101,경춘선,평내호평,5178,4890,10068
202101,경춘선,금곡,1233,1202,2435
202101,경춘선,사릉,2925,2807,5732
202101,경춘선,퇴계원,3097,2895,5992
202101,경춘선,별내,2270,2206,4476
202101,경춘선,갈매,2656,2277,4933
202101,경춘선,신내,1234,1184,2418
202101,경춘선,춘천,740,683,1423
202101,경춘선,남춘천,1548,1528,3076
202101,경춘선,김유정,117,125,242
202101,경춘선,강촌,145,172,317
202101,경춘선,백양리,72,98,170
202101,경춘선,굴봉산,37,37,74
202101,경춘선,가평,887,865,1752
202101,경춘선,상천,118,97,215
202101,경춘선,청평,765,819,1584
202101,경춘선,대성리,267,238,505
202101,경춘선,마석,2602,2653,5255
202101,경춘선,천마산,1081,982,2063
202101,경춘선,평내호평,4267,4352,8619
202101,경춘선,금곡,1083,1049,2132
202101,경춘선,사릉,2512,2448,4960
202101,경춘선,퇴계원,2693,2576,5269
202101,경춘선,별내,1889,1872,3761
202101,경춘선,갈매,2306,2075,4381
202101,경춘선,신내,1042,1010,2052
202101,경춘선,신내,1153,1190,2343
202101,경춘선,갈매,2466,2115,4581
202101,경춘선,별내,2082,2066,4148
202101,경춘선,퇴계원,2851,2702,5553
202101,경춘선,사릉,2784,2697,5481
202101,경춘선,금곡,1145,1069,2214
202101,경춘선,평내호평,4743,4590,9333
202101,경춘선,천마산,1258,1153,2411
202101,경춘선,마석,2911,2801,5712
202101,경춘선,대성리,295,250,545
202101,경춘선,청평,955,916,1871
202101,경춘선,상천,136,134,270
202101,경춘선,가평,942,923,1865
202101,경춘선,굴봉산,68,69,137
202101,경춘선,백양리,88,88,176
202101,경춘선,강촌,180,171,351
202101,경춘선,김유정,132,120,252
202101,경춘선,남춘천,1485,1516,3001
202101,경춘선,춘천,670,618,1288
202101,경춘선,춘천,717,683,1400
202101,경춘선,남춘천,1600,1714,3314
202101,경춘선,김유정,150,159,309
202101,경춘선,강촌,211,192,403
202101,경춘선,백양리,141,95,236
202101,경춘선,굴봉산,53,47,100
202101,경춘선,가평,966,953,1919
202101,경춘선,상천,149,153,302
202101,경춘선,청평,1001,1010,2011
202101,경춘선,대성리,368,279,647
202101,경춘선,마석,3071,3491,6562
202101,경춘선,천마산,1298,1323,2621
202101,경춘선,평내호평,4972,5407,10379
202101,경춘선,금곡,1293,1256,2549
202101,경춘선,사릉,2965,3117,6082
202101,경춘선,퇴계원,3119,3264,6383
202101,경춘선,별내,2326,2463,4789
202101,경춘선,갈매,2678,2618,5296
202101,경춘선,신내,1325,1371,2696
202101,경춘선,신내,1237,1314,2551
202101,경춘선,갈매,2623,2289,4912
202101,경춘선,별내,2216,2159,4375
202101,경춘선,퇴계원,3161,2977,6138
202101,경춘선,사릉,2915,2849,5764
202101,경춘선,금곡,1296,1226,2522
202101,경춘선,평내호평,5091,4902,9993
202101,경춘선,천마산,1358,1245,2603
202101,경춘선,마석,3103,3015,6118
202101,경춘선,대성리,348,337,685
202101,경춘선,청평,1033,1015,2048
202101,경춘선,상천,177,167,344
202101,경춘선,가평,1002,1037,2039
202101,경춘선,굴봉산,56,79,135
202101,경춘선,백양리,123,130,253
202101,경춘선,강촌,292,294,586
202101,경춘선,김유정,205,209,414
202101,경춘선,남춘천,1704,1687,3391
202101,경춘선,춘천,864,871,1735
202101,경춘선,신내,1276,1267,2543
202101,경춘선,갈매,2573,2228,4801
202101,경춘선,별내,2186,2181,4367
202101,경춘선,퇴계원,3138,2889,6027
202101,경춘선,사릉,2850,2759,5609
202101,경춘선,금곡,1283,1229,2512
202101,경춘선,평내호평,4983,4929,9912
202101,경춘선,천마산,1330,1289,2619
202101,경춘선,마석,3042,3016,6058
202101,경춘선,대성리,368,337,705
202101,경춘선,청평,1097,1078,2175
202101,경춘선,상천,199,174,373
202101,경춘선,가평,1007,1020,2027
202101,경춘선,굴봉산,77,91,168
202101,경춘선,백양리,122,119,241
202101,경춘선,강촌,251,265,516
202101,경춘선,김유정,184,186,370
202101,경춘선,남춘천,1629,1679,3308
202101,경춘선,춘천,775,765,1540
202101,경춘선,신내,1199,1201,2400
202101,경춘선,갈매,2505,2318,4823
202101,경춘선,별내,2230,2228,4458
202101,경춘선,퇴계원,3038,2821,5859
202101,경춘선,사릉,2789,2811,5600
202101,경춘선,금곡,1181,1160,2341
202101,경춘선,평내호평,4896,4838,9734
202101,경춘선,천마산,1310,1257,2567
202101,경춘선,마석,3022,3015,6037
202101,경춘선,대성리,328,320,648
202101,경춘선,청평,985,1043,2028
202101,경춘선,상천,147,141,288
202101,경춘선,가평,1063,1066,2129
202101,경춘선,굴봉산,63,73,136
202101,경춘선,백양리,139,125,264
202101,경춘선,강촌,243,230,473
202101,경춘선,김유정,160,171,331
202101,경춘선,남춘천,1927,1928,3855
202101,경춘선,춘천,1024,934,1958
202101,경춘선,춘천,956,875,1831
202101,경춘선,남춘천,1918,1919,3837
202101,경춘선,김유정,191,174,365
202101,경춘선,강촌,237,236,473
202101,경춘선,백양리,196,155,351
202101,경춘선,굴봉산,61,57,118
202101,경춘선,가평,1165,1155,2320
202101,경춘선,상천,167,146,313
202101,경춘선,청평,1030,966,1996
202101,경춘선,대성리,347,298,645
202101,경춘선,마석,3374,3105,6479
202101,경춘선,천마산,1319,1235,2554
202101,경춘선,평내호평,5340,5032,10372
202101,경춘선,금곡,1330,1235,2565
202101,경춘선,사릉,3095,2905,6000
202101,경춘선,퇴계원,3225,3053,6278
202101,경춘선,별내,2334,2260,4594
202101,경춘선,갈매,2670,2379,5049
202101,경춘선,신내,1306,1288,2594
202101,경춘선,신내,1261,1272,2533
202101,경춘선,갈매,2554,2284,4838
202101,경춘선,별내,2134,2144,4278
202101,경춘선,퇴계원,3038,2844,5882
202101,경춘선,사릉,2777,2707,5484
202101,경춘선,금곡,1327,1242,2569
202101,경춘선,평내호평,4848,4763,9611
202101,경춘선,천마산,1297,1237,2534
202101,경춘선,마석,2905,2974,5879
202101,경춘선,대성리,321,272,593
202101,경춘선,청평,953,914,1867
202101,경춘선,상천,133,116,249
202101,경춘선,가평,971,1002,1973
202101,경춘선,굴봉산,55,62,117
202101,경춘선,백양리,140,120,260
202101,경춘선,강촌,196,193,389
202101,경춘선,김유정,144,133,277
202101,경춘선,남춘천,1550,1587,3137
202101,경춘선,춘천,758,703,1461
202101,경춘선,춘천,798,766,1564
202101,경춘선,남춘천,1647,1718,3365
202101,경춘선,김유정,176,174,350
202101,경춘선,강촌,250,281,531
202101,경춘선,백양리,122,144,266
202101,경춘선,굴봉산,65,63,128
202101,경춘선,가평,1152,1105,2257
202101,경춘선,상천,176,174,350
202101,경춘선,청평,1102,1096,2198
202101,경춘선,대성리,369,304,673
202101,경춘선,마석,3177,3042,6219
202101,경춘선,천마산,1352,1292,2644
202101,경춘선,평내호평,5128,5058,10186
202101,경춘선,금곡,1308,1238,2546
202101,경춘선,사릉,2892,2841,5733
202101,경춘선,퇴계원,3108,2997,6105
202101,경춘선,별내,2345,2269,4614
202101,경춘선,갈매,2677,2323,5000
202101,경춘선,신내,1272,1287,2559
202101,경춘선,춘천,840,813,1653
202101,경춘선,남춘천,1621,1595,3216
202101,경춘선,김유정,140,124,264
202101,경춘선,강촌,187,197,384
202101,경춘선,백양리,149,129,278
202101,경춘선,굴봉산,74,67,141
202101,경춘선,가평,1082,1047,2129
202101,경춘선,상천,174,158,332
202101,경춘선,청평,1032,1057,2089
202101,경춘선,대성리,344,297,641
202101,경춘선,마석,2965,2972,5937
202101,경춘선,천마산,1321,1222,2543
202101,경춘선,평내호평,5033,4980,10013
202101,경춘선,금곡,1206,1148,2354
202101,경춘선,사릉,2755,2752,5507
202101,경춘선,퇴계원,3147,2946,6093
202101,경춘선,별내,2211,2180,4391
202101,경춘선,갈매,2616,2284,4900
202101,경춘선,신내,1300,1289,2589
202101,경춘선,춘천,1043,995,2038
202101,경춘선,남춘천,2105,2288,4393
202101,경춘선,김유정,161,164,325
202101,경춘선,강촌,215,230,445
202101,경춘선,백양리,133,113,246
202101,경춘선,굴봉산,59,72,131
202101,경춘선,가평,1157,1230,2387
202101,경춘선,상천,168,159,327
202101,경춘선,청평,1039,1141,2180
202101,경춘선,대성리,384,319,703
202101,경춘선,마석,3201,3127,6328
202101,경춘선,천마산,1385,1296,2681
202101,경춘선,평내호평,5279,5280,10559
202101,경춘선,금곡,1315,1220,2535
202101,경춘선,사릉,2857,2910,5767
202101,경춘선,퇴계원,3218,2932,6150
202101,경춘선,별내,2293,2339,4632
202101,경춘선,갈매,2643,2338,4981
202101,경춘선,신내,1285,1287,2572
202101,경춘선,신내,1305,1280,2585
202101,경춘선,갈매,2669,2401,5070
202101,경춘선,별내,2388,2313,4701
202101,경춘선,퇴계원,3315,3074,6389
202101,경춘선,사릉,3147,2984,6131
202101,경춘선,금곡,1345,1256,2601
202101,경춘선,평내호평,5520,5239,10759
202101,경춘선,천마산,1503,1411,2914
202101,경춘선,마석,3370,3297,6667
202101,경춘선,대성리,409,349,758
202101,경춘선,청평,1198,1118,2316
202101,경춘선,상천,167,173,340
202101,경춘선,가평,1199,1204,2403
202101,경춘선,굴봉산,76,80,156
202101,경춘선,백양리,165,138,303
202101,경춘선,강촌,263,265,528
202101,경춘선,김유정,172,178,350
202101,경춘선,남춘천,1868,1843,3711
202101,경춘선,춘천,984,908,1892
202101,경춘선,신내,1265,1306,2571
202101,경춘선,갈매,2630,2336,4966
202101,경춘선,별내,2265,2290,4555
202101,경춘선,퇴계원,3073,2954,6027
202101,경춘선,사릉,2945,2822,5767
202101,경춘선,금곡,1297,1228,2525
202101,경춘선,평내호평,5139,5026,10165
202101,경춘선,천마산,1338,1242,2580
202101,경춘선,마석,3157,3036,6193
202101,경춘선,대성리,377,307,684
202101,경춘선,청평,1070,1013,2083
202101,경춘선,상천,183,164,347
202101,경춘선,가평,1079,1085,2164
202101,경춘선,굴봉산,73,78,151
202101,경춘선,백양리,154,141,295
202101,경춘선,강촌,221,197,418
202101,경춘선,김유정,161,157,318
202101,경춘선,남춘천,1610,1713,3323
202101,경춘선,춘천,854,781,1635
202101,경춘선,신내,1396,1426,2822
202101,경춘선,갈매,2762,2459,5221
202101,경춘선,별내,2449,2362,4811
202101,경춘선,퇴계원,3350,3162,6512
202101,경춘선,사릉,3041,2904,5945
202101,경춘선,금곡,1404,1378,2782
202101,경춘선,평내호평,5427,5380,10807
202101,경춘선,천마산,1498,1436,2934
202101,경춘선,마석,3406,3230,6636
202101,경춘선,대성리,382,356,738
202101,경춘선,청평,1139,1124,2263
202101,경춘선,상천,191,175,366
202101,경춘선,가평,1257,1177,2434
202101,경춘선,굴봉산,85,96,181
202101,경춘선,백양리,176,136,312
202101,경춘선,강촌,262,277,539
202101,경춘선,김유정,202,200,402
202101,경춘선,남춘천,2145,2126,4271
202101,경춘선,춘천,923,819,1742
202101,경춘선,신내,1307,1304,2611
202101,경춘선,갈매,2687,2409,5096
202101,경춘선,별내,2387,2329,4716
202101,경춘선,퇴계원,3195,3006,6201
202101,경춘선,사릉,2922,2871,5793
202101,경춘선,금곡,1314,1281,2595
202101,경춘선,평내호평,5337,5095,10432
202101,경춘선,천마산,1324,1227,2551
202101,경춘선,마석,3219,3049,6268
202101,경춘선,대성리,334,299,633
202101,경춘선,청평,1008,1002,2010
202101,경춘선,상천,150,125,275
202101,경춘선,가평,1109,1130,2239
202101,경춘선,굴봉산,55,76,131
202101,경춘선,백양리,150,125,275
202101,경춘선,강촌,228,224,452
202101,경춘선,김유정,196,213,409
202101,경춘선,남춘천,1776,1852,3628
202101,경춘선,춘천,916,821,1737
202101,경춘선,신내,1194,1204,2398
202101,경춘선,갈매,2565,2215,4780
202101,경춘선,별내,2145,2187,4332
202101,경춘선,퇴계원,2997,2796,5793
202101,경춘선,사릉,2761,2767,5528
202101,경춘선,금곡,1241,1099,2340
202101,경춘선,평내호평,5011,5072,10083
202101,경춘선,천마산,1226,1177,2403
202101,경춘선,마석,2941,2994,5935
202101,경춘선,대성리,297,268,565
202101,경춘선,청평,989,997,1986
202101,경춘선,상천,142,136,278
202101,경춘선,가평,1095,1148,2243
202101,경춘선,굴봉산,74,69,143
202101,경춘선,백양리,171,147,318
202101,경춘선,강촌,177,196,373
202101,경춘선,김유정,162,159,321
202101,경춘선,남춘천,1845,1916,3761
202101,경춘선,춘천,916,878,1794
202102,경춘선,춘천,865,822,1687
202102,경춘선,남춘천,1742,1741,3483
202102,경춘선,김유정,172,190,362
202102,경춘선,강촌,235,202,437
202102,경춘선,백양리,131,121,252
202102,경춘선,굴봉산,65,82,147
202102,경춘선,가평,1195,1143,2338
202102,경춘선,상천,164,151,315
202102,경춘선,청평,1072,1060,2132
202102,경춘선,대성리,361,300,661
202102,경춘선,마석,3402,3222,6624
202102,경춘선,천마산,1493,1382,2875
202102,경춘선,평내호평,5538,5345,10883
202102,경춘선,금곡,1389,1312,2701
202102,경춘선,사릉,3051,2925,5976
202102,경춘선,퇴계원,3353,3112,6465
202102,경춘선,별내,2455,2315,4770
202102,경춘선,갈매,2806,2498,5304
202102,경춘선,신내,1389,1393,2782
202102,경춘선,춘천,770,732,1502
202102,경춘선,남춘천,1894,1892,3786
202102,경춘선,김유정,158,154,312
202102,경춘선,강촌,191,197,388
202102,경춘선,백양리,172,148,320
202102,경춘선,굴봉산,74,67,141
202102,경춘선,가평,1118,1040,2158
202102,경춘선,상천,168,153,321
202102,경춘선,청평,1056,1057,2113
202102,경춘선,대성리,332,309,641
202102,경춘선,마석,3274,3135,6409
202102,경춘선,천마산,1428,1310,2738
202102,경춘선,평내호평,5283,5210,10493
202102,경춘선,금곡,1316,1218,2534
202102,경춘선,사릉,2914,2841,5755
202102,경춘선,퇴계원,3215,3047,6262
202102,경춘선,별내,2329,2267,4596
202102,경춘선,갈매,2733,2435,5168
202102,경춘선,신내,1378,1326,2704
202102,경춘선,신내,1449,1501,2950
202102,경춘선,갈매,2829,2519,5348
202102,경춘선,별내,2391,2444,4835
202102,경춘선,퇴계원,3368,3192,6560
202102,경춘선,사릉,3017,2936,5953
202102,경춘선,금곡,1397,1385,2782
202102,경춘선,평내호평,5598,5456,11054
202102,경춘선,천마산,1484,1394,2878
202102,경춘선,마석,3574,3524,7098
202102,경춘선,대성리,378,318,696
202102,경춘선,청평,1170,1168,2338
202102,경춘선,상천,169,151,320
202102,경춘선,가평,1111,1122,2233
202102,경춘선,굴봉산,84,82,166
202102,경춘선,백양리,151,129,280
202102,경춘선,강촌,200,208,408
202102,경춘선,김유정,213,210,423
202102,경춘선,남춘천,1647,1717,3364
202102,경춘선,춘천,831,752,1583
202102,경춘선,신내,1421,1481,2902
202102,경춘선,갈매,2880,2466,5346
202102,경춘선,별내,2445,2417,4862
202102,경춘선,퇴계원,3381,3116,6497
202102,경춘선,사릉,3128,2988,6116
202102,경춘선,금곡,1373,1299,2672
202102,경춘선,평내호평,5768,5530,11298
202102,경춘선,천마산,1393,1339,2732
202102,경춘선,마석,3400,3239,6639
202102,경춘선,대성리,349,328,677
202102,경춘선,청평,1074,1107,2181
202102,경춘선,상천,161,163,324
202102,경춘선,가평,1166,1162,2328
202102,경춘선,굴봉산,74,74,148
202102,경춘선,백양리,160,162,322
202102,경춘선,강촌,271,265,536
202102,경춘선,김유정,221,230,451
202102,경춘선,남춘천,1772,1736,3508
202102,경춘선,춘천,1001,916,1917
202102,경춘선,춘천,1070,945,2015
202102,경춘선,남춘천,1953,2109,4062
202102,경춘선,김유정,184,197,381
202102,경춘선,강촌,254,223,477
202102,경춘선,백양리,202,161,363
202102,경춘선,굴봉산,65,95,160
202102,경춘선,가평,1224,1192,2416
202102,경춘선,상천,211,190,401
202102,경춘선,청평,1219,1163,2382
202102,경춘선,대성리,371,329,700
202102,경춘선,마석,3333,3284,6617
202102,경춘선,천마산,1485,1405,2890
202102,경춘선,평내호평,5627,5574,11201
202102,경춘선,금곡,1413,1317,2730
202102,경춘선,사릉,3058,2893,5951
202102,경춘선,퇴계원,3364,3049,6413
202102,경춘선,별내,2502,2484,4986
202102,경춘선,갈매,2853,2535,5388
202102,경춘선,신내,1308,1359,2667
202102,경춘선,신내,1308,1324,2632
202102,경춘선,갈매,2787,2469,5256
202102,경춘선,별내,2461,2390,4851
202102,경춘선,퇴계원,3349,3087,6436
202102,경춘선,사릉,3128,2904,6032
202102,경춘선,금곡,1367,1281,2648
202102,경춘선,평내호평,5703,5430,11133
202102,경춘선,천마산,1488,1392,2880
202102,경춘선,마석,3595,3524,7119
202102,경춘선,대성리,384,318,702
202102,경춘선,청평,1170,1169,2339
202102,경춘선,상천,206,192,398
202102,경춘선,가평,1258,1215,2473
202102,경춘선,굴봉산,64,81,145
202102,경춘선,백양리,144,133,277
202102,경춘선,강촌,253,233,486
202102,경춘선,김유정,179,166,345
202102,경춘선,남춘천,1894,1823,3717
202102,경춘선,춘천,949,857,1806
202102,경춘선,춘천,908,837,1745
202102,경춘선,남춘천,1705,1807,3512
202102,경춘선,김유정,176,191,367
202102,경춘선,강촌,239,241,480
202102,경춘선,백양리,195,152,347
202102,경춘선,굴봉산,75,71,146
202102,경춘선,가평,1255,1174,2429
202102,경춘선,상천,174,150,324
202102,경춘선,청평,1351,1272,2623
202102,경춘선,대성리,393,346,739
202102,경춘선,마석,3374,3355,6729
202102,경춘선,천마산,1435,1361,2796
202102,경춘선,평내호평,5730,5584,11314
202102,경춘선,금곡,1369,1287,2656
202102,경춘선,사릉,2933,2871,5804
202102,경춘선,퇴계원,3331,3189,6520
202102,경춘선,별내,2381,2391,4772
202102,경춘선,갈매,2719,2371,5090
202102,경춘선,신내,1318,1313,2631
202102,경춘선,신내,1204,1177,2381
202102,경춘선,갈매,2583,2326,4909
202102,경춘선,별내,2339,2276,4615
202102,경춘선,퇴계원,3222,2967,6189
202102,경춘선,사릉,2857,2792,5649
202102,경춘선,금곡,1292,1222,2514
202102,경춘선,평내호평,5360,5349,10709
202102,경춘선,천마산,1349,1292,2641
202102,경춘선,마석,3311,3320,6631
202102,경춘선,대성리,381,344,725
202102,경춘선,청평,1130,1261,2391
202102,경춘선,상천,202,183,385
202102,경춘선,가평,1218,1344,2562
202102,경춘선,굴봉산,66,63,129
202102,경춘선,백양리,146,148,294
202102,경춘선,강촌,228,225,453
202102,경춘선,김유정,172,188,360
202102,경춘선,남춘천,2044,2530,4574
202102,경춘선,춘천,1096,1092,2188
202102,경춘선,춘천,797,972,1769
202102,경춘선,남춘천,1343,1833,3176
202102,경춘선,김유정,178,253,431
202102,경춘선,강촌,225,311,536
202102,경춘선,백양리,208,233,441
202102,경춘선,굴봉산,56,90,146
202102,경춘선,가평,767,1287,2054
202102,경춘선,상천,124,143,267
202102,경춘선,청평,710,1025,1735
202102,경춘선,대성리,274,277,551
202102,경춘선,마석,1683,1879,3562
202102,경춘선,천마산,774,860,1634
202102,경춘선,평내호평,2257,2495,4752
202102,경춘선,금곡,555,543,1098
202102,경춘선,사릉,1143,1271,2414
202102,경춘선,퇴계원,1466,1444,2910
202102,경춘선,별내,1113,1075,2188
202102,경춘선,갈매,986,852,1838
202102,경춘선,신내,504,502,1006
202102,경춘선,신내,405,393,798
202102,경춘선,갈매,691,624,1315
202102,경춘선,별내,714,725,1439
202102,경춘선,퇴계원,1095,1040,2135
202102,경춘선,사릉,978,979,1957
202102,경춘선,금곡,530,502,1032
202102,경춘선,평내호평,1785,1754,3539
202102,경춘선,천마산,657,709,1366
202102,경춘선,마석,1556,1563,3119
202102,경춘선,대성리,318,287,605
202102,경춘선,청평,879,810,1689
202102,경춘선,상천,146,108,254
202102,경춘선,가평,1168,1047,2215
202102,경춘선,굴봉산,77,74,151
202102,경춘선,백양리,297,265,562
202102,경춘선,강촌,284,328,612
202102,경춘선,김유정,237,221,458
202102,경춘선,남춘천,1323,1361,2684
202102,경춘선,춘천,865,775,1640
202102,경춘선,춘천,911,867,1778
202102,경춘선,남춘천,1788,1791,3579
202102,경춘선,김유정,170,170,340
202102,경춘선,강촌,222,247,469
202102,경춘선,백양리,147,107,254
202102,경춘선,굴봉산,74,66,140
202102,경춘선,가평,1180,1257,2437
202102,경춘선,상천,167,155,322
202102,경춘선,청평,1146,1181,2327
202102,경춘선,대성리,371,299,670
202102,경춘선,마석,3400,3267,6667
202102,경춘선,천마산,1430,1331,2761
202102,경춘선,평내호평,5441,5212,10653
202102,경춘선,금곡,1378,1247,2625
202102,경춘선,사릉,3024,2845,5869
202102,경춘선,퇴계원,3301,3047,6348
202102,경춘선,별내,2369,2326,4695
202102,경춘선,갈매,2711,2361,5072
202102,경춘선,신내,1269,1237,2506
202102,경춘선,춘천,893,865,1758
202102,경춘선,남춘천,1699,1709,3408
202102,경춘선,김유정,214,215,429
202102,경춘선,강촌,278,237,515
202102,경춘선,백양리,172,150,322
202102,경춘선,굴봉산,86,109,195
202102,경춘선,가평,1224,1264,2488
202102,경춘선,상천,176,186,362
202102,경춘선,청평,1223,1159,2382
202102,경춘선,대성리,349,301,650
202102,경춘선,마석,3247,3165,6412
202102,경춘선,천마산,1357,1318,2675
202102,경춘선,평내호평,5424,5335,10759
202102,경춘선,금곡,1420,1304,2724
202102,경춘선,사릉,2968,2907,5875
202102,경춘선,퇴계원,3198,3051,6249
202102,경춘선,별내,2284,2303,4587
202102,경춘선,갈매,2810,2468,5278
202102,경춘선,신내,1406,1357,2763
202102,경춘선,신내,1273,1290,2563
202102,경춘선,갈매,2645,2326,4971
202102,경춘선,별내,2227,2209,4436
202102,경춘선,퇴계원,3116,2898,6014
202102,경춘선,사릉,2841,2732,5573
202102,경춘선,금곡,1250,1187,2437
202102,경춘선,평내호평,5242,5121,10363
202102,경춘선,천마산,1287,1239,2526
202102,경춘선,마석,3257,3186,6443
202102,경춘선,대성리,317,291,608
202102,경춘선,청평,1133,1095,2228
202102,경춘선,상천,145,144,289
202102,경춘선,가평,1275,1141,2416
202102,경춘선,굴봉산,60,67,127
202102,경춘선,백양리,146,137,283
202102,경춘선,강촌,204,199,403
202102,경춘선,김유정,177,170,347
202102,경춘선,남춘천,1836,1867,3703
202102,경춘선,춘천,886,841,1727
202102,경춘선,상천,146,155,301
202102,경춘선,청평,1163,1162,2325
202102,경춘선,대성리,329,307,636
202102,경춘선,마석,3323,3244,6567
202102,경춘선,천마산,1354,1256,2610
202102,경춘선,평내호평,5382,5259,10641
202102,경춘선,금곡,1290,1228,2518
202102,경춘선,사릉,2902,2869,5771
202102,경춘선,퇴계원,3164,2986,6150
202102,경춘선,별내,2353,2313,4666
202102,경춘선,갈매,2731,2347,5078
202102,경춘선,신내,1325,1349,2674
202102,경춘선,가평,1188,1240,2428
202102,경춘선,굴봉산,61,82,143
202102,경춘선,백양리,186,201,387
202102,경춘선,강촌,208,226,434
202102,경춘선,김유정,182,175,357
202102,경춘선,남춘천,1692,1696,3388
202102,경춘선,춘천,862,742,1604
202102,경춘선,신내,1394,1337,2731
202102,경춘선,갈매,2845,2525,5370
202102,경춘선,별내,2527,2496,5023
202102,경춘선,퇴계원,3413,3155,6568
202102,경춘선,사릉,3027,3004,6031
202102,경춘선,금곡,1445,1321,2766
202102,경춘선,평내호평,5622,5617,11239
202102,경춘선,천마산,1529,1398,2927
202102,경춘선,마석,3558,3522,7080
202102,경춘선,대성리,410,348,758
202102,경춘선,청평,1457,1376,2833
202102,경춘선,상천,229,216,445
202102,경춘선,가평,1293,1370,2663
202102,경춘선,굴봉산,81,80,161
202102,경춘선,백양리,197,166,363
202102,경춘선,강촌,331,352,683
202102,경춘선,김유정,247,273,520
202102,경춘선,남춘천,1976,2110,4086
202102,경춘선,춘천,1112,954,2066
202102,경춘선,신내,1431,1402,2833
202102,경춘선,갈매,2845,2502,5347
202102,경춘선,별내,2561,2506,5067
202102,경춘선,퇴계원,3499,3205,6704
202102,경춘선,사릉,3261,3075,6336
202102,경춘선,금곡,1434,1377,2811
202102,경춘선,평내호평,5838,5646,11484
202102,경춘선,천마산,1572,1423,2995
202102,경춘선,마석,3596,3426,7022
202102,경춘선,대성리,430,394,824
202102,경춘선,청평,1349,1391,2740
202102,경춘선,상천,239,215,454
202102,경춘선,가평,1456,1474,2930
202102,경춘선,굴봉산,96,94,190
202102,경춘선,백양리,164,146,310
202102,경춘선,강촌,306,314,620
202102,경춘선,김유정,248,235,483
202102,경춘선,남춘천,2442,2580,5022
202102,경춘선,춘천,1089,1048,2137
202102,경춘선,춘천,1051,978,2029
202102,경춘선,남춘천,1892,2000,3892
202102,경춘선,김유정,298,293,591
202102,경춘선,강촌,311,253,564
202102,경춘선,백양리,169,141,310
202102,경춘선,굴봉산,77,101,178
202102,경춘선,가평,1303,1241,2544
202102,경춘선,상천,196,169,365
202102,경춘선,청평,1388,1263,2651
202102,경춘선,대성리,404,341,745
202102,경춘선,마석,3726,3673,7399
202102,경춘선,천마산,1556,1435,2991
202102,경춘선,평내호평,5738,5741,11479
202102,경춘선,금곡,1412,1359,2771
202102,경춘선,사릉,3117,2972,6089
202102,경춘선,퇴계원,3463,3291,6754
202102,경춘선,별내,2508,2452,4960
202102,경춘선,갈매,2808,2540,5348
202102,경춘선,신내,1423,1433,2856
202102,경춘선,춘천,1142,1094,2236
202102,경춘선,남춘천,1962,1973,3935
202102,경춘선,김유정,275,303,578
202102,경춘선,강촌,300,264,564
202102,경춘선,백양리,152,115,267
202102,경춘선,굴봉산,105,111,216
202102,경춘선,가평,1412,1359,2771
202102,경춘선,상천,235,215,450
202102,경춘선,청평,1336,1358,2694
202102,경춘선,대성리,458,411,869
202102,경춘선,마석,3523,3491,7014
202102,경춘선,천마산,1544,1429,2973
202102,경춘선,평내호평,5863,5688,11551
202102,경춘선,금곡,1415,1348,2763
202102,경춘선,사릉,3082,2976,6058
202102,경춘선,퇴계원,3396,3183,6579
202102,경춘선,별내,2482,2359,4841
202102,경춘선,갈매,2855,2531,5386
202102,경춘선,신내,1425,1445,2870
202102,경춘선,신내,1423,1450,2873
202102,경춘선,갈매,2821,2476,5297
202102,경춘선,별내,2498,2437,4935
202102,경춘선,퇴계원,3472,3229,6701
202102,경춘선,사릉,3146,3011,6157
202102,경춘선,금곡,1428,1376,2804
202102,경춘선,평내호평,5755,5693,11448
202102,경춘선,천마산,1568,1464,3032
202102,경춘선,마석,3543,3442,6985
202102,경춘선,대성리,452,368,820
202102,경춘선,청평,1298,1417,2715
202102,경춘선,상천,197,189,386
202102,경춘선,가평,1346,1499,2845
202102,경춘선,굴봉산,109,100,209
202102,경춘선,백양리,150,164,314
202102,경춘선,강촌,249,272,521
202102,경춘선,김유정,289,271,560
202102,경춘선,남춘천,1927,1952,3879
202102,경춘선,춘천,1041,1059,2100
202102,경춘선,사릉,3254,3054,6308
202102,경춘선,신내,1459,1473,2932
202102,경춘선,갈매,2939,2621,5560
202102,경춘선,별내,2574,2583,5157
202102,경춘선,퇴계원,3565,3245,6810
202102,경춘선,금곡,1442,1379,2821
202102,경춘선,평내호평,5964,5956,11920
202102,경춘선,천마산,1569,1454,3023
202102,경춘선,마석,3642,3586,7228
202102,경춘선,대성리,451,419,870
202102,경춘선,청평,1569,1462,3031
202102,경춘선,상천,234,217,451
202102,경춘선,가평,1500,1483,2983
202102,경춘선,굴봉산,94,102,196
202102,경춘선,백양리,172,131,303
202102,경춘선,강촌,317,330,647
202102,경춘선,김유정,332,349,681
202102,경춘선,남춘천,2153,2291,4444
202102,경춘선,춘천,1284,1238,2522
202103,경춘선,신내,581,548,1129
202103,경춘선,갈매,1079,908,1987
202103,경춘선,별내,1132,1044,2176
202103,경춘선,퇴계원,1455,1351,2806
202103,경춘선,사릉,1260,1301,2561
202103,경춘선,금곡,577,531,1108
202103,경춘선,평내호평,2357,2222,4579
202103,경춘선,천마산,679,656,1335
202103,경춘선,마석,1565,1582,3147
202103,경춘선,대성리,247,179,426
202103,경춘선,청평,813,633,1446
202103,경춘선,상천,132,87,219
202103,경춘선,가평,875,636,1511
202103,경춘선,굴봉산,72,32,104
202103,경춘선,백양리,95,69,164
202103,경춘선,강촌,245,183,428
202103,경춘선,김유정,166,127,293
202103,경춘선,남춘천,1652,1648,3300
202103,경춘선,춘천,881,824,1705
202103,경춘선,춘천,1392,1322,2714
202103,경춘선,남춘천,2287,2339,4626
202103,경춘선,김유정,247,216,463
202103,경춘선,강촌,362,381,743
202103,경춘선,백양리,68,48,116
202103,경춘선,굴봉산,67,83,150
202103,경춘선,가평,1286,1272,2558
202103,경춘선,상천,212,217,429
202103,경춘선,청평,1394,1303,2697
202103,경춘선,대성리,367,301,668
202103,경춘선,마석,3744,3592,7336
202103,경춘선,천마산,1613,1504,3117
202103,경춘선,평내호평,6079,5992,12071
202103,경춘선,금곡,1476,1421,2897
202103,경춘선,사릉,3285,3056,6341
202103,경춘선,퇴계원,3498,3238,6736
202103,경춘선,별내,2536,2501,5037
202103,경춘선,갈매,3008,2696,5704
202103,경춘선,신내,1611,1618,3229
202103,경춘선,신내,1573,1590,3163
202103,경춘선,갈매,3081,2690,5771
202103,경춘선,별내,2658,2622,5280
202103,경춘선,퇴계원,3534,3375,6909
202103,경춘선,사릉,3321,3123,6444
202103,경춘선,금곡,1490,1466,2956
202103,경춘선,평내호평,6085,5980,12065
202103,경춘선,천마산,1614,1523,3137
202103,경춘선,마석,3966,3969,7935
202103,경춘선,대성리,435,375,810
202103,경춘선,청평,1418,1350,2768
202103,경춘선,상천,254,243,497
202103,경춘선,가평,1302,1283,2585
202103,경춘선,굴봉산,91,91,182
202103,경춘선,백양리,38,43,81
202103,경춘선,강촌,345,308,653
202103,경춘선,김유정,210,231,441
202103,경춘선,남춘천,1968,1990,3958
202103,경춘선,춘천,1336,1265,2601
202103,경춘선,신내,1604,1640,3244
202103,경춘선,갈매,3015,2688,5703
202103,경춘선,별내,2671,2565,5236
202103,경춘선,퇴계원,3497,3255,6752
202103,경춘선,사릉,3287,3124,6411
202103,경춘선,금곡,1512,1503,3015
202103,경춘선,평내호평,6032,5972,12004
202103,경춘선,천마산,1613,1483,3096
202103,경춘선,마석,3571,3607,7178
202103,경춘선,대성리,397,357,754
202103,경춘선,청평,1367,1455,2822
202103,경춘선,상천,241,245,486
202103,경춘선,가평,1197,1223,2420
202103,경춘선,굴봉산,109,105,214
202103,경춘선,백양리,34,49,83
202103,경춘선,강촌,333,301,634
202103,경춘선,김유정,201,214,415
202103,경춘선,남춘천,2141,1928,4069
202103,경춘선,춘천,1441,1161,2602
202103,경춘선,춘천,1608,1164,2772
202103,경춘선,남춘천,2631,2462,5093
202103,경춘선,김유정,305,304,609
202103,경춘선,강촌,321,343,664
202103,경춘선,백양리,77,67,144
202103,경춘선,굴봉산,103,122,225
202103,경춘선,가평,1405,1489,2894
202103,경춘선,상천,260,229,489
202103,경춘선,청평,1462,1472,2934
202103,경춘선,대성리,435,420,855
202103,경춘선,마석,3774,3905,7679
202103,경춘선,천마산,1640,1542,3182
202103,경춘선,평내호평,6195,6318,12513
202103,경춘선,금곡,1563,1510,3073
202103,경춘선,사릉,3406,3321,6727
202103,경춘선,퇴계원,3605,3400,7005
202103,경춘선,별내,2762,2695,5457
202103,경춘선,갈매,3215,2767,5982
202103,경춘선,신내,1623,1653,3276
202103,경춘선,신내,1626,1631,3257
202103,경춘선,갈매,3030,2656,5686
202103,경춘선,별내,2748,2553,5301
202103,경춘선,퇴계원,3556,3357,6913
202103,경춘선,사릉,3558,3321,6879
202103,경춘선,금곡,1588,1490,3078
202103,경춘선,평내호평,6330,6212,12542
202103,경춘선,천마산,1656,1512,3168
202103,경춘선,마석,4051,4089,8140
202103,경춘선,대성리,490,405,895
202103,경춘선,청평,1418,1365,2783
202103,경춘선,상천,251,250,501
202103,경춘선,가평,1281,1275,2556
202103,경춘선,굴봉산,113,123,236
202103,경춘선,백양리,64,48,112
202103,경춘선,강촌,395,380,775
202103,경춘선,김유정,238,242,480
202103,경춘선,남춘천,2089,2231,4320
202103,경춘선,춘천,1377,1419,2796
202103,경춘선,신내,1619,1644,3263
202103,경춘선,갈매,3088,2751,5839
202103,경춘선,별내,2672,2566,5238
202103,경춘선,퇴계원,3620,3347,6967
202103,경춘선,사릉,3596,3419,7015
202103,경춘선,금곡,1591,1520,3111
202103,경춘선,평내호평,6285,6241,12526
202103,경춘선,천마산,1645,1538,3183
202103,경춘선,마석,3826,3823,7649
202103,경춘선,대성리,438,369,807
202103,경춘선,청평,1407,1399,2806
202103,경춘선,상천,305,251,556
202103,경춘선,가평,1355,1261,2616
202103,경춘선,굴봉산,126,130,256
202103,경춘선,백양리,67,60,127
202103,경춘선,강촌,402,424,826
202103,경춘선,김유정,299,288,587
202103,경춘선,남춘천,2071,2101,4172
202103,경춘선,춘천,1380,1356,2736
202103,경춘선,신내,1679,1709,3388
202103,경춘선,갈매,3075,2680,5755
202103,경춘선,별내,2695,2562,5257
202103,경춘선,퇴계원,3682,3287,6969
202103,경춘선,사릉,3542,3366,6908
202103,경춘선,금곡,1549,1472,3021
202103,경춘선,평내호평,6283,6292,12575
202103,경춘선,천마산,1612,1531,3143
202103,경춘선,마석,3829,3750,7579
202103,경춘선,대성리,493,440,933
202103,경춘선,청평,1359,1350,2709
202103,경춘선,상천,284,296,580
202103,경춘선,가평,1329,1316,2645
202103,경춘선,굴봉산,111,114,225
202103,경춘선,백양리,57,49,106
202103,경춘선,강촌,408,414,822
202103,경춘선,김유정,239,247,486
202103,경춘선,남춘천,2032,2121,4153
202103,경춘선,춘천,1364,1273,2637
202103,경춘선,신내,1603,1680,3283
202103,경춘선,갈매,3104,2759,5863
202103,경춘선,별내,2636,2611,5247
202103,경춘선,퇴계원,3583,3432,7015
202103,경춘선,사릉,3549,3396,6945
202103,경춘선,금곡,1516,1475,2991
202103,경춘선,평내호평,6279,6277,12556
202103,경춘선,천마산,1649,1544,3193
202103,경춘선,마석,3750,3755,7505
202103,경춘선,대성리,451,403,854
202103,경춘선,청평,1429,1505,2934
202103,경춘선,상천,257,275,532
202103,경춘선,가평,1217,1223,2440
202103,경춘선,굴봉산,90,92,182
202103,경춘선,백양리,42,54,96
202103,경춘선,강촌,362,355,717
202103,경춘선,김유정,207,241,448
202103,경춘선,남춘천,2215,2026,4241
202103,경춘선,춘천,1496,1242,2738
202103,경춘선,신내,1588,1653,3241
202103,경춘선,갈매,3081,2689,5770
202103,경춘선,별내,2634,2638,5272
202103,경춘선,퇴계원,3587,3412,6999
202103,경춘선,사릉,3541,3403,6944
202103,경춘선,금곡,1494,1447,2941
202103,경춘선,평내호평,6213,6356,12569
202103,경춘선,천마산,1655,1501,3156
202103,경춘선,마석,3774,3846,7620
202103,경춘선,대성리,447,407,854
202103,경춘선,청평,1428,1568,2996
202103,경춘선,상천,228,230,458
202103,경춘선,가평,1345,1459,2804
202103,경춘선,굴봉산,106,84,190
202103,경춘선,백양리,51,66,117
202103,경춘선,강촌,267,318,585
202103,경춘선,김유정,224,245,469
202103,경춘선,남춘천,2994,2766,5760
202103,경춘선,춘천,1607,1173,2780
202103,경춘선,신내,1612,1603,3215
202103,경춘선,갈매,3108,2692,5800
202103,경춘선,별내,2691,2603,5294
202103,경춘선,퇴계원,3542,3344,6886
202103,경춘선,사릉,3522,3238,6760
202103,경춘선,금곡,1627,1521,3148
202103,경춘선,평내호평,6376,6225,12601
202103,경춘선,천마산,1687,1562,3249
202103,경춘선,마석,3924,3776,7700
202103,경춘선,대성리,468,389,857
202103,경춘선,청평,1436,1361,2797
202103,경춘선,상천,308,284,592
202103,경춘선,가평,1334,1301,2635
202103,경춘선,굴봉산,145,131,276
202103,경춘선,백양리,63,67,130
202103,경춘선,강촌,385,386,771
202103,경춘선,김유정,257,235,492
202103,경춘선,남춘천,2016,2207,4223
202103,경춘선,춘천,1267,1391,2658
202103,경춘선,신내,1568,1623,3191
202103,경춘선,갈매,3067,2677,5744
202103,경춘선,별내,2699,2619,5318
202103,경춘선,퇴계원,3519,3235,6754
202103,경춘선,사릉,3581,3317,6898
202103,경춘선,금곡,1493,1513,3006
202103,경춘선,평내호평,6209,6136,12345
202103,경춘선,천마산,1555,1473,3028
202103,경춘선,마석,3766,3685,7451
202103,경춘선,대성리,426,372,798
202103,경춘선,청평,1426,1381,2807
202103,경춘선,상천,254,242,496
202103,경춘선,가평,1262,1288,2550
202103,경춘선,굴봉산,95,90,185
202103,경춘선,백양리,72,62,134
202103,경춘선,강촌,374,354,728
202103,경춘선,김유정,231,251,482
202103,경춘선,남춘천,2005,1979,3984
202103,경춘선,춘천,1278,1239,2517
202103,경춘선,신내,1659,1712,3371
202103,경춘선,갈매,3190,2702,5892
202103,경춘선,별내,2755,2707,5462
202103,경춘선,퇴계원,3628,3405,7033
202103,경춘선,사릉,3590,3386,6976
202103,경춘선,금곡,1670,1558,3228
202103,경춘선,평내호평,6368,6280,12648
202103,경춘선,천마산,1729,1639,3368
202103,경춘선,마석,3915,3799,7714
202103,경춘선,대성리,502,428,930
202103,경춘선,청평,1459,1426,2885
202103,경춘선,상천,268,262,530
202103,경춘선,가평,1364,1333,2697
202103,경춘선,굴봉산,151,132,283
202103,경춘선,백양리,63,74,137
202103,경춘선,강촌,440,429,869
202103,경춘선,김유정,253,299,552
202103,경춘선,남춘천,2669,2615,5284
202103,경춘선,춘천,1303,1257,2560
202103,경춘선,춘천,1440,1187,2627
202103,경춘선,남춘천,2279,2034,4313
202103,경춘선,김유정,281,299,580
202103,경춘선,강촌,338,355,693
202103,경춘선,백양리,80,83,163
202103,경춘선,굴봉산,141,136,277
202103,경춘선,가평,1301,1390,2691
202103,경춘선,상천,290,270,560
202103,경춘선,청평,1451,1483,2934
202103,경춘선,대성리,516,445,961
202103,경춘선,마석,4208,4280,8488
202103,경춘선,천마산,1678,1568,3246
202103,경춘선,평내호평,6441,6385,12826
202103,경춘선,금곡,1612,1559,3171
202103,경춘선,사릉,3597,3364,6961
202103,경춘선,퇴계원,3732,3472,7204
202103,경춘선,별내,2765,2692,5457
202103,경춘선,갈매,3143,2720,5863
202103,경춘선,신내,1620,1646,3266
202103,경춘선,신내,1680,1658,3338
202103,경춘선,갈매,3204,2847,6051
202103,경춘선,별내,2860,2802,5662
202103,경춘선,퇴계원,3748,3579,7327
202103,경춘선,사릉,3633,3459,7092
202103,경춘선,금곡,1586,1521,3107
202103,경춘선,평내호평,6445,6625,13070
202103,경춘선,천마산,1675,1580,3255
202103,경춘선,마석,4002,4010,8012
202103,경춘선,대성리,522,480,1002
202103,경춘선,청평,1484,1623,3107
202103,경춘선,상천,303,283,586
202103,경춘선,가평,1451,1541,2992
202103,경춘선,굴봉산,110,121,231
202103,경춘선,백양리,71,75,146
202103,경춘선,강촌,357,403,760
202103,경춘선,김유정,322,350,672
202103,경춘선,남춘천,2696,2533,5229
202103,경춘선,춘천,1772,1306,3078
202103,경춘선,신내,1656,1692,3348
202103,경춘선,갈매,3014,2632,5646
202103,경춘선,별내,2768,2671,5439
202103,경춘선,퇴계원,3627,3296,6923
202103,경춘선,사릉,3578,3348,6926
202103,경춘선,금곡,1617,1471,3088
202103,경춘선,평내호평,6495,6341,12836
202103,경춘선,천마산,1670,1538,3208
202103,경춘선,마석,3845,3781,7626
202103,경춘선,대성리,477,410,887
202103,경춘선,청평,1465,1423,2888
202103,경춘선,상천,275,249,524
202103,경춘선,가평,1362,1281,2643
202103,경춘선,굴봉산,125,116,241
202103,경춘선,백양리,61,66,127
202103,경춘선,강촌,417,400,817
202103,경춘선,김유정,245,220,465
202103,경춘선,남춘천,2453,2632,5085
202103,경춘선,춘천,1285,1334,2619
202103,경춘선,춘천,1336,1318,2654
202103,경춘선,남춘천,2010,2059,4069
202103,경춘선,김유정,269,293,562
202103,경춘선,강촌,395,406,801
202103,경춘선,백양리,59,49,108
202103,경춘선,굴봉산,131,122,253
202103,경춘선,가평,1352,1344,2696
202103,경춘선,상천,301,289,590
202103,경춘선,청평,1442,1452,2894
202103,경춘선,대성리,526,427,953
202103,경춘선,마석,4233,4248,8481
202103,경춘선,천마산,1695,1576,3271
202103,경춘선,평내호평,6514,6434,12948
202103,경춘선,금곡,1656,1623,3279
202103,경춘선,사릉,3647,3424,7071
202103,경춘선,퇴계원,3643,3373,7016
202103,경춘선,별내,2813,2688,5501
202103,경춘선,갈매,3158,2805,5963
202103,경춘선,신내,1677,1703,3380
202103,경춘선,춘천,1344,1280,2624
202103,경춘선,남춘천,2193,2117,4310
202103,경춘선,김유정,289,317,606
202103,경춘선,강촌,489,445,934
202103,경춘선,백양리,69,73,142
202103,경춘선,굴봉산,108,111,219
202103,경춘선,가평,1357,1349,2706
202103,경춘선,상천,311,279,590
202103,경춘선,청평,1441,1444,2885
202103,경춘선,대성리,506,452,958
202103,경춘선,마석,3950,3877,7827
202103,경춘선,천마산,1724,1623,3347
202103,경춘선,평내호평,6399,6360,12759
202103,경춘선,신내,1630,1710,3340
202103,경춘선,갈매,3176,2729,5905
202103,경춘선,별내,2776,2661,5437
202103,경춘선,퇴계원,3647,3394,7041
202103,경춘선,사릉,3585,3415,7000
202103,경춘선,금곡,1615,1580,3195
202103,경춘선,춘천,1505,1242,2747
202103,경춘선,남춘천,2199,2088,4287
202103,경춘선,김유정,276,301,577
202103,경춘선,강촌,427,417,844
202103,경춘선,백양리,75,82,157
202103,경춘선,굴봉산,116,119,235
202103,경춘선,가평,1383,1413,2796
202103,경춘선,상천,287,301,588
202103,경춘선,청평,1466,1558,3024
202103,경춘선,대성리,494,420,914
202103,경춘선,마석,4017,3852,7869
202103,경춘선,천마산,1686,1639,3325
202103,경춘선,평내호평,6470,6391,12861
202103,경춘선,금곡,1672,1632,3304
202103,경춘선,사릉,3558,3356,6914
202103,경춘선,퇴계원,3625,3392,7017
202103,경춘선,별내,2816,2779,5595
202103,경춘선,갈매,3148,2694,5842
202103,경춘선,신내,1685,1713,3398
202103,경춘선,춘천,1823,1412,3235
202103,경춘선,남춘천,2823,2670,5493
202103,경춘선,김유정,337,349,686
202103,경춘선,강촌,407,430,837
202103,경춘선,백양리,72,87,159
202103,경춘선,굴봉산,163,157,320
202103,경춘선,가평,1565,1718,3283
202103,경춘선,상천,365,352,717
202103,경춘선,청평,1628,1756,3384
202103,경춘선,대성리,587,538,1125
202103,경춘선,마석,4045,4153,8198
202103,경춘선,천마산,1771,1638,3409
202103,경춘선,평내호평,6677,6751,13428
202103,경춘선,금곡,1653,1587,3240
202103,경춘선,사릉,3725,3603,7328
202103,경춘선,퇴계원,3825,3502,7327
202103,경춘선,별내,2913,2895,5808
202103,경춘선,갈매,3179,2759,5938
202103,경춘선,신내,1711,1682,3393
202103,경춘선,춘천,1248,1356,2604
202103,경춘선,남춘천,2026,2238,4264
202103,경춘선,김유정,248,263,511
202103,경춘선,강촌,370,371,741
202103,경춘선,백양리,93,64,157
202103,경춘선,굴봉산,122,125,247
202103,경춘선,가평,1320,1205,2525
202103,경춘선,상천,269,277,546
202103,경춘선,청평,1417,1386,2803
202103,경춘선,대성리,466,409,875
202103,경춘선,마석,3968,3813,7781
202103,경춘선,천마산,1646,1495,3141
202103,경춘선,평내호평,6455,6141,12596
202103,경춘선,금곡,1591,1505,3096
202103,경춘선,사릉,3617,3369,6986
202103,경춘선,퇴계원,3628,3318,6946
202103,경춘선,별내,2774,2653,5427
202103,경춘선,갈매,3087,2688,5775
202103,경춘선,신내,1721,1679,3400
202103,경춘선,남춘천,1954,2029,3983
202103,경춘선,강촌,426,426,852
202103,경춘선,백양리,66,70,136
202103,경춘선,굴봉산,154,140,294
202103,경춘선,가평,1398,1439,2837
202103,경춘선,상천,299,278,577
202103,경춘선,청평,1417,1431,2848
202103,경춘선,대성리,542,474,1016
202103,경춘선,마석,3992,3928,7920
202103,경춘선,천마산,1701,1596,3297
202103,경춘선,평내호평,6367,6302,12669
202103,경춘선,금곡,1590,1558,3148
202103,경춘선,사릉,3605,3488,7093
202103,경춘선,퇴계원,3649,3394,7043
202103,경춘선,별내,2846,2697,5543
202103,경춘선,갈매,3178,2780,5958
202103,경춘선,신내,1685,1712,3397
202103,경춘선,김유정,272,275,547
202103,경춘선,춘천,1412,1330,2742
202103,경춘선,신내,1725,1725,3450
202103,경춘선,갈매,3172,2747,5919
202103,경춘선,별내,2902,2751,5653
202103,경춘선,퇴계원,3737,3459,7196
202103,경춘선,사릉,3620,3429,7049
202103,경춘선,금곡,1661,1562,3223
202103,경춘선,평내호평,6445,6468,12913
202103,경춘선,천마산,1750,1658,3408
202103,경춘선,마석,4050,3886,7936
202103,경춘선,대성리,619,536,1155
202103,경춘선,청평,1479,1518,2997
202103,경춘선,상천,352,308,660
202103,경춘선,가평,1436,1395,2831
202103,경춘선,굴봉산,158,156,314
202103,경춘선,백양리,78,64,142
202103,경춘선,강촌,441,465,906
202103,경춘선,김유정,295,295,590
202103,경춘선,남춘천,2204,2149,4353
202103,경춘선,춘천,1440,1400,2840
202104,경춘선,춘천,1434,1223,2657
202104,경춘선,남춘천,2241,2097,4338
202104,경춘선,김유정,298,319,617
202104,경춘선,강촌,437,424,861
202104,경춘선,백양리,85,87,172
202104,경춘선,굴봉산,142,128,270
202104,경춘선,가평,1344,1450,2794
202104,경춘선,상천,336,320,656
202104,경춘선,청평,1455,1519,2974
202104,경춘선,대성리,676,631,1307
202104,경춘선,마석,4018,3976,7994
202104,경춘선,천마산,1738,1567,3305
202104,경춘선,평내호평,6533,6425,12958
202104,경춘선,금곡,1678,1570,3248
202104,경춘선,사릉,3509,3432,6941
202104,경춘선,퇴계원,3757,3463,7220
202104,경춘선,별내,2955,2818,5773
202104,경춘선,갈매,3201,2748,5949
202104,경춘선,신내,1720,1718,3438
202104,경춘선,춘천,1768,1369,3137
202104,경춘선,남춘천,3302,3181,6483
202104,경춘선,김유정,344,367,711
202104,경춘선,강촌,415,451,866
202104,경춘선,백양리,74,90,164
202104,경춘선,굴봉산,185,197,382
202104,경춘선,가평,1543,1722,3265
202104,경춘선,상천,374,338,712
202104,경춘선,청평,1670,1743,3413
202104,경춘선,대성리,768,774,1542
202104,경춘선,마석,4070,4069,8139
202104,경춘선,천마산,1830,1752,3582
202104,경춘선,평내호평,6661,6674,13335
202104,경춘선,금곡,1607,1565,3172
202104,경춘선,사릉,3706,3527,7233
202104,경춘선,퇴계원,3779,3583,7362
202104,경춘선,별내,2949,2979,5928
202104,경춘선,갈매,3197,2772,5969
202104,경춘선,신내,1757,1788,3545
202104,경춘선,신내,1681,1703,3384
202104,경춘선,갈매,3133,2744,5877
202104,경춘선,별내,2983,2762,5745
202104,경춘선,퇴계원,3762,3382,7144
202104,경춘선,사릉,3702,3479,7181
202104,경춘선,금곡,1652,1544,3196
202104,경춘선,평내호평,6720,6543,13263
202104,경춘선,천마산,1726,1632,3358
202104,경춘선,마석,4204,4060,8264
202104,경춘선,대성리,821,739,1560
202104,경춘선,청평,1614,1606,3220
202104,경춘선,상천,373,340,713
202104,경춘선,춘천,1346,1428,2774
202104,경춘선,남춘천,2127,2346,4473
202104,경춘선,김유정,281,282,563
202104,경춘선,강촌,485,496,981
202104,경춘선,백양리,102,85,187
202104,경춘선,굴봉산,191,203,394
202104,경춘선,가평,1564,1501,3065
202104,경춘선,춘천,1394,1348,2742
202104,경춘선,남춘천,2050,2138,4188
202104,경춘선,김유정,339,365,704
202104,경춘선,강촌,508,491,999
202104,경춘선,백양리,93,91,184
202104,경춘선,굴봉산,201,195,396
202104,경춘선,가평,1538,1507,3045
202104,경춘선,상천,355,330,685
202104,경춘선,청평,1616,1573,3189
202104,경춘선,대성리,850,849,1699
202104,경춘선,마석,4104,3904,8008
202104,경춘선,천마산,1782,1730,3512
202104,경춘선,평내호평,6453,6351,12804
202104,경춘선,금곡,1573,1530,3103
202104,경춘선,사릉,3664,3469,7133
202104,경춘선,퇴계원,3740,3490,7230
202104,경춘선,별내,2873,2799,5672
202104,경춘선,갈매,3229,2785,6014
202104,경춘선,신내,1749,1804,3553
202104,경춘선,춘천,1348,1246,2594
202104,경춘선,남춘천,2643,2689,5332
202104,경춘선,김유정,313,316,629
202104,경춘선,강촌,571,590,1161
202104,경춘선,백양리,103,94,197
202104,경춘선,굴봉산,179,184,363
202104,경춘선,가평,1566,1544,3110
202104,경춘선,상천,419,389,808
202104,경춘선,청평,1545,1557,3102
202104,경춘선,대성리,794,732,1526
202104,경춘선,마석,4030,3897,7927
202104,경춘선,천마산,1778,1677,3455
202104,경춘선,평내호평,6581,6490,13071
202104,경춘선,금곡,1620,1568,3188
202104,경춘선,사릉,3616,3449,7065
202104,경춘선,퇴계원,3824,3526,7350
202104,경춘선,별내,2892,2819,5711
202104,경춘선,갈매,3105,2748,5853
202104,경춘선,신내,1679,1734,3413
202104,경춘선,신내,1743,1771,3514
202104,경춘선,갈매,3239,2789,6028
202104,경춘선,별내,2919,2833,5752
202104,경춘선,퇴계원,3708,3501,7209
202104,경춘선,사릉,3658,3572,7230
202104,경춘선,금곡,1617,1576,3193
202104,경춘선,평내호평,6538,6590,13128
202104,경춘선,천마산,1764,1619,3383
202104,경춘선,마석,4439,4388,8827
202104,경춘선,대성리,711,691,1402
202104,경춘선,청평,1694,1735,3429
202104,경춘선,상천,389,378,767
202104,경춘선,가평,1590,1589,3179
202104,경춘선,굴봉산,198,197,395
202104,경춘선,백양리,92,108,200
202104,경춘선,강촌,521,500,1021
202104,경춘선,김유정,370,439,809
202104,경춘선,남춘천,2152,2189,4341
202104,경춘선,춘천,1481,1184,2665
202104,경춘선,신내,1751,1752,3503
202104,경춘선,갈매,3245,2786,6031
202104,경춘선,별내,2938,2858,5796
202104,경춘선,퇴계원,3684,3455,7139
202104,경춘선,사릉,3621,3462,7083
202104,경춘선,금곡,1617,1550,3167
202104,경춘선,평내호평,6629,6782,13411
202104,경춘선,천마산,1759,1656,3415
202104,경춘선,마석,4058,4129,8187
202104,경춘선,대성리,710,701,1411
202104,경춘선,청평,1765,1916,3681
202104,경춘선,상천,416,417,833
202104,경춘선,가평,1723,1834,3557
202104,경춘선,굴봉산,209,197,406
202104,경춘선,백양리,102,108,210
202104,경춘선,강촌,468,532,1000
202104,경춘선,김유정,319,393,712
202104,경춘선,남춘천,2514,2537,5051
202104,경춘선,춘천,1699,1409,3108
202104,경춘선,춘천,1135,1198,2333
202104,경춘선,남춘천,2135,2294,4429
202104,경춘선,김유정,194,187,381
202104,경춘선,강촌,318,336,654
202104,경춘선,백양리,72,71,143
202104,경춘선,굴봉산,139,119,258
202104,경춘선,가평,1323,1208,2531
202104,경춘선,상천,251,238,489
202104,경춘선,청평,1363,1248,2611
202104,경춘선,대성리,415,396,811
202104,경춘선,마석,3678,3587,7265
202104,경춘선,천마산,1556,1452,3008
202104,경춘선,평내호평,6095,5895,11990
202104,경춘선,금곡,1441,1361,2802
202104,경춘선,사릉,3460,3212,6672
202104,경춘선,퇴계원,3445,3171,6616
202104,경춘선,별내,2679,2541,5220
202104,경춘선,갈매,3045,2637,5682
202104,경춘선,신내,1657,1604,3261
202104,경춘선,신내,1688,1775,3463
202104,경춘선,갈매,3087,2737,5824
202104,경춘선,별내,2770,2675,5445
202104,경춘선,퇴계원,3623,3310,6933
202104,경춘선,사릉,3563,3425,6988
202104,경춘선,금곡,1574,1575,3149
202104,경춘선,평내호평,6432,6211,12643
202104,경춘선,천마산,1649,1540,3189
202104,경춘선,마석,4015,4095,8110
202104,경춘선,대성리,488,445,933
202104,경춘선,청평,1412,1412,2824
202104,경춘선,상천,309,295,604
202104,경춘선,가평,1380,1418,2798
202104,경춘선,굴봉산,189,207,396
202104,경춘선,백양리,84,66,150
202104,경춘선,강촌,391,396,787
202104,경춘선,김유정,256,272,528
202104,경춘선,남춘천,1905,2001,3906
202104,경춘선,춘천,1160,1168,2328
202104,경춘선,신내,1713,1808,3521
202104,경춘선,갈매,3110,2768,5878
202104,경춘선,별내,2843,2748,5591
202104,경춘선,퇴계원,3615,3418,7033
202104,경춘선,사릉,3593,3382,6975
202104,경춘선,금곡,1576,1480,3056
202104,경춘선,평내호평,6315,6194,12509
202104,경춘선,천마산,1755,1668,3423
202104,경춘선,마석,4044,3913,7957
202104,경춘선,대성리,533,507,1040
202104,경춘선,청평,1667,1640,3307
202104,경춘선,상천,379,365,744
202104,경춘선,가평,1556,1537,3093
202104,경춘선,굴봉산,328,332,660
202104,경춘선,백양리,121,118,239
202104,경춘선,강촌,528,550,1078
202104,경춘선,김유정,340,365,705
202104,경춘선,남춘천,2074,2118,4192
202104,경춘선,춘천,1345,1289,2634
202104,경춘선,신내,1729,1769,3498
202104,경춘선,갈매,3174,2803,5977
202104,경춘선,별내,2908,2815,5723
202104,경춘선,퇴계원,3774,3451,7225
202104,경춘선,사릉,3598,3406,7004
202104,경춘선,금곡,1634,1590,3224
202104,경춘선,평내호평,6432,6341,12773
202104,경춘선,천마산,1740,1648,3388
202104,경춘선,마석,4058,4079,8137
202104,경춘선,대성리,623,551,1174
202104,경춘선,청평,1555,1606,3161
202104,경춘선,상천,435,422,857
202104,경춘선,가평,1606,1569,3175
202104,경춘선,굴봉산,279,281,560
202104,경춘선,백양리,116,120,236
202104,경춘선,강촌,512,510,1022
202104,경춘선,김유정,298,316,614
202104,경춘선,남춘천,2176,2159,4335
202104,경춘선,춘천,1419,1276,2695
202104,경춘선,신내,1555,1536,3091
202104,경춘선,갈매,3089,2685,5774
202104,경춘선,별내,2749,2718,5467
202104,경춘선,퇴계원,3592,3297,6889
202104,경춘선,사릉,3371,3323,6694
202104,경춘선,금곡,1492,1401,2893
202104,경춘선,평내호평,6129,6259,12388
202104,경춘선,천마산,1665,1524,3189
202104,경춘선,마석,3725,3745,7470
202104,경춘선,대성리,409,431,840
202104,경춘선,청평,1396,1573,2969
202104,경춘선,상천,259,263,522
202104,경춘선,가평,1327,1470,2797
202104,경춘선,굴봉산,129,127,256
202104,경춘선,백양리,76,92,168
202104,경춘선,강촌,308,368,676
202104,경춘선,김유정,210,236,446
202104,경춘선,남춘천,2228,2227,4455
202104,경춘선,춘천,1264,1108,2372
202104,경춘선,춘천,1423,1382,2805
202104,경춘선,남춘천,2128,2274,4402
202104,경춘선,김유정,347,335,682
202104,경춘선,강촌,537,566,1103
202104,경춘선,백양리,143,139,282
202104,경춘선,굴봉산,260,261,521
202104,경춘선,가평,1556,1506,3062
202104,경춘선,상천,416,400,816
202104,경춘선,청평,1641,1544,3185
202104,경춘선,대성리,599,510,1109
202104,경춘선,마석,4109,4019,8128
202104,경춘선,천마산,1726,1631,3357
202104,경춘선,평내호평,6672,6555,13227
202104,경춘선,금곡,1622,1519,3141
202104,경춘선,사릉,3737,3513,7250
202104,경춘선,퇴계원,3706,3442,7148
202104,경춘선,별내,2941,2793,5734
202104,경춘선,갈매,3159,2752,5911
202104,경춘선,신내,1720,1769,3489
202104,경춘선,춘천,1902,1769,3671
202104,경춘선,남춘천,2315,2384,4699
202104,경춘선,김유정,354,378,732
202104,경춘선,강촌,649,623,1272
202104,경춘선,백양리,125,126,251
202104,경춘선,굴봉산,264,256,520
202104,경춘선,가평,1595,1608,3203
202104,경춘선,상천,490,444,934
202104,경춘선,청평,1681,1629,3310
202104,경춘선,대성리,651,526,1177
202104,경춘선,마석,4248,4119,8367
202104,경춘선,천마산,1707,1669,3376
202104,경춘선,평내호평,6480,6466,12946
202104,경춘선,금곡,1697,1651,3348
202104,경춘선,사릉,3741,3537,7278
202104,경춘선,퇴계원,3744,3554,7298
202104,경춘선,별내,2973,2819,5792
202104,경춘선,갈매,3199,2777,5976
202104,경춘선,신내,1757,1811,3568
202104,경춘선,춘천,1737,1624,3361
202104,경춘선,남춘천,2304,2326,4630
202104,경춘선,김유정,296,316,612
202104,경춘선,강촌,671,618,1289
202104,경춘선,백양리,109,112,221
202104,경춘선,굴봉산,270,268,538
202104,경춘선,가평,1556,1559,3115
202104,경춘선,상천,428,400,828
202104,경춘선,청평,1629,1670,3299
202104,경춘선,대성리,604,510,1114
202104,경춘선,마석,4203,4139,8342
202104,경춘선,천마산,1774,1656,3430
202104,경춘선,평내호평,6535,6450,12985
202104,경춘선,금곡,1602,1598,3200
202104,경춘선,사릉,3745,3583,7328
202104,경춘선,퇴계원,3754,3483,7237
202104,경춘선,별내,3018,2893,5911
202104,경춘선,갈매,3161,2746,5907
202104,경춘선,신내,1740,1796,3536
202104,경춘선,춘천,1726,1480,3206
202104,경춘선,남춘천,3237,3057,6294
202104,경춘선,김유정,325,360,685
202104,경춘선,강촌,625,582,1207
202104,경춘선,백양리,125,139,264
202104,경춘선,굴봉산,276,278,554
202104,경춘선,가평,1595,1639,3234
202104,경춘선,상천,383,350,733
202104,경춘선,청평,1623,1596,3219
202104,경춘선,대성리,610,545,1155
202104,경춘선,마석,4074,4042,8116
202104,경춘선,천마산,1827,1727,3554
202104,경춘선,평내호평,6444,6436,12880
202104,경춘선,금곡,1603,1559,3162
202104,경춘선,사릉,3693,3579,7272
202104,경춘선,퇴계원,3779,3586,7365
202104,경춘선,별내,2955,2840,5795
202104,경춘선,갈매,3164,2758,5922
202104,경춘선,신내,1746,1775,3521
202104,경춘선,신내,1760,1807,3567
202104,경춘선,갈매,3203,2823,6026
202104,경춘선,별내,2992,2948,5940
202104,경춘선,퇴계원,3770,3551,7321
202104,경춘선,사릉,3660,3508,7168
202104,경춘선,금곡,1645,1575,3220
202104,경춘선,평내호평,6640,6737,13377
202104,경춘선,천마산,1786,1599,3385
202104,경춘선,마석,4530,4622,9152
202104,경춘선,대성리,539,521,1060
202104,경춘선,청평,1654,1836,3490
202104,경춘선,상천,346,341,687
202104,경춘선,가평,1709,1770,3479
202104,경춘선,굴봉산,204,224,428
202104,경춘선,백양리,128,122,250
202104,경춘선,강촌,512,508,1020
202104,경춘선,김유정,321,371,692
202104,경춘선,남춘천,2753,2577,5330
202104,경춘선,춘천,1836,1371,3207
202104,경춘선,춘천,1609,1710,3319
202104,경춘선,남춘천,2368,2512,4880
202104,경춘선,김유정,308,305,613
202104,경춘선,강촌,539,530,1069
202104,경춘선,백양리,126,123,249
202104,경춘선,굴봉산,209,210,419
202104,경춘선,가평,1655,1596,3251
202104,경춘선,상천,403,364,767
202104,경춘선,청평,1665,1615,3280
202104,경춘선,대성리,610,489,1099
202104,경춘선,마석,4220,4155,8375
202104,경춘선,천마산,1768,1712,3480
202104,경춘선,평내호평,6750,6438,13188
202104,경춘선,금곡,1660,1634,3294
202104,경춘선,사릉,3717,3509,7226
202104,경춘선,퇴계원,3861,3536,7397
202104,경춘선,별내,3009,2803,5812
202104,경춘선,갈매,3146,2675,5821
202104,경춘선,신내,1720,1711,3431
202104,경춘선,춘천,1353,1376,2729
202104,경춘선,남춘천,2866,2901,5767
202104,경춘선,김유정,333,363,696
202104,경춘선,강촌,605,590,1195
202104,경춘선,백양리,128,134,262
202104,경춘선,신내,1821,1860,3681
202104,경춘선,갈매,3195,2800,5995
202104,경춘선,별내,2958,2894,5852
202104,경춘선,퇴계원,3728,3408,7136
202104,경춘선,사릉,3719,3533,7252
202104,경춘선,금곡,1665,1631,3296
202104,경춘선,평내호평,6545,6435,12980
202104,경춘선,천마산,1763,1642,3405
202104,경춘선,마석,4232,4232,8464
202104,경춘선,대성리,539,496,1035
202104,경춘선,청평,1610,1584,3194
202104,경춘선,상천,354,360,714
202104,경춘선,가평,1617,1629,3246
202104,경춘선,굴봉산,238,236,474
202104,경춘선,춘천,1411,1283,2694
202104,경춘선,남춘천,2278,2254,4532
202104,경춘선,김유정,288,317,605
202104,경춘선,강촌,559,534,1093
202104,경춘선,백양리,159,138,297
202104,경춘선,굴봉산,169,164,333
202104,경춘선,가평,1552,1524,3076
202104,경춘선,상천,395,378,773
202104,경춘선,청평,1555,1512,3067
202104,경춘선,대성리,527,472,999
202104,경춘선,마석,4398,4447,8845
202104,경춘선,천마산,1737,1637,3374
202104,경춘선,평내호평,6508,6471,12979
202104,경춘선,금곡,1635,1576,3211
202104,경춘선,사릉,3723,3541,7264
202104,경춘선,퇴계원,3739,3461,7200
202104,경춘선,별내,2988,2864,5852
202104,경춘선,갈매,3173,2768,5941
202104,경춘선,신내,1769,1834,3603
202104,경춘선,신내,1738,1806,3544
202104,경춘선,갈매,3204,2747,5951
202104,경춘선,별내,2995,2918,5913
202104,경춘선,퇴계원,3649,3411,7060
202104,경춘선,사릉,3564,3463,7027
202104,경춘선,금곡,1605,1571,3176
202104,경춘선,평내호평,6414,6357,12771
202104,경춘선,천마산,1755,1642,3397
202104,경춘선,마석,4016,3967,7983
202104,경춘선,대성리,544,468,1012
202104,경춘선,청평,1574,1640,3214
202104,경춘선,상천,374,383,757
202104,경춘선,가평,1675,1670,3345
202104,경춘선,굴봉산,185,200,385
202104,경춘선,백양리,97,93,190
202104,경춘선,강촌,526,521,1047
202104,경춘선,김유정,285,312,597
202104,경춘선,남춘천,2316,2116,4432
202104,경춘선,춘천,1526,1238,2764
202104,경춘선,신내,1707,1703,3410
202104,경춘선,갈매,3186,2778,5964
202104,경춘선,별내,3005,2949,5954
202104,경춘선,퇴계원,3709,3437,7146
202104,경춘선,사릉,3572,3435,7007
202104,경춘선,금곡,1525,1462,2987
202104,경춘선,평내호평,6452,6553,13005
202104,경춘선,천마산,1700,1555,3255
202104,경춘선,마석,3976,3953,7929
202104,경춘선,대성리,482,446,928
202104,경춘선,청평,1495,1767,3262
202104,경춘선,상천,286,271,557
202104,경춘선,가평,1609,1850,3459
202104,경춘선,굴봉산,145,140,285
202104,경춘선,백양리,80,95,175
202104,경춘선,강촌,502,493,995
202104,경춘선,김유정,213,289,502
202104,경춘선,남춘천,2800,2570,5370
202104,경춘선,춘천,1735,1354,3089
202105,경춘선,춘천,1518,1596,3114
202105,경춘선,남춘천,2325,2453,4778
202105,경춘선,김유정,382,391,773
202105,경춘선,강촌,625,613,1238
202105,경춘선,백양리,126,128,254
202105,경춘선,굴봉산,213,223,436
202105,경춘선,가평,1857,1731,3588
202105,경춘선,상천,421,429,850
202105,경춘선,청평,1823,1815,3638
202105,경춘선,대성리,645,513,1158
202105,경춘선,마석,4693,4614,9307
202105,경춘선,천마산,1864,1773,3637
202105,경춘선,평내호평,6858,6634,13492
202105,경춘선,금곡,1693,1620,3313
202105,경춘선,사릉,3764,3520,7284
202105,경춘선,퇴계원,3893,3506,7399
202105,경춘선,별내,3135,2893,6028
202105,경춘선,갈매,3184,2803,5987
202105,경춘선,신내,1814,1752,3566
202105,경춘선,춘천,1365,1295,2660
202105,경춘선,남춘천,2105,2138,4243
202105,경춘선,김유정,176,222,398
202105,경춘선,강촌,342,372,714
202105,경춘선,백양리,73,62,135
202105,경춘선,굴봉산,102,109,211
202105,경춘선,가평,1279,1322,2601
202105,경춘선,상천,178,168,346
202105,경춘선,청평,1300,1363,2663
202105,경춘선,대성리,404,383,787
202105,경춘선,마석,3646,3715,7361
202105,경춘선,천마산,1575,1455,3030
202105,경춘선,평내호평,5972,5993,11965
202105,경춘선,금곡,1482,1438,2920
202105,경춘선,사릉,3464,3307,6771
202105,경춘선,퇴계원,3605,3255,6860
202105,경춘선,별내,2873,2844,5717
202105,경춘선,갈매,2890,2532,5422
202105,경춘선,신내,1574,1565,3139
202105,경춘선,갈매,1749,1615,3364
202105,경춘선,별내,2018,1980,3998
202105,경춘선,퇴계원,2400,2242,4642
202105,경춘선,사릉,2182,2074,4256
202105,경춘선,금곡,1072,1040,2112
202105,경춘선,평내호평,4281,4216,8497
202105,경춘선,천마산,1320,1301,2621
202105,경춘선,마석,2994,2946,5940
202105,경춘선,대성리,866,712,1578
202105,경춘선,청평,1708,1637,3345
202105,경춘선,상천,482,429,911
202105,경춘선,가평,2026,2019,4045
202105,경춘선,굴봉산,285,303,588
202105,경춘선,백양리,175,168,343
202105,경춘선,강촌,887,786,1673
202105,경춘선,김유정,759,876,1635
202105,경춘선,남춘천,2381,2312,4693
202105,경춘선,춘천,2056,1675,3731
202105,경춘선,신내,1056,1080,2136
202105,경춘선,신내,1739,1766,3505
202105,경춘선,갈매,3188,2818,6006
202105,경춘선,별내,3128,2974,6102
202105,경춘선,퇴계원,3835,3557,7392
202105,경춘선,사릉,3621,3480,7101
202105,경춘선,금곡,1651,1623,3274
202105,경춘선,평내호평,6806,6550,13356
202105,경춘선,천마산,1866,1763,3629
202105,경춘선,마석,4350,4260,8610
202105,경춘선,대성리,605,529,1134
202105,경춘선,청평,1705,1706,3411
202105,경춘선,상천,380,362,742
202105,경춘선,가평,1791,1751,3542
202105,경춘선,굴봉산,201,205,406
202105,경춘선,백양리,149,141,290
202105,경춘선,강촌,621,549,1170
202105,경춘선,김유정,413,456,869
202105,경춘선,남춘천,2450,2369,4819
202105,경춘선,춘천,1694,1414,3108
202105,경춘선,춘천,1689,1391,3080
202105,경춘선,남춘천,3098,2993,6091
202105,경춘선,김유정,283,343,626
202105,경춘선,강촌,328,380,708
202105,경춘선,백양리,103,92,195
202105,경춘선,굴봉산,143,155,298
202105,경춘선,가평,1594,1765,3359
202105,경춘선,상천,262,249,511
202105,경춘선,청평,1535,1752,3287
202105,경춘선,대성리,462,463,925
202105,경춘선,마석,3905,3941,7846
202105,경춘선,천마산,1650,1542,3192
202105,경춘선,평내호평,6353,6728,13081
202105,경춘선,금곡,1517,1480,2997
202105,경춘선,사릉,3519,3545,7064
202105,경춘선,퇴계원,3681,3505,7186
202105,경춘선,별내,3005,2870,5875
202105,경춘선,갈매,3090,2752,5842
202105,경춘선,신내,1720,1736,3456
202105,경춘선,신내,1704,1665,3369
202105,경춘선,갈매,3155,2762,5917
202105,경춘선,별내,2975,2824,5799
202105,경춘선,퇴계원,3690,3342,7032
202105,경춘선,사릉,3605,3307,6912
202105,경춘선,금곡,1519,1419,2938
202105,경춘선,평내호평,6385,6172,12557
202105,경춘선,천마산,1687,1603,3290
202105,경춘선,마석,4041,3917,7958
202105,경춘선,대성리,462,366,828
202105,경춘선,청평,1452,1383,2835
202105,경춘선,상천,239,220,459
202105,경춘선,가평,1448,1408,2856
202105,경춘선,굴봉산,114,108,222
202105,경춘선,백양리,75,74,149
202105,경춘선,강촌,388,355,743
202105,경춘선,김유정,247,266,513
202105,경춘선,남춘천,2049,2253,4302
202105,경춘선,춘천,1258,1360,2618
202105,경춘선,신내,1775,1812,3587
202105,경춘선,갈매,3279,2925,6204
202105,경춘선,별내,3076,2971,6047
202105,경춘선,퇴계원,3858,3494,7352
202105,경춘선,사릉,3729,3496,7225
202105,경춘선,금곡,1659,1639,3298
202105,경춘선,평내호평,6705,6496,13201
202105,경춘선,천마산,1786,1731,3517
202105,경춘선,마석,4242,4193,8435
202105,경춘선,대성리,562,512,1074
202105,경춘선,청평,1698,1618,3316
202105,경춘선,상천,363,366,729
202105,경춘선,가평,1729,1716,3445
202105,경춘선,굴봉산,195,212,407
202105,경춘선,백양리,142,138,280
202105,경춘선,강촌,526,521,1047
202105,경춘선,김유정,364,394,758
202105,경춘선,남춘천,2178,2273,4451
202105,경춘선,춘천,1437,1416,2853
202105,경춘선,춘천,1504,1369,2873
202105,경춘선,남춘천,2803,2903,5706
202105,경춘선,김유정,349,380,729
202105,경춘선,강촌,605,595,1200
202105,경춘선,백양리,102,96,198
202105,경춘선,굴봉산,179,187,366
202105,경춘선,가평,1709,1674,3383
202105,경춘선,상천,356,324,680
202105,경춘선,청평,1815,1689,3504
202105,경춘선,대성리,603,570,1173
202105,경춘선,마석,4207,4094,8301
202105,경춘선,천마산,1786,1706,3492
202105,경춘선,평내호평,6587,6466,13053
202105,경춘선,금곡,1673,1649,3322
202105,경춘선,사릉,3781,3459,7240
202105,경춘선,퇴계원,3858,3531,7389
202105,경춘선,별내,3116,2974,6090
202105,경춘선,갈매,3291,2919,6210
202105,경춘선,신내,1840,1898,3738
202105,경춘선,신내,1806,1803,3609
202105,경춘선,갈매,3340,2912,6252
202105,경춘선,별내,3149,3059,6208
202105,경춘선,퇴계원,3822,3494,7316
202105,경춘선,사릉,3586,3417,7003
202105,경춘선,금곡,1750,1682,3432
202105,경춘선,평내호평,6754,6596,13350
202105,경춘선,천마산,1800,1683,3483
202105,경춘선,마석,4516,4492,9008
202105,경춘선,대성리,589,495,1084
202105,경춘선,청평,1704,1715,3419
202105,경춘선,상천,341,316,657
202105,경춘선,가평,1719,1713,3432
202105,경춘선,굴봉산,221,221,442
202105,경춘선,백양리,101,105,206
202105,경춘선,강촌,543,529,1072
202105,경춘선,김유정,344,348,692
202105,경춘선,남춘천,2328,2183,4511
202105,경춘선,춘천,1576,1297,2873
202105,경춘선,신내,1861,1836,3697
202105,경춘선,갈매,3295,2851,6146
202105,경춘선,별내,3341,3219,6560
202105,경춘선,퇴계원,3886,3610,7496
202105,경춘선,사릉,3693,3439,7132
202105,경춘선,금곡,1684,1591,3275
202105,경춘선,평내호평,6824,6795,13619
202105,경춘선,천마산,1834,1696,3530
202105,경춘선,마석,4298,4344,8642
202105,경춘선,대성리,576,527,1103
202105,경춘선,청평,1913,1966,3879
202105,경춘선,상천,334,328,662
202105,경춘선,가평,1870,2074,3944
202105,경춘선,굴봉산,175,169,344
202105,경춘선,백양리,93,106,199
202105,경춘선,강촌,492,512,1004
202105,경춘선,김유정,405,463,868
202105,경춘선,남춘천,2826,2711,5537
202105,경춘선,춘천,1906,1517,3423
202105,경춘선,춘천,1206,1350,2556
202105,경춘선,남춘천,2258,2464,4722
202105,경춘선,김유정,220,213,433
202105,경춘선,강촌,373,339,712
202105,경춘선,백양리,80,70,150
202105,경춘선,굴봉산,118,123,241
202105,경춘선,가평,1422,1318,2740
202105,경춘선,상천,240,237,477
202105,경춘선,청평,1446,1297,2743
202105,경춘선,대성리,445,376,821
202105,경춘선,마석,3868,3753,7621
202105,경춘선,천마산,1742,1637,3379
202105,경춘선,평내호평,6361,6171,12532
202105,경춘선,금곡,1600,1497,3097
202105,경춘선,사릉,3620,3362,6982
202105,경춘선,퇴계원,3756,3358,7114
202105,경춘선,별내,2941,2793,5734
202105,경춘선,갈매,3156,2724,5880
202105,경춘선,신내,1664,1664,3328
202105,경춘선,신내,1933,1909,3842
202105,경춘선,갈매,3348,2857,6205
202105,경춘선,별내,3302,3139,6441
202105,경춘선,퇴계원,3911,3571,7482
202105,경춘선,사릉,3710,3480,7190
202105,경춘선,금곡,1781,1683,3464
202105,경춘선,평내호평,6752,6625,13377
202105,경춘선,천마산,1806,1739,3545
202105,경춘선,마석,4485,4498,8983
202105,경춘선,대성리,617,566,1183
202105,경춘선,청평,1776,1964,3740
202105,경춘선,상천,365,361,726
202105,경춘선,가평,1726,1934,3660
202105,경춘선,굴봉산,185,202,387
202105,경춘선,백양리,116,112,228
202105,경춘선,강촌,542,550,1092
202105,경춘선,김유정,322,400,722
202105,경춘선,남춘천,2418,2625,5043
202105,경춘선,춘천,1682,1567,3249
202105,경춘선,춘천,2497,1962,4459
202105,경춘선,남춘천,2595,2727,5322
202105,경춘선,김유정,829,904,1733
202105,경춘선,강촌,1054,918,1972
202105,경춘선,백양리,214,187,401
202105,경춘선,굴봉산,262,274,536
202105,경춘선,가평,2389,2306,4695
202105,경춘선,상천,558,428,986
202105,경춘선,청평,1984,1859,3843
202105,경춘선,대성리,989,822,1811
202105,경춘선,마석,3283,3291,6574
202105,경춘선,천마산,1487,1476,2963
202105,경춘선,평내호평,4547,4464,9011
202105,경춘선,금곡,1122,1095,2217
202105,경춘선,사릉,2436,2419,4855
202105,경춘선,퇴계원,2615,2408,5023
202105,경춘선,별내,2188,2110,4298
202105,경춘선,갈매,1857,1665,3522
202105,경춘선,신내,1130,1138,2268
202105,경춘선,춘천,1369,1211,2580
202105,경춘선,남춘천,2196,2134,4330
202105,경춘선,김유정,259,265,524
202105,경춘선,강촌,441,414,855
202105,경춘선,백양리,61,64,125
202105,경춘선,굴봉산,120,120,240
202105,경춘선,가평,1478,1453,2931
202105,경춘선,상천,256,234,490
202105,경춘선,청평,1491,1528,3019
202105,경춘선,대성리,460,389,849
202105,경춘선,마석,3849,3740,7589
202105,경춘선,천마산,1708,1554,3262
202105,경춘선,평내호평,6222,6204,12426
202105,경춘선,금곡,1525,1529,3054
202105,경춘선,사릉,3546,3339,6885
202105,경춘선,퇴계원,3620,3380,7000
202105,경춘선,별내,3080,2895,5975
202105,경춘선,갈매,3115,2694,5809
202105,경춘선,신내,1669,1696,3365
202105,경춘선,춘천,1652,1341,2993
202105,경춘선,남춘천,2516,2452,4968
202105,경춘선,김유정,259,310,569
202105,경춘선,강촌,427,432,859
202105,경춘선,백양리,73,84,157
202105,경춘선,굴봉산,121,109,230
202105,경춘선,가평,1618,1764,3382
202105,경춘선,상천,252,250,502
202105,경춘선,청평,1520,1743,3263
202105,경춘선,대성리,499,452,951
202105,경춘선,마석,3989,3992,7981
202105,경춘선,천마산,1692,1632,3324
202105,경춘선,평내호평,6456,6375,12831
202105,경춘선,금곡,1611,1570,3181
202105,경춘선,사릉,3521,3439,6960
202105,경춘선,퇴계원,3797,3409,7206
202105,경춘선,별내,3106,3021,6127
202105,경춘선,갈매,3237,2835,6072
202105,경춘선,신내,1715,1701,3416
202105,경춘선,춘천,1390,1432,2822
202105,경춘선,남춘천,2160,2460,4620
202105,경춘선,김유정,302,306,608
202105,경춘선,강촌,409,351,760
202105,경춘선,백양리,103,101,204
202105,경춘선,굴봉산,154,143,297
202105,경춘선,청평,1630,1531,3161
202105,경춘선,가평,1756,1670,3426
202105,경춘선,상천,297,292,589
202105,경춘선,신내,1775,1777,3552
202105,경춘선,갈매,3251,2848,6099
202105,경춘선,별내,3161,3048,6209
202105,경춘선,퇴계원,3778,3445,7223
202105,경춘선,사릉,3778,3561,7339
202105,경춘선,금곡,1656,1554,3210
202105,경춘선,평내호평,6754,6530,13284
202105,경춘선,천마산,1818,1697,3515
202105,경춘선,마석,4141,3982,8123
202105,경춘선,대성리,591,457,1048
202105,경춘선,퇴계원,3665,3408,7073
202105,경춘선,신내,1711,1756,3467
202105,경춘선,갈매,3217,2816,6033
202105,경춘선,별내,3004,2870,5874
202105,경춘선,사릉,3577,3374,6951
202105,경춘선,금곡,1565,1581,3146
202105,경춘선,평내호평,6215,6177,12392
202105,경춘선,천마산,1717,1581,3298
202105,경춘선,마석,3927,3820,7747
202105,경춘선,대성리,413,358,771
202105,경춘선,청평,1444,1433,2877
202105,경춘선,상천,219,233,452
202105,경춘선,가평,1350,1332,2682
202105,경춘선,굴봉산,103,104,207
202105,경춘선,백양리,65,74,139
202105,경춘선,강촌,393,377,770
202105,경춘선,김유정,245,270,515
202105,경춘선,남춘천,1914,1919,3833
202105,경춘선,춘천,1204,1140,2344
202105,경춘선,신내,1781,1820,3601
202105,경춘선,갈매,3271,2838,6109
202105,경춘선,별내,3176,2954,6130
202105,경춘선,퇴계원,3841,3564,7405
202105,경춘선,사릉,3632,3427,7059
202105,경춘선,금곡,1700,1615,3315
202105,경춘선,평내호평,6470,6291,12761
202105,경춘선,천마산,1806,1721,3527
202105,경춘선,마석,4215,4021,8236
202105,경춘선,대성리,543,470,1013
202105,경춘선,청평,1662,1616,3278
202105,경춘선,상천,335,318,653
202105,경춘선,가평,1644,1671,3315
202105,경춘선,굴봉산,185,185,370
202105,경춘선,백양리,79,80,159
202105,경춘선,강촌,561,524,1085
202105,경춘선,김유정,301,352,653
202105,경춘선,남춘천,2143,2181,4324
202105,경춘선,춘천,1442,1320,2762
202105,경춘선,신내,1746,1780,3526
202105,경춘선,갈매,3230,2701,5931
202105,경춘선,별내,2965,2808,5773
202105,경춘선,퇴계원,3577,3287,6864
202105,경춘선,사릉,3359,3282,6641
202105,경춘선,금곡,1494,1444,2938
202105,경춘선,평내호평,5956,5855,11811
202105,경춘선,천마산,1556,1475,3031
202105,경춘선,마석,3780,3686,7466
202105,경춘선,대성리,404,337,741
202105,경춘선,청평,1312,1281,2593
202105,경춘선,상천,209,177,386
202105,경춘선,가평,1298,1330,2628
202105,경춘선,굴봉산,99,109,208
202105,경춘선,백양리,63,48,111
202105,경춘선,강촌,373,354,727
202105,경춘선,김유정,190,207,397
202105,경춘선,남춘천,2162,2086,4248
202105,경춘선,춘천,1239,1053,2292
202105,경춘선,춘천,1395,1115,2510
202105,경춘선,남춘천,2399,2284,4683
202105,경춘선,김유정,194,238,432
202105,경춘선,강촌,364,374,738
202105,경춘선,백양리,62,85,147
202105,경춘선,굴봉산,98,119,217
202105,경춘선,가평,1337,1502,2839
202105,경춘선,상천,169,185,354
202105,경춘선,청평,1377,1597,2974
202105,경춘선,대성리,385,354,739
202105,경춘선,마석,3945,3960,7905
202105,경춘선,천마산,1652,1551,3203
202105,경춘선,평내호평,6144,6216,12360
202105,경춘선,금곡,1527,1510,3037
202105,경춘선,사릉,3445,3305,6750
202105,경춘선,퇴계원,3564,3358,6922
202105,경춘선,별내,3043,2897,5940
202105,경춘선,갈매,3149,2664,5813
202105,경춘선,신내,1655,1688,3343
202105,경춘선,춘천,1291,1330,2621
202105,경춘선,남춘천,1980,2203,4183
202105,경춘선,김유정,226,236,462
202105,경춘선,강촌,394,384,778
202105,경춘선,백양리,67,68,135
202105,경춘선,굴봉산,129,125,254
202105,경춘선,가평,1654,1471,3125
202105,경춘선,상천,263,239,502
202105,경춘선,청평,1505,1380,2885
202105,경춘선,대성리,468,441,909
202105,경춘선,마석,4013,3795,7808
202105,경춘선,천마산,1775,1635,3410
202105,경춘선,평내호평,6361,6060,12421
202105,경춘선,금곡,1621,1542,3163
202105,경춘선,사릉,3630,3381,7011
202105,경춘선,퇴계원,3696,3378,7074
202105,경춘선,별내,3064,2925,5989
202105,경춘선,갈매,3199,2765,5964
202105,경춘선,신내,1736,1734,3470
202106,경춘선,신내,1725,1761,3486
202106,경춘선,갈매,3217,2748,5965
202106,경춘선,별내,3105,2896,6001
202106,경춘선,퇴계원,3641,3334,6975
202106,경춘선,사릉,3552,3400,6952
202106,경춘선,금곡,1627,1552,3179
202106,경춘선,평내호평,6343,6264,12607
202106,경춘선,천마산,1699,1579,3278
202106,경춘선,마석,3891,3821,7712
202106,경춘선,대성리,449,412,861
202106,경춘선,청평,1489,1475,2964
202106,경춘선,상천,271,276,547
202106,경춘선,가평,1411,1468,2879
202106,경춘선,굴봉산,119,134,253
202106,경춘선,백양리,71,62,133
202106,경춘선,강촌,427,429,856
202106,경춘선,김유정,232,244,476
202106,경춘선,남춘천,2033,2035,4068
202106,경춘선,춘천,1258,1208,2466
202106,경춘선,신내,1815,1815,3630
202106,경춘선,갈매,3179,2827,6006
202106,경춘선,별내,3081,2950,6031
202106,경춘선,퇴계원,3854,3509,7363
202106,경춘선,사릉,3631,3388,7019
202106,경춘선,금곡,1566,1525,3091
202106,경춘선,평내호평,6471,6385,12856
202106,경춘선,천마산,1734,1620,3354
202106,경춘선,마석,3987,3906,7893
202106,경춘선,대성리,529,466,995
202106,경춘선,청평,1584,1522,3106
202106,경춘선,상천,322,310,632
202106,경춘선,가평,1560,1451,3011
202106,경춘선,굴봉산,169,169,338
202106,경춘선,백양리,97,82,179
202106,경춘선,강촌,456,471,927
202106,경춘선,김유정,314,316,630
202106,경춘선,남춘천,2551,2601,5152
202106,경춘선,춘천,1322,1213,2535
202106,경춘선,신내,1660,1712,3372
202106,경춘선,갈매,3065,2636,5701
202106,경춘선,별내,2914,2773,5687
202106,경춘선,퇴계원,3499,3286,6785
202106,경춘선,사릉,3396,3243,6639
202106,경춘선,금곡,1472,1398,2870
202106,경춘선,평내호평,5945,5873,11818
202106,경춘선,천마산,1591,1434,3025
202106,경춘선,마석,3904,3868,7772
202106,경춘선,대성리,395,361,756
202106,경춘선,청평,1308,1306,2614
202106,경춘선,상천,210,202,412
202106,경춘선,가평,1234,1294,2528
202106,경춘선,굴봉산,110,107,217
202106,경춘선,백양리,51,57,108
202106,경춘선,강촌,349,355,704
202106,경춘선,김유정,223,233,456
202106,경춘선,남춘천,1888,1797,3685
202106,경춘선,춘천,1181,1043,2224
202106,경춘선,신내,1774,1785,3559
202106,경춘선,갈매,3241,2847,6088
202106,경춘선,별내,3261,3111,6372
202106,경춘선,퇴계원,3740,3490,7230
202106,경춘선,사릉,3708,3458,7166
202106,경춘선,금곡,1638,1551,3189
202106,경춘선,평내호평,6478,6595,13073
202106,경춘선,천마산,1847,1713,3560
202106,경춘선,마석,4151,4090,8241
202106,경춘선,대성리,546,527,1073
202106,경춘선,청평,1549,1749,3298
202106,경춘선,상천,269,286,555
202106,경춘선,가평,1715,1955,3670
202106,경춘선,굴봉산,152,171,323
202106,경춘선,백양리,69,82,151
202106,경춘선,강촌,462,511,973
202106,경춘선,김유정,304,324,628
202106,경춘선,남춘천,2412,2463,4875
202106,경춘선,춘천,1475,1265,2740
202106,경춘선,춘천,1353,1311,2664
202106,경춘선,남춘천,2726,2887,5613
202106,경춘선,김유정,262,273,535
202106,경춘선,강촌,430,402,832
202106,경춘선,백양리,79,82,161
202106,경춘선,굴봉산,167,171,338
202106,경춘선,가평,1531,1525,3056
202106,경춘선,상천,289,265,554
202106,경춘선,청평,1646,1518,3164
202106,경춘선,대성리,517,475,992
202106,경춘선,마석,4047,3884,7931
202106,경춘선,천마산,1816,1639,3455
202106,경춘선,평내호평,6519,6340,12859
202106,경춘선,금곡,1566,1517,3083
202106,경춘선,사릉,3629,3333,6962
202106,경춘선,퇴계원,3761,3412,7173
202106,경춘선,별내,3128,2973,6101
202106,경춘선,갈매,3172,2731,5903
202106,경춘선,신내,1678,1678,3356
202106,경춘선,신내,1807,1817,3624
202106,경춘선,갈매,3254,2869,6123
202106,경춘선,별내,3246,3057,6303
202106,경춘선,퇴계원,3700,3418,7118
202106,경춘선,사릉,3629,3477,7106
202106,경춘선,금곡,1666,1602,3268
202106,경춘선,평내호평,6535,6447,12982
202106,경춘선,천마산,1761,1627,3388
202106,경춘선,마석,4275,4325,8600
202106,경춘선,대성리,475,439,914
202106,경춘선,청평,1549,1478,3027
202106,경춘선,상천,275,285,560
202106,경춘선,가평,1601,1530,3131
202106,경춘선,굴봉산,130,119,249
202106,경춘선,백양리,79,61,140
202106,경춘선,강촌,416,421,837
202106,경춘선,김유정,241,261,502
202106,경춘선,남춘천,2303,2323,4626
202106,경춘선,춘천,1164,1125,2289
202106,경춘선,신내,1782,1802,3584
202106,경춘선,갈매,3247,2777,6024
202106,경춘선,별내,3020,2829,5849
202106,경춘선,퇴계원,3686,3399,7085
202106,경춘선,사릉,3552,3378,6930
202106,경춘선,금곡,1574,1476,3050
202106,경춘선,평내호평,6324,6127,12451
202106,경춘선,천마산,1711,1600,3311
202106,경춘선,마석,3920,3833,7753
202106,경춘선,대성리,546,432,978
202106,경춘선,청평,1480,1412,2892
202106,경춘선,상천,306,276,582
202106,경춘선,가평,1538,1542,3080
202106,경춘선,굴봉산,174,165,339
202106,경춘선,백양리,76,98,174
202106,경춘선,강촌,448,450,898
202106,경춘선,김유정,311,341,652
202106,경춘선,남춘천,2190,2347,4537
202106,경춘선,춘천,1299,1224,2523
202106,경춘선,춘천,1654,1407,3061
202106,경춘선,남춘천,2633,2510,5143
202106,경춘선,김유정,230,289,519
202106,경춘선,강촌,520,441,961
202106,경춘선,백양리,81,92,173
202106,경춘선,굴봉산,138,138,276
202106,경춘선,가평,1578,1518,3096
202106,경춘선,상천,304,282,586
202106,경춘선,청평,1522,1517,3039
202106,경춘선,대성리,534,451,985
202106,경춘선,마석,4071,3872,7943
202106,경춘선,천마산,1732,1607,3339
202106,경춘선,평내호평,6262,6341,12603
202106,경춘선,금곡,1564,1485,3049
202106,경춘선,사릉,3580,3473,7053
202106,경춘선,퇴계원,3753,3484,7237
202106,경춘선,별내,3123,2944,6067
202106,경춘선,갈매,3244,2771,6015
202106,경춘선,신내,1722,1780,3502
202106,경춘선,춘천,1353,1203,2556
202106,경춘선,남춘천,2536,2389,4925
202106,경춘선,김유정,228,262,490
202106,경춘선,강촌,388,410,798
202106,경춘선,백양리,66,78,144
202106,경춘선,굴봉산,106,101,207
202106,경춘선,가평,1405,1656,3061
202106,경춘선,상천,210,221,431
202106,경춘선,청평,1448,1600,3048
202106,경춘선,대성리,409,374,783
202106,경춘선,마석,3946,3941,7887
202106,경춘선,천마산,1721,1621,3342
202106,경춘선,평내호평,6201,6196,12397
202106,경춘선,금곡,1482,1453,2935
202106,경춘선,사릉,3422,3356,6778
202106,경춘선,퇴계원,3602,3382,6984
202106,경춘선,별내,3113,2952,6065
202106,경춘선,갈매,3195,2806,6001
202106,경춘선,신내,1616,1619,3235
202106,경춘선,남춘천,2109,2243,4352
202106,경춘선,춘천,1577,1523,3100
202106,경춘선,김유정,269,269,538
202106,경춘선,강촌,493,424,917
202106,경춘선,백양리,65,73,138
202106,경춘선,굴봉산,150,151,301
202106,경춘선,가평,1589,1616,3205
202106,경춘선,상천,299,294,593
202106,경춘선,청평,1711,1627,3338
202106,경춘선,대성리,528,466,994
202106,경춘선,마석,4038,3895,7933
202106,경춘선,천마산,1749,1599,3348
202106,경춘선,평내호평,6408,6194,12602
202106,경춘선,금곡,1550,1482,3032
202106,경춘선,사릉,3547,3423,6970
202106,경춘선,퇴계원,3595,3288,6883
202106,경춘선,별내,3011,2905,5916
202106,경춘선,갈매,3039,2695,5734
202106,경춘선,신내,1795,1701,3496
202106,경춘선,춘천,1620,1564,3184
202106,경춘선,남춘천,2025,2142,4167
202106,경춘선,김유정,273,287,560
202106,경춘선,강촌,476,416,892
202106,경춘선,백양리,59,58,117
202106,경춘선,굴봉산,128,153,281
202106,경춘선,가평,1524,1515,3039
202106,경춘선,상천,241,220,461
202106,경춘선,청평,1457,1391,2848
202106,경춘선,대성리,410,378,788
202106,경춘선,마석,3918,3853,7771
202106,경춘선,천마산,1655,1597,3252
202106,경춘선,평내호평,6131,6120,12251
202106,경춘선,금곡,1566,1549,3115
202106,경춘선,사릉,3587,3401,6988
202106,경춘선,퇴계원,3602,3366,6968
202106,경춘선,별내,3050,2880,5930
202106,경춘선,갈매,3108,2767,5875
202106,경춘선,신내,1710,1759,3469
202106,경춘선,신내,1744,1800,3544
202106,경춘선,갈매,3283,2863,6146
202106,경춘선,별내,3142,3042,6184
202106,경춘선,퇴계원,3763,3467,7230
202106,경춘선,사릉,3651,3480,7131
202106,경춘선,금곡,1591,1554,3145
202106,경춘선,평내호평,6404,6347,12751
202106,경춘선,천마산,1739,1636,3375
202106,경춘선,마석,4121,3996,8117
202106,경춘선,대성리,572,504,1076
202106,경춘선,청평,1683,1685,3368
202106,경춘선,상천,294,277,571
202106,경춘선,가평,1744,1779,3523
202106,경춘선,굴봉산,149,129,278
202106,경춘선,백양리,97,110,207
202106,경춘선,강촌,609,651,1260
202106,경춘선,김유정,291,320,611
202106,경춘선,남춘천,2342,2393,4735
202106,경춘선,춘천,1698,1502,3200
202106,경춘선,춘천,1475,1300,2775
202106,경춘선,남춘천,3209,3026,6235
202106,경춘선,김유정,317,357,674
202106,경춘선,강촌,541,507,1048
202106,경춘선,백양리,93,90,183
202106,경춘선,굴봉산,184,191,375
202106,경춘선,가평,1843,1907,3750
202106,경춘선,상천,308,275,583
202106,경춘선,청평,1656,1618,3274
202106,경춘선,대성리,559,472,1031
202106,경춘선,마석,4081,3896,7977
202106,경춘선,천마산,1672,1647,3319
202106,경춘선,평내호평,6471,6372,12843
202106,경춘선,금곡,1610,1598,3208
202106,경춘선,사릉,3586,3385,6971
202106,경춘선,퇴계원,3759,3481,7240
202106,경춘선,별내,3145,3001,6146
202106,경춘선,갈매,3216,2760,5976
202106,경춘선,신내,1747,1798,3545
202106,경춘선,신내,1589,1642,3231
202106,경춘선,갈매,3053,2685,5738
202106,경춘선,별내,3117,2998,6115
202106,경춘선,퇴계원,3547,3316,6863
202106,경춘선,사릉,3427,3290,6717
202106,경춘선,금곡,1515,1456,2971
202106,경춘선,평내호평,6109,6329,12438
202106,경춘선,천마산,1681,1508,3189
202106,경춘선,마석,3894,4007,7901
202106,경춘선,대성리,478,436,914
202106,경춘선,청평,1459,1631,3090
202106,경춘선,상천,214,220,434
202106,경춘선,가평,1655,1871,3526
202106,경춘선,굴봉산,92,87,179
202106,경춘선,백양리,54,79,133
202106,경춘선,강촌,413,471,884
202106,경춘선,김유정,230,254,484
202106,경춘선,춘천,1470,1265,2735
202106,경춘선,남춘천,2540,2583,5123
202106,경춘선,신내,1732,1723,3455
202106,경춘선,갈매,3190,2821,6011
202106,경춘선,별내,3197,3037,6234
202106,경춘선,퇴계원,3723,3434,7157
202106,경춘선,사릉,3519,3309,6828
202106,경춘선,금곡,1613,1546,3159
202106,경춘선,평내호평,6490,6241,12731
202106,경춘선,천마산,1768,1655,3423
202106,경춘선,마석,4166,4022,8188
202106,경춘선,대성리,540,524,1064
202106,경춘선,청평,1928,1833,3761
202106,경춘선,상천,307,280,587
202106,경춘선,가평,1834,2053,3887
202106,경춘선,굴봉산,143,145,288
202106,경춘선,백양리,72,72,144
202106,경춘선,강촌,402,400,802
202106,경춘선,김유정,300,323,623
202106,경춘선,남춘천,2205,2291,4496
202106,경춘선,춘천,1485,1324,2809
202106,경춘선,신내,1770,1802,3572
202106,경춘선,갈매,3282,2758,6040
202106,경춘선,별내,3166,3063,6229
202106,경춘선,퇴계원,3722,3396,7118
202106,경춘선,사릉,3488,3335,6823
202106,경춘선,금곡,1603,1543,3146
202106,경춘선,평내호평,6432,6261,12693
202106,경춘선,천마산,1663,1613,3276
202106,경춘선,마석,4034,3928,7962
202106,경춘선,대성리,565,519,1084
202106,경춘선,청평,1755,1682,3437
202106,경춘선,상천,297,273,570
202106,경춘선,가평,2079,2110,4189
202106,경춘선,굴봉산,151,143,294
202106,경춘선,백양리,81,77,158
202106,경춘선,강촌,370,397,767
202106,경춘선,김유정,326,340,666
202106,경춘선,남춘천,2644,2699,5343
202106,경춘선,춘천,1284,1201,2485
202106,경춘선,신내,1753,1742,3495
202106,경춘선,갈매,3203,2785,5988
202106,경춘선,별내,3081,2912,5993
202106,경춘선,퇴계원,3731,3474,7205
202106,경춘선,사릉,3405,3264,6669
202106,경춘선,금곡,1580,1499,3079
202106,경춘선,평내호평,6164,6132,12296
202106,경춘선,천마산,1685,1553,3238
202106,경춘선,마석,4213,4155,8368
202106,경춘선,대성리,575,556,1131
202106,경춘선,청평,1773,1670,3443
202106,경춘선,상천,283,245,528
202106,경춘선,가평,1998,1926,3924
202106,경춘선,굴봉산,175,152,327
202106,경춘선,백양리,86,107,193
202106,경춘선,강촌,378,387,765
202106,경춘선,김유정,326,361,687
202106,경춘선,남춘천,2068,2076,4144
202106,경춘선,춘천,1225,1166,2391
202106,경춘선,신내,1745,1725,3470
202106,경춘선,갈매,3250,2800,6050
202106,경춘선,별내,3192,3045,6237
202106,경춘선,퇴계원,3763,3464,7227
202106,경춘선,사릉,3442,3296,6738
202106,경춘선,금곡,1580,1524,3104
202106,경춘선,평내호평,6402,6189,12591
202106,경춘선,천마산,1728,1631,3359
202106,경춘선,마석,3934,3894,7828
202106,경춘선,대성리,631,595,1226
202106,경춘선,청평,1747,1722,3469
202106,경춘선,상천,302,278,580
202106,경춘선,가평,2112,2167,4279
202106,경춘선,굴봉산,146,156,302
202106,경춘선,백양리,95,103,198
202106,경춘선,강촌,395,423,818
202106,경춘선,김유정,333,351,684
202106,경춘선,남춘천,2231,2264,4495
202106,경춘선,춘천,1251,1139,2390
202106,경춘선,춘천,1584,1340,2924
202106,경춘선,남춘천,2638,2754,5392
202106,경춘선,김유정,348,430,778
202106,경춘선,강촌,387,449,836
202106,경춘선,백양리,116,110,226
202106,경춘선,굴봉산,140,146,286
202106,경춘선,가평,2337,2254,4591
202106,경춘선,상천,305,281,586
202106,경춘선,청평,1934,2001,3935
202106,경춘선,대성리,676,588,1264
202106,경춘선,마석,4202,4287,8489
202106,경춘선,천마산,1816,1726,3542
202106,경춘선,평내호평,6476,6543,13019
202106,경춘선,금곡,1660,1605,3265
202106,경춘선,사릉,3464,3405,6869
202106,경춘선,퇴계원,3837,3572,7409
202106,경춘선,별내,3272,3124,6396
202106,경춘선,갈매,3314,2863,6177
202106,경춘선,신내,1761,1749,3510
202106,경춘선,춘천,1234,1149,2383
202106,경춘선,남춘천,2118,2236,4354
202106,경춘선,김유정,296,286,582
202106,경춘선,강촌,362,410,772
202106,경춘선,백양리,91,53,144
202106,경춘선,굴봉산,144,131,275
202106,경춘선,가평,1863,2263,4126
202106,경춘선,상천,260,229,489
202106,경춘선,청평,1794,1802,3596
202106,경춘선,대성리,577,502,1079
202106,경춘선,마석,4241,4173,8414
202106,경춘선,천마산,1789,1655,3444
202106,경춘선,평내호평,6463,6075,12538
202106,경춘선,금곡,1577,1555,3132
202106,경춘선,사릉,3446,3242,6688
202106,경춘선,퇴계원,3605,3320,6925
202106,경춘선,별내,3051,2952,6003
202106,경춘선,갈매,3215,2811,6026
202106,경춘선,신내,1669,1692,3361
202106,경춘선,춘천,1228,1032,2260
202106,경춘선,남춘천,1951,2125,4076
202106,경춘선,김유정,320,365,685
202106,경춘선,강촌,480,423,903
202106,경춘선,백양리,80,93,173
202106,경춘선,굴봉산,161,160,321
202106,경춘선,가평,2309,2140,4449
202106,경춘선,상천,286,263,549
202106,경춘선,청평,1817,1679,3496
202106,경춘선,대성리,562,484,1046
202106,경춘선,마석,3924,3909,7833
202106,경춘선,천마산,1677,1668,3345
202106,경춘선,평내호평,6332,6105,12437
202106,경춘선,금곡,1561,1533,3094
202106,경춘선,사릉,3388,3289,6677
202106,경춘선,퇴계원,3703,3447,7150
202106,경춘선,별내,3090,2998,6088
202106,경춘선,갈매,3383,2943,6326
202106,경춘선,신내,1779,1665,3444
202106,경춘선,신내,1701,1728,3429
202106,경춘선,갈매,3342,2839,6181
202106,경춘선,별내,3139,3049,6188
202106,경춘선,퇴계원,3645,3347,6992
202106,경춘선,사릉,3406,3305,6711
202106,경춘선,금곡,1518,1497,3015
202106,경춘선,평내호평,6314,6168,12482
202106,경춘선,천마산,1756,1625,3381
202106,경춘선,마석,3959,3880,7839
202106,경춘선,대성리,619,467,1086
202106,경춘선,청평,1741,1700,3441
202106,경춘선,상천,261,243,504
202106,경춘선,가평,2218,2002,4220
202106,경춘선,굴봉산,114,104,218
202106,경춘선,백양리,106,89,195
202106,경춘선,강촌,426,388,814
202106,경춘선,김유정,288,307,595
202106,경춘선,남춘천,2095,2090,4185
202106,경춘선,춘천,1082,983,2065
202107,경춘선,춘천,1176,1044,2220
202107,경춘선,남춘천,2102,2120,4222
202107,경춘선,김유정,321,325,646
202107,경춘선,강촌,442,496,938
202107,경춘선,백양리,87,88,175
202107,경춘선,굴봉산,148,158,306
202107,경춘선,가평,1996,2139,4135
202107,경춘선,상천,287,277,564
202107,경춘선,청평,1814,1766,3580
202107,경춘선,대성리,541,488,1029
202107,경춘선,마석,3950,3826,7776
202107,경춘선,천마산,1673,1581,3254
202107,경춘선,평내호평,6423,6253,12676
202107,경춘선,금곡,1552,1584,3136
202107,경춘선,사릉,3448,3246,6694
202107,경춘선,퇴계원,3761,3474,7235
202107,경춘선,별내,3215,3041,6256
202107,경춘선,갈매,3306,2909,6215
202107,경춘선,신내,1817,1759,3576
202107,경춘선,춘천,1383,1329,2712
202107,경춘선,남춘천,2993,3047,6040
202107,경춘선,김유정,376,403,779
202107,경춘선,강촌,513,559,1072
202107,경춘선,백양리,95,111,206
202107,경춘선,굴봉산,149,159,308
202107,경춘선,가평,2336,2334,4670
202107,경춘선,상천,309,294,603
202107,경춘선,청평,1871,1992,3863
202107,경춘선,대성리,568,538,1106
202107,경춘선,마석,4095,4130,8225
202107,경춘선,천마산,1709,1608,3317
202107,경춘선,평내호평,6613,6601,13214
202107,경춘선,금곡,1671,1569,3240
202107,경춘선,사릉,3521,3388,6909
202107,경춘선,퇴계원,3791,3510,7301
202107,경춘선,별내,3323,3192,6515
202107,경춘선,갈매,3375,3031,6406
202107,경춘선,신내,1779,1828,3607
202107,경춘선,춘천,1247,1146,2393
202107,경춘선,남춘천,2088,2196,4284
202107,경춘선,김유정,321,309,630
202107,경춘선,강촌,410,452,862
202107,경춘선,백양리,75,90,165
202107,경춘선,굴봉산,132,130,262
202107,경춘선,가평,1910,2333,4243
202107,경춘선,상천,305,280,585
202107,경춘선,청평,1755,1818,3573
202107,경춘선,대성리,554,531,1085
202107,경춘선,마석,4117,3966,8083
202107,경춘선,천마산,1788,1672,3460
202107,경춘선,평내호평,6573,6323,12896
202107,경춘선,금곡,1597,1560,3157
202107,경춘선,사릉,3558,3320,6878
202107,경춘선,퇴계원,3796,3494,7290
202107,경춘선,별내,3198,3139,6337
202107,경춘선,갈매,3324,2892,6216
202107,경춘선,신내,1759,1698,3457
202107,경춘선,강촌,485,412,897
202107,경춘선,백양리,105,103,208
202107,경춘선,굴봉산,160,155,315
202107,경춘선,가평,2224,2062,4286
202107,경춘선,상천,283,291,574
202107,경춘선,청평,1865,1764,3629
202107,경춘선,대성리,587,449,1036
202107,경춘선,마석,3995,3949,7944
202107,경춘선,천마산,1764,1642,3406
202107,경춘선,평내호평,6309,6319,12628
202107,경춘선,금곡,1634,1552,3186
202107,경춘선,사릉,3554,3394,6948
202107,경춘선,퇴계원,3764,3493,7257
202107,경춘선,별내,3361,3159,6520
202107,경춘선,갈매,3295,2836,6131
202107,경춘선,신내,1759,1780,3539
202107,경춘선,남춘천,1993,2098,4091
202107,경춘선,춘천,1206,1066,2272
202107,경춘선,김유정,334,343,677
202107,경춘선,신내,1685,1675,3360
202107,경춘선,갈매,3153,2710,5863
202107,경춘선,별내,3089,3054,6143
202107,경춘선,퇴계원,3689,3424,7113
202107,경춘선,사릉,3336,3343,6679
202107,경춘선,금곡,1534,1506,3040
202107,경춘선,평내호평,6176,6055,12231
202107,경춘선,천마산,1688,1613,3301
202107,경춘선,마석,3919,3839,7758
202107,경춘선,대성리,553,495,1048
202107,경춘선,청평,1828,1663,3491
202107,경춘선,상천,263,249,512
202107,경춘선,가평,1968,1927,3895
202107,경춘선,굴봉산,138,124,262
202107,경춘선,백양리,91,75,166
202107,경춘선,강촌,448,444,892
202107,경춘선,김유정,250,278,528
202107,경춘선,남춘천,2323,2384,4707
202107,경춘선,춘천,1052,936,1988
202107,경춘선,신내,1652,1610,3262
202107,경춘선,갈매,3111,2670,5781
202107,경춘선,별내,2978,2855,5833
202107,경춘선,퇴계원,3530,3237,6767
202107,경춘선,사릉,3173,3077,6250
202107,경춘선,금곡,1530,1520,3050
202107,경춘선,평내호평,6061,5861,11922
202107,경춘선,천마산,1572,1494,3066
202107,경춘선,마석,3861,3894,7755
202107,경춘선,대성리,490,420,910
202107,경춘선,청평,1557,1533,3090
202107,경춘선,상천,217,209,426
202107,경춘선,가평,1822,1865,3687
202107,경춘선,굴봉산,100,99,199
202107,경춘선,백양리,68,66,134
202107,경춘선,강촌,410,372,782
202107,경춘선,김유정,233,244,477
202107,경춘선,남춘천,1758,1850,3608
202107,경춘선,춘천,960,858,1818
202107,경춘선,신내,1624,1618,3242
202107,경춘선,갈매,3117,2690,5807
202107,경춘선,별내,3111,3025,6136
202107,경춘선,퇴계원,3537,3361,6898
202107,경춘선,사릉,3259,3202,6461
202107,경춘선,금곡,1491,1455,2946
202107,경춘선,평내호평,6031,6118,12149
202107,경춘선,천마산,1621,1524,3145
202107,경춘선,마석,3723,3764,7487
202107,경춘선,대성리,553,524,1077
202107,경춘선,청평,1700,1771,3471
202107,경춘선,상천,244,238,482
202107,경춘선,가평,1910,1987,3897
202107,경춘선,굴봉산,142,128,270
202107,경춘선,백양리,90,75,165
202107,경춘선,강촌,407,419,826
202107,경춘선,김유정,257,313,570
202107,경춘선,남춘천,2228,2307,4535
202107,경춘선,춘천,1190,1062,2252
202107,경춘선,신내,1512,1414,2926
202107,경춘선,갈매,2724,2394,5118
202107,경춘선,별내,2831,2718,5549
202107,경춘선,퇴계원,3340,3075,6415
202107,경춘선,사릉,3078,2965,6043
202107,경춘선,금곡,1354,1289,2643
202107,경춘선,평내호평,5646,5509,11155
202107,경춘선,천마산,1590,1465,3055
202107,경춘선,마석,3365,3425,6790
202107,경춘선,대성리,473,432,905
202107,경춘선,청평,1566,1448,3014
202107,경춘선,상천,240,219,459
202107,경춘선,가평,1818,1761,3579
202107,경춘선,굴봉산,140,135,275
202107,경춘선,백양리,66,56,122
202107,경춘선,강촌,344,359,703
202107,경춘선,김유정,234,251,485
202107,경춘선,남춘천,2160,2193,4353
202107,경춘선,춘천,1003,985,1988
202107,경춘선,춘천,1028,937,1965
202107,경춘선,남춘천,1776,1873,3649
202107,경춘선,김유정,268,290,558
202107,경춘선,강촌,393,420,813
202107,경춘선,백양리,116,96,212
202107,경춘선,굴봉산,129,120,249
202107,경춘선,가평,1578,1590,3168
202107,경춘선,상천,279,260,539
202107,경춘선,청평,1453,1351,2804
202107,경춘선,대성리,455,422,877
202107,경춘선,마석,3529,3618,7147
202107,경춘선,천마산,1570,1439,3009
202107,경춘선,평내호평,5511,5408,10919
202107,경춘선,금곡,1368,1297,2665
202107,경춘선,사릉,3029,2878,5907
202107,경춘선,퇴계원,3277,3057,6334
202107,경춘선,별내,2876,2811,5687
202107,경춘선,갈매,2782,2436,5218
202107,경춘선,신내,1498,1474,2972
202107,경춘선,춘천,1020,913,1933
202107,경춘선,남춘천,1791,1877,3668
202107,경춘선,김유정,305,312,617
202107,경춘선,강촌,407,427,834
202107,경춘선,백양리,113,112,225
202107,경춘선,굴봉산,147,124,271
202107,경춘선,가평,1578,1520,3098
202107,경춘선,상천,265,242,507
202107,경춘선,청평,1326,1350,2676
202107,경춘선,대성리,446,369,815
202107,경춘선,마석,3253,3201,6454
202107,경춘선,천마산,1511,1443,2954
202107,경춘선,평내호평,5290,5247,10537
202107,경춘선,금곡,1280,1281,2561
202107,경춘선,사릉,2933,2869,5802
202107,경춘선,퇴계원,3230,2924,6154
202107,경춘선,별내,2734,2668,5402
202107,경춘선,갈매,2646,2327,4973
202107,경춘선,신내,1414,1437,2851
202107,경춘선,춘천,1032,991,2023
202107,경춘선,남춘천,1823,1829,3652
202107,경춘선,김유정,245,286,531
202107,경춘선,강촌,423,392,815
202107,경춘선,백양리,122,133,255
202107,경춘선,굴봉산,123,125,248
202107,경춘선,가평,1461,1508,2969
202107,경춘선,상천,252,236,488
202107,경춘선,청평,1316,1249,2565
202107,경춘선,대성리,466,398,864
202107,경춘선,마석,3192,3161,6353
202107,경춘선,천마산,1468,1301,2769
202107,경춘선,평내호평,5057,5074,10131
202107,경춘선,금곡,1273,1189,2462
202107,경춘선,사릉,2798,2704,5502
202107,경춘선,퇴계원,3058,2793,5851
202107,경춘선,별내,2660,2530,5190
202107,경춘선,갈매,2609,2211,4820
202107,경춘선,신내,1390,1349,2739
202107,경춘선,춘천,1166,1067,2233
202107,경춘선,남춘천,2020,2256,4276
202107,경춘선,김유정,249,298,547
202107,경춘선,강촌,402,501,903
202107,경춘선,백양리,109,112,221
202107,경춘선,굴봉산,152,149,301
202107,경춘선,가평,1495,1598,3093
202107,경춘선,상천,230,227,457
202107,경춘선,청평,1343,1398,2741
202107,경춘선,대성리,435,431,866
202107,경춘선,마석,3289,3296,6585
202107,경춘선,천마산,1475,1362,2837
202107,경춘선,평내호평,5308,5416,10724
202107,경춘선,금곡,1274,1228,2502
202107,경춘선,사릉,2903,2835,5738
202107,경춘선,퇴계원,3221,2967,6188
202107,경춘선,별내,2744,2716,5460
202107,경춘선,갈매,2659,2455,5114
202107,경춘선,신내,1417,1335,2752
202107,경춘선,신내,1403,1321,2724
202107,경춘선,갈매,2671,2369,5040
202107,경춘선,별내,2708,2620,5328
202107,경춘선,퇴계원,3283,3042,6325
202107,경춘선,사릉,3032,2914,5946
202107,경춘선,금곡,1264,1252,2516
202107,경춘선,평내호평,5449,5207,10656
202107,경춘선,천마산,1535,1440,2975
202107,경춘선,마석,3417,3434,6851
202107,경춘선,대성리,439,404,843
202107,경춘선,청평,1352,1266,2618
202107,경춘선,상천,255,231,486
202107,경춘선,가평,1534,1516,3050
202107,경춘선,굴봉산,158,137,295
202107,경춘선,백양리,108,101,209
202107,경춘선,강촌,414,439,853
202107,경춘선,김유정,277,255,532
202107,경춘선,남춘천,1906,1964,3870
202107,경춘선,춘천,1058,975,2033
202107,경춘선,신내,1494,1517,3011
202107,경춘선,갈매,2756,2466,5222
202107,경춘선,별내,2686,2661,5347
202107,경춘선,퇴계원,3229,2968,6197
202107,경춘선,사릉,2895,2874,5769
202107,경춘선,금곡,1367,1303,2670
202107,경춘선,평내호평,5492,5396,10888
202107,경춘선,천마산,1546,1436,2982
202107,경춘선,마석,3357,3338,6695
202107,경춘선,대성리,449,409,858
202107,경춘선,청평,1357,1352,2709
202107,경춘선,상천,230,221,451
202107,경춘선,가평,1548,1574,3122
202107,경춘선,굴봉산,135,129,264
202107,경춘선,백양리,151,105,256
202107,경춘선,강촌,469,408,877
202107,경춘선,김유정,298,313,611
202107,경춘선,남춘천,1906,1969,3875
202107,경춘선,춘천,1122,1005,2127
202107,경춘선,춘천,1165,1118,2283
202107,경춘선,남춘천,1911,1977,3888
202107,경춘선,김유정,289,301,590
202107,경춘선,강촌,449,464,913
202107,경춘선,백양리,135,139,274
202107,경춘선,굴봉산,152,147,299
202107,경춘선,가평,1554,1578,3132
202107,경춘선,상천,236,236,472
202107,경춘선,청평,1257,1261,2518
202107,경춘선,대성리,441,366,807
202107,경춘선,마석,3266,3214,6480
202107,경춘선,천마산,1462,1356,2818
202107,경춘선,평내호평,5244,5276,10520
202107,경춘선,금곡,1256,1241,2497
202107,경춘선,사릉,2867,2705,5572
202107,경춘선,퇴계원,3174,3017,6191
202107,경춘선,별내,2667,2606,5273
202107,경춘선,갈매,2631,2339,4970
202107,경춘선,신내,1394,1440,2834
202107,경춘선,춘천,1100,1019,2119
202107,경춘선,남춘천,2273,2363,4636
202107,경춘선,김유정,270,284,554
202107,경춘선,강촌,458,444,902
202107,경춘선,백양리,116,122,238
202107,경춘선,굴봉산,128,129,257
202107,경춘선,가평,1553,1662,3215
202107,경춘선,상천,227,210,437
202107,경춘선,청평,1291,1278,2569
202107,경춘선,대성리,439,384,823
202107,경춘선,마석,3198,3145,6343
202107,경춘선,천마산,1428,1350,2778
202107,경춘선,평내호평,5209,5203,10412
202107,경춘선,금곡,1278,1228,2506
202107,경춘선,사릉,2835,2734,5569
202107,경춘선,퇴계원,3118,2907,6025
202107,경춘선,별내,2681,2549,5230
202107,경춘선,갈매,2600,2276,4876
202107,경춘선,신내,1391,1367,2758
202107,경춘선,신내,1408,1359,2767
202107,경춘선,갈매,2723,2386,5109
202107,경춘선,별내,2696,2617,5313
202107,경춘선,퇴계원,3208,3039,6247
202107,경춘선,사릉,2898,2783,5681
202107,경춘선,금곡,1265,1236,2501
202107,경춘선,평내호평,5263,5224,10487
202107,경춘선,천마산,1505,1438,2943
202107,경춘선,마석,3384,3389,6773
202107,경춘선,대성리,459,432,891
202107,경춘선,청평,1372,1427,2799
202107,경춘선,상천,261,248,509
202107,경춘선,가평,1599,1668,3267
202107,경춘선,굴봉산,168,169,337
202107,경춘선,백양리,158,148,306
202107,경춘선,강촌,465,449,914
202107,경춘선,김유정,266,277,543
202107,경춘선,남춘천,2040,2265,4305
202107,경춘선,춘천,1265,1184,2449
202107,경춘선,춘천,1208,1117,2325
202107,경춘선,남춘천,1969,2076,4045
202107,경춘선,김유정,273,247,520
202107,경춘선,강촌,432,420,852
202107,경춘선,백양리,191,155,346
202107,경춘선,굴봉산,166,162,328
202107,경춘선,가평,1605,1607,3212
202107,경춘선,상천,228,215,443
202107,경춘선,청평,1269,1232,2501
202107,경춘선,대성리,419,337,756
202107,경춘선,마석,3257,3169,6426
202107,경춘선,천마산,1417,1339,2756
202107,경춘선,평내호평,5199,5075,10274
202107,경춘선,금곡,1238,1138,2376
202107,경춘선,사릉,2789,2709,5498
202107,경춘선,퇴계원,3070,2890,5960
202107,경춘선,별내,2636,2551,5187
202107,경춘선,갈매,2528,2243,4771
202107,경춘선,신내,1396,1394,2790
202107,경춘선,춘천,1233,1139,2372
202107,경춘선,남춘천,2389,2442,4831
202107,경춘선,김유정,231,276,507
202107,경춘선,강촌,428,447,875
202107,경춘선,백양리,161,138,299
202107,경춘선,굴봉산,166,163,329
202107,경춘선,가평,1576,1586,3162
202107,경춘선,상천,224,229,453
202107,경춘선,청평,1309,1268,2577
202107,경춘선,대성리,398,384,782
202107,경춘선,마석,3116,3120,6236
202107,경춘선,천마산,1445,1338,2783
202107,경춘선,평내호평,5142,5056,10198
202107,경춘선,금곡,1247,1221,2468
202107,경춘선,사릉,2735,2664,5399
202107,경춘선,퇴계원,3107,2914,6021
202107,경춘선,별내,2574,2544,5118
202107,경춘선,갈매,2568,2269,4837
202107,경춘선,신내,1432,1391,2823
202107,경춘선,신내,1400,1357,2757
202107,경춘선,갈매,2509,2151,4660
202107,경춘선,별내,2470,2439,4909
202107,경춘선,퇴계원,3102,2843,5945
202107,경춘선,사릉,2774,2609,5383
202107,경춘선,금곡,1322,1276,2598
202107,경춘선,평내호평,5121,5006,10127
202107,경춘선,천마산,1411,1280,2691
202107,경춘선,마석,3237,3251,6488
202107,경춘선,대성리,426,382,808
202107,경춘선,청평,1258,1239,2497
202107,경춘선,상천,251,241,492
202107,경춘선,가평,1579,1637,3216
202107,경춘선,백양리,136,135,271
202107,경춘선,강촌,511,501,1012
202107,경춘선,김유정,246,248,494
202107,경춘선,남춘천,1924,2114,4038
202107,경춘선,춘천,1213,1097,2310
202107,경춘선,굴봉산,160,160,320
202107,경춘선,신내,1358,1355,2713
202107,경춘선,갈매,2421,2146,4567
202107,경춘선,별내,2578,2467,5045
202107,경춘선,퇴계원,3012,2827,5839
202107,경춘선,사릉,2686,2600,5286
202107,경춘선,금곡,1235,1205,2440
202107,경춘선,평내호평,5054,4949,10003
202107,경춘선,천마산,1406,1349,2755
202107,경춘선,마석,3126,3102,6228
202107,경춘선,대성리,434,393,827
202107,경춘선,청평,1311,1304,2615
202107,경춘선,상천,248,241,489
202107,경춘선,가평,1693,1737,3430
202107,경춘선,굴봉산,158,150,308
202107,경춘선,백양리,165,158,323
202107,경춘선,강촌,513,487,1000
202107,경춘선,김유정,290,309,599
202107,경춘선,남춘천,2066,2170,4236
202107,경춘선,춘천,1139,1048,2187
202107,경춘선,춘천,1401,1315,2716
202107,경춘선,남춘천,2153,2385,4538
202107,경춘선,김유정,234,276,510
202107,경춘선,강촌,571,634,1205
202107,경춘선,백양리,124,123,247
202107,경춘선,굴봉산,159,150,309
202107,경춘선,가평,1859,1895,3754
202107,경춘선,상천,261,251,512
202107,경춘선,청평,1393,1445,2838
202107,경춘선,대성리,477,425,902
202107,경춘선,마석,3220,3294,6514
202107,경춘선,천마산,1443,1364,2807
202107,경춘선,평내호평,5084,5082,10166
202107,경춘선,금곡,1228,1169,2397
202107,경춘선,사릉,2734,2629,5363
202107,경춘선,퇴계원,3061,2854,5915
202107,경춘선,별내,2556,2527,5083
202107,경춘선,갈매,2492,2254,4746
202107,경춘선,신내,1413,1325,2738
202108,경춘선,춘천,1237,1083,2320
202108,경춘선,남춘천,2245,2300,4545
202108,경춘선,김유정,284,276,560
202108,경춘선,강촌,371,425,796
202108,경춘선,백양리,111,85,196
202108,경춘선,굴봉산,142,138,280
202108,경춘선,가평,1592,1654,3246
202108,경춘선,상천,214,177,391
202108,경춘선,청평,1385,1288,2673
202108,경춘선,대성리,426,357,783
202108,경춘선,마석,3062,3072,6134
202108,경춘선,천마산,1427,1332,2759
202108,경춘선,평내호평,4905,4801,9706
202108,경춘선,금곡,1206,1128,2334
202108,경춘선,사릉,2599,2538,5137
202108,경춘선,퇴계원,3016,2834,5850
202108,경춘선,별내,2548,2474,5022
202108,경춘선,갈매,2352,2062,4414
202108,경춘선,신내,1352,1295,2647
202108,경춘선,신내,1299,1283,2582
202108,경춘선,갈매,2407,2123,4530
202108,경춘선,별내,2568,2500,5068
202108,경춘선,퇴계원,2928,2811,5739
202108,경춘선,사릉,2555,2528,5083
202108,경춘선,금곡,1325,1254,2579
202108,경춘선,평내호평,5074,4914,9988
202108,경춘선,천마산,1396,1344,2740
202108,경춘선,마석,3216,3254,6470
202108,경춘선,대성리,462,413,875
202108,경춘선,청평,1335,1351,2686
202108,경춘선,상천,223,233,456
202108,경춘선,가평,1802,1743,3545
202108,경춘선,굴봉산,167,136,303
202108,경춘선,백양리,111,108,219
202108,경춘선,강촌,548,551,1099
202108,경춘선,김유정,280,329,609
202108,경춘선,남춘천,2066,2050,4116
202108,경춘선,춘천,1264,1138,2402
202108,경춘선,상천,244,222,466
202108,경춘선,가평,1850,1838,3688
202108,경춘선,굴봉산,152,134,286
202108,경춘선,백양리,116,107,223
202108,경춘선,강촌,526,480,1006
202108,경춘선,김유정,289,307,596
202108,경춘선,남춘천,1895,1952,3847
202108,경춘선,춘천,1229,1124,2353
202108,경춘선,신내,1321,1330,2651
202108,경춘선,갈매,2434,2186,4620
202108,경춘선,별내,2570,2533,5103
202108,경춘선,퇴계원,2991,2771,5762
202108,경춘선,사릉,2668,2584,5252
202108,경춘선,금곡,1228,1187,2415
202108,경춘선,평내호평,5096,4970,10066
202108,경춘선,천마산,1340,1291,2631
202108,경춘선,마석,3094,3102,6196
202108,경춘선,대성리,497,433,930
202108,경춘선,청평,1375,1383,2758
202108,경춘선,신내,1391,1399,2790
202108,경춘선,갈매,2459,2238,4697
202108,경춘선,별내,2677,2545,5222
202108,경춘선,퇴계원,3051,2888,5939
202108,경춘선,사릉,2687,2741,5428
202108,경춘선,금곡,1265,1158,2423
202108,경춘선,평내호평,5059,4948,10007
202108,경춘선,천마산,1370,1258,2628
202108,경춘선,마석,3205,3183,6388
202108,경춘선,대성리,456,421,877
202108,경춘선,청평,1393,1385,2778
202108,경춘선,상천,246,231,477
202108,경춘선,가평,1833,1821,3654
202108,경춘선,굴봉산,153,134,287
202108,경춘선,백양리,157,119,276
202108,경춘선,강촌,506,489,995
202108,경춘선,김유정,260,322,582
202108,경춘선,남춘천,2001,2166,4167
202108,경춘선,춘천,1336,1173,2509
202108,경춘선,춘천,1392,1328,2720
202108,경춘선,남춘천,2149,2344,4493
202108,경춘선,김유정,292,349,641
202108,경춘선,강촌,567,567,1134
202108,경춘선,백양리,164,141,305
202108,경춘선,굴봉산,156,157,313
202108,경춘선,가평,1747,1897,3644
202108,경춘선,상천,240,227,467
202108,경춘선,청평,1364,1456,2820
202108,경춘선,대성리,459,433,892
202108,경춘선,마석,3214,3320,6534
202108,경춘선,천마산,1454,1357,2811
202108,경춘선,평내호평,5179,5190,10369
202108,경춘선,금곡,1290,1225,2515
202108,경춘선,사릉,2771,2773,5544
202108,경춘선,퇴계원,3100,2868,5968
202108,경춘선,별내,2665,2643,5308
202108,경춘선,갈매,2526,2202,4728
202108,경춘선,신내,1448,1361,2809
202108,경춘선,춘천,1162,1111,2273
202108,경춘선,남춘천,2085,2070,4155
202108,경춘선,김유정,278,275,553
202108,경춘선,강촌,487,456,943
202108,경춘선,백양리,138,126,264
202108,경춘선,굴봉산,148,116,264
202108,경춘선,가평,1788,1870,3658
202108,경춘선,상천,264,246,510
202108,경춘선,청평,1407,1394,2801
202108,경춘선,대성리,464,413,877
202108,경춘선,마석,3472,3486,6958
202108,경춘선,천마산,1544,1425,2969
202108,경춘선,평내호평,5474,5279,10753
202108,경춘선,금곡,1331,1233,2564
202108,경춘선,사릉,2865,2800,5665
202108,경춘선,퇴계원,3175,2962,6137
202108,경춘선,별내,2750,2612,5362
202108,경춘선,갈매,2573,2325,4898
202108,경춘선,신내,1402,1327,2729
202108,경춘선,춘천,1195,1062,2257
202108,경춘선,남춘천,1867,1993,3860
202108,경춘선,김유정,285,289,574
202108,경춘선,강촌,467,471,938
202108,경춘선,백양리,116,100,216
202108,경춘선,굴봉산,128,123,251
202108,경춘선,가평,1876,1749,3625
202108,경춘선,상천,267,238,505
202108,경춘선,청평,1335,1347,2682
202108,경춘선,대성리,449,393,842
202108,경춘선,마석,3302,3288,6590
202108,경춘선,천마산,1461,1402,2863
202108,경춘선,평내호평,5441,5244,10685
202108,경춘선,금곡,1312,1241,2553
202108,경춘선,사릉,2849,2767,5616
202108,경춘선,퇴계원,3165,3031,6196
202108,경춘선,별내,2744,2657,5401
202108,경춘선,갈매,2556,2268,4824
202108,경춘선,신내,1496,1468,2964
202108,경춘선,신내,1471,1443,2914
202108,경춘선,갈매,2643,2336,4979
202108,경춘선,별내,2750,2680,5430
202108,경춘선,퇴계원,3231,3026,6257
202108,경춘선,사릉,2849,2767,5616
202108,경춘선,금곡,1271,1245,2516
202108,경춘선,평내호평,5361,5275,10636
202108,경춘선,천마산,1469,1449,2918
202108,경춘선,마석,3461,3382,6843
202108,경춘선,대성리,515,446,961
202108,경춘선,청평,1409,1420,2829
202108,경춘선,상천,262,253,515
202108,경춘선,가평,1853,1990,3843
202108,경춘선,굴봉산,162,129,291
202108,경춘선,백양리,121,108,229
202108,경춘선,강촌,486,495,981
202108,경춘선,김유정,283,302,585
202108,경춘선,남춘천,1851,1976,3827
202108,경춘선,춘천,1140,992,2132
202108,경춘선,춘천,1212,1115,2327
202108,경춘선,남춘천,2367,2455,4822
202108,경춘선,김유정,325,340,665
202108,경춘선,강촌,483,544,1027
202108,경춘선,백양리,137,113,250
202108,경춘선,굴봉산,145,133,278
202108,경춘선,가평,1985,1990,3975
202108,경춘선,상천,253,243,496
202108,경춘선,청평,1504,1462,2966
202108,경춘선,대성리,457,404,861
202108,경춘선,마석,3432,3458,6890
202108,경춘선,천마산,1508,1379,2887
202108,경춘선,평내호평,5367,5296,10663
202108,경춘선,금곡,1332,1275,2607
202108,경춘선,사릉,2792,2792,5584
202108,경춘선,퇴계원,3123,2883,6006
202108,경춘선,별내,2694,2636,5330
202108,경춘선,갈매,2635,2343,4978
202108,경춘선,신내,1520,1429,2949
202108,경춘선,신내,1461,1395,2856
202108,경춘선,갈매,2602,2347,4949
202108,경춘선,별내,2843,2784,5627
202108,경춘선,퇴계원,3272,3004,6276
202108,경춘선,사릉,2868,2820,5688
202108,경춘선,금곡,1319,1311,2630
202108,경춘선,평내호평,5490,5555,11045
202108,경춘선,천마산,1547,1405,2952
202108,경춘선,마석,3533,3567,7100
202108,경춘선,대성리,463,458,921
202108,경춘선,청평,1481,1535,3016
202108,경춘선,상천,253,228,481
202108,경춘선,가평,1861,1989,3850
202108,경춘선,굴봉산,168,152,320
202108,경춘선,백양리,140,127,267
202108,경춘선,강촌,567,555,1122
202108,경춘선,김유정,316,377,693
202108,경춘선,남춘천,2125,2322,4447
202108,경춘선,춘천,1268,1318,2586
202108,경춘선,신내,955,930,1885
202108,경춘선,갈매,1572,1450,3022
202108,경춘선,별내,1844,1831,3675
202108,경춘선,퇴계원,2326,2298,4624
202108,경춘선,사릉,2049,2003,4052
202108,경춘선,금곡,979,892,1871
202108,경춘선,평내호평,3936,3851,7787
202108,경춘선,천마산,1260,1201,2461
202108,경춘선,마석,2850,2812,5662
202108,경춘선,대성리,586,450,1036
202108,경춘선,청평,1714,1378,3092
202108,경춘선,상천,317,247,564
202108,경춘선,가평,2597,2278,4875
202108,경춘선,굴봉산,208,148,356
202108,경춘선,백양리,163,131,294
202108,경춘선,강촌,777,683,1460
202108,경춘선,김유정,480,414,894
202108,경춘선,남춘천,2553,2397,4950
202108,경춘선,춘천,2005,1409,3414
202108,경춘선,신내,1601,1566,3167
202108,경춘선,갈매,2774,2453,5227
202108,경춘선,별내,2843,2690,5533
202108,경춘선,퇴계원,3289,3075,6364
202108,경춘선,사릉,2972,2904,5876
202108,경춘선,금곡,1410,1379,2789
202108,경춘선,평내호평,5690,5547,11237
202108,경춘선,천마산,1608,1562,3170
202108,경춘선,마석,3591,3588,7179
202108,경춘선,대성리,474,424,898
202108,경춘선,청평,1555,1440,2995
202108,경춘선,상천,233,205,438
202108,경춘선,가평,1920,1807,3727
202108,경춘선,굴봉산,151,139,290
202108,경춘선,백양리,120,77,197
202108,경춘선,강촌,576,533,1109
202108,경춘선,김유정,352,337,689
202108,경춘선,남춘천,2474,2530,5004
202108,경춘선,춘천,1153,1042,2195
202108,경춘선,춘천,1049,1003,2052
202108,경춘선,남춘천,1867,1935,3802
202108,경춘선,김유정,268,299,567
202108,경춘선,강촌,462,434,896
202108,경춘선,백양리,106,110,216
202108,경춘선,굴봉산,136,115,251
202108,경춘선,가평,1741,1709,3450
202108,경춘선,상천,241,221,462
202108,경춘선,청평,1430,1398,2828
202108,경춘선,대성리,474,448,922
202108,경춘선,마석,3397,3483,6880
202108,경춘선,천마산,1493,1426,2919
202108,경춘선,평내호평,5483,5338,10821
202108,경춘선,금곡,1311,1288,2599
202108,경춘선,사릉,2896,2786,5682
202108,경춘선,퇴계원,3259,3079,6338
202108,경춘선,별내,2808,2722,5530
202108,경춘선,갈매,2817,2437,5254
202108,경춘선,신내,1649,1567,3216
202108,경춘선,신내,1558,1515,3073
202108,경춘선,갈매,2879,2591,5470
202108,경춘선,별내,2857,2718,5575
202108,경춘선,퇴계원,3299,3115,6414
202108,경춘선,사릉,3068,2953,6021
202108,경춘선,금곡,1379,1388,2767
202108,경춘선,평내호평,5720,5589,11309
202108,경춘선,천마산,1571,1476,3047
202108,경춘선,마석,3580,3566,7146
202108,경춘선,대성리,489,446,935
202108,경춘선,청평,1439,1426,2865
202108,경춘선,상천,263,235,498
202108,경춘선,가평,1712,1817,3529
202108,경춘선,굴봉산,171,129,300
202108,경춘선,백양리,118,101,219
202108,경춘선,강촌,524,546,1070
202108,경춘선,김유정,322,384,706
202108,경춘선,남춘천,1996,2021,4017
202108,경춘선,춘천,1240,1139,2379
202108,경춘선,신내,1604,1613,3217
202108,경춘선,갈매,2905,2571,5476
202108,경춘선,별내,2898,2865,5763
202108,경춘선,퇴계원,3385,3244,6629
202108,경춘선,사릉,3085,3004,6089
202108,경춘선,금곡,1297,1338,2635
202108,경춘선,평내호평,5788,5755,11543
202108,경춘선,천마산,1535,1505,3040
202108,경춘선,마석,3618,3698,7316
202108,경춘선,대성리,478,430,908
202108,경춘선,청평,1544,1586,3130
202108,경춘선,상천,254,245,499
202108,경춘선,가평,1887,1957,3844
202108,경춘선,굴봉산,211,168,379
202108,경춘선,백양리,106,106,212
202108,경춘선,강촌,549,556,1105
202108,경춘선,김유정,324,328,652
202108,경춘선,남춘천,2158,2433,4591
202108,경춘선,춘천,1263,1179,2442
202108,경춘선,신내,1615,1531,3146
202108,경춘선,갈매,2767,2453,5220
202108,경춘선,별내,2778,2689,5467
202108,경춘선,퇴계원,3253,3042,6295
202108,경춘선,사릉,2990,2915,5905
202108,경춘선,금곡,1389,1303,2692
202108,경춘선,평내호평,5597,5499,11096
202108,경춘선,천마산,1535,1453,2988
202108,경춘선,마석,3601,3537,7138
202108,경춘선,대성리,423,342,765
202108,경춘선,청평,1379,1278,2657
202108,경춘선,상천,225,211,436
202108,경춘선,가평,1659,1681,3340
202108,경춘선,굴봉산,129,113,242
202108,경춘선,백양리,113,83,196
202108,경춘선,강촌,415,441,856
202108,경춘선,김유정,272,267,539
202108,경춘선,남춘천,1968,2078,4046
202108,경춘선,춘천,1110,1023,2133
202108,경춘선,춘천,958,905,1863
202108,경춘선,남춘천,1832,1892,3724
202108,경춘선,김유정,199,219,418
202108,경춘선,강촌,455,418,873
202108,경춘선,백양리,97,73,170
202108,경춘선,굴봉산,96,75,171
202108,경춘선,가평,1547,1553,3100
202108,경춘선,상천,166,161,327
202108,경춘선,청평,1387,1278,2665
202108,경춘선,대성리,379,322,701
202108,경춘선,마석,3307,3302,6609
202108,경춘선,천마산,1470,1360,2830
202108,경춘선,평내호평,5266,5218,10484
202108,경춘선,금곡,1297,1265,2562
202108,경춘선,사릉,2953,2856,5809
202108,경춘선,퇴계원,3148,2934,6082
202108,경춘선,별내,2682,2627,5309
202108,경춘선,갈매,2680,2381,5061
202108,경춘선,신내,1519,1465,2984
202108,경춘선,춘천,1043,988,2031
202108,경춘선,남춘천,1881,1859,3740
202108,경춘선,김유정,279,295,574
202108,경춘선,강촌,445,491,936
202108,경춘선,백양리,102,75,177
202108,경춘선,굴봉산,111,110,221
202108,경춘선,가평,1575,1627,3202
202108,경춘선,상천,226,235,461
202108,경춘선,청평,1389,1353,2742
202108,경춘선,대성리,442,411,853
202108,경춘선,마석,3511,3456,6967
202108,경춘선,천마산,1595,1524,3119
202108,경춘선,평내호평,5672,5544,11216
202108,경춘선,금곡,1385,1342,2727
202108,경춘선,사릉,3096,3019,6115
202108,경춘선,퇴계원,3315,3068,6383
202108,경춘선,별내,2749,2644,5393
202108,경춘선,갈매,2837,2481,5318
202108,경춘선,신내,1654,1609,3263
202108,경춘선,신내,1713,1655,3368
202108,경춘선,갈매,2889,2454,5343
202108,경춘선,별내,2848,2767,5615
202108,경춘선,퇴계원,3350,3167,6517
202108,경춘선,사릉,3083,3061,6144
202108,경춘선,금곡,1397,1372,2769
202108,경춘선,평내호평,5744,5634,11378
202108,경춘선,천마산,1638,1525,3163
202108,경춘선,마석,3745,3653,7398
202108,경춘선,대성리,537,472,1009
202108,경춘선,청평,1504,1545,3049
202108,경춘선,상천,302,267,569
202108,경춘선,가평,1725,1813,3538
202108,경춘선,굴봉산,131,135,266
202108,경춘선,백양리,111,105,216
202108,경춘선,강촌,536,537,1073
202108,경춘선,김유정,281,353,634
202108,경춘선,남춘천,2139,2234,4373
202108,경춘선,춘천,1159,1055,2214
202108,경춘선,신내,1629,1592,3221
202108,경춘선,갈매,2834,2520,5354
202108,경춘선,별내,2830,2841,5671
202108,경춘선,퇴계원,3392,3178,6570
202108,경춘선,사릉,3031,3046,6077
202108,경춘선,금곡,1375,1347,2722
202108,경춘선,평내호평,5674,5578,11252
202108,경춘선,천마산,1578,1457,3035
202108,경춘선,마석,3593,3600,7193
202108,경춘선,대성리,402,386,788
202108,경춘선,청평,1504,1551,3055
202108,경춘선,상천,246,223,469
202108,경춘선,가평,1714,1712,3426
202108,경춘선,굴봉산,129,118,247
202108,경춘선,백양리,86,82,168
202108,경춘선,강촌,455,405,860
202108,경춘선,김유정,290,324,614
202108,경춘선,남춘천,2528,2807,5335
202108,경춘선,춘천,1138,1046,2184
202108,경춘선,평내호평,6053,5876,11929
202108,경춘선,신내,1769,1670,3439
202108,경춘선,갈매,2977,2656,5633
202108,경춘선,별내,2970,2878,5848
202108,경춘선,퇴계원,3544,3298,6842
202108,경춘선,사릉,3300,3191,6491
202108,경춘선,금곡,1498,1474,2972
202108,경춘선,천마산,1696,1588,3284
202108,경춘선,마석,3850,3792,7642
202108,경춘선,대성리,509,416,925
202108,경춘선,청평,1596,1535,3131
202108,경춘선,상천,295,258,553
202108,경춘선,가평,1789,1707,3496
202108,경춘선,굴봉산,108,113,221
202108,경춘선,백양리,94,103,197
202108,경춘선,강촌,534,550,1084
202108,경춘선,김유정,316,339,655
202108,경춘선,남춘천,2211,2246,4457
202108,경춘선,춘천,1419,1339,2758
202108,경춘선,신내,1651,1579,3230
202108,경춘선,갈매,2773,2428,5201
202108,경춘선,별내,2725,2640,5365
202108,경춘선,퇴계원,3261,3085,6346
202108,경춘선,사릉,2993,2995,5988
202108,경춘선,금곡,1301,1295,2596
202108,경춘선,평내호평,5470,5324,10794
202108,경춘선,천마산,1471,1341,2812
202108,경춘선,마석,3410,3416,6826
202108,경춘선,대성리,417,358,775
202108,경춘선,청평,1276,1174,2450
202108,경춘선,상천,200,175,375
202108,경춘선,가평,1441,1250,2691
202108,경춘선,굴봉산,111,92,203
202108,경춘선,백양리,88,63,151
202108,경춘선,강촌,455,368,823
202108,경춘선,김유정,220,235,455
202108,경춘선,남춘천,1931,2020,3951
202108,경춘선,춘천,1257,1244,2501
202109,경춘선,신내,1710,1577,3287
202109,경춘선,갈매,2840,2551,5391
202109,경춘선,별내,2795,2774,5569
202109,경춘선,퇴계원,3403,3130,6533
202109,경춘선,사릉,3088,3073,6161
202109,경춘선,금곡,1345,1369,2714
202109,경춘선,평내호평,5748,5572,11320
202109,경춘선,천마산,1569,1506,3075
202109,경춘선,마석,3529,3530,7059
202109,경춘선,대성리,429,378,807
202109,경춘선,청평,1323,1324,2647
202109,경춘선,상천,209,198,407
202109,경춘선,가평,1275,1270,2545
202109,경춘선,굴봉산,85,87,172
202109,경춘선,백양리,60,59,119
202109,경춘선,강촌,368,381,749
202109,경춘선,김유정,189,210,399
202109,경춘선,남춘천,1874,1943,3817
202109,경춘선,춘천,1073,1049,2122
202109,경춘선,춘천,1383,1188,2571
202109,경춘선,남춘천,2724,2623,5347
202109,경춘선,김유정,257,305,562
202109,경춘선,강촌,463,489,952
202109,경춘선,백양리,95,95,190
202109,경춘선,굴봉산,132,137,269
202109,경춘선,가평,1511,1582,3093
202109,경춘선,상천,285,267,552
202109,경춘선,청평,1451,1524,2975
202109,경춘선,대성리,541,526,1067
202109,경춘선,마석,3723,3755,7478
202109,경춘선,천마산,1633,1510,3143
202109,경춘선,평내호평,6074,6011,12085
202109,경춘선,금곡,1540,1518,3058
202109,경춘선,사릉,3238,3219,6457
202109,경춘선,퇴계원,3556,3310,6866
202109,경춘선,별내,2986,2798,5784
202109,경춘선,갈매,2927,2579,5506
202109,경춘선,신내,1768,1741,3509
202109,경춘선,춘천,1630,1381,3011
202109,경춘선,남춘천,2568,2447,5015
202109,경춘선,김유정,301,348,649
202109,경춘선,강촌,421,457,878
202109,경춘선,백양리,92,118,210
202109,경춘선,굴봉산,145,125,270
202109,경춘선,가평,1749,1897,3646
202109,경춘선,상천,334,307,641
202109,경춘선,청평,1703,1786,3489
202109,경춘선,대성리,563,544,1107
202109,경춘선,마석,3969,4100,8069
202109,경춘선,천마산,1738,1630,3368
202109,경춘선,평내호평,6168,6162,12330
202109,경춘선,금곡,1524,1453,2977
202109,경춘선,사릉,3403,3243,6646
202109,경춘선,퇴계원,3518,3371,6889
202109,경춘선,별내,3094,3064,6158
202109,경춘선,갈매,3073,2746,5819
202109,경춘선,신내,1750,1766,3516
202109,경춘선,신내,1838,1755,3593
202109,경춘선,갈매,2949,2597,5546
202109,경춘선,별내,3036,2903,5939
202109,경춘선,퇴계원,3551,3243,6794
202109,경춘선,사릉,3350,3234,6584
202109,경춘선,금곡,1491,1443,2934
202109,경춘선,평내호평,6173,5943,12116
202109,경춘선,천마산,1726,1625,3351
202109,경춘선,마석,3923,3738,7661
202109,경춘선,대성리,513,426,939
202109,경춘선,청평,1583,1489,3072
202109,경춘선,상천,286,266,552
202109,경춘선,가평,1583,1493,3076
202109,경춘선,굴봉산,97,116,213
202109,경춘선,백양리,81,75,156
202109,경춘선,강촌,468,425,893
202109,경춘선,김유정,276,246,522
202109,경춘선,남춘천,1948,2145,4093
202109,경춘선,춘천,1377,1386,2763
202109,경춘선,신내,1683,1565,3248
202109,경춘선,갈매,2805,2391,5196
202109,경춘선,별내,2693,2634,5327
202109,경춘선,퇴계원,3227,3045,6272
202109,경춘선,사릉,3048,2980,6028
202109,경춘선,금곡,1287,1279,2566
202109,경춘선,평내호평,5405,5290,10695
202109,경춘선,천마산,1488,1371,2859
202109,경춘선,마석,3393,3278,6671
202109,경춘선,대성리,333,316,649
202109,경춘선,청평,1124,1106,2230
202109,경춘선,상천,189,177,366
202109,경춘선,가평,1169,1110,2279
202109,경춘선,굴봉산,75,78,153
202109,경춘선,백양리,56,51,107
202109,경춘선,강촌,331,300,631
202109,경춘선,김유정,199,199,398
202109,경춘선,남춘천,2006,2059,4065
202109,경춘선,춘천,1173,1135,2308
202109,경춘선,신내,1826,1757,3583
202109,경춘선,갈매,3052,2719,5771
202109,경춘선,별내,3034,2903,5937
202109,경춘선,퇴계원,3536,3357,6893
202109,경춘선,사릉,3268,3199,6467
202109,경춘선,금곡,1496,1497,2993
202109,경춘선,평내호평,6148,5925,12073
202109,경춘선,천마산,1732,1608,3340
202109,경춘선,마석,3923,3927,7850
202109,경춘선,대성리,620,573,1193
202109,경춘선,청평,1523,1545,3068
202109,경춘선,상천,330,314,644
202109,경춘선,가평,1408,1497,2905
202109,경춘선,굴봉산,134,121,255
202109,경춘선,백양리,69,77,146
202109,경춘선,강촌,406,429,835
202109,경춘선,김유정,304,306,610
202109,경춘선,남춘천,2103,2050,4153
202109,경춘선,춘천,1223,1230,2453
202109,경춘선,춘천,1570,1312,2882
202109,경춘선,신내,1822,1782,3604
202109,경춘선,갈매,3109,2702,5811
202109,경춘선,별내,3209,3017,6226
202109,경춘선,퇴계원,3596,3376,6972
202109,경춘선,사릉,3372,3246,6618
202109,경춘선,금곡,1557,1516,3073
202109,경춘선,평내호평,6106,6082,12188
202109,경춘선,천마산,1674,1612,3286
202109,경춘선,마석,3895,3853,7748
202109,경춘선,대성리,648,624,1272
202109,경춘선,청평,1541,1610,3151
202109,경춘선,상천,351,343,694
202109,경춘선,가평,1568,1635,3203
202109,경춘선,굴봉산,142,150,292
202109,경춘선,백양리,87,93,180
202109,경춘선,강촌,488,510,998
202109,경춘선,김유정,352,354,706
202109,경춘선,남춘천,2272,2158,4430
202109,경춘선,춘천,1674,1330,3004
202109,경춘선,남춘천,2501,2399,4900
202109,경춘선,김유정,386,415,801
202109,경춘선,강촌,437,482,919
202109,경춘선,백양리,98,104,202
202109,경춘선,굴봉산,164,149,313
202109,경춘선,가평,1597,1798,3395
202109,경춘선,상천,330,314,644
202109,경춘선,청평,1654,1711,3365
202109,경춘선,대성리,545,547,1092
202109,경춘선,마석,3826,3872,7698
202109,경춘선,천마산,1750,1641,3391
202109,경춘선,평내호평,6293,6183,12476
202109,경춘선,금곡,1532,1485,3017
202109,경춘선,사릉,3334,3202,6536
202109,경춘선,퇴계원,3631,3388,7019
202109,경춘선,별내,3131,3112,6243
202109,경춘선,갈매,3059,2719,5778
202109,경춘선,신내,1820,1840,3660
202109,경춘선,갈매,3045,2598,5643
202109,경춘선,춘천,1366,1418,2784
202109,경춘선,남춘천,2122,2298,4420
202109,경춘선,김유정,307,301,608
202109,경춘선,강촌,449,482,931
202109,경춘선,백양리,78,72,150
202109,경춘선,굴봉산,131,116,247
202109,경춘선,가평,1620,1587,3207
202109,경춘선,상천,357,324,681
202109,경춘선,청평,1600,1464,3064
202109,경춘선,대성리,498,427,925
202109,경춘선,마석,4133,4098,8231
202109,경춘선,천마산,1746,1651,3397
202109,경춘선,평내호평,6370,5946,12316
202109,경춘선,금곡,1532,1516,3048
202109,경춘선,사릉,3499,3293,6792
202109,경춘선,퇴계원,3595,3344,6939
202109,경춘선,별내,3209,3012,6221
202109,경춘선,신내,1850,1811,3661
202109,경춘선,춘천,1398,1303,2701
202109,경춘선,남춘천,2035,2060,4095
202109,경춘선,김유정,251,281,532
202109,경춘선,강촌,522,489,1011
202109,경춘선,백양리,84,91,175
202109,경춘선,굴봉산,145,149,294
202109,경춘선,가평,1555,1556,3111
202109,경춘선,상천,345,337,682
202109,경춘선,청평,1532,1515,3047
202109,경춘선,대성리,543,508,1051
202109,경춘선,마석,3884,3778,7662
202109,경춘선,천마산,1707,1569,3276
202109,경춘선,평내호평,6076,5933,12009
202109,경춘선,금곡,1508,1511,3019
202109,경춘선,사릉,3424,3336,6760
202109,경춘선,퇴계원,3643,3227,6870
202109,경춘선,별내,3131,3010,6141
202109,경춘선,갈매,3033,2646,5679
202109,경춘선,신내,1773,1815,3588
202109,경춘선,춘천,1248,1179,2427
202109,경춘선,남춘천,2147,2072,4219
202109,경춘선,김유정,283,310,593
202109,경춘선,강촌,472,465,937
202109,경춘선,백양리,71,80,151
202109,경춘선,굴봉산,126,118,244
202109,경춘선,가평,1489,1552,3041
202109,경춘선,상천,330,295,625
202109,경춘선,청평,1563,1534,3097
202109,경춘선,대성리,576,545,1121
202109,경춘선,마석,3941,3803,7744
202109,경춘선,천마산,1739,1609,3348
202109,경춘선,평내호평,6261,6090,12351
202109,경춘선,금곡,1504,1457,2961
202109,경춘선,사릉,3438,3298,6736
202109,경춘선,퇴계원,3659,3377,7036
202109,경춘선,별내,3166,3021,6187
202109,경춘선,갈매,3039,2627,5666
202109,경춘선,신내,1887,1797,3684
202109,경춘선,춘천,1474,1197,2671
202109,경춘선,남춘천,2238,2060,4298
202109,경춘선,김유정,278,321,599
202109,경춘선,강촌,470,444,914
202109,경춘선,백양리,83,61,144
202109,경춘선,굴봉산,122,136,258
202109,경춘선,가평,1592,1677,3269
202109,경춘선,상천,345,318,663
202109,경춘선,청평,1559,1601,3160
202109,경춘선,대성리,567,490,1057
202109,경춘선,마석,3877,3859,7736
202109,경춘선,천마산,1735,1601,3336
202109,경춘선,평내호평,6139,5960,12099
202109,경춘선,금곡,1538,1518,3056
202109,경춘선,사릉,3473,3341,6814
202109,경춘선,퇴계원,3674,3323,6997
202109,경춘선,별내,3156,2955,6111
202109,경춘선,갈매,3070,2638,5708
202109,경춘선,신내,1902,1821,3723
202109,경춘선,신내,1847,1734,3581
202109,경춘선,갈매,3069,2613,5682
202109,경춘선,별내,3225,3045,6270
202109,경춘선,퇴계원,3605,3424,7029
202109,경춘선,사릉,3273,3257,6530
202109,경춘선,금곡,1497,1514,3011
202109,경춘선,평내호평,6302,6370,12672
202109,경춘선,천마산,1743,1585,3328
202109,경춘선,마석,3967,4114,8081
202109,경춘선,대성리,455,441,896
202109,경춘선,청평,1568,1658,3226
202109,경춘선,상천,319,300,619
202109,경춘선,가평,1670,1802,3472
202109,경춘선,굴봉산,149,138,287
202109,경춘선,백양리,86,89,175
202109,경춘선,강촌,431,442,873
202109,경춘선,김유정,265,347,612
202109,경춘선,남춘천,3615,3244,6859
202109,경춘선,춘천,1835,1434,3269
202109,경춘선,신내,626,630,1256
202109,경춘선,갈매,998,912,1910
202109,경춘선,별내,1381,1281,2662
202109,경춘선,퇴계원,1592,1506,3098
202109,경춘선,사릉,1316,1429,2745
202109,경춘선,금곡,720,675,1395
202109,경춘선,평내호평,2516,2609,5125
202109,경춘선,천마산,866,941,1807
202109,경춘선,마석,2053,2230,4283
202109,경춘선,대성리,607,483,1090
202109,경춘선,청평,1483,1605,3088
202109,경춘선,상천,268,271,539
202109,경춘선,가평,2041,2239,4280
202109,경춘선,굴봉산,212,190,402
202109,경춘선,백양리,133,98,231
202109,경춘선,강촌,645,540,1185
202109,경춘선,김유정,461,587,1048
202109,경춘선,남춘천,1833,2217,4050
202109,경춘선,춘천,1685,1669,3354
202109,경춘선,신내,579,506,1085
202109,경춘선,갈매,789,702,1491
202109,경춘선,별내,1017,979,1996
202109,경춘선,퇴계원,1358,1267,2625
202109,경춘선,사릉,1173,1146,2319
202109,경춘선,금곡,657,586,1243
202109,경춘선,평내호평,2180,2018,4198
202109,경춘선,천마산,735,733,1468
202109,경춘선,마석,1889,1724,3613
202109,경춘선,대성리,427,372,799
202109,경춘선,가평,1853,1347,3200
202109,경춘선,굴봉산,137,91,228
202109,경춘선,백양리,74,71,145
202109,경춘선,강촌,457,325,782
202109,경춘선,김유정,300,271,571
202109,경춘선,남춘천,2102,1729,3831
202109,경춘선,춘천,1843,1071,2914
202109,경춘선,청평,1269,987,2256
202109,경춘선,상천,214,177,391
202109,경춘선,신내,710,732,1442
202109,경춘선,갈매,1222,1132,2354
202109,경춘선,별내,1632,1456,3088
202109,경춘선,퇴계원,1902,1657,3559
202109,경춘선,사릉,1581,1502,3083
202109,경춘선,금곡,885,771,1656
202109,경춘선,평내호평,3229,2908,6137
202109,경춘선,천마산,1018,932,1950
202109,경춘선,마석,2306,2142,4448
202109,경춘선,대성리,543,427,970
202109,경춘선,청평,1601,1126,2727
202109,경춘선,상천,377,340,717
202109,경춘선,가평,2092,1446,3538
202109,경춘선,굴봉산,211,180,391
202109,경춘선,백양리,93,96,189
202109,경춘선,강촌,652,528,1180
202109,경춘선,김유정,452,426,878
202109,경춘선,남춘천,3118,2693,5811
202109,경춘선,춘천,2574,1646,4220
202109,경춘선,신내,1749,1611,3360
202109,경춘선,갈매,2833,2541,5374
202109,경춘선,별내,3009,2909,5918
202109,경춘선,퇴계원,3458,3158,6616
202109,경춘선,사릉,3219,3052,6271
202109,경춘선,금곡,1520,1480,3000
202109,경춘선,평내호평,6027,5820,11847
202109,경춘선,천마산,1622,1523,3145
202109,경춘선,마석,3823,3774,7597
202109,경춘선,대성리,580,530,1110
202109,경춘선,청평,1586,1620,3206
202109,경춘선,상천,373,357,730
202109,경춘선,가평,1701,1687,3388
202109,경춘선,굴봉산,153,139,292
202109,경춘선,백양리,85,93,178
202109,경춘선,강촌,500,513,1013
202109,경춘선,김유정,337,374,711
202109,경춘선,남춘천,2137,2281,4418
202109,경춘선,춘천,1411,1283,2694
202109,경춘선,신내,1870,1815,3685
202109,경춘선,갈매,2942,2557,5499
202109,경춘선,별내,3152,3101,6253
202109,경춘선,퇴계원,3586,3340,6926
202109,경춘선,사릉,3373,3234,6607
202109,경춘선,금곡,1515,1465,2980
202109,경춘선,평내호평,6213,6077,12290
202109,경춘선,천마산,1657,1587,3244
202109,경춘선,마석,3846,3983,7829
202109,경춘선,대성리,545,536,1081
202109,경춘선,청평,1804,1831,3635
202109,경춘선,상천,303,308,611
202109,경춘선,가평,1850,1889,3739
202109,경춘선,굴봉산,135,137,272
202109,경춘선,백양리,98,94,192
202109,경춘선,강촌,499,497,996
202109,경춘선,김유정,378,447,825
202109,경춘선,남춘천,2371,2336,4707
202109,경춘선,춘천,1608,1405,3013
202109,경춘선,춘천,1461,1465,2926
202109,경춘선,남춘천,2654,2870,5524
202109,경춘선,김유정,304,323,627
202109,경춘선,강촌,484,452,936
202109,경춘선,백양리,87,90,177
202109,경춘선,굴봉산,136,137,273
202109,경춘선,가평,1686,1648,3334
202109,경춘선,상천,357,320,677
202109,경춘선,청평,1651,1541,3192
202109,경춘선,대성리,534,462,996
202109,경춘선,마석,4014,3924,7938
202109,경춘선,천마산,1752,1656,3408
202109,경춘선,평내호평,6348,6091,12439
202109,경춘선,금곡,1577,1559,3136
202109,경춘선,사릉,3504,3340,6844
202109,경춘선,퇴계원,3655,3384,7039
202109,경춘선,별내,3158,2987,6145
202109,경춘선,갈매,3073,2645,5718
202109,경춘선,신내,1938,1847,3785
202109,경춘선,신내,1905,1793,3698
202109,경춘선,갈매,3003,2593,5596
202109,경춘선,별내,3136,3023,6159
202109,경춘선,퇴계원,3532,3254,6786
202109,경춘선,사릉,3448,3301,6749
202109,경춘선,금곡,1580,1537,3117
202109,경춘선,평내호평,5970,5969,11939
202109,경춘선,천마산,1717,1550,3267
202109,경춘선,마석,4223,4164,8387
202109,경춘선,대성리,522,470,992
202109,경춘선,청평,1593,1559,3152
202109,경춘선,상천,280,275,555
202109,경춘선,가평,1603,1646,3249
202109,경춘선,굴봉산,121,108,229
202109,경춘선,백양리,82,60,142
202109,경춘선,강촌,447,380,827
202109,경춘선,김유정,292,310,602
202109,경춘선,남춘천,2122,2136,4258
202109,경춘선,춘천,1349,1346,2695
202109,경춘선,신내,1744,1720,3464
202109,경춘선,갈매,2827,2449,5276
202109,경춘선,별내,2830,2772,5602
202109,경춘선,퇴계원,3364,3132,6496
202109,경춘선,사릉,3279,3136,6415
202109,경춘선,금곡,1394,1370,2764
202109,경춘선,평내호평,5642,5446,11088
202109,경춘선,천마산,1526,1408,2934
202109,경춘선,마석,3523,3403,6926
202109,경춘선,대성리,350,311,661
202109,경춘선,청평,1283,1237,2520
202109,경춘선,상천,239,205,444
202109,경춘선,가평,1230,1230,2460
202109,경춘선,굴봉산,81,80,161
202109,경춘선,백양리,40,51,91
202109,경춘선,강촌,310,335,645
202109,경춘선,김유정,179,202,381
202109,경춘선,남춘천,1776,1823,3599
202109,경춘선,춘천,1144,1105,2249
202109,경춘선,신내,1902,1855,3757
202109,경춘선,갈매,3093,2700,5793
202109,경춘선,별내,3212,3085,6297
202109,경춘선,퇴계원,3666,3391,7057
202109,경춘선,사릉,3523,3381,6904
202109,경춘선,금곡,1594,1555,3149
202109,경춘선,평내호평,6247,6115,12362
202109,경춘선,천마산,1736,1614,3350
202109,경춘선,마석,3900,3860,7760
202109,경춘선,대성리,554,511,1065
202109,경춘선,청평,1624,1653,3277
202109,경춘선,상천,349,350,699
202109,경춘선,가평,1952,2060,4012
202109,경춘선,굴봉산,144,157,301
202109,경춘선,백양리,110,104,214
202109,경춘선,강촌,511,518,1029
202109,경춘선,김유정,372,408,780
202109,경춘선,남춘천,2352,2184,4536
202109,경춘선,춘천,1566,1338,2904
202110,경춘선,춘천,1687,1356,3043
202110,경춘선,남춘천,2626,2423,5049
202110,경춘선,김유정,350,425,775
202110,경춘선,강촌,453,517,970
202110,경춘선,백양리,92,81,173
202110,경춘선,굴봉산,148,156,304
202110,경춘선,가평,2007,2071,4078
202110,경춘선,상천,368,342,710
202110,경춘선,청평,1756,1835,3591
202110,경춘선,대성리,551,515,1066
202110,경춘선,마석,3972,3996,7968
202110,경춘선,천마산,1663,1602,3265
202110,경춘선,평내호평,6261,6320,12581
202110,경춘선,금곡,1518,1487,3005
202110,경춘선,사릉,3402,3263,6665
202110,경춘선,퇴계원,3685,3466,7151
202110,경춘선,별내,3194,3096,6290
202110,경춘선,갈매,3112,2732,5844
202110,경춘선,신내,1940,1841,3781
202110,경춘선,신내,1048,1007,2055
202110,경춘선,갈매,1645,1440,3085
202110,경춘선,별내,1988,1917,3905
202110,경춘선,퇴계원,2264,2090,4354
202110,경춘선,사릉,2077,1981,4058
202110,경춘선,금곡,1013,967,1980
202110,경춘선,평내호평,3838,3602,7440
202110,경춘선,천마산,1229,1159,2388
202110,경춘선,마석,2730,2628,5358
202110,경춘선,대성리,546,431,977
202110,경춘선,청평,1466,1241,2707
202110,경춘선,상천,321,275,596
202110,경춘선,가평,1924,1767,3691
202110,경춘선,굴봉산,191,127,318
202110,경춘선,백양리,97,87,184
202110,경춘선,강촌,583,501,1084
202110,경춘선,김유정,509,520,1029
202110,경춘선,남춘천,2182,2317,4499
202110,경춘선,춘천,1537,1371,2908
202110,경춘선,춘천,1334,1300,2634
202110,경춘선,남춘천,2034,2111,4145
202110,경춘선,김유정,239,250,489
202110,경춘선,강촌,396,414,810
202110,경춘선,백양리,69,61,130
202110,경춘선,굴봉산,98,92,190
202110,경춘선,가평,1610,1540,3150
202110,경춘선,상천,235,224,459
202110,경춘선,청평,1461,1449,2910
202110,경춘선,대성리,456,370,826
202110,경춘선,마석,3912,3777,7689
202110,경춘선,천마산,1692,1612,3304
202110,경춘선,평내호평,6127,5894,12021
202110,경춘선,금곡,1505,1460,2965
202110,경춘선,사릉,3538,3356,6894
202110,경춘선,퇴계원,3598,3326,6924
202110,경춘선,별내,3219,3012,6231
202110,경춘선,갈매,3136,2741,5877
202110,경춘선,신내,1886,1841,3727
202110,경춘선,신내,1814,1713,3527
202110,경춘선,갈매,3130,2710,5840
202110,경춘선,별내,3095,2975,6070
202110,경춘선,퇴계원,3420,3110,6530
202110,경춘선,사릉,3383,3221,6604
202110,경춘선,금곡,1476,1453,2929
202110,경춘선,평내호평,5921,5727,11648
202110,경춘선,천마산,1585,1498,3083
202110,경춘선,마석,3635,3614,7249
202110,경춘선,대성리,418,370,788
202110,경춘선,청평,1388,1398,2786
202110,경춘선,상천,215,219,434
202110,경춘선,가평,1435,1383,2818
202110,경춘선,굴봉산,103,90,193
202110,경춘선,백양리,56,48,104
202110,경춘선,강촌,414,395,809
202110,경춘선,김유정,193,204,397
202110,경춘선,남춘천,1983,2012,3995
202110,경춘선,춘천,1179,1148,2327
202110,경춘선,춘천,1340,1159,2499
202110,경춘선,남춘천,2566,2459,5025
202110,경춘선,김유정,287,287,574
202110,경춘선,강촌,406,407,813
202110,경춘선,백양리,61,81,142
202110,경춘선,굴봉산,103,103,206
202110,경춘선,가평,1527,1619,3146
202110,경춘선,상천,226,233,459
202110,경춘선,청평,1481,1555,3036
202110,경춘선,대성리,434,387,821
202110,경춘선,마석,3764,3722,7486
202110,경춘선,천마산,1672,1587,3259
202110,경춘선,평내호평,6063,5984,12047
202110,경춘선,금곡,1485,1450,2935
202110,경춘선,사릉,3495,3264,6759
202110,경춘선,퇴계원,3534,3263,6797
202110,경춘선,별내,3215,3082,6297
202110,경춘선,갈매,3179,2726,5905
202110,경춘선,신내,1876,1782,3658
202110,경춘선,춘천,1583,1351,2934
202110,경춘선,남춘천,2632,2539,5171
202110,경춘선,김유정,332,351,683
202110,경춘선,강촌,428,527,955
202110,경춘선,백양리,97,90,187
202110,경춘선,굴봉산,124,141,265
202110,경춘선,가평,1796,1946,3742
202110,경춘선,상천,267,260,527
202110,경춘선,청평,1615,1734,3349
202110,경춘선,대성리,454,420,874
202110,경춘선,마석,4049,4127,8176
202110,경춘선,천마산,1638,1522,3160
202110,경춘선,평내호평,6066,6153,12219
202110,경춘선,금곡,1501,1407,2908
202110,경춘선,사릉,3446,3334,6780
202110,경춘선,퇴계원,3612,3326,6938
202110,경춘선,별내,3253,3141,6394
202110,경춘선,갈매,3181,2790,5971
202110,경춘선,신내,1944,1901,3845
202110,경춘선,신내,1134,1157,2291
202110,경춘선,갈매,1709,1509,3218
202110,경춘선,별내,2223,2088,4311
202110,경춘선,퇴계원,2452,2308,4760
202110,경춘선,사릉,2184,2122,4306
202110,경춘선,금곡,1125,1116,2241
202110,경춘선,평내호평,4253,4021,8274
202110,경춘선,천마산,1362,1309,2671
202110,경춘선,마석,3011,2902,5913
202110,경춘선,대성리,639,509,1148
202110,경춘선,청평,1689,1350,3039
202110,경춘선,상천,382,319,701
202110,경춘선,가평,2567,2220,4787
202110,경춘선,굴봉산,190,151,341
202110,경춘선,백양리,103,93,196
202110,경춘선,강촌,801,654,1455
202110,경춘선,김유정,586,598,1184
202110,경춘선,남춘천,2599,2733,5332
202110,경춘선,춘천,2042,1787,3829
202110,경춘선,신내,2176,1983,4159
202110,경춘선,갈매,3388,2797,6185
202110,경춘선,별내,3375,3137,6512
202110,경춘선,퇴계원,3752,3434,7186
202110,경춘선,사릉,3673,3429,7102
202110,경춘선,금곡,1607,1525,3132
202110,경춘선,평내호평,6379,6160,12539
202110,경춘선,천마산,1772,1643,3415
202110,경춘선,마석,4081,3999,8080
202110,경춘선,대성리,518,459,977
202110,경춘선,청평,1626,1550,3176
202110,경춘선,상천,279,274,553
202110,경춘선,가평,1952,1893,3845
202110,경춘선,굴봉산,121,111,232
202110,경춘선,백양리,88,66,154
202110,경춘선,강촌,546,498,1044
202110,경춘선,김유정,329,345,674
202110,경춘선,남춘천,2913,3040,5953
202110,경춘선,춘천,1487,1425,2912
202110,경춘선,춘천,1336,1296,2632
202110,경춘선,남춘천,2303,2341,4644
202110,경춘선,김유정,357,370,727
202110,경춘선,강촌,575,564,1139
202110,경춘선,백양리,75,69,144
202110,경춘선,굴봉산,157,133,290
202110,경춘선,가평,2013,2005,4018
202110,경춘선,상천,335,295,630
202110,경춘선,청평,1680,1668,3348
202110,경춘선,대성리,531,518,1049
202110,경춘선,마석,4312,4369,8681
202110,경춘선,천마산,1710,1573,3283
202110,경춘선,평내호평,6423,6187,12610
202110,경춘선,금곡,1590,1557,3147
202110,경춘선,사릉,3590,3350,6940
202110,경춘선,퇴계원,3646,3335,6981
202110,경춘선,별내,3286,3095,6381
202110,경춘선,갈매,3251,2821,6072
202110,경춘선,신내,2092,2002,4094
202110,경춘선,춘천,1628,1381,3009
202110,경춘선,남춘천,2444,2425,4869
202110,경춘선,김유정,359,416,775
202110,경춘선,강촌,612,600,1212
202110,경춘선,백양리,108,123,231
202110,경춘선,굴봉산,161,143,304
202110,경춘선,가평,2047,2045,4092
202110,경춘선,상천,302,293,595
202110,경춘선,청평,1671,1728,3399
202110,경춘선,대성리,564,497,1061
202110,경춘선,마석,4101,4079,8180
202110,경춘선,천마산,1688,1571,3259
202110,경춘선,평내호평,6331,6152,12483
202110,경춘선,금곡,1634,1627,3261
202110,경춘선,사릉,3565,3366,6931
202110,경춘선,퇴계원,3638,3419,7057
202110,경춘선,별내,3353,3204,6557
202110,경춘선,갈매,3217,2730,5947
202110,경춘선,신내,2076,2028,4104
202110,경춘선,신내,2091,1997,4088
202110,경춘선,갈매,3172,2778,5950
202110,경춘선,별내,3354,3181,6535
202110,경춘선,퇴계원,3685,3407,7092
202110,경춘선,사릉,3582,3310,6892
202110,경춘선,금곡,1569,1552,3121
202110,경춘선,평내호평,6282,6302,12584
202110,경춘선,천마산,1737,1661,3398
202110,경춘선,마석,3855,3963,7818
202110,경춘선,대성리,534,472,1006
202110,경춘선,청평,1708,1785,3493
202110,경춘선,상천,271,300,571
202110,경춘선,가평,1868,2041,3909
202110,경춘선,굴봉산,117,125,242
202110,경춘선,백양리,96,90,186
202110,경춘선,강촌,436,471,907
202110,경춘선,김유정,338,393,731
202110,경춘선,남춘천,2609,2608,5217
202110,경춘선,춘천,1570,1303,2873
202110,경춘선,신내,1989,1869,3858
202110,경춘선,갈매,3100,2680,5780
202110,경춘선,별내,3294,3121,6415
202110,경춘선,퇴계원,3569,3252,6821
202110,경춘선,사릉,3463,3306,6769
202110,경춘선,금곡,1555,1490,3045
202110,경춘선,평내호평,6385,5981,12366
202110,경춘선,천마산,1668,1531,3199
202110,경춘선,마석,4037,4063,8100
202110,경춘선,대성리,472,449,921
202110,경춘선,청평,1492,1431,2923
202110,경춘선,상천,234,234,468
202110,경춘선,가평,1850,1730,3580
202110,경춘선,굴봉산,142,115,257
202110,경춘선,백양리,91,71,162
202110,경춘선,강촌,590,546,1136
202110,경춘선,김유정,284,299,583
202110,경춘선,남춘천,2420,2478,4898
202110,경춘선,춘천,1528,1454,2982
202110,경춘선,평내호평,6163,5985,12148
202110,경춘선,천마산,1693,1569,3262
202110,경춘선,마석,3872,3776,7648
202110,경춘선,대성리,477,411,888
202110,경춘선,청평,1511,1468,2979
202110,경춘선,상천,231,228,459
202110,경춘선,가평,1542,1512,3054
202110,경춘선,김유정,281,291,572
202110,경춘선,강촌,571,585,1156
202110,경춘선,백양리,91,73,164
202110,경춘선,굴봉산,110,96,206
202110,경춘선,신내,2004,1933,3937
202110,경춘선,갈매,3117,2683,5800
202110,경춘선,별내,3314,3049,6363
202110,경춘선,퇴계원,3565,3291,6856
202110,경춘선,사릉,3570,3408,6978
202110,경춘선,금곡,1552,1457,3009
202110,경춘선,남춘천,2106,2228,4334
202110,경춘선,춘천,1667,1462,3129
202110,경춘선,신내,1998,1992,3990
202110,경춘선,갈매,3240,2812,6052
202110,경춘선,별내,3391,3164,6555
202110,경춘선,퇴계원,3768,3430,7198
202110,경춘선,사릉,3538,3376,6914
202110,경춘선,금곡,1624,1585,3209
202110,경춘선,평내호평,6492,6232,12724
202110,경춘선,천마산,1780,1638,3418
202110,경춘선,마석,4086,4038,8124
202110,경춘선,대성리,521,460,981
202110,경춘선,청평,1554,1570,3124
202110,경춘선,상천,264,244,508
202110,경춘선,가평,1764,1771,3535
202110,경춘선,굴봉산,135,150,285
202110,경춘선,백양리,98,107,205
202110,경춘선,강촌,609,627,1236
202110,경춘선,김유정,311,342,653
202110,경춘선,남춘천,2500,2515,5015
202110,경춘선,춘천,1655,1417,3072
202110,경춘선,신내,1999,2025,4024
202110,경춘선,갈매,3204,2753,5957
202110,경춘선,별내,3445,3205,6650
202110,경춘선,퇴계원,3680,3464,7144
202110,경춘선,사릉,3605,3394,6999
202110,경춘선,금곡,1581,1546,3127
202110,경춘선,평내호평,6339,6261,12600
202110,경춘선,천마산,1709,1625,3334
202110,경춘선,마석,4063,3998,8061
202110,경춘선,대성리,517,462,979
202110,경춘선,청평,1486,1551,3037
202110,경춘선,상천,292,292,584
202110,경춘선,가평,1858,1907,3765
202110,경춘선,굴봉산,133,122,255
202110,경춘선,백양리,82,86,168
202110,경춘선,강촌,679,584,1263
202110,경춘선,김유정,378,433,811
202110,경춘선,남춘천,2821,2675,5496
202110,경춘선,춘천,1751,1468,3219
202110,경춘선,춘천,1962,1544,3506
202110,경춘선,남춘천,3692,3604,7296
202110,경춘선,김유정,307,369,676
202110,경춘선,강촌,506,525,1031
202110,경춘선,백양리,85,81,166
202110,경춘선,굴봉산,161,162,323
202110,경춘선,가평,1990,2056,4046
202110,경춘선,상천,313,285,598
202110,경춘선,청평,1676,1887,3563
202110,경춘선,대성리,586,556,1142
202110,경춘선,마석,4040,4150,8190
202110,경춘선,천마산,1788,1667,3455
202110,경춘선,평내호평,6413,6356,12769
202110,경춘선,금곡,1588,1501,3089
202110,경춘선,사릉,3598,3468,7066
202110,경춘선,퇴계원,3756,3553,7309
202110,경춘선,별내,3400,3204,6604
202110,경춘선,갈매,3178,2736,5914
202110,경춘선,신내,2093,1990,4083
202110,경춘선,신내,2017,1908,3925
202110,경춘선,갈매,3238,2773,6011
202110,경춘선,별내,3443,3254,6697
202110,경춘선,퇴계원,3720,3396,7116
202110,경춘선,사릉,3695,3450,7145
202110,경춘선,금곡,1651,1594,3245
202110,경춘선,평내호평,6611,6209,12820
202110,경춘선,천마산,1824,1665,3489
202110,경춘선,마석,4143,4053,8196
202110,경춘선,대성리,515,398,913
202110,경춘선,청평,1641,1607,3248
202110,경춘선,상천,296,286,582
202110,경춘선,가평,1941,1873,3814
202110,경춘선,굴봉산,185,153,338
202110,경춘선,백양리,80,89,169
202110,경춘선,강촌,454,442,896
202110,경춘선,김유정,345,343,688
202110,경춘선,남춘천,2653,2859,5512
202110,경춘선,춘천,1644,1567,3211
202110,경춘선,춘천,1957,1696,3653
202110,경춘선,남춘천,2728,2837,5565
202110,경춘선,김유정,358,389,747
202110,경춘선,강촌,556,520,1076
202110,경춘선,백양리,71,77,148
202110,경춘선,굴봉산,137,133,270
202110,경춘선,가평,1885,1913,3798
202110,경춘선,상천,301,276,577
202110,경춘선,청평,1576,1517,3093
202110,경춘선,대성리,564,516,1080
202110,경춘선,마석,4143,4064,8207
202110,경춘선,천마산,1752,1607,3359
202110,경춘선,평내호평,6474,6323,12797
202110,경춘선,금곡,1600,1541,3141
202110,경춘선,사릉,3679,3470,7149
202110,경춘선,퇴계원,3809,3458,7267
202110,경춘선,별내,3488,3268,6756
202110,경춘선,갈매,3241,2800,6041
202110,경춘선,신내,2072,2013,4085
202110,경춘선,춘천,1660,1478,3138
202110,경춘선,남춘천,3498,3497,6995
202110,경춘선,김유정,375,402,777
202110,경춘선,강촌,602,583,1185
202110,경춘선,백양리,79,78,157
202110,경춘선,굴봉산,131,126,257
202110,경춘선,가평,1830,1841,3671
202110,경춘선,상천,339,319,658
202110,경춘선,청평,1661,1609,3270
202110,경춘선,대성리,528,483,1011
202110,경춘선,마석,4142,4137,8279
202110,경춘선,천마산,1777,1647,3424
202110,경춘선,평내호평,6436,6174,12610
202110,경춘선,금곡,1627,1597,3224
202110,경춘선,사릉,3625,3441,7066
202110,경춘선,퇴계원,3786,3455,7241
202110,경춘선,별내,3416,3125,6541
202110,경춘선,갈매,3186,2777,5963
202110,경춘선,신내,2079,2067,4146
202110,경춘선,춘천,2130,1648,3778
202110,경춘선,남춘천,3025,2991,6016
202110,경춘선,김유정,377,444,821
202110,경춘선,강촌,617,562,1179
202110,경춘선,백양리,139,108,247
202110,경춘선,굴봉산,161,131,292
202110,경춘선,가평,2055,2091,4146
202110,경춘선,상천,310,299,609
202110,경춘선,청평,1679,1705,3384
202110,경춘선,대성리,568,515,1083
202110,경춘선,마석,4452,4439,8891
202110,경춘선,천마산,1738,1608,3346
202110,경춘선,평내호평,6546,6401,12947
202110,경춘선,금곡,1679,1672,3351
202110,경춘선,사릉,3604,3510,7114
202110,경춘선,퇴계원,3855,3550,7405
202110,경춘선,별내,3496,3363,6859
202110,경춘선,갈매,3273,2837,6110
202110,경춘선,신내,2055,2074,4129
202110,경춘선,강촌,487,600,1087
202110,경춘선,백양리,95,108,203
202110,경춘선,굴봉산,141,156,297
202110,경춘선,가평,2166,2405,4571
202110,경춘선,상천,308,305,613
202110,경춘선,청평,1713,1834,3547
202110,경춘선,대성리,542,555,1097
202110,경춘선,마석,4173,4175,8348
202110,경춘선,천마산,1812,1752,3564
202110,경춘선,평내호평,6640,6580,13220
202110,경춘선,금곡,1599,1551,3150
202110,경춘선,사릉,3613,3470,7083
202110,경춘선,퇴계원,3843,3507,7350
202110,경춘선,별내,3489,3435,6924
202110,경춘선,갈매,3332,2812,6144
202110,경춘선,신내,2100,2114,4214
202110,경춘선,춘천,2205,1776,3981
202110,경춘선,남춘천,3292,3259,6551
202110,경춘선,김유정,384,462,846
202111,경춘선,춘천,1741,1704,3445
202111,경춘선,남춘천,2430,2693,5123
202111,경춘선,김유정,323,312,635
202111,경춘선,강촌,482,435,917
202111,경춘선,백양리,91,86,177
202111,경춘선,굴봉산,171,150,321
202111,경춘선,가평,2017,1936,3953
202111,경춘선,상천,278,260,538
202111,경춘선,청평,1585,1543,3128
202111,경춘선,대성리,510,425,935
202111,경춘선,마석,4088,4016,8104
202111,경춘선,천마산,1829,1629,3458
202111,경춘선,평내호평,6591,6154,12745
202111,경춘선,금곡,1612,1520,3132
202111,경춘선,사릉,3689,3433,7122
202111,경춘선,퇴계원,3679,3410,7089
202111,경춘선,별내,3536,3317,6853
202111,경춘선,갈매,3268,2812,6080
202111,경춘선,신내,2120,1966,4086
202111,경춘선,신내,2150,2071,4221
202111,경춘선,갈매,3250,2844,6094
202111,경춘선,별내,3606,3320,6926
202111,경춘선,퇴계원,3761,3522,7283
202111,경춘선,사릉,3610,3399,7009
202111,경춘선,금곡,1627,1611,3238
202111,경춘선,평내호평,6587,6351,12938
202111,경춘선,천마산,1794,1632,3426
202111,경춘선,마석,4197,4154,8351
202111,경춘선,대성리,514,486,1000
202111,경춘선,청평,1726,1618,3344
202111,경춘선,상천,311,293,604
202111,경춘선,가평,2197,2194,4391
202111,경춘선,굴봉산,161,144,305
202111,경춘선,백양리,92,93,185
202111,경춘선,강촌,537,533,1070
202111,경춘선,김유정,368,429,797
202111,경춘선,남춘천,3328,3465,6793
202111,경춘선,춘천,1732,1513,3245
202111,경춘선,춘천,1659,1413,3072
202111,경춘선,남춘천,2429,2483,4912
202111,경춘선,김유정,382,389,771
202111,경춘선,강촌,576,583,1159
202111,경춘선,백양리,78,73,151
202111,경춘선,굴봉산,162,146,308
202111,경춘선,가평,2104,2200,4304
202111,경춘선,상천,347,340,687
202111,경춘선,청평,1690,1697,3387
202111,경춘선,대성리,484,480,964
202111,경춘선,마석,4557,4555,9112
202111,경춘선,천마산,1809,1701,3510
202111,경춘선,평내호평,6681,6372,13053
202111,경춘선,금곡,1607,1546,3153
202111,경춘선,사릉,3672,3461,7133
202111,경춘선,퇴계원,3798,3468,7266
202111,경춘선,별내,3662,3377,7039
202111,경춘선,갈매,3305,2912,6217
202111,경춘선,신내,2125,2033,4158
202111,경춘선,춘천,1930,1499,3429
202111,경춘선,남춘천,2648,2593,5241
202111,경춘선,김유정,336,429,765
202111,경춘선,강촌,612,529,1141
202111,경춘선,백양리,83,91,174
202111,경춘선,굴봉산,157,146,303
202111,경춘선,가평,2204,2258,4462
202111,경춘선,상천,306,309,615
202111,경춘선,청평,1559,1657,3216
202111,경춘선,대성리,575,493,1068
202111,경춘선,마석,4082,4009,8091
202111,경춘선,천마산,1747,1579,3326
202111,경춘선,평내호평,6495,6284,12779
202111,경춘선,금곡,1573,1523,3096
202111,경춘선,사릉,3620,3454,7074
202111,경춘선,퇴계원,3802,3486,7288
202111,경춘선,별내,3533,3272,6805
202111,경춘선,갈매,3203,2788,5991
202111,경춘선,신내,2151,1988,4139
202111,경춘선,춘천,2140,1709,3849
202111,경춘선,남춘천,3262,3137,6399
202111,경춘선,김유정,431,543,974
202111,경춘선,강촌,551,550,1101
202111,경춘선,백양리,93,101,194
202111,경춘선,굴봉산,145,142,287
202111,경춘선,가평,2574,2721,5295
202111,경춘선,상천,326,320,646
202111,경춘선,청평,1765,1972,3737
202111,경춘선,대성리,639,612,1251
202111,경춘선,마석,4248,4237,8485
202111,경춘선,천마산,1790,1554,3344
202111,경춘선,평내호평,6565,6637,13202
202111,경춘선,금곡,1617,1545,3162
202111,경춘선,사릉,3715,3525,7240
202111,경춘선,퇴계원,3915,3554,7469
202111,경춘선,별내,3656,3471,7127
202111,경춘선,갈매,3381,2875,6256
202111,경춘선,신내,2124,2056,4180
202111,경춘선,신내,1933,1795,3728
202111,경춘선,갈매,2986,2592,5578
202111,경춘선,별내,3145,2834,5979
202111,경춘선,퇴계원,3524,3145,6669
202111,경춘선,사릉,3364,3122,6486
202111,경춘선,금곡,1408,1317,2725
202111,경춘선,평내호평,5854,5620,11474
202111,경춘선,천마산,1520,1356,2876
202111,경춘선,마석,3666,3520,7186
202111,경춘선,대성리,358,335,693
202111,경춘선,청평,1303,1204,2507
202111,경춘선,상천,178,168,346
202111,경춘선,가평,1507,1332,2839
202111,경춘선,굴봉산,77,71,148
202111,경춘선,백양리,46,49,95
202111,경춘선,강촌,361,338,699
202111,경춘선,김유정,215,197,412
202111,경춘선,남춘천,2030,2227,4257
202111,경춘선,춘천,1279,1344,2623
202111,경춘선,신내,1934,1887,3821
202111,경춘선,갈매,3179,2729,5908
202111,경춘선,별내,3372,3142,6514
202111,경춘선,퇴계원,3618,3290,6908
202111,경춘선,사릉,3490,3288,6778
202111,경춘선,금곡,1538,1432,2970
202111,경춘선,평내호평,6199,5928,12127
202111,경춘선,천마산,1647,1461,3108
202111,경춘선,마석,3768,3678,7446
202111,경춘선,대성리,386,362,748
202111,경춘선,청평,1322,1354,2676
202111,경춘선,상천,222,188,410
202111,경춘선,가평,1485,1358,2843
202111,경춘선,굴봉산,100,99,199
202111,경춘선,백양리,69,65,134
202111,경춘선,강촌,421,387,808
202111,경춘선,김유정,217,225,442
202111,경춘선,남춘천,2003,2075,4078
202111,경춘선,춘천,1315,1246,2561
202111,경춘선,신내,2166,2090,4256
202111,경춘선,갈매,3317,2845,6162
202111,경춘선,별내,3348,3134,6482
202111,경춘선,퇴계원,3718,3367,7085
202111,경춘선,사릉,3588,3402,6990
202111,경춘선,금곡,1515,1490,3005
202111,경춘선,평내호평,6376,6106,12482
202111,경춘선,천마산,1676,1543,3219
202111,경춘선,마석,3976,3815,7791
202111,경춘선,대성리,457,406,863
202111,경춘선,청평,1450,1457,2907
202111,경춘선,상천,221,226,447
202111,경춘선,가평,1517,1618,3135
202111,경춘선,굴봉산,116,113,229
202111,경춘선,백양리,75,65,140
202111,경춘선,강촌,470,459,929
202111,경춘선,김유정,253,298,551
202111,경춘선,남춘천,2195,2192,4387
202111,경춘선,춘천,1359,1217,2576
202111,경춘선,신내,2026,1922,3948
202111,경춘선,갈매,3231,2754,5985
202111,경춘선,별내,3475,3223,6698
202111,경춘선,퇴계원,3761,3506,7267
202111,경춘선,사릉,3580,3294,6874
202111,경춘선,금곡,1494,1478,2972
202111,경춘선,평내호평,6355,6171,12526
202111,경춘선,천마산,1659,1522,3181
202111,경춘선,마석,3973,3894,7867
202111,경춘선,대성리,525,420,945
202111,경춘선,청평,1428,1493,2921
202111,경춘선,상천,226,235,461
202111,경춘선,가평,1516,1662,3178
202111,경춘선,굴봉산,145,131,276
202111,경춘선,백양리,45,58,103
202111,경춘선,강촌,465,463,928
202111,경춘선,김유정,293,350,643
202111,경춘선,남춘천,2451,2314,4765
202111,경춘선,춘천,1499,1294,2793
202111,경춘선,신내,2067,1868,3935
202111,경춘선,갈매,3266,2716,5982
202111,경춘선,별내,3568,3421,6989
202111,경춘선,퇴계원,3817,3455,7272
202111,경춘선,사릉,3548,3381,6929
202111,경춘선,금곡,1562,1442,3004
202111,경춘선,평내호평,6303,6370,12673
202111,경춘선,천마산,1738,1574,3312
202111,경춘선,마석,4017,3986,8003
202111,경춘선,대성리,462,553,1015
202111,경춘선,청평,1597,1759,3356
202111,경춘선,상천,260,270,530
202111,경춘선,가평,1869,2140,4009
202111,경춘선,굴봉산,140,145,285
202111,경춘선,백양리,85,97,182
202111,경춘선,강촌,427,510,937
202111,경춘선,김유정,324,420,744
202111,경춘선,남춘천,3366,3261,6627
202111,경춘선,춘천,1840,1440,3280
202111,경춘선,신내,2035,1842,3877
202111,경춘선,갈매,3116,2742,5858
202111,경춘선,별내,3468,3261,6729
202111,경춘선,퇴계원,3784,3345,7129
202111,경춘선,사릉,3626,3325,6951
202111,경춘선,금곡,1568,1479,3047
202111,경춘선,평내호평,6411,6077,12488
202111,경춘선,천마산,1674,1537,3211
202111,경춘선,마석,4005,3800,7805
202111,경춘선,대성리,516,446,962
202111,경춘선,청평,1595,1412,3007
202111,경춘선,상천,265,261,526
202111,경춘선,가평,1617,1558,3175
202111,경춘선,굴봉산,140,134,274
202111,경춘선,백양리,91,86,177
202111,경춘선,강촌,485,462,947
202111,경춘선,김유정,310,305,615
202111,경춘선,남춘천,2286,2566,4852
202111,경춘선,춘천,1555,1583,3138
202111,경춘선,춘천,1579,1482,3061
202111,경춘선,남춘천,2248,2420,4668
202111,경춘선,김유정,340,362,702
202111,경춘선,강촌,501,473,974
202111,경춘선,백양리,95,83,178
202111,경춘선,굴봉산,148,134,282
202111,경춘선,가평,1575,1555,3130
202111,경춘선,상천,262,245,507
202111,경춘선,청평,1496,1425,2921
202111,경춘선,대성리,471,436,907
202111,경춘선,마석,4026,3960,7986
202111,경춘선,천마산,1773,1564,3337
202111,경춘선,평내호평,6470,6267,12737
202111,경춘선,금곡,1571,1502,3073
202111,경춘선,사릉,3603,3415,7018
202111,경춘선,퇴계원,3798,3453,7251
202111,경춘선,별내,3480,3183,6663
202111,경춘선,갈매,3210,2726,5936
202111,경춘선,신내,2113,1949,4062
202111,경춘선,별내,3470,3281,6751
202111,경춘선,춘천,1428,1327,2755
202111,경춘선,남춘천,2930,2878,5808
202111,경춘선,김유정,343,332,675
202111,경춘선,강촌,474,469,943
202111,경춘선,백양리,79,66,145
202111,경춘선,굴봉산,133,126,259
202111,경춘선,가평,1624,1658,3282
202111,경춘선,상천,323,305,628
202111,경춘선,청평,1589,1541,3130
202111,경춘선,대성리,541,482,1023
202111,경춘선,마석,4010,3868,7878
202111,경춘선,천마산,1737,1618,3355
202111,경춘선,평내호평,6443,6324,12767
202111,경춘선,금곡,1605,1509,3114
202111,경춘선,사릉,3550,3420,6970
202111,경춘선,퇴계원,3804,3424,7228
202111,경춘선,갈매,3226,2850,6076
202111,경춘선,신내,2046,2015,4061
202111,경춘선,춘천,1532,1257,2789
202111,경춘선,남춘천,2386,2270,4656
202111,경춘선,김유정,271,329,600
202111,경춘선,강촌,455,442,897
202111,경춘선,백양리,73,79,152
202111,경춘선,굴봉산,118,130,248
202111,경춘선,가평,1513,1582,3095
202111,경춘선,상천,259,244,503
202111,경춘선,청평,1495,1464,2959
202111,경춘선,대성리,517,397,914
202111,경춘선,마석,4102,4098,8200
202111,경춘선,천마산,1638,1539,3177
202111,경춘선,평내호평,6313,6194,12507
202111,경춘선,금곡,1513,1411,2924
202111,경춘선,사릉,3551,3377,6928
202111,경춘선,퇴계원,3710,3396,7106
202111,경춘선,별내,3432,3142,6574
202111,경춘선,갈매,3143,2698,5841
202111,경춘선,신내,1983,1853,3836
202111,경춘선,신내,2016,1852,3868
202111,경춘선,갈매,3225,2727,5952
202111,경춘선,별내,3480,3287,6767
202111,경춘선,퇴계원,3781,3487,7268
202111,경춘선,사릉,3554,3391,6945
202111,경춘선,금곡,1587,1428,3015
202111,경춘선,평내호평,6455,6341,12796
202111,경춘선,천마산,1758,1558,3316
202111,경춘선,마석,4006,4001,8007
202111,경춘선,대성리,497,708,1205
202111,경춘선,청평,1628,1752,3380
202111,경춘선,상천,270,254,524
202111,경춘선,가평,1717,1956,3673
202111,경춘선,굴봉산,124,122,246
202111,경춘선,백양리,60,96,156
202111,경춘선,강촌,417,446,863
202111,경춘선,김유정,360,417,777
202111,경춘선,남춘천,2937,2782,5719
202111,경춘선,춘천,1913,1472,3385
202111,경춘선,신내,2134,2021,4155
202111,경춘선,갈매,3100,2631,5731
202111,경춘선,별내,3421,3190,6611
202111,경춘선,퇴계원,3708,3349,7057
202111,경춘선,사릉,3490,3182,6672
202111,경춘선,금곡,1550,1437,2987
202111,경춘선,평내호평,6472,6086,12558
202111,경춘선,천마산,1745,1603,3348
202111,경춘선,마석,4007,3965,7972
202111,경춘선,대성리,502,408,910
202111,경춘선,청평,1554,1469,3023
202111,경춘선,상천,219,203,422
202111,경춘선,가평,1537,1460,2997
202111,경춘선,굴봉산,111,108,219
202111,경춘선,백양리,88,61,149
202111,경춘선,강촌,397,400,797
202111,경춘선,김유정,269,252,521
202111,경춘선,남춘천,2610,2887,5497
202111,경춘선,춘천,1359,1474,2833
202111,경춘선,춘천,1264,1206,2470
202111,경춘선,남춘천,2114,2128,4242
202111,경춘선,김유정,275,271,546
202111,경춘선,강촌,446,407,853
202111,경춘선,백양리,62,60,122
202111,경춘선,굴봉산,107,91,198
202111,경춘선,가평,1430,1421,2851
202111,경춘선,상천,220,189,409
202111,경춘선,청평,1382,1350,2732
202111,경춘선,대성리,441,372,813
202111,경춘선,마석,4068,4082,8150
202111,경춘선,천마산,1717,1542,3259
202111,경춘선,평내호평,6246,5974,12220
202111,경춘선,금곡,1562,1485,3047
202111,경춘선,사릉,3496,3371,6867
202111,경춘선,퇴계원,3641,3243,6884
202111,경춘선,별내,3424,3131,6555
202111,경춘선,갈매,3183,2654,5837
202111,경춘선,신내,2130,2037,4167
202111,경춘선,춘천,1247,1130,2377
202111,경춘선,남춘천,2042,2086,4128
202111,경춘선,김유정,249,260,509
202111,경춘선,강촌,402,413,815
202111,경춘선,백양리,63,68,131
202111,경춘선,굴봉산,95,104,199
202111,경춘선,가평,1464,1448,2912
202111,경춘선,상천,236,219,455
202111,경춘선,청평,1409,1389,2798
202111,경춘선,대성리,421,407,828
202111,경춘선,마석,3882,3751,7633
202111,경춘선,천마산,1699,1558,3257
202111,경춘선,평내호평,6247,6001,12248
202111,경춘선,금곡,1500,1494,2994
202111,경춘선,사릉,3523,3298,6821
202111,경춘선,퇴계원,3662,3355,7017
202111,경춘선,별내,3334,3115,6449
202111,경춘선,갈매,3156,2728,5884
202111,경춘선,신내,2151,2072,4223
202111,경춘선,신내,2153,2051,4204
202111,경춘선,갈매,3243,2737,5980
202111,경춘선,별내,3438,3279,6717
202111,경춘선,퇴계원,3756,3395,7151
202111,경춘선,사릉,3581,3501,7082
202111,경춘선,금곡,1576,1573,3149
202111,경춘선,평내호평,6312,6175,12487
202111,경춘선,천마산,1738,1566,3304
202111,경춘선,마석,3960,3880,7840
202111,경춘선,대성리,465,407,872
202111,경춘선,청평,1481,1534,3015
202111,경춘선,상천,218,194,412
202111,경춘선,가평,1497,1537,3034
202111,경춘선,굴봉산,111,113,224
202111,경춘선,백양리,88,76,164
202111,경춘선,강촌,456,462,918
202111,경춘선,김유정,340,352,692
202111,경춘선,남춘천,2445,2307,4752
202111,경춘선,춘천,1435,1224,2659
202111,경춘선,신내,2198,2064,4262
202111,경춘선,갈매,3225,2701,5926
202111,경춘선,별내,3508,3324,6832
202111,경춘선,퇴계원,3789,3469,7258
202111,경춘선,사릉,3580,3331,6911
202111,경춘선,금곡,1576,1548,3124
202111,경춘선,평내호평,6426,6407,12833
202111,경춘선,천마산,1744,1640,3384
202111,경춘선,마석,3956,3861,7817
202111,경춘선,대성리,489,704,1193
202111,경춘선,청평,1595,1695,3290
202111,경춘선,상천,224,245,469
202111,경춘선,가평,1625,1784,3409
202111,경춘선,굴봉산,112,132,244
202111,경춘선,백양리,135,140,275
202111,경춘선,강촌,452,446,898
202111,경춘선,김유정,351,386,737
202111,경춘선,남춘천,3051,2821,5872
202111,경춘선,춘천,1709,1433,3142
202111,경춘선,신내,2190,2130,4320
202111,경춘선,갈매,3112,2666,5778
202111,경춘선,별내,3472,3213,6685
202111,경춘선,퇴계원,3744,3375,7119
202111,경춘선,사릉,3675,3418,7093
202111,경춘선,금곡,1557,1496,3053
202111,경춘선,평내호평,6464,6080,12544
202111,경춘선,천마산,1795,1600,3395
202111,경춘선,마석,4114,4022,8136
202111,경춘선,대성리,473,395,868
202111,경춘선,청평,1491,1408,2899
202111,경춘선,상천,237,221,458
202111,경춘선,가평,1578,1453,3031
202111,경춘선,굴봉산,112,97,209
202111,경춘선,백양리,68,63,131
202111,경춘선,강촌,469,428,897
202111,경춘선,김유정,274,244,518
202111,경춘선,남춘천,2125,2378,4503
202111,경춘선,춘천,1406,1478,2884
202111,경춘선,신내,1964,1916,3880
202111,경춘선,갈매,2995,2512,5507
202111,경춘선,별내,3152,2863,6015
202111,경춘선,퇴계원,3411,3091,6502
202111,경춘선,사릉,3396,3167,6563
202111,경춘선,금곡,1313,1294,2607
202111,경춘선,평내호평,5640,5472,11112
202111,경춘선,천마산,1465,1328,2793
202111,경춘선,마석,3472,3339,6811
202111,경춘선,대성리,307,266,573
202111,경춘선,청평,1183,1177,2360
202111,경춘선,상천,138,117,255
202111,경춘선,가평,1233,1226,2459
202111,경춘선,굴봉산,64,67,131
202111,경춘선,백양리,68,57,125
202111,경춘선,강촌,333,317,650
202111,경춘선,김유정,179,162,341
202111,경춘선,남춘천,1736,1833,3569
202111,경춘선,춘천,1196,1103,2299
202112,경춘선,춘천,1212,1104,2316
202112,경춘선,남춘천,2069,2029,4098
202112,경춘선,김유정,203,211,414
202112,경춘선,강촌,345,371,716
202112,경춘선,백양리,83,90,173
202112,경춘선,굴봉산,95,102,197
202112,경춘선,가평,1288,1309,2597
202112,경춘선,상천,190,174,364
202112,경춘선,청평,1394,1353,2747
202112,경춘선,대성리,378,360,738
202112,경춘선,마석,3718,3645,7363
202112,경춘선,천마산,1588,1387,2975
202112,경춘선,평내호평,6079,5954,12033
202112,경춘선,금곡,1423,1382,2805
202112,경춘선,사릉,3442,3218,6660
202112,경춘선,퇴계원,3610,3273,6883
202112,경춘선,별내,3361,3119,6480
202112,경춘선,갈매,3173,2748,5921
202112,경춘선,신내,2151,2010,4161
202112,경춘선,춘천,1361,1128,2489
202112,경춘선,남춘천,2496,2371,4867
202112,경춘선,김유정,247,273,520
202112,경춘선,강촌,376,380,756
202112,경춘선,백양리,88,117,205
202112,경춘선,굴봉산,94,94,188
202112,경춘선,가평,1312,1362,2674
202112,경춘선,상천,181,171,352
202112,경춘선,청평,1345,1378,2723
202112,경춘선,대성리,418,433,851
202112,경춘선,마석,3707,3641,7348
202112,경춘선,천마산,1636,1470,3106
202112,경춘선,평내호평,6014,5914,11928
202112,경춘선,금곡,1475,1432,2907
202112,경춘선,사릉,3471,3293,6764
202112,경춘선,퇴계원,3545,3262,6807
202112,경춘선,별내,3250,3076,6326
202112,경춘선,갈매,3112,2642,5754
202112,경춘선,신내,2069,1990,4059
202112,경춘선,신내,2124,2040,4164
202112,경춘선,갈매,3186,2706,5892
202112,경춘선,별내,3471,3303,6774
202112,경춘선,퇴계원,3652,3329,6981
202112,경춘선,사릉,3531,3397,6928
202112,경춘선,금곡,1511,1451,2962
202112,경춘선,평내호평,6226,6274,12500
202112,경춘선,천마산,1698,1525,3223
202112,경춘선,마석,4128,4041,8169
202112,경춘선,대성리,520,484,1004
202112,경춘선,청평,1506,1587,3093
202112,경춘선,상천,199,186,385
202112,경춘선,가평,1429,1547,2976
202112,경춘선,굴봉산,105,119,224
202112,경춘선,백양리,118,136,254
202112,경춘선,강촌,310,381,691
202112,경춘선,김유정,240,292,532
202112,경춘선,남춘천,2601,2420,5021
202112,경춘선,춘천,1532,1228,2760
202112,경춘선,춘천,1286,1278,2564
202112,경춘선,남춘천,2113,2281,4394
202112,경춘선,김유정,231,238,469
202112,경춘선,강촌,390,381,771
202112,경춘선,백양리,139,129,268
202112,경춘선,굴봉산,89,111,200
202112,경춘선,가평,1406,1322,2728
202112,경춘선,상천,253,234,487
202112,경춘선,청평,1473,1378,2851
202112,경춘선,대성리,436,329,765
202112,경춘선,마석,3902,3794,7696
202112,경춘선,천마산,1661,1573,3234
202112,경춘선,평내호평,6338,5914,12252
202112,경춘선,금곡,1546,1545,3091
202112,경춘선,사릉,3576,3300,6876
202112,경춘선,퇴계원,3599,3210,6809
202112,경춘선,별내,3509,3265,6774
202112,경춘선,갈매,3198,2740,5938
202112,경춘선,신내,2111,1993,4104
202112,경춘선,신내,2164,2099,4263
202112,경춘선,갈매,3191,2732,5923
202112,경춘선,별내,3382,3152,6534
202112,경춘선,퇴계원,3675,3297,6972
202112,경춘선,사릉,3593,3406,6999
202112,경춘선,금곡,1536,1485,3021
202112,경춘선,평내호평,6248,6072,12320
202112,경춘선,천마산,1677,1551,3228
202112,경춘선,마석,3846,3799,7645
202112,경춘선,대성리,456,481,937
202112,경춘선,청평,1440,1410,2850
202112,경춘선,상천,237,218,455
202112,경춘선,가평,1438,1402,2840
202112,경춘선,굴봉산,120,116,236
202112,경춘선,백양리,142,144,286
202112,경춘선,강촌,380,389,769
202112,경춘선,김유정,356,335,691
202112,경춘선,남춘천,2504,2556,5060
202112,경춘선,춘천,1257,1204,2461
202112,경춘선,춘천,1204,1125,2329
202112,경춘선,남춘천,2123,2178,4301
202112,경춘선,김유정,249,269,518
202112,경춘선,강촌,389,371,760
202112,경춘선,백양리,106,136,242
202112,경춘선,굴봉산,105,125,230
202112,경춘선,가평,1416,1339,2755
202112,경춘선,상천,258,242,500
202112,경춘선,청평,1448,1355,2803
202112,경춘선,대성리,494,434,928
202112,경춘선,마석,3990,4011,8001
202112,경춘선,천마산,1641,1543,3184
202112,경춘선,평내호평,6218,6012,12230
202112,경춘선,금곡,1543,1463,3006
202112,경춘선,사릉,3558,3343,6901
202112,경춘선,퇴계원,3562,3339,6901
202112,경춘선,별내,3323,3114,6437
202112,경춘선,갈매,3214,2687,5901
202112,경춘선,신내,2036,1972,4008
202112,경춘선,신내,2126,1972,4098
202112,경춘선,갈매,3142,2664,5806
202112,경춘선,별내,3355,3139,6494
202112,경춘선,퇴계원,3601,3277,6878
202112,경춘선,사릉,3442,3303,6745
202112,경춘선,금곡,1475,1449,2924
202112,경춘선,평내호평,6000,5881,11881
202112,경춘선,천마산,1659,1480,3139
202112,경춘선,마석,3667,3591,7258
202112,경춘선,대성리,455,398,853
202112,경춘선,청평,1339,1329,2668
202112,경춘선,상천,240,211,451
202112,경춘선,가평,1325,1354,2679
202112,경춘선,굴봉산,128,115,243
202112,경춘선,백양리,140,137,277
202112,경춘선,강촌,354,342,696
202112,경춘선,김유정,457,469,926
202112,경춘선,남춘천,2417,2317,4734
202112,경춘선,춘천,1484,1213,2697
202112,경춘선,신내,2082,1908,3990
202112,경춘선,갈매,3134,2655,5789
202112,경춘선,별내,3383,3162,6545
202112,경춘선,퇴계원,3547,3217,6764
202112,경춘선,사릉,3367,3263,6630
202112,경춘선,금곡,1462,1428,2890
202112,경춘선,평내호평,5977,5952,11929
202112,경춘선,천마산,1631,1487,3118
202112,경춘선,마석,3724,3621,7345
202112,경춘선,대성리,366,393,759
202112,경춘선,청평,1428,1483,2911
202112,경춘선,상천,201,195,396
202112,경춘선,가평,1380,1560,2940
202112,경춘선,굴봉산,102,134,236
202112,경춘선,백양리,176,181,357
202112,경춘선,강촌,297,351,648
202112,경춘선,김유정,458,488,946
202112,경춘선,남춘천,2438,2471,4909
202112,경춘선,춘천,1484,1191,2675
202112,경춘선,춘천,1248,1123,2371
202112,경춘선,남춘천,2292,2395,4687
202112,경춘선,김유정,403,383,786
202112,경춘선,강촌,535,466,1001
202112,경춘선,백양리,126,135,261
202112,경춘선,굴봉산,87,105,192
202112,경춘선,가평,1277,1240,2517
202112,경춘선,상천,192,171,363
202112,경춘선,청평,1353,1311,2664
202112,경춘선,대성리,380,328,708
202112,경춘선,마석,3892,3831,7723
202112,경춘선,천마산,1538,1442,2980
202112,경춘선,평내호평,5900,5705,11605
202112,경춘선,금곡,1458,1368,2826
202112,경춘선,사릉,3338,3179,6517
202112,경춘선,퇴계원,3509,3136,6645
202112,경춘선,별내,3273,3000,6273
202112,경춘선,갈매,2895,2483,5378
202112,경춘선,신내,2060,1874,3934
202112,경춘선,신내,2047,1984,4031
202112,경춘선,갈매,3057,2695,5752
202112,경춘선,별내,3301,3030,6331
202112,경춘선,퇴계원,3516,3195,6711
202112,경춘선,사릉,3387,3133,6520
202112,경춘선,금곡,1481,1427,2908
202112,경춘선,평내호평,5847,5760,11607
202112,경춘선,천마산,1584,1485,3069
202112,경춘선,마석,3675,3578,7253
202112,경춘선,대성리,391,322,713
202112,경춘선,청평,1318,1289,2607
202112,경춘선,상천,180,177,357
202112,경춘선,가평,1316,1275,2591
202112,경춘선,굴봉산,90,106,196
202112,경춘선,백양리,177,174,351
202112,경춘선,강촌,528,492,1020
202112,경춘선,김유정,458,476,934
202112,경춘선,남춘천,2157,2239,4396
202112,경춘선,춘천,1312,1166,2478
202112,경춘선,청평,1362,1303,2665
202112,경춘선,신내,2066,1967,4033
202112,경춘선,갈매,3028,2695,5723
202112,경춘선,별내,3320,3068,6388
202112,경춘선,퇴계원,3532,3225,6757
202112,경춘선,사릉,3369,3264,6633
202112,경춘선,금곡,1414,1373,2787
202112,경춘선,평내호평,5988,5808,11796
202112,경춘선,천마산,1576,1493,3069
202112,경춘선,마석,3696,3482,7178
202112,경춘선,대성리,346,317,663
202112,경춘선,상천,193,173,366
202112,경춘선,가평,1306,1378,2684
202112,경춘선,굴봉산,108,116,224
202112,경춘선,백양리,201,176,377
202112,경춘선,강촌,472,453,925
202112,경춘선,김유정,244,254,498
202112,경춘선,남춘천,2107,2041,4148
202112,경춘선,춘천,1090,1001,2091
202112,경춘선,춘천,1120,1030,2150
202112,경춘선,남춘천,2269,2110,4379
202112,경춘선,김유정,238,254,492
202112,경춘선,강촌,542,532,1074
202112,경춘선,백양리,157,181,338
202112,경춘선,굴봉산,116,104,220
202112,경춘선,가평,1394,1498,2892
202112,경춘선,상천,193,175,368
202112,경춘선,청평,1344,1385,2729
202112,경춘선,대성리,403,406,809
202112,경춘선,마석,3691,3609,7300
202112,경춘선,천마산,1568,1479,3047
202112,경춘선,평내호평,6023,5845,11868
202112,경춘선,금곡,1491,1420,2911
202112,경춘선,사릉,3380,3187,6567
202112,경춘선,퇴계원,3643,3332,6975
202112,경춘선,별내,3338,3091,6429
202112,경춘선,갈매,3109,2648,5757
202112,경춘선,신내,2157,1988,4145
202112,경춘선,춘천,1269,1089,2358
202112,경춘선,남춘천,2792,2602,5394
202112,경춘선,김유정,247,277,524
202112,경춘선,강촌,421,432,853
202112,경춘선,백양리,186,214,400
202112,경춘선,굴봉산,125,112,237
202112,경춘선,가평,1471,1580,3051
202112,경춘선,상천,187,188,375
202112,경춘선,청평,1381,1468,2849
202112,경춘선,대성리,419,388,807
202112,경춘선,마석,3633,3606,7239
202112,경춘선,천마산,1540,1371,2911
202112,경춘선,평내호평,5794,5765,11559
202112,경춘선,금곡,1461,1319,2780
202112,경춘선,사릉,3232,3079,6311
202112,경춘선,퇴계원,3496,3173,6669
202112,경춘선,별내,3201,3052,6253
202112,경춘선,갈매,2924,2552,5476
202112,경춘선,신내,1999,1871,3870
202112,경춘선,신내,1994,1810,3804
202112,경춘선,갈매,3060,2665,5725
202112,경춘선,별내,3408,3158,6566
202112,경춘선,퇴계원,3598,3339,6937
202112,경춘선,사릉,3327,3211,6538
202112,경춘선,금곡,1521,1461,2982
202112,경춘선,평내호평,6053,5746,11799
202112,경춘선,천마산,1621,1531,3152
202112,경춘선,마석,3639,3561,7200
202112,경춘선,대성리,414,367,781
202112,경춘선,청평,1368,1315,2683
202112,경춘선,상천,244,224,468
202112,경춘선,가평,1488,1447,2935
202112,경춘선,굴봉산,121,129,250
202112,경춘선,백양리,228,231,459
202112,경춘선,강촌,309,317,626
202112,경춘선,김유정,256,251,507
202112,경춘선,남춘천,2137,2244,4381
202112,경춘선,춘천,1403,1299,2702
202112,경춘선,신내,2108,1930,4038
202112,경춘선,갈매,3090,2671,5761
202112,경춘선,별내,3432,3246,6678
202112,경춘선,퇴계원,3650,3415,7065
202112,경춘선,사릉,3301,3175,6476
202112,경춘선,금곡,1494,1432,2926
202112,경춘선,평내호평,5989,5907,11896
202112,경춘선,천마산,1602,1524,3126
202112,경춘선,마석,3694,3648,7342
202112,경춘선,대성리,405,395,800
202112,경춘선,청평,1456,1382,2838
202112,경춘선,상천,174,183,357
202112,경춘선,가평,1469,1507,2976
202112,경춘선,굴봉산,120,115,235
202112,경춘선,백양리,234,207,441
202112,경춘선,강촌,331,344,675
202112,경춘선,김유정,260,269,529
202112,경춘선,남춘천,2089,2150,4239
202112,경춘선,춘천,1478,1370,2848
202112,경춘선,신내,2072,1931,4003
202112,경춘선,갈매,3092,2690,5782
202112,경춘선,별내,3306,3093,6399
202112,경춘선,퇴계원,3587,3296,6883
202112,경춘선,사릉,3284,3191,6475
202112,경춘선,금곡,1505,1429,2934
202112,경춘선,평내호평,6025,5818,11843
202112,경춘선,천마산,1674,1556,3230
202112,경춘선,마석,3719,3652,7371
202112,경춘선,대성리,430,397,827
202112,경춘선,청평,1452,1402,2854
202112,경춘선,상천,220,186,406
202112,경춘선,가평,1481,1475,2956
202112,경춘선,굴봉산,107,117,224
202112,경춘선,백양리,304,274,578
202112,경춘선,강촌,392,381,773
202112,경춘선,김유정,304,305,609
202112,경춘선,남춘천,2605,2530,5135
202112,경춘선,춘천,1378,1229,2607
202112,경춘선,춘천,1213,1036,2249
202112,경춘선,남춘천,2113,2057,4170
202112,경춘선,김유정,314,309,623
202112,경춘선,강촌,312,316,628
202112,경춘선,백양리,327,269,596
202112,경춘선,굴봉산,90,134,224
202112,경춘선,가평,1562,1631,3193
202112,경춘선,상천,194,203,397
202112,경춘선,청평,1519,1585,3104
202112,경춘선,대성리,448,404,852
202112,경춘선,마석,3926,3927,7853
202112,경춘선,천마산,1659,1542,3201
202112,경춘선,평내호평,6036,5912,11948
202112,경춘선,금곡,1487,1431,2918
202112,경춘선,사릉,3196,3058,6254
202112,경춘선,퇴계원,3608,3271,6879
202112,경춘선,별내,3376,3159,6535
202112,경춘선,갈매,3073,2725,5798
202112,경춘선,신내,2065,1916,3981
202112,경춘선,춘천,1314,1261,2575
202112,경춘선,남춘천,2318,2616,4934
202112,경춘선,김유정,245,289,534
202112,경춘선,강촌,319,330,649
202112,경춘선,백양리,298,262,560
202112,경춘선,굴봉산,103,110,213
202112,경춘선,가평,1701,1866,3567
202112,경춘선,상천,205,199,404
202112,경춘선,청평,1594,1651,3245
202112,경춘선,대성리,416,367,783
202112,경춘선,마석,3609,3610,7219
202112,경춘선,천마산,1615,1530,3145
202112,경춘선,평내호평,5867,5917,11784
202112,경춘선,금곡,1443,1360,2803
202112,경춘선,사릉,3152,3059,6211
202112,경춘선,퇴계원,3441,3240,6681
202112,경춘선,별내,3328,3268,6596
202112,경춘선,갈매,2915,2550,5465
202112,경춘선,신내,2011,1858,3869
202112,경춘선,춘천,974,856,1830
202112,경춘선,남춘천,2187,2127,4314
202112,경춘선,김유정,196,189,385
202112,경춘선,강촌,245,264,509
202112,경춘선,백양리,249,214,463
202112,경춘선,굴봉산,101,139,240
202112,경춘선,가평,1357,1431,2788
202112,경춘선,상천,156,148,304
202112,경춘선,청평,1346,1323,2669
202112,경춘선,대성리,372,339,711
202112,경춘선,마석,3243,3316,6559
202112,경춘선,천마산,1472,1344,2816
202112,경춘선,평내호평,5503,5165,10668
202112,경춘선,금곡,1372,1262,2634
202112,경춘선,사릉,2992,2798,5790
202112,경춘선,퇴계원,3202,2947,6149
202112,경춘선,별내,3003,2896,5899
202112,경춘선,갈매,2799,2431,5230
202112,경춘선,신내,1917,1770,3687
202112,경춘선,춘천,1023,920,1943
202112,경춘선,남춘천,1884,1935,3819
202112,경춘선,김유정,270,259,529
202112,경춘선,강촌,299,288,587
202112,경춘선,백양리,256,194,450
202112,경춘선,굴봉산,127,121,248
202112,경춘선,가평,1420,1419,2839
202112,경춘선,상천,182,159,341
202112,경춘선,청평,1479,1294,2773
202112,경춘선,대성리,409,410,819
202112,경춘선,마석,3690,3580,7270
202112,경춘선,천마산,1519,1428,2947
202112,경춘선,평내호평,5692,5551,11243
202112,경춘선,금곡,1406,1320,2726
202112,경춘선,사릉,3061,2983,6044
202112,경춘선,퇴계원,3358,3021,6379
202112,경춘선,별내,3253,3048,6301
202112,경춘선,갈매,2848,2496,5344
202112,경춘선,신내,1980,1876,3856
202112,경춘선,신내,2044,1964,4008
202112,경춘선,갈매,2953,2618,5571
202112,경춘선,별내,3272,3100,6372
202112,경춘선,퇴계원,3496,3220,6716
202112,경춘선,사릉,3170,2997,6167
202112,경춘선,금곡,1411,1342,2753
202112,경춘선,평내호평,5932,5738,11670
202112,경춘선,천마산,1548,1463,3011
202112,경춘선,마석,3593,3524,7117
202112,경춘선,대성리,431,353,784
202112,경춘선,청평,1392,1362,2754
202112,경춘선,상천,193,190,383
202112,경춘선,가평,1485,1494,2979
202112,경춘선,굴봉산,103,115,218
202112,경춘선,백양리,254,224,478
202112,경춘선,강촌,349,345,694
202112,경춘선,김유정,299,293,592
202112,경춘선,남춘천,1996,2077,4073
202112,경춘선,춘천,1142,969,2111
202112,경춘선,상천,182,178,360
202112,경춘선,신내,1951,1823,3774
202112,경춘선,갈매,2833,2511,5344
202112,경춘선,별내,3176,2967,6143
202112,경춘선,퇴계원,3408,3178,6586
202112,경춘선,사릉,3083,2958,6041
202112,경춘선,금곡,1371,1336,2707
202112,경춘선,평내호평,5666,5474,11140
202112,경춘선,천마산,1520,1417,2937
202112,경춘선,마석,3465,3488,6953
202112,경춘선,대성리,406,341,747
202112,경춘선,청평,1372,1363,2735
202112,경춘선,춘천,1063,958,2021
202112,경춘선,남춘천,2008,2029,4037
202112,경춘선,김유정,265,255,520
202112,경춘선,강촌,298,321,619
202112,경춘선,백양리,242,176,418
202112,경춘선,굴봉산,104,115,219
202112,경춘선,가평,1398,1458,2856
202112,경춘선,신내,1740,1705,3445
202112,경춘선,갈매,2574,2215,4789
202112,경춘선,별내,2890,2790,5680
202112,경춘선,퇴계원,3209,2920,6129
202112,경춘선,사릉,2784,2762,5546
202112,경춘선,금곡,1309,1206,2515
202112,경춘선,평내호평,5312,5388,10700
202112,경춘선,천마산,1454,1339,2793
202112,경춘선,마석,3285,3392,6677
202112,경춘선,대성리,393,421,814
202112,경춘선,청평,1377,1598,2975
202112,경춘선,상천,189,192,381
202112,경춘선,가평,1383,1867,3250
202112,경춘선,굴봉산,103,122,225
202112,경춘선,백양리,236,254,490
202112,경춘선,강촌,335,370,705
202112,경춘선,김유정,240,261,501
202112,경춘선,남춘천,2285,2589,4874
202112,경춘선,춘천,1154,1169,2323
