사용월,호선명,지하철역,승차총승객수,하차총승객수,승하차총승객수
202101,분당선,선릉,1471,1811,3282
202101,분당선,한티,2563,2561,5124
202101,분당선,도곡,1273,1178,2451
202101,분당선,구룡,270,254,524
202101,분당선,개포동,669,681,1350
202101,분당선,대모산입구,659,606,1265
202101,분당선,수서,2983,3517,6500
202101,분당선,수원,2803,2282,5085
202101,분당선,서울숲,1570,1440,3010
202101,분당선,압구정로데오,2634,2911,5545
202101,분당선,강남구청,1161,1345,2506
202101,분당선,선정릉,924,878,1802
202101,분당선,가천대,1704,2059,3763
202101,분당선,태평,4448,4194,8642
202101,분당선,모란,5910,6074,11984
202101,분당선,야탑,5940,6185,12125
202101,분당선,서현,5962,5880,11842
202101,분당선,수내,2433,2316,4749
202101,분당선,정자,3497,3399,6896
202101,분당선,미금,3709,3807,7516
202101,분당선,오리,2744,2320,5064
202101,분당선,이매,1202,1224,2426
202101,분당선,보정,447,422,869
202101,분당선,죽전,3146,3513,6659
202101,분당선,구성,992,1092,2084
202101,분당선,신갈,850,899,1749
202101,분당선,기흥,2431,2381,4812
202101,분당선,상갈,1314,1397,2711
202101,분당선,청명,823,846,1669
202101,분당선,영통,2257,2300,4557
202101,분당선,망포,3192,2945,6137
202101,분당선,매탄권선,1221,1156,2377
202101,분당선,수원시청,3603,3585,7188
202101,분당선,매교,669,670,1339
202101,분당선,매교,2098,2157,4255
202101,분당선,수원시청,9398,9713,19111
202101,분당선,매탄권선,3582,3468,7050
202101,분당선,망포,10882,10775,21657
202101,분당선,영통,5989,6107,12096
202101,분당선,청명,3112,3050,6162
202101,분당선,상갈,4151,4044,8195
202101,분당선,기흥,7352,7067,14419
202101,분당선,신갈,3667,3651,7318
202101,분당선,구성,3806,4060,7866
202101,분당선,죽전,10090,11155,21245
202101,분당선,보정,1803,1557,3360
202101,분당선,이매,4067,3890,7957
202101,분당선,오리,9527,8123,17650
202101,분당선,미금,12612,13541,26153
202101,분당선,정자,12438,13151,25589
202101,분당선,수내,10517,10488,21005
202101,분당선,서현,19275,19296,38571
202101,분당선,야탑,20154,20854,41008
202101,분당선,모란,17663,17968,35631
202101,분당선,태평,11194,11100,22294
202101,분당선,가천대,5193,6105,11298
202101,분당선,선릉,11708,16873,28581
202101,분당선,한티,10707,11551,22258
202101,분당선,도곡,5242,5293,10535
202101,분당선,구룡,1591,1557,3148
202101,분당선,개포동,2807,2874,5681
202101,분당선,대모산입구,2908,2720,5628
202101,분당선,수서,9943,10057,20000
202101,분당선,수원,5867,4767,10634
202101,분당선,서울숲,6512,6732,13244
202101,분당선,압구정로데오,12997,13770,26767
202101,분당선,강남구청,7660,8597,16257
202101,분당선,선정릉,6775,7217,13992
202101,분당선,매교,1996,2043,4039
202101,분당선,수원시청,9372,9837,19209
202101,분당선,매탄권선,3556,3450,7006
202101,분당선,망포,10842,10664,21506
202101,분당선,영통,5935,6031,11966
202101,분당선,청명,3202,3070,6272
202101,분당선,상갈,4166,4021,8187
202101,분당선,기흥,7315,6960,14275
202101,분당선,신갈,3497,3523,7020
202101,분당선,구성,3758,4041,7799
202101,분당선,죽전,10105,10927,21032
202101,분당선,보정,1842,1592,3434
202101,분당선,이매,4179,3920,8099
202101,분당선,오리,9603,8119,17722
202101,분당선,미금,12484,13201,25685
202101,분당선,정자,12719,13264,25983
202101,분당선,수내,10506,10680,21186
202101,분당선,서현,18779,19193,37972
202101,분당선,야탑,20069,21068,41137
202101,분당선,모란,16169,16174,32343
202101,분당선,태평,10975,10761,21736
202101,분당선,가천대,5075,5991,11066
202101,분당선,선정릉,6844,7165,14009
202101,분당선,강남구청,7772,8837,16609
202101,분당선,압구정로데오,14027,14899,28926
202101,분당선,서울숲,6689,6803,13492
202101,분당선,수원,5691,4732,10423
202101,분당선,수서,9663,9973,19636
202101,분당선,대모산입구,2896,2720,5616
202101,분당선,개포동,2868,2953,5821
202101,분당선,구룡,1559,1510,3069
202101,분당선,도곡,5221,5222,10443
202101,분당선,한티,11219,11919,23138
202101,분당선,선릉,11616,16768,28384
202101,분당선,복정,1,0,1
202101,분당선,매교,2339,2247,4586
202101,분당선,수원시청,10323,10672,20995
202101,분당선,매탄권선,3770,3902,7672
202101,분당선,망포,11554,11623,23177
202101,분당선,영통,6247,6502,12749
202101,분당선,청명,3482,3689,7171
202101,분당선,상갈,4229,4734,8963
202101,분당선,기흥,7859,8984,16843
202101,분당선,신갈,3530,3859,7389
202101,분당선,구성,3722,4593,8315
202101,분당선,죽전,10406,12011,22417
202101,분당선,보정,1824,1842,3666
202101,분당선,이매,4181,4443,8624
202101,분당선,오리,9844,8767,18611
202101,분당선,미금,12908,13567,26475
202101,분당선,정자,13545,14442,27987
202101,분당선,수내,11501,11632,23133
202101,분당선,서현,19940,20557,40497
202101,분당선,야탑,22106,22926,45032
202101,분당선,모란,18112,16881,34993
202101,분당선,태평,12352,12703,25055
202101,분당선,가천대,6030,6683,12713
202101,분당선,선정릉,8171,7874,16045
202101,분당선,강남구청,9307,9586,18893
202101,분당선,압구정로데오,18355,15182,33537
202101,분당선,서울숲,7106,7214,14320
202101,분당선,수원,6033,5105,11138
202101,분당선,수서,10297,11059,21356
202101,분당선,대모산입구,2919,2990,5909
202101,분당선,개포동,2950,3392,6342
202101,분당선,구룡,1294,1498,2792
202101,분당선,도곡,5720,6099,11819
202101,분당선,한티,13642,13534,27176
202101,분당선,선릉,13679,17338,31017
202101,분당선,매교,2984,3064,6048
202101,분당선,수원시청,13655,13830,27485
202101,분당선,매탄권선,5738,5540,11278
202101,분당선,망포,17662,16577,34239
202101,분당선,영통,9256,8936,18192
202101,분당선,청명,6264,5290,11554
202101,분당선,상갈,6131,5800,11931
202101,분당선,기흥,11238,9811,21049
202101,분당선,신갈,5114,4788,9902
202101,분당선,구성,6187,5760,11947
202101,분당선,죽전,13122,14372,27494
202101,분당선,보정,2864,2349,5213
202101,분당선,이매,6811,6088,12899
202101,분당선,오리,12290,10702,22992
202101,분당선,미금,15996,17510,33506
202101,분당선,정자,17168,18625,35793
202101,분당선,수내,14584,14885,29469
202101,분당선,서현,25635,26486,52121
202101,분당선,야탑,33750,33489,67239
202101,분당선,모란,24562,21137,45699
202101,분당선,태평,15895,15606,31501
202101,분당선,가천대,7156,7772,14928
202101,분당선,선정릉,8024,8427,16451
202101,분당선,강남구청,9388,10590,19978
202101,분당선,압구정로데오,16334,17602,33936
202101,분당선,서울숲,7572,7764,15336
202101,분당선,수원,7983,6359,14342
202101,분당선,수서,12322,12803,25125
202101,분당선,대모산입구,3196,2961,6157
202101,분당선,개포동,3493,3442,6935
202101,분당선,구룡,1431,1435,2866
202101,분당선,도곡,6555,6332,12887
202101,분당선,한티,14372,14886,29258
202101,분당선,선릉,13084,19289,32373
202101,분당선,매교,2361,2398,4759
202101,분당선,수원시청,11437,12429,23866
202101,분당선,매탄권선,4906,4557,9463
202101,분당선,망포,14509,13739,28248
202101,분당선,영통,7623,7762,15385
202101,분당선,청명,4429,4140,8569
202101,분당선,상갈,4944,4769,9713
202101,분당선,기흥,8626,8034,16660
202101,분당선,신갈,4205,4073,8278
202101,분당선,구성,4551,4622,9173
202101,분당선,죽전,11665,12381,24046
202101,분당선,보정,2180,1796,3976
202101,분당선,이매,4938,4718,9656
202101,분당선,오리,10950,9125,20075
202101,분당선,미금,13722,14772,28494
202101,분당선,정자,14727,15668,30395
202101,분당선,수내,12369,12522,24891
202101,분당선,서현,22036,22476,44512
202101,분당선,야탑,23755,25499,49254
202101,분당선,모란,17243,17511,34754
202101,분당선,태평,12603,12058,24661
202101,분당선,가천대,5634,6424,12058
202101,분당선,선정릉,7279,7654,14933
202101,분당선,강남구청,8390,9371,17761
202101,분당선,압구정로데오,15386,16459,31845
202101,분당선,서울숲,6863,6917,13780
202101,분당선,수원,7036,5464,12500
202101,분당선,복정,1,0,1
202101,분당선,수서,11237,11931,23168
202101,분당선,대모산입구,2758,2578,5336
202101,분당선,개포동,2962,3080,6042
202101,분당선,구룡,1187,1158,2345
202101,분당선,도곡,5751,5767,11518
202101,분당선,한티,12382,13020,25402
202101,분당선,선릉,11760,17336,29096
202101,분당선,선릉,12193,17718,29911
202101,분당선,한티,11025,11832,22857
202101,분당선,도곡,5567,5580,11147
202101,분당선,구룡,1194,1212,2406
202101,분당선,개포동,2917,2950,5867
202101,분당선,대모산입구,2995,2778,5773
202101,분당선,수서,10050,10558,20608
202101,분당선,복정,1,0,1
202101,분당선,수원,6096,4923,11019
202101,분당선,서울숲,6712,6774,13486
202101,분당선,압구정로데오,13359,14229,27588
202101,분당선,강남구청,7972,9065,17037
202101,분당선,선정릉,7006,7440,14446
202101,분당선,가천대,5388,6358,11746
202101,분당선,태평,11432,11176,22608
202101,분당선,모란,16304,16519,32823
202101,분당선,야탑,21088,21979,43067
202101,분당선,서현,20282,20272,40554
202101,분당선,수내,10952,10892,21844
202101,분당선,정자,13192,14004,27196
202101,분당선,미금,13078,12758,25836
202101,분당선,오리,9941,8485,18426
202101,분당선,이매,4180,4037,8217
202101,분당선,보정,1885,1601,3486
202101,분당선,죽전,10300,11257,21557
202101,분당선,구성,3912,4103,8015
202101,분당선,신갈,3779,3677,7456
202101,분당선,기흥,7517,7187,14704
202101,분당선,상갈,4287,4151,8438
202101,분당선,청명,3376,3230,6606
202101,분당선,영통,6308,6468,12776
202101,분당선,망포,11648,11391,23039
202101,분당선,매탄권선,3885,3739,7624
202101,분당선,수원시청,10049,10508,20557
202101,분당선,매교,2197,2301,4498
202101,분당선,매교,2276,2452,4728
202101,분당선,수원시청,10532,11169,21701
202101,분당선,매탄권선,4222,4127,8349
202101,분당선,망포,12384,12532,24916
202101,분당선,영통,6631,7242,13873
202101,분당선,청명,3555,3936,7491
202101,분당선,상갈,4638,4898,9536
202101,분당선,기흥,7864,8648,16512
202101,분당선,신갈,3751,4142,7893
202101,분당선,구성,4063,5042,9105
202101,분당선,죽전,11070,12682,23752
202101,분당선,보정,2036,1907,3943
202101,분당선,이매,4909,4848,9757
202101,분당선,오리,10961,9376,20337
202101,분당선,미금,14045,13975,28020
202101,분당선,정자,15174,15990,31164
202101,분당선,수내,12946,12711,25657
202101,분당선,서현,22648,22901,45549
202101,분당선,야탑,25472,24972,50444
202101,분당선,모란,17843,17801,35644
202101,분당선,태평,12358,13162,25520
202101,분당선,가천대,5735,6719,12454
202101,분당선,선정릉,8407,8076,16483
202101,분당선,강남구청,9600,10297,19897
202101,분당선,압구정로데오,18014,16594,34608
202101,분당선,서울숲,7709,7591,15300
202101,분당선,수원,6417,5465,11882
202101,분당선,수서,11145,11907,23052
202101,분당선,대모산입구,3226,3154,6380
202101,분당선,개포동,3167,3506,6673
202101,분당선,구룡,1412,1471,2883
202101,분당선,도곡,6009,6207,12216
202101,분당선,한티,13358,13918,27276
202101,분당선,선릉,13851,18184,32035
202101,분당선,선릉,12205,18079,30284
202101,분당선,한티,12142,12648,24790
202101,분당선,도곡,5879,5782,11661
202101,분당선,구룡,1343,1312,2655
202101,분당선,개포동,3178,3252,6430
202101,분당선,대모산입구,3113,2913,6026
202101,분당선,수서,10647,11158,21805
202101,분당선,수원,6473,5215,11688
202101,분당선,서울숲,7434,7552,14986
202101,분당선,압구정로데오,14974,16280,31254
202101,분당선,강남구청,8641,9950,18591
202101,분당선,선정릉,7236,7802,15038
202101,분당선,가천대,5588,6485,12073
202101,분당선,태평,12366,11812,24178
202101,분당선,모란,17022,17429,34451
202101,분당선,야탑,23140,24498,47638
202101,분당선,서현,21248,21866,43114
202101,분당선,수내,11940,12117,24057
202101,분당선,정자,14230,15053,29283
202101,분당선,미금,13992,14985,28977
202101,분당선,오리,10928,9102,20030
202101,분당선,이매,4875,4606,9481
202101,분당선,보정,2286,1884,4170
202101,분당선,죽전,11373,12090,23463
202101,분당선,구성,4327,4336,8663
202101,분당선,신갈,4018,3881,7899
202101,분당선,기흥,8237,7602,15839
202101,분당선,상갈,4739,4471,9210
202101,분당선,청명,3609,3452,7061
202101,분당선,영통,6763,6742,13505
202101,분당선,망포,12377,11893,24270
202101,분당선,매탄권선,4178,4007,8185
202101,분당선,수원시청,10446,11011,21457
202101,분당선,매교,2319,2353,4672
202101,분당선,선릉,12304,17368,29672
202101,분당선,한티,11598,12241,23839
202101,분당선,도곡,5483,5432,10915
202101,분당선,구룡,1357,1341,2698
202101,분당선,개포동,2894,3012,5906
202101,분당선,대모산입구,3143,2893,6036
202101,분당선,수서,10481,11039,21520
202101,분당선,수원,6262,5118,11380
202101,분당선,서울숲,7337,7372,14709
202101,분당선,압구정로데오,15294,16388,31682
202101,분당선,강남구청,8285,9320,17605
202101,분당선,선정릉,7094,7619,14713
202101,분당선,가천대,5470,6323,11793
202101,분당선,태평,11856,11384,23240
202101,분당선,모란,19350,19819,39169
202101,분당선,야탑,21985,22918,44903
202101,분당선,서현,20549,20732,41281
202101,분당선,수내,11379,11526,22905
202101,분당선,정자,14053,14580,28633
202101,분당선,미금,13405,14294,27699
202101,분당선,오리,10437,8791,19228
202101,분당선,이매,4522,4198,8720
202101,분당선,보정,2064,1825,3889
202101,분당선,죽전,10789,11769,22558
202101,분당선,구성,4191,4399,8590
202101,분당선,신갈,3796,3830,7626
202101,분당선,기흥,7732,7511,15243
202101,분당선,상갈,4591,4386,8977
202101,분당선,청명,3496,3382,6878
202101,분당선,영통,6444,6545,12989
202101,분당선,망포,11739,11395,23134
202101,분당선,매탄권선,3912,3776,7688
202101,분당선,수원시청,9963,10437,20400
202101,분당선,매교,2286,2340,4626
202101,분당선,선릉,12154,17539,29693
202101,분당선,한티,11998,12671,24669
202101,분당선,도곡,5717,5581,11298
202101,분당선,구룡,1325,1289,2614
202101,분당선,개포동,3040,3128,6168
202101,분당선,대모산입구,2997,2778,5775
202101,분당선,수서,10962,11677,22639
202101,분당선,수원,6711,5517,12228
202101,분당선,서울숲,7257,7236,14493
202101,분당선,압구정로데오,16514,17604,34118
202101,분당선,강남구청,8775,9772,18547
202101,분당선,선정릉,7159,7608,14767
202101,분당선,가천대,5736,6393,12129
202101,분당선,태평,11891,11679,23570
202101,분당선,모란,17348,17351,34699
202101,분당선,야탑,22109,23348,45457
202101,분당선,서현,20816,21181,41997
202101,분당선,수내,11682,11757,23439
202101,분당선,정자,14155,14833,28988
202101,분당선,미금,13295,14212,27507
202101,분당선,오리,10383,8728,19111
202101,분당선,이매,4521,4300,8821
202101,분당선,보정,2020,1691,3711
202101,분당선,죽전,11441,12316,23757
202101,분당선,구성,4095,4332,8427
202101,분당선,신갈,3831,3769,7600
202101,분당선,기흥,8069,7587,15656
202101,분당선,상갈,4660,4479,9139
202101,분당선,청명,3496,3446,6942
202101,분당선,영통,6970,7059,14029
202101,분당선,망포,12614,11981,24595
202101,분당선,매탄권선,4105,3786,7891
202101,분당선,수원시청,10537,11520,22057
202101,분당선,매교,2299,2393,4692
202101,분당선,매교,2568,2615,5183
202101,분당선,수원시청,11688,12317,24005
202101,분당선,매탄권선,4647,4379,9026
202101,분당선,망포,13891,13206,27097
202101,분당선,영통,7587,7598,15185
202101,분당선,청명,4229,3906,8135
202101,분당선,상갈,5249,4960,10209
202101,분당선,기흥,8961,8193,17154
202101,분당선,신갈,4323,4208,8531
202101,분당선,구성,4755,4778,9533
202101,분당선,죽전,11571,12656,24227
202101,분당선,보정,2283,1963,4246
202101,분당선,이매,5096,4908,10004
202101,분당선,오리,11066,9470,20536
202101,분당선,미금,14848,15930,30778
202101,분당선,정자,15598,16366,31964
202101,분당선,수내,12600,12692,25292
202101,분당선,서현,22616,22763,45379
202101,분당선,태평,12380,12149,24529
202101,분당선,가천대,5635,6739,12374
202101,분당선,선정릉,7760,8105,15865
202101,분당선,강남구청,8873,10084,18957
202101,분당선,압구정로데오,15003,15988,30991
202101,분당선,서울숲,7528,7703,15231
202101,분당선,수원,7001,5572,12573
202101,분당선,복정,1,0,1
202101,분당선,수서,11338,11827,23165
202101,분당선,대모산입구,3174,2928,6102
202101,분당선,개포동,3241,3343,6584
202101,분당선,구룡,1393,1411,2804
202101,분당선,도곡,6127,6256,12383
202101,분당선,한티,12677,13533,26210
202101,분당선,선릉,12962,19142,32104
202101,분당선,야탑,24348,25338,49686
202101,분당선,모란,17267,17478,34745
202101,분당선,복정,1,0,1
202101,분당선,선릉,12753,18380,31133
202101,분당선,한티,12106,12694,24800
202101,분당선,도곡,5564,5611,11175
202101,분당선,구룡,1309,1327,2636
202101,분당선,개포동,3060,3178,6238
202101,분당선,대모산입구,3039,2842,5881
202101,분당선,수서,10319,10944,21263
202101,분당선,수원,6467,5344,11811
202101,분당선,서울숲,7434,7407,14841
202101,분당선,압구정로데오,15581,16716,32297
202101,분당선,강남구청,8497,9645,18142
202101,분당선,선정릉,7363,7821,15184
202101,분당선,가천대,5341,6318,11659
202101,분당선,태평,11796,11412,23208
202101,분당선,모란,17815,17989,35804
202101,분당선,야탑,22166,23134,45300
202101,분당선,서현,20668,20867,41535
202101,분당선,수내,11477,11570,23047
202101,분당선,정자,14483,15181,29664
202101,분당선,미금,13467,14336,27803
202101,분당선,오리,10251,8812,19063
202101,분당선,이매,4420,4261,8681
202101,분당선,보정,1983,1747,3730
202101,분당선,죽전,10866,11790,22656
202101,분당선,구성,4064,4329,8393
202101,분당선,신갈,3851,3874,7725
202101,분당선,기흥,7835,7520,15355
202101,분당선,상갈,4579,4465,9044
202101,분당선,청명,3446,3380,6826
202101,분당선,영통,6721,6892,13613
202101,분당선,망포,12139,11624,23763
202101,분당선,매탄권선,3910,3851,7761
202101,분당선,수원시청,10462,11019,21481
202101,분당선,매교,2267,2299,4566
202101,분당선,매교,2402,2520,4922
202101,분당선,수원시청,11001,11645,22646
202101,분당선,매탄권선,3940,3917,7857
202101,분당선,망포,12348,12046,24394
202101,분당선,영통,7031,7161,14192
202101,분당선,청명,3613,3478,7091
202101,분당선,상갈,4687,4592,9279
202101,분당선,기흥,8206,7903,16109
202101,분당선,신갈,4110,4026,8136
202101,분당선,구성,4371,4551,8922
202101,분당선,죽전,11339,12593,23932
202101,분당선,보정,2050,1841,3891
202101,분당선,이매,4666,4453,9119
202101,분당선,오리,10741,9108,19849
202101,분당선,미금,14125,14870,28995
202101,분당선,정자,14960,15727,30687
202101,분당선,수내,11748,11911,23659
202101,분당선,서현,21902,22052,43954
202101,분당선,야탑,23019,23953,46972
202101,분당선,모란,17261,17269,34530
202101,분당선,태평,12124,11931,24055
202101,분당선,가천대,5587,6562,12149
202101,분당선,선정릉,7543,7942,15485
202101,분당선,강남구청,8835,10099,18934
202101,분당선,압구정로데오,16024,17031,33055
202101,분당선,서울숲,7701,7832,15533
202101,분당선,수원,6732,5519,12251
202101,분당선,복정,1,0,1
202101,분당선,수서,10643,11006,21649
202101,분당선,대모산입구,3162,2958,6120
202101,분당선,개포동,3128,3328,6456
202101,분당선,구룡,1334,1303,2637
202101,분당선,도곡,5873,5798,11671
202101,분당선,한티,12628,13218,25846
202101,분당선,선릉,12787,18486,31273
202101,분당선,매교,2283,2383,4666
202101,분당선,수원시청,10481,11049,21530
202101,분당선,매탄권선,3999,3909,7908
202101,분당선,망포,11960,11567,23527
202101,분당선,영통,6704,6874,13578
202101,분당선,청명,3494,3459,6953
202101,분당선,상갈,4550,4438,8988
202101,분당선,기흥,8153,7748,15901
202101,분당선,신갈,3968,4012,7980
202101,분당선,구성,4282,4490,8772
202101,분당선,죽전,11095,12246,23341
202101,분당선,보정,1903,1663,3566
202101,분당선,이매,4438,4368,8806
202101,분당선,오리,10613,8954,19567
202101,분당선,미금,13371,14300,27671
202101,분당선,정자,14602,15459,30061
202101,분당선,수내,11816,11813,23629
202101,분당선,서현,20960,21170,42130
202101,분당선,야탑,22493,23510,46003
202101,분당선,모란,16909,16772,33681
202101,분당선,태평,11880,11575,23455
202101,분당선,가천대,5467,6424,11891
202101,분당선,선정릉,7716,8076,15792
202101,분당선,강남구청,8589,9914,18503
202101,분당선,압구정로데오,16201,17093,33294
202101,분당선,서울숲,7545,7556,15101
202101,분당선,수원,6418,5259,11677
202101,분당선,수서,10575,11160,21735
202101,분당선,대모산입구,3130,2937,6067
202101,분당선,개포동,3103,3281,6384
202101,분당선,구룡,1343,1386,2729
202101,분당선,도곡,5867,5880,11747
202101,분당선,한티,12463,13372,25835
202101,분당선,선릉,12932,18486,31418
202101,분당선,매교,2369,2411,4780
202101,분당선,수원시청,11296,12418,23714
202101,분당선,매탄권선,4299,3897,8196
202101,분당선,망포,12882,12182,25064
202101,분당선,영통,7390,7575,14965
202101,분당선,청명,3683,3503,7186
202101,분당선,상갈,4785,4606,9391
202101,분당선,기흥,8193,7946,16139
202101,분당선,신갈,4020,3997,8017
202101,분당선,구성,4324,4486,8810
202101,분당선,죽전,11816,12684,24500
202101,분당선,보정,2109,1803,3912
202101,분당선,이매,4653,4427,9080
202101,분당선,오리,10809,9257,20066
202101,분당선,미금,13995,14939,28934
202101,분당선,정자,15193,15986,31179
202101,분당선,수내,11913,12091,24004
202101,분당선,서현,22298,22839,45137
202101,분당선,야탑,23296,24375,47671
202101,분당선,모란,17745,17702,35447
202101,분당선,태평,12197,11919,24116
202101,분당선,가천대,5736,6452,12188
202101,분당선,선정릉,7433,7953,15386
202101,분당선,강남구청,8881,10059,18940
202101,분당선,압구정로데오,17515,18903,36418
202101,분당선,서울숲,7870,7832,15702
202101,분당선,수원,7072,5928,13000
202101,분당선,복정,1,0,1
202101,분당선,수서,11344,12037,23381
202101,분당선,대모산입구,3172,2885,6057
202101,분당선,개포동,3179,3317,6496
202101,분당선,구룡,1414,1382,2796
202101,분당선,도곡,6172,5945,12117
202101,분당선,한티,12939,13563,26502
202101,분당선,선릉,12709,18480,31189
202101,분당선,선릉,12937,18915,31852
202101,분당선,한티,12515,13197,25712
202101,분당선,도곡,6006,6037,12043
202101,분당선,구룡,1466,1411,2877
202101,분당선,개포동,3171,3280,6451
202101,분당선,대모산입구,3290,3114,6404
202101,분당선,수서,11041,11398,22439
202101,분당선,수원,6843,5662,12505
202101,분당선,서울숲,8011,8180,16191
202101,분당선,압구정로데오,15462,16560,32022
202101,분당선,강남구청,8784,9987,18771
202101,분당선,선정릉,7665,8146,15811
202101,분당선,가천대,5958,6821,12779
202101,분당선,태평,12345,12200,24545
202101,분당선,모란,17645,17944,35589
202101,분당선,야탑,23205,24280,47485
202101,분당선,서현,21980,21969,43949
202101,분당선,수내,11734,11673,23407
202101,분당선,정자,15133,15836,30969
202101,분당선,미금,13911,14734,28645
202101,분당선,오리,10893,9300,20193
202101,분당선,이매,4678,4443,9121
202101,분당선,보정,2099,1836,3935
202101,분당선,죽전,11438,12677,24115
202101,분당선,구성,4318,4536,8854
202101,분당선,신갈,4093,4112,8205
202101,분당선,기흥,8242,7901,16143
202101,분당선,상갈,4760,4630,9390
202101,분당선,청명,3622,3506,7128
202101,분당선,영통,6892,6972,13864
202101,분당선,망포,12419,12069,24488
202101,분당선,매탄권선,4066,3917,7983
202101,분당선,수원시청,11158,11660,22818
202101,분당선,매교,2391,2489,4880
202101,분당선,선릉,12936,18741,31677
202101,분당선,한티,12809,13438,26247
202101,분당선,도곡,6045,5949,11994
202101,분당선,구룡,1394,1381,2775
202101,분당선,개포동,3102,3258,6360
202101,분당선,대모산입구,3290,3056,6346
202101,분당선,수서,10897,11371,22268
202101,분당선,수원,6576,5293,11869
202101,분당선,서울숲,8029,8014,16043
202101,분당선,압구정로데오,16379,17479,33858
202101,분당선,강남구청,9073,10362,19435
202101,분당선,선정릉,7785,8182,15967
202101,분당선,가천대,5481,6425,11906
202101,분당선,태평,12058,11833,23891
202101,분당선,모란,17015,16980,33995
202101,분당선,야탑,22864,23778,46642
202101,분당선,서현,21392,21498,42890
202101,분당선,수내,11921,11946,23867
202101,분당선,정자,15012,15764,30776
202101,분당선,미금,13590,14623,28213
202101,분당선,오리,10535,8995,19530
202101,분당선,이매,4646,4531,9177
202101,분당선,보정,2050,1790,3840
202101,분당선,죽전,11295,12317,23612
202101,분당선,구성,4261,4466,8727
202101,분당선,신갈,3981,3891,7872
202101,분당선,기흥,8029,7732,15761
202101,분당선,상갈,4709,4535,9244
202101,분당선,청명,3580,3502,7082
202101,분당선,영통,6779,6864,13643
202101,분당선,망포,12056,11822,23878
202101,분당선,매탄권선,3915,3805,7720
202101,분당선,수원시청,10675,11220,21895
202101,분당선,매교,2393,2386,4779
202101,분당선,선릉,13280,18985,32265
202101,분당선,한티,13206,13859,27065
202101,분당선,도곡,6205,6199,12404
202101,분당선,구룡,1484,1464,2948
202101,분당선,개포동,3219,3254,6473
202101,분당선,대모산입구,3328,3177,6505
202101,분당선,수서,10990,11604,22594
202101,분당선,수원,7053,5781,12834
202101,분당선,서울숲,8545,8711,17256
202101,분당선,압구정로데오,16647,17554,34201
202101,분당선,강남구청,9153,10374,19527
202101,분당선,선정릉,7798,8358,16156
202101,분당선,가천대,6113,6871,12984
202101,분당선,태평,12516,12275,24791
202101,분당선,모란,18017,18110,36127
202101,분당선,야탑,23792,24824,48616
202101,분당선,서현,22946,23053,45999
202101,분당선,수내,12427,12581,25008
202101,분당선,정자,15364,16230,31594
202101,분당선,미금,14338,15301,29639
202101,분당선,오리,11187,9565,20752
202101,분당선,이매,4820,4717,9537
202101,분당선,보정,2145,1926,4071
202101,분당선,죽전,11893,12954,24847
202101,분당선,구성,4498,4730,9228
202101,분당선,신갈,4154,4165,8319
202101,분당선,기흥,8408,8157,16565
202101,분당선,상갈,4957,4778,9735
202101,분당선,청명,3748,3610,7358
202101,분당선,영통,7732,7757,15489
202101,분당선,망포,12654,12323,24977
202101,분당선,매탄권선,4224,4058,8282
202101,분당선,수원시청,11166,11830,22996
202101,분당선,매교,2457,2557,5014
202101,분당선,선릉,13079,18868,31947
202101,분당선,한티,12958,13827,26785
202101,분당선,도곡,6070,5980,12050
202101,분당선,구룡,1623,1619,3242
202101,분당선,개포동,3242,3357,6599
202101,분당선,대모산입구,3252,3053,6305
202101,분당선,수서,11125,11604,22729
202101,분당선,수원,6659,5517,12176
202101,분당선,서울숲,7982,8052,16034
202101,분당선,압구정로데오,16374,17671,34045
202101,분당선,강남구청,9030,10464,19494
202101,분당선,선정릉,7893,8382,16275
202101,분당선,가천대,5556,6498,12054
202101,분당선,태평,12127,11925,24052
202101,분당선,모란,17304,17356,34660
202101,분당선,야탑,23177,24369,47546
202101,분당선,서현,22455,22624,45079
202101,분당선,수내,12235,12407,24642
202101,분당선,정자,15764,16425,32189
202101,분당선,미금,14316,15290,29606
202101,분당선,오리,11187,9300,20487
202101,분당선,이매,4849,4745,9594
202101,분당선,보정,2185,1919,4104
202101,분당선,죽전,11634,12798,24432
202101,분당선,구성,4391,4612,9003
202101,분당선,신갈,4100,4059,8159
202101,분당선,기흥,8305,7927,16232
202101,분당선,상갈,4850,4573,9423
202101,분당선,청명,3753,3637,7390
202101,분당선,영통,7213,7243,14456
202101,분당선,망포,12781,12298,25079
202101,분당선,매탄권선,4141,4068,8209
202101,분당선,수원시청,10829,11449,22278
202101,분당선,매교,2350,2433,4783
202101,분당선,선릉,12599,18133,30732
202101,분당선,한티,12899,13339,26238
202101,분당선,도곡,5994,5905,11899
202101,분당선,구룡,1470,1441,2911
202101,분당선,개포동,3047,3280,6327
202101,분당선,대모산입구,3060,2855,5915
202101,분당선,수서,11028,11843,22871
202101,분당선,수원,6828,5742,12570
202101,분당선,서울숲,7732,7590,15322
202101,분당선,압구정로데오,17420,18055,35475
202101,분당선,강남구청,8874,9890,18764
202101,분당선,선정릉,7657,7891,15548
202101,분당선,가천대,5929,6759,12688
202101,분당선,태평,12076,11971,24047
202101,분당선,모란,18887,19786,38673
202101,분당선,야탑,22926,24025,46951
202101,분당선,서현,22566,23152,45718
202101,분당선,수내,11928,11953,23881
202101,분당선,정자,15217,16223,31440
202101,분당선,미금,13894,14941,28835
202101,분당선,오리,10757,9438,20195
202101,분당선,이매,4669,4855,9524
202101,분당선,보정,1985,1748,3733
202101,분당선,죽전,11528,12701,24229
202101,분당선,구성,4142,4399,8541
202101,분당선,신갈,4054,4118,8172
202101,분당선,기흥,8258,7866,16124
202101,분당선,상갈,4745,4500,9245
202101,분당선,청명,3617,3499,7116
202101,분당선,영통,7250,7373,14623
202101,분당선,망포,12941,12201,25142
202101,분당선,매탄권선,4182,3970,8152
202101,분당선,수원시청,10972,11890,22862
202101,분당선,매교,2286,2432,4718
202102,분당선,매교,2457,2464,4921
202102,분당선,수원시청,11154,11461,22615
202102,분당선,매탄권선,4196,4086,8282
202102,분당선,망포,12527,12327,24854
202102,분당선,영통,7223,7330,14553
202102,분당선,청명,3753,3551,7304
202102,분당선,상갈,4735,4603,9338
202102,분당선,기흥,8218,7968,16186
202102,분당선,신갈,4164,4158,8322
202102,분당선,구성,4352,4590,8942
202102,분당선,죽전,11450,12644,24094
202102,분당선,보정,2121,1859,3980
202102,분당선,이매,4854,4644,9498
202102,분당선,오리,10915,9317,20232
202102,분당선,미금,14510,15448,29958
202102,분당선,정자,15430,16120,31550
202102,분당선,수내,12028,11916,23944
202102,분당선,서현,22851,22912,45763
202102,분당선,야탑,23226,24403,47629
202102,분당선,모란,18022,18141,36163
202102,분당선,태평,12409,12212,24621
202102,분당선,가천대,5796,6773,12569
202102,분당선,선정릉,7659,8217,15876
202102,분당선,강남구청,9123,10381,19504
202102,분당선,압구정로데오,15980,16978,32958
202102,분당선,서울숲,7930,8060,15990
202102,분당선,수원,6870,5592,12462
202102,분당선,수서,10975,11588,22563
202102,분당선,대모산입구,3236,2965,6201
202102,분당선,개포동,3221,3333,6554
202102,분당선,구룡,1465,1478,2943
202102,분당선,도곡,6153,6241,12394
202102,분당선,한티,12657,13416,26073
202102,분당선,선릉,13074,19017,32091
202102,분당선,복정,1,0,1
202102,분당선,매교,2349,2448,4797
202102,분당선,수원시청,10971,11371,22342
202102,분당선,매탄권선,3997,4014,8011
202102,분당선,망포,12453,12084,24537
202102,분당선,영통,7107,7202,14309
202102,분당선,청명,3667,3558,7225
202102,분당선,상갈,4783,4711,9494
202102,분당선,기흥,8340,8039,16379
202102,분당선,신갈,4121,4225,8346
202102,분당선,구성,4454,4714,9168
202102,분당선,죽전,11678,12782,24460
202102,분당선,보정,2145,1805,3950
202102,분당선,이매,4695,4524,9219
202102,분당선,오리,11062,9338,20400
202102,분당선,미금,14087,15007,29094
202102,분당선,정자,15549,16316,31865
202102,분당선,수내,11994,11979,23973
202102,분당선,서현,22415,22736,45151
202102,분당선,야탑,23064,23818,46882
202102,분당선,모란,17756,17857,35613
202102,분당선,태평,12240,12075,24315
202102,분당선,가천대,5712,6600,12312
202102,분당선,선정릉,8003,8414,16417
202102,분당선,강남구청,9272,10430,19702
202102,분당선,압구정로데오,16528,17670,34198
202102,분당선,서울숲,8007,8002,16009
202102,분당선,수원,6869,5625,12494
202102,분당선,수서,10888,11375,22263
202102,분당선,대모산입구,3143,2997,6140
202102,분당선,개포동,3236,3343,6579
202102,분당선,구룡,1504,1516,3020
202102,분당선,도곡,5966,6088,12054
202102,분당선,한티,13015,13700,26715
202102,분당선,선릉,12948,16633,29581
202102,분당선,선릉,13602,19239,32841
202102,분당선,한티,13830,14475,28305
202102,분당선,도곡,6551,6669,13220
202102,분당선,구룡,1590,1596,3186
202102,분당선,개포동,3465,3713,7178
202102,분당선,대모산입구,3341,3206,6547
202102,분당선,수서,11392,11994,23386
202102,분당선,수원,7018,5753,12771
202102,분당선,서울숲,8419,8452,16871
202102,분당선,압구정로데오,17854,18286,36140
202102,분당선,강남구청,9704,10849,20553
202102,분당선,선정릉,8315,8562,16877
202102,분당선,가천대,5869,6955,12824
202102,분당선,태평,12730,12679,25409
202102,분당선,모란,18276,18547,36823
202102,분당선,야탑,24629,25549,50178
202102,분당선,서현,23618,23595,47213
202102,분당선,수내,13069,12969,26038
202102,분당선,정자,16427,17419,33846
202102,분당선,미금,14820,15658,30478
202102,분당선,오리,11650,10000,21650
202102,분당선,이매,5104,4989,10093
202102,분당선,보정,2220,1982,4202
202102,분당선,죽전,12054,13544,25598
202102,분당선,구성,4651,5034,9685
202102,분당선,신갈,4343,4380,8723
202102,분당선,기흥,8611,8487,17098
202102,분당선,상갈,4961,4844,9805
202102,분당선,청명,3772,3722,7494
202102,분당선,영통,7331,7567,14898
202102,분당선,망포,13055,12753,25808
202102,분당선,매탄권선,4271,4330,8601
202102,분당선,수원시청,11385,12001,23386
202102,분당선,매교,2405,2477,4882
202102,분당선,복정,2,0,2
202102,분당선,오리,12147,10311,22458
202102,분당선,이매,5338,5146,10484
202102,분당선,보정,2453,2049,4502
202102,분당선,죽전,12731,13870,26601
202102,분당선,구성,4901,5045,9946
202102,분당선,신갈,4549,4493,9042
202102,분당선,기흥,9407,8742,18149
202102,분당선,상갈,5321,5019,10340
202102,분당선,청명,4316,4000,8316
202102,분당선,영통,7998,8025,16023
202102,분당선,망포,14466,13860,28326
202102,분당선,매탄권선,4955,4711,9666
202102,분당선,수원시청,12341,12813,25154
202102,분당선,매교,2572,2604,5176
202102,분당선,선릉,13274,19846,33120
202102,분당선,한티,13562,14374,27936
202102,분당선,도곡,6334,6449,12783
202102,분당선,구룡,1568,1590,3158
202102,분당선,개포동,3461,3548,7009
202102,분당선,대모산입구,3424,3144,6568
202102,분당선,수서,11708,12285,23993
202102,분당선,복정,1,0,1
202102,분당선,수원,7560,6027,13587
202102,분당선,서울숲,8461,8615,17076
202102,분당선,압구정로데오,17608,19113,36721
202102,분당선,강남구청,9352,10813,20165
202102,분당선,선정릉,8130,8681,16811
202102,분당선,가천대,5802,6888,12690
202102,분당선,태평,13151,12629,25780
202102,분당선,모란,21446,22104,43550
202102,분당선,야탑,25089,26361,51450
202102,분당선,서현,24348,24212,48560
202102,분당선,수내,13489,13486,26975
202102,분당선,정자,17299,18159,35458
202102,분당선,미금,15284,16223,31507
202102,분당선,매교,2464,2606,5070
202102,분당선,수원시청,11843,13070,24913
202102,분당선,매탄권선,4516,4391,8907
202102,분당선,망포,13631,12898,26529
202102,분당선,영통,7938,7971,15909
202102,분당선,청명,3880,3636,7516
202102,분당선,상갈,5029,4967,9996
202102,분당선,기흥,8944,8469,17413
202102,분당선,신갈,4408,4355,8763
202102,분당선,구성,4590,4838,9428
202102,분당선,죽전,12657,13799,26456
202102,분당선,보정,2241,1950,4191
202102,분당선,이매,4906,4772,9678
202102,분당선,오리,11815,9871,21686
202102,분당선,미금,15033,15824,30857
202102,분당선,정자,16530,17567,34097
202102,분당선,수내,12690,12811,25501
202102,분당선,서현,24109,24354,48463
202102,분당선,야탑,24586,25858,50444
202102,분당선,모란,19070,19179,38249
202102,분당선,태평,12850,12661,25511
202102,분당선,가천대,5967,6799,12766
202102,분당선,선정릉,8137,8596,16733
202102,분당선,강남구청,9673,10811,20484
202102,분당선,압구정로데오,19205,20829,40034
202102,분당선,서울숲,8469,8474,16943
202102,분당선,수원,7598,6232,13830
202102,분당선,수서,11735,12457,24192
202102,분당선,대모산입구,3280,3008,6288
202102,분당선,개포동,3433,3480,6913
202102,분당선,구룡,1803,1805,3608
202102,분당선,도곡,6536,6396,12932
202102,분당선,한티,13771,14414,28185
202102,분당선,선릉,13256,19262,32518
202102,분당선,선릉,13544,19369,32913
202102,분당선,한티,13384,14160,27544
202102,분당선,도곡,6402,6532,12934
202102,분당선,구룡,1572,1572,3144
202102,분당선,개포동,3326,3458,6784
202102,분당선,대모산입구,3284,3048,6332
202102,분당선,수서,11149,11933,23082
202102,분당선,복정,1,0,1
202102,분당선,수원,7064,5656,12720
202102,분당선,서울숲,7898,8126,16024
202102,분당선,압구정로데오,16768,17826,34594
202102,분당선,강남구청,9219,10397,19616
202102,분당선,선정릉,8115,8573,16688
202102,분당선,가천대,5791,6761,12552
202102,분당선,태평,12624,12430,25054
202102,분당선,모란,18357,18338,36695
202102,분당선,야탑,24160,25202,49362
202102,분당선,서현,23604,23642,47246
202102,분당선,수내,12567,12472,25039
202102,분당선,정자,16411,17332,33743
202102,분당선,미금,14563,15730,30293
202102,분당선,오리,11610,9792,21402
202102,분당선,이매,4907,4765,9672
202102,분당선,보정,2154,1922,4076
202102,분당선,죽전,11989,13129,25118
202102,분당선,구성,4519,4688,9207
202102,분당선,신갈,4288,4299,8587
202102,분당선,기흥,8530,8188,16718
202102,분당선,상갈,4918,4808,9726
202102,분당선,청명,3760,3641,7401
202102,분당선,영통,7392,7507,14899
202102,분당선,망포,12776,12299,25075
202102,분당선,매탄권선,4236,4056,8292
202102,분당선,수원시청,11350,11902,23252
202102,분당선,매교,2407,2534,4941
202102,분당선,태평,13140,12825,25965
202102,분당선,모란,22857,23285,46142
202102,분당선,야탑,24771,25989,50760
202102,분당선,서현,24005,24106,48111
202102,분당선,수내,12573,12542,25115
202102,분당선,정자,16617,17513,34130
202102,분당선,미금,14829,15826,30655
202102,분당선,오리,11722,9857,21579
202102,분당선,이매,5162,4968,10130
202102,분당선,보정,2270,1974,4244
202102,분당선,죽전,12189,13359,25548
202102,분당선,구성,4480,4688,9168
202102,분당선,신갈,4248,4291,8539
202102,분당선,기흥,8624,8249,16873
202102,분당선,상갈,5032,4967,9999
202102,분당선,청명,3840,3676,7516
202102,분당선,영통,7556,7594,15150
202102,분당선,망포,13018,12373,25391
202102,분당선,매탄권선,4207,4105,8312
202102,분당선,수원시청,11349,11955,23304
202102,분당선,매교,2453,2497,4950
202102,분당선,복정,1,0,1
202102,분당선,수서,11328,12422,23750
202102,분당선,대모산입구,3323,3122,6445
202102,분당선,개포동,3358,3478,6836
202102,분당선,구룡,1525,1537,3062
202102,분당선,도곡,6577,6603,13180
202102,분당선,한티,13922,14686,28608
202102,분당선,선릉,13355,19284,32639
202102,분당선,수원,7189,5939,13128
202102,분당선,서울숲,8493,8461,16954
202102,분당선,압구정로데오,18838,19744,38582
202102,분당선,강남구청,9555,10971,20526
202102,분당선,선정릉,8172,8602,16774
202102,분당선,가천대,5838,6540,12378
202102,분당선,매교,2235,2268,4503
202102,분당선,선릉,11506,16711,28217
202102,분당선,한티,13618,13791,27409
202102,분당선,도곡,6368,6124,12492
202102,분당선,구룡,1370,1293,2663
202102,분당선,개포동,3146,3327,6473
202102,분당선,대모산입구,2987,2700,5687
202102,분당선,수서,10750,12511,23261
202102,분당선,수원,7562,6599,14161
202102,분당선,서울숲,7959,7794,15753
202102,분당선,압구정로데오,17759,19144,36903
202102,분당선,강남구청,8791,9865,18656
202102,분당선,선정릉,6862,7302,14164
202102,분당선,가천대,5211,5567,10778
202102,분당선,태평,12883,12765,25648
202102,분당선,모란,18627,18462,37089
202102,분당선,야탑,23776,25918,49694
202102,분당선,서현,23581,24035,47616
202102,분당선,수내,11856,11863,23719
202102,분당선,정자,15502,16353,31855
202102,분당선,미금,14371,15047,29418
202102,분당선,오리,10909,9327,20236
202102,분당선,이매,4831,4606,9437
202102,분당선,보정,2032,1834,3866
202102,분당선,죽전,12594,13435,26029
202102,분당선,구성,4155,4484,8639
202102,분당선,신갈,4090,4074,8164
202102,분당선,기흥,8457,8115,16572
202102,분당선,상갈,4881,4750,9631
202102,분당선,청명,3518,3422,6940
202102,분당선,영통,7572,7344,14916
202102,분당선,망포,13387,11906,25293
202102,분당선,매탄권선,4502,3973,8475
202102,분당선,수원시청,11481,12311,23792
202102,분당선,매교,1040,1052,2092
202102,분당선,수원시청,5070,4836,9906
202102,분당선,매탄권선,1702,1593,3295
202102,분당선,망포,4815,4123,8938
202102,분당선,영통,3439,3033,6472
202102,분당선,청명,1338,1265,2603
202102,분당선,상갈,2104,2168,4272
202102,분당선,기흥,3624,3578,7202
202102,분당선,신갈,1426,1504,2930
202102,분당선,구성,1584,1891,3475
202102,분당선,죽전,4800,5303,10103
202102,분당선,보정,745,760,1505
202102,분당선,이매,2016,2052,4068
202102,분당선,오리,4143,3489,7632
202102,분당선,미금,5649,5713,11362
202102,분당선,정자,5366,5085,10451
202102,분당선,수내,4647,4079,8726
202102,분당선,서현,9139,9016,18155
202102,분당선,야탑,8875,10180,19055
202102,분당선,모란,8442,8558,17000
202102,분당선,태평,6188,5933,12121
202102,분당선,가천대,2426,2450,4876
202102,분당선,선정릉,1393,1224,2617
202102,분당선,강남구청,1845,1996,3841
202102,분당선,압구정로데오,7069,7563,14632
202102,분당선,서울숲,2798,2594,5392
202102,분당선,수원,4561,3853,8414
202102,분당선,수서,4063,5750,9813
202102,분당선,대모산입구,983,885,1868
202102,분당선,개포동,1055,1019,2074
202102,분당선,구룡,476,413,889
202102,분당선,도곡,1966,1792,3758
202102,분당선,한티,4425,3985,8410
202102,분당선,선릉,1809,2277,4086
202102,분당선,선릉,945,1357,2302
202102,분당선,한티,2304,2418,4722
202102,분당선,도곡,1115,1035,2150
202102,분당선,구룡,288,297,585
202102,분당선,개포동,669,682,1351
202102,분당선,대모산입구,741,735,1476
202102,분당선,수서,3597,3751,7348
202102,분당선,수원,3670,2708,6378
202102,분당선,서울숲,1805,1758,3563
202102,분당선,압구정로데오,2074,2498,4572
202102,분당선,강남구청,943,1115,2058
202102,분당선,선정릉,753,762,1515
202102,분당선,가천대,1825,2122,3947
202102,분당선,태평,4298,4040,8338
202102,분당선,모란,5464,5674,11138
202102,분당선,야탑,5952,6008,11960
202102,분당선,서현,5401,5449,10850
202102,분당선,수내,2052,1976,4028
202102,분당선,정자,3187,3307,6494
202102,분당선,미금,3550,3617,7167
202102,분당선,오리,2600,2086,4686
202102,분당선,이매,1296,1295,2591
202102,분당선,보정,551,487,1038
202102,분당선,죽전,3075,3654,6729
202102,분당선,구성,1162,1247,2409
202102,분당선,신갈,1024,1099,2123
202102,분당선,기흥,2728,2548,5276
202102,분당선,상갈,1523,1534,3057
202102,분당선,청명,952,903,1855
202102,분당선,영통,2018,2081,4099
202102,분당선,망포,2999,2943,5942
202102,분당선,매탄권선,1235,1191,2426
202102,분당선,수원시청,3311,3642,6953
202102,분당선,매교,723,731,1454
202102,분당선,서울숲,8242,8372,16614
202102,분당선,압구정로데오,16158,17136,33294
202102,분당선,강남구청,8779,9892,18671
202102,분당선,선정릉,7375,7888,15263
202102,분당선,가천대,5114,6187,11301
202102,분당선,태평,12248,12130,24378
202102,분당선,모란,17721,17850,35571
202102,분당선,야탑,23701,24605,48306
202102,분당선,서현,23230,23259,46489
202102,분당선,수내,12022,12132,24154
202102,분당선,정자,15537,16457,31994
202102,분당선,미금,14479,15478,29957
202102,분당선,오리,10872,9277,20149
202102,분당선,이매,4778,4638,9416
202102,분당선,보정,2128,1899,4027
202102,분당선,죽전,11606,12994,24600
202102,분당선,구성,4361,4614,8975
202102,분당선,신갈,4099,4094,8193
202102,분당선,기흥,8444,8180,16624
202102,분당선,상갈,4717,4575,9292
202102,분당선,청명,3777,3542,7319
202102,분당선,영통,7261,7435,14696
202102,분당선,망포,12435,12301,24736
202102,분당선,매탄권선,4121,4046,8167
202102,분당선,수원시청,11552,12070,23622
202102,분당선,매교,2378,2455,4833
202102,분당선,선릉,12726,18585,31311
202102,분당선,한티,12710,13520,26230
202102,분당선,도곡,5955,6032,11987
202102,분당선,구룡,1412,1416,2828
202102,분당선,개포동,3195,3340,6535
202102,분당선,대모산입구,3116,2917,6033
202102,분당선,수서,12256,11390,23646
202102,분당선,복정,1,0,1
202102,분당선,수원,7239,6099,13338
202102,분당선,매교,2378,2494,4872
202102,분당선,수원시청,11839,12359,24198
202102,분당선,매탄권선,4339,4224,8563
202102,분당선,망포,13227,12848,26075
202102,분당선,영통,7492,7746,15238
202102,분당선,청명,3910,3835,7745
202102,분당선,상갈,5065,4884,9949
202102,분당선,기흥,8792,8382,17174
202102,분당선,신갈,4227,4208,8435
202102,분당선,구성,4450,4716,9166
202102,분당선,죽전,11970,13222,25192
202102,분당선,보정,2159,1870,4029
202102,분당선,이매,5153,4945,10098
202102,분당선,오리,11154,9427,20581
202102,분당선,미금,15015,15764,30779
202102,분당선,정자,16596,17534,34130
202102,분당선,수내,12595,12718,25313
202102,분당선,서현,23592,23835,47427
202102,분당선,야탑,24580,25402,49982
202102,분당선,모란,18036,18199,36235
202102,분당선,태평,12393,12195,24588
202102,분당선,가천대,5824,6698,12522
202102,분당선,선정릉,8167,8675,16842
202102,분당선,강남구청,9542,10691,20233
202102,분당선,압구정로데오,17510,18922,36432
202102,분당선,서울숲,8833,8855,17688
202102,분당선,수원,7229,6053,13282
202102,분당선,수서,12792,12598,25390
202102,분당선,대모산입구,3235,3039,6274
202102,분당선,개포동,3262,3460,6722
202102,분당선,구룡,1555,1544,3099
202102,분당선,도곡,6203,6219,12422
202102,분당선,한티,13364,14264,27628
202102,분당선,선릉,13461,19645,33106
202102,분당선,선릉,13518,19746,33264
202102,분당선,한티,13430,14190,27620
202102,분당선,도곡,5900,6041,11941
202102,분당선,구룡,1524,1509,3033
202102,분당선,개포동,3415,3539,6954
202102,분당선,대모산입구,3142,3011,6153
202102,분당선,수서,12370,12662,25032
202102,분당선,수원,7092,5846,12938
202102,분당선,서울숲,8334,8463,16797
202102,분당선,압구정로데오,17498,18665,36163
202102,분당선,강남구청,9545,10737,20282
202102,분당선,선정릉,8310,8737,17047
202102,분당선,가천대,5634,6651,12285
202102,분당선,태평,12274,12049,24323
202102,분당선,모란,17327,17490,34817
202102,분당선,야탑,24138,25010,49148
202102,분당선,서현,23226,23435,46661
202102,분당선,수내,12350,12401,24751
202102,분당선,정자,16313,17341,33654
202102,분당선,미금,14234,15203,29437
202102,분당선,오리,10921,9256,20177
202102,분당선,이매,4922,4684,9606
202102,분당선,보정,2131,1887,4018
202102,분당선,죽전,11715,13044,24759
202102,분당선,구성,4258,4591,8849
202102,분당선,신갈,4026,4025,8051
202102,분당선,기흥,8609,8169,16778
202102,분당선,상갈,4883,4684,9567
202102,분당선,청명,3761,3591,7352
202102,분당선,영통,7432,7654,15086
202102,분당선,망포,12807,12442,25249
202102,분당선,매탄권선,4269,4073,8342
202102,분당선,수원시청,11480,12190,23670
202102,분당선,매교,2366,2391,4757
202102,분당선,서현,23399,23546,46945
202102,분당선,수내,12376,12451,24827
202102,분당선,정자,16574,17350,33924
202102,분당선,미금,14447,15399,29846
202102,분당선,오리,11079,9429,20508
202102,분당선,이매,5025,4742,9767
202102,분당선,보정,2173,1865,4038
202102,분당선,죽전,12156,13494,25650
202102,분당선,구성,4362,4590,8952
202102,분당선,신갈,4029,4069,8098
202102,분당선,기흥,8439,8166,16605
202102,분당선,상갈,4864,4671,9535
202102,분당선,청명,3773,3618,7391
202102,분당선,영통,7432,7569,15001
202102,분당선,망포,13015,12510,25525
202102,분당선,매탄권선,4248,4102,8350
202102,분당선,수원시청,11430,11985,23415
202102,분당선,매교,2475,2523,4998
202102,분당선,선릉,13709,19643,33352
202102,분당선,한티,13129,14063,27192
202102,분당선,도곡,6047,6011,12058
202102,분당선,구룡,1551,1494,3045
202102,분당선,개포동,3262,3405,6667
202102,분당선,대모산입구,3050,2908,5958
202102,분당선,수서,12523,13008,25531
202102,분당선,복정,1,0,1
202102,분당선,수원,7219,5936,13155
202102,분당선,서울숲,8754,8837,17591
202102,분당선,압구정로데오,18224,19540,37764
202102,분당선,강남구청,9520,10713,20233
202102,분당선,선정릉,8157,8570,16727
202102,분당선,가천대,5624,6674,12298
202102,분당선,태평,12289,12115,24404
202102,분당선,모란,17970,17889,35859
202102,분당선,야탑,23852,24834,48686
202102,분당선,수원,8124,6890,15014
202102,분당선,서울숲,9156,9208,18364
202102,분당선,압구정로데오,20510,22456,42966
202102,분당선,강남구청,9995,11353,21348
202102,분당선,선정릉,8271,8750,17021
202102,분당선,가천대,5945,6800,12745
202102,분당선,태평,13344,12771,26115
202102,분당선,모란,23006,23664,46670
202102,분당선,야탑,25419,26663,52082
202102,분당선,서현,25176,25516,50692
202102,분당선,수내,13137,13212,26349
202102,분당선,정자,17495,15833,33328
202102,분당선,미금,15365,16298,31663
202102,분당선,오리,11881,9790,21671
202102,분당선,기흥,8955,8747,17702
202102,분당선,상갈,5331,5049,10380
202102,분당선,청명,4009,3799,7808
202102,분당선,영통,8158,8379,16537
202102,분당선,망포,14317,13429,27746
202102,분당선,매탄권선,4668,4441,9109
202102,분당선,수원시청,12461,13552,26013
202102,분당선,매교,2639,2728,5367
202102,분당선,이매,5425,5071,10496
202102,분당선,보정,2317,1985,4302
202102,분당선,죽전,13273,14514,27787
202102,분당선,구성,4702,4877,9579
202102,분당선,신갈,4445,4348,8793
202102,분당선,선릉,13671,19971,33642
202102,분당선,한티,14037,14797,28834
202102,분당선,도곡,6630,6487,13117
202102,분당선,구룡,1584,1517,3101
202102,분당선,개포동,3588,3675,7263
202102,분당선,대모산입구,3357,3117,6474
202102,분당선,수서,13879,14700,28579
202102,분당선,선릉,13636,19917,33553
202102,분당선,한티,13078,14085,27163
202102,분당선,도곡,6360,6409,12769
202102,분당선,구룡,1763,1725,3488
202102,분당선,개포동,3432,3613,7045
202102,분당선,대모산입구,3369,3154,6523
202102,분당선,수서,12631,12977,25608
202102,분당선,복정,1,0,1
202102,분당선,수원,7488,6371,13859
202102,분당선,서울숲,8980,9005,17985
202102,분당선,압구정로데오,16896,18092,34988
202102,분당선,강남구청,9423,10639,20062
202102,분당선,선정릉,8255,8651,16906
202102,분당선,가천대,5829,6834,12663
202102,분당선,태평,12946,12641,25587
202102,분당선,모란,18721,18607,37328
202102,분당선,야탑,24697,25416,50113
202102,분당선,서현,23875,23878,47753
202102,분당선,수내,12464,12521,24985
202102,분당선,정자,16891,14365,31256
202102,분당선,미금,15146,16010,31156
202102,분당선,오리,11582,9590,21172
202102,분당선,이매,5079,5113,10192
202102,분당선,보정,2310,2053,4363
202102,분당선,죽전,12294,13409,25703
202102,분당선,구성,4547,4803,9350
202102,분당선,신갈,4297,4379,8676
202102,분당선,기흥,9029,8627,17656
202102,분당선,상갈,5155,4916,10071
202102,분당선,청명,3929,3847,7776
202102,분당선,영통,7788,7865,15653
202102,분당선,망포,13274,12765,26039
202102,분당선,매탄권선,4467,4312,8779
202102,분당선,수원시청,11902,12501,24403
202102,분당선,매교,2632,2681,5313
202102,분당선,수원시청,11778,12442,24220
202102,분당선,매탄권선,4395,4304,8699
202102,분당선,망포,13279,12851,26130
202102,분당선,영통,7767,7835,15602
202102,분당선,청명,3847,3695,7542
202102,분당선,상갈,5078,5056,10134
202102,분당선,기흥,8870,8381,17251
202102,분당선,신갈,4381,4315,8696
202102,분당선,구성,4622,4882,9504
202102,분당선,죽전,12153,13557,25710
202102,분당선,보정,2383,2102,4485
202102,분당선,이매,5010,4932,9942
202102,분당선,오리,11369,9540,20909
202102,분당선,미금,14899,15773,30672
202102,분당선,정자,16894,15854,32748
202102,분당선,수내,12783,12879,25662
202102,분당선,서현,23839,24087,47926
202102,분당선,야탑,24528,25368,49896
202102,분당선,모란,18740,18698,37438
202102,분당선,태평,12942,12708,25650
202102,분당선,가천대,6233,7194,13427
202102,분당선,선정릉,8168,8718,16886
202102,분당선,강남구청,9535,10960,20495
202102,분당선,압구정로데오,17991,19538,37529
202102,분당선,서울숲,9022,9040,18062
202102,분당선,수원,7504,6269,13773
202102,분당선,수서,12723,13143,25866
202102,분당선,대모산입구,3289,3114,6403
202102,분당선,개포동,3668,3770,7438
202102,분당선,구룡,1782,1756,3538
202102,분당선,도곡,6362,6366,12728
202102,분당선,한티,13457,14322,27779
202102,분당선,선릉,13689,20102,33791
202102,분당선,복정,1,0,1
202102,분당선,매교,2580,2657,5237
202102,분당선,매교,2650,2772,5422
202102,분당선,수원시청,11869,12716,24585
202102,분당선,매탄권선,4489,4314,8803
202102,분당선,망포,13660,13162,26822
202102,분당선,영통,7895,7912,15807
202102,분당선,청명,4066,3865,7931
202102,분당선,상갈,5179,4991,10170
202102,분당선,기흥,8873,8533,17406
202102,분당선,신갈,4361,4412,8773
202102,분당선,구성,4709,4878,9587
202102,분당선,죽전,12539,13890,26429
202102,분당선,보정,2360,2078,4438
202102,분당선,이매,5310,5113,10423
202102,분당선,오리,11620,9718,21338
202102,분당선,미금,15174,16186,31360
202102,분당선,정자,16964,18094,35058
202102,분당선,수내,12862,12930,25792
202102,분당선,서현,24282,24340,48622
202102,분당선,야탑,25281,26145,51426
202102,분당선,모란,23449,23943,47392
202102,분당선,태평,13242,12956,26198
202102,분당선,가천대,6561,7614,14175
202102,분당선,선정릉,8284,8786,17070
202102,분당선,강남구청,9703,11104,20807
202102,분당선,압구정로데오,18073,19687,37760
202102,분당선,서울숲,9436,9617,19053
202102,분당선,수원,7726,6374,14100
202102,분당선,복정,1,0,1
202102,분당선,수서,13035,13471,26506
202102,분당선,대모산입구,3408,3215,6623
202102,분당선,개포동,3777,3967,7744
202102,분당선,구룡,1726,1632,3358
202102,분당선,도곡,6581,6529,13110
202102,분당선,한티,13599,14480,28079
202102,분당선,선릉,13560,19707,33267
202102,분당선,선릉,13457,19749,33206
202102,분당선,한티,13631,14416,28047
202102,분당선,도곡,6558,6516,13074
202102,분당선,구룡,1639,1613,3252
202102,분당선,개포동,3502,3644,7146
202102,분당선,대모산입구,3369,3185,6554
202102,분당선,수서,12986,13469,26455
202102,분당선,복정,1,0,1
202102,분당선,수원,7656,6191,13847
202102,분당선,서울숲,9198,9393,18591
202102,분당선,압구정로데오,18381,20120,38501
202102,분당선,강남구청,9585,10991,20576
202102,분당선,선정릉,8195,8734,16929
202102,분당선,가천대,7040,8015,15055
202102,분당선,태평,12934,12675,25609
202102,분당선,모란,18921,18863,37784
202102,분당선,야탑,24735,25660,50395
202102,분당선,서현,23909,24052,47961
202102,분당선,수내,12793,12929,25722
202102,분당선,정자,17065,18029,35094
202102,분당선,미금,14825,15662,30487
202102,분당선,오리,11449,9713,21162
202102,분당선,이매,5094,4941,10035
202102,분당선,보정,2347,2045,4392
202102,분당선,죽전,12255,13644,25899
202102,분당선,구성,4650,4735,9385
202102,분당선,신갈,4271,4322,8593
202102,분당선,기흥,8875,8457,17332
202102,분당선,상갈,5162,4977,10139
202102,분당선,청명,3984,3785,7769
202102,분당선,영통,7883,8052,15935
202102,분당선,망포,13305,12824,26129
202102,분당선,매탄권선,4425,4297,8722
202102,분당선,수원시청,11597,12347,23944
202102,분당선,매교,2701,2754,5455
202102,분당선,선릉,13510,19933,33443
202102,분당선,한티,14106,14937,29043
202102,분당선,도곡,6739,6507,13246
202102,분당선,구룡,1715,1621,3336
202102,분당선,개포동,3747,3875,7622
202102,분당선,대모산입구,3379,3201,6580
202102,분당선,수서,14073,15168,29241
202102,분당선,복정,1,0,1
202102,분당선,수원,8457,7267,15724
202102,분당선,서울숲,10002,10040,20042
202102,분당선,압구정로데오,20368,22257,42625
202102,분당선,강남구청,10116,11359,21475
202102,분당선,선정릉,8229,8750,16979
202102,분당선,가천대,6417,7156,13573
202102,분당선,태평,13363,12949,26312
202102,분당선,모란,19831,19793,39624
202102,분당선,야탑,25498,26381,51879
202102,분당선,서현,24847,25585,50432
202102,분당선,수내,13118,13276,26394
202102,분당선,정자,17379,18466,35845
202102,분당선,미금,15586,16456,32042
202102,분당선,오리,11707,9840,21547
202102,분당선,이매,5401,5049,10450
202102,분당선,보정,2412,2104,4516
202102,분당선,죽전,13494,14584,28078
202102,분당선,구성,4721,4854,9575
202102,분당선,신갈,4558,4465,9023
202102,분당선,기흥,9220,8861,18081
202102,분당선,상갈,5365,5113,10478
202102,분당선,청명,4002,3828,7830
202102,분당선,영통,8326,8418,16744
202102,분당선,망포,14478,13277,27755
202102,분당선,매탄권선,4747,4444,9191
202102,분당선,수원시청,12530,13756,26286
202102,분당선,매교,2619,2742,5361
202103,분당선,선릉,2557,3878,6435
202103,분당선,한티,5978,6125,12103
202103,분당선,도곡,2245,2351,4596
202103,분당선,구룡,637,684,1321
202103,분당선,개포동,1436,1455,2891
202103,분당선,대모산입구,1294,1230,2524
202103,분당선,수서,7048,6040,13088
202103,분당선,수원,4289,3613,7902
202103,분당선,서울숲,2506,2576,5082
202103,분당선,압구정로데오,7769,8326,16095
202103,분당선,강남구청,2449,2909,5358
202103,분당선,선정릉,1804,1828,3632
202103,분당선,가천대,2778,3512,6290
202103,분당선,태평,6114,5956,12070
202103,분당선,모란,8773,8862,17635
202103,분당선,야탑,10147,10362,20509
202103,분당선,서현,10838,10850,21688
202103,분당선,수내,4928,4880,9808
202103,분당선,정자,5917,6122,12039
202103,분당선,미금,6083,6498,12581
202103,분당선,오리,4101,3590,7691
202103,분당선,이매,2181,2229,4410
202103,분당선,보정,822,779,1601
202103,분당선,죽전,5916,6901,12817
202103,분당선,구성,1694,1828,3522
202103,분당선,신갈,1541,1571,3112
202103,분당선,기흥,3910,3778,7688
202103,분당선,상갈,2061,2203,4264
202103,분당선,청명,1428,1427,2855
202103,분당선,영통,3557,3794,7351
202103,분당선,망포,4767,5205,9972
202103,분당선,매탄권선,1858,1794,3652
202103,분당선,수원시청,5148,5215,10363
202103,분당선,매교,1067,1018,2085
202103,분당선,매교,2959,2921,5880
202103,분당선,수원시청,11601,12260,23861
202103,분당선,매탄권선,4650,4583,9233
202103,분당선,망포,13412,13005,26417
202103,분당선,영통,7667,7951,15618
202103,분당선,청명,4038,3892,7930
202103,분당선,상갈,5054,4889,9943
202103,분당선,기흥,8927,8455,17382
202103,분당선,신갈,4493,4460,8953
202103,분당선,구성,4704,4868,9572
202103,분당선,죽전,12455,13869,26324
202103,분당선,보정,2435,2209,4644
202103,분당선,이매,5354,5051,10405
202103,분당선,오리,11371,9749,21120
202103,분당선,미금,15294,16088,31382
202103,분당선,정자,16734,15234,31968
202103,분당선,수내,12862,12953,25815
202103,분당선,서현,23451,23595,47046
202103,분당선,야탑,24627,25575,50202
202103,분당선,모란,18827,18850,37677
202103,분당선,태평,13137,12799,25936
202103,분당선,가천대,8324,9580,17904
202103,분당선,선정릉,8258,8722,16980
202103,분당선,강남구청,9691,10984,20675
202103,분당선,압구정로데오,16925,18488,35413
202103,분당선,서울숲,8975,9034,18009
202103,분당선,수원,7622,6257,13879
202103,분당선,복정,1,0,1
202103,분당선,수서,12764,12827,25591
202103,분당선,대모산입구,3427,3143,6570
202103,분당선,개포동,3630,3670,7300
202103,분당선,구룡,2000,1913,3913
202103,분당선,도곡,6568,6640,13208
202103,분당선,한티,13016,13999,27015
202103,분당선,선릉,13704,20190,33894
202103,분당선,선릉,13917,20471,34388
202103,분당선,한티,13096,14235,27331
202103,분당선,도곡,6501,6636,13137
202103,분당선,구룡,1944,1847,3791
202103,분당선,개포동,3657,3760,7417
202103,분당선,대모산입구,3459,3225,6684
202103,분당선,수서,12547,12961,25508
202103,분당선,복정,3,0,3
202103,분당선,수원,7840,6442,14282
202103,분당선,서울숲,9417,9566,18983
202103,분당선,압구정로데오,17655,18961,36616
202103,분당선,강남구청,9897,11278,21175
202103,분당선,선정릉,8326,8884,17210
202103,분당선,가천대,7997,9109,17106
202103,분당선,태평,13287,12790,26077
202103,분당선,모란,19017,19197,38214
202103,분당선,야탑,25264,26268,51532
202103,분당선,서현,24005,24196,48201
202103,분당선,수내,12958,12895,25853
202103,분당선,정자,17126,16435,33561
202103,분당선,미금,15898,16595,32493
202103,분당선,오리,11838,10087,21925
202103,분당선,이매,5405,5130,10535
202103,분당선,보정,2505,2147,4652
202103,분당선,죽전,12937,14290,27227
202103,분당선,구성,4680,4886,9566
202103,분당선,신갈,4433,4448,8881
202103,분당선,기흥,9119,8842,17961
202103,분당선,상갈,5195,5077,10272
202103,분당선,청명,4040,3835,7875
202103,분당선,영통,7838,8097,15935
202103,분당선,망포,13692,13236,26928
202103,분당선,매탄권선,4717,4581,9298
202103,분당선,수원시청,11935,12548,24483
202103,분당선,매교,2935,2946,5881
202103,분당선,선릉,14028,20387,34415
202103,분당선,한티,13161,14149,27310
202103,분당선,도곡,6651,6521,13172
202103,분당선,구룡,1988,1968,3956
202103,분당선,개포동,3618,3750,7368
202103,분당선,대모산입구,3503,3296,6799
202103,분당선,수서,13069,13439,26508
202103,분당선,수원,7824,6377,14201
202103,분당선,서울숲,9444,9566,19010
202103,분당선,압구정로데오,17555,19298,36853
202103,분당선,강남구청,9729,11077,20806
202103,분당선,선정릉,8243,8722,16965
202103,분당선,가천대,8239,9428,17667
202103,분당선,태평,13225,12889,26114
202103,분당선,모란,24233,24652,48885
202103,분당선,야탑,24902,25973,50875
202103,분당선,서현,24086,24280,48366
202103,분당선,수내,13027,13129,26156
202103,분당선,정자,17220,18321,35541
202103,분당선,미금,15248,16277,31525
202103,분당선,오리,11804,10017,21821
202103,분당선,이매,5443,5068,10511
202103,분당선,보정,2456,2165,4621
202103,분당선,죽전,12881,14228,27109
202103,분당선,구성,4863,5010,9873
202103,분당선,신갈,4381,4433,8814
202103,분당선,기흥,9138,8692,17830
202103,분당선,상갈,5246,5105,10351
202103,분당선,청명,4166,3906,8072
202103,분당선,영통,7681,7913,15594
202103,분당선,망포,13476,12930,26406
202103,분당선,매탄권선,4659,4536,9195
202103,분당선,수원시청,11545,12227,23772
202103,분당선,매교,2900,2933,5833
202103,분당선,매교,2991,3129,6120
202103,분당선,수원시청,13062,14384,27446
202103,분당선,매탄권선,5076,4821,9897
202103,분당선,망포,14979,13961,28940
202103,분당선,영통,8803,8925,17728
202103,분당선,청명,4441,4147,8588
202103,분당선,상갈,5508,5340,10848
202103,분당선,기흥,9554,9190,18744
202103,분당선,신갈,4694,4712,9406
202103,분당선,구성,5007,5287,10294
202103,분당선,죽전,14284,15231,29515
202103,분당선,보정,2581,2272,4853
202103,분당선,이매,5788,5392,11180
202103,분당선,오리,12273,10388,22661
202103,분당선,미금,16139,17010,33149
202103,분당선,정자,18009,19202,37211
202103,분당선,수내,13567,13550,27117
202103,분당선,서현,25437,25912,51349
202103,분당선,야탑,26065,27401,53466
202103,분당선,모란,20344,20400,40744
202103,분당선,태평,13676,13245,26921
202103,분당선,가천대,8354,9029,17383
202103,분당선,선정릉,8434,8968,17402
202103,분당선,강남구청,10445,11662,22107
202103,분당선,압구정로데오,19935,22231,42166
202103,분당선,서울숲,10070,10195,20265
202103,분당선,수원,8580,7358,15938
202103,분당선,수서,14432,15132,29564
202103,분당선,대모산입구,3533,3311,6844
202103,분당선,개포동,3807,3981,7788
202103,분당선,구룡,2110,1973,4083
202103,분당선,도곡,7104,7005,14109
202103,분당선,한티,14110,15085,29195
202103,분당선,선릉,13806,20640,34446
202103,분당선,선릉,13580,20135,33715
202103,분당선,한티,12223,13151,25374
202103,분당선,도곡,6472,6529,13001
202103,분당선,구룡,1975,1954,3929
202103,분당선,개포동,3593,3728,7321
202103,분당선,대모산입구,3538,3331,6869
202103,분당선,수서,12663,12936,25599
202103,분당선,수원,7739,6345,14084
202103,분당선,서울숲,9230,9235,18465
202103,분당선,압구정로데오,15818,17189,33007
202103,분당선,강남구청,9738,10828,20566
202103,분당선,선정릉,8165,8692,16857
202103,분당선,가천대,8735,10056,18791
202103,분당선,태평,13072,12832,25904
202103,분당선,모란,18961,18823,37784
202103,분당선,야탑,24422,25439,49861
202103,분당선,서현,22702,22835,45537
202103,분당선,수내,11937,11874,23811
202103,분당선,정자,16678,15061,31739
202103,분당선,미금,15108,16071,31179
202103,분당선,오리,11575,9832,21407
202103,분당선,이매,5480,5088,10568
202103,분당선,보정,2513,2195,4708
202103,분당선,죽전,12945,14102,27047
202103,분당선,구성,4821,4973,9794
202103,분당선,신갈,4457,4435,8892
202103,분당선,기흥,9107,8692,17799
202103,분당선,상갈,5199,5058,10257
202103,분당선,청명,4072,3887,7959
202103,분당선,영통,7876,8071,15947
202103,분당선,망포,13635,13117,26752
202103,분당선,매탄권선,4813,4566,9379
202103,분당선,수원시청,11599,12303,23902
202103,분당선,매교,2992,2982,5974
202103,분당선,선릉,13722,20577,34299
202103,분당선,한티,13297,14313,27610
202103,분당선,도곡,6672,6573,13245
202103,분당선,구룡,1929,1954,3883
202103,분당선,개포동,3721,3821,7542
202103,분당선,대모산입구,3616,3398,7014
202103,분당선,수서,13010,13399,26409
202103,분당선,복정,3,0,3
202103,분당선,수원,7964,6477,14441
202103,분당선,서울숲,9394,9630,19024
202103,분당선,압구정로데오,17561,19151,36712
202103,분당선,강남구청,9987,11334,21321
202103,분당선,선정릉,8374,8852,17226
202103,분당선,가천대,9580,10766,20346
202103,분당선,태평,13479,13211,26690
202103,분당선,모란,25467,26197,51664
202103,분당선,야탑,25166,26049,51215
202103,분당선,서현,24175,24347,48522
202103,분당선,수내,12927,12874,25801
202103,분당선,정자,17432,16912,34344
202103,분당선,미금,15677,16485,32162
202103,분당선,오리,11895,9901,21796
202103,분당선,이매,5546,5343,10889
202103,분당선,보정,2563,2248,4811
202103,분당선,죽전,13029,14521,27550
202103,분당선,구성,4943,5085,10028
202103,분당선,신갈,4566,4551,9117
202103,분당선,기흥,9414,8806,18220
202103,분당선,상갈,5306,5112,10418
202103,분당선,청명,4283,4073,8356
202103,분당선,영통,7922,8124,16046
202103,분당선,망포,13663,13205,26868
202103,분당선,매탄권선,4758,4685,9443
202103,분당선,수원시청,11913,12647,24560
202103,분당선,매교,3037,3084,6121
202103,분당선,선릉,13819,20360,34179
202103,분당선,한티,13352,14486,27838
202103,분당선,도곡,6652,6713,13365
202103,분당선,구룡,2034,1934,3968
202103,분당선,개포동,3750,3923,7673
202103,분당선,대모산입구,3543,3250,6793
202103,분당선,수서,12673,13086,25759
202103,분당선,수원,8047,6553,14600
202103,분당선,서울숲,9776,9815,19591
202103,분당선,압구정로데오,17869,19538,37407
202103,분당선,강남구청,9977,11293,21270
202103,분당선,선정릉,8503,8889,17392
202103,분당선,가천대,9406,10461,19867
202103,분당선,태평,13315,12857,26172
202103,분당선,모란,19349,19439,38788
202103,분당선,야탑,25817,26994,52811
202103,분당선,서현,24208,24368,48576
202103,분당선,수내,13127,13218,26345
202103,분당선,정자,17198,18412,35610
202103,분당선,미금,15541,16569,32110
202103,분당선,오리,11846,10010,21856
202103,분당선,이매,5634,5188,10822
202103,분당선,보정,2546,2267,4813
202103,분당선,죽전,13349,14661,28010
202103,분당선,구성,4748,5001,9749
202103,분당선,신갈,4553,4581,9134
202103,분당선,기흥,9289,8852,18141
202103,분당선,상갈,5327,5151,10478
202103,분당선,청명,4227,4057,8284
202103,분당선,영통,7950,8192,16142
202103,분당선,망포,13952,13235,27187
202103,분당선,매탄권선,4848,4653,9501
202103,분당선,수원시청,11928,12746,24674
202103,분당선,매교,3053,3118,6171
202103,분당선,선릉,13953,20507,34460
202103,분당선,한티,13243,14241,27484
202103,분당선,도곡,6556,6566,13122
202103,분당선,구룡,2043,2004,4047
202103,분당선,개포동,3656,3710,7366
202103,분당선,대모산입구,3432,3182,6614
202103,분당선,수서,13114,13317,26431
202103,분당선,수원,7934,6711,14645
202103,분당선,서울숲,9478,9712,19190
202103,분당선,압구정로데오,17941,19673,37614
202103,분당선,강남구청,9759,11133,20892
202103,분당선,선정릉,8098,8747,16845
202103,분당선,가천대,9478,10437,19915
202103,분당선,태평,13134,12705,25839
202103,분당선,모란,19257,19200,38457
202103,분당선,야탑,25036,26235,51271
202103,분당선,서현,23780,23813,47593
202103,분당선,수내,12798,12975,25773
202103,분당선,정자,17228,18299,35527
202103,분당선,미금,15238,16151,31389
202103,분당선,오리,11794,9928,21722
202103,분당선,이매,5642,5206,10848
202103,분당선,보정,2483,2258,4741
202103,분당선,죽전,13142,14362,27504
202103,분당선,구성,4859,5088,9947
202103,분당선,신갈,4360,4364,8724
202103,분당선,기흥,9243,8691,17934
202103,분당선,상갈,5350,5126,10476
202103,분당선,청명,4195,3929,8124
202103,분당선,영통,8166,8260,16426
202103,분당선,망포,13617,13244,26861
202103,분당선,매탄권선,4804,4674,9478
202103,분당선,수원시청,11718,12454,24172
202103,분당선,매교,3039,3061,6100
202103,분당선,선릉,13719,20256,33975
202103,분당선,한티,14033,14944,28977
202103,분당선,도곡,6916,6899,13815
202103,분당선,구룡,2140,1986,4126
202103,분당선,개포동,3802,4020,7822
202103,분당선,대모산입구,3513,3274,6787
202103,분당선,수서,14386,15238,29624
202103,분당선,복정,1,0,1
202103,분당선,수원,8529,7385,15914
202103,분당선,서울숲,9592,9637,19229
202103,분당선,압구정로데오,19730,21946,41676
202103,분당선,강남구청,10083,11501,21584
202103,분당선,선정릉,8438,8918,17356
202103,분당선,가천대,8967,9474,18441
202103,분당선,태평,13556,13101,26657
202103,분당선,모란,19867,20089,39956
202103,분당선,야탑,26237,27467,53704
202103,분당선,서현,24966,25579,50545
202103,분당선,수내,13304,13501,26805
202103,분당선,정자,17993,19141,37134
202103,분당선,미금,15515,16476,31991
202103,분당선,오리,11991,10081,22072
202103,분당선,이매,5753,5295,11048
202103,분당선,보정,2530,2180,4710
202103,분당선,죽전,13844,14807,28651
202103,분당선,구성,4826,5093,9919
202103,분당선,신갈,4477,4428,8905
202103,분당선,기흥,9502,9017,18519
202103,분당선,상갈,5517,5349,10866
202103,분당선,청명,4385,4129,8514
202103,분당선,영통,8663,8756,17419
202103,분당선,망포,14917,13855,28772
202103,분당선,매탄권선,5125,4878,10003
202103,분당선,수원시청,12487,13982,26469
202103,분당선,매교,3033,3064,6097
202103,분당선,선릉,13691,20081,33772
202103,분당선,한티,13025,14057,27082
202103,분당선,도곡,6637,6679,13316
202103,분당선,구룡,1985,1989,3974
202103,분당선,개포동,3455,3663,7118
202103,분당선,대모산입구,3439,3235,6674
202103,분당선,수서,12941,13197,26138
202103,분당선,수원,7959,6426,14385
202103,분당선,서울숲,9238,9345,18583
202103,분당선,압구정로데오,16421,17877,34298
202103,분당선,강남구청,9549,10821,20370
202103,분당선,선정릉,8189,8686,16875
202103,분당선,가천대,9303,10508,19811
202103,분당선,태평,13079,12806,25885
202103,분당선,모란,18716,18649,37365
202103,분당선,야탑,24720,25895,50615
202103,분당선,서현,23279,23419,46698
202103,분당선,수내,12749,12681,25430
202103,분당선,정자,16837,17811,34648
202103,분당선,미금,15172,16048,31220
202103,분당선,오리,11575,9902,21477
202103,분당선,이매,5468,5001,10469
202103,분당선,보정,2415,2209,4624
202103,분당선,죽전,12047,13295,25342
202103,분당선,구성,4758,4962,9720
202103,분당선,신갈,4438,4390,8828
202103,분당선,기흥,9202,8793,17995
202103,분당선,상갈,5245,4976,10221
202103,분당선,청명,4158,3982,8140
202103,분당선,영통,7735,8025,15760
202103,분당선,망포,13489,12979,26468
202103,분당선,매탄권선,4762,4595,9357
202103,분당선,수원시청,11846,12468,24314
202103,분당선,매교,2963,3029,5992
202103,분당선,선릉,13654,20435,34089
202103,분당선,한티,13294,14265,27559
202103,분당선,도곡,6674,6726,13400
202103,분당선,구룡,1942,1897,3839
202103,분당선,개포동,3584,3816,7400
202103,분당선,대모산입구,3410,3218,6628
202103,분당선,수서,12809,12899,25708
202103,분당선,수원,7748,6342,14090
202103,분당선,서울숲,9587,9755,19342
202103,분당선,압구정로데오,17556,18916,36472
202103,분당선,강남구청,9895,11332,21227
202103,분당선,선정릉,8435,8861,17296
202103,분당선,가천대,9360,10435,19795
202103,분당선,태평,13249,12971,26220
202103,분당선,모란,19163,19242,38405
202103,분당선,야탑,25264,26293,51557
202103,분당선,서현,23668,23878,47546
202103,분당선,수내,12862,13028,25890
202103,분당선,정자,17238,18234,35472
202103,분당선,미금,15200,16239,31439
202103,분당선,오리,11811,9912,21723
202103,분당선,이매,5661,5241,10902
202103,분당선,보정,2478,2175,4653
202103,분당선,죽전,13114,14430,27544
202103,분당선,구성,4828,5099,9927
202103,분당선,신갈,4470,4550,9020
202103,분당선,기흥,9207,8825,18032
202103,분당선,상갈,5269,5123,10392
202103,분당선,청명,4103,3901,8004
202103,분당선,영통,7792,8110,15902
202103,분당선,망포,13760,13210,26970
202103,분당선,매탄권선,4822,4648,9470
202103,분당선,수원시청,11884,12459,24343
202103,분당선,매교,2949,2961,5910
202103,분당선,한티,13362,14419,27781
202103,분당선,도곡,6673,6799,13472
202103,분당선,구룡,2002,1953,3955
202103,분당선,개포동,3765,3920,7685
202103,분당선,대모산입구,3536,3284,6820
202103,분당선,수서,12877,13225,26102
202103,분당선,수원,7974,6600,14574
202103,분당선,서울숲,9760,9886,19646
202103,분당선,압구정로데오,17849,19463,37312
202103,분당선,강남구청,10016,11431,21447
202103,분당선,선정릉,8335,8801,17136
202103,분당선,가천대,9455,10564,20019
202103,분당선,태평,13374,13059,26433
202103,분당선,모란,19463,19347,38810
202103,분당선,야탑,25481,26565,52046
202103,분당선,서현,24047,24139,48186
202103,분당선,수내,12890,13103,25993
202103,분당선,정자,17279,18366,35645
202103,분당선,미금,15625,16400,32025
202103,분당선,오리,11955,10187,22142
202103,분당선,이매,5640,5216,10856
202103,분당선,보정,2624,2320,4944
202103,분당선,죽전,13324,14769,28093
202103,분당선,구성,4872,5182,10054
202103,분당선,신갈,4623,4655,9278
202103,분당선,기흥,9185,8785,17970
202103,분당선,상갈,5462,5182,10644
202103,분당선,청명,4158,3978,8136
202103,분당선,영통,8121,8351,16472
202103,분당선,망포,13845,13268,27113
202103,분당선,매탄권선,4805,4726,9531
202103,분당선,수원시청,12135,12955,25090
202103,분당선,매교,3019,3090,6109
202103,분당선,선릉,13768,20344,34112
202103,분당선,매교,3001,3087,6088
202103,분당선,수원시청,12055,12675,24730
202103,분당선,매탄권선,4838,4627,9465
202103,분당선,망포,13821,13343,27164
202103,분당선,영통,8090,8372,16462
202103,분당선,청명,4279,4041,8320
202103,분당선,상갈,5404,5093,10497
202103,분당선,기흥,9172,8740,17912
202103,분당선,신갈,4495,4558,9053
202103,분당선,구성,5003,5026,10029
202103,분당선,죽전,13170,14565,27735
202103,분당선,보정,2524,2266,4790
202103,분당선,이매,5687,5226,10913
202103,분당선,오리,12020,10178,22198
202103,분당선,미금,15295,16240,31535
202103,분당선,정자,16949,17957,34906
202103,분당선,수내,12971,12983,25954
202103,분당선,서현,23930,24326,48256
202103,분당선,야탑,25225,26417,51642
202103,분당선,모란,19414,19311,38725
202103,분당선,태평,13206,12812,26018
202103,분당선,가천대,9575,10603,20178
202103,분당선,선정릉,8297,8760,17057
202103,분당선,강남구청,9970,11453,21423
202103,분당선,압구정로데오,18224,19872,38096
202103,분당선,서울숲,9748,9893,19641
202103,분당선,수원,7976,6673,14649
202103,분당선,수서,13400,13682,27082
202103,분당선,대모산입구,3478,3244,6722
202103,분당선,개포동,3794,3850,7644
202103,분당선,구룡,1982,1947,3929
202103,분당선,도곡,6627,6651,13278
202103,분당선,한티,13222,14253,27475
202103,분당선,선릉,13765,20313,34078
202103,분당선,복정,1,0,1
202103,분당선,선릉,13724,20497,34221
202103,분당선,한티,14309,15163,29472
202103,분당선,도곡,7079,7047,14126
202103,분당선,구룡,2129,2010,4139
202103,분당선,개포동,3817,3944,7761
202103,분당선,대모산입구,3620,3331,6951
202103,분당선,수서,15167,15881,31048
202103,분당선,수원,9080,7642,16722
202103,분당선,서울숲,10396,10395,20791
202103,분당선,압구정로데오,20485,23055,43540
202103,분당선,강남구청,10267,11767,22034
202103,분당선,선정릉,8309,8796,17105
202103,분당선,가천대,9225,9741,18966
202103,분당선,태평,14012,13460,27472
202103,분당선,모란,27219,28057,55276
202103,분당선,야탑,26613,28019,54632
202103,분당선,서현,25202,26125,51327
202103,분당선,수내,13469,13582,27051
202103,분당선,정자,17656,18810,36466
202103,분당선,미금,16368,17378,33746
202103,분당선,오리,12481,10491,22972
202103,분당선,이매,5964,5486,11450
202103,분당선,보정,2656,2411,5067
202103,분당선,죽전,14424,15280,29704
202103,분당선,구성,5115,5239,10354
202103,분당선,신갈,4666,4692,9358
202103,분당선,기흥,9785,9230,19015
202103,분당선,상갈,5610,5384,10994
202103,분당선,청명,4563,4185,8748
202103,분당선,영통,8963,9149,18112
202103,분당선,망포,15402,14107,29509
202103,분당선,매탄권선,5196,4943,10139
202103,분당선,수원시청,13226,14735,27961
202103,분당선,매교,3125,3115,6240
202103,분당선,선릉,13515,19949,33464
202103,분당선,한티,12906,14000,26906
202103,분당선,도곡,6673,6820,13493
202103,분당선,구룡,1990,1994,3984
202103,분당선,개포동,3527,3665,7192
202103,분당선,대모산입구,3474,3168,6642
202103,분당선,수서,12955,12976,25931
202103,분당선,수원,7777,6454,14231
202103,분당선,서울숲,9317,9505,18822
202103,분당선,압구정로데오,16342,17536,33878
202103,분당선,강남구청,9735,10977,20712
202103,분당선,선정릉,8126,8807,16933
202103,분당선,가천대,7722,8903,16625
202103,분당선,태평,13117,12823,25940
202103,분당선,모란,18923,18976,37899
202103,분당선,야탑,24716,25841,50557
202103,분당선,서현,22996,23050,46046
202103,분당선,수내,12786,12823,25609
202103,분당선,정자,16437,17549,33986
202103,분당선,미금,15202,16036,31238
202103,분당선,오리,11418,9788,21206
202103,분당선,이매,5588,5129,10717
202103,분당선,보정,2492,2204,4696
202103,분당선,죽전,12836,14241,27077
202103,분당선,구성,4832,4959,9791
202103,분당선,신갈,4440,4426,8866
202103,분당선,기흥,9168,8562,17730
202103,분당선,상갈,5245,4984,10229
202103,분당선,청명,4143,3968,8111
202103,분당선,영통,7767,7982,15749
202103,분당선,망포,13546,12993,26539
202103,분당선,매탄권선,4828,4598,9426
202103,분당선,수원시청,11718,12349,24067
202103,분당선,매교,2964,3041,6005
202103,분당선,서현,23268,23698,46966
202103,분당선,야탑,25130,26196,51326
202103,분당선,모란,19551,19253,38804
202103,분당선,태평,13284,12959,26243
202103,분당선,가천대,7817,9075,16892
202103,분당선,선정릉,8424,9001,17425
202103,분당선,강남구청,9906,11232,21138
202103,분당선,압구정로데오,18039,19704,37743
202103,분당선,서울숲,9851,10004,19855
202103,분당선,수원,7663,6379,14042
202103,분당선,복정,2,0,2
202103,분당선,수서,12911,13186,26097
202103,분당선,대모산입구,3482,3165,6647
202103,분당선,개포동,3684,3776,7460
202103,분당선,구룡,1979,1922,3901
202103,분당선,도곡,6641,6622,13263
202103,분당선,한티,13125,14077,27202
202103,분당선,선릉,13781,20420,34201
202103,분당선,매교,3050,3081,6131
202103,분당선,수원시청,11932,12651,24583
202103,분당선,매탄권선,4782,4712,9494
202103,분당선,망포,13725,13061,26786
202103,분당선,영통,7860,8000,15860
202103,분당선,청명,4231,3974,8205
202103,분당선,상갈,5316,5090,10406
202103,분당선,기흥,9386,8897,18283
202103,분당선,신갈,4542,4513,9055
202103,분당선,구성,4829,5077,9906
202103,분당선,죽전,12732,14081,26813
202103,분당선,보정,2512,2305,4817
202103,분당선,이매,5573,5145,10718
202103,분당선,오리,11899,10073,21972
202103,분당선,미금,15287,16148,31435
202103,분당선,정자,17074,18036,35110
202103,분당선,수내,13229,13395,26624
202103,분당선,청명,4333,4138,8471
202103,분당선,상갈,5342,5082,10424
202103,분당선,기흥,9467,9035,18502
202103,분당선,신갈,4605,4619,9224
202103,분당선,구성,4995,5209,10204
202103,분당선,죽전,13591,14741,28332
202103,분당선,매교,3010,3106,6116
202103,분당선,수원시청,12163,12941,25104
202103,분당선,매탄권선,4905,4746,9651
202103,분당선,망포,13853,13281,27134
202103,분당선,영통,8097,8385,16482
202103,분당선,도곡,6860,6799,13659
202103,분당선,한티,13273,14131,27404
202103,분당선,선릉,13761,20231,33992
202103,분당선,개포동,3830,4046,7876
202103,분당선,구룡,2033,1977,4010
202103,분당선,보정,2572,2240,4812
202103,분당선,이매,5633,5237,10870
202103,분당선,오리,12232,10278,22510
202103,분당선,미금,15917,16923,32840
202103,분당선,정자,17565,18570,36135
202103,분당선,수내,13122,13258,26380
202103,분당선,서현,24014,24066,48080
202103,분당선,야탑,25686,26546,52232
202103,분당선,모란,25479,26466,51945
202103,분당선,태평,13875,13216,27091
202103,분당선,가천대,8055,9138,17193
202103,분당선,선정릉,8272,8913,17185
202103,분당선,강남구청,10103,11457,21560
202103,분당선,압구정로데오,17590,19289,36879
202103,분당선,서울숲,10033,10177,20210
202103,분당선,수원,7928,6780,14708
202103,분당선,수서,13216,13576,26792
202103,분당선,대모산입구,3532,3373,6905
202103,분당선,매교,3003,3119,6122
202103,분당선,수원시청,12235,12889,25124
202103,분당선,매탄권선,4826,4731,9557
202103,분당선,망포,14035,13472,27507
202103,분당선,영통,8252,8345,16597
202103,분당선,청명,4274,4055,8329
202103,분당선,상갈,5438,5270,10708
202103,분당선,기흥,9410,8856,18266
202103,분당선,신갈,4579,4540,9119
202103,분당선,구성,4980,5059,10039
202103,분당선,죽전,13505,14953,28458
202103,분당선,보정,2566,2237,4803
202103,분당선,이매,5655,5170,10825
202103,분당선,오리,11910,10161,22071
202103,분당선,미금,15582,16441,32023
202103,분당선,정자,17255,18262,35517
202103,분당선,수내,13011,13058,26069
202103,분당선,서현,23881,24423,48304
202103,분당선,야탑,25549,26381,51930
202103,분당선,모란,19583,19420,39003
202103,분당선,태평,13581,13131,26712
202103,분당선,가천대,7980,9018,16998
202103,분당선,선정릉,8219,8926,17145
202103,분당선,강남구청,10071,11439,21510
202103,분당선,압구정로데오,18229,19958,38187
202103,분당선,서울숲,10248,10413,20661
202103,분당선,수원,8196,6782,14978
202103,분당선,복정,2,0,2
202103,분당선,수서,13456,13840,27296
202103,분당선,대모산입구,3492,3262,6754
202103,분당선,개포동,3761,3862,7623
202103,분당선,구룡,2036,1982,4018
202103,분당선,도곡,6668,6721,13389
202103,분당선,한티,13169,14066,27235
202103,분당선,선릉,13671,20587,34258
202103,분당선,매교,3150,3265,6415
202103,분당선,수원시청,13307,14898,28205
202103,분당선,매탄권선,5307,4953,10260
202103,분당선,망포,15160,13909,29069
202103,분당선,영통,8922,8950,17872
202103,분당선,청명,4584,4228,8812
202103,분당선,상갈,5515,5344,10859
202103,분당선,기흥,9672,9164,18836
202103,분당선,신갈,4743,4733,9476
202103,분당선,구성,5093,5257,10350
202103,분당선,죽전,14519,15465,29984
202103,분당선,보정,2569,2277,4846
202103,분당선,이매,6056,5477,11533
202103,분당선,오리,12366,10282,22648
202103,분당선,미금,16335,17290,33625
202103,분당선,정자,17978,19266,37244
202103,분당선,수내,13368,13521,26889
202103,분당선,서현,25306,25887,51193
202103,분당선,야탑,26458,27759,54217
202103,분당선,모란,20653,20533,41186
202103,분당선,태평,13866,13384,27250
202103,분당선,가천대,7942,8658,16600
202103,분당선,선정릉,8231,8750,16981
202103,분당선,강남구청,10336,11690,22026
202103,분당선,압구정로데오,20476,22896,43372
202103,분당선,서울숲,10900,10989,21889
202103,분당선,수원,8969,7659,16628
202103,분당선,수서,14799,15834,30633
202103,분당선,대모산입구,3493,2416,5909
202103,분당선,개포동,3901,4043,7944
202103,분당선,구룡,2144,2061,4205
202103,분당선,도곡,7094,6899,13993
202103,분당선,한티,14396,15340,29736
202103,분당선,선릉,13617,20520,34137
202103,분당선,구성,4756,5052,9808
202103,분당선,죽전,12919,14302,27221
202103,분당선,보정,2423,2222,4645
202103,분당선,이매,5665,5232,10897
202103,분당선,오리,11552,9834,21386
202103,분당선,미금,15153,16037,31190
202103,분당선,정자,16422,17434,33856
202103,분당선,수내,12586,12446,25032
202103,분당선,서현,23134,23314,46448
202103,분당선,야탑,24993,26063,51056
202103,분당선,모란,24442,25068,49510
202103,분당선,태평,13322,13034,26356
202103,분당선,가천대,7974,9327,17301
202103,분당선,선정릉,8160,8629,16789
202103,분당선,강남구청,9734,10869,20603
202103,분당선,압구정로데오,16214,17497,33711
202103,분당선,서울숲,9529,9558,19087
202103,분당선,수원,7733,6218,13951
202103,분당선,수서,13470,13483,26953
202103,분당선,대모산입구,3529,3279,6808
202103,분당선,개포동,3546,3728,7274
202103,분당선,구룡,1994,1945,3939
202103,분당선,도곡,6422,6414,12836
202103,분당선,한티,12979,13784,26763
202103,분당선,선릉,13450,20223,33673
202103,분당선,신갈,4400,4366,8766
202103,분당선,기흥,8820,8619,17439
202103,분당선,상갈,5254,5058,10312
202103,분당선,청명,4110,3896,8006
202103,분당선,영통,7675,7947,15622
202103,분당선,망포,13636,12912,26548
202103,분당선,매탄권선,4814,4668,9482
202103,분당선,수원시청,11863,12401,24264
202103,분당선,매교,2920,2999,5919
202103,분당선,매교,2959,3079,6038
202103,분당선,수원시청,12011,12651,24662
202103,분당선,매탄권선,4930,4735,9665
202103,분당선,망포,13857,13156,27013
202103,분당선,영통,7874,8149,16023
202103,분당선,청명,4066,3984,8050
202103,분당선,상갈,5302,5096,10398
202103,분당선,기흥,9163,8836,17999
202103,분당선,신갈,4505,4548,9053
202103,분당선,구성,4764,4977,9741
202103,분당선,죽전,13080,14263,27343
202103,분당선,보정,2467,2200,4667
202103,분당선,이매,5510,5248,10758
202103,분당선,오리,11878,10066,21944
202103,분당선,미금,15591,15828,31419
202103,분당선,정자,16972,18230,35202
202103,분당선,수내,13094,13113,26207
202103,분당선,서현,23285,23594,46879
202103,분당선,야탑,25162,26181,51343
202103,분당선,모란,19519,19378,38897
202103,분당선,태평,13402,13068,26470
202103,분당선,가천대,8488,9577,18065
202103,분당선,선정릉,8284,8852,17136
202103,분당선,강남구청,9812,11348,21160
202103,분당선,압구정로데오,17987,19656,37643
202103,분당선,서울숲,10580,10748,21328
202103,분당선,수원,7782,6537,14319
202103,분당선,수서,12830,13150,25980
202103,분당선,대모산입구,3439,3311,6750
202103,분당선,개포동,3635,3855,7490
202103,분당선,구룡,1954,1904,3858
202103,분당선,도곡,6818,6754,13572
202103,분당선,한티,13169,14053,27222
202103,분당선,선릉,13741,20280,34021
202103,분당선,선릉,13635,20270,33905
202103,분당선,한티,13576,14631,28207
202103,분당선,도곡,7175,7087,14262
202103,분당선,구룡,1985,1925,3910
202103,분당선,개포동,3924,4158,8082
202103,분당선,대모산입구,3507,3315,6822
202103,분당선,수서,12848,13024,25872
202103,분당선,수원,8023,6592,14615
202103,분당선,서울숲,12456,13192,25648
202103,분당선,압구정로데오,17823,19670,37493
202103,분당선,강남구청,9940,11380,21320
202103,분당선,선정릉,8239,8772,17011
202103,분당선,가천대,8354,9477,17831
202103,분당선,태평,13451,12946,26397
202103,분당선,모란,19740,19533,39273
202103,분당선,야탑,25655,26718,52373
202103,분당선,서현,23830,24321,48151
202103,분당선,수내,13256,13210,26466
202103,분당선,정자,17169,18222,35391
202103,분당선,미금,15589,15951,31540
202103,분당선,오리,11997,10230,22227
202103,분당선,이매,5595,5202,10797
202103,분당선,보정,2546,2263,4809
202103,분당선,죽전,13530,14870,28400
202103,분당선,구성,5066,5238,10304
202103,분당선,신갈,4647,4642,9289
202103,분당선,기흥,9196,8802,17998
202103,분당선,상갈,5430,5156,10586
202103,분당선,청명,4271,4123,8394
202103,분당선,영통,8323,8485,16808
202103,분당선,망포,14111,13361,27472
202103,분당선,매탄권선,5102,4818,9920
202103,분당선,수원시청,12096,12930,25026
202103,분당선,매교,2999,3050,6049
202104,분당선,매교,3045,3117,6162
202104,분당선,수원시청,12002,12861,24863
202104,분당선,매탄권선,4953,4769,9722
202104,분당선,망포,13880,13197,27077
202104,분당선,영통,8218,8378,16596
202104,분당선,청명,4224,4006,8230
202104,분당선,상갈,5424,5225,10649
202104,분당선,기흥,9429,9063,18492
202104,분당선,신갈,4621,4596,9217
202104,분당선,구성,5121,5240,10361
202104,분당선,죽전,13387,14617,28004
202104,분당선,보정,2556,2284,4840
202104,분당선,이매,5685,5162,10847
202104,분당선,오리,12078,10191,22269
202104,분당선,미금,15187,16109,31296
202104,분당선,정자,17162,18376,35538
202104,분당선,수내,13016,13309,26325
202104,분당선,서현,23920,24393,48313
202104,분당선,야탑,25436,26310,51746
202104,분당선,모란,19510,19499,39009
202104,분당선,태평,13405,13004,26409
202104,분당선,가천대,8740,9773,18513
202104,분당선,선정릉,8054,8776,16830
202104,분당선,강남구청,9963,11231,21194
202104,분당선,압구정로데오,18135,19987,38122
202104,분당선,서울숲,13933,15400,29333
202104,분당선,수원,8109,6806,14915
202104,분당선,수서,13123,13451,26574
202104,분당선,대모산입구,3542,3288,6830
202104,분당선,개포동,3854,3960,7814
202104,분당선,구룡,1937,1960,3897
202104,분당선,도곡,7242,7028,14270
202104,분당선,한티,13527,14420,27947
202104,분당선,선릉,13645,20147,33792
202104,분당선,매교,3162,3198,6360
202104,분당선,수원시청,12983,14529,27512
202104,분당선,매탄권선,5267,4814,10081
202104,분당선,망포,15051,13893,28944
202104,분당선,영통,8850,9054,17904
202104,분당선,청명,4408,4081,8489
202104,분당선,상갈,5650,5219,10869
202104,분당선,기흥,9763,9258,19021
202104,분당선,신갈,4614,4632,9246
202104,분당선,구성,5254,5254,10508
202104,분당선,죽전,14447,15496,29943
202104,분당선,보정,2540,2304,4844
202104,분당선,이매,5874,5421,11295
202104,분당선,오리,12218,10148,22366
202104,분당선,미금,16091,17078,33169
202104,분당선,정자,18058,19254,37312
202104,분당선,수내,13578,13629,27207
202104,분당선,서현,25093,25858,50951
202104,분당선,야탑,26375,27501,53876
202104,분당선,모란,20615,20338,40953
202104,분당선,태평,13850,13346,27196
202104,분당선,가천대,8253,8817,17070
202104,분당선,선정릉,8393,8772,17165
202104,분당선,강남구청,10199,11362,21561
202104,분당선,압구정로데오,19925,22535,42460
202104,분당선,서울숲,15134,16617,31751
202104,분당선,수원,8792,7558,16350
202104,분당선,복정,1,0,1
202104,분당선,수서,14654,15799,30453
202104,분당선,대모산입구,3599,3286,6885
202104,분당선,개포동,4036,4212,8248
202104,분당선,구룡,2090,2016,4106
202104,분당선,도곡,7506,7392,14898
202104,분당선,한티,14247,15264,29511
202104,분당선,선릉,13355,19713,33068
202104,분당선,매교,3041,3123,6164
202104,분당선,수원시청,11756,12401,24157
202104,분당선,매탄권선,4756,4606,9362
202104,분당선,망포,13666,12925,26591
202104,분당선,영통,7776,8045,15821
202104,분당선,청명,4145,3960,8105
202104,분당선,상갈,5377,5068,10445
202104,분당선,기흥,9340,8889,18229
202104,분당선,신갈,4481,4477,8958
202104,분당선,구성,4979,5055,10034
202104,분당선,죽전,12873,14407,27280
202104,분당선,보정,2558,2288,4846
202104,분당선,이매,5623,5089,10712
202104,분당선,오리,11502,9797,21299
202104,분당선,미금,15149,15987,31136
202104,분당선,정자,16656,17813,34469
202104,분당선,수내,13065,12982,26047
202104,분당선,서현,23516,23748,47264
202104,분당선,야탑,25100,26158,51258
202104,분당선,모란,19336,19402,38738
202104,분당선,태평,13291,12916,26207
202104,분당선,가천대,8164,9392,17556
202104,분당선,선정릉,8312,8877,17189
202104,분당선,강남구청,9600,10902,20502
202104,분당선,압구정로데오,16638,18234,34872
202104,분당선,서울숲,11135,11552,22687
202104,분당선,수원,7866,6642,14508
202104,분당선,수서,13090,13357,26447
202104,분당선,대모산입구,3501,3211,6712
202104,분당선,개포동,3721,3832,7553
202104,분당선,구룡,2027,1997,4024
202104,분당선,도곡,6757,6919,13676
202104,분당선,한티,13110,13999,27109
202104,분당선,선릉,13418,19947,33365
202104,분당선,매교,3150,3200,6350
202104,분당선,수원시청,11896,12599,24495
202104,분당선,매탄권선,4870,4723,9593
202104,분당선,망포,13955,13330,27285
202104,분당선,영통,8024,8373,16397
202104,분당선,청명,4212,3986,8198
202104,분당선,상갈,5534,5269,10803
202104,분당선,기흥,9583,9104,18687
202104,분당선,신갈,4547,4525,9072
202104,분당선,구성,4964,5206,10170
202104,분당선,죽전,13233,14603,27836
202104,분당선,보정,2550,2276,4826
202104,분당선,이매,5771,5178,10949
202104,분당선,오리,11807,9945,21752
202104,분당선,미금,15395,16194,31589
202104,분당선,정자,17160,18280,35440
202104,분당선,수내,13288,13363,26651
202104,분당선,서현,23456,23898,47354
202104,분당선,야탑,25375,26274,51649
202104,분당선,모란,19498,19444,38942
202104,분당선,태평,13515,13154,26669
202104,분당선,가천대,8415,9582,17997
202104,분당선,선정릉,8509,8898,17407
202104,분당선,강남구청,9956,11440,21396
202104,분당선,압구정로데오,18104,19965,38069
202104,분당선,서울숲,11088,11467,22555
202104,분당선,수원,7888,6598,14486
202104,분당선,수서,13038,13213,26251
202104,분당선,대모산입구,3566,3323,6889
202104,분당선,개포동,3788,4001,7789
202104,분당선,구룡,2056,2079,4135
202104,분당선,도곡,6708,6927,13635
202104,분당선,한티,13471,14310,27781
202104,분당선,선릉,13583,20194,33777
202104,분당선,매교,3036,3145,6181
202104,분당선,수원시청,11929,12762,24691
202104,분당선,매탄권선,4941,4742,9683
202104,분당선,망포,13990,13333,27323
202104,분당선,영통,8061,8458,16519
202104,분당선,청명,4276,4088,8364
202104,분당선,상갈,5387,5133,10520
202104,분당선,기흥,9576,9026,18602
202104,분당선,신갈,4541,4556,9097
202104,분당선,구성,4979,5275,10254
202104,분당선,죽전,13299,14472,27771
202104,분당선,보정,2484,2283,4767
202104,분당선,이매,5877,5339,11216
202104,분당선,오리,11951,9972,21923
202104,분당선,미금,15488,16389,31877
202104,분당선,정자,17243,18215,35458
202104,분당선,수내,12977,13246,26223
202104,분당선,서현,23608,23858,47466
202104,분당선,야탑,25406,26321,51727
202104,분당선,모란,19549,19607,39156
202104,분당선,태평,13338,12915,26253
202104,분당선,가천대,8322,9470,17792
202104,분당선,선정릉,8171,8651,16822
202104,분당선,강남구청,9691,11063,20754
202104,분당선,압구정로데오,18100,19668,37768
202104,분당선,서울숲,11073,11557,22630
202104,분당선,수원,7962,6655,14617
202104,분당선,복정,1,0,1
202104,분당선,수서,12975,13250,26225
202104,분당선,대모산입구,3356,3218,6574
202104,분당선,개포동,3860,3987,7847
202104,분당선,구룡,2042,2048,4090
202104,분당선,도곡,6630,6574,13204
202104,분당선,한티,13219,14115,27334
202104,분당선,선릉,13295,19847,33142
202104,분당선,선릉,13426,19981,33407
202104,분당선,한티,13293,14270,27563
202104,분당선,도곡,6476,6595,13071
202104,분당선,구룡,2037,2023,4060
202104,분당선,개포동,3761,3922,7683
202104,분당선,대모산입구,3462,3218,6680
202104,분당선,수서,13422,13961,27383
202104,분당선,수원,8054,6825,14879
202104,분당선,서울숲,11003,11401,22404
202104,분당선,압구정로데오,18364,20109,38473
202104,분당선,강남구청,9992,11181,21173
202104,분당선,선정릉,8233,8733,16966
202104,분당선,가천대,8553,9657,18210
202104,분당선,태평,13312,12779,26091
202104,분당선,모란,19383,19205,38588
202104,분당선,야탑,25089,26099,51188
202104,분당선,서현,23412,23660,47072
202104,분당선,수내,13132,13325,26457
202104,분당선,정자,17024,18234,35258
202104,분당선,미금,15263,16296,31559
202104,분당선,오리,11682,9781,21463
202104,분당선,이매,5613,5286,10899
202104,분당선,보정,2505,2289,4794
202104,분당선,죽전,13236,14341,27577
202104,분당선,구성,5036,5211,10247
202104,분당선,신갈,4429,4446,8875
202104,분당선,기흥,9474,9039,18513
202104,분당선,상갈,5427,5150,10577
202104,분당선,청명,4315,4106,8421
202104,분당선,영통,8069,8284,16353
202104,분당선,망포,13826,13075,26901
202104,분당선,매탄권선,4830,4819,9649
202104,분당선,수원시청,11819,12691,24510
202104,분당선,매교,3068,3130,6198
202104,분당선,선릉,13385,19879,33264
202104,분당선,한티,14278,14996,29274
202104,분당선,도곡,7054,6952,14006
202104,분당선,구룡,2183,2011,4194
202104,분당선,개포동,3957,4101,8058
202104,분당선,대모산입구,3609,3386,6995
202104,분당선,수서,14693,15830,30523
202104,분당선,수원,8856,7634,16490
202104,분당선,서울숲,12475,12742,25217
202104,분당선,압구정로데오,20063,22765,42828
202104,분당선,강남구청,10370,11650,22020
202104,분당선,선정릉,8436,8902,17338
202104,분당선,가천대,8247,8760,17007
202104,분당선,태평,14122,13851,27973
202104,분당선,모란,27331,28314,55645
202104,분당선,야탑,26486,27660,54146
202104,분당선,서현,25050,25505,50555
202104,분당선,수내,13657,13694,27351
202104,분당선,정자,17743,19033,36776
202104,분당선,미금,16141,17084,33225
202104,분당선,오리,12420,10319,22739
202104,분당선,이매,6019,5501,11520
202104,분당선,보정,2577,2301,4878
202104,분당선,죽전,14398,15362,29760
202104,분당선,구성,5153,5247,10400
202104,분당선,신갈,4689,4704,9393
202104,분당선,기흥,9884,9321,19205
202104,분당선,상갈,5600,5290,10890
202104,분당선,청명,4544,4222,8766
202104,분당선,영통,8749,9040,17789
202104,분당선,망포,14987,13648,28635
202104,분당선,매탄권선,5171,4862,10033
202104,분당선,수원시청,12851,14291,27142
202104,분당선,매교,3072,3088,6160
202104,분당선,수원시청,11011,11635,22646
202104,분당선,매탄권선,4565,4548,9113
202104,분당선,망포,12979,12526,25505
202104,분당선,영통,7200,7493,14693
202104,분당선,청명,4003,3898,7901
202104,분당선,상갈,5114,4968,10082
202104,분당선,기흥,8973,8479,17452
202104,분당선,신갈,4165,4174,8339
202104,분당선,구성,4620,4739,9359
202104,분당선,죽전,11985,13373,25358
202104,분당선,보정,2392,2117,4509
202104,분당선,이매,5396,4922,10318
202104,분당선,오리,11124,9332,20456
202104,분당선,미금,14407,15467,29874
202104,분당선,정자,15854,16981,32835
202104,분당선,수내,12228,12315,24543
202104,분당선,서현,21954,22392,44346
202104,분당선,야탑,23937,24635,48572
202104,분당선,모란,18385,18470,36855
202104,분당선,태평,12895,12526,25421
202104,분당선,가천대,8459,9752,18211
202104,분당선,선정릉,8164,8490,16654
202104,분당선,강남구청,9620,10671,20291
202104,분당선,압구정로데오,15882,16889,32771
202104,분당선,서울숲,9104,9151,18255
202104,분당선,수원,7257,6057,13314
202104,분당선,수서,12888,13004,25892
202104,분당선,대모산입구,3300,3171,6471
202104,분당선,개포동,3594,3803,7397
202104,분당선,구룡,1962,1959,3921
202104,분당선,도곡,6455,6596,13051
202104,분당선,한티,12632,13926,26558
202104,분당선,선릉,13478,19649,33127
202104,분당선,매교,2865,2880,5745
202104,분당선,선릉,13520,19972,33492
202104,분당선,한티,13176,14151,27327
202104,분당선,도곡,6466,6507,12973
202104,분당선,구룡,1958,1913,3871
202104,분당선,개포동,3585,3814,7399
202104,분당선,대모산입구,3375,3221,6596
202104,분당선,수서,12757,13211,25968
202104,분당선,수원,7800,6470,14270
202104,분당선,서울숲,10954,11051,22005
202104,분당선,압구정로데오,17759,19406,37165
202104,분당선,강남구청,10002,11281,21283
202104,분당선,선정릉,8407,8900,17307
202104,분당선,가천대,8670,9797,18467
202104,분당선,태평,13247,12832,26079
202104,분당선,모란,19036,19034,38070
202104,분당선,야탑,24794,25523,50317
202104,분당선,서현,22676,23001,45677
202104,분당선,수내,12774,12802,25576
202104,분당선,정자,16788,17732,34520
202104,분당선,미금,14914,15827,30741
202104,분당선,오리,11601,9785,21386
202104,분당선,이매,5540,5120,10660
202104,분당선,보정,2475,2171,4646
202104,분당선,죽전,12746,13859,26605
202104,분당선,구성,4810,5013,9823
202104,분당선,신갈,4492,4419,8911
202104,분당선,기흥,9424,8754,18178
202104,분당선,상갈,5326,5178,10504
202104,분당선,청명,4103,3922,8025
202104,분당선,영통,7724,7869,15593
202104,분당선,망포,13443,12934,26377
202104,분당선,매탄권선,4736,4606,9342
202104,분당선,수원시청,11797,12505,24302
202104,분당선,매교,2921,3019,5940
202104,분당선,선릉,13534,20198,33732
202104,분당선,한티,13198,14158,27356
202104,분당선,도곡,6619,6657,13276
202104,분당선,구룡,1967,1992,3959
202104,분당선,개포동,3892,4089,7981
202104,분당선,대모산입구,3537,3344,6881
202104,분당선,수서,13116,13384,26500
202104,분당선,수원,7820,6412,14232
202104,분당선,서울숲,11436,11961,23397
202104,분당선,압구정로데오,17948,19551,37499
202104,분당선,강남구청,10044,11341,21385
202104,분당선,선정릉,8270,8818,17088
202104,분당선,가천대,8660,9817,18477
202104,분당선,태평,13745,13386,27131
202104,분당선,모란,25243,25905,51148
202104,분당선,야탑,25410,26239,51649
202104,분당선,서현,23610,23944,47554
202104,분당선,수내,12693,12749,25442
202104,분당선,정자,17147,18170,35317
202104,분당선,미금,15431,16467,31898
202104,분당선,오리,11798,9819,21617
202104,분당선,이매,5750,5271,11021
202104,분당선,보정,2510,2221,4731
202104,분당선,죽전,12964,14428,27392
202104,분당선,구성,4818,5138,9956
202104,분당선,신갈,4463,4536,8999
202104,분당선,기흥,9494,8895,18389
202104,분당선,상갈,5303,5190,10493
202104,분당선,청명,4187,3979,8166
202104,분당선,영통,8060,8171,16231
202104,분당선,망포,13656,13163,26819
202104,분당선,매탄권선,4809,4704,9513
202104,분당선,수원시청,11786,12545,24331
202104,분당선,매교,2966,3008,5974
202104,분당선,복정,1,0,1
202104,분당선,선릉,13671,20051,33722
202104,분당선,한티,13138,14155,27293
202104,분당선,도곡,6605,6501,13106
202104,분당선,구룡,1974,1957,3931
202104,분당선,개포동,3741,3965,7706
202104,분당선,대모산입구,3478,3192,6670
202104,분당선,수서,13292,13503,26795
202104,분당선,복정,1,0,1
202104,분당선,수원,7918,6619,14537
202104,분당선,서울숲,12095,12574,24669
202104,분당선,압구정로데오,18193,19977,38170
202104,분당선,강남구청,9793,11181,20974
202104,분당선,선정릉,8270,8791,17061
202104,분당선,가천대,8725,9709,18434
202104,분당선,태평,13327,12941,26268
202104,분당선,모란,19580,19399,38979
202104,분당선,야탑,24973,25766,50739
202104,분당선,서현,23067,23026,46093
202104,분당선,수내,12750,12921,25671
202104,분당선,정자,16653,17678,34331
202104,분당선,미금,15187,16109,31296
202104,분당선,오리,11511,9706,21217
202104,분당선,이매,5639,5291,10930
202104,분당선,보정,2530,2240,4770
202104,분당선,죽전,12905,14273,27178
202104,분당선,구성,4925,5161,10086
202104,분당선,신갈,4518,4531,9049
202104,분당선,기흥,9552,8816,18368
202104,분당선,상갈,5341,5220,10561
202104,분당선,청명,4173,3977,8150
202104,분당선,영통,7818,8134,15952
202104,분당선,망포,13745,13079,26824
202104,분당선,매탄권선,4816,4717,9533
202104,분당선,수원시청,11697,12466,24163
202104,분당선,매교,2979,3043,6022
202104,분당선,선릉,13163,19711,32874
202104,분당선,한티,13665,14601,28266
202104,분당선,도곡,6676,6665,13341
202104,분당선,구룡,1986,1906,3892
202104,분당선,개포동,3773,3969,7742
202104,분당선,대모산입구,3379,3124,6503
202104,분당선,수서,14048,15238,29286
202104,분당선,수원,8250,7032,15282
202104,분당선,서울숲,10781,10784,21565
202104,분당선,압구정로데오,19387,21732,41119
202104,분당선,강남구청,9805,11082,20887
202104,분당선,선정릉,8220,8681,16901
202104,분당선,가천대,8120,8705,16825
202104,분당선,태평,13298,12882,26180
202104,분당선,모란,19647,19553,39200
202104,분당선,야탑,25097,26525,51622
202104,분당선,서현,23748,24108,47856
202104,분당선,수내,12760,12759,25519
202104,분당선,정자,16601,17587,34188
202104,분당선,미금,15305,16018,31323
202104,분당선,오리,11431,9467,20898
202104,분당선,이매,5682,5199,10881
202104,분당선,보정,2358,2140,4498
202104,분당선,죽전,13168,14264,27432
202104,분당선,구성,4666,4928,9594
202104,분당선,신갈,4378,4406,8784
202104,분당선,기흥,9145,8927,18072
202104,분당선,상갈,5320,5039,10359
202104,분당선,청명,4215,3880,8095
202104,분당선,영통,8396,8509,16905
202104,분당선,망포,14685,13496,28181
202104,분당선,매탄권선,4973,4677,9650
202104,분당선,수원시청,12339,13789,26128
202104,분당선,매교,2967,3069,6036
202104,분당선,정자,16234,17149,33383
202104,분당선,수내,11917,11810,23727
202104,분당선,서현,21999,22121,44120
202104,분당선,야탑,24756,25771,50527
202104,분당선,모란,25043,26144,51187
202104,분당선,태평,13354,12963,26317
202104,분당선,가천대,8663,9889,18552
202104,분당선,선정릉,8231,8782,17013
202104,분당선,강남구청,9497,10667,20164
202104,분당선,압구정로데오,15280,16642,31922
202104,분당선,서울숲,11475,11785,23260
202104,분당선,수원,7421,6256,13677
202104,분당선,복정,1,0,1
202104,분당선,수서,13226,13312,26538
202104,분당선,대모산입구,3574,3319,6893
202104,분당선,개포동,3613,3833,7446
202104,분당선,구룡,1997,1959,3956
202104,분당선,도곡,6299,6410,12709
202104,분당선,한티,11987,12888,24875
202104,분당선,선릉,13180,19813,32993
202104,분당선,오리,11590,9762,21352
202104,분당선,이매,5536,5074,10610
202104,분당선,보정,2423,2209,4632
202104,분당선,죽전,11635,12960,24595
202104,분당선,구성,4815,5078,9893
202104,분당선,신갈,4413,4428,8841
202104,분당선,기흥,9173,8623,17796
202104,분당선,상갈,5157,5035,10192
202104,분당선,미금,15357,16303,31660
202104,분당선,청명,4160,3900,8060
202104,분당선,영통,7512,7748,15260
202104,분당선,망포,13368,12714,26082
202104,분당선,매탄권선,4802,4662,9464
202104,분당선,수원시청,11361,12122,23483
202104,분당선,매교,3151,3213,6364
202104,분당선,매교,3217,3176,6393
202104,분당선,수원시청,11883,12639,24522
202104,분당선,매탄권선,4766,4786,9552
202104,분당선,망포,13680,13117,26797
202104,분당선,영통,7810,8110,15920
202104,분당선,청명,4154,3983,8137
202104,분당선,상갈,5477,5297,10774
202104,분당선,기흥,9486,8827,18313
202104,분당선,신갈,4555,4574,9129
202104,분당선,구성,4883,5009,9892
202104,분당선,죽전,12784,14263,27047
202104,분당선,보정,2532,2257,4789
202104,분당선,이매,5548,5181,10729
202104,분당선,오리,11741,9913,21654
202104,분당선,미금,15248,15342,30590
202104,분당선,정자,16388,17586,33974
202104,분당선,수내,12716,12939,25655
202104,분당선,서현,23163,23301,46464
202104,분당선,야탑,24889,25992,50881
202104,분당선,모란,19242,19406,38648
202104,분당선,태평,13405,13012,26417
202104,분당선,가천대,11197,12318,23515
202104,분당선,선정릉,8321,8831,17152
202104,분당선,강남구청,9764,11364,21128
202104,분당선,압구정로데오,17908,19405,37313
202104,분당선,서울숲,11480,11882,23362
202104,분당선,수원,7746,6419,14165
202104,분당선,복정,1,0,1
202104,분당선,수서,12848,13269,26117
202104,분당선,대모산입구,3547,3251,6798
202104,분당선,개포동,3712,3867,7579
202104,분당선,구룡,2026,1966,3992
202104,분당선,도곡,6265,6269,12534
202104,분당선,한티,13255,14240,27495
202104,분당선,선릉,13413,19962,33375
202104,분당선,매교,3198,3266,6464
202104,분당선,수원시청,11817,12770,24587
202104,분당선,매탄권선,4920,4753,9673
202104,분당선,망포,13967,13220,27187
202104,분당선,영통,7902,8274,16176
202104,분당선,청명,4310,4169,8479
202104,분당선,상갈,5427,5231,10658
202104,분당선,기흥,9619,9053,18672
202104,분당선,신갈,4681,4646,9327
202104,분당선,구성,4986,5126,10112
202104,분당선,죽전,13107,14384,27491
202104,분당선,보정,2527,2300,4827
202104,분당선,이매,5591,5238,10829
202104,분당선,오리,11829,9870,21699
202104,분당선,미금,15910,16911,32821
202104,분당선,정자,16761,17816,34577
202104,분당선,수내,12799,12928,25727
202104,분당선,서현,23184,23344,46528
202104,분당선,야탑,25707,26951,52658
202104,분당선,모란,19720,19626,39346
202104,분당선,태평,13588,13038,26626
202104,분당선,가천대,10967,11979,22946
202104,분당선,선정릉,8237,8803,17040
202104,분당선,강남구청,9930,11325,21255
202104,분당선,압구정로데오,17785,19673,37458
202104,분당선,서울숲,11797,12306,24103
202104,분당선,수원,7922,6635,14557
202104,분당선,수서,13050,13606,26656
202104,분당선,대모산입구,3507,3336,6843
202104,분당선,개포동,3830,3973,7803
202104,분당선,구룡,2000,1943,3943
202104,분당선,도곡,6276,6393,12669
202104,분당선,한티,13189,14112,27301
202104,분당선,선릉,13475,19931,33406
202104,분당선,매교,3126,3210,6336
202104,분당선,수원시청,11769,12597,24366
202104,분당선,매탄권선,4722,4678,9400
202104,분당선,망포,13907,13129,27036
202104,분당선,영통,7731,8016,15747
202104,분당선,청명,4207,4049,8256
202104,분당선,상갈,5381,5167,10548
202104,분당선,기흥,9528,8855,18383
202104,분당선,신갈,4446,4494,8940
202104,분당선,구성,4858,5024,9882
202104,분당선,죽전,12917,14316,27233
202104,분당선,보정,2471,2161,4632
202104,분당선,이매,5605,5168,10773
202104,분당선,오리,11638,9801,21439
202104,분당선,미금,15284,16207,31491
202104,분당선,정자,16773,17778,34551
202104,분당선,수내,12732,12790,25522
202104,분당선,서현,23218,23230,46448
202104,분당선,야탑,24863,25694,50557
202104,분당선,모란,19800,19646,39446
202104,분당선,태평,13408,12926,26334
202104,분당선,가천대,10784,11560,22344
202104,분당선,선정릉,8188,8836,17024
202104,분당선,강남구청,9802,11322,21124
202104,분당선,압구정로데오,17876,19818,37694
202104,분당선,서울숲,11350,11689,23039
202104,분당선,수원,7954,6633,14587
202104,분당선,수서,13416,13905,27321
202104,분당선,대모산입구,3516,3334,6850
202104,분당선,개포동,3642,3743,7385
202104,분당선,구룡,1914,1930,3844
202104,분당선,도곡,6081,6183,12264
202104,분당선,한티,13077,13880,26957
202104,분당선,선릉,13273,19829,33102
202104,분당선,선릉,13290,19937,33227
202104,분당선,한티,14012,14641,28653
202104,분당선,도곡,6358,6404,12762
202104,분당선,구룡,2168,1974,4142
202104,분당선,개포동,3839,4001,7840
202104,분당선,대모산입구,3522,3342,6864
202104,분당선,수서,14677,15762,30439
202104,분당선,수원,8621,7319,15940
202104,분당선,서울숲,11699,11911,23610
202104,분당선,압구정로데오,20141,22708,42849
202104,분당선,강남구청,10376,11702,22078
202104,분당선,선정릉,8219,8899,17118
202104,분당선,가천대,9856,10499,20355
202104,분당선,태평,13624,13249,26873
202104,분당선,모란,20292,20181,40473
202104,분당선,야탑,25695,27238,52933
202104,분당선,서현,24414,24318,48732
202104,분당선,수내,13166,13281,26447
202104,분당선,정자,17336,18514,35850
202104,분당선,미금,15892,16717,32609
202104,분당선,오리,11840,9942,21782
202104,분당선,이매,5628,5254,10882
202104,분당선,보정,2504,2191,4695
202104,분당선,죽전,13901,14720,28621
202104,분당선,구성,4890,5067,9957
202104,분당선,신갈,4621,4546,9167
202104,분당선,기흥,9444,8972,18416
202104,분당선,상갈,5466,5225,10691
202104,분당선,청명,4401,4070,8471
202104,분당선,영통,8287,8581,16868
202104,분당선,망포,14822,13605,28427
202104,분당선,매탄권선,5059,4765,9824
202104,분당선,수원시청,12611,14221,26832
202104,분당선,매교,2830,2847,5677
202104,분당선,매교,2752,2792,5544
202104,분당선,수원시청,12127,12776,24903
202104,분당선,매탄권선,4920,4744,9664
202104,분당선,망포,13706,13038,26744
202104,분당선,영통,7663,7811,15474
202104,분당선,청명,4249,4067,8316
202104,분당선,상갈,5369,5139,10508
202104,분당선,기흥,9336,8761,18097
202104,분당선,신갈,4471,4483,8954
202104,분당선,구성,4801,5008,9809
202104,분당선,죽전,12947,14467,27414
202104,분당선,보정,2508,2212,4720
202104,분당선,이매,5666,5157,10823
202104,분당선,오리,11566,9776,21342
202104,분당선,미금,15272,16254,31526
202104,분당선,정자,16500,17504,34004
202104,분당선,수내,12738,12684,25422
202104,분당선,서현,23375,23457,46832
202104,분당선,야탑,24717,25930,50647
202104,분당선,모란,19547,19547,39094
202104,분당선,태평,13449,13008,26457
202104,분당선,가천대,10310,11311,21621
202104,분당선,선정릉,8392,8708,17100
202104,분당선,강남구청,9683,11072,20755
202104,분당선,압구정로데오,16195,17928,34123
202104,분당선,서울숲,10666,11188,21854
202104,분당선,수원,8121,6792,14913
202104,분당선,수서,13310,13455,26765
202104,분당선,대모산입구,3606,3314,6920
202104,분당선,개포동,3707,3805,7512
202104,분당선,구룡,2113,2073,4186
202104,분당선,도곡,6342,6422,12764
202104,분당선,한티,12948,13902,26850
202104,분당선,선릉,13373,20116,33489
202104,분당선,매교,3044,3141,6185
202104,분당선,수원시청,12100,12906,25006
202104,분당선,매탄권선,4875,4747,9622
202104,분당선,망포,13743,13279,27022
202104,분당선,영통,7640,7832,15472
202104,분당선,청명,4200,3991,8191
202104,분당선,상갈,5444,5284,10728
202104,분당선,기흥,9541,9030,18571
202104,분당선,신갈,4389,4490,8879
202104,분당선,구성,4911,5064,9975
202104,분당선,죽전,13188,14492,27680
202104,분당선,보정,2501,2191,4692
202104,분당선,이매,5766,5288,11054
202104,분당선,오리,11854,9925,21779
202104,분당선,미금,15141,16052,31193
202104,분당선,정자,17016,18142,35158
202104,분당선,수내,12865,12888,25753
202104,분당선,서현,23654,23851,47505
202104,분당선,야탑,25035,26182,51217
202104,분당선,모란,19431,19386,38817
202104,분당선,태평,13335,12972,26307
202104,분당선,가천대,8945,10064,19009
202104,분당선,선정릉,8417,8978,17395
202104,분당선,강남구청,9894,11366,21260
202104,분당선,압구정로데오,17972,19826,37798
202104,분당선,서울숲,10793,11059,21852
202104,분당선,수원,7918,6503,14421
202104,분당선,복정,1,0,1
202104,분당선,수서,13225,13582,26807
202104,분당선,대모산입구,3561,3316,6877
202104,분당선,개포동,3572,3812,7384
202104,분당선,구룡,2148,2083,4231
202104,분당선,도곡,6336,6263,12599
202104,분당선,한티,13356,14233,27589
202104,분당선,선릉,13448,19978,33426
202104,분당선,매교,2954,3061,6015
202104,분당선,수원시청,12080,13076,25156
202104,분당선,매탄권선,4884,4804,9688
202104,분당선,망포,13708,13133,26841
202104,분당선,영통,7907,8120,16027
202104,분당선,청명,4234,4013,8247
202104,분당선,상갈,5365,5115,10480
202104,분당선,기흥,9292,8878,18170
202104,분당선,신갈,4392,4372,8764
202104,분당선,구성,4877,5109,9986
202104,분당선,죽전,13342,14539,27881
202104,분당선,보정,2493,2196,4689
202104,분당선,이매,5668,5300,10968
202104,분당선,오리,11864,9965,21829
202104,분당선,미금,15384,16252,31636
202104,분당선,정자,17208,18294,35502
202104,분당선,수내,12966,13007,25973
202104,분당선,서현,23919,24473,48392
202104,분당선,야탑,25153,26247,51400
202104,분당선,모란,19311,19263,38574
202104,분당선,태평,13386,12973,26359
202104,분당선,가천대,8898,9998,18896
202104,분당선,선정릉,8298,8842,17140
202104,분당선,강남구청,10070,11364,21434
202104,분당선,압구정로데오,18127,20017,38144
202104,분당선,서울숲,10940,11155,22095
202104,분당선,수원,7873,6442,14315
202104,분당선,수서,13068,13683,26751
202104,분당선,대모산입구,3517,3317,6834
202104,분당선,개포동,3880,3996,7876
202104,분당선,구룡,2099,2077,4176
202104,분당선,도곡,6436,6488,12924
202104,분당선,한티,13308,14001,27309
202104,분당선,선릉,13486,20132,33618
202104,분당선,선릉,13467,19994,33461
202104,분당선,한티,13171,14019,27190
202104,분당선,도곡,6369,6447,12816
202104,분당선,구룡,2177,2099,4276
202104,분당선,개포동,3761,3890,7651
202104,분당선,대모산입구,3662,3413,7075
202104,분당선,수서,13813,14277,28090
202104,분당선,복정,1,0,1
202104,분당선,수원,8118,6752,14870
202104,분당선,서울숲,11230,11344,22574
202104,분당선,압구정로데오,18875,20555,39430
202104,분당선,강남구청,9854,11378,21232
202104,분당선,선정릉,8204,8883,17087
202104,분당선,가천대,9400,10291,19691
202104,분당선,태평,13661,13230,26891
202104,분당선,모란,25737,26483,52220
202104,분당선,야탑,25423,26504,51927
202104,분당선,서현,24277,24571,48848
202104,분당선,수내,13037,13175,26212
202104,분당선,정자,17048,18162,35210
202104,분당선,미금,15534,16526,32060
202104,분당선,오리,12209,10146,22355
202104,분당선,이매,5814,5391,11205
202104,분당선,보정,2525,2215,4740
202104,분당선,죽전,13676,14976,28652
202104,분당선,구성,5025,5204,10229
202104,분당선,신갈,4486,4504,8990
202104,분당선,기흥,9640,9044,18684
202104,분당선,상갈,5365,5208,10573
202104,분당선,청명,4255,4150,8405
202104,분당선,영통,7929,8110,16039
202104,분당선,망포,14001,13390,27391
202104,분당선,매탄권선,4984,4756,9740
202104,분당선,수원시청,12042,12941,24983
202104,분당선,매교,2988,3074,6062
202104,분당선,선릉,13355,19973,33328
202104,분당선,한티,13965,14658,28623
202104,분당선,도곡,6548,6543,13091
202104,분당선,구룡,2138,2012,4150
202104,분당선,개포동,3862,4065,7927
202104,분당선,대모산입구,3527,3264,6791
202104,분당선,수서,14548,15797,30345
202104,분당선,수원,8910,7497,16407
202104,분당선,서울숲,10771,10933,21704
202104,분당선,압구정로데오,20678,22949,43627
202104,분당선,강남구청,10167,11602,21769
202104,분당선,선정릉,8450,8985,17435
202104,분당선,가천대,8721,9045,17766
202104,분당선,태평,13776,13164,26940
202104,분당선,모란,20143,20272,40415
202104,분당선,야탑,26099,27588,53687
202104,분당선,서현,25292,26012,51304
202104,분당선,수내,13325,13168,26493
202104,분당선,정자,17568,18617,36185
202104,분당선,미금,15699,16498,32197
202104,분당선,오리,11965,10089,22054
202104,분당선,이매,5870,5359,11229
202104,분당선,보정,2500,2256,4756
202104,분당선,죽전,14084,14934,29018
202104,분당선,구성,4901,5226,10127
202104,분당선,신갈,4411,4403,8814
202104,분당선,기흥,9607,9258,18865
202104,분당선,상갈,5600,5417,11017
202104,분당선,청명,4530,4187,8717
202104,분당선,영통,8813,8925,17738
202104,분당선,망포,15127,13919,29046
202104,분당선,매탄권선,5320,4952,10272
202104,분당선,수원시청,12822,14327,27149
202104,분당선,매교,2977,3075,6052
202105,분당선,매교,3031,3070,6101
202105,분당선,수원시청,12181,12777,24958
202105,분당선,매탄권선,5016,4793,9809
202105,분당선,망포,13812,13159,26971
202105,분당선,영통,8049,8381,16430
202105,분당선,청명,4159,3952,8111
202105,분당선,상갈,5487,5223,10710
202105,분당선,기흥,9399,8713,18112
202105,분당선,신갈,4416,4432,8848
202105,분당선,구성,4914,5050,9964
202105,분당선,죽전,13075,14415,27490
202105,분당선,보정,2471,2185,4656
202105,분당선,이매,5607,5203,10810
202105,분당선,오리,11620,9891,21511
202105,분당선,미금,14981,16181,31162
202105,분당선,정자,16890,18124,35014
202105,분당선,수내,12881,12699,25580
202105,분당선,서현,24397,24520,48917
202105,분당선,야탑,25042,26082,51124
202105,분당선,모란,19572,19766,39338
202105,분당선,태평,13242,12876,26118
202105,분당선,가천대,8715,9798,18513
202105,분당선,선정릉,8103,8686,16789
202105,분당선,강남구청,9490,10784,20274
202105,분당선,압구정로데오,17011,18634,35645
202105,분당선,서울숲,10815,11210,22025
202105,분당선,수원,8067,6897,14964
202105,분당선,복정,3,0,3
202105,분당선,수서,13375,13472,26847
202105,분당선,대모산입구,3504,3313,6817
202105,분당선,개포동,3783,3987,7770
202105,분당선,구룡,2009,1964,3973
202105,분당선,도곡,6215,6344,12559
202105,분당선,한티,13126,13926,27052
202105,분당선,선릉,13347,19847,33194
202105,분당선,매교,2898,3003,5901
202105,분당선,수원시청,12198,13524,25722
202105,분당선,매탄권선,4944,4846,9790
202105,분당선,망포,14042,13316,27358
202105,분당선,영통,7841,8171,16012
202105,분당선,청명,4355,4070,8425
202105,분당선,상갈,5233,5027,10260
202105,분당선,기흥,9250,8789,18039
202105,분당선,신갈,4393,4431,8824
202105,분당선,구성,4689,4976,9665
202105,분당선,죽전,12890,14387,27277
202105,분당선,보정,2420,2091,4511
202105,분당선,이매,5545,5111,10656
202105,분당선,오리,11725,9782,21507
202105,분당선,미금,15061,15928,30989
202105,분당선,정자,17281,18309,35590
202105,분당선,수내,12801,12839,25640
202105,분당선,서현,24316,24755,49071
202105,분당선,야탑,24998,26176,51174
202105,분당선,모란,22972,23247,46219
202105,분당선,태평,13370,12902,26272
202105,분당선,가천대,8840,9758,18598
202105,분당선,선정릉,8403,8832,17235
202105,분당선,강남구청,9960,11288,21248
202105,분당선,압구정로데오,18936,20298,39234
202105,분당선,서울숲,9325,9544,18869
202105,분당선,수원,8097,6689,14786
202105,분당선,수서,13287,14388,27675
202105,분당선,대모산입구,3443,3247,6690
202105,분당선,개포동,3745,3820,7565
202105,분당선,구룡,2055,1950,4005
202105,분당선,도곡,6310,6257,12567
202105,분당선,한티,13343,14069,27412
202105,분당선,선릉,13657,19954,33611
202105,분당선,선릉,3219,4848,8067
202105,분당선,한티,7446,7606,15052
202105,분당선,도곡,2748,2629,5377
202105,분당선,구룡,900,873,1773
202105,분당선,개포동,2070,1996,4066
202105,분당선,대모산입구,1891,1802,3693
202105,분당선,수서,7173,7139,14312
202105,분당선,수원,6403,5278,11681
202105,분당선,서울숲,10023,11300,21323
202105,분당선,압구정로데오,13126,14826,27952
202105,분당선,강남구청,3537,4141,7678
202105,분당선,선정릉,2337,2338,4675
202105,분당선,가천대,4297,5012,9309
202105,분당선,태평,8745,8641,17386
202105,분당선,모란,12750,12797,25547
202105,분당선,야탑,13174,13734,26908
202105,분당선,서현,15489,15312,30801
202105,분당선,수내,6472,6288,12760
202105,분당선,정자,8233,8606,16839
202105,분당선,미금,8219,8835,17054
202105,분당선,오리,5833,4831,10664
202105,분당선,이매,3075,3010,6085
202105,분당선,보정,1165,1116,2281
202105,분당선,죽전,8881,9840,18721
202105,분당선,구성,2603,2664,5267
202105,분당선,신갈,2178,2233,4411
202105,분당선,기흥,5410,5193,10603
202105,분당선,상갈,3373,3403,6776
202105,분당선,청명,1996,1960,3956
202105,분당선,영통,5221,5216,10437
202105,분당선,망포,6897,6699,13596
202105,분당선,매탄권선,2719,2632,5351
202105,분당선,수원시청,7173,7403,14576
202105,분당선,매교,1667,1773,3440
202105,분당선,매교,2989,3118,6107
202105,분당선,수원시청,12079,12858,24937
202105,분당선,매탄권선,4920,4765,9685
202105,분당선,망포,13746,13081,26827
202105,분당선,영통,8130,8259,16389
202105,분당선,청명,4258,4007,8265
202105,분당선,상갈,5624,5383,11007
202105,분당선,기흥,9569,9022,18591
202105,분당선,신갈,4669,4722,9391
202105,분당선,구성,4986,5149,10135
202105,분당선,죽전,13355,14659,28014
202105,분당선,보정,2589,2241,4830
202105,분당선,이매,5598,5244,10842
202105,분당선,오리,11627,9794,21421
202105,분당선,미금,15344,16403,31747
202105,분당선,정자,17154,18174,35328
202105,분당선,수내,13139,13076,26215
202105,분당선,서현,24326,24775,49101
202105,분당선,야탑,25593,26677,52270
202105,분당선,모란,19875,19855,39730
202105,분당선,태평,13679,13097,26776
202105,분당선,가천대,8902,9848,18750
202105,분당선,선정릉,8211,8832,17043
202105,분당선,강남구청,9993,11444,21437
202105,분당선,압구정로데오,18479,20379,38858
202105,분당선,서울숲,10796,11259,22055
202105,분당선,수원,8057,6978,15035
202105,분당선,수서,13232,13997,27229
202105,분당선,대모산입구,3435,3272,6707
202105,분당선,개포동,3887,3945,7832
202105,분당선,선릉,13728,20210,33938
202105,분당선,한티,13233,14217,27450
202105,분당선,도곡,6131,6137,12268
202105,분당선,구룡,1703,1676,3379
202105,분당선,망포,14918,13718,28636
202105,분당선,영통,8582,8653,17235
202105,분당선,청명,4211,4052,8263
202105,분당선,상갈,5478,5290,10768
202105,분당선,기흥,9429,9069,18498
202105,분당선,신갈,4538,4488,9026
202105,분당선,구성,4749,5021,9770
202105,분당선,죽전,13669,14923,28592
202105,분당선,보정,2561,2155,4716
202105,분당선,이매,5777,5392,11169
202105,분당선,오리,11865,9807,21672
202105,분당선,미금,15707,16397,32104
202105,분당선,정자,17752,18329,36081
202105,분당선,수내,13060,13081,26141
202105,분당선,서현,25056,25655,50711
202105,분당선,야탑,25918,27325,53243
202105,분당선,모란,19902,19901,39803
202105,분당선,태평,13614,13164,26778
202105,분당선,가천대,8388,8881,17269
202105,분당선,선정릉,8029,8741,16770
202105,분당선,강남구청,10034,11305,21339
202105,분당선,압구정로데오,19802,22074,41876
202105,분당선,서울숲,10356,10255,20611
202105,분당선,수원,8562,7409,15971
202105,분당선,수서,13793,15311,29104
202105,분당선,매탄권선,5222,4902,10124
202105,분당선,수원시청,12815,14175,26990
202105,분당선,매교,2952,2999,5951
202105,분당선,대모산입구,3427,3204,6631
202105,분당선,개포동,3895,4096,7991
202105,분당선,구룡,1709,1706,3415
202105,분당선,도곡,6244,6157,12401
202105,분당선,한티,13903,14753,28656
202105,분당선,선릉,13428,19833,33261
202105,분당선,선릉,13623,20188,33811
202105,분당선,한티,13076,13935,27011
202105,분당선,도곡,6354,6319,12673
202105,분당선,구룡,2001,1976,3977
202105,분당선,개포동,3723,3897,7620
202105,분당선,대모산입구,3499,3211,6710
202105,분당선,수서,13474,13293,26767
202105,분당선,수원,7354,6026,13380
202105,분당선,매교,2895,2922,5817
202105,분당선,수원시청,11353,12055,23408
202105,분당선,매탄권선,4643,4570,9213
202105,분당선,망포,13205,12794,25999
202105,분당선,영통,7558,7832,15390
202105,분당선,청명,4070,3846,7916
202105,분당선,상갈,5165,4932,10097
202105,분당선,기흥,9144,8451,17595
202105,분당선,신갈,4373,4307,8680
202105,분당선,구성,4718,4944,9662
202105,분당선,죽전,12272,13729,26001
202105,분당선,보정,2508,2169,4677
202105,분당선,이매,5546,4986,10532
202105,분당선,오리,11396,9622,21018
202105,분당선,미금,14867,15819,30686
202105,분당선,정자,17036,17905,34941
202105,분당선,수내,12566,12493,25059
202105,분당선,서현,22901,23221,46122
202105,분당선,야탑,24483,25589,50072
202105,분당선,모란,18728,18738,37466
202105,분당선,태평,13135,12804,25939
202105,분당선,가천대,8379,9637,18016
202105,분당선,선정릉,8279,8766,17045
202105,분당선,강남구청,9675,10961,20636
202105,분당선,압구정로데오,16027,17650,33677
202105,분당선,서울숲,9216,9463,18679
202105,분당선,선릉,13821,20434,34255
202105,분당선,한티,13565,14469,28034
202105,분당선,도곡,6397,6569,12966
202105,분당선,구룡,2026,1978,4004
202105,분당선,개포동,3785,3923,7708
202105,분당선,대모산입구,3617,3395,7012
202105,분당선,수서,13336,13506,26842
202105,분당선,수원,8065,6804,14869
202105,분당선,서울숲,10992,11162,22154
202105,분당선,압구정로데오,18594,20515,39109
202105,분당선,강남구청,10075,11608,21683
202105,분당선,선정릉,8396,8975,17371
202105,분당선,가천대,8976,10018,18994
202105,분당선,태평,13735,13427,27162
202105,분당선,모란,19830,19887,39717
202105,분당선,야탑,25435,26530,51965
202105,분당선,서현,24086,24288,48374
202105,분당선,수내,13192,13284,26476
202105,분당선,정자,17877,18864,36741
202105,분당선,미금,15839,16754,32593
202105,분당선,오리,12169,10153,22322
202105,분당선,이매,5552,5227,10779
202105,분당선,보정,2682,2318,5000
202105,분당선,죽전,13407,14746,28153
202105,분당선,구성,5145,5324,10469
202105,분당선,신갈,4539,4660,9199
202105,분당선,기흥,9764,9068,18832
202105,분당선,상갈,5611,5337,10948
202105,분당선,청명,4379,4210,8589
202105,분당선,영통,8175,8496,16671
202105,분당선,망포,14215,13375,27590
202105,분당선,매탄권선,4924,4845,9769
202105,분당선,수원시청,12249,13055,25304
202105,분당선,매교,3214,3246,6460
202105,분당선,망포,14285,13663,27948
202105,분당선,매교,3205,3244,6449
202105,분당선,수원시청,12436,13376,25812
202105,분당선,매탄권선,4992,4809,9801
202105,분당선,영통,8314,8524,16838
202105,분당선,청명,4378,4189,8567
202105,분당선,상갈,5566,5309,10875
202105,분당선,기흥,9713,9102,18815
202105,분당선,신갈,4668,4704,9372
202105,분당선,구성,5095,5337,10432
202105,분당선,죽전,13556,15198,28754
202105,분당선,보정,2767,2309,5076
202105,분당선,이매,5800,5271,11071
202105,분당선,오리,12113,10082,22195
202105,분당선,미금,16007,16965,32972
202105,분당선,정자,17840,18809,36649
202105,분당선,수내,13275,13343,26618
202105,분당선,서현,23947,24393,48340
202105,분당선,야탑,25800,26870,52670
202105,분당선,모란,19862,19770,39632
202105,분당선,태평,13548,13134,26682
202105,분당선,가천대,8808,9769,18577
202105,분당선,선정릉,8172,8771,16943
202105,분당선,강남구청,10125,11624,21749
202105,분당선,압구정로데오,18325,20264,38589
202105,분당선,서울숲,10813,11068,21881
202105,분당선,수원,8133,6730,14863
202105,분당선,복정,2,0,2
202105,분당선,수서,13409,13792,27201
202105,분당선,대모산입구,3611,3343,6954
202105,분당선,개포동,4046,4255,8301
202105,분당선,구룡,2044,1934,3978
202105,분당선,도곡,6451,6557,13008
202105,분당선,한티,13741,14693,28434
202105,분당선,선릉,13690,20406,34096
202105,분당선,선릉,13767,20402,34169
202105,분당선,한티,13593,14545,28138
202105,분당선,도곡,6606,6535,13141
202105,분당선,구룡,2025,1965,3990
202105,분당선,개포동,3887,4061,7948
202105,분당선,대모산입구,3523,3315,6838
202105,분당선,수서,13684,14016,27700
202105,분당선,수원,8174,6731,14905
202105,분당선,서울숲,11185,11234,22419
202105,분당선,압구정로데오,18705,20638,39343
202105,분당선,강남구청,10066,11585,21651
202105,분당선,선정릉,8351,9028,17379
202105,분당선,가천대,8795,9366,18161
202105,분당선,태평,13426,13028,26454
202105,분당선,모란,19808,19783,39591
202105,분당선,야탑,25481,26714,52195
202105,분당선,서현,24113,24523,48636
202105,분당선,수내,13333,13437,26770
202105,분당선,정자,17699,18672,36371
202105,분당선,미금,15494,16423,31917
202105,분당선,오리,11874,9967,21841
202105,분당선,이매,5711,5310,11021
202105,분당선,보정,2639,2324,4963
202105,분당선,죽전,13342,14909,28251
202105,분당선,구성,5115,5257,10372
202105,분당선,신갈,4634,4592,9226
202105,분당선,기흥,9782,9076,18858
202105,분당선,상갈,5552,5413,10965
202105,분당선,청명,4294,4158,8452
202105,분당선,영통,8248,8395,16643
202105,분당선,망포,13990,13328,27318
202105,분당선,매탄권선,4965,4854,9819
202105,분당선,수원시청,12247,13143,25390
202105,분당선,매교,3105,3226,6331
202105,분당선,선릉,13980,20656,34636
202105,분당선,한티,14520,15710,30230
202105,분당선,도곡,6893,6996,13889
202105,분당선,구룡,2308,2133,4441
202105,분당선,개포동,4162,4273,8435
202105,분당선,대모산입구,3795,3404,7199
202105,분당선,수서,15371,16373,31744
202105,분당선,수원,8959,7812,16771
202105,분당선,서울숲,11997,12116,24113
202105,분당선,압구정로데오,21384,24062,45446
202105,분당선,강남구청,10573,12176,22749
202105,분당선,선정릉,8550,9097,17647
202105,분당선,가천대,8669,8970,17639
202105,분당선,태평,14159,13652,27811
202105,분당선,모란,26678,27356,54034
202105,분당선,야탑,27113,28388,55501
202105,분당선,서현,25894,26310,52204
202105,분당선,수내,13970,13898,27868
202105,분당선,정자,18713,19754,38467
202105,분당선,미금,16527,17360,33887
202105,분당선,오리,12547,10363,22910
202105,분당선,이매,6071,5713,11784
202105,분당선,보정,2726,2355,5081
202105,분당선,죽전,14577,15996,30573
202105,분당선,구성,5253,5382,10635
202105,분당선,신갈,4805,4787,9592
202105,분당선,기흥,9986,9496,19482
202105,분당선,상갈,5763,5461,11224
202105,분당선,청명,4728,4373,9101
202105,분당선,영통,9158,9322,18480
202105,분당선,망포,15488,14242,29730
202105,분당선,매탄권선,5401,5072,10473
202105,분당선,수원시청,13442,15128,28570
202105,분당선,매교,3223,3311,6534
202105,분당선,모란,18957,18889,37846
202105,분당선,야탑,24285,25492,49777
202105,분당선,서현,23007,23307,46314
202105,분당선,수내,12673,12577,25250
202105,분당선,정자,17089,18056,35145
202105,분당선,미금,14791,15641,30432
202105,분당선,오리,11483,9533,21016
202105,분당선,이매,5582,5034,10616
202105,분당선,보정,2441,2146,4587
202105,분당선,죽전,11719,13009,24728
202105,분당선,구성,4731,4905,9636
202105,분당선,신갈,4417,4342,8759
202105,분당선,기흥,9039,8440,17479
202105,분당선,상갈,5113,4873,9986
202105,분당선,청명,4058,3949,8007
202105,분당선,영통,7759,7921,15680
202105,분당선,망포,13492,12857,26349
202105,분당선,매탄권선,4730,4602,9332
202105,분당선,수원시청,11707,12375,24082
202105,분당선,매교,2945,2943,5888
202105,분당선,태평,13255,12951,26206
202105,분당선,가천대,7995,9005,17000
202105,분당선,선정릉,8208,8772,16980
202105,분당선,강남구청,9864,11269,21133
202105,분당선,압구정로데오,16749,18240,34989
202105,분당선,서울숲,9331,9462,18793
202105,분당선,수원,7477,6357,13834
202105,분당선,복정,1,0,1
202105,분당선,수서,13063,13465,26528
202105,분당선,대모산입구,3459,3151,6610
202105,분당선,개포동,3828,3875,7703
202105,분당선,구룡,1939,1956,3895
202105,분당선,도곡,6576,6745,13321
202105,분당선,한티,13203,14274,27477
202105,분당선,선릉,13565,20217,33782
202105,분당선,매교,3130,3185,6315
202105,분당선,수원시청,13271,14802,28073
202105,분당선,매탄권선,5174,4960,10134
202105,분당선,망포,15451,14358,29809
202105,분당선,영통,8502,8729,17231
202105,분당선,청명,4543,4304,8847
202105,분당선,상갈,5655,5463,11118
202105,분당선,기흥,10062,9516,19578
202105,분당선,신갈,4722,4682,9404
202105,분당선,구성,5111,5258,10369
202105,분당선,죽전,13944,15348,29292
202105,분당선,보정,2727,2324,5051
202105,분당선,이매,6026,5509,11535
202105,분당선,오리,12273,10330,22603
202105,분당선,미금,16292,17165,33457
202105,분당선,정자,18551,19774,38325
202105,분당선,수내,13551,13588,27139
202105,분당선,서현,25290,25582,50872
202105,분당선,야탑,26764,27963,54727
202105,분당선,모란,20507,20904,41411
202105,분당선,태평,14007,13618,27625
202105,분당선,가천대,8546,9138,17684
202105,분당선,선정릉,8577,9097,17674
202105,분당선,강남구청,10523,12100,22623
202105,분당선,압구정로데오,20036,22334,42370
202105,분당선,서울숲,11255,11475,22730
202105,분당선,수원,8590,7236,15826
202105,분당선,수서,14258,14802,29060
202105,분당선,대모산입구,3742,3454,7196
202105,분당선,개포동,4005,4080,8085
202105,분당선,구룡,2102,2006,4108
202105,분당선,도곡,7105,7036,14141
202105,분당선,한티,14138,14890,29028
202105,분당선,선릉,14160,21198,35358
202105,분당선,매교,1847,1956,3803
202105,분당선,수원시청,7722,7863,15585
202105,분당선,매탄권선,2905,2725,5630
202105,분당선,망포,7588,7231,14819
202105,분당선,영통,5407,5453,10860
202105,분당선,청명,2377,2297,4674
202105,분당선,상갈,3698,3707,7405
202105,분당선,기흥,5839,5560,11399
202105,분당선,신갈,2442,2516,4958
202105,분당선,구성,2969,3113,6082
202105,분당선,죽전,9559,10561,20120
202105,분당선,보정,1358,1299,2657
202105,분당선,이매,3605,3520,7125
202105,분당선,오리,6448,5369,11817
202105,분당선,미금,9072,9552,18624
202105,분당선,정자,9070,9445,18515
202105,분당선,수내,7278,7040,14318
202105,분당선,서현,16292,16339,32631
202105,분당선,야탑,14040,14557,28597
202105,분당선,모란,19719,20394,40113
202105,분당선,태평,9845,9368,19213
202105,분당선,가천대,4613,5355,9968
202105,분당선,선정릉,2830,2835,5665
202105,분당선,강남구청,3799,4576,8375
202105,분당선,압구정로데오,14112,16021,30133
202105,분당선,서울숲,10178,10884,21062
202105,분당선,수원,6579,5401,11980
202105,분당선,수서,8017,8205,16222
202105,분당선,대모산입구,2109,2015,4124
202105,분당선,개포동,2287,2243,4530
202105,분당선,구룡,1105,1072,2177
202105,분당선,도곡,3253,3043,6296
202105,분당선,한티,8291,8450,16741
202105,분당선,선릉,3531,5102,8633
202105,분당선,매교,3010,3095,6105
202105,분당선,수원시청,11903,12460,24363
202105,분당선,매탄권선,4671,4672,9343
202105,분당선,망포,13489,12999,26488
202105,분당선,영통,7931,8173,16104
202105,분당선,청명,4110,4025,8135
202105,분당선,상갈,5282,5078,10360
202105,분당선,기흥,9405,8864,18269
202105,분당선,신갈,4443,4495,8938
202105,분당선,구성,4875,5147,10022
202105,분당선,죽전,12927,14591,27518
202105,분당선,보정,2542,2260,4802
202105,분당선,이매,5609,5318,10927
202105,분당선,오리,11737,9889,21626
202105,분당선,미금,15378,16381,31759
202105,분당선,정자,17431,18189,35620
202105,분당선,수내,13087,13182,26269
202105,분당선,서현,23596,23723,47319
202105,분당선,야탑,24869,25688,50557
202105,분당선,모란,19131,19168,38299
202105,분당선,태평,13290,12875,26165
202105,분당선,가천대,8481,9498,17979
202105,분당선,선정릉,8482,8880,17362
202105,분당선,강남구청,10177,11541,21718
202105,분당선,압구정로데오,18364,19945,38309
202105,분당선,서울숲,9932,10013,19945
202105,분당선,수원,7745,6492,14237
202105,분당선,수서,13348,13771,27119
202105,분당선,대모산입구,3558,3324,6882
202105,분당선,개포동,3801,3915,7716
202105,분당선,구룡,1972,1937,3909
202105,분당선,도곡,6581,6649,13230
202105,분당선,한티,13385,14506,27891
202105,분당선,선릉,13816,20643,34459
202105,분당선,매교,3031,3097,6128
202105,분당선,수원시청,12880,14229,27109
202105,분당선,매탄권선,5065,4816,9881
202105,분당선,망포,14696,13673,28369
202105,분당선,영통,8557,8625,17182
202105,분당선,청명,4427,4100,8527
202105,분당선,상갈,5620,5254,10874
202105,분당선,기흥,9412,8997,18409
202105,분당선,신갈,4609,4553,9162
202105,분당선,구성,5017,5226,10243
202105,분당선,죽전,13799,15015,28814
202105,분당선,보정,2592,2187,4779
202105,분당선,이매,5804,5384,11188
202105,분당선,오리,11980,9939,21919
202105,분당선,미금,15755,16427,32182
202105,분당선,정자,18121,19073,37194
202105,분당선,수내,13423,13195,26618
202105,분당선,서현,24705,25403,50108
202105,분당선,야탑,25804,27319,53123
202105,분당선,모란,19939,19746,39685
202105,분당선,태평,13639,13130,26769
202105,분당선,가천대,8354,8926,17280
202105,분당선,선정릉,8488,8921,17409
202105,분당선,강남구청,10357,11577,21934
202105,분당선,압구정로데오,20261,22571,42832
202105,분당선,서울숲,10538,10652,21190
202105,분당선,수원,8521,7175,15696
202105,분당선,수서,14499,15637,30136
202105,분당선,대모산입구,3518,3286,6804
202105,분당선,개포동,3986,4092,8078
202105,분당선,구룡,2124,1983,4107
202105,분당선,도곡,6888,6783,13671
202105,분당선,한티,14273,15284,29557
202105,분당선,선릉,13849,20569,34418
202105,분당선,복정,1,0,1
202105,분당선,복정,1,0,1
202105,분당선,매교,3124,3196,6320
202105,분당선,수원시청,12133,12912,25045
202105,분당선,매탄권선,4916,4804,9720
202105,분당선,망포,13595,13171,26766
202105,분당선,영통,8204,8409,16613
202105,분당선,청명,4313,4081,8394
202105,분당선,상갈,5460,5199,10659
202105,분당선,기흥,9664,9029,18693
202105,분당선,신갈,4620,4594,9214
202105,분당선,구성,5017,5171,10188
202105,분당선,죽전,13108,14558,27666
202105,분당선,보정,2554,2270,4824
202105,분당선,이매,5720,5327,11047
202105,분당선,오리,11875,10048,21923
202105,분당선,미금,15561,16552,32113
202105,분당선,정자,17404,18264,35668
202105,분당선,수내,12319,12223,24542
202105,분당선,서현,23590,24151,47741
202105,분당선,야탑,25596,26498,52094
202105,분당선,모란,24918,25688,50606
202105,분당선,태평,13790,13304,27094
202105,분당선,가천대,8317,9474,17791
202105,분당선,선정릉,8226,8951,17177
202105,분당선,강남구청,10033,11392,21425
202105,분당선,압구정로데오,16784,18383,35167
202105,분당선,서울숲,10602,10891,21493
202105,분당선,수원,7939,6486,14425
202105,분당선,수서,13594,13822,27416
202105,분당선,대모산입구,3680,3444,7124
202105,분당선,개포동,3770,3926,7696
202105,분당선,구룡,2079,2062,4141
202105,분당선,도곡,6605,6629,13234
202105,분당선,한티,12629,12965,25594
202105,분당선,선릉,13787,20564,34351
202105,분당선,선릉,13856,20692,34548
202105,분당선,한티,13710,14578,28288
202105,분당선,도곡,6718,6656,13374
202105,분당선,구룡,1976,1963,3939
202105,분당선,개포동,3739,3881,7620
202105,분당선,대모산입구,3538,3281,6819
202105,분당선,수서,13050,13355,26405
202105,분당선,수원,7793,6391,14184
202105,분당선,서울숲,10665,10928,21593
202105,분당선,압구정로데오,18054,20019,38073
202105,분당선,강남구청,10136,11648,21784
202105,분당선,선정릉,8507,9283,17790
202105,분당선,가천대,8756,9871,18627
202105,분당선,태평,13497,13129,26626
202105,분당선,모란,19536,19462,38998
202105,분당선,야탑,25365,26369,51734
202105,분당선,서현,23511,23789,47300
202105,분당선,수내,13145,13237,26382
202105,분당선,정자,17394,18332,35726
202105,분당선,미금,15471,16258,31729
202105,분당선,오리,11855,9970,21825
202105,분당선,이매,5642,5169,10811
202105,분당선,보정,2605,2249,4854
202105,분당선,죽전,12964,14184,27148
202105,분당선,구성,4903,5129,10032
202105,분당선,신갈,4501,4531,9032
202105,분당선,기흥,9621,8900,18521
202105,분당선,상갈,5334,5176,10510
202105,분당선,청명,4162,3983,8145
202105,분당선,영통,8044,8348,16392
202105,분당선,망포,13851,13238,27089
202105,분당선,매탄권선,4860,4661,9521
202105,분당선,수원시청,12139,13072,25211
202105,분당선,매교,2996,3087,6083
202105,분당선,매교,3120,3205,6325
202105,분당선,수원시청,12355,13345,25700
202105,분당선,매탄권선,4951,4857,9808
202105,분당선,망포,14147,13382,27529
202105,분당선,영통,8406,8556,16962
202105,분당선,청명,4397,4189,8586
202105,분당선,상갈,5609,5306,10915
202105,분당선,기흥,9743,9036,18779
202105,분당선,신갈,4569,4617,9186
202105,분당선,구성,5062,5248,10310
202105,분당선,죽전,13348,14793,28141
202105,분당선,보정,2640,2361,5001
202105,분당선,이매,5801,5361,11162
202105,분당선,오리,12025,10123,22148
202105,분당선,미금,15879,16884,32763
202105,분당선,정자,17829,18722,36551
202105,분당선,수내,13058,13171,26229
202105,분당선,서현,24246,24722,48968
202105,분당선,야탑,25662,26784,52446
202105,분당선,모란,19772,19727,39499
202105,분당선,태평,13619,13019,26638
202105,분당선,가천대,8318,9399,17717
202105,분당선,선정릉,8462,9014,17476
202105,분당선,강남구청,10263,11877,22140
202105,분당선,압구정로데오,18549,20217,38766
202105,분당선,선릉,13941,20664,34605
202105,분당선,한티,14134,15060,29194
202105,분당선,도곡,6714,6649,13363
202105,분당선,구룡,2118,2014,4132
202105,분당선,개포동,4036,4085,8121
202105,분당선,대모산입구,3525,3354,6879
202105,분당선,수서,13286,13477,26763
202105,분당선,수원,8001,6623,14624
202105,분당선,서울숲,10864,11352,22216
202105,분당선,선릉,13751,20629,34380
202105,분당선,매교,2951,2976,5927
202105,분당선,수원시청,11823,12733,24556
202105,분당선,매탄권선,4854,4673,9527
202105,분당선,망포,13775,13037,26812
202105,분당선,영통,8026,8264,16290
202105,분당선,청명,4119,3969,8088
202105,분당선,상갈,5345,5067,10412
202105,분당선,기흥,9420,8637,18057
202105,분당선,신갈,4424,4364,8788
202105,분당선,구성,4724,4994,9718
202105,분당선,죽전,12585,13877,26462
202105,분당선,보정,2574,2235,4809
202105,분당선,이매,5511,5093,10604
202105,분당선,오리,11546,9729,21275
202105,분당선,미금,14896,15750,30646
202105,분당선,정자,17331,18150,35481
202105,분당선,수내,12656,12766,25422
202105,분당선,서현,22757,23217,45974
202105,분당선,야탑,24658,25533,50191
202105,분당선,모란,18970,18788,37758
202105,분당선,태평,13200,12769,25969
202105,분당선,가천대,8452,9347,17799
202105,분당선,선정릉,8203,8960,17163
202105,분당선,강남구청,9872,11399,21271
202105,분당선,압구정로데오,17927,19884,37811
202105,분당선,서울숲,9893,10074,19967
202105,분당선,수원,7604,6317,13921
202105,분당선,수서,13377,13695,27072
202105,분당선,대모산입구,3519,3276,6795
202105,분당선,개포동,3690,3854,7544
202105,분당선,구룡,1942,1925,3867
202105,분당선,도곡,6498,6328,12826
202105,분당선,한티,13408,14481,27889
202105,분당선,죽전,13202,14279,27481
202105,분당선,구성,4799,4925,9724
202105,분당선,신갈,4391,4346,8737
202105,분당선,기흥,9393,8697,18090
202105,분당선,상갈,5258,5013,10271
202105,분당선,청명,4413,4044,8457
202105,분당선,영통,8522,8654,17176
202105,분당선,망포,14707,13500,28207
202105,분당선,매탄권선,5205,4858,10063
202105,분당선,수원시청,12650,14080,26730
202105,분당선,매교,2923,3004,5927
202105,분당선,보정,2395,2000,4395
202105,분당선,이매,5616,5163,10779
202105,분당선,오리,11617,9791,21408
202105,분당선,미금,15304,15974,31278
202105,분당선,정자,17739,18585,36324
202105,분당선,수내,12973,13051,26024
202105,분당선,서현,23835,24370,48205
202105,분당선,야탑,25233,26371,51604
202105,분당선,모란,19297,19432,38729
202105,분당선,태평,13459,12787,26246
202105,분당선,가천대,8044,8715,16759
202105,분당선,선정릉,8219,8855,17074
202105,분당선,강남구청,10217,11700,21917
202105,분당선,압구정로데오,19614,22121,41735
202105,분당선,서울숲,10319,10631,20950
202105,분당선,수원,8311,7002,15313
202105,분당선,수서,14352,15343,29695
202105,분당선,대모산입구,3435,3086,6521
202105,분당선,개포동,3743,3917,7660
202105,분당선,구룡,2029,1939,3968
202105,분당선,도곡,6558,6550,13108
202105,분당선,한티,14138,15169,29307
202105,분당선,선릉,13458,20382,33840
202105,분당선,수원,7659,6467,14126
202105,분당선,서울숲,10104,10330,20434
202105,분당선,압구정로데오,15897,17561,33458
202105,분당선,강남구청,9568,10834,20402
202105,분당선,선정릉,8065,8681,16746
202105,분당선,가천대,8332,9407,17739
202105,분당선,태평,13144,12702,25846
202105,분당선,모란,18969,19230,38199
202105,분당선,야탑,24505,25653,50158
202105,분당선,서현,22869,23233,46102
202105,분당선,수내,12598,12527,25125
202105,분당선,정자,16934,17949,34883
202105,분당선,미금,14938,15827,30765
202105,분당선,오리,11649,9754,21403
202105,분당선,이매,5530,5095,10625
202105,분당선,보정,2504,2193,4697
202105,분당선,죽전,12738,14069,26807
202105,분당선,구성,4840,5076,9916
202105,분당선,신갈,4449,4306,8755
202105,분당선,기흥,9393,8701,18094
202105,분당선,상갈,5358,5158,10516
202105,분당선,청명,4132,3898,8030
202105,분당선,영통,7809,8081,15890
202105,분당선,망포,13578,12908,26486
202105,분당선,매탄권선,4852,4654,9506
202105,분당선,수원시청,11890,12695,24585
202105,분당선,매교,2967,2986,5953
202105,분당선,대모산입구,3506,3238,6744
202105,분당선,개포동,3674,3884,7558
202105,분당선,구룡,2074,1958,4032
202105,분당선,도곡,6613,6603,13216
202105,분당선,한티,13337,14233,27570
202105,분당선,선릉,13618,20164,33782
202105,분당선,수서,13158,13246,26404
202106,분당선,선릉,13642,20744,34386
202106,분당선,한티,13556,14648,28204
202106,분당선,도곡,6762,6580,13342
202106,분당선,구룡,2027,1930,3957
202106,분당선,개포동,3789,3904,7693
202106,분당선,대모산입구,3541,3296,6837
202106,분당선,수서,12656,12872,25528
202106,분당선,복정,1,0,1
202106,분당선,수원,7699,6233,13932
202106,분당선,서울숲,10587,10869,21456
202106,분당선,압구정로데오,17938,19545,37483
202106,분당선,강남구청,9931,11271,21202
202106,분당선,선정릉,8093,8792,16885
202106,분당선,가천대,8306,9244,17550
202106,분당선,태평,13413,12976,26389
202106,분당선,모란,19223,19240,38463
202106,분당선,야탑,24880,26043,50923
202106,분당선,서현,23321,23628,46949
202106,분당선,수내,12875,12993,25868
202106,분당선,정자,17068,17999,35067
202106,분당선,미금,15149,16203,31352
202106,분당선,오리,11826,9867,21693
202106,분당선,이매,5504,5086,10590
202106,분당선,보정,2575,2252,4827
202106,분당선,죽전,12890,14280,27170
202106,분당선,구성,4943,5064,10007
202106,분당선,신갈,4544,4520,9064
202106,분당선,기흥,9536,8812,18348
202106,분당선,상갈,5195,5077,10272
202106,분당선,청명,4229,4064,8293
202106,분당선,영통,8064,8190,16254
202106,분당선,망포,13858,13198,27056
202106,분당선,매탄권선,4761,4777,9538
202106,분당선,수원시청,12227,13000,25227
202106,분당선,매교,2943,2955,5898
202106,분당선,선릉,13822,20574,34396
202106,분당선,한티,13648,14501,28149
202106,분당선,도곡,6656,6606,13262
202106,분당선,구룡,2054,1999,4053
202106,분당선,개포동,3913,4023,7936
202106,분당선,대모산입구,3462,3280,6742
202106,분당선,수서,12938,13088,26026
202106,분당선,수원,7775,6472,14247
202106,분당선,서울숲,11254,11407,22661
202106,분당선,압구정로데오,17941,19559,37500
202106,분당선,강남구청,10218,11658,21876
202106,분당선,선정릉,8182,8835,17017
202106,분당선,가천대,8317,9369,17686
202106,분당선,태평,13435,13018,26453
202106,분당선,모란,19189,19324,38513
202106,분당선,야탑,25420,26530,51950
202106,분당선,서현,23270,23747,47017
202106,분당선,수내,12954,12988,25942
202106,분당선,정자,17454,18475,35929
202106,분당선,미금,15401,16181,31582
202106,분당선,오리,11643,9818,21461
202106,분당선,이매,5716,5209,10925
202106,분당선,보정,2484,2192,4676
202106,분당선,죽전,12974,14330,27304
202106,분당선,구성,5041,5213,10254
202106,분당선,신갈,4494,4463,8957
202106,분당선,기흥,9504,8969,18473
202106,분당선,상갈,5355,5170,10525
202106,분당선,청명,4277,4139,8416
202106,분당선,영통,8197,8324,16521
202106,분당선,망포,13938,13230,27168
202106,분당선,매탄권선,4862,4773,9635
202106,분당선,수원시청,12031,13045,25076
202106,분당선,매교,2985,3023,6008
202106,분당선,선릉,14024,20287,34311
202106,분당선,한티,13709,14447,28156
202106,분당선,도곡,6535,6591,13126
202106,분당선,구룡,1945,1912,3857
202106,분당선,개포동,3733,3843,7576
202106,분당선,대모산입구,3382,3187,6569
202106,분당선,수서,12978,13446,26424
202106,분당선,복정,1,0,1
202106,분당선,수원,7160,6028,13188
202106,분당선,서울숲,10071,10409,20480
202106,분당선,압구정로데오,17817,19065,36882
202106,분당선,강남구청,9869,11430,21299
202106,분당선,선정릉,8306,8747,17053
202106,분당선,가천대,8311,9154,17465
202106,분당선,태평,13057,12615,25672
202106,분당선,모란,18551,18539,37090
202106,분당선,야탑,24325,25356,49681
202106,분당선,서현,22786,23120,45906
202106,분당선,수내,12673,12867,25540
202106,분당선,정자,17299,18395,35694
202106,분당선,미금,14546,15444,29990
202106,분당선,오리,11413,9642,21055
202106,분당선,이매,5698,5110,10808
202106,분당선,보정,2455,2171,4626
202106,분당선,죽전,12345,13791,26136
202106,분당선,구성,4611,5008,9619
202106,분당선,신갈,4297,4344,8641
202106,분당선,기흥,9267,8647,17914
202106,분당선,상갈,5134,5016,10150
202106,분당선,청명,4149,3984,8133
202106,분당선,영통,7671,7996,15667
202106,분당선,망포,13408,12814,26222
202106,분당선,매탄권선,4579,4692,9271
202106,분당선,수원시청,11506,12161,23667
202106,분당선,매교,2845,2884,5729
202106,분당선,선릉,13855,20526,34381
202106,분당선,한티,14696,15498,30194
202106,분당선,도곡,7002,6744,13746
202106,분당선,구룡,2281,2024,4305
202106,분당선,개포동,4022,4152,8174
202106,분당선,대모산입구,3651,3357,7008
202106,분당선,수서,14668,15818,30486
202106,분당선,복정,1,0,1
202106,분당선,수원,8315,7386,15701
202106,분당선,서울숲,12018,12365,24383
202106,분당선,압구정로데오,20241,22448,42689
202106,분당선,강남구청,10535,11744,22279
202106,분당선,선정릉,8186,8956,17142
202106,분당선,가천대,8021,8639,16660
202106,분당선,태평,14158,13544,27702
202106,분당선,모란,26431,27262,53693
202106,분당선,야탑,26931,27899,54830
202106,분당선,서현,24941,25646,50587
202106,분당선,수내,13363,13387,26750
202106,분당선,정자,18394,19714,38108
202106,분당선,미금,15972,17096,33068
202106,분당선,오리,12448,10298,22746
202106,분당선,이매,6038,5648,11686
202106,분당선,보정,2640,2315,4955
202106,분당선,죽전,14235,15287,29522
202106,분당선,구성,5137,5260,10397
202106,분당선,신갈,4631,4588,9219
202106,분당선,기흥,9790,9288,19078
202106,분당선,상갈,5661,5318,10979
202106,분당선,청명,4550,4227,8777
202106,분당선,영통,8885,8911,17796
202106,분당선,망포,15227,13915,29142
202106,분당선,매탄권선,5430,5005,10435
202106,분당선,수원시청,13260,14886,28146
202106,분당선,매교,3176,3152,6328
202106,분당선,매교,2893,2985,5878
202106,분당선,수원시청,11820,12625,24445
202106,분당선,매탄권선,4774,4703,9477
202106,분당선,망포,13600,13002,26602
202106,분당선,영통,7943,8085,16028
202106,분당선,청명,4222,4012,8234
202106,분당선,상갈,5409,5071,10480
202106,분당선,기흥,9212,8791,18003
202106,분당선,신갈,4426,4353,8779
202106,분당선,구성,4890,5116,10006
202106,분당선,죽전,12800,13978,26778
202106,분당선,보정,2525,2226,4751
202106,분당선,이매,5225,4989,10214
202106,분당선,오리,11511,9809,21320
202106,분당선,미금,15006,15845,30851
202106,분당선,정자,16793,17678,34471
202106,분당선,수내,12371,12491,24862
202106,분당선,서현,22975,23176,46151
202106,분당선,야탑,24714,25856,50570
202106,분당선,모란,19038,19177,38215
202106,분당선,태평,13230,12828,26058
202106,분당선,가천대,8489,9690,18179
202106,분당선,선정릉,8060,8610,16670
202106,분당선,강남구청,9395,10725,20120
202106,분당선,압구정로데오,16133,17506,33639
202106,분당선,서울숲,9653,9748,19401
202106,분당선,수원,7585,6369,13954
202106,분당선,복정,1,0,1
202106,분당선,수서,12851,13034,25885
202106,분당선,대모산입구,3470,3243,6713
202106,분당선,개포동,3717,3834,7551
202106,분당선,구룡,2043,1962,4005
202106,분당선,도곡,6519,6537,13056
202106,분당선,한티,13242,14416,27658
202106,분당선,선릉,13508,20140,33648
202106,분당선,선릉,13893,20712,34605
202106,분당선,한티,13556,14635,28191
202106,분당선,도곡,6693,6699,13392
202106,분당선,구룡,2034,1922,3956
202106,분당선,개포동,3773,3869,7642
202106,분당선,대모산입구,3520,3257,6777
202106,분당선,수서,13067,13187,26254
202106,분당선,수원,7630,6411,14041
202106,분당선,서울숲,10175,10223,20398
202106,분당선,압구정로데오,17744,19294,37038
202106,분당선,강남구청,9960,11488,21448
202106,분당선,선정릉,8270,8829,17099
202106,분당선,가천대,11558,12578,24136
202106,분당선,태평,13292,12878,26170
202106,분당선,모란,19495,19396,38891
202106,분당선,야탑,25244,26325,51569
202106,분당선,서현,23325,23807,47132
202106,분당선,수내,12771,13118,25889
202106,분당선,정자,17576,18623,36199
202106,분당선,미금,15506,16236,31742
202106,분당선,오리,11611,9889,21500
202106,분당선,이매,5549,5147,10696
202106,분당선,보정,2524,2213,4737
202106,분당선,죽전,12846,14166,27012
202106,분당선,구성,4920,5086,10006
202106,분당선,신갈,4611,4567,9178
202106,분당선,기흥,9499,9085,18584
202106,분당선,상갈,5495,5292,10787
202106,분당선,청명,4238,4016,8254
202106,분당선,영통,8000,8281,16281
202106,분당선,망포,13983,13425,27408
202106,분당선,매탄권선,4891,4784,9675
202106,분당선,수원시청,11905,12690,24595
202106,분당선,매교,3079,3088,6167
202106,분당선,선릉,13723,20387,34110
202106,분당선,한티,13631,14680,28311
202106,분당선,도곡,6732,6610,13342
202106,분당선,구룡,2024,1969,3993
202106,분당선,개포동,3896,4029,7925
202106,분당선,대모산입구,3563,3255,6818
202106,분당선,수서,13270,13668,26938
202106,분당선,수원,7641,6438,14079
202106,분당선,서울숲,10205,10503,20708
202106,분당선,압구정로데오,17887,19486,37373
202106,분당선,강남구청,10024,11439,21463
202106,분당선,선정릉,8252,8919,17171
202106,분당선,가천대,10864,11737,22601
202106,분당선,태평,13579,13102,26681
202106,분당선,모란,24494,25039,49533
202106,분당선,야탑,25296,26284,51580
202106,분당선,서현,23926,24122,48048
202106,분당선,수내,12817,12944,25761
202106,분당선,정자,17467,18758,36225
202106,분당선,미금,15538,16569,32107
202106,분당선,오리,11844,10003,21847
202106,분당선,이매,5780,5440,11220
202106,분당선,보정,2510,2207,4717
202106,분당선,죽전,12956,14307,27263
202106,분당선,구성,5005,5157,10162
202106,분당선,신갈,4582,4548,9130
202106,분당선,기흥,9502,8973,18475
202106,분당선,상갈,5414,5192,10606
202106,분당선,청명,4271,4253,8524
202106,분당선,영통,8253,8309,16562
202106,분당선,망포,13789,13203,26992
202106,분당선,매탄권선,5030,4830,9860
202106,분당선,수원시청,11945,12921,24866
202106,분당선,매교,3052,3122,6174
202106,분당선,매교,2963,3060,6023
202106,분당선,수원시청,11800,12789,24589
202106,분당선,매탄권선,4889,4772,9661
202106,분당선,망포,14057,13361,27418
202106,분당선,영통,7969,8131,16100
202106,분당선,청명,4203,4130,8333
202106,분당선,상갈,5471,5361,10832
202106,분당선,기흥,9521,9068,18589
202106,분당선,신갈,4559,4504,9063
202106,분당선,구성,4948,5144,10092
202106,분당선,죽전,12902,14265,27167
202106,분당선,보정,2522,2251,4773
202106,분당선,이매,5590,5310,10900
202106,분당선,오리,11941,9903,21844
202106,분당선,미금,15155,16114,31269
202106,분당선,정자,17535,18817,36352
202106,분당선,수내,12861,13051,25912
202106,분당선,서현,23625,23896,47521
202106,분당선,야탑,24975,25946,50921
202106,분당선,모란,19542,19664,39206
202106,분당선,태평,13385,12929,26314
202106,분당선,가천대,11149,12089,23238
202106,분당선,선정릉,8341,8870,17211
202106,분당선,강남구청,9927,11404,21331
202106,분당선,압구정로데오,18340,19781,38121
202106,분당선,서울숲,10158,10302,20460
202106,분당선,수원,7782,6572,14354
202106,분당선,수서,13328,13777,27105
202106,분당선,대모산입구,3577,3418,6995
202106,분당선,개포동,3780,4033,7813
202106,분당선,구룡,2038,1914,3952
202106,분당선,도곡,6783,6665,13448
202106,분당선,한티,13589,14887,28476
202106,분당선,선릉,13795,20445,34240
202106,분당선,매교,2918,2988,5906
202106,분당선,수원시청,12688,14396,27084
202106,분당선,매탄권선,5139,4844,9983
202106,분당선,망포,14635,13654,28289
202106,분당선,영통,8454,8630,17084
202106,분당선,청명,4478,4060,8538
202106,분당선,상갈,5540,5207,10747
202106,분당선,기흥,9472,8733,18205
202106,분당선,신갈,4433,4465,8898
202106,분당선,구성,4792,4981,9773
202106,분당선,죽전,13373,14559,27932
202106,분당선,보정,2481,2128,4609
202106,분당선,이매,5623,5256,10879
202106,분당선,오리,11696,9876,21572
202106,분당선,미금,15609,16176,31785
202106,분당선,정자,17532,18566,36098
202106,분당선,수내,12917,13077,25994
202106,분당선,서현,24269,24749,49018
202106,분당선,야탑,25436,26882,52318
202106,분당선,모란,20032,20059,40091
202106,분당선,태평,13578,12951,26529
202106,분당선,가천대,9937,10504,20441
202106,분당선,선정릉,7999,8489,16488
202106,분당선,강남구청,9880,11158,21038
202106,분당선,압구정로데오,19223,21408,40631
202106,분당선,서울숲,10035,10264,20299
202106,분당선,수원,8307,7207,15514
202106,분당선,복정,1,0,1
202106,분당선,수서,14114,15174,29288
202106,분당선,대모산입구,3564,3292,6856
202106,분당선,개포동,3777,3954,7731
202106,분당선,구룡,2111,1941,4052
202106,분당선,도곡,6821,6578,13399
202106,분당선,한티,14073,14923,28996
202106,분당선,선릉,13364,19794,33158
202106,분당선,매교,3019,2968,5987
202106,분당선,수원시청,11811,12667,24478
202106,분당선,매탄권선,4948,4771,9719
202106,분당선,망포,13597,12973,26570
202106,분당선,영통,7774,8029,15803
202106,분당선,청명,4160,3914,8074
202106,분당선,상갈,5434,5188,10622
202106,분당선,기흥,9205,8734,17939
202106,분당선,신갈,4433,4426,8859
202106,분당선,구성,4933,5155,10088
202106,분당선,죽전,12856,14021,26877
202106,분당선,보정,2504,2243,4747
202106,분당선,이매,5606,5222,10828
202106,분당선,오리,11584,9772,21356
202106,분당선,미금,15111,16315,31426
202106,분당선,정자,16914,17815,34729
202106,분당선,수내,12107,12114,24221
202106,분당선,서현,23736,23956,47692
202106,분당선,야탑,25126,25994,51120
202106,분당선,모란,23880,24671,48551
202106,분당선,태평,13603,13239,26842
202106,분당선,가천대,10315,11260,21575
202106,분당선,선정릉,8040,8525,16565
202106,분당선,강남구청,9632,10913,20545
202106,분당선,압구정로데오,16342,17942,34284
202106,분당선,서울숲,9773,9799,19572
202106,분당선,수원,7900,6498,14398
202106,분당선,수서,13489,13673,27162
202106,분당선,대모산입구,3729,3592,7321
202106,분당선,개포동,3747,3800,7547
202106,분당선,구룡,2131,2080,4211
202106,분당선,도곡,6725,6657,13382
202106,분당선,한티,12434,13513,25947
202106,분당선,선릉,13498,20126,33624
202106,분당선,매교,2895,2941,5836
202106,분당선,수원시청,11923,12759,24682
202106,분당선,매탄권선,4935,4761,9696
202106,분당선,망포,13880,13186,27066
202106,분당선,영통,7712,7861,15573
202106,분당선,청명,4210,3996,8206
202106,분당선,상갈,5328,5152,10480
202106,분당선,기흥,9206,8784,17990
202106,분당선,신갈,4430,4390,8820
202106,분당선,구성,4927,5013,9940
202106,분당선,죽전,12702,14005,26707
202106,분당선,보정,2487,2138,4625
202106,분당선,이매,5504,5130,10634
202106,분당선,오리,11501,9787,21288
202106,분당선,미금,15083,16093,31176
202106,분당선,정자,17262,18048,35310
202106,분당선,수내,12774,12858,25632
202106,분당선,서현,23325,23670,46995
202106,분당선,야탑,25049,25989,51038
202106,분당선,모란,18953,19105,38058
202106,분당선,태평,13104,12626,25730
202106,분당선,가천대,7651,8734,16385
202106,분당선,선정릉,8000,8565,16565
202106,분당선,강남구청,9719,11177,20896
202106,분당선,압구정로데오,17603,19216,36819
202106,분당선,서울숲,9769,9896,19665
202106,분당선,수원,7656,6335,13991
202106,분당선,수서,13101,13337,26438
202106,분당선,대모산입구,3421,3129,6550
202106,분당선,개포동,3687,3814,7501
202106,분당선,구룡,2075,2036,4111
202106,분당선,도곡,6588,6580,13168
202106,분당선,한티,13519,14607,28126
202106,분당선,선릉,13821,20168,33989
202106,분당선,선릉,13667,20299,33966
202106,분당선,한티,14061,15012,29073
202106,분당선,도곡,6826,6747,13573
202106,분당선,구룡,2214,2173,4387
202106,분당선,개포동,3807,3971,7778
202106,분당선,대모산입구,3334,3149,6483
202106,분당선,수서,13275,13516,26791
202106,분당선,수원,8039,6773,14812
202106,분당선,서울숲,11088,11060,22148
202106,분당선,압구정로데오,18379,20160,38539
202106,분당선,강남구청,9926,11500,21426
202106,분당선,선정릉,8337,8800,17137
202106,분당선,가천대,7747,8833,16580
202106,분당선,태평,13341,12982,26323
202106,분당선,모란,19251,19541,38792
202106,분당선,야탑,25835,26944,52779
202106,분당선,서현,24151,24359,48510
202106,분당선,수내,12930,13061,25991
202106,분당선,정자,17482,18443,35925
202106,분당선,미금,15682,16541,32223
202106,분당선,오리,11714,9850,21564
202106,분당선,이매,5629,5333,10962
202106,분당선,보정,2502,2200,4702
202106,분당선,죽전,13245,14540,27785
202106,분당선,구성,4928,5093,10021
202106,분당선,신갈,4601,4571,9172
202106,분당선,기흥,9548,9147,18695
202106,분당선,상갈,5469,5229,10698
202106,분당선,청명,4262,4198,8460
202106,분당선,영통,8071,8187,16258
202106,분당선,망포,13997,13367,27364
202106,분당선,매탄권선,5075,4870,9945
202106,분당선,수원시청,12301,13270,25571
202106,분당선,매교,2958,3121,6079
202106,분당선,매교,2995,3038,6033
202106,분당선,수원시청,12237,13191,25428
202106,분당선,매탄권선,4929,4875,9804
202106,분당선,망포,13875,13169,27044
202106,분당선,영통,7881,8155,16036
202106,분당선,청명,4249,4045,8294
202106,분당선,상갈,5476,5196,10672
202106,분당선,기흥,9413,8912,18325
202106,분당선,신갈,4595,4529,9124
202106,분당선,구성,4993,5202,10195
202106,분당선,죽전,13134,14461,27595
202106,분당선,보정,2540,2213,4753
202106,분당선,이매,5631,5275,10906
202106,분당선,오리,11932,9869,21801
202106,분당선,미금,15208,16303,31511
202106,분당선,정자,17550,18557,36107
202106,분당선,수내,12952,12938,25890
202106,분당선,서현,24099,24663,48762
202106,분당선,야탑,25508,26639,52147
202106,분당선,모란,19752,19544,39296
202106,분당선,태평,13306,12861,26167
202106,분당선,가천대,7391,8607,15998
202106,분당선,선정릉,8210,8796,17006
202106,분당선,강남구청,9955,11386,21341
202106,분당선,압구정로데오,18404,20227,38631
202106,분당선,서울숲,10802,10816,21618
202106,분당선,수원,8199,6758,14957
202106,분당선,복정,1,0,1
202106,분당선,수서,13803,14064,27867
202106,분당선,대모산입구,3427,3131,6558
202106,분당선,개포동,3678,3892,7570
202106,분당선,구룡,2617,2607,5224
202106,분당선,도곡,6885,6791,13676
202106,분당선,한티,13696,14784,28480
202106,분당선,선릉,13792,20558,34350
202106,분당선,매교,2916,2926,5842
202106,분당선,수원시청,12730,14339,27069
202106,분당선,매탄권선,5187,4822,10009
202106,분당선,망포,14960,13763,28723
202106,분당선,영통,8534,8690,17224
202106,분당선,청명,4426,4086,8512
202106,분당선,상갈,5500,5072,10572
202106,분당선,기흥,9449,8882,18331
202106,분당선,신갈,4456,4433,8889
202106,분당선,구성,4871,5184,10055
202106,분당선,죽전,13501,14437,27938
202106,분당선,보정,2482,2130,4612
202106,분당선,이매,5730,5352,11082
202106,분당선,오리,11730,9710,21440
202106,분당선,미금,15621,16286,31907
202106,분당선,정자,17909,18896,36805
202106,분당선,수내,12944,13027,25971
202106,분당선,서현,24487,24916,49403
202106,분당선,야탑,25737,27271,53008
202106,분당선,모란,19864,19763,39627
202106,분당선,태평,13452,12750,26202
202106,분당선,가천대,7132,7967,15099
202106,분당선,선정릉,8266,8753,17019
202106,분당선,강남구청,10285,11486,21771
202106,분당선,압구정로데오,20005,22684,42689
202106,분당선,서울숲,10667,10698,21365
202106,분당선,수원,8473,7205,15678
202106,분당선,수서,14415,15588,30003
202106,분당선,대모산입구,3343,3101,6444
202106,분당선,개포동,3823,3973,7796
202106,분당선,구룡,2237,2059,4296
202106,분당선,도곡,6864,6690,13554
202106,분당선,한티,14227,15064,29291
202106,분당선,선릉,13287,19825,33112
202106,분당선,선릉,13720,20225,33945
202106,분당선,한티,13848,14817,28665
202106,분당선,도곡,6824,6788,13612
202106,분당선,구룡,2157,2073,4230
202106,분당선,개포동,3844,3910,7754
202106,분당선,대모산입구,3490,3177,6667
202106,분당선,매교,3079,3061,6140
202106,분당선,수원시청,12412,13156,25568
202106,분당선,매탄권선,4986,4852,9838
202106,분당선,망포,13982,13388,27370
202106,분당선,영통,7984,8130,16114
202106,분당선,청명,4322,4165,8487
202106,분당선,상갈,5498,5235,10733
202106,분당선,기흥,9288,8865,18153
202106,분당선,신갈,4628,4535,9163
202106,분당선,구성,5055,5247,10302
202106,분당선,죽전,12019,13517,25536
202106,분당선,보정,2584,2321,4905
202106,분당선,이매,5709,5237,10946
202106,분당선,오리,11828,10070,21898
202106,분당선,미금,15487,16372,31859
202106,분당선,정자,17535,18494,36029
202106,분당선,수내,12981,13003,25984
202106,분당선,서현,23118,23482,46600
202106,분당선,야탑,25493,26477,51970
202106,분당선,모란,19487,19545,39032
202106,분당선,태평,13340,12881,26221
202106,분당선,가천대,6499,7503,14002
202106,분당선,선정릉,8304,8788,17092
202106,분당선,강남구청,9799,11243,21042
202106,분당선,압구정로데오,17540,19351,36891
202106,분당선,서울숲,11058,11236,22294
202106,분당선,수원,7808,6575,14383
202106,분당선,수서,13676,13781,27457
202106,분당선,선릉,14269,21103,35372
202106,분당선,한티,14076,15036,29112
202106,분당선,도곡,6867,6846,13713
202106,분당선,구룡,2237,2108,4345
202106,분당선,개포동,3935,4052,7987
202106,분당선,대모산입구,3509,3276,6785
202106,분당선,수서,13552,13873,27425
202106,분당선,수원,8069,6766,14835
202106,분당선,서울숲,11069,11252,22321
202106,분당선,압구정로데오,18919,20869,39788
202106,분당선,강남구청,10231,11798,22029
202106,분당선,선정릉,8399,8900,17299
202106,분당선,가천대,6555,7563,14118
202106,분당선,태평,13535,12985,26520
202106,분당선,모란,19601,19658,39259
202106,분당선,야탑,25880,26807,52687
202106,분당선,서현,24663,25121,49784
202106,분당선,수내,13162,13217,26379
202106,분당선,정자,17876,18958,36834
202106,분당선,미금,15585,16599,32184
202106,분당선,오리,11941,10041,21982
202106,분당선,이매,5798,5363,11161
202106,분당선,보정,2646,2341,4987
202106,분당선,죽전,13370,14568,27938
202106,분당선,구성,4982,5265,10247
202106,분당선,신갈,4802,4706,9508
202106,분당선,기흥,9399,8906,18305
202106,분당선,상갈,5530,5244,10774
202106,분당선,청명,4248,4076,8324
202106,분당선,영통,8145,8289,16434
202106,분당선,망포,14204,13604,27808
202106,분당선,매탄권선,4988,4940,9928
202106,분당선,수원시청,12713,13404,26117
202106,분당선,매교,3106,3206,6312
202106,분당선,복정,2,0,2
202106,분당선,선릉,13976,20682,34658
202106,분당선,한티,14040,15029,29069
202106,분당선,도곡,6975,6957,13932
202106,분당선,구룡,2142,2112,4254
202106,분당선,개포동,4025,4186,8211
202106,분당선,대모산입구,3383,3156,6539
202106,분당선,수서,13391,13719,27110
202106,분당선,수원,7961,6622,14583
202106,분당선,서울숲,11037,11179,22216
202106,분당선,압구정로데오,18619,20566,39185
202106,분당선,강남구청,10162,11788,21950
202106,분당선,선정릉,8381,8969,17350
202106,분당선,가천대,6566,7466,14032
202106,분당선,태평,13586,12956,26542
202106,분당선,모란,19381,19316,38697
202106,분당선,야탑,26034,27250,53284
202106,분당선,서현,24743,24957,49700
202106,분당선,수내,13371,13341,26712
202106,분당선,정자,17779,19162,36941
202106,분당선,미금,15557,16616,32173
202106,분당선,오리,12067,10127,22194
202106,분당선,이매,5890,5546,11436
202106,분당선,보정,2562,2258,4820
202106,분당선,죽전,13361,15011,28372
202106,분당선,구성,4928,5060,9988
202106,분당선,신갈,4656,4625,9281
202106,분당선,기흥,9417,8959,18376
202106,분당선,상갈,5431,5182,10613
202106,분당선,청명,4315,4147,8462
202106,분당선,영통,8260,8491,16751
202106,분당선,망포,14176,13405,27581
202106,분당선,매탄권선,4991,4802,9793
202106,분당선,수원시청,12392,13253,25645
202106,분당선,매교,3107,3131,6238
202106,분당선,선릉,14125,20836,34961
202106,분당선,한티,14048,15121,29169
202106,분당선,도곡,6928,6779,13707
202106,분당선,구룡,2196,2185,4381
202106,분당선,개포동,3932,4050,7982
202106,분당선,대모산입구,3553,3340,6893
202106,분당선,수서,14108,14612,28720
202106,분당선,복정,3,0,3
202106,분당선,수원,8129,6877,15006
202106,분당선,서울숲,11628,11687,23315
202106,분당선,압구정로데오,19506,21529,41035
202106,분당선,강남구청,10157,11675,21832
202106,분당선,선정릉,8357,8932,17289
202106,분당선,가천대,6532,7496,14028
202106,분당선,태평,14094,13331,27425
202106,분당선,모란,25514,26184,51698
202106,분당선,야탑,26303,27127,53430
202106,분당선,서현,25010,25483,50493
202106,분당선,수내,13384,13503,26887
202106,분당선,정자,18283,17025,35308
202106,분당선,미금,15901,16860,32761
202106,분당선,오리,12228,10194,22422
202106,분당선,이매,5926,5565,11491
202106,분당선,보정,2787,2392,5179
202106,분당선,죽전,13495,14948,28443
202106,분당선,구성,5059,5270,10329
202106,분당선,신갈,4664,4570,9234
202106,분당선,기흥,9624,9163,18787
202106,분당선,상갈,5546,5180,10726
202106,분당선,청명,4332,4131,8463
202106,분당선,영통,8262,8513,16775
202106,분당선,망포,14509,13637,28146
202106,분당선,매탄권선,5138,4963,10101
202106,분당선,수원시청,12809,13582,26391
202106,분당선,매교,3213,3266,6479
202106,분당선,매교,3187,3180,6367
202106,분당선,수원시청,13793,15296,29089
202106,분당선,매탄권선,5469,5160,10629
202106,분당선,망포,15644,14492,30136
202106,분당선,영통,8866,9068,17934
202106,분당선,청명,4578,4382,8960
202106,분당선,상갈,5800,5447,11247
202106,분당선,기흥,10090,9523,19613
202106,분당선,신갈,4698,4688,9386
202106,분당선,구성,5199,5291,10490
202106,분당선,죽전,14598,15522,30120
202106,분당선,보정,2719,2315,5034
202106,분당선,이매,6118,5471,11589
202106,분당선,오리,12320,10172,22492
202106,분당선,미금,16487,17422,33909
202106,분당선,정자,18937,18552,37489
202106,분당선,수내,13852,13826,27678
202106,분당선,서현,26001,26504,52505
202106,분당선,야탑,27078,28302,55380
202106,분당선,모란,20831,20874,41705
202106,분당선,태평,13952,13448,27400
202106,분당선,가천대,6830,7468,14298
202106,분당선,선정릉,8380,8932,17312
202106,분당선,강남구청,10573,11907,22480
202106,분당선,압구정로데오,21148,24106,45254
202106,분당선,서울숲,12227,12227,24454
202106,분당선,수원,8690,7625,16315
202106,분당선,수서,14857,16142,30999
202106,분당선,대모산입구,3512,3249,6761
202106,분당선,개포동,4125,4310,8435
202106,분당선,구룡,2389,2201,4590
202106,분당선,도곡,7153,7046,14199
202106,분당선,한티,14787,15769,30556
202106,분당선,선릉,14041,20906,34947
202106,분당선,매탄권선,4945,4694,9639
202106,분당선,망포,13854,13231,27085
202106,분당선,영통,7692,8049,15741
202106,분당선,청명,4216,4045,8261
202106,분당선,상갈,5357,5141,10498
202106,분당선,기흥,9259,8761,18020
202106,분당선,신갈,4627,4516,9143
202106,분당선,구성,4851,5162,10013
202106,분당선,죽전,12600,13950,26550
202106,분당선,보정,2659,2298,4957
202106,분당선,이매,5629,5310,10939
202106,분당선,오리,11584,9736,21320
202106,분당선,미금,15110,16106,31216
202106,분당선,정자,17338,18218,35556
202106,분당선,수내,12841,12692,25533
202106,분당선,서현,23862,24175,48037
202106,분당선,야탑,25174,26102,51276
202106,분당선,모란,19005,19032,38037
202106,분당선,태평,13220,12956,26176
202106,분당선,가천대,6316,7378,13694
202106,분당선,선정릉,8084,8810,16894
202106,분당선,강남구청,9762,11121,20883
202106,분당선,압구정로데오,16846,18626,35472
202106,분당선,서울숲,10321,10393,20714
202106,분당선,수원,7811,6567,14378
202106,분당선,수서,13681,13819,27500
202106,분당선,대모산입구,3358,3076,6434
202106,분당선,개포동,3680,3888,7568
202106,분당선,구룡,2190,2113,4303
202106,분당선,도곡,6958,6850,13808
202106,분당선,한티,13620,14641,28261
202106,분당선,선릉,13678,20426,34104
202106,분당선,매교,2898,3004,5902
202106,분당선,수원시청,12029,12748,24777
202106,분당선,야탑,25934,26838,52772
202106,분당선,모란,24315,24960,49275
202106,분당선,태평,13906,13193,27099
202106,분당선,가천대,6487,7491,13978
202106,분당선,선정릉,8477,8935,17412
202106,분당선,강남구청,10113,11699,21812
202106,분당선,압구정로데오,18852,20798,39650
202106,분당선,서울숲,10971,11319,22290
202106,분당선,수원,7864,6421,14285
202106,분당선,복정,1,0,1
202106,분당선,수서,13877,14099,27976
202106,분당선,대모산입구,3485,3247,6732
202106,분당선,개포동,3887,3969,7856
202106,분당선,구룡,2224,2150,4374
202106,분당선,도곡,6979,6965,13944
202106,분당선,한티,14032,14956,28988
202106,분당선,선릉,14154,20811,34965
202106,분당선,서현,24618,25177,49795
202106,분당선,매교,3099,3070,6169
202106,분당선,수원시청,12372,13133,25505
202106,분당선,매탄권선,5084,4921,10005
202106,분당선,망포,14138,13613,27751
202106,분당선,영통,8027,8303,16330
202106,분당선,청명,4313,4174,8487
202106,분당선,상갈,5369,5149,10518
202106,분당선,기흥,9451,9100,18551
202106,분당선,신갈,4674,4646,9320
202106,분당선,구성,5080,5190,10270
202106,분당선,죽전,13182,14650,27832
202106,분당선,보정,2727,2359,5086
202106,분당선,이매,5945,5545,11490
202106,분당선,오리,11940,10090,22030
202106,분당선,미금,15584,16571,32155
202106,분당선,정자,18112,19023,37135
202106,분당선,수내,12916,13021,25937
202106,분당선,매교,2958,3059,6017
202106,분당선,선릉,13798,20432,34230
202106,분당선,한티,14107,15108,29215
202106,분당선,도곡,6950,6904,13854
202106,분당선,구룡,2183,2096,4279
202106,분당선,개포동,4078,4182,8260
202106,분당선,대모산입구,3389,3198,6587
202106,분당선,수서,13382,13664,27046
202106,분당선,복정,1,0,1
202106,분당선,수원,7711,6238,13949
202106,분당선,서울숲,11019,11143,22162
202106,분당선,압구정로데오,18659,20779,39438
202106,분당선,강남구청,10183,11829,22012
202106,분당선,선정릉,8284,9016,17300
202106,분당선,가천대,6449,7456,13905
202106,분당선,태평,13617,13075,26692
202106,분당선,모란,19509,19646,39155
202106,분당선,야탑,26283,27332,53615
202106,분당선,서현,24516,24981,49497
202106,분당선,수내,13419,13579,26998
202106,분당선,정자,17968,18943,36911
202106,분당선,미금,15785,16569,32354
202106,분당선,오리,11908,10084,21992
202106,분당선,이매,5883,5431,11314
202106,분당선,보정,2561,2270,4831
202106,분당선,죽전,13284,14628,27912
202106,분당선,구성,4893,5177,10070
202106,분당선,신갈,4630,4542,9172
202106,분당선,기흥,9485,9000,18485
202106,분당선,상갈,5467,5128,10595
202106,분당선,청명,4232,4117,8349
202106,분당선,영통,8080,8360,16440
202106,분당선,망포,14451,13503,27954
202106,분당선,매탄권선,5121,4907,10028
202106,분당선,수원시청,12344,13336,25680
202107,분당선,매교,3232,3270,6502
202107,분당선,수원시청,12274,13366,25640
202107,분당선,매탄권선,5175,5054,10229
202107,분당선,망포,14272,13539,27811
202107,분당선,영통,8310,8542,16852
202107,분당선,청명,4253,4136,8389
202107,분당선,상갈,5514,5216,10730
202107,분당선,기흥,9600,9116,18716
202107,분당선,신갈,4640,4548,9188
202107,분당선,구성,4993,5159,10152
202107,분당선,죽전,13264,14774,28038
202107,분당선,보정,2658,2316,4974
202107,분당선,이매,5784,5382,11166
202107,분당선,오리,12090,10133,22223
202107,분당선,미금,15590,16537,32127
202107,분당선,정자,17862,19002,36864
202107,분당선,수내,13400,13432,26832
202107,분당선,서현,24942,25299,50241
202107,분당선,야탑,25739,26761,52500
202107,분당선,모란,19664,19800,39464
202107,분당선,태평,13567,13008,26575
202107,분당선,가천대,6578,7408,13986
202107,분당선,선정릉,8307,9017,17324
202107,분당선,강남구청,10342,11827,22169
202107,분당선,압구정로데오,19478,21336,40814
202107,분당선,서울숲,11476,11417,22893
202107,분당선,수원,7924,6506,14430
202107,분당선,복정,1,0,1
202107,분당선,수서,13459,14010,27469
202107,분당선,대모산입구,3373,3096,6469
202107,분당선,개포동,3882,4016,7898
202107,분당선,구룡,2142,2051,4193
202107,분당선,도곡,6919,6941,13860
202107,분당선,한티,14147,14988,29135
202107,분당선,선릉,13907,20839,34746
202107,분당선,매교,3253,3381,6634
202107,분당선,수원시청,13399,15177,28576
202107,분당선,매탄권선,5504,5100,10604
202107,분당선,망포,15692,14425,30117
202107,분당선,영통,9218,9292,18510
202107,분당선,청명,4785,4421,9206
202107,분당선,상갈,5833,5570,11403
202107,분당선,기흥,9995,9570,19565
202107,분당선,신갈,4990,4707,9697
202107,분당선,구성,5156,5346,10502
202107,분당선,죽전,14391,15679,30070
202107,분당선,보정,2848,2438,5286
202107,분당선,이매,6021,5508,11529
202107,분당선,오리,12490,10418,22908
202107,분당선,미금,16586,17493,34079
202107,분당선,정자,18435,19537,37972
202107,분당선,수내,13666,13560,27226
202107,분당선,서현,26878,27308,54186
202107,분당선,야탑,26795,28001,54796
202107,분당선,모란,20529,20797,41326
202107,분당선,태평,13898,13194,27092
202107,분당선,가천대,6896,7473,14369
202107,분당선,선정릉,8365,8997,17362
202107,분당선,강남구청,10695,12169,22864
202107,분당선,압구정로데오,20952,23694,44646
202107,분당선,서울숲,11676,11635,23311
202107,분당선,수원,8745,7459,16204
202107,분당선,수서,14737,15754,30491
202107,분당선,대모산입구,3382,3135,6517
202107,분당선,개포동,3997,4155,8152
202107,분당선,구룡,2380,2187,4567
202107,분당선,도곡,7096,6902,13998
202107,분당선,한티,14737,15545,30282
202107,분당선,선릉,14013,21008,35021
202107,분당선,매교,3219,3235,6454
202107,분당선,수원시청,12247,12863,25110
202107,분당선,매탄권선,4970,4869,9839
202107,분당선,망포,13990,13617,27607
202107,분당선,영통,7927,8104,16031
202107,분당선,청명,4378,4184,8562
202107,분당선,상갈,5527,5255,10782
202107,분당선,기흥,9501,9032,18533
202107,분당선,신갈,4687,4698,9385
202107,분당선,구성,5048,5206,10254
202107,분당선,죽전,12369,13949,26318
202107,분당선,보정,2651,2364,5015
202107,분당선,이매,6094,5487,11581
202107,분당선,오리,11862,9968,21830
202107,분당선,미금,15839,16740,32579
202107,분당선,정자,17412,18337,35749
202107,분당선,수내,13159,13112,26271
202107,분당선,서현,24775,25175,49950
202107,분당선,야탑,25333,26548,51881
202107,분당선,모란,19470,19566,39036
202107,분당선,태평,13580,13077,26657
202107,분당선,가천대,6862,7749,14611
202107,분당선,선정릉,8387,8894,17281
202107,분당선,강남구청,10001,11360,21361
202107,분당선,압구정로데오,17142,18691,35833
202107,분당선,서울숲,10513,10699,21212
202107,분당선,수원,7827,6437,14264
202107,분당선,수서,13423,13639,27062
202107,분당선,대모산입구,3542,3299,6841
202107,분당선,개포동,3825,3988,7813
202107,분당선,구룡,1822,1708,3530
202107,분당선,도곡,7173,7018,14191
202107,분당선,한티,13817,14777,28594
202107,분당선,선릉,13997,20898,34895
202107,분당선,야탑,26032,26699,52731
202107,분당선,서현,25400,25780,51180
202107,분당선,수내,13574,13565,27139
202107,분당선,정자,17881,18792,36673
202107,분당선,미금,15911,16704,32615
202107,분당선,오리,11941,10143,22084
202107,분당선,이매,5794,5435,11229
202107,분당선,보정,2611,2288,4899
202107,분당선,죽전,13468,14950,28418
202107,분당선,구성,4999,5184,10183
202107,분당선,신갈,4736,4700,9436
202107,분당선,기흥,9500,8988,18488
202107,분당선,상갈,5486,5252,10738
202107,분당선,청명,4298,4232,8530
202107,분당선,영통,8108,8317,16425
202107,분당선,망포,14036,13490,27526
202107,분당선,매탄권선,5171,4897,10068
202107,분당선,수원시청,12345,13158,25503
202107,분당선,매교,3187,3232,6419
202107,분당선,선릉,14295,21320,35615
202107,분당선,한티,14320,14995,29315
202107,분당선,도곡,7207,6987,14194
202107,분당선,구룡,1920,1769,3689
202107,분당선,개포동,4036,4122,8158
202107,분당선,대모산입구,3464,3224,6688
202107,분당선,수서,13379,13556,26935
202107,분당선,수원,7750,6374,14124
202107,분당선,서울숲,10830,10802,21632
202107,분당선,압구정로데오,18846,20680,39526
202107,분당선,강남구청,10540,12150,22690
202107,분당선,선정릉,8330,9092,17422
202107,분당선,가천대,6360,7280,13640
202107,분당선,태평,13439,13030,26469
202107,분당선,모란,19496,19671,39167
202107,분당선,선릉,13932,20384,34316
202107,분당선,한티,13735,14657,28392
202107,분당선,도곡,6736,6765,13501
202107,분당선,구룡,1738,1677,3415
202107,분당선,개포동,3872,3986,7858
202107,분당선,대모산입구,3313,3110,6423
202107,분당선,수서,13030,13225,26255
202107,분당선,복정,1,0,1
202107,분당선,수원,7622,6102,13724
202107,분당선,서울숲,10117,10222,20339
202107,분당선,압구정로데오,17751,19294,37045
202107,분당선,강남구청,10258,11695,21953
202107,분당선,선정릉,8199,8896,17095
202107,분당선,가천대,6314,7313,13627
202107,분당선,태평,13241,12730,25971
202107,분당선,모란,19106,19108,38214
202107,분당선,야탑,25450,26443,51893
202107,분당선,서현,24174,24526,48700
202107,분당선,수내,12918,13043,25961
202107,분당선,정자,17367,18265,35632
202107,분당선,미금,15410,16429,31839
202107,분당선,오리,11935,9929,21864
202107,분당선,이매,5565,5253,10818
202107,분당선,보정,2479,2218,4697
202107,분당선,죽전,13002,14543,27545
202107,분당선,구성,4717,4987,9704
202107,분당선,신갈,4602,4576,9178
202107,분당선,기흥,9173,8691,17864
202107,분당선,상갈,5374,5206,10580
202107,분당선,청명,4225,4054,8279
202107,분당선,영통,7889,8074,15963
202107,분당선,망포,13672,12929,26601
202107,분당선,매탄권선,4928,4816,9744
202107,분당선,수원시청,11977,13042,25019
202107,분당선,매교,3011,3058,6069
202107,분당선,선릉,13652,19526,33178
202107,분당선,한티,13325,14393,27718
202107,분당선,도곡,6427,6336,12763
202107,분당선,구룡,1735,1682,3417
202107,분당선,개포동,3661,3775,7436
202107,분당선,대모산입구,3114,2909,6023
202107,분당선,수서,12780,13076,25856
202107,분당선,수원,7324,6033,13357
202107,분당선,서울숲,9872,9932,19804
202107,분당선,압구정로데오,17098,19004,36102
202107,분당선,강남구청,9400,10931,20331
202107,분당선,선정릉,7923,8529,16452
202107,분당선,가천대,6061,6954,13015
202107,분당선,태평,13004,12418,25422
202107,분당선,모란,18594,18724,37318
202107,분당선,야탑,24377,25461,49838
202107,분당선,서현,23377,23692,47069
202107,분당선,수내,12580,12643,25223
202107,분당선,정자,16527,17526,34053
202107,분당선,미금,14742,15508,30250
202107,분당선,오리,11231,9360,20591
202107,분당선,이매,5356,4873,10229
202107,분당선,보정,2460,2141,4601
202107,분당선,죽전,12415,13718,26133
202107,분당선,구성,4608,4809,9417
202107,분당선,신갈,4308,4231,8539
202107,분당선,기흥,8882,8443,17325
202107,분당선,상갈,5254,4990,10244
202107,분당선,청명,4135,4013,8148
202107,분당선,영통,7672,7814,15486
202107,분당선,망포,13304,12536,25840
202107,분당선,매탄권선,4796,4636,9432
202107,분당선,수원시청,11668,12358,24026
202107,분당선,매교,2994,2877,5871
202107,분당선,망포,14327,12953,27280
202107,분당선,매탄권선,5116,4867,9983
202107,분당선,선릉,13106,18920,32026
202107,분당선,한티,13677,14449,28126
202107,분당선,도곡,6661,6534,13195
202107,분당선,구룡,1747,1634,3381
202107,분당선,개포동,3640,3846,7486
202107,분당선,대모산입구,3272,3085,6357
202107,분당선,수서,13769,15050,28819
202107,분당선,수원,7877,6793,14670
202107,분당선,서울숲,10019,10058,20077
202107,분당선,압구정로데오,17759,20062,37821
202107,분당선,강남구청,9522,10738,20260
202107,분당선,선정릉,7862,8168,16030
202107,분당선,가천대,6220,6780,13000
202107,분당선,태평,13434,12693,26127
202107,분당선,모란,23777,24373,48150
202107,분당선,야탑,24932,26359,51291
202107,분당선,서현,23795,24414,48209
202107,분당선,수내,12723,12666,25389
202107,분당선,정자,16492,17336,33828
202107,분당선,미금,15082,16041,31123
202107,분당선,오리,11596,9530,21126
202107,분당선,이매,5663,5098,10761
202107,분당선,보정,2461,2119,4580
202107,분당선,죽전,12999,14135,27134
202107,분당선,구성,4759,5089,9848
202107,분당선,신갈,4460,4363,8823
202107,분당선,기흥,9314,8675,17989
202107,분당선,상갈,5303,5057,10360
202107,분당선,청명,4298,4040,8338
202107,분당선,영통,8228,8343,16571
202107,분당선,수원시청,12198,13730,25928
202107,분당선,매교,2953,2967,5920
202107,분당선,선릉,12181,17643,29824
202107,분당선,한티,11285,12274,23559
202107,분당선,도곡,6020,6040,12060
202107,분당선,구룡,1644,1617,3261
202107,분당선,개포동,3250,3326,6576
202107,분당선,대모산입구,2950,2723,5673
202107,분당선,수서,11390,11658,23048
202107,분당선,수원,6562,5510,12072
202107,분당선,서울숲,8314,8397,16711
202107,분당선,압구정로데오,13111,14235,27346
202107,분당선,강남구청,8749,9958,18707
202107,분당선,선정릉,7289,7711,15000
202107,분당선,가천대,5574,6523,12097
202107,분당선,태평,12120,11690,23810
202107,분당선,모란,17020,17346,34366
202107,분당선,야탑,22129,23136,45265
202107,분당선,서현,20112,20059,40171
202107,분당선,수내,10672,10652,21324
202107,분당선,정자,14368,15146,29514
202107,분당선,미금,13286,14235,27521
202107,분당선,오리,10327,8529,18856
202107,분당선,이매,4846,4550,9396
202107,분당선,보정,2163,1954,4117
202107,분당선,죽전,10839,11971,22810
202107,분당선,구성,4177,4519,8696
202107,분당선,신갈,3992,4022,8014
202107,분당선,기흥,8068,7713,15781
202107,분당선,상갈,4782,4579,9361
202107,분당선,청명,3625,3450,7075
202107,분당선,영통,6834,6959,13793
202107,분당선,망포,12067,11602,23669
202107,분당선,매탄권선,4182,4097,8279
202107,분당선,수원시청,10614,11138,21752
202107,분당선,매교,2389,2426,4815
202107,분당선,매교,2576,2503,5079
202107,분당선,수원시청,10377,10978,21355
202107,분당선,매탄권선,4183,4131,8314
202107,분당선,망포,12056,11477,23533
202107,분당선,영통,6751,6944,13695
202107,분당선,청명,3609,3515,7124
202107,분당선,상갈,4636,4541,9177
202107,분당선,기흥,8148,7694,15842
202107,분당선,신갈,3920,3903,7823
202107,분당선,구성,4151,4428,8579
202107,분당선,죽전,10997,12143,23140
202107,분당선,보정,2094,1841,3935
202107,분당선,이매,4998,4615,9613
202107,분당선,오리,10252,8537,18789
202107,분당선,미금,13461,14346,27807
202107,분당선,정자,14628,15205,29833
202107,분당선,수내,11360,11562,22922
202107,분당선,서현,21012,21192,42204
202107,분당선,야탑,22002,22896,44898
202107,분당선,모란,17007,17085,34092
202107,분당선,태평,12096,11712,23808
202107,분당선,가천대,5559,6420,11979
202107,분당선,선정릉,7123,7606,14729
202107,분당선,강남구청,8565,9830,18395
202107,분당선,압구정로데오,15067,16430,31497
202107,분당선,서울숲,8413,8498,16911
202107,분당선,수원,6704,5704,12408
202107,분당선,수서,10836,11188,22024
202107,분당선,대모산입구,2992,2779,5771
202107,분당선,개포동,3201,3350,6551
202107,분당선,구룡,1700,1621,3321
202107,분당선,도곡,5754,5819,11573
202107,분당선,한티,12193,13053,25246
202107,분당선,선릉,12108,17458,29566
202107,분당선,매교,2410,2412,4822
202107,분당선,수원시청,10750,11413,22163
202107,분당선,매탄권선,4137,4037,8174
202107,분당선,망포,12055,11712,23767
202107,분당선,청명,3662,3496,7158
202107,분당선,상갈,4682,4510,9192
202107,분당선,기흥,7968,7695,15663
202107,분당선,신갈,3791,3759,7550
202107,분당선,구성,4244,4479,8723
202107,분당선,죽전,10915,12213,23128
202107,분당선,보정,2080,1898,3978
202107,분당선,이매,4831,4496,9327
202107,분당선,오리,10497,8689,19186
202107,분당선,미금,13461,14338,27799
202107,분당선,정자,14398,15142,29540
202107,분당선,수내,11406,11411,22817
202107,분당선,서현,20681,20968,41649
202107,분당선,야탑,22227,23150,45377
202107,분당선,모란,19914,20193,40107
202107,분당선,태평,12164,11817,23981
202107,분당선,가천대,5593,6416,12009
202107,분당선,선정릉,7147,7559,14706
202107,분당선,강남구청,8630,9849,18479
202107,분당선,압구정로데오,14669,15889,30558
202107,분당선,서울숲,8687,8691,17378
202107,분당선,수원,6841,5635,12476
202107,분당선,수서,10821,11098,21919
202107,분당선,대모산입구,2986,2765,5751
202107,분당선,개포동,3282,3462,6744
202107,분당선,구룡,1621,1556,3177
202107,분당선,도곡,5747,5713,11460
202107,분당선,한티,12095,13041,25136
202107,분당선,선릉,11944,17100,29044
202107,분당선,영통,7006,7039,14045
202107,분당선,매교,2391,2388,4779
202107,분당선,수원시청,10320,10805,21125
202107,분당선,매탄권선,3972,3903,7875
202107,분당선,망포,11871,11252,23123
202107,분당선,영통,6646,6777,13423
202107,분당선,청명,3424,3247,6671
202107,분당선,상갈,4619,4346,8965
202107,분당선,기흥,8018,7664,15682
202107,분당선,신갈,3687,3682,7369
202107,분당선,구성,3918,4282,8200
202107,분당선,죽전,11026,11955,22981
202107,분당선,보정,2046,1767,3813
202107,분당선,이매,4599,4363,8962
202107,분당선,오리,10023,8390,18413
202107,분당선,미금,13111,13804,26915
202107,분당선,정자,14002,14606,28608
202107,분당선,수내,11099,11176,22275
202107,분당선,서현,20115,20426,40541
202107,분당선,야탑,21442,22381,43823
202107,분당선,모란,16870,16834,33704
202107,분당선,태평,11739,11282,23021
202107,분당선,가천대,5450,6323,11773
202107,분당선,선정릉,6891,7296,14187
202107,분당선,강남구청,8312,9472,17784
202107,분당선,압구정로데오,14719,16109,30828
202107,분당선,서울숲,8268,8412,16680
202107,분당선,수원,6510,5522,12032
202107,분당선,수서,10743,11285,22028
202107,분당선,대모산입구,2851,2660,5511
202107,분당선,개포동,3219,3328,6547
202107,분당선,구룡,1562,1494,3056
202107,분당선,도곡,5618,5604,11222
202107,분당선,한티,12061,12917,24978
202107,분당선,선릉,11903,17051,28954
202107,분당선,매교,2284,2294,4578
202107,분당선,수원시청,10952,11917,22869
202107,분당선,매탄권선,4309,4163,8472
202107,분당선,망포,12740,11674,24414
202107,분당선,영통,7283,7359,14642
202107,분당선,청명,3634,3477,7111
202107,분당선,상갈,4829,4539,9368
202107,분당선,기흥,8222,7854,16076
202107,분당선,신갈,3799,3868,7667
202107,분당선,구성,4105,4394,8499
202107,분당선,죽전,11670,12447,24117
202107,분당선,보정,2003,1830,3833
202107,분당선,이매,5099,4807,9906
202107,분당선,오리,10181,8423,18604
202107,분당선,미금,13733,14442,28175
202107,분당선,정자,14599,15449,30048
202107,분당선,수내,11448,11565,23013
202107,분당선,서현,21468,21936,43404
202107,분당선,야탑,22099,23190,45289
202107,분당선,모란,17685,17573,35258
202107,분당선,태평,12159,11672,23831
202107,분당선,가천대,5583,6206,11789
202107,분당선,선정릉,6927,7273,14200
202107,분당선,강남구청,8511,9541,18052
202107,분당선,압구정로데오,15976,17479,33455
202107,분당선,서울숲,8430,8524,16954
202107,분당선,수원,7045,6119,13164
202107,분당선,수서,11730,13078,24808
202107,분당선,대모산입구,2913,2699,5612
202107,분당선,개포동,3257,3417,6674
202107,분당선,구룡,1528,1471,2999
202107,분당선,도곡,5940,5894,11834
202107,분당선,한티,12802,13553,26355
202107,분당선,선릉,11897,16917,28814
202107,분당선,매교,2404,2328,4732
202107,분당선,수원시청,10549,11122,21671
202107,분당선,매탄권선,4110,4091,8201
202107,분당선,망포,11847,11407,23254
202107,분당선,영통,6752,6861,13613
202107,분당선,청명,3488,3361,6849
202107,분당선,상갈,4669,4464,9133
202107,분당선,기흥,8058,7784,15842
202107,분당선,신갈,3875,3876,7751
202107,분당선,구성,4076,4341,8417
202107,분당선,죽전,10950,12078,23028
202107,분당선,보정,2045,1780,3825
202107,분당선,이매,4649,4370,9019
202107,분당선,오리,10355,8713,19068
202107,분당선,미금,13491,14542,28033
202107,분당선,정자,14255,15148,29403
202107,분당선,수내,11269,11229,22498
202107,분당선,서현,21222,21301,42523
202107,분당선,야탑,21688,22590,44278
202107,분당선,모란,19666,20017,39683
202107,분당선,태평,12150,11748,23898
202107,분당선,가천대,5553,6409,11962
202107,분당선,선정릉,7006,7534,14540
202107,분당선,강남구청,8461,9592,18053
202107,분당선,압구정로데오,13711,14973,28684
202107,분당선,서울숲,8028,8209,16237
202107,분당선,수원,6786,5715,12501
202107,분당선,수서,11315,11356,22671
202107,분당선,대모산입구,2941,2644,5585
202107,분당선,개포동,3147,3286,6433
202107,분당선,구룡,1477,1523,3000
202107,분당선,도곡,5807,5787,11594
202107,분당선,한티,12480,13406,25886
202107,분당선,선릉,11859,17266,29125
202107,분당선,복정,1,0,1
202107,분당선,기흥,8160,7739,15899
202107,분당선,선릉,12063,17319,29382
202107,분당선,한티,12779,13579,26358
202107,분당선,도곡,5684,5706,11390
202107,분당선,구룡,1774,1723,3497
202107,분당선,개포동,3190,3397,6587
202107,분당선,대모산입구,2973,2782,5755
202107,분당선,수서,10994,11129,22123
202107,분당선,수원,6784,5679,12463
202107,분당선,서울숲,8497,8536,17033
202107,분당선,압구정로데오,15272,16569,31841
202107,분당선,강남구청,8698,9961,18659
202107,분당선,선정릉,7125,7580,14705
202107,분당선,가천대,5459,6296,11755
202107,분당선,태평,12207,11671,23878
202107,분당선,모란,17267,17477,34744
202107,분당선,야탑,22106,23080,45186
202107,분당선,서현,21083,21255,42338
202107,분당선,수내,11383,11568,22951
202107,분당선,정자,14769,15663,30432
202107,분당선,미금,13569,14629,28198
202107,분당선,오리,10549,8752,19301
202107,분당선,이매,4536,4303,8839
202107,분당선,보정,2043,1854,3897
202107,분당선,죽전,11079,12258,23337
202107,분당선,구성,4181,4430,8611
202107,분당선,신갈,3917,3930,7847
202107,분당선,매교,2344,2359,4703
202107,분당선,수원시청,10656,11446,22102
202107,분당선,매탄권선,4222,4118,8340
202107,분당선,망포,11987,11429,23416
202107,분당선,영통,6823,6889,13712
202107,분당선,청명,3541,3372,6913
202107,분당선,상갈,4703,4512,9215
202107,분당선,망포,11962,11346,23308
202107,분당선,영통,6777,6903,13680
202107,분당선,청명,3545,3363,6908
202107,분당선,상갈,4693,4506,9199
202107,분당선,기흥,8019,7760,15779
202107,분당선,신갈,3801,3798,7599
202107,분당선,구성,4015,4385,8400
202107,분당선,죽전,11074,12119,23193
202107,분당선,보정,1995,1760,3755
202107,분당선,이매,4555,4382,8937
202107,분당선,오리,10332,8595,18927
202107,분당선,미금,13216,14112,27328
202107,분당선,정자,14577,15448,30025
202107,분당선,수내,11417,11519,22936
202107,분당선,서현,20951,21045,41996
202107,분당선,야탑,21477,22720,44197
202107,분당선,모란,16988,17073,34061
202107,분당선,태평,11935,11426,23361
202107,분당선,가천대,5437,6252,11689
202107,분당선,선정릉,7133,7575,14708
202107,분당선,강남구청,8469,9793,18262
202107,분당선,매탄권선,4098,3932,8030
202107,분당선,수원시청,10670,11374,22044
202107,분당선,압구정로데오,14679,15936,30615
202107,분당선,서울숲,8483,8583,17066
202107,분당선,수원,6765,5697,12462
202107,분당선,수서,10995,11281,22276
202107,분당선,대모산입구,2842,2652,5494
202107,분당선,개포동,3211,3390,6601
202107,분당선,구룡,1756,1691,3447
202107,분당선,도곡,5673,5677,11350
202107,분당선,한티,12779,13664,26443
202107,분당선,선릉,11793,16921,28714
202107,분당선,매교,2360,2382,4742
202107,분당선,복정,1,0,1
202107,분당선,매교,2309,2332,4641
202107,분당선,수원시청,10520,11122,21642
202107,분당선,매탄권선,3920,3883,7803
202107,분당선,망포,11785,11134,22919
202107,분당선,영통,6709,6780,13489
202107,분당선,청명,3498,3442,6940
202107,분당선,상갈,4534,4395,8929
202107,분당선,기흥,7939,7550,15489
202107,분당선,신갈,3772,3754,7526
202107,분당선,구성,3974,4222,8196
202107,분당선,죽전,10733,11847,22580
202107,분당선,보정,2015,1793,3808
202107,분당선,이매,4465,4179,8644
202107,분당선,오리,10161,8345,18506
202107,분당선,미금,12997,13943,26940
202107,분당선,정자,14493,15270,29763
202107,분당선,수내,11436,11490,22926
202107,분당선,서현,20389,20749,41138
202107,분당선,야탑,21488,22366,43854
202107,분당선,모란,16949,16919,33868
202107,분당선,태평,11888,11423,23311
202107,분당선,가천대,5468,6365,11833
202107,분당선,선정릉,6992,7471,14463
202107,분당선,강남구청,8465,9549,18014
202107,분당선,압구정로데오,15021,16288,31309
202107,분당선,서울숲,8376,8389,16765
202107,분당선,수원,6653,5599,12252
202107,분당선,수서,10951,11582,22533
202107,분당선,대모산입구,2841,2708,5549
202107,분당선,개포동,3104,3253,6357
202107,분당선,구룡,1757,1671,3428
202107,분당선,도곡,5602,5611,11213
202107,분당선,한티,12528,13494,26022
202107,분당선,선릉,11631,16985,28616
202107,분당선,선릉,11884,16925,28809
202107,분당선,한티,13195,13899,27094
202107,분당선,도곡,5846,5748,11594
202107,분당선,구룡,1584,1510,3094
202107,분당선,개포동,3243,3397,6640
202107,분당선,대모산입구,2926,2680,5606
202107,분당선,수서,11887,13253,25140
202107,분당선,수원,6953,6127,13080
202107,분당선,서울숲,8550,8535,17085
202107,분당선,압구정로데오,16419,18014,34433
202107,분당선,강남구청,8655,9779,18434
202107,분당선,선정릉,7190,7566,14756
202107,분당선,가천대,5558,6292,11850
202107,분당선,태평,12200,11605,23805
202107,분당선,모란,17685,17632,35317
202107,분당선,야탑,22126,23308,45434
202107,분당선,서현,21440,21774,43214
202107,분당선,수내,11823,11809,23632
202107,분당선,정자,14827,15573,30400
202107,분당선,미금,13502,14289,27791
202107,분당선,오리,10399,8676,19075
202107,분당선,이매,4746,4443,9189
202107,분당선,보정,2016,1730,3746
202107,분당선,죽전,11506,12463,23969
202107,분당선,구성,4069,4394,8463
202107,분당선,신갈,3746,3787,7533
202107,분당선,기흥,8322,7813,16135
202107,분당선,상갈,4821,4498,9319
202107,분당선,청명,3575,3453,7028
202107,분당선,영통,7172,7351,14523
202107,분당선,망포,12653,11667,24320
202107,분당선,매탄권선,4310,4135,8445
202107,분당선,수원시청,10897,11897,22794
202107,분당선,매교,2320,2323,4643
202107,분당선,매교,2357,2328,4685
202107,분당선,수원시청,10607,11049,21656
202107,분당선,매탄권선,3973,3839,7812
202107,분당선,망포,11565,11282,22847
202107,분당선,영통,6681,6708,13389
202107,분당선,청명,3350,3284,6634
202107,분당선,상갈,4558,4346,8904
202107,분당선,기흥,8197,7530,15727
202107,분당선,신갈,3772,3800,7572
202107,분당선,구성,3989,4219,8208
202107,분당선,죽전,10751,11812,22563
202107,분당선,보정,1989,1782,3771
202107,분당선,이매,4577,4262,8839
202107,분당선,오리,9913,8364,18277
202107,분당선,미금,13113,14091,27204
202107,분당선,정자,14169,14890,29059
202107,분당선,수내,11190,11242,22432
202107,분당선,서현,20725,20860,41585
202107,분당선,야탑,21474,22400,43874
202107,분당선,모란,17087,16958,34045
202107,분당선,태평,11894,11577,23471
202107,분당선,가천대,5329,6267,11596
202107,분당선,선정릉,7081,7644,14725
202107,분당선,강남구청,8235,9386,17621
202107,분당선,압구정로데오,14153,15139,29292
202107,분당선,서울숲,8106,8112,16218
202107,분당선,수원,6784,5699,12483
202107,분당선,복정,1,0,1
202107,분당선,수서,11271,11479,22750
202107,분당선,대모산입구,2784,2546,5330
202107,분당선,개포동,3111,3199,6310
202107,분당선,구룡,1512,1457,2969
202107,분당선,도곡,5686,5628,11314
202107,분당선,한티,12424,13175,25599
202107,분당선,선릉,11850,17394,29244
202107,분당선,매교,2293,2309,4602
202107,분당선,수원시청,10431,10910,21341
202107,분당선,매탄권선,3963,3979,7942
202107,분당선,망포,11604,11113,22717
202107,분당선,영통,6451,6545,12996
202107,분당선,청명,3488,3356,6844
202107,분당선,상갈,4523,4302,8825
202107,분당선,기흥,8019,7566,15585
202107,분당선,신갈,3803,3825,7628
202107,분당선,구성,3936,4198,8134
202107,분당선,죽전,10750,11997,22747
202107,분당선,보정,2012,1730,3742
202107,분당선,이매,4381,4170,8551
202107,분당선,오리,9877,8290,18167
202107,분당선,미금,13235,14108,27343
202107,분당선,정자,14346,15027,29373
202107,분당선,수내,11378,11466,22844
202107,분당선,서현,20752,20900,41652
202107,분당선,야탑,21260,22210,43470
202107,분당선,모란,16976,17101,34077
202107,분당선,태평,11947,11532,23479
202107,분당선,가천대,5325,6158,11483
202107,분당선,선정릉,7142,7407,14549
202107,분당선,강남구청,8327,9464,17791
202107,분당선,압구정로데오,15110,16251,31361
202107,분당선,서울숲,8304,8487,16791
202107,분당선,수원,6643,5577,12220
202107,분당선,복정,3,0,3
202107,분당선,수서,10892,11149,22041
202107,분당선,대모산입구,2831,2624,5455
202107,분당선,개포동,3145,3205,6350
202107,분당선,구룡,1498,1409,2907
202107,분당선,도곡,5583,5631,11214
202107,분당선,한티,12508,13173,25681
202107,분당선,선릉,11895,17134,29029
202107,분당선,선릉,11608,16814,28422
202107,분당선,한티,12540,13331,25871
202107,분당선,도곡,5484,5505,10989
202107,분당선,구룡,1492,1417,2909
202107,분당선,개포동,3077,3280,6357
202107,분당선,대모산입구,2690,2571,5261
202107,분당선,수서,10648,11300,21948
202107,분당선,수원,6607,5637,12244
202107,분당선,서울숲,8349,8423,16772
202107,분당선,압구정로데오,14951,16033,30984
202107,분당선,강남구청,8314,9524,17838
202107,분당선,선정릉,6880,7338,14218
202107,분당선,가천대,5474,6335,11809
202107,분당선,태평,11784,11402,23186
202107,분당선,모란,17075,16895,33970
202107,분당선,야탑,21230,22330,43560
202107,분당선,서현,20249,20361,40610
202107,분당선,수내,11421,11426,22847
202107,분당선,정자,14243,14825,29068
202107,분당선,미금,13085,13938,27023
202107,분당선,오리,9953,8340,18293
202107,분당선,이매,4588,4316,8904
202107,분당선,보정,1906,1683,3589
202107,분당선,죽전,10831,11958,22789
202107,분당선,구성,3847,4188,8035
202107,분당선,신갈,3742,3732,7474
202107,분당선,기흥,8003,7644,15647
202107,분당선,상갈,4509,4315,8824
202107,분당선,청명,3384,3286,6670
202107,분당선,영통,6608,6646,13254
202107,분당선,망포,11456,10918,22374
202107,분당선,매탄권선,4016,3847,7863
202107,분당선,수원시청,10470,11126,21596
202107,분당선,매교,2286,2279,4565
202107,분당선,선릉,11526,16661,28187
202107,분당선,한티,12003,12845,24848
202107,분당선,도곡,5480,5436,10916
202107,분당선,구룡,1480,1393,2873
202107,분당선,개포동,3047,3189,6236
202107,분당선,대모산입구,2831,2647,5478
202107,분당선,수서,10826,11517,22343
202107,분당선,수원,6575,5489,12064
202107,분당선,서울숲,8342,8290,16632
202107,분당선,압구정로데오,15283,16506,31789
202107,분당선,강남구청,8364,9546,17910
202107,분당선,선정릉,7003,7440,14443
202107,분당선,가천대,5570,6326,11896
202107,분당선,태평,11925,11586,23511
202107,분당선,모란,19092,19168,38260
202107,분당선,야탑,21094,22053,43147
202107,분당선,서현,20560,20612,41172
202107,분당선,수내,11098,11154,22252
202107,분당선,정자,14067,14685,28752
202107,분당선,미금,13060,13731,26791
202107,분당선,오리,10025,8337,18362
202107,분당선,이매,4325,4169,8494
202107,분당선,보정,2010,1792,3802
202107,분당선,죽전,10712,11844,22556
202107,분당선,구성,3843,4232,8075
202107,분당선,신갈,3572,3752,7324
202107,분당선,기흥,7923,7610,15533
202107,분당선,상갈,4571,4355,8926
202107,분당선,청명,3314,3231,6545
202107,분당선,영통,6431,6518,12949
202107,분당선,망포,11295,10757,22052
202107,분당선,매탄권선,3939,3858,7797
202107,분당선,수원시청,10251,11026,21277
202107,분당선,매교,2178,2277,4455
202107,분당선,매교,2278,2312,4590
202107,분당선,수원시청,10726,11590,22316
202107,분당선,매탄권선,4196,3967,8163
202107,분당선,망포,12080,11102,23182
202107,분당선,영통,6893,6923,13816
202107,분당선,청명,3425,3262,6687
202107,분당선,상갈,4667,4387,9054
202107,분당선,기흥,8061,7707,15768
202107,분당선,신갈,3672,3667,7339
202107,분당선,구성,3849,4204,8053
202107,분당선,죽전,11184,12264,23448
202107,분당선,보정,1906,1632,3538
202107,분당선,이매,4489,4231,8720
202107,분당선,오리,10074,8383,18457
202107,분당선,미금,13206,13869,27075
202107,분당선,정자,14369,14996,29365
202107,분당선,수내,11157,11207,22364
202107,분당선,서현,21414,21544,42958
202107,분당선,야탑,21523,22759,44282
202107,분당선,모란,17322,17229,34551
202107,분당선,태평,11955,11523,23478
202107,분당선,가천대,5573,6111,11684
202107,분당선,선정릉,6864,7193,14057
202107,분당선,강남구청,8440,9507,17947
202107,분당선,압구정로데오,16532,17906,34438
202107,분당선,서울숲,8501,8522,17023
202107,분당선,수원,6872,6204,13076
202107,분당선,복정,1,0,1
202107,분당선,수서,11538,13316,24854
202107,분당선,대모산입구,2749,2516,5265
202107,분당선,개포동,3100,3254,6354
202107,분당선,구룡,1482,1469,2951
202107,분당선,도곡,5556,5529,11085
202107,분당선,한티,12819,13492,26311
202107,분당선,선릉,11389,16401,27790
202108,분당선,매교,2020,2063,4083
202108,분당선,수원시청,9835,10289,20124
202108,분당선,매탄권선,3822,3631,7453
202108,분당선,망포,10638,10201,20839
202108,분당선,영통,6270,6365,12635
202108,분당선,청명,3223,3089,6312
202108,분당선,상갈,4122,4009,8131
202108,분당선,기흥,7498,7200,14698
202108,분당선,신갈,3544,3602,7146
202108,분당선,구성,3623,4026,7649
202108,분당선,죽전,10109,11184,21293
202108,분당선,보정,1849,1675,3524
202108,분당선,이매,4337,4130,8467
202108,분당선,오리,9526,8042,17568
202108,분당선,미금,12599,13415,26014
202108,분당선,정자,13363,13925,27288
202108,분당선,수내,10640,10542,21182
202108,분당선,서현,20324,20723,41047
202108,분당선,야탑,20744,21546,42290
202108,분당선,모란,16128,16339,32467
202108,분당선,태평,11443,11001,22444
202108,분당선,가천대,4586,5389,9975
202108,분당선,선정릉,6705,7199,13904
202108,분당선,강남구청,8167,9351,17518
202108,분당선,압구정로데오,13865,14787,28652
202108,분당선,서울숲,7912,7977,15889
202108,분당선,수원,6611,5575,12186
202108,분당선,복정,1,0,1
202108,분당선,수서,10950,10905,21855
202108,분당선,대모산입구,2804,2539,5343
202108,분당선,개포동,2675,2872,5547
202108,분당선,구룡,1297,1228,2525
202108,분당선,도곡,5414,5394,10808
202108,분당선,한티,11749,12614,24363
202108,분당선,선릉,10989,16199,27188
202108,분당선,선릉,11041,16263,27304
202108,분당선,한티,12426,12818,25244
202108,분당선,도곡,5428,5391,10819
202108,분당선,구룡,1296,1280,2576
202108,분당선,개포동,2729,2891,5620
202108,분당선,대모산입구,2820,2569,5389
202108,분당선,수서,10761,10850,21611
202108,분당선,수원,6690,5529,12219
202108,분당선,서울숲,8150,8256,16406
202108,분당선,압구정로데오,14532,15689,30221
202108,분당선,강남구청,8177,9388,17565
202108,분당선,선정릉,6847,7305,14152
202108,분당선,가천대,4645,5600,10245
202108,분당선,태평,11592,11001,22593
202108,분당선,모란,16700,16896,33596
202108,분당선,야탑,21060,22044,43104
202108,분당선,서현,20375,20524,40899
202108,분당선,수내,10817,10911,21728
202108,분당선,정자,13455,14147,27602
202108,분당선,미금,12949,13929,26878
202108,분당선,오리,9851,8200,18051
202108,분당선,이매,4410,4245,8655
202108,분당선,보정,1898,1742,3640
202108,분당선,죽전,10134,11379,21513
202108,분당선,구성,3731,4013,7744
202108,분당선,신갈,3677,3744,7421
202108,분당선,기흥,7570,7283,14853
202108,분당선,상갈,4369,4228,8597
202108,분당선,청명,3095,3075,6170
202108,분당선,영통,6398,6444,12842
202108,분당선,망포,10606,10258,20864
202108,분당선,매탄권선,3870,3644,7514
202108,분당선,수원시청,9944,10373,20317
202108,분당선,매교,2117,2159,4276
202108,분당선,선릉,11006,16208,27214
202108,분당선,한티,12281,13154,25435
202108,분당선,도곡,5510,5409,10919
202108,분당선,구룡,1305,1247,2552
202108,분당선,개포동,2946,3039,5985
202108,분당선,대모산입구,2801,2714,5515
202108,분당선,수서,10899,11228,22127
202108,분당선,수원,6722,5603,12325
202108,분당선,서울숲,8331,8396,16727
202108,분당선,압구정로데오,14778,15970,30748
202108,분당선,강남구청,8349,9512,17861
202108,분당선,선정릉,6917,7322,14239
202108,분당선,가천대,4700,5604,10304
202108,분당선,태평,11861,11327,23188
202108,분당선,모란,18983,19367,38350
202108,분당선,야탑,21020,21878,42898
202108,분당선,서현,20445,20727,41172
202108,분당선,수내,11133,10981,22114
202108,분당선,정자,13600,14276,27876
202108,분당선,미금,12729,13516,26245
202108,분당선,오리,9826,8264,18090
202108,분당선,이매,4423,4211,8634
202108,분당선,보정,1874,1663,3537
202108,분당선,죽전,10314,11549,21863
202108,분당선,구성,3720,4046,7766
202108,분당선,신갈,3709,3683,7392
202108,분당선,기흥,7601,7412,15013
202108,분당선,상갈,4339,4131,8470
202108,분당선,청명,3271,3154,6425
202108,분당선,영통,6331,6348,12679
202108,분당선,망포,10760,10231,20991
202108,분당선,매탄권선,3827,3667,7494
202108,분당선,수원시청,9930,10411,20341
202108,분당선,매교,2116,2126,4242
202108,분당선,선릉,11246,16466,27712
202108,분당선,한티,12435,13168,25603
202108,분당선,도곡,5567,5557,11124
202108,분당선,구룡,1291,1270,2561
202108,분당선,개포동,3048,3089,6137
202108,분당선,대모산입구,2876,2698,5574
202108,분당선,수서,10832,11265,22097
202108,분당선,수원,6635,5493,12128
202108,분당선,서울숲,8590,8645,17235
202108,분당선,압구정로데오,15252,16434,31686
202108,분당선,강남구청,8353,9456,17809
202108,분당선,선정릉,6883,7286,14169
202108,분당선,가천대,4647,5565,10212
202108,분당선,태평,11711,11160,22871
202108,분당선,모란,16936,16922,33858
202108,분당선,야탑,21173,21969,43142
202108,분당선,서현,20442,20493,40935
202108,분당선,수내,11003,11065,22068
202108,분당선,정자,13600,14426,28026
202108,분당선,미금,12924,13741,26665
202108,분당선,오리,9859,8217,18076
202108,분당선,이매,4434,4285,8719
202108,분당선,보정,1846,1656,3502
202108,분당선,죽전,10407,11548,21955
202108,분당선,구성,3798,4082,7880
202108,분당선,신갈,3669,3681,7350
202108,분당선,기흥,7826,7492,15318
202108,분당선,상갈,4285,4124,8409
202108,분당선,청명,3354,3250,6604
202108,분당선,영통,6454,6577,13031
202108,분당선,망포,10899,10327,21226
202108,분당선,매탄권선,3821,3684,7505
202108,분당선,수원시청,9990,10488,20478
202108,분당선,매교,2070,2080,4150
202108,분당선,매교,2142,2161,4303
202108,분당선,수원시청,10299,11285,21584
202108,분당선,매탄권선,4011,3847,7858
202108,분당선,망포,11620,10791,22411
202108,분당선,영통,6824,6834,13658
202108,분당선,청명,3386,3220,6606
202108,분당선,상갈,4533,4351,8884
202108,분당선,기흥,7961,7707,15668
202108,분당선,신갈,3775,3757,7532
202108,분당선,구성,3917,4309,8226
202108,분당선,죽전,10851,11872,22723
202108,분당선,보정,1948,1718,3666
202108,분당선,이매,4606,4384,8990
202108,분당선,오리,9975,8449,18424
202108,분당선,미금,13064,13648,26712
202108,분당선,정자,13992,14777,28769
202108,분당선,수내,11247,11317,22564
202108,분당선,서현,20854,21134,41988
202108,분당선,야탑,21358,22651,44009
202108,분당선,모란,17504,17488,34992
202108,분당선,태평,11966,11478,23444
202108,분당선,가천대,4789,5457,10246
202108,분당선,선정릉,6785,7199,13984
202108,분당선,강남구청,8401,9534,17935
202108,분당선,압구정로데오,16341,17887,34228
202108,분당선,서울숲,8661,8770,17431
202108,분당선,수원,6830,5891,12721
202108,분당선,수서,11439,12485,23924
202108,분당선,대모산입구,2886,2675,5561
202108,분당선,개포동,3029,3205,6234
202108,분당선,구룡,1301,1231,2532
202108,분당선,도곡,5698,5619,11317
202108,분당선,한티,13095,13752,26847
202108,분당선,선릉,11056,16134,27190
202108,분당선,매교,2351,2377,4728
202108,분당선,수원시청,10657,11152,21809
202108,분당선,매탄권선,4180,3936,8116
202108,분당선,망포,11943,11497,23440
202108,분당선,영통,6734,6928,13662
202108,분당선,청명,3532,3354,6886
202108,분당선,상갈,4707,4492,9199
202108,분당선,기흥,8166,7856,16022
202108,분당선,신갈,3973,3971,7944
202108,분당선,구성,4064,4384,8448
202108,분당선,죽전,10888,12050,22938
202108,분당선,보정,1999,1734,3733
202108,분당선,이매,4694,4502,9196
202108,분당선,오리,10328,8557,18885
202108,분당선,미금,13417,14442,27859
202108,분당선,정자,14417,15021,29438
202108,분당선,수내,11560,11622,23182
202108,분당선,서현,20422,20412,40834
202108,분당선,야탑,21939,22657,44596
202108,분당선,모란,19920,20267,40187
202108,분당선,태평,12360,11944,24304
202108,분당선,가천대,5574,6520,12094
202108,분당선,선정릉,7233,7803,15036
202108,분당선,강남구청,8638,9695,18333
202108,분당선,압구정로데오,14212,15399,29611
202108,분당선,서울숲,8681,8729,17410
202108,분당선,수원,6690,5584,12274
202108,분당선,복정,1,0,1
202108,분당선,수서,11438,11656,23094
202108,분당선,대모산입구,3133,3022,6155
202108,분당선,개포동,3209,3346,6555
202108,분당선,구룡,1507,1467,2974
202108,분당선,도곡,5850,5883,11733
202108,분당선,한티,12751,13549,26300
202108,분당선,선릉,12017,17512,29529
202108,분당선,매교,2370,2403,4773
202108,분당선,수원시청,10701,11263,21964
202108,분당선,매탄권선,4168,4115,8283
202108,분당선,망포,11866,11484,23350
202108,분당선,영통,6838,6851,13689
202108,분당선,청명,3461,3409,6870
202108,분당선,상갈,4729,4568,9297
202108,분당선,기흥,8281,7903,16184
202108,분당선,신갈,3995,3924,7919
202108,분당선,구성,4069,4413,8482
202108,분당선,죽전,11037,12262,23299
202108,분당선,보정,2032,1830,3862
202108,분당선,이매,4671,4503,9174
202108,분당선,오리,10439,8754,19193
202108,분당선,미금,13704,14536,28240
202108,분당선,정자,14221,15077,29298
202108,분당선,수내,11754,11788,23542
202108,분당선,서현,21640,21816,43456
202108,분당선,야탑,22153,23097,45250
202108,분당선,모란,17838,17990,35828
202108,분당선,태평,12222,11846,24068
202108,분당선,가천대,5614,6482,12096
202108,분당선,선정릉,7203,7613,14816
202108,분당선,강남구청,8683,9975,18658
202108,분당선,압구정로데오,15690,16880,32570
202108,분당선,서울숲,8789,8973,17762
202108,분당선,수원,6826,5761,12587
202108,분당선,수서,11281,11372,22653
202108,분당선,대모산입구,3176,2967,6143
202108,분당선,개포동,3272,3383,6655
202108,분당선,구룡,1521,1489,3010
202108,분당선,도곡,5981,5784,11765
202108,분당선,한티,12856,13639,26495
202108,분당선,선릉,11933,17638,29571
202108,분당선,선릉,11896,17389,29285
202108,분당선,한티,13102,13861,26963
202108,분당선,도곡,5866,5693,11559
202108,분당선,구룡,1542,1494,3036
202108,분당선,개포동,3317,3493,6810
202108,분당선,대모산입구,3145,2975,6120
202108,분당선,수서,11205,11753,22958
202108,분당선,수원,6941,5764,12705
202108,분당선,서울숲,9013,9165,18178
202108,분당선,압구정로데오,15196,16621,31817
202108,분당선,강남구청,8731,10072,18803
202108,분당선,선정릉,7229,7679,14908
202108,분당선,가천대,5620,6485,12105
202108,분당선,태평,12304,11840,24144
202108,분당선,모란,17561,17655,35216
202108,분당선,야탑,22452,23358,45810
202108,분당선,서현,21537,21549,43086
202108,분당선,수내,11838,11717,23555
202108,분당선,정자,14692,15403,30095
202108,분당선,미금,13587,14337,27924
202108,분당선,오리,10305,8564,18869
202108,분당선,이매,4793,4515,9308
202108,분당선,보정,2053,1817,3870
202108,분당선,죽전,11284,12488,23772
202108,분당선,구성,4125,4472,8597
202108,분당선,신갈,3921,3917,7838
202108,분당선,기흥,8262,7899,16161
202108,분당선,상갈,4655,4515,9170
202108,분당선,청명,3604,3469,7073
202108,분당선,영통,6961,6989,13950
202108,분당선,망포,11972,11546,23518
202108,분당선,매탄권선,4285,4066,8351
202108,분당선,수원시청,10947,11523,22470
202108,분당선,매교,2395,2399,4794
202108,분당선,매교,2269,2327,4596
202108,분당선,수원시청,10658,11161,21819
202108,분당선,매탄권선,4209,4025,8234
202108,분당선,망포,11694,11178,22872
202108,분당선,영통,6879,6958,13837
202108,분당선,청명,3433,3344,6777
202108,분당선,상갈,4539,4468,9007
202108,분당선,기흥,8145,7883,16028
202108,분당선,신갈,3842,3910,7752
202108,분당선,구성,4105,4401,8506
202108,분당선,죽전,10927,12277,23204
202108,분당선,보정,2064,1760,3824
202108,분당선,이매,4502,4426,8928
202108,분당선,오리,10288,8536,18824
202108,분당선,미금,13390,14415,27805
202108,분당선,정자,14466,15149,29615
202108,분당선,수내,11695,11615,23310
202108,분당선,서현,21247,21448,42695
202108,분당선,야탑,22115,23077,45192
202108,분당선,모란,17183,17219,34402
202108,분당선,태평,12154,11664,23818
202108,분당선,가천대,5555,6298,11853
202108,분당선,선정릉,7370,7616,14986
202108,분당선,강남구청,8689,9972,18661
202108,분당선,압구정로데오,16187,17382,33569
202108,분당선,서울숲,8885,8889,17774
202108,분당선,수원,6808,5781,12589
202108,분당선,수서,11339,12099,23438
202108,분당선,대모산입구,3189,2991,6180
202108,분당선,개포동,3242,3356,6598
202108,분당선,구룡,1562,1517,3079
202108,분당선,도곡,5844,5798,11642
202108,분당선,한티,12890,13661,26551
202108,분당선,선릉,12051,17259,29310
202108,분당선,복정,1,0,1
202108,분당선,선릉,11520,16735,28255
202108,분당선,한티,13290,14047,27337
202108,분당선,도곡,5963,5828,11791
202108,분당선,구룡,1527,1469,2996
202108,분당선,개포동,3252,3395,6647
202108,분당선,대모산입구,3182,2906,6088
202108,분당선,수서,12191,13775,25966
202108,분당선,수원,7209,6176,13385
202108,분당선,서울숲,9193,9116,18309
202108,분당선,압구정로데오,16804,18512,35316
202108,분당선,강남구청,8773,9885,18658
202108,분당선,선정릉,6964,7291,14255
202108,분당선,가천대,5739,6372,12111
202108,분당선,태평,12299,11687,23986
202108,분당선,모란,17999,18049,36048
202108,분당선,야탑,22673,23811,46484
202108,분당선,서현,21938,22251,44189
202108,분당선,수내,11846,11729,23575
202108,분당선,정자,14710,15370,30080
202108,분당선,미금,13909,14564,28473
202108,분당선,오리,10420,8458,18878
202108,분당선,이매,4764,4542,9306
202108,분당선,보정,2012,1775,3787
202108,분당선,죽전,11583,12826,24409
202108,분당선,구성,4197,4445,8642
202108,분당선,신갈,3910,3826,7736
202108,분당선,기흥,8315,8125,16440
202108,분당선,상갈,4802,4635,9437
202108,분당선,청명,3520,3408,6928
202108,분당선,영통,7113,7150,14263
202108,분당선,망포,12509,11486,23995
202108,분당선,매탄권선,4318,3994,8312
202108,분당선,수원시청,10946,12051,22997
202108,분당선,매교,2323,2293,4616
202108,분당선,선릉,3655,5460,9115
202108,분당선,한티,8085,8448,16533
202108,분당선,도곡,2995,2963,5958
202108,분당선,구룡,756,807,1563
202108,분당선,개포동,1965,1904,3869
202108,분당선,대모산입구,1897,1771,3668
202108,분당선,수서,8111,7243,15354
202108,분당선,수원,5228,4294,9522
202108,분당선,서울숲,5250,5089,10339
202108,분당선,압구정로데오,10577,11589,22166
202108,분당선,강남구청,3353,4052,7405
202108,분당선,선정릉,2313,2498,4811
202108,분당선,가천대,3354,3936,7290
202108,분당선,태평,8131,7865,15996
202108,분당선,모란,12027,12446,24473
202108,분당선,야탑,12724,12995,25719
202108,분당선,서현,13948,13982,27930
202108,분당선,수내,6232,6240,12472
202108,분당선,정자,7491,7805,15296
202108,분당선,미금,8511,9077,17588
202108,분당선,오리,5537,4722,10259
202108,분당선,이매,2836,2850,5686
202108,분당선,보정,1108,979,2087
202108,분당선,죽전,7221,8323,15544
202108,분당선,구성,2396,2542,4938
202108,분당선,신갈,1972,1996,3968
202108,분당선,기흥,5063,4859,9922
202108,분당선,상갈,2859,2930,5789
202108,분당선,청명,1830,1867,3697
202108,분당선,영통,4560,4534,9094
202108,분당선,망포,6088,6452,12540
202108,분당선,매탄권선,2310,2299,4609
202108,분당선,수원시청,6783,6904,13687
202108,분당선,매교,1523,1505,3028
202108,분당선,선릉,12236,17777,30013
202108,분당선,한티,12529,13531,26060
202108,분당선,도곡,5972,6132,12104
202108,분당선,구룡,1523,1533,3056
202108,분당선,개포동,3325,3478,6803
202108,분당선,대모산입구,3299,3098,6397
202108,분당선,수서,11996,11931,23927
202108,분당선,수원,6664,5555,12219
202108,분당선,서울숲,9058,9182,18240
202108,분당선,압구정로데오,16457,17284,33741
202108,분당선,강남구청,8956,10199,19155
202108,분당선,선정릉,7491,7915,15406
202108,분당선,가천대,5612,6617,12229
202108,분당선,태평,12136,11800,23936
202108,분당선,모란,17698,17935,35633
202108,분당선,야탑,22318,23223,45541
202108,분당선,서현,21459,21825,43284
202108,분당선,수내,11736,11641,23377
202108,분당선,정자,14667,15675,30342
202108,분당선,미금,13737,14785,28522
202108,분당선,오리,10394,8561,18955
202108,분당선,이매,4954,4577,9531
202108,분당선,보정,2186,1904,4090
202108,분당선,죽전,11102,12354,23456
202108,분당선,구성,4192,4563,8755
202108,분당선,신갈,4050,4107,8157
202108,분당선,기흥,8268,7982,16250
202108,분당선,상갈,4678,4561,9239
202108,분당선,청명,3583,3533,7116
202108,분당선,영통,6920,7135,14055
202108,분당선,망포,11954,11477,23431
202108,분당선,매탄권선,4312,4152,8464
202108,분당선,수원시청,10711,11409,22120
202108,분당선,매교,2678,2644,5322
202108,분당선,매교,2715,2671,5386
202108,분당선,수원시청,10492,11332,21824
202108,분당선,매탄권선,4313,4124,8437
202108,분당선,망포,12019,11509,23528
202108,분당선,영통,6898,7054,13952
202108,분당선,청명,3723,3547,7270
202108,분당선,상갈,4679,4632,9311
202108,분당선,기흥,8286,7928,16214
202108,분당선,신갈,4060,3973,8033
202108,분당선,구성,4173,4485,8658
202108,분당선,죽전,11181,12562,23743
202108,분당선,보정,2183,1927,4110
202108,분당선,이매,4925,4643,9568
202108,분당선,오리,10469,8649,19118
202108,분당선,미금,13403,14516,27919
202108,분당선,정자,14621,15492,30113
202108,분당선,수내,11593,11530,23123
202108,분당선,서현,21164,21613,42777
202108,분당선,야탑,22393,23500,45893
202108,분당선,모란,17782,17809,35591
202108,분당선,태평,12297,11685,23982
202108,분당선,가천대,5707,6606,12313
202108,분당선,선정릉,7310,7822,15132
202108,분당선,강남구청,8863,10130,18993
202108,분당선,압구정로데오,15851,17222,33073
202108,분당선,서울숲,9113,9236,18349
202108,분당선,수원,6617,5473,12090
202108,분당선,복정,1,0,1
202108,분당선,수서,11685,11915,23600
202108,분당선,대모산입구,3402,3032,6434
202108,분당선,개포동,3419,3519,6938
202108,분당선,구룡,1598,1622,3220
202108,분당선,도곡,5985,6019,12004
202108,분당선,한티,12640,13640,26280
202108,분당선,선릉,11967,17753,29720
202108,분당선,선릉,12166,17721,29887
202108,분당선,한티,12930,13903,26833
202108,분당선,도곡,6068,5929,11997
202108,분당선,구룡,1863,1848,3711
202108,분당선,개포동,3386,3458,6844
202108,분당선,대모산입구,3540,3266,6806
202108,분당선,수서,12027,12248,24275
202108,분당선,수원,6827,5718,12545
202108,분당선,서울숲,9469,9494,18963
202108,분당선,압구정로데오,16500,17794,34294
202108,분당선,강남구청,9081,10416,19497
202108,분당선,선정릉,7277,7780,15057
202108,분당선,가천대,5744,6632,12376
202108,분당선,태평,12425,11868,24293
202108,분당선,모란,21047,21249,42296
202108,분당선,야탑,22703,23703,46406
202108,분당선,서현,21628,21850,43478
202108,분당선,수내,11742,11842,23584
202108,분당선,정자,14869,15837,30706
202108,분당선,미금,13899,14952,28851
202108,분당선,오리,10799,8932,19731
202108,분당선,이매,5086,4718,9804
202108,분당선,보정,2219,1987,4206
202108,분당선,죽전,11556,12826,24382
202108,분당선,구성,4232,4602,8834
202108,분당선,신갈,4077,4072,8149
202108,분당선,기흥,8349,7877,16226
202108,분당선,상갈,4713,4642,9355
202108,분당선,청명,3705,3500,7205
202108,분당선,영통,7026,7172,14198
202108,분당선,망포,12310,11672,23982
202108,분당선,매탄권선,4400,4187,8587
202108,분당선,수원시청,10888,11444,22332
202108,분당선,매교,2786,2746,5532
202108,분당선,선릉,12172,17807,29979
202108,분당선,한티,13246,14209,27455
202108,분당선,도곡,6353,6185,12538
202108,분당선,구룡,2034,1814,3848
202108,분당선,개포동,3413,3556,6969
202108,분당선,대모산입구,3466,3184,6650
202108,분당선,수서,12850,13692,26542
202108,분당선,복정,1,0,1
202108,분당선,수원,7151,6155,13306
202108,분당선,서울숲,9685,9721,19406
202108,분당선,압구정로데오,17392,19292,36684
202108,분당선,강남구청,9093,10247,19340
202108,분당선,선정릉,7335,7844,15179
202108,분당선,가천대,5751,6478,12229
202108,분당선,태평,12553,12094,24647
202108,분당선,모란,18481,18540,37021
202108,분당선,야탑,22990,24151,47141
202108,분당선,서현,22246,22603,44849
202108,분당선,수내,11945,11922,23867
202108,분당선,정자,15308,16031,31339
202108,분당선,미금,14248,15109,29357
202108,분당선,오리,10754,8879,19633
202108,분당선,이매,5162,4799,9961
202108,분당선,보정,2286,2005,4291
202108,분당선,죽전,12063,12972,25035
202108,분당선,구성,4293,4612,8905
202108,분당선,신갈,4109,4133,8242
202108,분당선,기흥,8642,8198,16840
202108,분당선,상갈,4901,4776,9677
202108,분당선,청명,3873,3571,7444
202108,분당선,영통,7451,7768,15219
202108,분당선,망포,12982,12140,25122
202108,분당선,매탄권선,4619,4415,9034
202108,분당선,수원시청,11191,12422,23613
202108,분당선,매교,2780,2789,5569
202108,분당선,선릉,12378,18193,30571
202108,분당선,한티,11556,12829,24385
202108,분당선,도곡,6043,6067,12110
202108,분당선,구룡,1818,1794,3612
202108,분당선,개포동,3300,3467,6767
202108,분당선,대모산입구,3447,3279,6726
202108,분당선,수서,11873,12184,24057
202108,분당선,수원,6522,5447,11969
202108,분당선,서울숲,8502,8638,17140
202108,분당선,압구정로데오,13892,14809,28701
202108,분당선,강남구청,8900,9985,18885
202108,분당선,선정릉,7408,7775,15183
202108,분당선,가천대,5682,6558,12240
202108,분당선,태평,11991,11566,23557
202108,분당선,모란,17426,17534,34960
202108,분당선,야탑,22139,22988,45127
202108,분당선,서현,20999,21246,42245
202108,분당선,수내,10996,11104,22100
202108,분당선,정자,14697,15534,30231
202108,분당선,미금,13611,14564,28175
202108,분당선,오리,10335,8586,18921
202108,분당선,이매,5004,4670,9674
202108,분당선,보정,2171,1919,4090
202108,분당선,죽전,10239,11289,21528
202108,분당선,구성,4227,4657,8884
202108,분당선,신갈,4020,3964,7984
202108,분당선,기흥,8121,7727,15848
202108,분당선,상갈,4696,4597,9293
202108,분당선,청명,3732,3575,7307
202108,분당선,영통,6783,7016,13799
202108,분당선,망포,12026,11433,23459
202108,분당선,매탄권선,4097,4081,8178
202108,분당선,수원시청,10481,11019,21500
202108,분당선,매교,2767,2699,5466
202108,분당선,매교,2704,2645,5349
202108,분당선,수원시청,10576,11229,21805
202108,분당선,매탄권선,4171,4149,8320
202108,분당선,망포,12030,11568,23598
202108,분당선,영통,6792,6970,13762
202108,분당선,청명,3738,3626,7364
202108,분당선,상갈,4642,4548,9190
202108,분당선,기흥,8078,7838,15916
202108,분당선,신갈,4056,4016,8072
202108,분당선,구성,4176,4526,8702
202108,분당선,죽전,11099,12174,23273
202108,분당선,보정,2178,1926,4104
202108,분당선,이매,4897,4558,9455
202108,분당선,오리,10388,8611,18999
202108,분당선,미금,13388,14444,27832
202108,분당선,정자,14645,15285,29930
202108,분당선,수내,11537,11488,23025
202108,분당선,서현,20664,20971,41635
202108,분당선,야탑,21949,22971,44920
202108,분당선,모란,18636,19000,37636
202108,분당선,태평,12073,11450,23523
202108,분당선,가천대,5597,6472,12069
202108,분당선,선정릉,7391,7784,15175
202108,분당선,강남구청,9137,10278,19415
202108,분당선,압구정로데오,15717,16872,32589
202108,분당선,서울숲,8568,8835,17403
202108,분당선,수원,6514,5280,11794
202108,분당선,복정,1,0,1
202108,분당선,수서,11791,11975,23766
202108,분당선,대모산입구,3515,3240,6755
202108,분당선,개포동,3273,3401,6674
202108,분당선,구룡,1700,1700,3400
202108,분당선,도곡,5953,5925,11878
202108,분당선,한티,12601,13597,26198
202108,분당선,선릉,12290,17797,30087
202108,분당선,매교,2752,2764,5516
202108,분당선,수원시청,11153,11843,22996
202108,분당선,매탄권선,4379,4235,8614
202108,분당선,망포,12358,11731,24089
202108,분당선,영통,7216,7406,14622
202108,분당선,청명,3829,3687,7516
202108,분당선,상갈,4773,4651,9424
202108,분당선,기흥,8352,7951,16303
202108,분당선,신갈,4126,4079,8205
202108,분당선,구성,4378,4697,9075
202108,분당선,죽전,11526,12790,24316
202108,분당선,보정,2279,2004,4283
202108,분당선,이매,5341,4982,10323
202108,분당선,오리,10875,8986,19861
202108,분당선,미금,13879,14780,28659
202108,분당선,정자,15177,15996,31173
202108,분당선,수내,11955,11986,23941
202108,분당선,서현,21750,22043,43793
202108,분당선,야탑,22820,23857,46677
202108,분당선,모란,18106,17962,36068
202108,분당선,태평,12398,12015,24413
202108,분당선,가천대,5835,6755,12590
202108,분당선,선정릉,7374,7883,15257
202108,분당선,강남구청,9328,10728,20056
202108,분당선,압구정로데오,16144,17385,33529
202108,분당선,서울숲,9414,9563,18977
202108,분당선,수원,6940,5738,12678
202108,분당선,수서,11943,12254,24197
202108,분당선,대모산입구,3535,3311,6846
202108,분당선,개포동,3435,3503,6938
202108,분당선,구룡,1876,1871,3747
202108,분당선,도곡,6182,6165,12347
202108,분당선,한티,13139,14215,27354
202108,분당선,선릉,12457,18109,30566
202108,분당선,선릉,12414,18027,30441
202108,분당선,한티,12914,13823,26737
202108,분당선,도곡,6080,5994,12074
202108,분당선,구룡,1895,1845,3740
202108,분당선,개포동,3502,3612,7114
202108,분당선,대모산입구,3472,3230,6702
202108,분당선,수서,11908,12493,24401
202108,분당선,수원,6909,5850,12759
202108,분당선,서울숲,9448,9638,19086
202108,분당선,압구정로데오,16650,17983,34633
202108,분당선,강남구청,9035,10314,19349
202108,분당선,선정릉,7332,7871,15203
202108,분당선,가천대,6315,7158,13473
202108,분당선,태평,12333,11961,24294
202108,분당선,모란,18421,18500,36921
202108,분당선,야탑,23016,24045,47061
202108,분당선,서현,21553,21871,43424
202108,분당선,수내,11877,11999,23876
202108,분당선,정자,14971,15981,30952
202108,분당선,미금,14156,14981,29137
202108,분당선,오리,10739,8856,19595
202108,분당선,이매,5219,4791,10010
202108,분당선,보정,2338,2062,4400
202108,분당선,죽전,11567,12842,24409
202108,분당선,구성,4454,4817,9271
202108,분당선,신갈,4075,4067,8142
202108,분당선,기흥,8571,8132,16703
202108,분당선,상갈,4833,4772,9605
202108,분당선,청명,3887,3732,7619
202108,분당선,영통,7064,7251,14315
202108,분당선,망포,12546,11680,24226
202108,분당선,매탄권선,4427,4225,8652
202108,분당선,수원시청,11151,11806,22957
202108,분당선,매교,2750,2769,5519
202108,분당선,선릉,12213,17879,30092
202108,분당선,한티,13223,14511,27734
202108,분당선,도곡,6221,5995,12216
202108,분당선,구룡,1895,1848,3743
202108,분당선,개포동,3458,3507,6965
202108,분당선,대모산입구,3462,3240,6702
202108,분당선,수서,12947,13810,26757
202108,분당선,복정,1,0,1
202108,분당선,수원,7041,6061,13102
202108,분당선,서울숲,9217,9160,18377
202108,분당선,압구정로데오,17618,19063,36681
202108,분당선,강남구청,9239,10378,19617
202108,분당선,선정릉,7145,7622,14767
202108,분당선,가천대,6137,6889,13026
202108,분당선,태평,12458,11910,24368
202108,분당선,모란,18248,18439,36687
202108,분당선,야탑,22841,24213,47054
202108,분당선,서현,22059,22470,44529
202108,분당선,수내,11794,11868,23662
202108,분당선,정자,15247,16049,31296
202108,분당선,미금,14208,14865,29073
202108,분당선,오리,10673,8935,19608
202108,분당선,이매,5230,4784,10014
202108,분당선,보정,2237,2038,4275
202108,분당선,죽전,11990,12869,24859
202108,분당선,구성,4425,4701,9126
202108,분당선,신갈,4028,4001,8029
202108,분당선,기흥,8508,8090,16598
202108,분당선,상갈,4862,4672,9534
202108,분당선,청명,3880,3677,7557
202108,분당선,영통,7417,7611,15028
202108,분당선,망포,12816,11860,24676
202108,분당선,매탄권선,4523,4296,8819
202108,분당선,수원시청,11167,12230,23397
202108,분당선,매교,2708,2682,5390
202108,분당선,매교,2743,2812,5555
202108,분당선,수원시청,11011,11471,22482
202108,분당선,매탄권선,4435,4354,8789
202108,분당선,망포,12364,11920,24284
202108,분당선,영통,7051,7309,14360
202108,분당선,청명,3803,3676,7479
202108,분당선,상갈,4958,4849,9807
202108,분당선,기흥,8671,8178,16849
202108,분당선,신갈,4193,4147,8340
202108,분당선,구성,4541,4894,9435
202108,분당선,죽전,11849,13011,24860
202108,분당선,보정,2276,2004,4280
202108,분당선,복정,1,0,1
202108,분당선,선릉,12429,18277,30706
202108,분당선,한티,12658,13662,26320
202108,분당선,도곡,6243,6262,12505
202108,분당선,구룡,1959,1895,3854
202108,분당선,개포동,3435,3528,6963
202108,분당선,대모산입구,3663,3445,7108
202108,분당선,수서,11876,12204,24080
202108,분당선,수원,7022,5764,12786
202108,분당선,서울숲,9315,9411,18726
202108,분당선,압구정로데오,15119,16291,31410
202108,분당선,강남구청,9230,10398,19628
202108,분당선,선정릉,7328,7934,15262
202108,분당선,가천대,6087,7182,13269
202108,분당선,태평,12429,12157,24586
202108,분당선,모란,18459,18632,37091
202108,분당선,야탑,22956,24088,47044
202108,분당선,서현,21576,21821,43397
202108,분당선,수내,11673,11782,23455
202108,분당선,정자,14889,15734,30623
202108,분당선,미금,14164,15095,29259
202108,분당선,오리,10932,9121,20053
202108,분당선,이매,5187,4753,9940
202108,분당선,선릉,12711,18149,30860
202108,분당선,한티,12625,13802,26427
202108,분당선,도곡,6145,6274,12419
202108,분당선,구룡,1821,1803,3624
202108,분당선,개포동,3325,3425,6750
202108,분당선,대모산입구,3456,3360,6816
202108,분당선,수서,11694,11990,23684
202108,분당선,복정,1,0,1
202108,분당선,수원,6627,5579,12206
202108,분당선,서울숲,9033,9135,18168
202108,분당선,압구정로데오,16364,17174,33538
202108,분당선,강남구청,9205,10610,19815
202108,분당선,선정릉,7661,7938,15599
202108,분당선,가천대,5929,7222,13151
202108,분당선,태평,11941,11518,23459
202108,분당선,모란,17302,17477,34779
202108,분당선,야탑,22210,23164,45374
202108,분당선,서현,20887,21128,42015
202108,분당선,수내,11499,11828,23327
202108,분당선,정자,14620,15582,30202
202108,분당선,미금,13680,14628,28308
202108,분당선,오리,10427,8574,19001
202108,분당선,이매,5017,4648,9665
202108,분당선,보정,2164,1925,4089
202108,분당선,죽전,11205,12455,23660
202108,분당선,구성,4229,4725,8954
202108,분당선,신갈,4022,3995,8017
202108,분당선,기흥,8486,7946,16432
202108,분당선,상갈,4819,4651,9470
202108,분당선,청명,3705,3641,7346
202108,분당선,영통,6820,7150,13970
202108,분당선,망포,12154,11583,23737
202108,분당선,매탄권선,4334,4190,8524
202108,분당선,수원시청,10319,10903,21222
202108,분당선,매교,2645,2654,5299
202109,분당선,선릉,12410,18118,30528
202109,분당선,한티,13050,13951,27001
202109,분당선,도곡,6061,6046,12107
202109,분당선,구룡,1895,1802,3697
202109,분당선,개포동,3431,3605,7036
202109,분당선,대모산입구,3636,3400,7036
202109,분당선,수서,11536,11938,23474
202109,분당선,수원,6823,5630,12453
202109,분당선,서울숲,9521,9604,19125
202109,분당선,압구정로데오,15768,17033,32801
202109,분당선,강남구청,9296,10686,19982
202109,분당선,선정릉,7628,8055,15683
202109,분당선,가천대,6165,7232,13397
202109,분당선,태평,12558,11972,24530
202109,분당선,모란,17998,18051,36049
202109,분당선,야탑,22968,23973,46941
202109,분당선,서현,21274,21857,43131
202109,분당선,수내,11831,11959,23790
202109,분당선,정자,15026,16075,31101
202109,분당선,미금,13987,14910,28897
202109,분당선,오리,10816,8860,19676
202109,분당선,이매,5521,4934,10455
202109,분당선,보정,2308,2027,4335
202109,분당선,죽전,11415,12763,24178
202109,분당선,구성,4392,4806,9198
202109,분당선,신갈,4086,4085,8171
202109,분당선,기흥,8567,8091,16658
202109,분당선,상갈,5005,4775,9780
202109,분당선,청명,3848,3636,7484
202109,분당선,영통,7006,7183,14189
202109,분당선,망포,12327,11730,24057
202109,분당선,매탄권선,4430,4268,8698
202109,분당선,수원시청,10694,11326,22020
202109,분당선,매교,2669,2700,5369
202109,분당선,매교,2791,2750,5541
202109,분당선,수원시청,11103,11840,22943
202109,분당선,매탄권선,4470,4351,8821
202109,분당선,망포,12431,11862,24293
202109,분당선,영통,7364,7526,14890
202109,분당선,청명,3858,3745,7603
202109,분당선,상갈,5074,4901,9975
202109,분당선,기흥,8597,8213,16810
202109,분당선,신갈,4117,4125,8242
202109,분당선,구성,4522,4823,9345
202109,분당선,죽전,12030,13098,25128
202109,분당선,보정,2251,1955,4206
202109,분당선,이매,5212,4818,10030
202109,분당선,오리,10960,9103,20063
202109,분당선,미금,14324,15335,29659
202109,분당선,정자,15045,16222,31267
202109,분당선,수내,12021,12130,24151
202109,분당선,서현,21739,21999,43738
202109,분당선,야탑,23164,24067,47231
202109,분당선,모란,18722,18693,37415
202109,분당선,태평,12599,12166,24765
202109,분당선,가천대,6330,7240,13570
202109,분당선,선정릉,7462,8116,15578
202109,분당선,강남구청,9358,10681,20039
202109,분당선,압구정로데오,16379,17732,34111
202109,분당선,서울숲,9754,9812,19566
202109,분당선,수원,6994,5911,12905
202109,분당선,복정,2,0,2
202109,분당선,수서,11957,12341,24298
202109,분당선,대모산입구,3584,3416,7000
202109,분당선,개포동,3370,3530,6900
202109,분당선,구룡,1854,1843,3697
202109,분당선,도곡,6015,5990,12005
202109,분당선,한티,13107,14252,27359
202109,분당선,선릉,12550,18350,30900
202109,분당선,매교,2879,2944,5823
202109,분당선,수원시청,11663,12978,24641
202109,분당선,영통,8009,8098,16107
202109,분당선,청명,4141,3854,7995
202109,분당선,상갈,5142,5149,10291
202109,분당선,기흥,9259,8693,17952
202109,분당선,신갈,4299,4273,8572
202109,분당선,구성,4680,4930,9610
202109,분당선,죽전,13028,14140,27168
202109,분당선,보정,2319,2076,4395
202109,분당선,이매,5511,5087,10598
202109,분당선,오리,11390,9183,20573
202109,분당선,미금,14727,15741,30468
202109,분당선,정자,15837,17160,32997
202109,분당선,수내,12438,12604,25042
202109,분당선,서현,23262,23861,47123
202109,분당선,야탑,24094,25240,49334
202109,분당선,모란,19486,19432,38918
202109,분당선,태평,13123,12536,25659
202109,분당선,가천대,6666,7280,13946
202109,분당선,선정릉,7604,8092,15696
202109,분당선,강남구청,9550,10860,20410
202109,분당선,압구정로데오,18191,19853,38044
202109,분당선,서울숲,10696,10634,21330
202109,분당선,수원,7699,6699,14398
202109,분당선,복정,1,0,1
202109,분당선,수서,13174,14232,27406
202109,분당선,대모산입구,3791,3549,7340
202109,분당선,개포동,3465,3702,7167
202109,분당선,구룡,2007,1812,3819
202109,분당선,도곡,6422,6247,12669
202109,분당선,한티,13930,15128,29058
202109,분당선,선릉,12567,18292,30859
202109,분당선,매탄권선,4885,4707,9592
202109,분당선,망포,13560,12500,26060
202109,분당선,미금,14453,15612,30065
202109,분당선,오리,11010,9113,20123
202109,분당선,이매,5196,4978,10174
202109,분당선,보정,2360,2085,4445
202109,분당선,서울숲,8943,9154,18097
202109,분당선,수원,7017,5875,12892
202109,분당선,복정,1,0,1
202109,분당선,수서,12235,12482,24717
202109,분당선,대모산입구,3909,3671,7580
202109,분당선,개포동,3611,3804,7415
202109,분당선,구룡,2061,2003,4064
202109,분당선,도곡,6283,6421,12704
202109,분당선,한티,13110,14354,27464
202109,분당선,선릉,12779,18783,31562
202109,분당선,청명,3840,3777,7617
202109,분당선,상갈,5051,4847,9898
202109,분당선,기흥,8911,8469,17380
202109,분당선,신갈,4220,4177,8397
202109,분당선,구성,4517,4891,9408
202109,분당선,가천대,6270,7202,13472
202109,분당선,선정릉,7741,8231,15972
202109,분당선,강남구청,9314,10447,19761
202109,분당선,압구정로데오,15428,16283,31711
202109,분당선,죽전,11805,13144,24949
202109,분당선,영통,7170,7383,14553
202109,분당선,태평,12686,12352,25038
202109,분당선,모란,18780,18786,37566
202109,분당선,야탑,23385,24327,47712
202109,분당선,서현,21859,21986,43845
202109,분당선,수내,11987,12238,24225
202109,분당선,정자,15395,16334,31729
202109,분당선,망포,12682,12038,24720
202109,분당선,매탄권선,4538,4479,9017
202109,분당선,수원시청,11037,11551,22588
202109,분당선,매교,2806,2792,5598
202109,분당선,선릉,12475,18396,30871
202109,분당선,한티,12799,13834,26633
202109,분당선,도곡,6122,6156,12278
202109,분당선,구룡,1877,1845,3722
202109,분당선,개포동,3424,3555,6979
202109,분당선,대모산입구,3582,3383,6965
202109,분당선,수서,11690,12138,23828
202109,분당선,복정,1,0,1
202109,분당선,수원,6660,5548,12208
202109,분당선,서울숲,8551,8771,17322
202109,분당선,압구정로데오,16028,17182,33210
202109,분당선,강남구청,9122,10368,19490
202109,분당선,선정릉,7573,8052,15625
202109,분당선,가천대,5999,7014,13013
202109,분당선,태평,12091,11691,23782
202109,분당선,모란,17415,17476,34891
202109,분당선,야탑,22399,23236,45635
202109,분당선,서현,20801,21254,42055
202109,분당선,수내,11524,11662,23186
202109,분당선,정자,14876,15758,30634
202109,분당선,미금,13783,14598,28381
202109,분당선,오리,10567,8701,19268
202109,분당선,이매,4996,4663,9659
202109,분당선,보정,2175,1921,4096
202109,분당선,죽전,11127,12378,23505
202109,분당선,구성,4361,4683,9044
202109,분당선,신갈,3989,3975,7964
202109,분당선,기흥,8514,7930,16444
202109,분당선,상갈,4878,4625,9503
202109,분당선,청명,3703,3596,7299
202109,분당선,영통,7025,7199,14224
202109,분당선,망포,12242,11601,23843
202109,분당선,매탄권선,4314,4236,8550
202109,분당선,수원시청,10665,11368,22033
202109,분당선,매교,2593,2661,5254
202109,분당선,수원시청,11432,12152,23584
202109,분당선,매교,2866,2955,5821
202109,분당선,매탄권선,4672,4492,9164
202109,분당선,망포,12807,12192,24999
202109,분당선,영통,7414,7731,15145
202109,분당선,청명,3919,3768,7687
202109,분당선,상갈,5226,4980,10206
202109,분당선,기흥,9041,8612,17653
202109,분당선,신갈,4332,4246,8578
202109,분당선,구성,4701,4892,9593
202109,분당선,죽전,12284,13570,25854
202109,분당선,보정,2449,2137,4586
202109,분당선,이매,5465,5061,10526
202109,분당선,오리,11253,9468,20721
202109,분당선,미금,14869,15740,30609
202109,분당선,정자,15537,16663,32200
202109,분당선,수내,12378,12426,24804
202109,분당선,서현,22573,23046,45619
202109,분당선,야탑,23836,24682,48518
202109,분당선,모란,18677,18803,37480
202109,분당선,태평,13037,12627,25664
202109,분당선,가천대,6492,7350,13842
202109,분당선,선정릉,7647,8261,15908
202109,분당선,강남구청,9565,10818,20383
202109,분당선,압구정로데오,16471,18037,34508
202109,분당선,서울숲,10103,10170,20273
202109,분당선,수원,7294,6052,13346
202109,분당선,수서,12502,12667,25169
202109,분당선,대모산입구,3849,3697,7546
202109,분당선,개포동,3695,3841,7536
202109,분당선,구룡,2128,2033,4161
202109,분당선,도곡,6518,6232,12750
202109,분당선,한티,13469,14644,28113
202109,분당선,선릉,12684,18914,31598
202109,분당선,선정릉,7502,8035,15537
202109,분당선,강남구청,9427,10781,20208
202109,분당선,압구정로데오,16844,18401,35245
202109,분당선,서울숲,10118,10200,20318
202109,분당선,수원,7326,6120,13446
202109,분당선,수서,12569,13028,25597
202109,분당선,대모산입구,3931,3660,7591
202109,분당선,개포동,3622,3768,7390
202109,분당선,구룡,2100,2019,4119
202109,분당선,도곡,6371,6254,12625
202109,분당선,한티,13553,14636,28189
202109,분당선,선릉,12590,18498,31088
202109,분당선,가천대,6425,7411,13836
202109,분당선,태평,13234,12720,25954
202109,분당선,모란,24253,24987,49240
202109,분당선,야탑,24056,24872,48928
202109,분당선,서현,22441,22828,45269
202109,분당선,수내,12136,12335,24471
202109,분당선,정자,15340,16170,31510
202109,분당선,미금,14906,15887,30793
202109,분당선,오리,11352,9321,20673
202109,분당선,이매,5655,5082,10737
202109,분당선,보정,2371,2079,4450
202109,분당선,죽전,12254,13486,25740
202109,분당선,구성,4810,5178,9988
202109,분당선,신갈,4289,4213,8502
202109,분당선,기흥,8996,8388,17384
202109,분당선,상갈,5248,5005,10253
202109,분당선,청명,3889,3800,7689
202109,분당선,영통,7587,7816,15403
202109,분당선,망포,13052,12191,25243
202109,분당선,매탄권선,4637,4431,9068
202109,분당선,수원시청,11494,12179,23673
202109,분당선,매교,2883,2951,5834
202109,분당선,매교,2881,2934,5815
202109,분당선,수원시청,12238,13488,25726
202109,분당선,매탄권선,4949,4637,9586
202109,분당선,망포,13836,12604,26440
202109,분당선,영통,8256,8454,16710
202109,분당선,청명,4131,3798,7929
202109,분당선,상갈,5303,5199,10502
202109,분당선,기흥,9339,8701,18040
202109,분당선,신갈,4297,4334,8631
202109,분당선,구성,4751,5099,9850
202109,분당선,죽전,12958,13910,26868
202109,분당선,보정,2431,2131,4562
202109,분당선,이매,5572,5115,10687
202109,분당선,오리,11549,9521,21070
202109,분당선,미금,15017,15961,30978
202109,분당선,정자,15770,16808,32578
202109,분당선,수내,12488,12733,25221
202109,분당선,서현,23448,23879,47327
202109,분당선,야탑,24085,25411,49496
202109,분당선,모란,19482,19660,39142
202109,분당선,태평,13147,12785,25932
202109,분당선,가천대,6495,7126,13621
202109,분당선,선정릉,7643,8091,15734
202109,분당선,강남구청,9590,10854,20444
202109,분당선,압구정로데오,18813,20668,39481
202109,분당선,서울숲,10442,10572,21014
202109,분당선,수원,7694,6519,14213
202109,분당선,수서,13424,14319,27743
202109,분당선,대모산입구,4019,3709,7728
202109,분당선,개포동,3738,3964,7702
202109,분당선,구룡,2174,2019,4193
202109,분당선,도곡,6535,6472,13007
202109,분당선,한티,13879,15027,28906
202109,분당선,선릉,12656,18451,31107
202109,분당선,복정,1,0,1
202109,분당선,매교,2933,2958,5891
202109,분당선,수원시청,11616,12136,23752
202109,분당선,매탄권선,4689,4456,9145
202109,분당선,망포,13103,12413,25516
202109,분당선,영통,7488,7810,15298
202109,분당선,청명,3940,3996,7936
202109,분당선,상갈,5216,5009,10225
202109,분당선,기흥,9069,8532,17601
202109,분당선,신갈,4363,4284,8647
202109,분당선,구성,4731,5009,9740
202109,분당선,죽전,12402,13593,25995
202109,분당선,보정,2411,2151,4562
202109,분당선,이매,5430,4956,10386
202109,분당선,오리,11400,9421,20821
202109,분당선,미금,14718,15667,30385
202109,분당선,정자,15498,16487,31985
202109,분당선,수내,12314,12314,24628
202109,분당선,서현,22541,22861,45402
202109,분당선,야탑,23639,24715,48354
202109,분당선,모란,19059,18942,38001
202109,분당선,태평,12928,12389,25317
202109,분당선,가천대,7204,8317,15521
202109,분당선,선정릉,7786,8383,16169
202109,분당선,강남구청,9361,10595,19956
202109,분당선,압구정로데오,15305,16748,32053
202109,분당선,서울숲,9700,9860,19560
202109,분당선,수원,7321,6013,13334
202109,분당선,수서,12716,13050,25766
202109,분당선,대모산입구,4100,3779,7879
202109,분당선,개포동,3638,3765,7403
202109,분당선,구룡,2087,2016,4103
202109,분당선,도곡,6521,6544,13065
202109,분당선,한티,13222,14403,27625
202109,분당선,선릉,12694,18820,31514
202109,분당선,매교,2810,2828,5638
202109,분당선,수원시청,11297,12077,23374
202109,분당선,매탄권선,4662,4434,9096
202109,분당선,망포,13068,12309,25377
202109,분당선,영통,7545,7741,15286
202109,분당선,청명,4007,3775,7782
202109,분당선,상갈,5244,5095,10339
202109,분당선,기흥,9170,8520,17690
202109,분당선,신갈,4344,4305,8649
202109,분당선,구성,4805,5204,10009
202109,분당선,죽전,12621,14013,26634
202109,분당선,보정,2459,2152,4611
202109,분당선,이매,5503,5132,10635
202109,분당선,오리,11641,9566,21207
202109,분당선,미금,15111,16017,31128
202109,분당선,정자,15835,16656,32491
202109,분당선,수내,12431,12623,25054
202109,분당선,서현,22829,23097,45926
202109,분당선,야탑,24426,25256,49682
202109,분당선,모란,24434,25306,49740
202109,분당선,태평,13260,12785,26045
202109,분당선,가천대,7276,8218,15494
202109,분당선,선정릉,7757,8257,16014
202109,분당선,강남구청,9579,10954,20533
202109,분당선,압구정로데오,17360,18699,36059
202109,분당선,서울숲,9851,10112,19963
202109,분당선,수원,7170,6170,13340
202109,분당선,수서,12920,13171,26091
202109,분당선,대모산입구,4192,3881,8073
202109,분당선,개포동,3723,3798,7521
202109,분당선,구룡,2106,2032,4138
202109,분당선,도곡,6607,6449,13056
202109,분당선,한티,13380,14565,27945
202109,분당선,선릉,13025,18893,31918
202109,분당선,매교,2954,3055,6009
202109,분당선,수원시청,11811,12586,24397
202109,분당선,매탄권선,4797,4583,9380
202109,분당선,망포,13423,12524,25947
202109,분당선,영통,7869,8071,15940
202109,분당선,청명,4124,3941,8065
202109,분당선,상갈,5292,5149,10441
202109,분당선,기흥,9298,8716,18014
202109,분당선,신갈,4357,4344,8701
202109,분당선,구성,4834,5172,10006
202109,분당선,죽전,12713,13869,26582
202109,분당선,보정,2378,2139,4517
202109,분당선,이매,5512,5189,10701
202109,분당선,오리,11608,9644,21252
202109,분당선,미금,14988,16116,31104
202109,분당선,정자,16012,17142,33154
202109,분당선,수내,12614,12683,25297
202109,분당선,서현,23078,23667,46745
202109,분당선,야탑,24572,25609,50181
202109,분당선,모란,19328,19331,38659
202109,분당선,태평,13012,12587,25599
202109,분당선,가천대,7362,8332,15694
202109,분당선,선정릉,8046,8561,16607
202109,분당선,강남구청,9994,11250,21244
202109,분당선,압구정로데오,17701,19094,36795
202109,분당선,서울숲,10465,10612,21077
202109,분당선,수원,7414,6206,13620
202109,분당선,복정,1,0,1
202109,분당선,수서,12831,13470,26301
202109,분당선,대모산입구,4072,3791,7863
202109,분당선,개포동,3787,3969,7756
202109,분당선,구룡,2182,2055,4237
202109,분당선,도곡,6769,6651,13420
202109,분당선,한티,13824,15090,28914
202109,분당선,선릉,13370,19507,32877
202109,분당선,미금,14942,15745,30687
202109,분당선,정자,15873,16855,32728
202109,분당선,수내,12451,12545,24996
202109,분당선,서현,22897,23425,46322
202109,분당선,야탑,24222,25337,49559
202109,분당선,모란,19414,19500,38914
202109,분당선,태평,13056,12507,25563
202109,분당선,가천대,7487,8107,15594
202109,분당선,선정릉,7851,8402,16253
202109,분당선,강남구청,9692,11082,20774
202109,분당선,압구정로데오,17818,19445,37263
202109,분당선,서울숲,10292,10361,20653
202109,분당선,수원,7556,6389,13945
202109,분당선,수서,12820,14187,27007
202109,분당선,대모산입구,4067,3757,7824
202109,분당선,개포동,3716,3804,7520
202109,분당선,구룡,2178,2061,4239
202109,분당선,도곡,6747,6510,13257
202109,분당선,한티,14081,15067,29148
202109,분당선,선릉,13004,19113,32117
202109,분당선,오리,11652,9616,21268
202109,분당선,이매,5512,5080,10592
202109,분당선,보정,2432,2104,4536
202109,분당선,죽전,12862,13972,26834
202109,분당선,구성,4846,5168,10014
202109,분당선,신갈,4334,4255,8589
202109,분당선,기흥,9014,8574,17588
202109,분당선,상갈,5282,5143,10425
202109,분당선,청명,4063,3889,7952
202109,분당선,영통,8065,8040,16105
202109,분당선,망포,13523,12599,26122
202109,분당선,매탄권선,4837,4531,9368
202109,분당선,수원시청,11798,12388,24186
202109,분당선,매교,2865,2823,5688
202109,분당선,선릉,12198,17840,30038
202109,분당선,한티,14585,15839,30424
202109,분당선,도곡,6756,6484,13240
202109,분당선,구룡,2298,2005,4303
202109,분당선,개포동,3834,3977,7811
202109,분당선,대모산입구,4106,3706,7812
202109,분당선,수서,11556,12743,24299
202109,분당선,수원,7889,6980,14869
202109,분당선,서울숲,10654,10742,21396
202109,분당선,압구정로데오,19911,21494,41405
202109,분당선,강남구청,9509,10855,20364
202109,분당선,선정릉,7436,7839,15275
202109,분당선,가천대,7382,7743,15125
202109,분당선,태평,13578,13037,26615
202109,분당선,모란,19861,19766,39627
202109,분당선,야탑,24970,27016,51986
202109,분당선,서현,24395,25007,49402
202109,분당선,수내,12796,12834,25630
202109,분당선,정자,16607,17597,34204
202109,분당선,미금,15329,16116,31445
202109,분당선,오리,11624,9658,21282
202109,분당선,이매,5662,5260,10922
202109,분당선,보정,2368,2126,4494
202109,분당선,죽전,13408,14562,27970
202109,분당선,구성,4733,5187,9920
202109,분당선,신갈,4370,4304,8674
202109,분당선,기흥,9236,9041,18277
202109,분당선,상갈,5378,5204,10582
202109,분당선,청명,4288,3938,8226
202109,분당선,영통,8477,8414,16891
202109,분당선,망포,14545,12769,27314
202109,분당선,매탄권선,5187,4735,9922
202109,분당선,수원시청,12550,13757,26307
202109,분당선,매교,2809,2876,5685
202109,분당선,청명,1340,1299,2639
202109,분당선,매교,966,1007,1973
202109,분당선,수원시청,4576,4209,8785
202109,분당선,매탄권선,1571,1531,3102
202109,분당선,망포,3913,3631,7544
202109,분당선,영통,2954,2805,5759
202109,분당선,선릉,1524,2104,3628
202109,분당선,한티,5616,5067,10683
202109,분당선,도곡,1836,1623,3459
202109,분당선,구룡,484,427,911
202109,분당선,개포동,1214,1185,2399
202109,분당선,대모산입구,1255,1184,2439
202109,분당선,수서,4330,5063,9393
202109,분당선,수원,4400,3694,8094
202109,분당선,서울숲,4237,4449,8686
202109,분당선,압구정로데오,5364,6172,11536
202109,분당선,강남구청,1663,1786,3449
202109,분당선,선정릉,1157,1061,2218
202109,분당선,가천대,2305,2444,4749
202109,분당선,태평,6431,6008,12439
202109,분당선,모란,7845,8058,15903
202109,분당선,야탑,8565,9339,17904
202109,분당선,서현,8239,8220,16459
202109,분당선,수내,4035,3907,7942
202109,분당선,정자,4724,4735,9459
202109,분당선,미금,5103,5277,10380
202109,분당선,오리,3808,3208,7016
202109,분당선,이매,2023,2109,4132
202109,분당선,보정,735,797,1532
202109,분당선,죽전,4444,4876,9320
202109,분당선,구성,1603,1800,3403
202109,분당선,신갈,1287,1411,2698
202109,분당선,기흥,3603,3445,7048
202109,분당선,상갈,2245,2434,4679
202109,분당선,매탄권선,1413,1354,2767
202109,분당선,망포,3110,3251,6361
202109,분당선,영통,2247,2413,4660
202109,분당선,청명,1053,1014,2067
202109,분당선,상갈,1712,1701,3413
202109,분당선,기흥,3099,2695,5794
202109,분당선,신갈,1110,1104,2214
202109,분당선,구성,1308,1341,2649
202109,분당선,죽전,3255,3867,7122
202109,분당선,보정,593,562,1155
202109,분당선,이매,1570,1616,3186
202109,분당선,오리,2578,2324,4902
202109,분당선,미금,3442,3753,7195
202109,분당선,정자,3423,3731,7154
202109,분당선,수내,2201,2239,4440
202109,분당선,서현,5261,5773,11034
202109,분당선,야탑,7165,6292,13457
202109,분당선,모란,6046,6285,12331
202109,분당선,태평,4870,4783,9653
202109,분당선,가천대,1955,2468,4423
202109,분당선,선정릉,835,870,1705
202109,분당선,강남구청,1108,1371,2479
202109,분당선,압구정로데오,2215,2619,4834
202109,분당선,서울숲,2770,2867,5637
202109,분당선,수원,3611,2973,6584
202109,분당선,수서,4251,3768,8019
202109,분당선,대모산입구,1065,996,2061
202109,분당선,개포동,846,850,1696
202109,분당선,선릉,1013,1614,2627
202109,분당선,한티,3674,3708,7382
202109,분당선,도곡,1081,1028,2109
202109,분당선,구룡,295,328,623
202109,분당선,매교,798,786,1584
202109,분당선,수원시청,3426,3924,7350
202109,분당선,선릉,2014,3145,5159
202109,분당선,한티,6649,6673,13322
202109,분당선,도곡,2076,2111,4187
202109,분당선,구룡,568,575,1143
202109,분당선,개포동,1392,1416,2808
202109,분당선,대모산입구,1439,1386,2825
202109,분당선,수서,6066,5114,11180
202109,분당선,수원,5157,4520,9677
202109,분당선,서울숲,5364,5586,10950
202109,분당선,압구정로데오,6079,7076,13155
202109,분당선,강남구청,2047,2432,4479
202109,분당선,선정릉,1292,1486,2778
202109,분당선,가천대,2566,3543,6109
202109,분당선,태평,6599,6286,12885
202109,분당선,모란,8663,9220,17883
202109,분당선,야탑,11826,10509,22335
202109,분당선,서현,11357,11394,22751
202109,분당선,수내,4076,4185,8261
202109,분당선,정자,6009,6615,12624
202109,분당선,미금,5845,6446,12291
202109,분당선,오리,4195,3678,7873
202109,분당선,이매,2402,2410,4812
202109,분당선,보정,986,878,1864
202109,분당선,죽전,6523,7633,14156
202109,분당선,구성,1973,1995,3968
202109,분당선,신갈,1590,1619,3209
202109,분당선,기흥,4308,3947,8255
202109,분당선,상갈,2657,2595,5252
202109,분당선,청명,1554,1529,3083
202109,분당선,영통,3648,4020,7668
202109,분당선,망포,4979,5365,10344
202109,분당선,매탄권선,2045,2015,4060
202109,분당선,수원시청,5458,5907,11365
202109,분당선,매교,1084,1090,2174
202109,분당선,선릉,11397,16955,28352
202109,분당선,한티,12910,13712,26622
202109,분당선,도곡,5826,5823,11649
202109,분당선,구룡,1626,1555,3181
202109,분당선,개포동,3449,3577,7026
202109,분당선,대모산입구,3745,3466,7211
202109,분당선,수서,12841,11105,23946
202109,분당선,수원,7141,6266,13407
202109,분당선,서울숲,8908,9008,17916
202109,분당선,압구정로데오,16185,17459,33644
202109,분당선,강남구청,8727,10008,18735
202109,분당선,선정릉,6780,7320,14100
202109,분당선,가천대,6601,7866,14467
202109,분당선,태평,12382,11951,24333
202109,분당선,모란,17509,17698,35207
202109,분당선,야탑,22760,23340,46100
202109,분당선,서현,21779,22244,44023
202109,분당선,수내,11706,11770,23476
202109,분당선,정자,13150,14182,27332
202109,분당선,미금,13755,14678,28433
202109,분당선,오리,10175,8530,18705
202109,분당선,이매,5125,4721,9846
202109,분당선,보정,2068,1879,3947
202109,분당선,죽전,11514,13081,24595
202109,분당선,구성,4315,4594,8909
202109,분당선,신갈,4063,4066,8129
202109,분당선,기흥,8392,8035,16427
202109,분당선,상갈,4776,4572,9348
202109,분당선,청명,3684,3457,7141
202109,분당선,영통,7148,7683,14831
202109,분당선,망포,11891,11459,23350
202109,분당선,매탄권선,4307,4156,8463
202109,분당선,수원시청,11118,12024,23142
202109,분당선,매교,2740,2747,5487
202109,분당선,선릉,12176,17928,30104
202109,분당선,한티,13679,14904,28583
202109,분당선,도곡,6496,6311,12807
202109,분당선,구룡,1725,1708,3433
202109,분당선,개포동,3689,3857,7546
202109,분당선,대모산입구,4112,3751,7863
202109,분당선,수서,13323,13216,26539
202109,분당선,복정,1,0,1
202109,분당선,수원,7640,6574,14214
202109,분당선,서울숲,10190,10273,20463
202109,분당선,압구정로데오,18403,20337,38740
202109,분당선,강남구청,9509,10710,20219
202109,분당선,선정릉,7017,7538,14555
202109,분당선,가천대,7045,7887,14932
202109,분당선,태평,13082,12606,25688
202109,분당선,모란,22159,22687,44846
202109,분당선,야탑,23918,24828,48746
202109,분당선,서현,23592,23987,47579
202109,분당선,수내,12291,12567,24858
202109,분당선,정자,15290,16593,31883
202109,분당선,미금,14835,15760,30595
202109,분당선,오리,10925,9030,19955
202109,분당선,이매,5468,4960,10428
202109,분당선,보정,2254,1991,4245
202109,분당선,죽전,12684,13816,26500
202109,분당선,구성,4606,4943,9549
202109,분당선,신갈,4291,4201,8492
202109,분당선,기흥,8865,8590,17455
202109,분당선,상갈,5217,5086,10303
202109,분당선,청명,4025,3848,7873
202109,분당선,영통,7843,8187,16030
202109,분당선,망포,13273,12192,25465
202109,분당선,매탄권선,4581,4436,9017
202109,분당선,수원시청,12113,13278,25391
202109,분당선,매교,2820,2908,5728
202109,분당선,선정릉,7863,8347,16210
202109,분당선,강남구청,9437,10842,20279
202109,분당선,압구정로데오,15541,16546,32087
202109,분당선,서울숲,9651,9866,19517
202109,분당선,수원,7153,6120,13273
202109,분당선,가천대,7330,8513,15843
202109,분당선,수서,12675,12952,25627
202109,분당선,대모산입구,4125,3848,7973
202109,분당선,개포동,3629,3838,7467
202109,분당선,구룡,2131,2054,4185
202109,분당선,도곡,6537,6547,13084
202109,분당선,한티,13074,14227,27301
202109,분당선,선릉,13218,19388,32606
202109,분당선,태평,12860,12381,25241
202109,분당선,모란,18539,18630,37169
202109,분당선,야탑,23919,24980,48899
202109,분당선,서현,22361,22609,44970
202109,분당선,수내,12256,12451,24707
202109,분당선,정자,15744,16611,32355
202109,분당선,미금,14628,15443,30071
202109,분당선,오리,11157,9310,20467
202109,분당선,이매,5412,4982,10394
202109,분당선,보정,2461,2170,4631
202109,분당선,죽전,12093,13562,25655
202109,분당선,구성,4758,5091,9849
202109,분당선,신갈,4379,4325,8704
202109,분당선,기흥,8997,8531,17528
202109,분당선,상갈,5051,4854,9905
202109,분당선,청명,4024,3809,7833
202109,분당선,영통,7400,7737,15137
202109,분당선,망포,13112,12467,25579
202109,분당선,매탄권선,4641,4431,9072
202109,분당선,수원시청,11366,12148,23514
202109,분당선,매교,2919,2839,5758
202109,분당선,선릉,13346,19555,32901
202109,분당선,한티,13146,14202,27348
202109,분당선,도곡,6541,6448,12989
202109,분당선,구룡,2049,2025,4074
202109,분당선,개포동,3698,3893,7591
202109,분당선,대모산입구,4071,3874,7945
202109,분당선,수서,12477,12764,25241
202109,분당선,수원,7096,5976,13072
202109,분당선,서울숲,9777,9923,19700
202109,분당선,압구정로데오,17151,18355,35506
202109,분당선,강남구청,9741,11082,20823
202109,분당선,선정릉,7887,8377,16264
202109,분당선,가천대,7367,8440,15807
202109,분당선,태평,12738,12404,25142
202109,분당선,모란,18353,18499,36852
202109,분당선,야탑,23560,24642,48202
202109,분당선,서현,22471,22733,45204
202109,분당선,수내,12387,12432,24819
202109,분당선,정자,15891,17093,32984
202109,분당선,미금,14680,15577,30257
202109,분당선,오리,11199,9233,20432
202109,분당선,이매,5403,5009,10412
202109,분당선,보정,2347,2106,4453
202109,분당선,죽전,12250,13335,25585
202109,분당선,구성,4645,5016,9661
202109,분당선,신갈,4315,4301,8616
202109,분당선,기흥,9068,8577,17645
202109,분당선,상갈,5076,4867,9943
202109,분당선,청명,3976,3860,7836
202109,분당선,영통,7555,7733,15288
202109,분당선,망포,13126,12478,25604
202109,분당선,매탄권선,4518,4458,8976
202109,분당선,수원시청,11466,12156,23622
202109,분당선,매교,2849,2864,5713
202109,분당선,선릉,13063,19145,32208
202109,분당선,한티,13036,14292,27328
202109,분당선,도곡,6255,6205,12460
202109,분당선,구룡,2028,1970,3998
202109,분당선,개포동,3626,3778,7404
202109,분당선,대모산입구,4049,3788,7837
202109,분당선,수서,12232,12545,24777
202109,분당선,복정,2,0,2
202109,분당선,수원,6942,5894,12836
202109,분당선,서울숲,9219,9560,18779
202109,분당선,압구정로데오,16213,17871,34084
202109,분당선,강남구청,9531,11025,20556
202109,분당선,선정릉,7764,8205,15969
202109,분당선,가천대,6918,7926,14844
202109,분당선,태평,12732,12181,24913
202109,분당선,모란,19815,20164,39979
202109,분당선,야탑,23227,24041,47268
202109,분당선,서현,21630,21902,43532
202109,분당선,수내,12093,12213,24306
202109,분당선,정자,15538,16364,31902
202109,분당선,미금,14191,15112,29303
202109,분당선,오리,10756,8966,19722
202109,분당선,이매,5245,4840,10085
202109,분당선,보정,2256,2011,4267
202109,분당선,죽전,11674,12925,24599
202109,분당선,구성,4510,4908,9418
202109,분당선,신갈,4071,3995,8066
202109,분당선,기흥,8718,8208,16926
202109,분당선,상갈,5015,4729,9744
202109,분당선,청명,3866,3692,7558
202109,분당선,영통,7287,7502,14789
202109,분당선,망포,12959,12136,25095
202109,분당선,매탄권선,4455,4384,8839
202109,분당선,수원시청,11147,11880,23027
202109,분당선,매교,2621,2661,5282
202109,분당선,매교,2857,2892,5749
202109,분당선,수원시청,11803,12476,24279
202109,분당선,매탄권선,4650,4478,9128
202109,분당선,망포,13484,12631,26115
202109,분당선,영통,7753,7939,15692
202109,분당선,청명,3991,3930,7921
202109,분당선,상갈,5321,5026,10347
202109,분당선,기흥,9269,8675,17944
202109,분당선,신갈,4325,4321,8646
202109,분당선,구성,4833,5223,10056
202109,분당선,죽전,12637,13767,26404
202109,분당선,보정,2466,2121,4587
202109,분당선,이매,5503,5071,10574
202109,분당선,오리,11351,9413,20764
202109,분당선,미금,14437,15600,30037
202109,분당선,복정,2,0,2
202109,분당선,정자,15928,16988,32916
202109,분당선,수내,12413,12702,25115
202109,분당선,서현,22313,22844,45157
202109,분당선,야탑,23977,24975,48952
202109,분당선,모란,18671,19020,37691
202109,분당선,태평,13062,12570,25632
202109,분당선,가천대,7415,8293,15708
202109,분당선,선정릉,7602,8199,15801
202109,분당선,강남구청,9730,11042,20772
202109,분당선,압구정로데오,17459,19148,36607
202109,분당선,서울숲,10471,10607,21078
202109,분당선,수원,7281,6363,13644
202109,분당선,수서,12581,13082,25663
202109,분당선,대모산입구,4144,3914,8058
202109,분당선,개포동,3776,3955,7731
202109,분당선,구룡,2091,2048,4139
202109,분당선,도곡,6637,6454,13091
202109,분당선,한티,13744,14606,28350
202109,분당선,선릉,12970,19297,32267
202110,분당선,수원시청,12282,13553,25835
202110,분당선,매탄권선,4946,4770,9716
202110,분당선,망포,14495,13274,27769
202110,분당선,영통,8606,8600,17206
202110,분당선,청명,4384,4058,8442
202110,분당선,상갈,5451,5296,10747
202110,분당선,기흥,9311,8957,18268
202110,분당선,신갈,4476,4406,8882
202110,분당선,구성,4916,5320,10236
202110,분당선,죽전,13378,14465,27843
202110,분당선,보정,2544,2158,4702
202110,분당선,이매,5556,5205,10761
202110,분당선,오리,11201,9209,20410
202110,분당선,미금,15265,16247,31512
202110,분당선,정자,16629,17930,34559
202110,분당선,수내,12740,12767,25507
202110,분당선,서현,23666,24162,47828
202110,분당선,야탑,24706,25915,50621
202110,분당선,모란,19452,19480,38932
202110,분당선,태평,13333,12730,26063
202110,분당선,가천대,7524,8074,15598
202110,분당선,선정릉,7659,8193,15852
202110,분당선,강남구청,9539,11024,20563
202110,분당선,압구정로데오,19259,21224,40483
202110,분당선,서울숲,10817,10753,21570
202110,분당선,수원,7872,6984,14856
202110,분당선,수서,13884,14842,28726
202110,분당선,대모산입구,4225,3936,8161
202110,분당선,개포동,3956,4164,8120
202110,분당선,구룡,2313,2097,4410
202110,분당선,도곡,6797,6707,13504
202110,분당선,한티,14045,15197,29242
202110,분당선,선릉,12902,19049,31951
202110,분당선,복정,1,0,1
202110,분당선,매교,2942,2937,5879
202110,분당선,선릉,3887,5849,9736
202110,분당선,한티,8520,8791,17311
202110,분당선,도곡,3477,3361,6838
202110,분당선,구룡,931,968,1899
202110,분당선,개포동,2295,2350,4645
202110,분당선,대모산입구,2304,2207,4511
202110,분당선,수서,8477,7887,16364
202110,분당선,수원,5381,4608,9989
202110,분당선,서울숲,5574,5684,11258
202110,분당선,압구정로데오,10824,11794,22618
202110,분당선,강남구청,3562,4282,7844
202110,분당선,선정릉,2610,2694,5304
202110,분당선,가천대,4375,5092,9467
202110,분당선,태평,9112,8669,17781
202110,분당선,모란,17712,18486,36198
202110,분당선,야탑,14372,14696,29068
202110,분당선,서현,14266,14171,28437
202110,분당선,수내,6855,6890,13745
202110,분당선,정자,8134,8626,16760
202110,분당선,미금,8639,9285,17924
202110,분당선,오리,5889,5166,11055
202110,분당선,이매,3199,3189,6388
202110,분당선,보정,1156,1049,2205
202110,분당선,죽전,7942,8981,16923
202110,분당선,구성,2708,2818,5526
202110,분당선,신갈,2167,2226,4393
202110,분당선,기흥,5489,5240,10729
202110,분당선,상갈,3095,3131,6226
202110,분당선,청명,2123,2151,4274
202110,분당선,영통,4686,4764,9450
202110,분당선,망포,6574,6814,13388
202110,분당선,매탄권선,2671,2562,5233
202110,분당선,수원시청,7233,7268,14501
202110,분당선,매교,1680,1717,3397
202110,분당선,매교,3060,3133,6193
202110,분당선,수원시청,11649,12309,23958
202110,분당선,매탄권선,4705,4597,9302
202110,분당선,망포,13654,12877,26531
202110,분당선,영통,7768,8051,15819
202110,분당선,청명,4160,3980,8140
202110,분당선,상갈,5267,5020,10287
202110,분당선,기흥,9351,8712,18063
202110,분당선,신갈,4525,4546,9071
202110,분당선,구성,4755,5158,9913
202110,분당선,죽전,12579,13735,26314
202110,분당선,보정,2527,2192,4719
202110,분당선,이매,5568,4981,10549
202110,분당선,오리,11429,9482,20911
202110,분당선,미금,15078,16231,31309
202110,분당선,정자,16220,17193,33413
202110,분당선,수내,12651,12639,25290
202110,분당선,서현,22719,23135,45854
202110,분당선,야탑,24263,25337,49600
202110,분당선,모란,18876,18852,37728
202110,분당선,태평,13061,12476,25537
202110,분당선,가천대,8181,9155,17336
202110,분당선,선정릉,7919,8443,16362
202110,분당선,강남구청,9716,11190,20906
202110,분당선,압구정로데오,16944,18334,35278
202110,분당선,서울숲,9782,9945,19727
202110,분당선,수원,7374,6278,13652
202110,분당선,수서,12618,13111,25729
202110,분당선,대모산입구,4213,3964,8177
202110,분당선,개포동,3742,3872,7614
202110,분당선,구룡,2091,2032,4123
202110,분당선,도곡,6520,6461,12981
202110,분당선,한티,13345,14459,27804
202110,분당선,선릉,13482,20074,33556
202110,분당선,선릉,13260,19686,32946
202110,분당선,한티,13323,14495,27818
202110,분당선,도곡,6545,6384,12929
202110,분당선,구룡,2064,2032,4096
202110,분당선,개포동,3789,3860,7649
202110,분당선,대모산입구,4174,3818,7992
202110,분당선,수서,12623,12978,25601
202110,분당선,수원,7200,6143,13343
202110,분당선,서울숲,9668,9792,19460
202110,분당선,압구정로데오,16683,18384,35067
202110,분당선,강남구청,9717,11250,20967
202110,분당선,선정릉,7856,8427,16283
202110,분당선,가천대,8045,9167,17212
202110,분당선,태평,12904,12375,25279
202110,분당선,모란,18419,18549,36968
202110,분당선,야탑,24044,25153,49197
202110,분당선,서현,22641,22916,45557
202110,분당선,수내,12434,12443,24877
202110,분당선,정자,16361,17287,33648
202110,분당선,미금,14737,15556,30293
202110,분당선,오리,11217,9407,20624
202110,분당선,이매,5603,5156,10759
202110,분당선,보정,2476,2195,4671
202110,분당선,죽전,12282,13593,25875
202110,분당선,구성,4893,5169,10062
202110,분당선,신갈,4405,4364,8769
202110,분당선,기흥,9097,8642,17739
202110,분당선,상갈,5217,4961,10178
202110,분당선,청명,4209,3970,8179
202110,분당선,영통,7698,7839,15537
202110,분당선,망포,13564,12787,26351
202110,분당선,매탄권선,4728,4562,9290
202110,분당선,수원시청,11448,12322,23770
202110,분당선,매교,3061,3037,6098
202110,분당선,태평,12966,12458,25424
202110,분당선,모란,18930,18868,37798
202110,분당선,야탑,23974,25041,49015
202110,분당선,서현,22366,22892,45258
202110,분당선,수내,12346,12419,24765
202110,분당선,정자,16227,17201,33428
202110,분당선,미금,14597,15549,30146
202110,분당선,오리,11341,9472,20813
202110,분당선,이매,5484,5053,10537
202110,분당선,보정,2572,2184,4756
202110,분당선,죽전,12686,13968,26654
202110,분당선,구성,4886,5123,10009
202110,분당선,신갈,4497,4471,8968
202110,분당선,기흥,9267,8629,17896
202110,분당선,상갈,5222,4947,10169
202110,분당선,청명,4159,3943,8102
202110,분당선,영통,7697,7995,15692
202110,분당선,망포,13387,12674,26061
202110,분당선,매탄권선,4684,4576,9260
202110,분당선,수원시청,11482,12214,23696
202110,분당선,매교,3056,3052,6108
202110,분당선,개포동,3836,3868,7704
202110,분당선,구룡,2151,2024,4175
202110,분당선,도곡,6505,6427,12932
202110,분당선,한티,13364,14400,27764
202110,분당선,선릉,13275,19309,32584
202110,분당선,대모산입구,4279,3918,8197
202110,분당선,수서,12865,13388,26253
202110,분당선,수원,7393,6207,13600
202110,분당선,서울숲,9830,10028,19858
202110,분당선,압구정로데오,17157,18724,35881
202110,분당선,강남구청,9611,11195,20806
202110,분당선,선정릉,7844,8533,16377
202110,분당선,가천대,8169,9064,17233
202110,분당선,매교,3142,3129,6271
202110,분당선,수원시청,12374,13645,26019
202110,분당선,매탄권선,4989,4782,9771
202110,분당선,망포,14529,13402,27931
202110,분당선,영통,8320,8399,16719
202110,분당선,청명,4395,3940,8335
202110,분당선,상갈,5379,5235,10614
202110,분당선,기흥,9492,8996,18488
202110,분당선,신갈,4510,4377,8887
202110,분당선,구성,5026,5191,10217
202110,분당선,죽전,13401,14482,27883
202110,분당선,보정,2514,2223,4737
202110,분당선,이매,5979,5368,11347
202110,분당선,오리,11557,9473,21030
202110,분당선,미금,15081,16230,31311
202110,분당선,정자,16763,17461,34224
202110,분당선,수내,12991,12867,25858
202110,분당선,서현,24107,25055,49162
202110,분당선,야탑,25184,26552,51736
202110,분당선,모란,19479,19665,39144
202110,분당선,태평,13078,12650,25728
202110,분당선,가천대,7983,8553,16536
202110,분당선,선정릉,7757,8304,16061
202110,분당선,강남구청,9848,11197,21045
202110,분당선,압구정로데오,19048,21112,40160
202110,분당선,서울숲,10055,10077,20132
202110,분당선,수원,7872,7066,14938
202110,분당선,복정,1,0,1
202110,분당선,수서,13952,15109,29061
202110,분당선,대모산입구,4282,3986,8268
202110,분당선,개포동,3927,3996,7923
202110,분당선,구룡,2109,1981,4090
202110,분당선,도곡,6922,6667,13589
202110,분당선,한티,14189,15196,29385
202110,분당선,선릉,13043,19231,32274
202110,분당선,선릉,4018,5872,9890
202110,분당선,한티,8164,8337,16501
202110,분당선,도곡,3537,3342,6879
202110,분당선,구룡,989,1058,2047
202110,분당선,개포동,2379,2405,4784
202110,분당선,대모산입구,2333,2145,4478
202110,분당선,수서,8619,8251,16870
202110,분당선,수원,5767,4798,10565
202110,분당선,서울숲,7043,7133,14176
202110,분당선,압구정로데오,11332,12523,23855
202110,분당선,강남구청,3711,4250,7961
202110,분당선,선정릉,2782,2915,5697
202110,분당선,가천대,4462,5164,9626
202110,분당선,태평,9089,8748,17837
202110,분당선,모란,13116,13467,26583
202110,분당선,야탑,14992,15338,30330
202110,분당선,서현,15030,14762,29792
202110,분당선,수내,6774,6768,13542
202110,분당선,정자,8600,8950,17550
202110,분당선,미금,9874,10274,20148
202110,분당선,오리,6214,5196,11410
202110,분당선,이매,3149,3134,6283
202110,분당선,보정,1305,1175,2480
202110,분당선,죽전,8568,9626,18194
202110,분당선,구성,2901,3004,5905
202110,분당선,신갈,2296,2345,4641
202110,분당선,기흥,5626,5463,11089
202110,분당선,상갈,3368,3389,6757
202110,분당선,청명,2185,2249,4434
202110,분당선,영통,5026,5176,10202
202110,분당선,망포,6892,7129,14021
202110,분당선,매탄권선,2751,2700,5451
202110,분당선,수원시청,7420,7531,14951
202110,분당선,매교,1602,1662,3264
202110,분당선,선릉,13550,20114,33664
202110,분당선,한티,13311,14478,27789
202110,분당선,도곡,6717,6727,13444
202110,분당선,구룡,2077,2081,4158
202110,분당선,개포동,3770,3947,7717
202110,분당선,대모산입구,4265,4028,8293
202110,분당선,수서,13170,13379,26549
202110,분당선,수원,7533,6420,13953
202110,분당선,서울숲,10270,10516,20786
202110,분당선,압구정로데오,17028,18543,35571
202110,분당선,강남구청,9759,11265,21024
202110,분당선,선정릉,7985,8657,16642
202110,분당선,가천대,8586,9628,18214
202110,분당선,태평,13297,12849,26146
202110,분당선,모란,19131,19293,38424
202110,분당선,야탑,24652,25829,50481
202110,분당선,서현,23120,23318,46438
202110,분당선,수내,12745,12657,25402
202110,분당선,정자,16336,17549,33885
202110,분당선,미금,15353,16259,31612
202110,분당선,오리,11389,9549,20938
202110,분당선,이매,5576,5106,10682
202110,분당선,보정,2476,2159,4635
202110,분당선,죽전,12751,13908,26659
202110,분당선,구성,5014,5265,10279
202110,분당선,신갈,4545,4595,9140
202110,분당선,기흥,9374,8823,18197
202110,분당선,상갈,5358,5154,10512
202110,분당선,청명,4198,3989,8187
202110,분당선,영통,7886,8173,16059
202110,분당선,망포,13597,12888,26485
202110,분당선,매탄권선,4748,4633,9381
202110,분당선,수원시청,11791,12381,24172
202110,분당선,매교,3075,3092,6167
202110,분당선,매교,3144,3168,6312
202110,분당선,수원시청,11956,12851,24807
202110,분당선,매탄권선,4916,4712,9628
202110,분당선,망포,13860,13040,26900
202110,분당선,영통,7987,8199,16186
202110,분당선,청명,4231,4057,8288
202110,분당선,상갈,5451,5234,10685
202110,분당선,기흥,9523,8933,18456
202110,분당선,신갈,4432,4475,8907
202110,분당선,구성,4945,5312,10257
202110,분당선,죽전,12936,14226,27162
202110,분당선,보정,2531,2209,4740
202110,분당선,이매,5742,5317,11059
202110,분당선,오리,11693,9756,21449
202110,분당선,미금,15213,16407,31620
202110,분당선,정자,16572,17496,34068
202110,분당선,수내,12715,12731,25446
202110,분당선,서현,22971,23474,46445
202110,분당선,야탑,25164,26052,51216
202110,분당선,모란,19185,19186,38371
202110,분당선,태평,13324,12781,26105
202110,분당선,가천대,8408,9362,17770
202110,분당선,선정릉,8225,8758,16983
202110,분당선,강남구청,9899,11245,21144
202110,분당선,압구정로데오,17385,19072,36457
202110,분당선,서울숲,11008,11272,22280
202110,분당선,수원,7584,6496,14080
202110,분당선,수서,12968,13377,26345
202110,분당선,대모산입구,4347,4066,8413
202110,분당선,개포동,3916,4060,7976
202110,분당선,구룡,2130,2058,4188
202110,분당선,도곡,6693,6643,13336
202110,분당선,한티,13643,14625,28268
202110,분당선,선릉,13560,20035,33595
202110,분당선,매교,3098,3094,6192
202110,분당선,수원시청,12039,12731,24770
202110,분당선,매탄권선,5029,4819,9848
202110,분당선,망포,13862,12990,26852
202110,분당선,영통,7914,8166,16080
202110,분당선,청명,4166,4070,8236
202110,분당선,상갈,5514,5175,10689
202110,분당선,기흥,9604,8846,18450
202110,분당선,신갈,4536,4525,9061
202110,분당선,구성,4895,5181,10076
202110,분당선,죽전,13063,14377,27440
202110,분당선,보정,2534,2207,4741
202110,분당선,이매,5742,5239,10981
202110,분당선,오리,11797,9603,21400
202110,분당선,미금,15109,16302,31411
202110,분당선,정자,16544,17644,34188
202110,분당선,수내,12639,12780,25419
202110,분당선,서현,23266,23671,46937
202110,분당선,야탑,25051,26023,51074
202110,분당선,모란,25019,25683,50702
202110,분당선,태평,13400,13001,26401
202110,분당선,가천대,8416,9313,17729
202110,분당선,선정릉,7947,8556,16503
202110,분당선,강남구청,9624,11110,20734
202110,분당선,압구정로데오,17455,19075,36530
202110,분당선,서울숲,10840,10992,21832
202110,분당선,수원,7344,6622,13966
202110,분당선,수서,13378,13863,27241
202110,분당선,대모산입구,4403,4089,8492
202110,분당선,개포동,3824,3943,7767
202110,분당선,구룡,2194,2042,4236
202110,분당선,도곡,6666,6579,13245
202110,분당선,한티,13556,14472,28028
202110,분당선,선릉,13281,19636,32917
202110,분당선,선릉,13116,19407,32523
202110,분당선,한티,14116,15122,29238
202110,분당선,도곡,6951,6597,13548
202110,분당선,구룡,1855,1774,3629
202110,분당선,개포동,3901,4102,8003
202110,분당선,대모산입구,4344,3986,8330
202110,분당선,수서,14173,15092,29265
202110,분당선,복정,2,0,2
202110,분당선,수원,8080,7076,15156
202110,분당선,서울숲,10899,11054,21953
202110,분당선,압구정로데오,19526,21779,41305
202110,분당선,강남구청,9841,11193,21034
202110,분당선,선정릉,7509,8239,15748
202110,분당선,가천대,8079,8700,16779
202110,분당선,태평,13397,12752,26149
202110,분당선,모란,19638,19765,39403
202110,분당선,야탑,25208,26365,51573
202110,분당선,서현,24122,24654,48776
202110,분당선,수내,13168,13040,26208
202110,분당선,정자,16925,18008,34933
202110,분당선,미금,14275,15316,29591
202110,분당선,오리,11763,9853,21616
202110,분당선,이매,5617,5200,10817
202110,분당선,보정,2504,2242,4746
202110,분당선,죽전,13586,14685,28271
202110,분당선,구성,5023,5258,10281
202110,분당선,신갈,4508,4501,9009
202110,분당선,기흥,9501,9142,18643
202110,분당선,상갈,5452,5241,10693
202110,분당선,청명,4498,4139,8637
202110,분당선,영통,8346,8321,16667
202110,분당선,망포,14628,13501,28129
202110,분당선,매탄권선,5182,4897,10079
202110,분당선,수원시청,12638,13859,26497
202110,분당선,매교,3161,3212,6373
202110,분당선,수원시청,11524,12178,23702
202110,분당선,선릉,13233,19773,33006
202110,분당선,한티,12108,13298,25406
202110,분당선,도곡,6493,6456,12949
202110,분당선,구룡,2106,2040,4146
202110,분당선,개포동,3617,3719,7336
202110,분당선,대모산입구,4220,3936,8156
202110,분당선,수서,12835,13159,25994
202110,분당선,수원,7262,6176,13438
202110,분당선,서울숲,9745,9970,19715
202110,분당선,압구정로데오,15627,17077,32704
202110,분당선,강남구청,9461,10725,20186
202110,분당선,선정릉,7961,8460,16421
202110,분당선,가천대,10078,11129,21207
202110,분당선,태평,12914,12678,25592
202110,분당선,모란,18869,18936,37805
202110,분당선,야탑,24053,25216,49269
202110,분당선,서현,21950,22196,44146
202110,분당선,수내,12007,12017,24024
202110,분당선,정자,16133,17048,33181
202110,분당선,미금,14702,15741,30443
202110,분당선,오리,11224,9491,20715
202110,분당선,이매,5468,5141,10609
202110,분당선,보정,2360,2090,4450
202110,분당선,죽전,11752,12796,24548
202110,분당선,구성,4958,5179,10137
202110,분당선,신갈,4346,4327,8673
202110,분당선,기흥,9302,8581,17883
202110,분당선,상갈,5154,4916,10070
202110,분당선,청명,4141,3978,8119
202110,분당선,영통,7648,7832,15480
202110,분당선,망포,13401,12994,26395
202110,분당선,매탄권선,4763,4647,9410
202110,분당선,매교,3036,3003,6039
202110,분당선,선릉,13266,19604,32870
202110,분당선,한티,13414,14466,27880
202110,분당선,도곡,6558,6365,12923
202110,분당선,구룡,2158,2072,4230
202110,분당선,개포동,3767,3884,7651
202110,분당선,대모산입구,4302,4016,8318
202110,분당선,수서,13140,13393,26533
202110,분당선,수원,7637,6437,14074
202110,분당선,서울숲,10035,10287,20322
202110,분당선,압구정로데오,17153,18628,35781
202110,분당선,강남구청,9760,11312,21072
202110,분당선,선정릉,7706,8346,16052
202110,분당선,가천대,10568,11579,22147
202110,분당선,태평,13416,12925,26341
202110,분당선,모란,25008,25795,50803
202110,분당선,야탑,24880,25791,50671
202110,분당선,서현,23610,24132,47742
202110,분당선,수내,12989,12864,25853
202110,분당선,정자,16424,17448,33872
202110,분당선,미금,15186,16283,31469
202110,분당선,오리,11668,9634,21302
202110,분당선,이매,5709,5306,11015
202110,분당선,보정,2453,2163,4616
202110,분당선,죽전,12993,14252,27245
202110,분당선,구성,4970,5322,10292
202110,분당선,신갈,4499,4475,8974
202110,분당선,기흥,9473,8879,18352
202110,분당선,상갈,5411,5164,10575
202110,분당선,청명,4137,4053,8190
202110,분당선,영통,7941,8104,16045
202110,분당선,망포,13817,13053,26870
202110,분당선,매탄권선,4966,4874,9840
202110,분당선,수원시청,11782,12502,24284
202110,분당선,매교,3091,3078,6169
202110,분당선,선릉,13449,20129,33578
202110,분당선,한티,13547,14597,28144
202110,분당선,도곡,6644,6576,13220
202110,분당선,구룡,1992,1953,3945
202110,분당선,개포동,3828,3991,7819
202110,분당선,대모산입구,4254,4006,8260
202110,분당선,수서,13485,13754,27239
202110,분당선,수원,7797,6795,14592
202110,분당선,서울숲,10519,10856,21375
202110,분당선,압구정로데오,17632,18955,36587
202110,분당선,강남구청,9978,11485,21463
202110,분당선,선정릉,7972,8658,16630
202110,분당선,가천대,10026,10956,20982
202110,분당선,태평,13575,13165,26740
202110,분당선,모란,21388,21268,42656
202110,분당선,야탑,25047,26497,51544
202110,분당선,서현,23844,24161,48005
202110,분당선,수내,12861,12869,25730
202110,분당선,정자,16690,17739,34429
202110,분당선,미금,15212,16275,31487
202110,분당선,오리,11819,9818,21637
202110,분당선,이매,5795,5266,11061
202110,분당선,보정,2438,2188,4626
202110,분당선,죽전,13041,14236,27277
202110,분당선,구성,5135,5488,10623
202110,분당선,신갈,4534,4555,9089
202110,분당선,기흥,9580,8955,18535
202110,분당선,상갈,5480,5345,10825
202110,분당선,청명,4293,4103,8396
202110,분당선,영통,7937,8168,16105
202110,분당선,망포,14071,13354,27425
202110,분당선,매탄권선,4937,4845,9782
202110,분당선,수원시청,12154,12845,24999
202110,분당선,매교,3085,3095,6180
202110,분당선,이매,5878,5417,11295
202110,분당선,선릉,13303,19628,32931
202110,분당선,한티,13499,14552,28051
202110,분당선,도곡,6593,6530,13123
202110,분당선,구룡,2155,2100,4255
202110,분당선,개포동,3777,3876,7653
202110,분당선,대모산입구,4291,4052,8343
202110,분당선,수서,13547,13756,27303
202110,분당선,복정,1,0,1
202110,분당선,수원,7923,6785,14708
202110,분당선,서울숲,10698,10977,21675
202110,분당선,압구정로데오,18016,19479,37495
202110,분당선,강남구청,9970,11317,21287
202110,분당선,선정릉,7871,8580,16451
202110,분당선,가천대,10380,11259,21639
202110,분당선,태평,13364,12820,26184
202110,분당선,모란,21257,21384,42641
202110,분당선,야탑,24908,26055,50963
202110,분당선,서현,23491,23995,47486
202110,분당선,수내,12683,12851,25534
202110,분당선,정자,16569,17639,34208
202110,분당선,미금,15104,16252,31356
202110,분당선,오리,11681,9789,21470
202110,분당선,매교,3063,3087,6150
202110,분당선,수원시청,12124,12874,24998
202110,분당선,매탄권선,4972,4893,9865
202110,분당선,망포,14130,13263,27393
202110,분당선,영통,8025,8262,16287
202110,분당선,청명,4313,4168,8481
202110,분당선,상갈,5425,5233,10658
202110,분당선,기흥,9786,9033,18819
202110,분당선,신갈,4429,4441,8870
202110,분당선,구성,5040,5392,10432
202110,분당선,죽전,13140,14428,27568
202110,분당선,보정,2513,2220,4733
202110,분당선,매교,3095,3168,6263
202110,분당선,수원시청,13220,14551,27771
202110,분당선,매탄권선,5178,5062,10240
202110,분당선,망포,15001,13745,28746
202110,분당선,영통,8664,8869,17533
202110,분당선,청명,4498,4151,8649
202110,분당선,상갈,5726,5462,11188
202110,분당선,기흥,9789,9308,19097
202110,분당선,신갈,4451,4459,8910
202110,분당선,구성,5148,5304,10452
202110,분당선,죽전,13942,15022,28964
202110,분당선,보정,2536,2176,4712
202110,분당선,이매,6110,5533,11643
202110,분당선,오리,11904,9807,21711
202110,분당선,미금,15562,16642,32204
202110,분당선,정자,17208,18079,35287
202110,분당선,수내,13259,13207,26466
202110,분당선,서현,24695,25530,50225
202110,분당선,야탑,25989,27068,53057
202110,분당선,모란,21914,22281,44195
202110,분당선,태평,13600,13065,26665
202110,분당선,가천대,9681,10176,19857
202110,분당선,선정릉,7750,8253,16003
202110,분당선,강남구청,9994,11530,21524
202110,분당선,압구정로데오,20086,22464,42550
202110,분당선,서울숲,11219,10353,21572
202110,분당선,수원,8591,7354,15945
202110,분당선,수서,14682,15365,30047
202110,분당선,대모산입구,4359,3998,8357
202110,분당선,개포동,3901,4098,7999
202110,분당선,구룡,2313,2075,4388
202110,분당선,도곡,6922,6652,13574
202110,분당선,한티,14116,15235,29351
202110,분당선,선릉,13057,19572,32629
202110,분당선,선릉,13286,20109,33395
202110,분당선,한티,13228,14397,27625
202110,분당선,도곡,6727,6706,13433
202110,분당선,구룡,2097,2050,4147
202110,분당선,개포동,3764,3902,7666
202110,분당선,대모산입구,4309,3976,8285
202110,분당선,수서,13185,13394,26579
202110,분당선,수원,7735,6615,14350
202110,분당선,서울숲,10331,10489,20820
202110,분당선,압구정로데오,16543,17918,34461
202110,분당선,강남구청,9605,10971,20576
202110,분당선,선정릉,8027,8635,16662
202110,분당선,가천대,9041,10151,19192
202110,분당선,태평,13377,12951,26328
202110,분당선,모란,19723,19832,39555
202110,분당선,야탑,24823,25779,50602
202110,분당선,서현,23963,24234,48197
202110,분당선,수내,12725,12692,25417
202110,분당선,정자,16454,17518,33972
202110,분당선,미금,15140,16234,31374
202110,분당선,오리,11763,9831,21594
202110,분당선,이매,5600,5316,10916
202110,분당선,보정,2487,2202,4689
202110,분당선,죽전,13067,14165,27232
202110,분당선,구성,5085,5288,10373
202110,분당선,신갈,4536,4526,9062
202110,분당선,기흥,9711,9101,18812
202110,분당선,상갈,5450,5272,10722
202110,분당선,청명,4359,4265,8624
202110,분당선,영통,8025,8291,16316
202110,분당선,망포,14007,13286,27293
202110,분당선,매탄권선,4929,4770,9699
202110,분당선,수원시청,12210,12733,24943
202110,분당선,매교,3101,3083,6184
202110,분당선,매교,3179,3239,6418
202110,분당선,수원시청,12556,13329,25885
202110,분당선,매탄권선,5050,4929,9979
202110,분당선,망포,14343,13649,27992
202110,분당선,영통,8277,8411,16688
202110,분당선,청명,4272,4273,8545
202110,분당선,상갈,5519,5248,10767
202110,분당선,기흥,9849,9098,18947
202110,분당선,신갈,4679,4631,9310
202110,분당선,구성,5340,5621,10961
202110,분당선,죽전,13329,14527,27856
202110,분당선,보정,2564,2246,4810
202110,분당선,이매,5763,5312,11075
202110,분당선,오리,11906,9910,21816
202110,분당선,미금,15559,16435,31994
202110,분당선,정자,16959,18080,35039
202110,분당선,수내,13179,13200,26379
202110,분당선,서현,24083,24551,48634
202110,분당선,야탑,25304,26433,51737
202110,분당선,모란,20079,20150,40229
202110,분당선,태평,13367,13034,26401
202110,분당선,가천대,8856,10041,18897
202110,분당선,선정릉,8123,8824,16947
202110,분당선,강남구청,10031,11509,21540
202110,분당선,압구정로데오,18043,19787,37830
202110,분당선,서울숲,10833,10385,21218
202110,분당선,수원,7888,6790,14678
202110,분당선,복정,1,0,1
202110,분당선,수서,13280,13612,26892
202110,분당선,대모산입구,4375,4048,8423
202110,분당선,개포동,3980,4107,8087
202110,분당선,구룡,2131,2065,4196
202110,분당선,도곡,6906,6697,13603
202110,분당선,한티,13723,14896,28619
202110,분당선,선릉,13839,20379,34218
202110,분당선,매교,3149,3180,6329
202110,분당선,수원시청,12428,13117,25545
202110,분당선,매탄권선,5070,4901,9971
202110,분당선,망포,14716,13883,28599
202110,분당선,영통,8197,8357,16554
202110,분당선,청명,4376,4212,8588
202110,분당선,상갈,5603,5482,11085
202110,분당선,기흥,9833,9234,19067
202110,분당선,신갈,4612,4614,9226
202110,분당선,구성,5219,5503,10722
202110,분당선,죽전,13632,14904,28536
202110,분당선,보정,2579,2323,4902
202110,분당선,이매,5898,5387,11285
202110,분당선,오리,12224,9923,22147
202110,분당선,미금,15468,16783,32251
202110,분당선,정자,17162,18221,35383
202110,분당선,수내,13085,13156,26241
202110,분당선,서현,24164,24657,48821
202110,분당선,야탑,25534,26956,52490
202110,분당선,모란,20107,20013,40120
202110,분당선,태평,13329,12941,26270
202110,분당선,가천대,9006,10076,19082
202110,분당선,선정릉,8114,8729,16843
202110,분당선,강남구청,10160,11529,21689
202110,분당선,압구정로데오,18438,19931,38369
202110,분당선,서울숲,11104,11198,22302
202110,분당선,수원,7952,6809,14761
202110,분당선,수서,13627,14153,27780
202110,분당선,대모산입구,4417,4101,8518
202110,분당선,개포동,3982,4073,8055
202110,분당선,구룡,2214,2160,4374
202110,분당선,도곡,6876,6637,13513
202110,분당선,한티,13905,14889,28794
202110,분당선,선릉,13786,20685,34471
202110,분당선,매교,3109,3231,6340
202110,분당선,수원시청,12497,13265,25762
202110,분당선,매탄권선,4964,4786,9750
202110,분당선,망포,14511,13554,28065
202110,분당선,영통,8155,8347,16502
202110,분당선,청명,4255,4088,8343
202110,분당선,상갈,5458,5346,10804
202110,분당선,기흥,9861,9207,19068
202110,분당선,신갈,4507,4481,8988
202110,분당선,구성,5149,5438,10587
202110,분당선,죽전,13577,14663,28240
202110,분당선,보정,2588,2243,4831
202110,분당선,이매,5705,5403,11108
202110,분당선,오리,12123,9973,22096
202110,분당선,미금,15524,16680,32204
202110,분당선,정자,17169,18282,35451
202110,분당선,수내,13051,13093,26144
202110,분당선,서현,23749,24283,48032
202110,분당선,야탑,25477,26644,52121
202110,분당선,모란,20273,20296,40569
202110,분당선,태평,13193,12813,26006
202110,분당선,가천대,8833,9670,18503
202110,분당선,선정릉,7940,8640,16580
202110,분당선,강남구청,9812,11285,21097
202110,분당선,압구정로데오,19085,20760,39845
202110,분당선,서울숲,11275,11292,22567
202110,분당선,수원,7948,6743,14691
202110,분당선,복정,1,0,1
202110,분당선,수서,13635,14101,27736
202110,분당선,대모산입구,4338,4069,8407
202110,분당선,개포동,3809,4024,7833
202110,분당선,구룡,2135,2056,4191
202110,분당선,도곡,6938,6732,13670
202110,분당선,한티,13642,14862,28504
202110,분당선,선릉,13394,20034,33428
202110,분당선,매탄권선,5371,5105,10476
202110,분당선,망포,15989,14542,30531
202110,분당선,영통,9301,9242,18543
202110,분당선,청명,4741,4283,9024
202110,분당선,상갈,5747,5496,11243
202110,분당선,기흥,10018,9432,19450
202110,분당선,신갈,4738,4652,9390
202110,분당선,구성,5242,5579,10821
202110,분당선,죽전,14418,15562,29980
202110,분당선,보정,2662,2391,5053
202110,분당선,이매,6043,5547,11590
202110,분당선,오리,12460,10089,22549
202110,분당선,미금,15896,17100,32996
202110,분당선,정자,17590,18775,36365
202110,분당선,수내,13473,13418,26891
202110,분당선,서현,25237,25767,51004
202110,분당선,야탑,26468,27561,54029
202110,분당선,모란,27257,28308,55565
202110,분당선,태평,14005,13555,27560
202110,분당선,가천대,8833,9300,18133
202110,분당선,선정릉,7796,8338,16134
202110,분당선,강남구청,10019,11313,21332
202110,분당선,압구정로데오,21092,23744,44836
202110,분당선,서울숲,11925,12136,24061
202110,분당선,수원,8628,7344,15972
202110,분당선,수서,15016,15628,30644
202110,분당선,대모산입구,4516,4189,8705
202110,분당선,개포동,4025,4236,8261
202110,분당선,구룡,2385,2123,4508
202110,분당선,도곡,7085,6864,13949
202110,분당선,한티,14366,15465,29831
202110,분당선,선릉,13034,19820,32854
202110,분당선,수원시청,13514,14940,28454
202110,분당선,매교,3191,3240,6431
202111,분당선,매교,3133,3160,6293
202111,분당선,수원시청,12062,12916,24978
202111,분당선,매탄권선,4987,4813,9800
202111,분당선,망포,14290,13511,27801
202111,분당선,영통,7864,8184,16048
202111,분당선,청명,4303,4067,8370
202111,분당선,상갈,5441,5142,10583
202111,분당선,기흥,9839,9173,19012
202111,분당선,신갈,4572,4478,9050
202111,분당선,구성,5167,5350,10517
202111,분당선,죽전,13056,14384,27440
202111,분당선,보정,2566,2217,4783
202111,분당선,이매,5684,5158,10842
202111,분당선,오리,11888,9965,21853
202111,분당선,미금,14936,16178,31114
202111,분당선,정자,16960,18012,34972
202111,분당선,수내,12882,12865,25747
202111,분당선,서현,23772,24150,47922
202111,분당선,야탑,25216,26139,51355
202111,분당선,모란,19701,19966,39667
202111,분당선,태평,13273,12731,26004
202111,분당선,가천대,8886,10059,18945
202111,분당선,선정릉,8052,8795,16847
202111,분당선,강남구청,9718,11125,20843
202111,분당선,압구정로데오,15852,17685,33537
202111,분당선,서울숲,11135,11400,22535
202111,분당선,수원,7965,6502,14467
202111,분당선,복정,1,0,1
202111,분당선,수서,13415,13371,26786
202111,분당선,대모산입구,4371,3960,8331
202111,분당선,개포동,3723,3869,7592
202111,분당선,구룡,2156,2120,4276
202111,분당선,도곡,6846,6844,13690
202111,분당선,한티,13351,14507,27858
202111,분당선,선릉,13347,20480,33827
202111,분당선,선릉,13888,21001,34889
202111,분당선,한티,13839,14876,28715
202111,분당선,도곡,7017,6852,13869
202111,분당선,구룡,2145,2148,4293
202111,분당선,개포동,3865,3932,7797
202111,분당선,대모산입구,4385,4108,8493
202111,분당선,수서,13365,13267,26632
202111,분당선,복정,2,0,2
202111,분당선,수원,7831,6474,14305
202111,분당선,서울숲,11603,11996,23599
202111,분당선,압구정로데오,17635,19800,37435
202111,분당선,강남구청,10153,11726,21879
202111,분당선,선정릉,8199,8747,16946
202111,분당선,가천대,9073,10032,19105
202111,분당선,태평,13588,12978,26566
202111,분당선,모란,20029,19969,39998
202111,분당선,야탑,25736,26570,52306
202111,분당선,서현,23960,24646,48606
202111,분당선,수내,13413,13342,26755
202111,분당선,정자,17404,18614,36018
202111,분당선,미금,15575,16661,32236
202111,분당선,오리,12177,10083,22260
202111,분당선,이매,5868,5493,11361
202111,분당선,보정,2659,2349,5008
202111,분당선,죽전,13490,14910,28400
202111,분당선,구성,5180,5515,10695
202111,분당선,신갈,4710,4656,9366
202111,분당선,기흥,10031,9272,19303
202111,분당선,상갈,5577,5271,10848
202111,분당선,청명,4518,4241,8759
202111,분당선,영통,8113,8420,16533
202111,분당선,망포,14688,13744,28432
202111,분당선,매탄권선,5171,5057,10228
202111,분당선,수원시청,12310,13386,25696
202111,분당선,매교,3144,3170,6314
202111,분당선,수서,13399,13832,27231
202111,분당선,대모산입구,4523,4118,8641
202111,분당선,개포동,3903,4049,7952
202111,분당선,구룡,2206,2092,4298
202111,분당선,도곡,7195,6977,14172
202111,분당선,한티,14112,15015,29127
202111,분당선,선릉,13774,20920,34694
202111,분당선,복정,1,0,1
202111,분당선,수원,8172,6615,14787
202111,분당선,서울숲,11895,12246,24141
202111,분당선,압구정로데오,17915,20273,38188
202111,분당선,강남구청,10289,11639,21928
202111,분당선,선정릉,8182,8902,17084
202111,분당선,가천대,9372,10370,19742
202111,분당선,태평,13739,13041,26780
202111,분당선,모란,19993,20414,40407
202111,분당선,야탑,26780,28045,54825
202111,분당선,서현,24299,24781,49080
202111,분당선,수내,13459,13516,26975
202111,분당선,정자,17881,19072,36953
202111,분당선,매교,3256,3342,6598
202111,분당선,수원시청,12760,13771,26531
202111,분당선,매탄권선,5234,5066,10300
202111,분당선,망포,14923,13922,28845
202111,분당선,영통,8477,8624,17101
202111,분당선,청명,4540,4311,8851
202111,분당선,상갈,5627,5436,11063
202111,분당선,기흥,10062,9453,19515
202111,분당선,신갈,4651,4636,9287
202111,분당선,구성,5330,5547,10877
202111,분당선,죽전,13685,14849,28534
202111,분당선,보정,2692,2394,5086
202111,분당선,이매,5913,5421,11334
202111,분당선,오리,12355,10390,22745
202111,분당선,미금,16028,17326,33354
202111,분당선,매교,3027,3049,6076
202111,분당선,수원시청,12298,13417,25715
202111,분당선,매탄권선,5172,4943,10115
202111,분당선,망포,14820,13796,28616
202111,분당선,영통,8351,8469,16820
202111,분당선,청명,4501,4263,8764
202111,분당선,상갈,5627,5291,10918
202111,분당선,기흥,10059,9411,19470
202111,분당선,신갈,4673,4646,9319
202111,분당선,구성,5325,5467,10792
202111,분당선,죽전,13859,15125,28984
202111,분당선,보정,2690,2319,5009
202111,분당선,이매,5904,5522,11426
202111,분당선,오리,12538,10398,22936
202111,분당선,미금,15671,16740,32411
202111,분당선,정자,17559,18830,36389
202111,분당선,수내,13289,13407,26696
202111,분당선,서현,24188,24895,49083
202111,분당선,야탑,26753,27666,54419
202111,분당선,모란,26324,27197,53521
202111,분당선,태평,13733,13211,26944
202111,분당선,가천대,9106,9815,18921
202111,분당선,선정릉,8063,8769,16832
202111,분당선,강남구청,10113,11659,21772
202111,분당선,압구정로데오,17948,20133,38081
202111,분당선,서울숲,11825,12136,23961
202111,분당선,수원,8036,6683,14719
202111,분당선,복정,1,0,1
202111,분당선,수서,13982,14562,28544
202111,분당선,대모산입구,4603,4187,8790
202111,분당선,개포동,3824,3965,7789
202111,분당선,구룡,2288,2198,4486
202111,분당선,도곡,7102,6889,13991
202111,분당선,한티,14050,14800,28850
202111,분당선,선릉,13616,20744,34360
202111,분당선,매교,3175,3235,6410
202111,분당선,수원시청,13483,16046,29529
202111,분당선,매탄권선,5558,5092,10650
202111,분당선,망포,16187,14484,30671
202111,분당선,영통,9165,9403,18568
202111,분당선,청명,4936,4397,9333
202111,분당선,상갈,5886,5511,11397
202111,분당선,기흥,10375,9764,20139
202111,분당선,신갈,4789,4770,9559
202111,분당선,구성,5492,5564,11056
202111,분당선,죽전,14755,15621,30376
202111,분당선,보정,2766,2336,5102
202111,분당선,이매,5974,5617,11591
202111,분당선,오리,12892,10636,23528
202111,분당선,미금,16112,17127,33239
202111,분당선,정자,18211,19359,37570
202111,분당선,수내,13586,13554,27140
202111,분당선,서현,25774,26760,52534
202111,분당선,야탑,27383,28567,55950
202111,분당선,모란,20956,21295,42251
202111,분당선,태평,14103,13252,27355
202111,분당선,가천대,8863,9276,18139
202111,분당선,선정릉,7920,8661,16581
202111,분당선,강남구청,10422,11906,22328
202111,분당선,압구정로데오,19982,23903,43885
202111,분당선,서울숲,12976,13327,26303
202111,분당선,수원,9013,7882,16895
202111,분당선,복정,2,0,2
202111,분당선,수서,14931,15753,30684
202111,분당선,대모산입구,4585,4105,8690
202111,분당선,개포동,3831,4005,7836
202111,분당선,구룡,2382,2219,4601
202111,분당선,도곡,7488,7168,14656
202111,분당선,한티,14664,15613,30277
202111,분당선,선릉,13342,20462,33804
202111,분당선,선릉,13491,20526,34017
202111,분당선,한티,12466,13536,26002
202111,분당선,도곡,6714,6663,13377
202111,분당선,구룡,1983,1963,3946
202111,분당선,개포동,3611,3663,7274
202111,분당선,대모산입구,4340,3931,8271
202111,분당선,수서,13160,13245,26405
202111,분당선,수원,7271,6265,13536
202111,분당선,서울숲,9804,9929,19733
202111,분당선,압구정로데오,15672,17484,33156
202111,분당선,강남구청,9610,10947,20557
202111,분당선,선정릉,8122,8748,16870
202111,분당선,가천대,8595,9824,18419
202111,분당선,태평,12964,12323,25287
202111,분당선,모란,18103,18226,36329
202111,분당선,야탑,24272,25251,49523
202111,분당선,서현,22848,23067,45915
202111,분당선,수내,11940,11989,23929
202111,분당선,정자,16507,17549,34056
202111,분당선,미금,14320,15237,29557
202111,분당선,오리,11277,9474,20751
202111,분당선,이매,5459,5048,10507
202111,분당선,보정,2489,2178,4667
202111,분당선,죽전,12226,13775,26001
202111,분당선,구성,4834,5075,9909
202111,분당선,신갈,4459,4325,8784
202111,분당선,기흥,9469,8746,18215
202111,분당선,상갈,5127,4890,10017
202111,분당선,청명,4176,4021,8197
202111,분당선,영통,7601,7927,15528
202111,분당선,망포,13656,12920,26576
202111,분당선,매탄권선,4798,4631,9429
202111,분당선,수원시청,11493,12233,23726
202111,분당선,매교,2725,2736,5461
202111,분당선,복정,1,0,1
202111,분당선,선릉,13987,20972,34959
202111,분당선,한티,13737,15060,28797
202111,분당선,도곡,6914,6780,13694
202111,분당선,구룡,2059,2016,4075
202111,분당선,개포동,3692,3838,7530
202111,분당선,대모산입구,4528,4151,8679
202111,분당선,수서,13585,13759,27344
202111,분당선,수원,7480,6169,13649
202111,분당선,서울숲,10403,10733,21136
202111,분당선,압구정로데오,17503,19881,37384
202111,분당선,강남구청,10287,11771,22058
202111,분당선,선정릉,8304,8976,17280
202111,분당선,가천대,8947,9950,18897
202111,분당선,태평,13480,12818,26298
202111,분당선,모란,22219,22924,45143
202111,분당선,야탑,25398,26348,51746
202111,분당선,서현,23473,23908,47381
202111,분당선,수내,13178,13081,26259
202111,분당선,정자,17570,18456,36026
202111,분당선,미금,15122,16196,31318
202111,분당선,오리,11875,9786,21661
202111,분당선,이매,5759,5356,11115
202111,분당선,보정,2610,2249,4859
202111,분당선,죽전,13153,14582,27735
202111,분당선,구성,5089,5352,10441
202111,분당선,신갈,4635,4526,9161
202111,분당선,기흥,9927,9276,19203
202111,분당선,상갈,5442,5181,10623
202111,분당선,청명,4310,4043,8353
202111,분당선,영통,8039,8171,16210
202111,분당선,망포,14189,13273,27462
202111,분당선,매탄권선,4800,4667,9467
202111,분당선,수원시청,12077,13003,25080
202111,분당선,매교,2857,2964,5821
202111,분당선,선릉,14131,21190,35321
202111,분당선,한티,14113,15198,29311
202111,분당선,도곡,7146,6922,14068
202111,분당선,구룡,2293,2157,4450
202111,분당선,개포동,3885,4007,7892
202111,분당선,대모산입구,4540,4184,8724
202111,분당선,수서,14066,14409,28475
202111,분당선,복정,1,0,1
202111,분당선,수원,8030,6719,14749
202111,분당선,서울숲,11312,11658,22970
202111,분당선,압구정로데오,18419,20737,39156
202111,분당선,강남구청,10533,12018,22551
202111,분당선,선정릉,8371,9027,17398
202111,분당선,가천대,9059,10021,19080
202111,분당선,태평,13756,13076,26832
202111,분당선,모란,20087,20246,40333
202111,분당선,야탑,26611,27823,54434
202111,분당선,서현,24341,25150,49491
202111,분당선,수내,13487,13499,26986
202111,분당선,정자,17975,19110,37085
202111,분당선,미금,15720,16634,32354
202111,분당선,오리,12467,10398,22865
202111,분당선,이매,5849,5530,11379
202111,분당선,보정,2660,2312,4972
202111,분당선,죽전,13680,15034,28714
202111,분당선,구성,5296,5620,10916
202111,분당선,신갈,4707,4725,9432
202111,분당선,기흥,9968,9468,19436
202111,분당선,상갈,5605,5375,10980
202111,분당선,청명,4406,4246,8652
202111,분당선,영통,8428,8545,16973
202111,분당선,망포,14724,13891,28615
202111,분당선,매탄권선,5048,4905,9953
202111,분당선,수원시청,12658,13751,26409
202111,분당선,매교,3016,3030,6046
202111,분당선,선릉,13915,20869,34784
202111,분당선,한티,14154,15113,29267
202111,분당선,도곡,7253,6893,14146
202111,분당선,구룡,2050,1952,4002
202111,분당선,개포동,3751,3839,7590
202111,분당선,대모산입구,4475,4222,8697
202111,분당선,수서,13963,14510,28473
202111,분당선,수원,8223,7106,15329
202111,분당선,서울숲,11558,11931,23489
202111,분당선,압구정로데오,18947,21315,40262
202111,분당선,강남구청,10322,11915,22237
202111,분당선,선정릉,8442,8990,17432
202111,분당선,가천대,9007,9964,18971
202111,분당선,태평,13697,13078,26775
202111,분당선,모란,20181,20439,40620
202111,분당선,야탑,26602,27461,54063
202111,분당선,서현,24420,25087,49507
202111,분당선,수내,13574,13494,27068
202111,분당선,정자,17716,19000,36716
202111,분당선,미금,15430,16422,31852
202111,분당선,오리,12230,10134,22364
202111,분당선,이매,5568,5369,10937
202111,분당선,보정,2583,2305,4888
202111,분당선,죽전,13951,15219,29170
202111,분당선,구성,5345,5513,10858
202111,분당선,신갈,4660,4570,9230
202111,분당선,기흥,10120,9432,19552
202111,분당선,상갈,5642,5292,10934
202111,분당선,청명,4337,4029,8366
202111,분당선,영통,8373,8572,16945
202111,분당선,망포,14784,13743,28527
202111,분당선,매탄권선,4963,4694,9657
202111,분당선,수원시청,12529,13621,26150
202111,분당선,매교,2704,2794,5498
202111,분당선,매탄권선,5334,5045,10379
202111,분당선,선릉,13603,20678,34281
202111,분당선,한티,14613,15449,30062
202111,분당선,도곡,7339,6360,13699
202111,분당선,구룡,2057,1941,3998
202111,분당선,개포동,3895,4085,7980
202111,분당선,대모산입구,4545,4147,8692
202111,분당선,수서,15050,15960,31010
202111,분당선,복정,1,0,1
202111,분당선,수원,8914,8050,16964
202111,분당선,서울숲,11975,12461,24436
202111,분당선,압구정로데오,20728,24265,44993
202111,분당선,강남구청,10762,12200,22962
202111,분당선,선정릉,8238,8849,17087
202111,분당선,가천대,8420,8856,17276
202111,분당선,태평,13968,13207,27175
202111,분당선,모란,20621,21103,41724
202111,분당선,야탑,27233,28290,55523
202111,분당선,서현,25887,26961,52848
202111,분당선,수내,13645,13685,27330
202111,분당선,정자,17995,19223,37218
202111,분당선,미금,15882,16809,32691
202111,분당선,오리,12682,10422,23104
202111,분당선,이매,5740,5531,11271
202111,분당선,보정,2585,2282,4867
202111,분당선,죽전,14594,15657,30251
202111,분당선,구성,5410,5519,10929
202111,분당선,신갈,4843,4726,9569
202111,분당선,기흥,10307,9674,19981
202111,분당선,상갈,5856,5532,11388
202111,분당선,청명,4701,4185,8886
202111,분당선,영통,9301,9267,18568
202111,분당선,망포,15890,14380,30270
202111,분당선,수원시청,13412,16029,29441
202111,분당선,매교,2798,2842,5640
202111,분당선,선릉,13651,20888,34539
202111,분당선,한티,13344,14600,27944
202111,분당선,도곡,6792,5993,12785
202111,분당선,구룡,2077,2011,4088
202111,분당선,개포동,3918,4068,7986
202111,분당선,대모산입구,4550,4183,8733
202111,분당선,수서,13794,13855,27649
202111,분당선,수원,7754,6754,14508
202111,분당선,서울숲,10842,11248,22090
202111,분당선,압구정로데오,16797,18678,35475
202111,분당선,강남구청,10035,11441,21476
202111,분당선,선정릉,8095,8740,16835
202111,분당선,가천대,9235,10279,19514
202111,분당선,태평,13471,12969,26440
202111,분당선,모란,19598,19962,39560
202111,분당선,야탑,25537,26561,52098
202111,분당선,서현,24148,24362,48510
202111,분당선,수내,13038,12983,26021
202111,분당선,정자,17097,18216,35313
202111,분당선,미금,14947,16152,31099
202111,분당선,오리,12074,9922,21996
202111,분당선,이매,5459,5228,10687
202111,분당선,보정,2501,2203,4704
202111,분당선,죽전,12389,13587,25976
202111,분당선,구성,5194,5353,10547
202111,분당선,신갈,4599,4525,9124
202111,분당선,기흥,9836,9055,18891
202111,분당선,상갈,5483,5260,10743
202111,분당선,청명,4199,4043,8242
202111,분당선,영통,7951,8163,16114
202111,분당선,망포,14439,13590,28029
202111,분당선,매탄권선,4908,4659,9567
202111,분당선,수원시청,12444,13137,25581
202111,분당선,매교,2731,2753,5484
202111,분당선,오리,12197,10047,22244
202111,분당선,미금,15229,16386,31615
202111,분당선,정자,17758,18963,36721
202111,분당선,수내,13345,13393,26738
202111,분당선,서현,23868,24475,48343
202111,분당선,야탑,26043,26972,53015
202111,분당선,모란,20267,20267,40534
202111,분당선,태평,13660,12952,26612
202111,분당선,가천대,9589,10574,20163
202111,분당선,선정릉,8319,9045,17364
202111,분당선,강남구청,10536,12123,22659
202111,분당선,압구정로데오,18272,20547,38819
202111,분당선,서울숲,11437,11822,23259
202111,분당선,수원,8022,6925,14947
202111,분당선,수서,13971,14245,28216
202111,분당선,대모산입구,4492,4144,8636
202111,분당선,개포동,3878,3994,7872
202111,분당선,구룡,2069,1998,4067
202111,분당선,도곡,6942,6015,12957
202111,분당선,한티,13688,14545,28233
202111,분당선,선릉,14187,21434,35621
202111,분당선,매교,2729,2770,5499
202111,분당선,수원시청,12825,13864,26689
202111,분당선,매탄권선,4977,4799,9776
202111,분당선,망포,14759,13978,28737
202111,분당선,영통,8296,8495,16791
202111,분당선,청명,4370,4147,8517
202111,분당선,상갈,5571,5388,10959
202111,분당선,기흥,10064,9473,19537
202111,분당선,신갈,4693,4607,9300
202111,분당선,구성,5365,5456,10821
202111,분당선,죽전,13661,15158,28819
202111,분당선,보정,2470,2151,4621
202111,분당선,이매,5723,5423,11146
202111,분당선,매교,3060,3013,6073
202111,분당선,수원시청,12913,13935,26848
202111,분당선,매탄권선,5246,4943,10189
202111,분당선,망포,15091,14342,29433
202111,분당선,영통,8570,8560,17130
202111,분당선,청명,4461,4186,8647
202111,분당선,상갈,5730,5466,11196
202111,분당선,기흥,10101,9484,19585
202111,분당선,신갈,4677,4664,9341
202111,분당선,구성,5352,5697,11049
202111,분당선,죽전,13989,15298,29287
202111,분당선,보정,2652,2341,4993
202111,분당선,이매,5759,5510,11269
202111,분당선,오리,12531,10255,22786
202111,분당선,미금,15615,16802,32417
202111,분당선,정자,17928,19257,37185
202111,분당선,수내,13694,13652,27346
202111,분당선,서현,24910,25373,50283
202111,분당선,야탑,26680,27930,54610
202111,분당선,모란,20135,20334,40469
202111,분당선,태평,13719,12984,26703
202111,분당선,가천대,9602,10527,20129
202111,분당선,선정릉,8703,9363,18066
202111,분당선,강남구청,10598,12024,22622
202111,분당선,압구정로데오,18239,20500,38739
202111,분당선,서울숲,11691,11888,23579
202111,분당선,수원,8254,6959,15213
202111,분당선,수서,13899,14308,28207
202111,분당선,대모산입구,4493,4195,8688
202111,분당선,개포동,4000,4076,8076
202111,분당선,구룡,2231,2060,4291
202111,분당선,도곡,7099,6187,13286
202111,분당선,한티,13664,14773,28437
202111,분당선,선릉,13896,21262,35158
202111,분당선,매교,2919,2790,5709
202111,분당선,수원시청,12800,13656,26456
202111,분당선,매탄권선,5313,5004,10317
202111,분당선,망포,15008,14185,29193
202111,분당선,영통,8737,8809,17546
202111,분당선,청명,4421,4201,8622
202111,분당선,상갈,5615,5324,10939
202111,분당선,기흥,10223,9377,19600
202111,분당선,신갈,4731,4604,9335
202111,분당선,구성,5342,5462,10804
202111,분당선,죽전,14005,15161,29166
202111,분당선,보정,2561,2305,4866
202111,분당선,이매,5635,5376,11011
202111,분당선,오리,12167,10127,22294
202111,분당선,미금,15113,16360,31473
202111,분당선,정자,17578,18863,36441
202111,분당선,수내,13194,13279,26473
202111,분당선,서현,24662,25282,49944
202111,분당선,야탑,26349,27168,53517
202111,분당선,모란,19910,19966,39876
202111,분당선,태평,13562,12822,26384
202111,분당선,가천대,9146,10004,19150
202111,분당선,선정릉,8166,8844,17010
202111,분당선,강남구청,10705,12310,23015
202111,분당선,압구정로데오,19013,21511,40524
202111,분당선,서울숲,11063,11402,22465
202111,분당선,수원,8146,7099,15245
202111,분당선,복정,1,0,1
202111,분당선,수서,13709,14414,28123
202111,분당선,대모산입구,4470,4008,8478
202111,분당선,개포동,3592,3748,7340
202111,분당선,구룡,1966,1871,3837
202111,분당선,도곡,7170,6059,13229
202111,분당선,한티,13677,14678,28355
202111,분당선,선릉,13827,21042,34869
202111,분당선,선릉,13690,21035,34725
202111,분당선,한티,15773,16694,32467
202111,분당선,도곡,7203,6207,13410
202111,분당선,구룡,1992,1833,3825
202111,분당선,개포동,3909,4103,8012
202111,분당선,대모산입구,4596,4135,8731
202111,분당선,수서,15297,16089,31386
202111,분당선,복정,2,0,2
202111,분당선,수원,9011,8074,17085
202111,분당선,서울숲,11974,12134,24108
202111,분당선,압구정로데오,20781,24951,45732
202111,분당선,강남구청,10510,12044,22554
202111,분당선,선정릉,8087,8741,16828
202111,분당선,가천대,9273,9605,18878
202111,분당선,태평,14428,13642,28070
202111,분당선,모란,25907,27087,52994
202111,분당선,야탑,27496,28388,55884
202111,분당선,서현,26390,27177,53567
202111,분당선,수내,13766,13717,27483
202111,분당선,정자,18689,19786,38475
202111,분당선,미금,16269,17184,33453
202111,분당선,오리,12726,10341,23067
202111,분당선,이매,5947,5657,11604
202111,분당선,보정,2486,2238,4724
202111,분당선,죽전,14751,15825,30576
202111,분당선,구성,5483,5617,11100
202111,분당선,신갈,4757,4519,9276
202111,분당선,기흥,10459,9703,20162
202111,분당선,상갈,5984,5528,11512
202111,분당선,청명,4646,4289,8935
202111,분당선,영통,9344,9468,18812
202111,분당선,망포,16171,14509,30680
202111,분당선,매탄권선,5499,4984,10483
202111,분당선,수원시청,13766,16285,30051
202111,분당선,매교,2910,2965,5875
202111,분당선,선릉,14029,21289,35318
202111,분당선,한티,15101,16429,31530
202111,분당선,도곡,6893,6249,13142
202111,분당선,구룡,2187,2108,4295
202111,분당선,개포동,3957,4067,8024
202111,분당선,대모산입구,4512,4108,8620
202111,분당선,수서,13881,14091,27972
202111,분당선,수원,7851,6615,14466
202111,분당선,서울숲,10278,10618,20896
202111,분당선,압구정로데오,17076,18875,35951
202111,분당선,강남구청,10360,11833,22193
202111,분당선,선정릉,8269,8971,17240
202111,분당선,가천대,9333,10334,19667
202111,분당선,태평,13495,12952,26447
202111,분당선,모란,19401,19520,38921
202111,분당선,야탑,25573,26678,52251
202111,분당선,서현,24451,24877,49328
202111,분당선,수내,13124,13143,26267
202111,분당선,정자,17322,18636,35958
202111,분당선,미금,15409,16457,31866
202111,분당선,오리,11949,9945,21894
202111,분당선,이매,5860,5290,11150
202111,분당선,보정,2607,2258,4865
202111,분당선,죽전,12932,14479,27411
202111,분당선,구성,5016,5311,10327
202111,분당선,신갈,4657,4615,9272
202111,분당선,기흥,10039,9335,19374
202111,분당선,상갈,5460,5283,10743
202111,분당선,청명,4416,4241,8657
202111,분당선,영통,8369,8635,17004
202111,분당선,망포,14480,13803,28283
202111,분당선,매탄권선,5157,5044,10201
202111,분당선,수원시청,12578,13309,25887
202111,분당선,매교,3175,3148,6323
202111,분당선,매교,3121,3148,6269
202111,분당선,수원시청,12606,13690,26296
202111,분당선,매탄권선,5172,5044,10216
202111,분당선,망포,14736,13917,28653
202111,분당선,영통,8722,7262,15984
202111,분당선,청명,4483,4288,8771
202111,분당선,상갈,5562,5430,10992
202111,분당선,기흥,10087,9431,19518
202111,분당선,신갈,4670,4608,9278
202111,분당선,구성,5214,5408,10622
202111,분당선,죽전,13466,14813,28279
202111,분당선,보정,2645,2274,4919
202111,분당선,이매,5972,5427,11399
202111,분당선,오리,12145,9977,22122
202111,분당선,미금,15660,16768,32428
202111,분당선,정자,17969,19204,37173
202111,분당선,수내,13493,13523,27016
202111,분당선,서현,24191,24977,49168
202111,분당선,야탑,25943,26977,52920
202111,분당선,모란,19636,19749,39385
202111,분당선,태평,13486,12926,26412
202111,분당선,가천대,9175,10209,19384
202111,분당선,선정릉,8504,9086,17590
202111,분당선,강남구청,10704,12122,22826
202111,분당선,압구정로데오,18442,20392,38834
202111,분당선,서울숲,10828,11012,21840
202111,분당선,수원,7784,6671,14455
202111,분당선,복정,1,0,1
202111,분당선,수서,13679,14025,27704
202111,분당선,대모산입구,4464,4115,8579
202111,분당선,개포동,4097,4189,8286
202111,분당선,구룡,2190,2070,4260
202111,분당선,도곡,7134,6370,13504
202111,분당선,한티,15358,16732,32090
202111,분당선,선릉,14440,21850,36290
202111,분당선,매교,3136,3217,6353
202111,분당선,수원시청,12661,13779,26440
202111,분당선,매탄권선,5217,4980,10197
202111,분당선,망포,14937,14248,29185
202111,분당선,영통,8833,8817,17650
202111,분당선,청명,4465,4231,8696
202111,분당선,상갈,5666,5485,11151
202111,분당선,기흥,10313,9506,19819
202111,분당선,신갈,4747,4684,9431
202111,분당선,구성,5336,5491,10827
202111,분당선,죽전,13646,15259,28905
202111,분당선,보정,2693,2325,5018
202111,분당선,이매,5958,5548,11506
202111,분당선,오리,12197,10109,22306
202111,분당선,미금,15872,17009,32881
202111,분당선,정자,18138,19473,37611
202111,분당선,수내,13681,13812,27493
202111,분당선,서현,24957,25660,50617
202111,분당선,야탑,26892,27794,54686
202111,분당선,모란,24282,24926,49208
202111,분당선,태평,13831,13167,26998
202111,분당선,가천대,8040,9056,17096
202111,분당선,선정릉,8362,9104,17466
202111,분당선,강남구청,10595,12222,22817
202111,분당선,압구정로데오,17944,20221,38165
202111,분당선,서울숲,10937,11178,22115
202111,분당선,수원,8013,6828,14841
202111,분당선,수서,14042,14366,28408
202111,분당선,대모산입구,4649,4226,8875
202111,분당선,개포동,4127,4214,8341
202111,분당선,구룡,2212,2105,4317
202111,분당선,도곡,7100,6989,14089
202111,분당선,한티,15233,16503,31736
202111,분당선,선릉,14299,21649,35948
202111,분당선,선릉,14436,21899,36335
202111,분당선,한티,15396,16522,31918
202111,분당선,도곡,7135,7019,14154
202111,분당선,구룡,2222,2144,4366
202111,분당선,개포동,3907,4043,7950
202111,분당선,대모산입구,4667,4273,8940
202111,분당선,수서,14570,15087,29657
202111,분당선,수원,8191,7135,15326
202111,분당선,서울숲,11009,11526,22535
202111,분당선,압구정로데오,18775,21134,39909
202111,분당선,강남구청,10685,12477,23162
202111,분당선,선정릉,8423,8957,17380
202111,분당선,가천대,13184,13339,26523
202111,분당선,태평,13714,13149,26863
202111,분당선,모란,20342,20496,40838
202111,분당선,야탑,26875,28069,54944
202111,분당선,서현,24943,25844,50787
202111,분당선,수내,13818,13912,27730
202111,분당선,정자,18060,19446,37506
202111,분당선,미금,15918,16966,32884
202111,분당선,오리,12465,10324,22789
202111,분당선,이매,6141,5618,11759
202111,분당선,보정,2770,2414,5184
202111,분당선,죽전,13920,15198,29118
202111,분당선,구성,5206,5574,10780
202111,분당선,신갈,4784,4663,9447
202111,분당선,기흥,10578,9834,20412
202111,분당선,상갈,5765,5680,11445
202111,분당선,청명,4563,4356,8919
202111,분당선,영통,8994,9099,18093
202111,분당선,망포,15180,14206,29386
202111,분당선,매탄권선,5275,5010,10285
202111,분당선,수원시청,13114,14108,27222
202111,분당선,매교,3252,3272,6524
202111,분당선,복정,2,0,2
202111,분당선,선릉,13724,21337,35061
202111,분당선,한티,15871,16865,32736
202111,분당선,도곡,7440,7270,14710
202111,분당선,구룡,2488,2294,4782
202111,분당선,개포동,4173,4260,8433
202111,분당선,대모산입구,4595,4164,8759
202111,분당선,수서,15395,16126,31521
202111,분당선,복정,1,0,1
202111,분당선,수원,9027,7909,16936
202111,분당선,서울숲,11336,11692,23028
202111,분당선,압구정로데오,20548,24667,45215
202111,분당선,강남구청,10825,12428,23253
202111,분당선,선정릉,8234,8833,17067
202111,분당선,가천대,13681,13143,26824
202111,분당선,태평,14290,12879,27169
202111,분당선,모란,21055,21181,42236
202111,분당선,야탑,27743,29334,57077
202111,분당선,서현,26682,27449,54131
202111,분당선,수내,13888,13862,27750
202111,분당선,정자,18712,20084,38796
202111,분당선,미금,16365,17163,33528
202111,분당선,오리,12641,10425,23066
202111,분당선,이매,6145,5669,11814
202111,분당선,보정,2923,2448,5371
202111,분당선,죽전,14529,15791,30320
202111,분당선,구성,5191,5519,10710
202111,분당선,신갈,4817,4727,9544
202111,분당선,기흥,10439,9652,20091
202111,분당선,상갈,6072,5653,11725
202111,분당선,청명,4792,4400,9192
202111,분당선,영통,9669,9736,19405
202111,분당선,망포,16366,14872,31238
202111,분당선,매탄권선,5700,5169,10869
202111,분당선,수원시청,13789,16440,30229
202111,분당선,매교,3317,3380,6697
202111,분당선,선릉,14169,21445,35614
202111,분당선,한티,13925,15124,29049
202111,분당선,도곡,7112,7291,14403
202111,분당선,구룡,2204,2123,4327
202111,분당선,개포동,3840,4032,7872
202111,분당선,대모산입구,4610,4231,8841
202111,분당선,수서,14020,14256,28276
202111,분당선,수원,8002,6856,14858
202111,분당선,서울숲,10389,10699,21088
202111,분당선,압구정로데오,16887,18762,35649
202111,분당선,강남구청,10255,11549,21804
202111,분당선,선정릉,8095,8785,16880
202111,분당선,가천대,8891,10056,18947
202111,분당선,태평,13682,13147,26829
202111,분당선,모란,24646,25333,49979
202111,분당선,야탑,26110,27009,53119
202111,분당선,서현,24895,25118,50013
202111,분당선,수내,13174,13094,26268
202111,분당선,정자,17508,18565,36073
202111,분당선,미금,15776,16731,32507
202111,분당선,오리,12233,10146,22379
202111,분당선,이매,5932,5482,11414
202111,분당선,보정,2559,2289,4848
202111,분당선,죽전,13350,14800,28150
202111,분당선,구성,5180,5422,10602
202111,분당선,신갈,4661,4667,9328
202111,분당선,기흥,10048,9266,19314
202111,분당선,상갈,5671,5364,11035
202111,분당선,청명,4392,4324,8716
202111,분당선,영통,8431,8711,17142
202111,분당선,망포,14709,13928,28637
202111,분당선,매탄권선,5187,4904,10091
202111,분당선,수원시청,12581,13410,25991
202111,분당선,매교,3316,3217,6533
202111,분당선,선릉,14025,21550,35575
202111,분당선,한티,13754,14997,28751
202111,분당선,도곡,6717,6951,13668
202111,분당선,구룡,2014,2015,4029
202111,분당선,개포동,3767,3862,7629
202111,분당선,대모산입구,4346,4025,8371
202111,분당선,수서,13181,13520,26701
202111,분당선,복정,1,0,1
202111,분당선,수원,7238,6194,13432
202111,분당선,서울숲,9896,10268,20164
202111,분당선,압구정로데오,17361,19496,36857
202111,분당선,강남구청,10272,11740,22012
202111,분당선,선정릉,8334,9010,17344
202111,분당선,가천대,8587,9562,18149
202111,분당선,태평,12902,12185,25087
202111,분당선,모란,18244,18425,36669
202111,분당선,야탑,24911,25991,50902
202111,분당선,서현,23253,23876,47129
202111,분당선,수내,12815,12909,25724
202111,분당선,정자,17390,18419,35809
202111,분당선,미금,14762,15613,30375
202111,분당선,오리,11330,9330,20660
202111,분당선,이매,5549,5087,10636
202111,분당선,보정,2523,2158,4681
202111,분당선,죽전,12458,13893,26351
202111,분당선,구성,4941,5242,10183
202111,분당선,신갈,4499,4373,8872
202111,분당선,기흥,9609,9007,18616
202111,분당선,상갈,5383,5065,10448
202111,분당선,청명,4203,4086,8289
202111,분당선,영통,8190,8228,16418
202111,분당선,망포,14344,13292,27636
202111,분당선,매탄권선,4993,4790,9783
202111,분당선,수원시청,11860,12793,24653
202111,분당선,매교,3008,2712,5720
202112,분당선,도곡,6798,7055,13853
202112,분당선,한티,14208,15352,29560
202112,분당선,선릉,14350,21496,35846
202112,분당선,매탄권선,5045,4952,9997
202112,분당선,수원시청,12397,13328,25725
202112,분당선,매교,3128,2694,5822
202112,분당선,망포,14561,13737,28298
202112,분당선,영통,8480,8685,17165
202112,분당선,청명,4429,4282,8711
202112,분당선,상갈,5430,5177,10607
202112,분당선,기흥,9858,9251,19109
202112,분당선,신갈,4729,4614,9343
202112,분당선,구성,5064,5355,10419
202112,분당선,죽전,13256,14648,27904
202112,분당선,보정,2614,2262,4876
202112,분당선,이매,5756,5313,11069
202112,분당선,오리,12030,9839,21869
202112,분당선,미금,15707,16579,32286
202112,분당선,정자,17707,19003,36710
202112,분당선,수내,13334,13557,26891
202112,분당선,서현,24394,25083,49477
202112,분당선,야탑,26387,27648,54035
202112,분당선,모란,19356,19410,38766
202112,분당선,태평,13477,12800,26277
202112,분당선,가천대,8955,10005,18960
202112,분당선,선정릉,8480,9095,17575
202112,분당선,강남구청,10500,12163,22663
202112,분당선,압구정로데오,18111,20109,38220
202112,분당선,서울숲,10612,10790,21402
202112,분당선,수원,7886,6646,14532
202112,분당선,복정,1,0,1
202112,분당선,수서,13399,13817,27216
202112,분당선,대모산입구,4436,4130,8566
202112,분당선,개포동,4062,4254,8316
202112,분당선,구룡,2139,2073,4212
202112,분당선,매교,3119,2958,6077
202112,분당선,수원시청,12261,13274,25535
202112,분당선,매탄권선,5013,4897,9910
202112,분당선,망포,14617,13555,28172
202112,분당선,영통,8468,8592,17060
202112,분당선,청명,4347,4142,8489
202112,분당선,상갈,5448,5251,10699
202112,분당선,기흥,9873,9324,19197
202112,분당선,신갈,4624,4545,9169
202112,분당선,구성,5031,5300,10331
202112,분당선,죽전,13251,14610,27861
202112,분당선,보정,2608,2198,4806
202112,분당선,이매,5586,5308,10894
202112,분당선,오리,12033,9932,21965
202112,분당선,미금,15333,16244,31577
202112,분당선,정자,17638,18887,36525
202112,분당선,수내,13304,13443,26747
202112,분당선,서현,23913,24370,48283
202112,분당선,야탑,25812,26865,52677
202112,분당선,모란,19439,19491,38930
202112,분당선,태평,13426,12752,26178
202112,분당선,가천대,8618,9439,18057
202112,분당선,선정릉,8276,8959,17235
202112,분당선,강남구청,10568,12240,22808
202112,분당선,압구정로데오,17965,20453,38418
202112,분당선,서울숲,10461,10799,21260
202112,분당선,수원,7858,6802,14660
202112,분당선,수서,13563,14081,27644
202112,분당선,대모산입구,4553,4215,8768
202112,분당선,개포동,3824,3996,7820
202112,분당선,구룡,2288,2115,4403
202112,분당선,도곡,6839,6993,13832
202112,분당선,한티,13943,15130,29073
202112,분당선,선릉,14336,21473,35809
202112,분당선,선릉,13872,21314,35186
202112,분당선,한티,14749,15777,30526
202112,분당선,도곡,7338,7292,14630
202112,분당선,구룡,2216,2079,4295
202112,분당선,개포동,3979,4137,8116
202112,분당선,대모산입구,4495,4038,8533
202112,분당선,수서,14740,15555,30295
202112,분당선,수원,8556,7595,16151
202112,분당선,서울숲,11545,11826,23371
202112,분당선,압구정로데오,19877,23630,43507
202112,분당선,강남구청,11053,12499,23552
202112,분당선,선정릉,8247,8907,17154
202112,분당선,가천대,8491,9033,17524
202112,분당선,태평,13942,13056,26998
202112,분당선,모란,20333,20886,41219
202112,분당선,야탑,27229,28388,55617
202112,분당선,서현,25963,26691,52654
202112,분당선,수내,13924,13968,27892
202112,분당선,정자,18418,19966,38384
202112,분당선,미금,16064,17275,33339
202112,분당선,오리,12195,10113,22308
202112,분당선,이매,5937,5595,11532
202112,분당선,보정,2533,2157,4690
202112,분당선,죽전,14203,15296,29499
202112,분당선,구성,5193,5425,10618
202112,분당선,신갈,4877,4719,9596
202112,분당선,기흥,10325,9576,19901
202112,분당선,상갈,5756,5445,11201
202112,분당선,청명,4800,4348,9148
202112,분당선,영통,9269,9369,18638
202112,분당선,망포,15783,14318,30101
202112,분당선,매탄권선,5426,5128,10554
202112,분당선,수원시청,13542,16023,29565
202112,분당선,매교,3255,3248,6503
202112,분당선,매교,3078,3096,6174
202112,분당선,수원시청,12335,12869,25204
202112,분당선,매탄권선,5016,4883,9899
202112,분당선,망포,14155,13637,27792
202112,분당선,영통,8213,8335,16548
202112,분당선,청명,4305,4139,8444
202112,분당선,상갈,5367,5035,10402
202112,분당선,기흥,9848,9230,19078
202112,분당선,신갈,4604,4617,9221
202112,분당선,구성,5072,5313,10385
202112,분당선,죽전,12879,14080,26959
202112,분당선,보정,2447,2166,4613
202112,분당선,이매,5433,5111,10544
202112,분당선,오리,11532,9737,21269
202112,분당선,미금,15336,16327,31663
202112,분당선,정자,16850,18128,34978
202112,분당선,수내,12930,12800,25730
202112,분당선,서현,24275,24485,48760
202112,분당선,야탑,25672,26493,52165
202112,분당선,모란,19232,19325,38557
202112,분당선,태평,13295,12798,26093
202112,분당선,가천대,10410,11546,21956
202112,분당선,선정릉,7997,8644,16641
202112,분당선,강남구청,10253,11725,21978
202112,분당선,압구정로데오,16309,17876,34185
202112,분당선,서울숲,9993,10075,20068
202112,분당선,수원,7850,6756,14606
202112,분당선,수서,13291,13530,26821
202112,분당선,대모산입구,4413,4006,8419
202112,분당선,개포동,3683,3824,7507
202112,분당선,구룡,2215,2123,4338
202112,분당선,도곡,6865,6931,13796
202112,분당선,한티,13041,14120,27161
202112,분당선,선릉,13760,20923,34683
202112,분당선,선릉,14122,21378,35500
202112,분당선,한티,13215,14459,27674
202112,분당선,도곡,6897,6759,13656
202112,분당선,구룡,2127,2065,4192
202112,분당선,개포동,3792,3859,7651
202112,분당선,대모산입구,4430,4132,8562
202112,분당선,수서,13268,13431,26699
202112,분당선,수원,7644,6674,14318
202112,분당선,서울숲,10207,10413,20620
202112,분당선,압구정로데오,17680,19773,37453
202112,분당선,강남구청,10448,11935,22383
202112,분당선,선정릉,8281,8828,17109
202112,분당선,가천대,10049,10846,20895
202112,분당선,태평,13560,12924,26484
202112,분당선,모란,19513,19763,39276
202112,분당선,야탑,25634,26777,52411
202112,분당선,서현,23867,24745,48612
202112,분당선,수내,13223,13137,26360
202112,분당선,정자,17310,18651,35961
202112,분당선,미금,15561,16377,31938
202112,분당선,오리,11734,9820,21554
202112,분당선,이매,5621,5209,10830
202112,분당선,보정,2549,2225,4774
202112,분당선,죽전,13008,14266,27274
202112,분당선,구성,5205,5393,10598
202112,분당선,신갈,4792,4629,9421
202112,분당선,기흥,9821,9082,18903
202112,분당선,상갈,5431,5288,10719
202112,분당선,청명,4469,4298,8767
202112,분당선,영통,8211,8374,16585
202112,분당선,망포,14316,13647,27963
202112,분당선,매탄권선,4900,4759,9659
202112,분당선,수원시청,12443,13427,25870
202112,분당선,매교,3098,3058,6156
202112,분당선,매교,3146,3140,6286
202112,분당선,수원시청,12333,13480,25813
202112,분당선,매탄권선,5019,4913,9932
202112,분당선,망포,14618,13889,28507
202112,분당선,영통,8265,8392,16657
202112,분당선,청명,4294,4129,8423
202112,분당선,상갈,5485,5208,10693
202112,분당선,기흥,9771,9081,18852
202112,분당선,신갈,4751,4645,9396
202112,분당선,구성,5168,5430,10598
202112,분당선,죽전,13394,14699,28093
202112,분당선,보정,2557,2174,4731
202112,분당선,이매,5438,5100,10538
202112,분당선,오리,11833,9806,21639
202112,분당선,미금,15433,16585,32018
202112,분당선,정자,17197,18439,35636
202112,분당선,수내,13060,13128,26188
202112,분당선,서현,23943,24596,48539
202112,분당선,야탑,26277,27280,53557
202112,분당선,모란,19516,19615,39131
202112,분당선,태평,13301,12742,26043
202112,분당선,가천대,9818,10643,20461
202112,분당선,선정릉,8171,8754,16925
202112,분당선,강남구청,10452,11983,22435
202112,분당선,압구정로데오,17487,19719,37206
202112,분당선,서울숲,10458,10672,21130
202112,분당선,수원,7893,6700,14593
202112,분당선,수서,13103,13302,26405
202112,분당선,대모산입구,4336,4081,8417
202112,분당선,개포동,3771,3967,7738
202112,분당선,구룡,2128,2031,4159
202112,분당선,도곡,6844,6800,13644
202112,분당선,한티,13247,14341,27588
202112,분당선,선릉,13643,20929,34572
202112,분당선,선릉,13838,20900,34738
202112,분당선,한티,13203,14213,27416
202112,분당선,도곡,6849,6608,13457
202112,분당선,구룡,2172,2141,4313
202112,분당선,개포동,3702,3817,7519
202112,분당선,대모산입구,4403,4145,8548
202112,분당선,수서,13553,14034,27587
202112,분당선,수원,7875,6613,14488
202112,분당선,서울숲,10498,10842,21340
202112,분당선,압구정로데오,17873,20332,38205
202112,분당선,강남구청,10288,11922,22210
202112,분당선,선정릉,7955,8640,16595
202112,분당선,가천대,9997,10879,20876
202112,분당선,태평,13529,12815,26344
202112,분당선,모란,24285,25295,49580
202112,분당선,야탑,25822,26801,52623
202112,분당선,서현,24071,24360,48431
202112,분당선,수내,12880,12874,25754
202112,분당선,정자,17258,18276,35534
202112,분당선,미금,15139,16309,31448
202112,분당선,오리,12006,9920,21926
202112,분당선,이매,5514,5116,10630
202112,분당선,보정,2597,2218,4815
202112,분당선,죽전,13259,14556,27815
202112,분당선,구성,5167,5367,10534
202112,분당선,신갈,4826,4658,9484
202112,분당선,기흥,9951,9267,19218
202112,분당선,상갈,5421,5093,10514
202112,분당선,청명,4417,4195,8612
202112,분당선,영통,8347,8516,16863
202112,분당선,망포,14438,13658,28096
202112,분당선,매탄권선,5025,4830,9855
202112,분당선,수원시청,12490,13378,25868
202112,분당선,매교,3144,3173,6317
202112,분당선,선릉,13363,20507,33870
202112,분당선,한티,13688,14666,28354
202112,분당선,도곡,6837,6750,13587
202112,분당선,구룡,2223,2086,4309
202112,분당선,개포동,3717,3990,7707
202112,분당선,대모산입구,4497,4070,8567
202112,분당선,수서,14426,15296,29722
202112,분당선,복정,2,0,2
202112,분당선,수원,8292,7288,15580
202112,분당선,서울숲,10356,10631,20987
202112,분당선,압구정로데오,19053,23128,42181
202112,분당선,강남구청,10352,11990,22342
202112,분당선,선정릉,8028,8587,16615
202112,분당선,가천대,9597,10036,19633
202112,분당선,태평,13497,12557,26054
202112,분당선,모란,19813,20085,39898
202112,분당선,야탑,26173,27549,53722
202112,분당선,서현,25132,24498,49630
202112,분당선,수내,13182,13056,26238
202112,분당선,정자,17588,18903,36491
202112,분당선,미금,15490,16470,31960
202112,분당선,오리,11807,9725,21532
202112,분당선,이매,5958,5366,11324
202112,분당선,보정,2647,2256,4903
202112,분당선,죽전,13683,14726,28409
202112,분당선,구성,5113,5286,10399
202112,분당선,신갈,4692,4551,9243
202112,분당선,기흥,9716,9061,18777
202112,분당선,상갈,5593,5140,10733
202112,분당선,청명,4610,4225,8835
202112,분당선,영통,9023,9218,18241
202112,분당선,망포,15707,14102,29809
202112,분당선,매탄권선,5337,5000,10337
202112,분당선,수원시청,13197,15343,28540
202112,분당선,매교,3211,3243,6454
202112,분당선,매교,2934,2991,5925
202112,분당선,수원시청,11902,12588,24490
202112,분당선,매탄권선,4782,4619,9401
202112,분당선,망포,13541,12899,26440
202112,분당선,영통,7851,8127,15978
202112,분당선,청명,4158,3906,8064
202112,분당선,상갈,5107,4875,9982
202112,분당선,기흥,9074,8607,17681
202112,분당선,신갈,4561,4421,8982
202112,분당선,구성,4704,4959,9663
202112,분당선,죽전,12000,13261,25261
202112,분당선,보정,2337,2065,4402
202112,분당선,이매,5258,4928,10186
202112,분당선,오리,11029,9144,20173
202112,분당선,미금,14373,15269,29642
202112,분당선,정자,16202,17375,33577
202112,분당선,수내,12487,12364,24851
202112,분당선,서현,22926,23198,46124
202112,분당선,야탑,24022,25050,49072
202112,분당선,모란,18165,18588,36753
202112,분당선,태평,12742,12309,25051
202112,분당선,가천대,7637,8692,16329
202112,분당선,선정릉,7836,8443,16279
202112,분당선,강남구청,9779,11145,20924
202112,분당선,압구정로데오,15646,17352,32998
202112,분당선,서울숲,9152,9236,18388
202112,분당선,수원,7396,6335,13731
202112,분당선,복정,1,0,1
202112,분당선,수서,13080,13215,26295
202112,분당선,대모산입구,4274,3959,8233
202112,분당선,개포동,3503,3640,7143
202112,분당선,구룡,2032,1987,4019
202112,분당선,도곡,6409,6540,12949
202112,분당선,한티,12343,13423,25766
202112,분당선,선릉,13313,20219,33532
202112,분당선,가천대,7828,8775,16603
202112,분당선,선정릉,8144,8639,16783
202112,분당선,강남구청,10435,11906,22341
202112,분당선,압구정로데오,17412,19479,36891
202112,분당선,서울숲,9703,9972,19675
202112,분당선,수원,7435,6428,13863
202112,분당선,수서,13026,13342,26368
202112,분당선,대모산입구,4464,4140,8604
202112,분당선,개포동,3685,3814,7499
202112,분당선,구룡,2054,1988,4042
202112,분당선,도곡,6696,6584,13280
202112,분당선,한티,13149,14156,27305
202112,분당선,선릉,13592,20658,34250
202112,분당선,매교,3018,3026,6044
202112,분당선,수원시청,12072,12902,24974
202112,분당선,매탄권선,4904,4746,9650
202112,분당선,망포,13926,13220,27146
202112,분당선,영통,7935,7935,15870
202112,분당선,청명,4214,4066,8280
202112,분당선,상갈,5125,4889,10014
202112,분당선,기흥,9273,8798,18071
202112,분당선,신갈,4578,4483,9061
202112,분당선,구성,5004,5337,10341
202112,분당선,죽전,12536,13869,26405
202112,분당선,보정,2480,2147,4627
202112,분당선,이매,5535,5173,10708
202112,분당선,오리,11563,9488,21051
202112,분당선,미금,15102,16155,31257
202112,분당선,정자,16940,18175,35115
202112,분당선,수내,12847,12814,25661
202112,분당선,서현,23790,24271,48061
202112,분당선,야탑,24915,25950,50865
202112,분당선,모란,23279,23843,47122
202112,분당선,태평,13415,12935,26350
202112,분당선,선릉,13403,20317,33720
202112,분당선,한티,13084,14006,27090
202112,분당선,도곡,6662,6600,13262
202112,분당선,구룡,2044,1972,4016
202112,분당선,개포동,3709,3830,7539
202112,분당선,대모산입구,4370,3998,8368
202112,분당선,수서,13075,13204,26279
202112,분당선,복정,2,0,2
202112,분당선,수원,7729,6748,14477
202112,분당선,서울숲,10312,10512,20824
202112,분당선,압구정로데오,17782,20199,37981
202112,분당선,강남구청,10045,11704,21749
202112,분당선,선정릉,8108,8730,16838
202112,분당선,가천대,7468,8288,15756
202112,분당선,태평,13215,12532,25747
202112,분당선,모란,19023,19204,38227
202112,분당선,야탑,24982,26241,51223
202112,분당선,서현,23958,24538,48496
202112,분당선,수내,12937,12791,25728
202112,분당선,정자,17034,18189,35223
202112,분당선,미금,15120,16210,31330
202112,분당선,오리,11599,9732,21331
202112,분당선,이매,5353,4960,10313
202112,분당선,보정,2488,2138,4626
202112,분당선,죽전,12911,14181,27092
202112,분당선,구성,4939,5150,10089
202112,분당선,신갈,4653,4446,9099
202112,분당선,기흥,9472,8915,18387
202112,분당선,상갈,5215,4895,10110
202112,분당선,청명,4314,4041,8355
202112,분당선,영통,8130,8431,16561
202112,분당선,망포,14155,13422,27577
202112,분당선,매탄권선,4979,4749,9728
202112,분당선,수원시청,12417,13403,25820
202112,분당선,매교,2975,3003,5978
202112,분당선,선릉,13428,20541,33969
202112,분당선,한티,13279,14164,27443
202112,분당선,도곡,6786,6563,13349
202112,분당선,구룡,2035,1955,3990
202112,분당선,개포동,3503,3666,7169
202112,분당선,대모산입구,4323,4001,8324
202112,분당선,수서,13140,13605,26745
202112,분당선,수원,7975,6924,14899
202112,분당선,태평,13158,12564,25722
202112,분당선,가천대,7403,8105,15508
202112,분당선,선정릉,8004,8595,16599
202112,분당선,강남구청,10276,11782,22058
202112,분당선,압구정로데오,18162,21021,39183
202112,분당선,서울숲,10054,10240,20294
202112,분당선,서현,24461,25157,49618
202112,분당선,수내,13083,12949,26032
202112,분당선,정자,17276,18334,35610
202112,분당선,미금,15151,15912,31063
202112,분당선,오리,11594,9865,21459
202112,분당선,이매,5414,5021,10435
202112,분당선,보정,2488,2138,4626
202112,분당선,죽전,13184,14535,27719
202112,분당선,구성,5036,5120,10156
202112,분당선,신갈,4635,4487,9122
202112,분당선,기흥,9645,9025,18670
202112,분당선,상갈,5212,4939,10151
202112,분당선,청명,4214,4040,8254
202112,분당선,영통,8298,8338,16636
202112,분당선,망포,14529,13776,28305
202112,분당선,매탄권선,5104,4819,9923
202112,분당선,수원시청,12502,13465,25967
202112,분당선,매교,3036,3012,6048
202112,분당선,야탑,25040,26238,51278
202112,분당선,모란,19243,19419,38662
202112,분당선,망포,15313,13997,29310
202112,분당선,매교,3071,3018,6089
202112,분당선,수원시청,13191,15380,28571
202112,분당선,매탄권선,5302,4838,10140
202112,분당선,영통,8907,9191,18098
202112,분당선,청명,4562,4137,8699
202112,분당선,상갈,5341,5035,10376
202112,분당선,기흥,9841,9310,19151
202112,분당선,신갈,4602,4450,9052
202112,분당선,구성,5094,5148,10242
202112,분당선,죽전,13528,14751,28279
202112,분당선,보정,2490,2088,4578
202112,분당선,이매,5592,5178,10770
202112,분당선,오리,11832,9651,21483
202112,분당선,미금,15499,16296,31795
202112,분당선,정자,17513,18728,36241
202112,분당선,수내,13195,13173,26368
202112,분당선,서현,25812,26280,52092
202112,분당선,야탑,25766,27005,52771
202112,분당선,모란,19691,20160,39851
202112,분당선,태평,13485,12689,26174
202112,분당선,가천대,7356,7988,15344
202112,분당선,선정릉,7958,8393,16351
202112,분당선,강남구청,10530,11846,22376
202112,분당선,압구정로데오,20289,24291,44580
202112,분당선,서울숲,10107,10175,20282
202112,분당선,수원,8410,7391,15801
202112,분당선,수서,14293,14984,29277
202112,분당선,대모산입구,4306,4028,8334
202112,분당선,개포동,3733,3812,7545
202112,분당선,구룡,2147,1930,4077
202112,분당선,도곡,6813,6682,13495
202112,분당선,한티,13859,14769,28628
202112,분당선,선릉,13122,19833,32955
202112,분당선,선릉,13271,20076,33347
202112,분당선,한티,13176,14149,27325
202112,분당선,도곡,6615,6702,13317
202112,분당선,구룡,1767,1743,3510
202112,분당선,개포동,3587,3758,7345
202112,분당선,대모산입구,4292,3945,8237
202112,분당선,수서,12961,13442,26403
202112,분당선,수원,7725,6563,14288
202112,분당선,서울숲,9905,9849,19754
202112,분당선,압구정로데오,17506,18756,36262
202112,분당선,강남구청,9881,11373,21254
202112,분당선,선정릉,7959,8404,16363
202112,분당선,가천대,6461,7359,13820
202112,분당선,태평,13074,12640,25714
202112,분당선,모란,18809,19059,37868
202112,분당선,야탑,24780,25767,50547
202112,분당선,서현,24040,24129,48169
202112,분당선,수내,12820,12842,25662
202112,분당선,정자,16423,17434,33857
202112,분당선,미금,14890,15823,30713
202112,분당선,오리,11637,9697,21334
202112,분당선,이매,5463,5075,10538
202112,분당선,보정,2420,2111,4531
202112,분당선,죽전,12815,14042,26857
202112,분당선,구성,4961,5227,10188
202112,분당선,신갈,4519,4392,8911
202112,분당선,기흥,9318,8948,18266
202112,분당선,상갈,5085,4937,10022
202112,분당선,청명,4152,4049,8201
202112,분당선,영통,7984,8053,16037
202112,분당선,망포,14088,13674,27762
202112,분당선,매탄권선,4809,4636,9445
202112,분당선,수원시청,12217,12926,25143
202112,분당선,매교,3052,3022,6074
202112,분당선,선릉,13758,20370,34128
202112,분당선,한티,13907,14936,28843
202112,분당선,도곡,6923,6995,13918
202112,분당선,구룡,1831,1879,3710
202112,분당선,개포동,3639,3785,7424
202112,분당선,대모산입구,4331,4023,8354
202112,분당선,수서,13245,13462,26707
202112,분당선,복정,1,0,1
202112,분당선,수원,7757,6670,14427
202112,분당선,서울숲,10049,10405,20454
202112,분당선,압구정로데오,19820,21120,40940
202112,분당선,강남구청,10299,11774,22073
202112,분당선,선정릉,8036,8640,16676
202112,분당선,가천대,6551,7446,13997
202112,분당선,태평,13189,12814,26003
202112,분당선,모란,19203,19460,38663
202112,분당선,야탑,25458,26560,52018
202112,분당선,서현,24986,25327,50313
202112,분당선,수내,13559,13454,27013
202112,분당선,정자,17135,18312,35447
202112,분당선,미금,15250,16314,31564
202112,분당선,오리,11925,9794,21719
202112,분당선,이매,5566,5259,10825
202112,분당선,보정,2503,2211,4714
202112,분당선,죽전,12966,14245,27211
202112,분당선,구성,5029,5316,10345
202112,분당선,신갈,4619,4596,9215
202112,분당선,기흥,9514,9001,18515
202112,분당선,상갈,5202,5031,10233
202112,분당선,청명,4141,3947,8088
202112,분당선,영통,8218,8280,16498
202112,분당선,망포,14237,13581,27818
202112,분당선,매탄권선,5103,4837,9940
202112,분당선,수원시청,12652,13429,26081
202112,분당선,매교,3073,3119,6192
202112,분당선,선릉,13632,20414,34046
202112,분당선,한티,13985,15004,28989
202112,분당선,도곡,6902,6958,13860
202112,분당선,구룡,2148,2039,4187
202112,분당선,개포동,3904,4104,8008
202112,분당선,대모산입구,4328,4051,8379
202112,분당선,수서,13143,13610,26753
202112,분당선,복정,1,0,1
202112,분당선,수원,7852,6831,14683
202112,분당선,서울숲,10500,10772,21272
202112,분당선,압구정로데오,20135,21500,41635
202112,분당선,강남구청,10583,12147,22730
202112,분당선,선정릉,8213,8812,17025
202112,분당선,가천대,6591,7474,14065
202112,분당선,태평,13435,12956,26391
202112,분당선,모란,19499,19452,38951
202112,분당선,야탑,25839,27119,52958
202112,분당선,서현,25207,25491,50698
202112,분당선,수내,13501,13485,26986
202112,분당선,정자,17351,18471,35822
202112,분당선,미금,15720,16825,32545
202112,분당선,오리,11806,9701,21507
202112,분당선,이매,5724,5331,11055
202112,분당선,보정,2540,2218,4758
202112,분당선,죽전,13521,14678,28199
202112,분당선,구성,5055,5325,10380
202112,분당선,신갈,4647,4519,9166
202112,분당선,기흥,9616,9289,18905
202112,분당선,상갈,5361,5171,10532
202112,분당선,청명,4153,4131,8284
202112,분당선,영통,8543,8582,17125
202112,분당선,망포,14534,13886,28420
202112,분당선,매탄권선,4989,4833,9822
202112,분당선,수원시청,12804,13619,26423
202112,분당선,매교,3140,3162,6302
202112,분당선,매교,3158,3166,6324
202112,분당선,수원시청,12842,13782,26624
202112,분당선,매탄권선,5086,4922,10008
202112,분당선,망포,14527,13737,28264
202112,분당선,영통,8453,8438,16891
202112,분당선,청명,4183,4056,8239
202112,분당선,상갈,5266,5069,10335
202112,분당선,기흥,9662,9019,18681
202112,분당선,신갈,4648,4612,9260
202112,분당선,구성,5212,5497,10709
202112,분당선,죽전,13275,14776,28051
202112,분당선,보정,2711,2323,5034
202112,분당선,이매,5700,5309,11009
202112,분당선,오리,12113,9906,22019
202112,분당선,미금,15425,16469,31894
202112,분당선,정자,17352,18489,35841
202112,분당선,수내,13624,13381,27005
202112,분당선,서현,25631,25923,51554
202112,분당선,야탑,26129,27310,53439
202112,분당선,모란,19620,19864,39484
202112,분당선,태평,13547,13078,26625
202112,분당선,가천대,6541,7460,14001
202112,분당선,선정릉,8120,8728,16848
202112,분당선,강남구청,10461,11819,22280
202112,분당선,압구정로데오,21244,23038,44282
202112,분당선,서울숲,10730,10901,21631
202112,분당선,수원,8035,6856,14891
202112,분당선,복정,1,0,1
202112,분당선,수서,13462,14301,27763
202112,분당선,대모산입구,4234,4107,8341
202112,분당선,개포동,3758,3822,7580
202112,분당선,구룡,2077,1978,4055
202112,분당선,도곡,7076,6940,14016
202112,분당선,한티,14102,15058,29160
202112,분당선,선릉,13895,20669,34564
202112,분당선,매교,2970,3042,6012
202112,분당선,수원시청,13659,15677,29336
202112,분당선,매탄권선,5494,5039,10533
202112,분당선,망포,15416,13958,29374
202112,분당선,영통,9281,9284,18565
202112,분당선,청명,4342,3999,8341
202112,분당선,상갈,5412,5182,10594
202112,분당선,기흥,9765,9503,19268
202112,분당선,신갈,4506,4483,8989
202112,분당선,구성,4887,5325,10212
202112,분당선,죽전,14263,15607,29870
202112,분당선,보정,2522,2210,4732
202112,분당선,이매,5958,5759,11717
202112,분당선,오리,12099,9902,22001
202112,분당선,미금,15555,16376,31931
202112,분당선,정자,16799,17928,34727
202112,분당선,수내,13230,13249,26479
202112,분당선,서현,27513,28232,55745
202112,분당선,야탑,26311,27456,53767
202112,분당선,모란,24115,24566,48681
202112,분당선,태평,13903,13679,27582
202112,분당선,가천대,6655,7206,13861
202112,분당선,선정릉,7900,8148,16048
202112,분당선,강남구청,10416,11426,21842
202112,분당선,압구정로데오,23741,25131,48872
202112,분당선,서울숲,10491,10601,21092
202112,분당선,수원,8969,7803,16772
202112,분당선,수서,13495,14838,28333
202112,분당선,대모산입구,4400,4001,8401
202112,분당선,개포동,3709,3897,7606
202112,분당선,구룡,2142,1862,4004
202112,분당선,도곡,7055,7069,14124
202112,분당선,한티,14567,15568,30135
202112,분당선,선릉,12641,18331,30972
202112,분당선,매교,2496,2543,5039
202112,분당선,수원시청,11759,12403,24162
202112,분당선,매탄권선,4530,4317,8847
202112,분당선,망포,13022,12535,25557
202112,분당선,영통,7455,7528,14983
202112,분당선,청명,3791,3653,7444
202112,분당선,상갈,4645,4496,9141
202112,분당선,기흥,8875,8412,17287
202112,분당선,신갈,4113,4109,8222
202112,분당선,구성,4486,4775,9261
202112,분당선,죽전,11769,12955,24724
202112,분당선,보정,2144,1831,3975
202112,분당선,이매,5102,4673,9775
202112,분당선,오리,10688,8813,19501
202112,분당선,미금,14141,14764,28905
202112,분당선,정자,15292,16074,31366
202112,분당선,수내,12247,12052,24299
202112,분당선,서현,22980,22913,45893
202112,분당선,야탑,23386,24529,47915
202112,분당선,모란,17904,17913,35817
202112,분당선,태평,12589,12310,24899
202112,분당선,가천대,5927,6933,12860
202112,분당선,선정릉,7668,8148,15816
202112,분당선,강남구청,9341,10497,19838
202112,분당선,압구정로데오,17481,18442,35923
202112,분당선,서울숲,8895,8994,17889
202112,분당선,수원,7269,6139,13408
202112,분당선,수서,12794,13272,26066
202112,분당선,대모산입구,3967,3712,7679
202112,분당선,개포동,3412,3566,6978
202112,분당선,구룡,1903,1819,3722
202112,분당선,도곡,6412,6502,12914
202112,분당선,한티,12826,13990,26816
202112,분당선,선릉,12665,19129,31794
202112,분당선,매교,2632,2603,5235
202112,분당선,수원시청,12163,12795,24958
202112,분당선,매탄권선,4744,4632,9376
202112,분당선,망포,13589,12923,26512
202112,분당선,영통,7777,7821,15598
202112,분당선,청명,3898,3763,7661
202112,분당선,상갈,5038,4872,9910
202112,분당선,기흥,9023,8697,17720
202112,분당선,신갈,4350,4280,8630
202112,분당선,구성,4752,5107,9859
202112,분당선,죽전,12466,13858,26324
202112,분당선,보정,2301,2039,4340
202112,분당선,이매,5560,5129,10689
202112,분당선,오리,11403,9379,20782
202112,분당선,미금,15068,15849,30917
202112,분당선,정자,16279,17230,33509
202112,분당선,수내,12866,13073,25939
202112,분당선,서현,23996,24256,48252
202112,분당선,야탑,24707,25766,50473
202112,분당선,모란,18698,18857,37555
202112,분당선,태평,12944,12446,25390
202112,분당선,가천대,11315,11663,22978
202112,분당선,선정릉,7723,8188,15911
202112,분당선,강남구청,9925,11187,21112
202112,분당선,압구정로데오,19749,21183,40932
202112,분당선,서울숲,9738,9876,19614
202112,분당선,수원,7542,6465,14007
202112,분당선,수서,13130,13584,26714
202112,분당선,대모산입구,4229,3988,8217
202112,분당선,개포동,3541,3680,7221
202112,분당선,구룡,2024,1960,3984
202112,분당선,도곡,6666,6632,13298
202112,분당선,한티,13701,14766,28467
202112,분당선,선릉,13343,19934,33277
202112,분당선,선릉,13197,19894,33091
202112,분당선,한티,13740,15043,28783
202112,분당선,도곡,6362,6375,12737
202112,분당선,구룡,1966,1906,3872
202112,분당선,개포동,3595,3806,7401
202112,분당선,대모산입구,4262,3946,8208
202112,분당선,수서,13136,13789,26925
202112,분당선,수원,7614,6506,14120
202112,분당선,서울숲,10244,10185,20429
202112,분당선,압구정로데오,20578,21907,42485
202112,분당선,강남구청,9862,11378,21240
202112,분당선,선정릉,7635,8359,15994
202112,분당선,가천대,6267,7194,13461
202112,분당선,태평,13450,13034,26484
202112,분당선,모란,23394,24429,47823
202112,분당선,야탑,25546,26492,52038
202112,분당선,서현,24705,24986,49691
202112,분당선,수내,13253,13188,26441
202112,분당선,정자,16890,17636,34526
202112,분당선,미금,15522,16508,32030
202112,분당선,오리,12111,9870,21981
202112,분당선,이매,5842,5575,11417
202112,분당선,보정,2313,2030,4343
202112,분당선,죽전,12921,14395,27316
202112,분당선,구성,4851,5096,9947
202112,분당선,신갈,4449,4438,8887
202112,분당선,기흥,9391,8855,18246
202112,분당선,상갈,5139,4970,10109
202112,분당선,청명,4006,3843,7849
202112,분당선,영통,8189,8184,16373
202112,분당선,망포,13823,13256,27079
202112,분당선,매탄권선,4852,4731,9583
202112,분당선,수원시청,12766,13326,26092
202112,분당선,매교,2647,2623,5270
202112,분당선,한티,13912,14659,28571
202112,분당선,도곡,5983,6029,12012
202112,분당선,구룡,1740,1725,3465
202112,분당선,개포동,3256,3391,6647
202112,분당선,대모산입구,4090,3793,7883
202112,분당선,수서,12831,13863,26694
202112,분당선,복정,3,0,3
202112,분당선,수원,7798,6526,14324
202112,분당선,서울숲,9928,10134,20062
202112,분당선,압구정로데오,20571,21781,42352
202112,분당선,강남구청,9643,10994,20637
202112,분당선,선정릉,7359,7900,15259
202112,분당선,가천대,6277,6983,13260
202112,분당선,태평,13148,12814,25962
202112,분당선,모란,19493,19313,38806
202112,분당선,야탑,24627,25889,50516
202112,분당선,서현,24813,24790,49603
202112,분당선,수내,12881,12953,25834
202112,분당선,정자,16019,16894,32913
202112,분당선,미금,15056,15755,30811
202112,분당선,오리,11418,9357,20775
202112,분당선,이매,5354,5005,10359
202112,분당선,보정,2293,2009,4302
202112,분당선,죽전,12665,13852,26517
202112,분당선,구성,4724,4962,9686
202112,분당선,신갈,4269,4163,8432
202112,분당선,기흥,9106,8650,17756
202112,분당선,상갈,4945,4745,9690
202112,분당선,청명,3909,3827,7736
202112,분당선,영통,8214,8104,16318
202112,분당선,망포,13582,12647,26229
202112,분당선,매탄권선,4778,4629,9407
202112,분당선,수원시청,12526,13140,25666
202112,분당선,매교,2672,2685,5357
202112,분당선,선릉,12573,19033,31606
202112,분당선,선릉,10099,14935,25034
202112,분당선,한티,13154,13873,27027
202112,분당선,도곡,5760,5600,11360
202112,분당선,구룡,1779,1565,3344
202112,분당선,개포동,2882,3154,6036
202112,분당선,대모산입구,3698,3368,7066
202112,분당선,수서,11993,13705,25698
202112,분당선,수원,7978,6804,14782
202112,분당선,서울숲,8545,8503,17048
202112,분당선,압구정로데오,19150,20297,39447
202112,분당선,강남구청,8311,9154,17465
202112,분당선,선정릉,5780,6037,11817
202112,분당선,가천대,5899,6151,12050
202112,분당선,태평,12882,12744,25626
202112,분당선,모란,18339,18511,36850
202112,분당선,야탑,22948,24335,47283
202112,분당선,서현,23685,23747,47432
202112,분당선,수내,11256,11389,22645
202112,분당선,정자,14291,15003,29294
202112,분당선,미금,13945,14413,28358
202112,분당선,오리,10072,8309,18381
202112,분당선,이매,5054,4781,9835
202112,분당선,보정,2023,1799,3822
202112,분당선,죽전,12070,13148,25218
202112,분당선,구성,4196,4626,8822
202112,분당선,신갈,3889,3817,7706
202112,분당선,기흥,8396,7966,16362
202112,분당선,상갈,4688,4441,9129
202112,분당선,청명,3750,3408,7158
202112,분당선,영통,7971,7745,15716
202112,분당선,망포,13021,11604,24625
202112,분당선,매탄권선,4871,4328,9199
202112,분당선,수원시청,12190,13675,25865
202112,분당선,매교,2389,2422,4811
