사용월,호선명,지하철역,승차총승객수,하차총승객수,승하차총승객수
202101,9호선,노들,1719,1527,3246
202101,9호선,중앙보훈병원,2199,1996,4195
202101,9호선,둔촌오륜,278,274,552
202101,9호선,올림픽공원,1915,1910,3825
202101,9호선,한성백제,857,777,1634
202101,9호선,송파나루,1811,1899,3710
202101,9호선,석촌,2824,2523,5347
202101,9호선,석촌고분,2227,2271,4498
202101,9호선,삼전,2702,2621,5323
202101,9호선,종합운동장,1446,1400,2846
202101,9호선,봉은사,4492,4367,8859
202101,9호선,삼성중앙,1575,1595,3170
202101,9호선,선정릉,2062,2321,4383
202101,9호선,언주,2723,2665,5388
202101,9호선,신논현,12272,12017,24289
202101,9호선,사평,926,893,1819
202101,9호선,고속터미널,5633,6792,12425
202101,9호선,신반포,1006,935,1941
202101,9호선,구반포,866,957,1823
202101,9호선,동작,655,494,1149
202101,9호선,흑석,2712,2935,5647
202101,9호선,노량진,9732,10192,19924
202101,9호선,샛강,1307,1368,2675
202101,9호선,여의도,3503,3367,6870
202101,9호선,국회의사당,1723,1754,3477
202101,9호선,당산,5978,5867,11845
202101,9호선,선유도,1721,1743,3464
202101,9호선,신목동,1115,953,2068
202101,9호선,염창,5939,5855,11794
202101,9호선,등촌,3824,3931,7755
202101,9호선,증미,2420,2522,4942
202101,9호선,가양,7249,7409,14658
202101,9호선,양천향교,2870,3083,5953
202101,9호선,마곡나루,3267,3279,6546
202101,9호선,신방화,2576,2459,5035
202101,9호선,공항시장,1333,1466,2799
202101,9호선,김포공항,4344,5124,9468
202101,9호선,개화,736,642,1378
202101,9호선,개화,617,571,1188
202101,9호선,김포공항,4806,5401,10207
202101,9호선,공항시장,968,1163,2131
202101,9호선,신방화,2003,2008,4011
202101,9호선,마곡나루,2542,2807,5349
202101,9호선,양천향교,2180,2521,4701
202101,9호선,가양,5431,5568,10999
202101,9호선,증미,1836,1963,3799
202101,9호선,등촌,2789,3038,5827
202101,9호선,염창,4531,4779,9310
202101,9호선,신목동,904,831,1735
202101,9호선,선유도,1310,1480,2790
202101,9호선,삼성중앙,1152,1214,2366
202101,9호선,봉은사,3390,3331,6721
202101,9호선,종합운동장,1050,1101,2151
202101,9호선,삼전,2021,2132,4153
202101,9호선,석촌고분,1767,1890,3657
202101,9호선,석촌,2172,2041,4213
202101,9호선,송파나루,1332,1521,2853
202101,9호선,한성백제,628,663,1291
202101,9호선,올림픽공원,1463,1473,2936
202101,9호선,둔촌오륜,227,232,459
202101,9호선,중앙보훈병원,1723,1642,3365
202101,9호선,당산,4584,4884,9468
202101,9호선,국회의사당,1733,1607,3340
202101,9호선,여의도,2833,2816,5649
202101,9호선,샛강,915,1042,1957
202101,9호선,노량진,7457,8261,15718
202101,9호선,노들,1344,1174,2518
202101,9호선,흑석,2023,2241,4264
202101,9호선,동작,510,427,937
202101,9호선,구반포,599,686,1285
202101,9호선,신반포,676,670,1346
202101,9호선,고속터미널,5713,5953,11666
202101,9호선,사평,644,735,1379
202101,9호선,신논현,7388,7228,14616
202101,9호선,언주,1704,1822,3526
202101,9호선,선정릉,1527,1737,3264
202101,9호선,중앙보훈병원,2537,2287,4824
202101,9호선,둔촌오륜,449,411,860
202101,9호선,올림픽공원,2156,2116,4272
202101,9호선,한성백제,1228,1082,2310
202101,9호선,송파나루,2526,2616,5142
202101,9호선,석촌,3769,3175,6944
202101,9호선,석촌고분,3049,2978,6027
202101,9호선,삼전,3534,3466,7000
202101,9호선,종합운동장,1933,1811,3744
202101,9호선,봉은사,5856,5914,11770
202101,9호선,삼성중앙,2156,2122,4278
202101,9호선,선정릉,2998,3159,6157
202101,9호선,언주,4213,4098,8311
202101,9호선,신논현,15833,15431,31264
202101,9호선,사평,1292,1292,2584
202101,9호선,고속터미널,6598,8880,15478
202101,9호선,신반포,1425,1354,2779
202101,9호선,구반포,1335,1394,2729
202101,9호선,동작,706,509,1215
202101,9호선,흑석,3588,3669,7257
202101,9호선,노들,2001,1783,3784
202101,9호선,노량진,11948,11933,23881
202101,9호선,샛강,1702,1711,3413
202101,9호선,여의도,4943,4681,9624
202101,9호선,국회의사당,2489,2518,5007
202101,9호선,당산,7724,7302,15026
202101,9호선,선유도,2257,2333,4590
202101,9호선,신목동,1270,1141,2411
202101,9호선,염창,7233,6992,14225
202101,9호선,등촌,4816,4808,9624
202101,9호선,증미,3068,3087,6155
202101,9호선,가양,9215,8906,18121
202101,9호선,양천향교,3759,3791,7550
202101,9호선,마곡나루,4506,4459,8965
202101,9호선,신방화,3134,3114,6248
202101,9호선,공항시장,1559,1695,3254
202101,9호선,김포공항,4569,6287,10856
202101,9호선,개화,799,685,1484
202101,9호선,중앙보훈병원,1782,1737,3519
202101,9호선,둔촌오륜,281,261,542
202101,9호선,올림픽공원,1546,1547,3093
202101,9호선,한성백제,799,693,1492
202101,9호선,송파나루,1675,1758,3433
202101,9호선,석촌,2588,2192,4780
202101,9호선,석촌고분,2028,2046,4074
202101,9호선,삼전,2402,2399,4801
202101,9호선,종합운동장,1178,1128,2306
202101,9호선,봉은사,4184,4049,8233
202101,9호선,삼성중앙,1234,1325,2559
202101,9호선,선정릉,1871,2078,3949
202101,9호선,언주,2280,2272,4552
202101,9호선,신논현,8298,8100,16398
202101,9호선,사평,743,823,1566
202101,9호선,고속터미널,5219,6506,11725
202101,9호선,신반포,728,766,1494
202101,9호선,구반포,734,739,1473
202101,9호선,동작,513,431,944
202101,9호선,흑석,4422,3844,8266
202101,9호선,노들,1498,1312,2810
202101,9호선,노량진,8147,9035,17182
202101,9호선,샛강,1003,1043,2046
202101,9호선,여의도,3277,3022,6299
202101,9호선,국회의사당,1833,1815,3648
202101,9호선,당산,4977,4886,9863
202101,9호선,선유도,1448,1465,2913
202101,9호선,신목동,921,831,1752
202101,9호선,염창,4888,4930,9818
202101,9호선,등촌,2980,3060,6040
202101,9호선,증미,1564,1591,3155
202101,9호선,가양,5874,5885,11759
202101,9호선,양천향교,2482,2569,5051
202101,9호선,마곡나루,2885,2950,5835
202101,9호선,신방화,2060,1976,4036
202101,9호선,공항시장,984,1130,2114
202101,9호선,김포공항,4012,5420,9432
202101,9호선,개화,600,535,1135
202101,9호선,개화,974,803,1777
202101,9호선,김포공항,5215,7517,12732
202101,9호선,공항시장,1717,1906,3623
202101,9호선,신방화,3481,3428,6909
202101,9호선,마곡나루,5122,5086,10208
202101,9호선,양천향교,4212,4160,8372
202101,9호선,가양,10175,10019,20194
202101,9호선,증미,3367,3315,6682
202101,9호선,등촌,5506,5396,10902
202101,9호선,염창,8223,7876,16099
202101,9호선,신목동,1488,1360,2848
202101,9호선,선유도,2573,2491,5064
202101,9호선,당산,8802,8360,17162
202101,9호선,국회의사당,2609,2802,5411
202101,9호선,여의도,5577,5434,11011
202101,9호선,샛강,1807,1795,3602
202101,9호선,노량진,13803,13749,27552
202101,9호선,노들,2288,2055,4343
202101,9호선,흑석,3980,4011,7991
202101,9호선,동작,850,665,1515
202101,9호선,구반포,1447,1508,2955
202101,9호선,신반포,1556,1463,3019
202101,9호선,고속터미널,7737,10089,17826
202101,9호선,사평,1493,1434,2927
202101,9호선,신논현,17809,17142,34951
202101,9호선,언주,4444,4382,8826
202101,9호선,선정릉,3288,3625,6913
202101,9호선,삼성중앙,2302,2269,4571
202101,9호선,봉은사,6458,6577,13035
202101,9호선,종합운동장,2037,1911,3948
202101,9호선,삼전,3799,3445,7244
202101,9호선,석촌고분,3225,3117,6342
202101,9호선,석촌,4242,3675,7917
202101,9호선,송파나루,2664,2773,5437
202101,9호선,한성백제,1243,1121,2364
202101,9호선,올림픽공원,2650,2516,5166
202101,9호선,둔촌오륜,489,437,926
202101,9호선,중앙보훈병원,2913,2690,5603
202101,9호선,봉은사,4496,4361,8857
202101,9호선,삼성중앙,1333,1394,2727
202101,9호선,선정릉,2110,2310,4420
202101,9호선,언주,2524,2494,5018
202101,9호선,신논현,9569,8948,18517
202101,9호선,사평,791,901,1692
202101,9호선,고속터미널,6045,7190,13235
202101,9호선,신반포,799,861,1660
202101,9호선,구반포,784,851,1635
202101,9호선,동작,616,433,1049
202101,9호선,흑석,2574,2683,5257
202101,9호선,노들,1528,1423,2951
202101,9호선,노량진,8995,9680,18675
202101,9호선,샛강,1072,1154,2226
202101,9호선,여의도,3588,3312,6900
202101,9호선,국회의사당,2119,1860,3979
202101,9호선,당산,5590,5535,11125
202101,9호선,선유도,1730,1766,3496
202101,9호선,신목동,1026,902,1928
202101,9호선,염창,5397,5580,10977
202101,9호선,등촌,3309,3522,6831
202101,9호선,증미,2269,2282,4551
202101,9호선,가양,6669,6746,13415
202101,9호선,양천향교,2658,2849,5507
202101,9호선,마곡나루,3243,3264,6507
202101,9호선,신방화,2347,2333,4680
202101,9호선,공항시장,1162,1295,2457
202101,9호선,김포공항,4832,6822,11654
202101,9호선,개화,689,619,1308
202101,9호선,종합운동장,1340,1239,2579
202101,9호선,삼전,2496,2537,5033
202101,9호선,석촌고분,2122,2222,4344
202101,9호선,석촌,2780,2408,5188
202101,9호선,송파나루,1784,1942,3726
202101,9호선,한성백제,794,783,1577
202101,9호선,올림픽공원,1751,1759,3510
202101,9호선,둔촌오륜,274,280,554
202101,9호선,중앙보훈병원,1904,1850,3754
202101,9호선,개화,1017,867,1884
202101,9호선,김포공항,5441,8060,13501
202101,9호선,공항시장,1836,1965,3801
202101,9호선,신방화,3627,3603,7230
202101,9호선,마곡나루,5832,5711,11543
202101,9호선,양천향교,4599,4537,9136
202101,9호선,가양,11304,10771,22075
202101,9호선,증미,3500,3522,7022
202101,9호선,등촌,5942,5750,11692
202101,9호선,염창,9138,8723,17861
202101,9호선,신목동,1747,1571,3318
202101,9호선,선유도,2821,2811,5632
202101,9호선,당산,9889,9428,19317
202101,9호선,국회의사당,2953,3012,5965
202101,9호선,여의도,6203,5977,12180
202101,9호선,샛강,2014,2112,4126
202101,9호선,노량진,16271,16227,32498
202101,9호선,노들,2522,2152,4674
202101,9호선,흑석,4540,4414,8954
202101,9호선,동작,1058,816,1874
202101,9호선,구반포,1659,1825,3484
202101,9호선,신반포,1787,1575,3362
202101,9호선,고속터미널,8408,11355,19763
202101,9호선,사평,1561,1473,3034
202101,9호선,신논현,19731,19451,39182
202101,9호선,언주,4857,4879,9736
202101,9호선,선정릉,3833,4164,7997
202101,9호선,삼성중앙,2424,2398,4822
202101,9호선,봉은사,7412,7372,14784
202101,9호선,종합운동장,2251,2093,4344
202101,9호선,삼전,3947,3718,7665
202101,9호선,석촌고분,3383,3268,6651
202101,9호선,석촌,4919,4200,9119
202101,9호선,송파나루,2940,3106,6046
202101,9호선,한성백제,1397,1184,2581
202101,9호선,올림픽공원,3029,3074,6103
202101,9호선,둔촌오륜,569,506,1075
202101,9호선,중앙보훈병원,3229,3013,6242
202101,9호선,동작,815,675,1490
202101,9호선,개화,862,679,1541
202101,9호선,김포공항,5005,7258,12263
202101,9호선,공항시장,1273,1367,2640
202101,9호선,신방화,2527,2499,5026
202101,9호선,마곡나루,3858,3962,7820
202101,9호선,양천향교,3016,3234,6250
202101,9호선,가양,7455,7593,15048
202101,9호선,증미,1886,1888,3774
202101,9호선,등촌,3847,4019,7866
202101,9호선,염창,6205,6143,12348
202101,9호선,신목동,1230,1065,2295
202101,9호선,선유도,1920,1970,3890
202101,9호선,당산,6399,6233,12632
202101,9호선,국회의사당,3058,2822,5880
202101,9호선,여의도,4296,3922,8218
202101,9호선,샛강,1216,1229,2445
202101,9호선,노량진,10375,11066,21441
202101,9호선,노들,1870,1644,3514
202101,9호선,흑석,3046,3153,6199
202101,9호선,구반포,867,869,1736
202101,9호선,신반포,1056,1122,2178
202101,9호선,고속터미널,6668,8174,14842
202101,9호선,사평,905,1001,1906
202101,9호선,신논현,11202,10650,21852
202101,9호선,언주,2729,2722,5451
202101,9호선,선정릉,2363,2514,4877
202101,9호선,삼성중앙,1416,1513,2929
202101,9호선,봉은사,4877,4683,9560
202101,9호선,종합운동장,1363,1335,2698
202101,9호선,삼전,2697,2667,5364
202101,9호선,석촌고분,2339,2328,4667
202101,9호선,석촌,3242,2948,6190
202101,9호선,송파나루,2035,2228,4263
202101,9호선,한성백제,1047,912,1959
202101,9호선,올림픽공원,2241,2214,4455
202101,9호선,둔촌오륜,317,329,646
202101,9호선,중앙보훈병원,2334,2288,4622
202101,9호선,개화,994,851,1845
202101,9호선,김포공항,5829,8601,14430
202101,9호선,공항시장,1868,1962,3830
202101,9호선,신방화,3824,3680,7504
202101,9호선,마곡나루,5699,5719,11418
202101,9호선,양천향교,4712,4603,9315
202101,9호선,가양,11252,10849,22101
202101,9호선,증미,3367,3496,6863
202101,9호선,등촌,6020,5799,11819
202101,9호선,염창,9168,8750,17918
202101,9호선,신목동,1694,1497,3191
202101,9호선,선유도,2795,2841,5636
202101,9호선,당산,9963,9290,19253
202101,9호선,국회의사당,3010,3098,6108
202101,9호선,여의도,6072,5748,11820
202101,9호선,샛강,2088,2204,4292
202101,9호선,노량진,15932,16201,32133
202101,9호선,노들,2521,2228,4749
202101,9호선,흑석,4286,4370,8656
202101,9호선,동작,1021,770,1791
202101,9호선,구반포,1646,1755,3401
202101,9호선,신반포,1914,1833,3747
202101,9호선,고속터미널,8713,11653,20366
202101,9호선,사평,1627,1514,3141
202101,9호선,신논현,20266,19934,40200
202101,9호선,언주,4816,4712,9528
202101,9호선,선정릉,3765,4198,7963
202101,9호선,삼성중앙,2523,2551,5074
202101,9호선,봉은사,7705,7790,15495
202101,9호선,종합운동장,2447,2139,4586
202101,9호선,삼전,4044,3795,7839
202101,9호선,석촌고분,3465,3335,6800
202101,9호선,석촌,4983,4178,9161
202101,9호선,송파나루,3031,3276,6307
202101,9호선,한성백제,1462,1249,2711
202101,9호선,올림픽공원,2907,3055,5962
202101,9호선,둔촌오륜,556,502,1058
202101,9호선,중앙보훈병원,3267,2996,6263
202101,9호선,염창,6509,6436,12945
202101,9호선,개화,796,675,1471
202101,9호선,김포공항,5363,7539,12902
202101,9호선,공항시장,1338,1484,2822
202101,9호선,신방화,2670,2641,5311
202101,9호선,마곡나루,3905,3986,7891
202101,9호선,양천향교,3086,3264,6350
202101,9호선,가양,7898,7754,15652
202101,9호선,증미,2369,2384,4753
202101,9호선,등촌,3952,4119,8071
202101,9호선,신목동,1270,1169,2439
202101,9호선,선유도,2085,2065,4150
202101,9호선,당산,6523,6400,12923
202101,9호선,국회의사당,3055,2806,5861
202101,9호선,여의도,4262,4054,8316
202101,9호선,샛강,1312,1310,2622
202101,9호선,노량진,10913,11534,22447
202101,9호선,노들,1786,1636,3422
202101,9호선,흑석,2855,3049,5904
202101,9호선,동작,857,688,1545
202101,9호선,구반포,885,969,1854
202101,9호선,신반포,1007,1095,2102
202101,9호선,고속터미널,6962,8609,15571
202101,9호선,사평,1139,1167,2306
202101,9호선,신논현,11605,10726,22331
202101,9호선,언주,2703,2800,5503
202101,9호선,선정릉,2348,2590,4938
202101,9호선,삼성중앙,1533,1627,3160
202101,9호선,봉은사,5303,5173,10476
202101,9호선,종합운동장,1501,1391,2892
202101,9호선,삼전,2831,2902,5733
202101,9호선,석촌고분,2373,2368,4741
202101,9호선,석촌,3393,2882,6275
202101,9호선,송파나루,1994,2320,4314
202101,9호선,한성백제,1001,896,1897
202101,9호선,올림픽공원,2283,2282,4565
202101,9호선,둔촌오륜,363,342,705
202101,9호선,중앙보훈병원,2148,2096,4244
202102,9호선,개화,1191,986,2177
202102,9호선,김포공항,5916,9614,15530
202102,9호선,공항시장,1922,2031,3953
202102,9호선,신방화,4058,3920,7978
202102,9호선,마곡나루,6148,6151,12299
202102,9호선,양천향교,4978,4902,9880
202102,9호선,가양,11980,11284,23264
202102,9호선,증미,3663,3757,7420
202102,9호선,등촌,6489,6275,12764
202102,9호선,염창,9727,9319,19046
202102,9호선,신목동,1827,1595,3422
202102,9호선,선유도,3067,3026,6093
202102,9호선,당산,10299,9556,19855
202102,9호선,국회의사당,2876,2948,5824
202102,9호선,여의도,6259,5965,12224
202102,9호선,샛강,2043,2118,4161
202102,9호선,노량진,16829,16781,33610
202102,9호선,노들,2584,2271,4855
202102,9호선,흑석,5033,4809,9842
202102,9호선,동작,1194,897,2091
202102,9호선,구반포,1642,1755,3397
202102,9호선,신반포,1786,1620,3406
202102,9호선,고속터미널,9170,12641,21811
202102,9호선,사평,1727,1614,3341
202102,9호선,신논현,21520,21487,43007
202102,9호선,언주,5148,5087,10235
202102,9호선,선정릉,4022,4507,8529
202102,9호선,삼성중앙,2509,2499,5008
202102,9호선,봉은사,7456,7522,14978
202102,9호선,종합운동장,2561,2269,4830
202102,9호선,삼전,4405,4008,8413
202102,9호선,석촌고분,3522,3356,6878
202102,9호선,석촌,5380,4470,9850
202102,9호선,송파나루,3323,3521,6844
202102,9호선,한성백제,1438,1269,2707
202102,9호선,올림픽공원,3157,3089,6246
202102,9호선,둔촌오륜,544,527,1071
202102,9호선,중앙보훈병원,3514,3264,6778
202102,9호선,중앙보훈병원,2341,2171,4512
202102,9호선,둔촌오륜,377,346,723
202102,9호선,올림픽공원,2070,2110,4180
202102,9호선,한성백제,1067,938,2005
202102,9호선,송파나루,2370,2575,4945
202102,9호선,석촌,3467,2950,6417
202102,9호선,석촌고분,2451,2438,4889
202102,9호선,삼전,2895,2842,5737
202102,9호선,종합운동장,1721,1479,3200
202102,9호선,봉은사,5295,5025,10320
202102,9호선,삼성중앙,1577,1644,3221
202102,9호선,선정릉,2510,2774,5284
202102,9호선,언주,2856,2762,5618
202102,9호선,신논현,12216,11319,23535
202102,9호선,사평,967,1100,2067
202102,9호선,고속터미널,6828,9100,15928
202102,9호선,신반포,1094,1120,2214
202102,9호선,구반포,942,1001,1943
202102,9호선,동작,842,690,1532
202102,9호선,흑석,2993,3801,6794
202102,9호선,노들,1906,1709,3615
202102,9호선,노량진,11512,12032,23544
202102,9호선,샛강,1350,1411,2761
202102,9호선,여의도,4501,4050,8551
202102,9호선,국회의사당,3286,3007,6293
202102,9호선,당산,6748,6631,13379
202102,9호선,선유도,2156,2083,4239
202102,9호선,신목동,1324,1207,2531
202102,9호선,염창,6612,6611,13223
202102,9호선,등촌,4402,4543,8945
202102,9호선,증미,2658,2632,5290
202102,9호선,가양,8009,8015,16024
202102,9호선,양천향교,3265,3362,6627
202102,9호선,마곡나루,4132,4025,8157
202102,9호선,신방화,2811,2758,5569
202102,9호선,공항시장,1388,1541,2929
202102,9호선,김포공항,5683,8786,14469
202102,9호선,개화,817,712,1529
202102,9호선,개화,963,822,1785
202102,9호선,김포공항,6935,8405,15340
202102,9호선,공항시장,1285,1412,2697
202102,9호선,신방화,2464,2517,4981
202102,9호선,마곡나루,3801,4144,7945
202102,9호선,양천향교,2933,3279,6212
202102,9호선,가양,7286,7681,14967
202102,9호선,증미,2212,2437,4649
202102,9호선,등촌,3643,3960,7603
202102,9호선,염창,6068,6297,12365
202102,9호선,신목동,1345,1180,2525
202102,9호선,선유도,1761,1955,3716
202102,9호선,당산,5955,6334,12289
202102,9호선,국회의사당,1629,1610,3239
202102,9호선,여의도,4025,4047,8072
202102,9호선,샛강,1251,1234,2485
202102,9호선,노량진,10294,11590,21884
202102,9호선,노들,1769,1601,3370
202102,9호선,흑석,2721,2922,5643
202102,9호선,동작,740,608,1348
202102,9호선,구반포,825,910,1735
202102,9호선,신반포,1026,964,1990
202102,9호선,고속터미널,9239,8644,17883
202102,9호선,사평,1063,999,2062
202102,9호선,신논현,11642,11666,23308
202102,9호선,언주,1895,2110,4005
202102,9호선,선정릉,1956,2391,4347
202102,9호선,삼성중앙,1372,1461,2833
202102,9호선,봉은사,5079,5373,10452
202102,9호선,종합운동장,1465,1488,2953
202102,9호선,삼전,2536,2660,5196
202102,9호선,석촌고분,2095,2311,4406
202102,9호선,석촌,3199,3049,6248
202102,9호선,송파나루,1923,2418,4341
202102,9호선,한성백제,949,915,1864
202102,9호선,올림픽공원,2393,2354,4747
202102,9호선,둔촌오륜,273,299,572
202102,9호선,중앙보훈병원,2462,2293,4755
202102,9호선,노량진,9918,11574,21492
202102,9호선,중앙보훈병원,2325,2216,4541
202102,9호선,둔촌오륜,322,339,661
202102,9호선,올림픽공원,2311,2350,4661
202102,9호선,한성백제,972,1028,2000
202102,9호선,송파나루,2004,2503,4507
202102,9호선,석촌,3219,3123,6342
202102,9호선,석촌고분,2270,2455,4725
202102,9호선,삼전,2578,2923,5501
202102,9호선,종합운동장,1514,1523,3037
202102,9호선,봉은사,5424,5548,10972
202102,9호선,삼성중앙,1305,1504,2809
202102,9호선,선정릉,2031,2500,4531
202102,9호선,언주,2053,2320,4373
202102,9호선,신논현,11297,11348,22645
202102,9호선,사평,959,1071,2030
202102,9호선,고속터미널,10938,9036,19974
202102,9호선,신반포,1088,1054,2142
202102,9호선,구반포,893,953,1846
202102,9호선,동작,753,612,1365
202102,9호선,흑석,2753,3046,5799
202102,9호선,노들,1770,1622,3392
202102,9호선,샛강,1170,1178,2348
202102,9호선,여의도,3982,4045,8027
202102,9호선,국회의사당,2722,2672,5394
202102,9호선,당산,6040,6661,12701
202102,9호선,선유도,1886,2136,4022
202102,9호선,신목동,1249,1084,2333
202102,9호선,염창,5963,6644,12607
202102,9호선,등촌,3633,4028,7661
202102,9호선,증미,1787,2068,3855
202102,9호선,가양,7114,7536,14650
202102,9호선,양천향교,2880,3511,6391
202102,9호선,마곡나루,3498,4007,7505
202102,9호선,신방화,2610,2673,5283
202102,9호선,공항시장,1243,1401,2644
202102,9호선,김포공항,7844,9263,17107
202102,9호선,개화,823,727,1550
202102,9호선,중앙보훈병원,3716,3464,7180
202102,9호선,둔촌오륜,566,535,1101
202102,9호선,올림픽공원,3554,3431,6985
202102,9호선,한성백제,1694,1449,3143
202102,9호선,송파나루,3392,3766,7158
202102,9호선,석촌,5879,4861,10740
202102,9호선,석촌고분,3891,3739,7630
202102,9호선,삼전,4381,4081,8462
202102,9호선,종합운동장,2920,2631,5551
202102,9호선,봉은사,9135,9292,18427
202102,9호선,삼성중앙,2777,2822,5599
202102,9호선,선정릉,4473,4878,9351
202102,9호선,언주,5632,5696,11328
202102,9호선,신논현,24188,23716,47904
202102,9호선,사평,1751,1682,3433
202102,9호선,고속터미널,10186,14096,24282
202102,9호선,신반포,2111,2028,4139
202102,9호선,구반포,1945,2099,4044
202102,9호선,동작,1163,986,2149
202102,9호선,흑석,4906,4854,9760
202102,9호선,노들,2848,2355,5203
202102,9호선,노량진,17350,17613,34963
202102,9호선,샛강,2179,2086,4265
202102,9호선,여의도,7620,7363,14983
202102,9호선,국회의사당,3460,3619,7079
202102,9호선,당산,11344,10554,21898
202102,9호선,선유도,3350,3243,6593
202102,9호선,신목동,2082,1745,3827
202102,9호선,염창,10298,9672,19970
202102,9호선,등촌,6498,6354,12852
202102,9호선,증미,3853,3732,7585
202102,9호선,가양,12615,11973,24588
202102,9호선,양천향교,5325,5111,10436
202102,9호선,마곡나루,6934,7002,13936
202102,9호선,신방화,4089,3928,8017
202102,9호선,공항시장,2018,2264,4282
202102,9호선,김포공항,7215,10563,17778
202102,9호선,개화,1178,970,2148
202102,9호선,중앙보훈병원,2608,2543,5151
202102,9호선,둔촌오륜,385,392,777
202102,9호선,올림픽공원,2562,2634,5196
202102,9호선,한성백제,1300,1083,2383
202102,9호선,송파나루,2465,2690,5155
202102,9호선,석촌,3878,3297,7175
202102,9호선,석촌고분,2642,2535,5177
202102,9호선,삼전,2980,2997,5977
202102,9호선,종합운동장,1725,1600,3325
202102,9호선,봉은사,6017,5929,11946
202102,9호선,삼성중앙,1579,1622,3201
202102,9호선,선정릉,2773,3020,5793
202102,9호선,언주,3311,3287,6598
202102,9호선,신논현,14063,13489,27552
202102,9호선,사평,1116,1181,2297
202102,9호선,고속터미널,7909,10358,18267
202102,9호선,신반포,1415,1442,2857
202102,9호선,구반포,1161,1217,2378
202102,9호선,동작,986,814,1800
202102,9호선,흑석,3320,3581,6901
202102,9호선,노들,2122,1859,3981
202102,9호선,노량진,11946,12671,24617
202102,9호선,샛강,1547,1563,3110
202102,9호선,여의도,5316,4990,10306
202102,9호선,국회의사당,3849,3520,7369
202102,9호선,당산,7339,7011,14350
202102,9호선,선유도,2451,2376,4827
202102,9호선,신목동,1430,1292,2722
202102,9호선,염창,7275,7146,14421
202102,9호선,등촌,4465,4534,8999
202102,9호선,증미,2630,2661,5291
202102,9호선,가양,8846,8814,17660
202102,9호선,양천향교,3612,3740,7352
202102,9호선,마곡나루,5110,5129,10239
202102,9호선,신방화,3023,3005,6028
202102,9호선,공항시장,1521,1676,3197
202102,9호선,김포공항,6498,9829,16327
202102,9호선,개화,910,821,1731
202102,9호선,개화,1393,1112,2505
202102,9호선,김포공항,7287,12305,19592
202102,9호선,공항시장,2067,2241,4308
202102,9호선,신방화,4438,4203,8641
202102,9호선,마곡나루,7320,7157,14477
202102,9호선,양천향교,5515,5195,10710
202102,9호선,가양,13481,12798,26279
202102,9호선,증미,4075,3973,8048
202102,9호선,등촌,6829,6561,13390
202102,9호선,염창,10974,10138,21112
202102,9호선,신목동,2047,1854,3901
202102,9호선,선유도,3653,3650,7303
202102,9호선,당산,12328,11117,23445
202102,9호선,국회의사당,3937,3970,7907
202102,9호선,여의도,16512,15801,32313
202102,9호선,샛강,2498,2297,4795
202102,9호선,노량진,18904,18983,37887
202102,9호선,노들,3053,2604,5657
202102,9호선,흑석,5295,5277,10572
202102,9호선,동작,1445,1195,2640
202102,9호선,구반포,2015,2191,4206
202102,9호선,신반포,2295,2268,4563
202102,9호선,고속터미널,11120,16478,27598
202102,9호선,사평,1962,1883,3845
202102,9호선,신논현,25437,25242,50679
202102,9호선,언주,5476,5365,10841
202102,9호선,선정릉,4944,5498,10442
202102,9호선,삼성중앙,2841,2872,5713
202102,9호선,봉은사,9695,10084,19779
202102,9호선,종합운동장,2727,2521,5248
202102,9호선,삼전,4700,4251,8951
202102,9호선,석촌고분,3937,3719,7656
202102,9호선,석촌,5893,4900,10793
202102,9호선,송파나루,3552,3813,7365
202102,9호선,한성백제,1777,1444,3221
202102,9호선,올림픽공원,3845,3856,7701
202102,9호선,둔촌오륜,627,569,1196
202102,9호선,중앙보훈병원,4012,3675,7687
202102,9호선,개화,960,885,1845
202102,9호선,김포공항,6478,10319,16797
202102,9호선,공항시장,1588,1704,3292
202102,9호선,신방화,3271,3172,6443
202102,9호선,마곡나루,5472,5453,10925
202102,9호선,양천향교,3843,3850,7693
202102,9호선,가양,9797,9232,19029
202102,9호선,증미,2341,2351,4692
202102,9호선,등촌,4734,4838,9572
202102,9호선,염창,8004,7642,15646
202102,9호선,신목동,1567,1372,2939
202102,9호선,선유도,2697,2741,5438
202102,9호선,당산,8386,7880,16266
202102,9호선,국회의사당,4005,3637,7642
202102,9호선,여의도,13862,12940,26802
202102,9호선,샛강,1741,1557,3298
202102,9호선,노량진,13442,14147,27589
202102,9호선,노들,2427,2150,4577
202102,9호선,흑석,3619,3843,7462
202102,9호선,동작,1102,878,1980
202102,9호선,구반포,1075,1221,2296
202102,9호선,신반포,1388,1416,2804
202102,9호선,고속터미널,8450,11664,20114
202102,9호선,사평,1240,1228,2468
202102,9호선,신논현,15295,14923,30218
202102,9호선,언주,3265,3182,6447
202102,9호선,선정릉,3073,3308,6381
202102,9호선,삼성중앙,1730,1858,3588
202102,9호선,봉은사,7089,7138,14227
202102,9호선,종합운동장,1926,1760,3686
202102,9호선,삼전,3199,3151,6350
202102,9호선,석촌고분,2839,2704,5543
202102,9호선,석촌,4196,3625,7821
202102,9호선,송파나루,2553,2895,5448
202102,9호선,한성백제,1303,1042,2345
202102,9호선,올림픽공원,2736,2732,5468
202102,9호선,둔촌오륜,420,404,824
202102,9호선,중앙보훈병원,2803,2644,5447
202103,9호선,개화,1391,1201,2592
202103,9호선,김포공항,6781,11276,18057
202103,9호선,공항시장,2093,2221,4314
202103,9호선,신방화,4385,4352,8737
202103,9호선,마곡나루,7278,7079,14357
202103,9호선,양천향교,5581,5428,11009
202103,9호선,가양,13184,12548,25732
202103,9호선,증미,3866,3881,7747
202103,9호선,등촌,6776,6720,13496
202103,9호선,염창,10715,10224,20939
202103,9호선,신목동,2174,1926,4100
202103,9호선,선유도,3586,3581,7167
202103,9호선,당산,12196,11281,23477
202103,9호선,국회의사당,3813,3958,7771
202103,9호선,여의도,13740,12587,26327
202103,9호선,샛강,2495,2374,4869
202103,9호선,노량진,19365,19436,38801
202103,9호선,노들,2946,2635,5581
202103,9호선,흑석,5377,5322,10699
202103,9호선,동작,1209,1044,2253
202103,9호선,구반포,1976,2021,3997
202103,9호선,신반포,2278,2200,4478
202103,9호선,고속터미널,11000,14878,25878
202103,9호선,사평,2169,2012,4181
202103,9호선,신논현,25069,24676,49745
202103,9호선,언주,5661,5538,11199
202103,9호선,선정릉,4779,5244,10023
202103,9호선,삼성중앙,2863,2879,5742
202103,9호선,봉은사,11411,11871,23282
202103,9호선,종합운동장,2904,2530,5434
202103,9호선,삼전,4593,4321,8914
202103,9호선,석촌고분,4006,3850,7856
202103,9호선,석촌,5920,4883,10803
202103,9호선,송파나루,3733,3951,7684
202103,9호선,한성백제,1700,1532,3232
202103,9호선,올림픽공원,3827,3802,7629
202103,9호선,둔촌오륜,623,583,1206
202103,9호선,중앙보훈병원,3990,3741,7731
202103,9호선,노들,2283,2043,4326
202103,9호선,중앙보훈병원,2863,2713,5576
202103,9호선,둔촌오륜,399,408,807
202103,9호선,올림픽공원,2643,2811,5454
202103,9호선,한성백제,1353,1094,2447
202103,9호선,송파나루,2468,2787,5255
202103,9호선,석촌,4006,3505,7511
202103,9호선,석촌고분,2777,2774,5551
202103,9호선,삼전,3070,3105,6175
202103,9호선,종합운동장,1899,1738,3637
202103,9호선,봉은사,7731,7738,15469
202103,9호선,삼성중앙,1839,1886,3725
202103,9호선,선정릉,2894,3272,6166
202103,9호선,언주,3298,3163,6461
202103,9호선,신논현,14510,13704,28214
202103,9호선,사평,1226,1310,2536
202103,9호선,고속터미널,8486,11326,19812
202103,9호선,신반포,1386,1536,2922
202103,9호선,구반포,1091,1217,2308
202103,9호선,동작,1014,863,1877
202103,9호선,흑석,3621,3875,7496
202103,9호선,노량진,12992,13849,26841
202103,9호선,샛강,1669,1583,3252
202103,9호선,여의도,10401,9416,19817
202103,9호선,국회의사당,4067,3663,7730
202103,9호선,당산,8097,7757,15854
202103,9호선,선유도,2539,2552,5091
202103,9호선,신목동,1570,1427,2997
202103,9호선,염창,7654,7513,15167
202103,9호선,등촌,4761,4801,9562
202103,9호선,증미,2762,2942,5704
202103,9호선,가양,9641,9488,19129
202103,9호선,양천향교,3828,3982,7810
202103,9호선,마곡나루,4950,4964,9914
202103,9호선,신방화,3050,2928,5978
202103,9호선,공항시장,1627,1828,3455
202103,9호선,김포공항,6381,9403,15784
202103,9호선,개화,1040,901,1941
202103,9호선,개화,1365,1163,2528
202103,9호선,김포공항,7179,11952,19131
202103,9호선,공항시장,2129,2228,4357
202103,9호선,신방화,4409,4301,8710
202103,9호선,마곡나루,7481,7362,14843
202103,9호선,양천향교,5510,5522,11032
202103,9호선,가양,13244,12606,25850
202103,9호선,증미,4040,3937,7977
202103,9호선,등촌,6919,6663,13582
202103,9호선,염창,10987,10464,21451
202103,9호선,신목동,2223,1992,4215
202103,9호선,선유도,3535,3610,7145
202103,9호선,당산,11952,10977,22929
202103,9호선,국회의사당,3909,4095,8004
202103,9호선,여의도,13727,13004,26731
202103,9호선,샛강,2566,2466,5032
202103,9호선,노량진,20224,20041,40265
202103,9호선,노들,3064,2553,5617
202103,9호선,흑석,5555,5574,11129
202103,9호선,동작,1330,1072,2402
202103,9호선,구반포,1918,2076,3994
202103,9호선,신반포,2359,2319,4678
202103,9호선,고속터미널,11426,16251,27677
202103,9호선,사평,1901,1867,3768
202103,9호선,신논현,25552,24926,50478
202103,9호선,언주,5763,5680,11443
202103,9호선,선정릉,4856,5282,10138
202103,9호선,삼성중앙,2994,3095,6089
202103,9호선,봉은사,10224,10585,20809
202103,9호선,종합운동장,3009,2544,5553
202103,9호선,삼전,4752,4288,9040
202103,9호선,석촌고분,3955,3843,7798
202103,9호선,석촌,6301,5143,11444
202103,9호선,송파나루,3589,4004,7593
202103,9호선,한성백제,1748,1555,3303
202103,9호선,올림픽공원,3928,3916,7844
202103,9호선,둔촌오륜,624,597,1221
202103,9호선,중앙보훈병원,4305,3957,8262
202103,9호선,중앙보훈병원,2927,2733,5660
202103,9호선,둔촌오륜,431,446,877
202103,9호선,올림픽공원,2692,2757,5449
202103,9호선,한성백제,1215,1168,2383
202103,9호선,송파나루,2545,2751,5296
202103,9호선,석촌,4234,3613,7847
202103,9호선,석촌고분,2699,2732,5431
202103,9호선,삼전,3173,3144,6317
202103,9호선,종합운동장,1815,1696,3511
202103,9호선,봉은사,6986,6876,13862
202103,9호선,삼성중앙,1780,1814,3594
202103,9호선,선정릉,2795,3167,5962
202103,9호선,언주,3376,3309,6685
202103,9호선,신논현,14225,13566,27791
202103,9호선,사평,1177,1178,2355
202103,9호선,고속터미널,9066,12475,21541
202103,9호선,신반포,1354,1514,2868
202103,9호선,구반포,1104,1150,2254
202103,9호선,동작,1071,868,1939
202103,9호선,흑석,3701,3895,7596
202103,9호선,노들,2330,2060,4390
202103,9호선,노량진,13576,14980,28556
202103,9호선,샛강,1761,1638,3399
202103,9호선,여의도,10347,9419,19766
202103,9호선,국회의사당,3996,3608,7604
202103,9호선,당산,8015,7644,15659
202103,9호선,선유도,2513,2441,4954
202103,9호선,신목동,1545,1319,2864
202103,9호선,염창,7658,7733,15391
202103,9호선,등촌,4683,4668,9351
202103,9호선,증미,2304,2347,4651
202103,9호선,가양,9125,9087,18212
202103,9호선,양천향교,3739,3958,7697
202103,9호선,마곡나루,5233,5211,10444
202103,9호선,신방화,3096,3035,6131
202103,9호선,공항시장,1545,1720,3265
202103,9호선,김포공항,6692,10534,17226
202103,9호선,개화,966,821,1787
202103,9호선,개화,1209,1016,2225
202103,9호선,김포공항,6961,11769,18730
202103,9호선,공항시장,2079,2113,4192
202103,9호선,신방화,4285,4092,8377
202103,9호선,마곡나루,6890,7055,13945
202103,9호선,양천향교,5373,5158,10531
202103,9호선,가양,12680,11990,24670
202103,9호선,증미,3875,3759,7634
202103,9호선,등촌,6523,6359,12882
202103,9호선,염창,10245,9614,19859
202103,9호선,신목동,1937,1648,3585
202103,9호선,선유도,3266,3253,6519
202103,9호선,당산,11804,10899,22703
202103,9호선,국회의사당,4006,4270,8276
202103,9호선,여의도,11777,10649,22426
202103,9호선,샛강,2348,2356,4704
202103,9호선,노량진,19395,19243,38638
202103,9호선,노들,2750,2315,5065
202103,9호선,흑석,4905,4877,9782
202103,9호선,동작,1138,906,2044
202103,9호선,구반포,2047,2141,4188
202103,9호선,신반포,2100,2004,4104
202103,9호선,고속터미널,10339,15133,25472
202103,9호선,사평,1880,1786,3666
202103,9호선,신논현,24447,24179,48626
202103,9호선,언주,6025,5797,11822
202103,9호선,선정릉,4751,5241,9992
202103,9호선,삼성중앙,2867,2880,5747
202103,9호선,봉은사,10875,11403,22278
202103,9호선,종합운동장,3070,2648,5718
202103,9호선,삼전,4349,4111,8460
202103,9호선,석촌고분,3837,3661,7498
202103,9호선,석촌,5807,4834,10641
202103,9호선,송파나루,3541,3845,7386
202103,9호선,한성백제,1490,1335,2825
202103,9호선,올림픽공원,3380,3249,6629
202103,9호선,둔촌오륜,611,571,1182
202103,9호선,중앙보훈병원,3808,3473,7281
202103,9호선,개화,1006,881,1887
202103,9호선,김포공항,6728,10943,17671
202103,9호선,공항시장,1556,1724,3280
202103,9호선,신방화,3268,3215,6483
202103,9호선,마곡나루,5363,5286,10649
202103,9호선,양천향교,4006,4142,8148
202103,9호선,가양,9511,9561,19072
202103,9호선,증미,2870,2905,5775
202103,9호선,등촌,4728,4990,9718
202103,9호선,염창,7732,7878,15610
202103,9호선,신목동,1542,1358,2900
202103,9호선,선유도,2431,2483,4914
202103,9호선,당산,8229,8068,16297
202103,9호선,국회의사당,4100,3905,8005
202103,9호선,여의도,9640,7973,17613
202103,9호선,샛강,1714,1601,3315
202103,9호선,노량진,13885,14559,28444
202103,9호선,노들,2237,2074,4311
202103,9호선,흑석,3485,3770,7255
202103,9호선,동작,1020,871,1891
202103,9호선,구반포,1079,1135,2214
202103,9호선,신반포,1461,1502,2963
202103,9호선,고속터미널,8751,12145,20896
202103,9호선,사평,1248,1296,2544
202103,9호선,신논현,14748,13956,28704
202103,9호선,언주,3614,3589,7203
202103,9호선,선정릉,2954,3415,6369
202103,9호선,삼성중앙,1723,1794,3517
202103,9호선,봉은사,7559,7613,15172
202103,9호선,종합운동장,2002,1771,3773
202103,9호선,삼전,3298,3342,6640
202103,9호선,석촌고분,2792,2758,5550
202103,9호선,석촌,4180,3645,7825
202103,9호선,송파나루,2716,2958,5674
202103,9호선,한성백제,1258,1179,2437
202103,9호선,올림픽공원,2734,2700,5434
202103,9호선,둔촌오륜,397,415,812
202103,9호선,중앙보훈병원,2912,2745,5657
202103,9호선,중앙보훈병원,3923,3485,7408
202103,9호선,둔촌오륜,650,595,1245
202103,9호선,올림픽공원,3295,3187,6482
202103,9호선,한성백제,1559,1371,2930
202103,9호선,송파나루,3836,4011,7847
202103,9호선,석촌,5737,4685,10422
202103,9호선,석촌고분,3929,3822,7751
202103,9호선,삼전,4475,4250,8725
202103,9호선,종합운동장,3340,2755,6095
202103,9호선,봉은사,10134,10291,20425
202103,9호선,삼성중앙,2927,2928,5855
202103,9호선,선정릉,4534,5195,9729
202103,9호선,언주,5560,5556,11116
202103,9호선,신논현,24521,23781,48302
202103,9호선,사평,2007,1973,3980
202103,9호선,고속터미널,10571,15353,25924
202103,9호선,신반포,2175,2169,4344
202103,9호선,구반포,1865,1981,3846
202103,9호선,동작,1207,972,2179
202103,9호선,흑석,5193,5276,10469
202103,9호선,노들,2796,2520,5316
202103,9호선,노량진,19898,19519,39417
202103,9호선,샛강,2440,2459,4899
202103,9호선,여의도,12800,11115,23915
202103,9호선,국회의사당,3910,4196,8106
202103,9호선,당산,11951,10946,22897
202103,9호선,선유도,3300,3400,6700
202103,9호선,신목동,1990,1883,3873
202103,9호선,염창,10454,9962,20416
202103,9호선,등촌,6695,6542,13237
202103,9호선,증미,3783,3824,7607
202103,9호선,가양,12556,11875,24431
202103,9호선,양천향교,5450,5269,10719
202103,9호선,마곡나루,6942,6806,13748
202103,9호선,신방화,4311,4322,8633
202103,9호선,공항시장,2077,2179,4256
202103,9호선,김포공항,7279,11281,18560
202103,9호선,개화,1328,1095,2423
202103,9호선,중앙보훈병원,2477,2327,4804
202103,9호선,둔촌오륜,351,362,713
202103,9호선,올림픽공원,2470,2459,4929
202103,9호선,한성백제,1105,1028,2133
202103,9호선,송파나루,2454,2693,5147
202103,9호선,석촌,4070,3519,7589
202103,9호선,석촌고분,2605,2654,5259
202103,9호선,삼전,3007,2935,5942
202103,9호선,종합운동장,1801,1661,3462
202103,9호선,봉은사,6698,6445,13143
202103,9호선,삼성중앙,1742,1815,3557
202103,9호선,선정릉,2616,2854,5470
202103,9호선,언주,3122,3204,6326
202103,9호선,신논현,13456,12918,26374
202103,9호선,사평,1133,1208,2341
202103,9호선,고속터미널,8641,11746,20387
202103,9호선,신반포,1333,1354,2687
202103,9호선,구반포,1000,1062,2062
202103,9호선,동작,1008,845,1853
202103,9호선,흑석,3332,3593,6925
202103,9호선,노들,2033,1799,3832
202103,9호선,노량진,13195,14081,27276
202103,9호선,샛강,1478,1458,2936
202103,9호선,여의도,8968,8039,17007
202103,9호선,국회의사당,4159,3777,7936
202103,9호선,당산,7529,7278,14807
202103,9호선,선유도,2295,2336,4631
202103,9호선,신목동,1463,1328,2791
202103,9호선,염창,7024,7139,14163
202103,9호선,등촌,4352,4558,8910
202103,9호선,증미,2264,2262,4526
202103,9호선,가양,8627,8495,17122
202103,9호선,양천향교,3631,3877,7508
202103,9호선,마곡나루,4937,4873,9810
202103,9호선,신방화,2908,2866,5774
202103,9호선,공항시장,1515,1691,3206
202103,9호선,김포공항,6586,9809,16395
202103,9호선,개화,841,811,1652
202104,9호선,개화,1062,940,2002
202104,9호선,김포공항,6953,11375,18328
202104,9호선,공항시장,1927,2092,4019
202104,9호선,신방화,4040,3914,7954
202104,9호선,마곡나루,6478,6403,12881
202104,9호선,양천향교,5041,5048,10089
202104,9호선,가양,11237,10792,22029
202104,9호선,증미,3593,3592,7185
202104,9호선,등촌,6256,6172,12428
202104,9호선,염창,9652,9108,18760
202104,9호선,신목동,1799,1577,3376
202104,9호선,선유도,3083,2998,6081
202104,9호선,당산,10780,9839,20619
202104,9호선,국회의사당,4238,4099,8337
202104,9호선,여의도,11781,10376,22157
202104,9호선,샛강,2456,2171,4627
202104,9호선,노량진,18021,17590,35611
202104,9호선,노들,2451,2238,4689
202104,9호선,흑석,4502,4538,9040
202104,9호선,동작,1087,925,2012
202104,9호선,구반포,1783,1907,3690
202104,9호선,신반포,2059,1972,4031
202104,9호선,고속터미널,9810,14377,24187
202104,9호선,사평,1877,1816,3693
202104,9호선,신논현,22297,21774,44071
202104,9호선,언주,5670,5416,11086
202104,9호선,선정릉,4209,4619,8828
202104,9호선,삼성중앙,2840,2873,5713
202104,9호선,봉은사,9401,9698,19099
202104,9호선,종합운동장,3041,2508,5549
202104,9호선,삼전,4214,3975,8189
202104,9호선,석촌고분,3667,3519,7186
202104,9호선,석촌,5363,4319,9682
202104,9호선,송파나루,3545,3624,7169
202104,9호선,한성백제,1450,1305,2755
202104,9호선,올림픽공원,2973,2964,5937
202104,9호선,둔촌오륜,521,525,1046
202104,9호선,중앙보훈병원,3355,3026,6381
202104,9호선,개화,985,894,1879
202104,9호선,김포공항,7061,10391,17452
202104,9호선,공항시장,1624,1782,3406
202104,9호선,신방화,3189,3149,6338
202104,9호선,마곡나루,5144,5171,10315
202104,9호선,양천향교,3802,4049,7851
202104,9호선,가양,9270,9502,18772
202104,9호선,증미,2995,3110,6105
202104,9호선,등촌,4822,4928,9750
202104,9호선,염창,7605,7774,15379
202104,9호선,신목동,1511,1396,2907
202104,9호선,선유도,2843,2909,5752
202104,9호선,당산,8240,8047,16287
202104,9호선,국회의사당,5506,4693,10199
202104,9호선,여의도,10081,8577,18658
202104,9호선,샛강,1922,1778,3700
202104,9호선,노량진,13663,14458,28121
202104,9호선,노들,2494,2189,4683
202104,9호선,흑석,3568,3943,7511
202104,9호선,동작,1158,1045,2203
202104,9호선,구반포,1083,1188,2271
202104,9호선,신반포,1562,1639,3201
202104,9호선,고속터미널,9115,12014,21129
202104,9호선,사평,1188,1284,2472
202104,9호선,신논현,13821,13337,27158
202104,9호선,언주,3186,3053,6239
202104,9호선,선정릉,2780,3040,5820
202104,9호선,삼성중앙,1636,1734,3370
202104,9호선,봉은사,5839,5557,11396
202104,9호선,종합운동장,2061,1832,3893
202104,9호선,삼전,3107,3193,6300
202104,9호선,석촌고분,2742,2785,5527
202104,9호선,석촌,4099,3675,7774
202104,9호선,송파나루,2660,2892,5552
202104,9호선,한성백제,1485,1305,2790
202104,9호선,올림픽공원,3206,3217,6423
202104,9호선,둔촌오륜,337,339,676
202104,9호선,중앙보훈병원,2874,2661,5535
202104,9호선,중앙보훈병원,4214,3962,8176
202104,9호선,둔촌오륜,645,601,1246
202104,9호선,올림픽공원,4383,4515,8898
202104,9호선,한성백제,1875,1533,3408
202104,9호선,송파나루,3652,3910,7562
202104,9호선,석촌,6403,5466,11869
202104,9호선,석촌고분,3980,3794,7774
202104,9호선,삼전,4796,4433,9229
202104,9호선,종합운동장,3439,2829,6268
202104,9호선,봉은사,10050,10455,20505
202104,9호선,삼성중앙,2918,2917,5835
202104,9호선,선정릉,4562,5393,9955
202104,9호선,언주,5564,5536,11100
202104,9호선,신논현,24802,24113,48915
202104,9호선,사평,1929,1788,3717
202104,9호선,고속터미널,12148,17048,29196
202104,9호선,신반포,2606,2637,5243
202104,9호선,구반포,1974,2116,4090
202104,9호선,동작,1327,1154,2481
202104,9호선,흑석,5549,5512,11061
202104,9호선,노들,3287,2852,6139
202104,9호선,노량진,19977,19829,39806
202104,9호선,샛강,2577,2374,4951
202104,9호선,여의도,12565,11670,24235
202104,9호선,국회의사당,3976,4070,8046
202104,9호선,당산,12048,11073,23121
202104,9호선,선유도,3899,4100,7999
202104,9호선,신목동,2254,1974,4228
202104,9호선,염창,11166,10498,21664
202104,9호선,등촌,6983,6782,13765
202104,9호선,증미,3959,3928,7887
202104,9호선,가양,13411,12755,26166
202104,9호선,양천향교,5667,5416,11083
202104,9호선,마곡나루,8229,8120,16349
202104,9호선,신방화,4412,4155,8567
202104,9호선,공항시장,2162,2302,4464
202104,9호선,김포공항,8027,11946,19973
202104,9호선,개화,1444,1236,2680
202104,9호선,중앙보훈병원,3362,3161,6523
202104,9호선,둔촌오륜,341,345,686
202104,9호선,올림픽공원,3086,3275,6361
202104,9호선,한성백제,1394,1249,2643
202104,9호선,송파나루,2603,2783,5386
202104,9호선,석촌,4230,3819,8049
202104,9호선,석촌고분,2687,2678,5365
202104,9호선,삼전,3337,3348,6685
202104,9호선,종합운동장,1934,1786,3720
202104,9호선,봉은사,6915,7005,13920
202104,9호선,삼성중앙,1667,1781,3448
202104,9호선,선정릉,2930,3338,6268
202104,9호선,언주,3597,3608,7205
202104,9호선,신논현,14181,13474,27655
202104,9호선,사평,1173,1228,2401
202104,9호선,고속터미널,9464,12389,21853
202104,9호선,신반포,1628,1804,3432
202104,9호선,구반포,1242,1339,2581
202104,9호선,동작,1068,881,1949
202104,9호선,흑석,3604,3732,7336
202104,9호선,노들,2464,2208,4672
202104,9호선,노량진,13540,14714,28254
202104,9호선,샛강,1652,1605,3257
202104,9호선,여의도,8813,8135,16948
202104,9호선,국회의사당,4111,3894,8005
202104,9호선,당산,8163,7978,16141
202104,9호선,선유도,2879,3016,5895
202104,9호선,신목동,1548,1390,2938
202104,9호선,염창,7876,7831,15707
202104,9호선,증미,2346,2408,4754
202104,9호선,가양,9393,9330,18723
202104,9호선,양천향교,3868,4062,7930
202104,9호선,마곡나루,5573,5670,11243
202104,9호선,신방화,3100,3124,6224
202104,9호선,공항시장,1602,1703,3305
202104,9호선,김포공항,7194,9899,17093
202104,9호선,개화,1054,929,1983
202104,9호선,등촌,4856,4979,9835
202104,9호선,개화,1317,1087,2404
202104,9호선,김포공항,7386,11983,19369
202104,9호선,공항시장,1956,2140,4096
202104,9호선,신방화,4321,4138,8459
202104,9호선,마곡나루,7335,7234,14569
202104,9호선,양천향교,5681,5502,11183
202104,9호선,가양,13046,12307,25353
202104,9호선,증미,3784,3838,7622
202104,9호선,등촌,6770,6415,13185
202104,9호선,염창,10958,10402,21360
202104,9호선,신목동,2191,1939,4130
202104,9호선,선유도,3692,3659,7351
202104,9호선,당산,12002,10989,22991
202104,9호선,국회의사당,3779,4014,7793
202104,9호선,여의도,11867,11081,22948
202104,9호선,샛강,2554,2392,4946
202104,9호선,노량진,20274,20091,40365
202104,9호선,노들,2867,2452,5319
202104,9호선,흑석,4854,4878,9732
202104,9호선,동작,1300,1031,2331
202104,9호선,구반포,2007,2161,4168
202104,9호선,신반포,2365,2288,4653
202104,9호선,고속터미널,10795,14903,25698
202104,9호선,사평,2069,2000,4069
202104,9호선,신논현,23335,22867,46202
202104,9호선,언주,5324,5295,10619
202104,9호선,선정릉,4429,4914,9343
202104,9호선,삼성중앙,2831,2833,5664
202104,9호선,봉은사,9082,9435,18517
202104,9호선,종합운동장,3149,2648,5797
202104,9호선,삼전,4454,4190,8644
202104,9호선,석촌고분,3824,3629,7453
202104,9호선,석촌,5969,4963,10932
202104,9호선,송파나루,3537,3660,7197
202104,9호선,한성백제,1656,1410,3066
202104,9호선,올림픽공원,3652,3647,7299
202104,9호선,둔촌오륜,576,554,1130
202104,9호선,중앙보훈병원,3961,3705,7666
202104,9호선,중앙보훈병원,2906,2759,5665
202104,9호선,둔촌오륜,399,424,823
202104,9호선,올림픽공원,3081,3126,6207
202104,9호선,한성백제,1316,1199,2515
202104,9호선,송파나루,2494,2791,5285
202104,9호선,석촌,4061,3620,7681
202104,9호선,석촌고분,2730,2710,5440
202104,9호선,삼전,3229,3153,6382
202104,9호선,종합운동장,1929,1692,3621
202104,9호선,봉은사,6325,6265,12590
202104,9호선,삼성중앙,1731,1797,3528
202104,9호선,선정릉,2956,3298,6254
202104,9호선,언주,2872,2939,5811
202104,9호선,신논현,13421,12741,26162
202104,9호선,사평,1149,1232,2381
202104,9호선,고속터미널,8931,11722,20653
202104,9호선,신반포,1450,1535,2985
202104,9호선,구반포,1067,1199,2266
202104,9호선,동작,1072,888,1960
202104,9호선,흑석,3384,3642,7026
202104,9호선,노들,2357,2200,4557
202104,9호선,노량진,13547,14601,28148
202104,9호선,샛강,1564,1487,3051
202104,9호선,여의도,8370,7397,15767
202104,9호선,국회의사당,4059,3780,7839
202104,9호선,당산,7970,7851,15821
202104,9호선,선유도,2782,2752,5534
202104,9호선,신목동,1548,1365,2913
202104,9호선,염창,7606,7590,15196
202104,9호선,등촌,4844,4992,9836
202104,9호선,증미,2783,2876,5659
202104,9호선,가양,9171,9148,18319
202104,9호선,양천향교,3836,4127,7963
202104,9호선,마곡나루,5485,5500,10985
202104,9호선,신방화,3073,3100,6173
202104,9호선,공항시장,1522,1642,3164
202104,9호선,김포공항,7248,10175,17423
202104,9호선,개화,1055,975,2030
202104,9호선,중앙보훈병원,4162,3818,7980
202104,9호선,둔촌오륜,594,544,1138
202104,9호선,올림픽공원,3882,3960,7842
202104,9호선,한성백제,1720,1454,3174
202104,9호선,송파나루,3413,3720,7133
202104,9호선,석촌,6039,4985,11024
202104,9호선,석촌고분,3911,3609,7520
202104,9호선,삼전,4564,4163,8727
202104,9호선,종합운동장,2797,2543,5340
202104,9호선,봉은사,8735,9055,17790
202104,9호선,삼성중앙,2708,2775,5483
202104,9호선,선정릉,4693,5204,9897
202104,9호선,언주,5501,5390,10891
202104,9호선,신논현,23810,23559,47369
202104,9호선,사평,2291,2086,4377
202104,9호선,고속터미널,11841,16793,28634
202104,9호선,신반포,2541,2501,5042
202104,9호선,구반포,2072,2231,4303
202104,9호선,동작,1422,1194,2616
202104,9호선,흑석,5278,5334,10612
202104,9호선,노들,3096,2708,5804
202104,9호선,노량진,19971,20089,40060
202104,9호선,샛강,2410,2373,4783
202104,9호선,여의도,11395,11123,22518
202104,9호선,국회의사당,3937,4035,7972
202104,9호선,당산,12038,11278,23316
202104,9호선,선유도,3834,3829,7663
202104,9호선,신목동,2314,1932,4246
202104,9호선,염창,10989,10230,21219
202104,9호선,등촌,6891,6738,13629
202104,9호선,증미,3997,3956,7953
202104,9호선,가양,13256,12418,25674
202104,9호선,양천향교,5571,5395,10966
202104,9호선,마곡나루,7586,7573,15159
202104,9호선,신방화,4328,4148,8476
202104,9호선,공항시장,2231,2302,4533
202104,9호선,김포공항,7522,12225,19747
202104,9호선,개화,1425,1237,2662
202104,9호선,중앙보훈병원,3131,2999,6130
202104,9호선,둔촌오륜,357,389,746
202104,9호선,올림픽공원,3091,3239,6330
202104,9호선,한성백제,1379,1227,2606
202104,9호선,송파나루,2543,2697,5240
202104,9호선,석촌,4250,3700,7950
202104,9호선,석촌고분,2723,2702,5425
202104,9호선,삼전,3205,3192,6397
202104,9호선,종합운동장,1932,1762,3694
202104,9호선,봉은사,6108,6069,12177
202104,9호선,삼성중앙,1756,1789,3545
202104,9호선,선정릉,2964,3317,6281
202104,9호선,언주,3055,3203,6258
202104,9호선,신논현,13555,12884,26439
202104,9호선,사평,1231,1289,2520
202104,9호선,고속터미널,9557,12314,21871
202104,9호선,신반포,1490,1612,3102
202104,9호선,구반포,1206,1300,2506
202104,9호선,동작,1150,968,2118
202104,9호선,흑석,3515,3727,7242
202104,9호선,노들,2498,2205,4703
202104,9호선,노량진,13705,14865,28570
202104,9호선,샛강,1519,1594,3113
202104,9호선,여의도,8384,7719,16103
202104,9호선,국회의사당,4000,3717,7717
202104,9호선,당산,8300,8186,16486
202104,9호선,선유도,2985,3040,6025
202104,9호선,신목동,1596,1447,3043
202104,9호선,염창,7924,7860,15784
202104,9호선,등촌,4724,4970,9694
202104,9호선,증미,2400,2429,4829
202104,9호선,가양,9066,8914,17980
202104,9호선,양천향교,3952,4206,8158
202104,9호선,마곡나루,5750,5656,11406
202104,9호선,신방화,3091,3023,6114
202104,9호선,공항시장,1591,1855,3446
202104,9호선,김포공항,7142,10418,17560
202104,9호선,개화,1054,967,2021
202105,9호선,노량진,19486,19311,38797
202105,9호선,개화,1288,1077,2365
202105,9호선,김포공항,7751,11500,19251
202105,9호선,공항시장,2098,2187,4285
202105,9호선,신방화,4103,4065,8168
202105,9호선,마곡나루,7236,7108,14344
202105,9호선,양천향교,5204,5097,10301
202105,9호선,가양,12301,11673,23974
202105,9호선,증미,3690,3607,7297
202105,9호선,등촌,6385,6302,12687
202105,9호선,염창,10277,9441,19718
202105,9호선,신목동,2054,1733,3787
202105,9호선,선유도,3408,3357,6765
202105,9호선,당산,11175,10484,21659
202105,9호선,국회의사당,4086,4386,8472
202105,9호선,여의도,12402,10917,23319
202105,9호선,샛강,2390,2291,4681
202105,9호선,노들,2849,2431,5280
202105,9호선,흑석,4591,4725,9316
202105,9호선,동작,1205,998,2203
202105,9호선,구반포,1954,2088,4042
202105,9호선,신반포,1889,1784,3673
202105,9호선,고속터미널,11244,16329,27573
202105,9호선,사평,1828,1711,3539
202105,9호선,신논현,22747,22080,44827
202105,9호선,언주,5248,5258,10506
202105,9호선,선정릉,4366,4930,9296
202105,9호선,삼성중앙,2754,2782,5536
202105,9호선,봉은사,10199,10736,20935
202105,9호선,종합운동장,3011,2657,5668
202105,9호선,삼전,4199,4035,8234
202105,9호선,석촌고분,3627,3588,7215
202105,9호선,석촌,5515,4623,10138
202105,9호선,송파나루,3654,3745,7399
202105,9호선,한성백제,1461,1241,2702
202105,9호선,올림픽공원,3200,3267,6467
202105,9호선,둔촌오륜,508,485,993
202105,9호선,중앙보훈병원,3600,3386,6986
202105,9호선,개화,1205,997,2202
202105,9호선,김포공항,7279,10645,17924
202105,9호선,공항시장,1593,1705,3298
202105,9호선,신방화,3083,3154,6237
202105,9호선,마곡나루,5635,5749,11384
202105,9호선,양천향교,3919,4066,7985
202105,9호선,가양,9320,9472,18792
202105,9호선,증미,2937,2929,5866
202105,9호선,염창,7871,7932,15803
202105,9호선,신목동,1809,1594,3403
202105,9호선,선유도,2951,3080,6031
202105,9호선,당산,8141,7958,16099
202105,9호선,국회의사당,4418,4259,8677
202105,9호선,여의도,9228,8331,17559
202105,9호선,샛강,1721,1685,3406
202105,9호선,노량진,13564,14536,28100
202105,9호선,노들,2468,2214,4682
202105,9호선,흑석,3784,4008,7792
202105,9호선,동작,1159,1000,2159
202105,9호선,구반포,1203,1217,2420
202105,9호선,신반포,1659,1749,3408
202105,9호선,고속터미널,10100,13399,23499
202105,9호선,사평,1207,1218,2425
202105,9호선,신논현,14592,14175,28767
202105,9호선,언주,2982,2840,5822
202105,9호선,선정릉,2810,3166,5976
202105,9호선,삼성중앙,1678,1826,3504
202105,9호선,봉은사,6625,6678,13303
202105,9호선,종합운동장,2071,1883,3954
202105,9호선,삼전,3244,3122,6366
202105,9호선,석촌고분,2845,2788,5633
202105,9호선,석촌,4251,3803,8054
202105,9호선,송파나루,2792,2961,5753
202105,9호선,한성백제,1427,1207,2634
202105,9호선,올림픽공원,3228,3299,6527
202105,9호선,둔촌오륜,422,469,891
202105,9호선,중앙보훈병원,3227,3023,6250
202105,9호선,등촌,4927,5056,9983
202105,9호선,개화,1280,1054,2334
202105,9호선,김포공항,7171,11597,18768
202105,9호선,공항시장,1878,2062,3940
202105,9호선,신방화,4111,3912,8023
202105,9호선,마곡나루,6387,6196,12583
202105,9호선,양천향교,5063,4827,9890
202105,9호선,가양,12360,11685,24045
202105,9호선,증미,3606,3617,7223
202105,9호선,등촌,6368,5986,12354
202105,9호선,염창,9964,9311,19275
202105,9호선,신목동,2068,1730,3798
202105,9호선,선유도,3279,3121,6400
202105,9호선,당산,10119,9353,19472
202105,9호선,국회의사당,3126,3190,6316
202105,9호선,여의도,9743,9084,18827
202105,9호선,샛강,2202,2284,4486
202105,9호선,노량진,18187,17586,35773
202105,9호선,노들,2749,2354,5103
202105,9호선,흑석,4835,4697,9532
202105,9호선,동작,1402,1120,2522
202105,9호선,구반포,1674,1759,3433
202105,9호선,신반포,2107,1941,4048
202105,9호선,고속터미널,10543,15869,26412
202105,9호선,사평,1844,1742,3586
202105,9호선,신논현,20246,19588,39834
202105,9호선,언주,4626,4606,9232
202105,9호선,선정릉,4158,4385,8543
202105,9호선,삼성중앙,2495,2491,4986
202105,9호선,봉은사,7598,7583,15181
202105,9호선,종합운동장,2772,2407,5179
202105,9호선,삼전,4157,3779,7936
202105,9호선,석촌고분,3566,3352,6918
202105,9호선,석촌,5425,4560,9985
202105,9호선,송파나루,3160,3240,6400
202105,9호선,한성백제,1386,1213,2599
202105,9호선,올림픽공원,3358,3479,6837
202105,9호선,둔촌오륜,548,532,1080
202105,9호선,중앙보훈병원,3639,3507,7146
202105,9호선,중앙보훈병원,3255,3010,6265
202105,9호선,둔촌오륜,419,446,865
202105,9호선,올림픽공원,3203,3257,6460
202105,9호선,한성백제,1277,1154,2431
202105,9호선,송파나루,2608,2985,5593
202105,9호선,석촌,4231,3885,8116
202105,9호선,석촌고분,2621,2835,5456
202105,9호선,삼전,3067,3267,6334
202105,9호선,종합운동장,2087,1933,4020
202105,9호선,봉은사,5958,5995,11953
202105,9호선,삼성중앙,1667,1757,3424
202105,9호선,선정릉,2673,3204,5877
202105,9호선,언주,3022,3126,6148
202105,9호선,신논현,14022,13738,27760
202105,9호선,사평,1226,1322,2548
202105,9호선,고속터미널,11071,12707,23778
202105,9호선,신반포,1518,1655,3173
202105,9호선,구반포,1179,1219,2398
202105,9호선,동작,1206,1038,2244
202105,9호선,흑석,3596,3859,7455
202105,9호선,노들,2459,2205,4664
202105,9호선,노량진,13152,14633,27785
202105,9호선,샛강,1586,1645,3231
202105,9호선,여의도,8202,7579,15781
202105,9호선,국회의사당,3886,3643,7529
202105,9호선,당산,8141,8172,16313
202105,9호선,선유도,2866,3075,5941
202105,9호선,신목동,1768,1512,3280
202105,9호선,염창,7822,8126,15948
202105,9호선,등촌,4659,5029,9688
202105,9호선,증미,2358,2501,4859
202105,9호선,가양,9149,9433,18582
202105,9호선,양천향교,3729,4279,8008
202105,9호선,마곡나루,5081,5343,10424
202105,9호선,신방화,3121,3220,6341
202105,9호선,공항시장,1618,1860,3478
202105,9호선,김포공항,7350,10832,18182
202105,9호선,개화,1102,1044,2146
202105,9호선,개화,1307,1083,2390
202105,9호선,김포공항,7806,11974,19780
202105,9호선,공항시장,2220,2345,4565
202105,9호선,신방화,4449,4267,8716
202105,9호선,마곡나루,7424,7428,14852
202105,9호선,양천향교,5718,5574,11292
202105,9호선,가양,13156,12507,25663
202105,9호선,증미,3970,3960,7930
202105,9호선,등촌,6704,6576,13280
202105,9호선,염창,10882,10092,20974
202105,9호선,신목동,2230,1973,4203
202105,9호선,선유도,3710,3635,7345
202105,9호선,당산,11906,11166,23072
202105,9호선,국회의사당,3978,4219,8197
202105,9호선,여의도,12454,10934,23388
202105,9호선,샛강,2566,2544,5110
202105,9호선,노량진,19530,19016,38546
202105,9호선,노들,2911,2580,5491
202105,9호선,흑석,5189,5265,10454
202105,9호선,동작,1280,1084,2364
202105,9호선,구반포,2197,2288,4485
202105,9호선,신반포,2262,2187,4449
202105,9호선,고속터미널,11436,16598,28034
202105,9호선,사평,2278,2145,4423
202105,9호선,신논현,24542,23925,48467
202105,9호선,언주,5677,5751,11428
202105,9호선,선정릉,4645,5129,9774
202105,9호선,삼성중앙,2897,2948,5845
202105,9호선,봉은사,9731,9935,19666
202105,9호선,종합운동장,3221,2652,5873
202105,9호선,삼전,4477,4419,8896
202105,9호선,석촌고분,3766,3770,7536
202105,9호선,석촌,5854,4966,10820
202105,9호선,송파나루,3836,4075,7911
202105,9호선,한성백제,1581,1414,2995
202105,9호선,올림픽공원,3614,3550,7164
202105,9호선,둔촌오륜,636,576,1212
202105,9호선,중앙보훈병원,4341,4023,8364
202105,9호선,개화,794,734,1528
202105,9호선,김포공항,6814,10084,16898
202105,9호선,공항시장,1442,1595,3037
202105,9호선,신방화,2948,2899,5847
202105,9호선,마곡나루,4122,4085,8207
202105,9호선,양천향교,3430,3761,7191
202105,9호선,가양,7833,7913,15746
202105,9호선,증미,2416,2525,4941
202105,9호선,등촌,4054,4150,8204
202105,9호선,염창,6536,6629,13165
202105,9호선,신목동,1263,1197,2460
202105,9호선,선유도,2211,2233,4444
202105,9호선,당산,7258,7045,14303
202105,9호선,국회의사당,3773,3439,7212
202105,9호선,여의도,8185,6644,14829
202105,9호선,샛강,1356,1375,2731
202105,9호선,노량진,11789,12315,24104
202105,9호선,노들,1863,1646,3509
202105,9호선,흑석,3105,3350,6455
202105,9호선,동작,832,614,1446
202105,9호선,구반포,1093,1208,2301
202105,9호선,신반포,1134,1254,2388
202105,9호선,고속터미널,7970,11277,19247
202105,9호선,사평,1123,1261,2384
202105,9호선,신논현,12667,12113,24780
202105,9호선,언주,3009,3020,6029
202105,9호선,선정릉,2414,2692,5106
202105,9호선,삼성중앙,1620,1718,3338
202105,9호선,봉은사,7061,6988,14049
202105,9호선,종합운동장,1629,1449,3078
202105,9호선,삼전,2763,2911,5674
202105,9호선,석촌고분,2485,2511,4996
202105,9호선,석촌,3400,3016,6416
202105,9호선,송파나루,2474,2535,5009
202105,9호선,한성백제,1067,955,2022
202105,9호선,올림픽공원,2021,2011,4032
202105,9호선,둔촌오륜,345,361,706
202105,9호선,중앙보훈병원,2599,2518,5117
202105,9호선,중앙보훈병원,4551,4299,8850
202105,9호선,둔촌오륜,716,647,1363
202105,9호선,올림픽공원,4794,4980,9774
202105,9호선,한성백제,1942,1699,3641
202105,9호선,송파나루,3794,4292,8086
202105,9호선,석촌,6358,5526,11884
202105,9호선,석촌고분,4008,3756,7764
202105,9호선,삼전,4749,4377,9126
202105,9호선,종합운동장,3324,2923,6247
202105,9호선,봉은사,9187,9495,18682
202105,9호선,삼성중앙,3020,3069,6089
202105,9호선,선정릉,5204,5712,10916
202105,9호선,언주,6002,6069,12071
202105,9호선,신논현,25075,24921,49996
202105,9호선,사평,2052,1994,4046
202105,9호선,고속터미널,12453,17656,30109
202105,9호선,신반포,2704,2653,5357
202105,9호선,구반포,2089,2191,4280
202105,9호선,동작,1831,1481,3312
202105,9호선,흑석,5747,5525,11272
202105,9호선,노들,3381,2959,6340
202105,9호선,노량진,20556,19962,40518
202105,9호선,샛강,2628,2535,5163
202105,9호선,여의도,12291,11690,23981
202105,9호선,국회의사당,4135,4437,8572
202105,9호선,당산,12360,11579,23939
202105,9호선,선유도,4388,4372,8760
202105,9호선,신목동,2520,2107,4627
202105,9호선,염창,11604,10704,22308
202105,9호선,등촌,7323,6864,14187
202105,9호선,증미,4160,4016,8176
202105,9호선,가양,14097,13620,27717
202105,9호선,양천향교,5887,5656,11543
202105,9호선,마곡나루,8137,8085,16222
202105,9호선,신방화,4574,4376,8950
202105,9호선,공항시장,2158,2268,4426
202105,9호선,김포공항,8660,12264,20924
202105,9호선,개화,1398,1287,2685
202105,9호선,개화,1076,1011,2087
202105,9호선,김포공항,7377,10695,18072
202105,9호선,공항시장,1572,1796,3368
202105,9호선,신방화,3155,3069,6224
202105,9호선,마곡나루,5542,5609,11151
202105,9호선,양천향교,3885,4015,7900
202105,9호선,가양,9858,9600,19458
202105,9호선,증미,2372,2461,4833
202105,9호선,등촌,4911,5042,9953
202105,9호선,염창,7932,7856,15788
202105,9호선,신목동,1640,1487,3127
202105,9호선,선유도,2977,2936,5913
202105,9호선,당산,8083,8032,16115
202105,9호선,국회의사당,4166,3973,8139
202105,9호선,여의도,8443,7657,16100
202105,9호선,노량진,13316,14281,27597
202105,9호선,노들,2402,2238,4640
202105,9호선,흑석,3776,4024,7800
202105,9호선,동작,1213,1032,2245
202105,9호선,구반포,1184,1336,2520
202105,9호선,신반포,1629,1748,3377
202105,9호선,고속터미널,9951,13008,22959
202105,9호선,사평,1207,1324,2531
202105,9호선,신논현,14309,13838,28147
202105,9호선,언주,3337,3323,6660
202105,9호선,선정릉,3140,3501,6641
202105,9호선,삼성중앙,1814,1856,3670
202105,9호선,봉은사,6337,6317,12654
202105,9호선,종합운동장,2016,1841,3857
202105,9호선,삼전,3183,3216,6399
202105,9호선,석촌고분,2787,2732,5519
202105,9호선,석촌,4269,3805,8074
202105,9호선,송파나루,2612,2908,5520
202105,9호선,한성백제,1443,1315,2758
202105,9호선,올림픽공원,3504,3683,7187
202105,9호선,둔촌오륜,405,415,820
202105,9호선,중앙보훈병원,3096,3048,6144
202105,9호선,샛강,1728,1763,3491
202105,9호선,개화,1348,1160,2508
202105,9호선,김포공항,8029,13433,21462
202105,9호선,공항시장,2196,2290,4486
202105,9호선,신방화,4437,4201,8638
202105,9호선,마곡나루,7699,7573,15272
202105,9호선,양천향교,5823,5663,11486
202105,9호선,가양,13544,12636,26180
202105,9호선,증미,3968,3942,7910
202105,9호선,등촌,7154,6762,13916
202105,9호선,염창,11051,10254,21305
202105,9호선,신목동,2258,1838,4096
202105,9호선,선유도,3790,3770,7560
202105,9호선,당산,12031,11208,23239
202105,9호선,국회의사당,4050,4190,8240
202105,9호선,여의도,12229,11295,23524
202105,9호선,노량진,19547,19288,38835
202105,9호선,노들,3113,2597,5710
202105,9호선,흑석,5216,5326,10542
202105,9호선,동작,1672,1364,3036
202105,9호선,구반포,2036,2250,4286
202105,9호선,신반포,2354,2356,4710
202105,9호선,고속터미널,11766,16748,28514
202105,9호선,사평,2076,1947,4023
202105,9호선,신논현,24533,24214,48747
202105,9호선,언주,5899,5954,11853
202105,9호선,선정릉,4964,5550,10514
202105,9호선,삼성중앙,2927,2968,5895
202105,9호선,봉은사,11497,12281,23778
202105,9호선,종합운동장,2848,2691,5539
202105,9호선,삼전,4651,4309,8960
202105,9호선,석촌고분,4004,3852,7856
202105,9호선,석촌,5993,4995,10988
202105,9호선,송파나루,3790,3962,7752
202105,9호선,한성백제,1801,1520,3321
202105,9호선,올림픽공원,5159,5122,10281
202105,9호선,둔촌오륜,741,667,1408
202105,9호선,중앙보훈병원,4173,3789,7962
202105,9호선,샛강,2566,2533,5099
202105,9호선,중앙보훈병원,3193,3212,6405
202105,9호선,둔촌오륜,455,491,946
202105,9호선,올림픽공원,4649,4733,9382
202105,9호선,한성백제,1585,1331,2916
202105,9호선,송파나루,2783,2994,5777
202105,9호선,석촌,4358,3916,8274
202105,9호선,석촌고분,2846,2889,5735
202105,9호선,삼전,3265,3330,6595
202105,9호선,종합운동장,1988,1843,3831
202105,9호선,봉은사,8287,8894,17181
202105,9호선,삼성중앙,1821,1821,3642
202105,9호선,선정릉,2935,3399,6334
202105,9호선,언주,3482,3560,7042
202105,9호선,신논현,14517,13755,28272
202105,9호선,사평,1222,1454,2676
202105,9호선,고속터미널,9611,12566,22177
202105,9호선,신반포,1536,1620,3156
202105,9호선,구반포,1153,1308,2461
202105,9호선,동작,1419,1186,2605
202105,9호선,흑석,3795,4032,7827
202105,9호선,노들,2483,2279,4762
202105,9호선,노량진,13902,14541,28443
202105,9호선,샛강,1774,1717,3491
202105,9호선,여의도,8578,7566,16144
202105,9호선,국회의사당,4158,3962,8120
202105,9호선,당산,8358,8343,16701
202105,9호선,선유도,3131,3142,6273
202105,9호선,신목동,1644,1551,3195
202105,9호선,염창,7969,7819,15788
202105,9호선,등촌,5014,5236,10250
202105,9호선,증미,3036,3079,6115
202105,9호선,가양,9649,9837,19486
202105,9호선,양천향교,3996,4246,8242
202105,9호선,마곡나루,5928,5676,11604
202105,9호선,신방화,3185,3301,6486
202105,9호선,공항시장,1682,1820,3502
202105,9호선,김포공항,7707,11208,18915
202105,9호선,개화,1045,986,2031
202106,9호선,개화,1426,1274,2700
202106,9호선,김포공항,7690,12651,20341
202106,9호선,공항시장,2174,2282,4456
202106,9호선,신방화,4471,4271,8742
202106,9호선,마곡나루,7679,7657,15336
202106,9호선,양천향교,5789,5545,11334
202106,9호선,가양,13836,13199,27035
202106,9호선,증미,4169,4064,8233
202106,9호선,등촌,7183,6759,13942
202106,9호선,염창,11376,10737,22113
202106,9호선,신목동,2240,1972,4212
202106,9호선,선유도,4037,4093,8130
202106,9호선,당산,12336,11626,23962
202106,9호선,국회의사당,4007,4283,8290
202106,9호선,여의도,11501,11059,22560
202106,9호선,샛강,2574,2617,5191
202106,9호선,노량진,19962,19603,39565
202106,9호선,노들,3490,2831,6321
202106,9호선,흑석,5327,5287,10614
202106,9호선,동작,3903,3686,7589
202106,9호선,구반포,1980,2095,4075
202106,9호선,신반포,2569,2514,5083
202106,9호선,고속터미널,12398,17344,29742
202106,9호선,사평,2032,1892,3924
202106,9호선,신논현,24486,24181,48667
202106,9호선,언주,5993,5930,11923
202106,9호선,선정릉,4744,5395,10139
202106,9호선,삼성중앙,2941,2843,5784
202106,9호선,봉은사,10407,10940,21347
202106,9호선,종합운동장,3300,2975,6275
202106,9호선,삼전,4622,4273,8895
202106,9호선,석촌고분,4004,3832,7836
202106,9호선,석촌,6360,5280,11640
202106,9호선,송파나루,3757,4204,7961
202106,9호선,한성백제,1898,1571,3469
202106,9호선,올림픽공원,6741,6812,13553
202106,9호선,둔촌오륜,840,796,1636
202106,9호선,중앙보훈병원,4574,4289,8863
202106,9호선,당산,8171,8011,16182
202106,9호선,샛강,1689,1629,3318
202106,9호선,개화,1065,984,2049
202106,9호선,김포공항,7202,10629,17831
202106,9호선,공항시장,1573,1756,3329
202106,9호선,신방화,3116,3199,6315
202106,9호선,마곡나루,5243,5320,10563
202106,9호선,양천향교,3853,4080,7933
202106,9호선,가양,9720,9669,19389
202106,9호선,증미,3009,2974,5983
202106,9호선,등촌,4852,4993,9845
202106,9호선,염창,7875,7912,15787
202106,9호선,신목동,1587,1426,3013
202106,9호선,선유도,2822,2807,5629
202106,9호선,국회의사당,4660,4485,9145
202106,9호선,여의도,7677,7279,14956
202106,9호선,노량진,13313,13964,27277
202106,9호선,노들,2531,2304,4835
202106,9호선,흑석,3795,3858,7653
202106,9호선,동작,7885,7786,15671
202106,9호선,구반포,1135,1229,2364
202106,9호선,신반포,1591,1697,3288
202106,9호선,고속터미널,9763,12687,22450
202106,9호선,사평,1317,1326,2643
202106,9호선,신논현,13815,12979,26794
202106,9호선,언주,3557,3572,7129
202106,9호선,선정릉,2977,3256,6233
202106,9호선,삼성중앙,1751,1843,3594
202106,9호선,봉은사,7443,7424,14867
202106,9호선,종합운동장,2001,1805,3806
202106,9호선,삼전,3139,3142,6281
202106,9호선,석촌고분,2818,2813,5631
202106,9호선,석촌,4229,3673,7902
202106,9호선,송파나루,2439,2848,5287
202106,9호선,한성백제,1471,1199,2670
202106,9호선,올림픽공원,5175,5111,10286
202106,9호선,둔촌오륜,391,451,842
202106,9호선,중앙보훈병원,3081,2984,6065
202106,9호선,개화,1371,1240,2611
202106,9호선,김포공항,7570,12334,19904
202106,9호선,공항시장,2170,2266,4436
202106,9호선,신방화,4486,4304,8790
202106,9호선,마곡나루,7478,7474,14952
202106,9호선,양천향교,5792,5566,11358
202106,9호선,가양,13673,12787,26460
202106,9호선,증미,4062,3921,7983
202106,9호선,등촌,7105,6756,13861
202106,9호선,염창,11014,10052,21066
202106,9호선,신목동,2253,1992,4245
202106,9호선,선유도,3838,3850,7688
202106,9호선,당산,11640,10940,22580
202106,9호선,국회의사당,3709,3970,7679
202106,9호선,여의도,11597,11115,22712
202106,9호선,샛강,2396,2492,4888
202106,9호선,노량진,19669,18963,38632
202106,9호선,노들,3166,2673,5839
202106,9호선,흑석,5106,5110,10216
202106,9호선,동작,1734,1499,3233
202106,9호선,구반포,1995,2107,4102
202106,9호선,신반포,2447,2390,4837
202106,9호선,고속터미널,11848,16851,28699
202106,9호선,사평,1948,1830,3778
202106,9호선,신논현,23940,23684,47624
202106,9호선,언주,5722,5870,11592
202106,9호선,선정릉,4666,5246,9912
202106,9호선,삼성중앙,2852,2807,5659
202106,9호선,봉은사,10590,11184,21774
202106,9호선,종합운동장,3091,2788,5879
202106,9호선,삼전,4662,4285,8947
202106,9호선,석촌고분,3998,3847,7845
202106,9호선,석촌,5918,4913,10831
202106,9호선,송파나루,3673,4130,7803
202106,9호선,한성백제,1741,1442,3183
202106,9호선,올림픽공원,4130,4174,8304
202106,9호선,둔촌오륜,593,575,1168
202106,9호선,중앙보훈병원,4208,3954,8162
202106,9호선,개화,1002,950,1952
202106,9호선,김포공항,7193,10806,17999
202106,9호선,공항시장,1561,1740,3301
202106,9호선,신방화,3125,3077,6202
202106,9호선,마곡나루,5075,5130,10205
202106,9호선,양천향교,3778,4019,7797
202106,9호선,가양,9237,9323,18560
202106,9호선,증미,2471,2440,4911
202106,9호선,등촌,4799,4789,9588
202106,9호선,염창,7672,7685,15357
202106,9호선,신목동,1496,1369,2865
202106,9호선,선유도,2887,2892,5779
202106,9호선,당산,7946,7778,15724
202106,9호선,국회의사당,4050,3774,7824
202106,9호선,여의도,8623,7736,16359
202106,9호선,샛강,1537,1589,3126
202106,9호선,노량진,12832,13724,26556
202106,9호선,노들,2290,2077,4367
202106,9호선,흑석,3495,3655,7150
202106,9호선,동작,1159,953,2112
202106,9호선,구반포,1074,1113,2187
202106,9호선,신반포,1437,1472,2909
202106,9호선,고속터미널,9446,12169,21615
202106,9호선,사평,1287,1384,2671
202106,9호선,신논현,13729,13276,27005
202106,9호선,언주,3483,3569,7052
202106,9호선,선정릉,2723,3107,5830
202106,9호선,삼성중앙,1778,1946,3724
202106,9호선,봉은사,7138,7356,14494
202106,9호선,종합운동장,2015,1789,3804
202106,9호선,삼전,3205,3087,6292
202106,9호선,석촌고분,2734,2796,5530
202106,9호선,석촌,4066,3721,7787
202106,9호선,송파나루,2674,2992,5666
202106,9호선,한성백제,1372,1201,2573
202106,9호선,올림픽공원,3009,3058,6067
202106,9호선,둔촌오륜,418,476,894
202106,9호선,중앙보훈병원,2996,2979,5975
202106,9호선,개화,1430,1234,2664
202106,9호선,김포공항,8036,13736,21772
202106,9호선,공항시장,2123,2251,4374
202106,9호선,신방화,4555,4355,8910
202106,9호선,마곡나루,7792,7694,15486
202106,9호선,양천향교,5891,5576,11467
202106,9호선,가양,14097,13401,27498
202106,9호선,증미,4261,3986,8247
202106,9호선,등촌,7131,6829,13960
202106,9호선,염창,11220,10346,21566
202106,9호선,신목동,2374,2104,4478
202106,9호선,선유도,3995,3848,7843
202106,9호선,당산,12363,11525,23888
202106,9호선,국회의사당,3998,4215,8213
202106,9호선,여의도,12263,11856,24119
202106,9호선,샛강,2570,2583,5153
202106,9호선,노량진,20064,19786,39850
202106,9호선,노들,3351,2795,6146
202106,9호선,흑석,5268,5159,10427
202106,9호선,동작,1582,1275,2857
202106,9호선,구반포,1853,1900,3753
202106,9호선,신반포,2600,2505,5105
202106,9호선,고속터미널,12524,17807,30331
202106,9호선,사평,2055,1924,3979
202106,9호선,신논현,26104,25694,51798
202106,9호선,언주,5893,5847,11740
202106,9호선,선정릉,4985,5515,10500
202106,9호선,삼성중앙,2946,2967,5913
202106,9호선,봉은사,10519,11101,21620
202106,9호선,종합운동장,3087,2841,5928
202106,9호선,삼전,4649,4249,8898
202106,9호선,석촌고분,4093,3893,7986
202106,9호선,석촌,6299,5276,11575
202106,9호선,송파나루,3801,4226,8027
202106,9호선,한성백제,1806,1605,3411
202106,9호선,올림픽공원,5335,5370,10705
202106,9호선,둔촌오륜,647,624,1271
202106,9호선,중앙보훈병원,4429,4109,8538
202106,9호선,중앙보훈병원,3072,3063,6135
202106,9호선,둔촌오륜,429,494,923
202106,9호선,올림픽공원,4090,4242,8332
202106,9호선,한성백제,1415,1291,2706
202106,9호선,송파나루,2623,2963,5586
202106,9호선,석촌,4313,3766,8079
202106,9호선,석촌고분,2755,2783,5538
202106,9호선,삼전,3418,3288,6706
202106,9호선,종합운동장,2101,1914,4015
202106,9호선,봉은사,6724,6841,13565
202106,9호선,삼성중앙,1674,1824,3498
202106,9호선,선정릉,2993,3326,6319
202106,9호선,언주,3383,3324,6707
202106,9호선,신논현,14693,14044,28737
202106,9호선,사평,1281,1383,2664
202106,9호선,고속터미널,10234,12890,23124
202106,9호선,신반포,1546,1630,3176
202106,9호선,구반포,1106,1146,2252
202106,9호선,동작,1193,990,2183
202106,9호선,흑석,3655,3873,7528
202106,9호선,노들,2549,2173,4722
202106,9호선,노량진,13963,14717,28680
202106,9호선,샛강,1601,1773,3374
202106,9호선,여의도,8568,7640,16208
202106,9호선,국회의사당,4146,3926,8072
202106,9호선,당산,8330,8117,16447
202106,9호선,선유도,2861,2757,5618
202106,9호선,신목동,1657,1531,3188
202106,9호선,염창,7847,7930,15777
202106,9호선,등촌,4908,5000,9908
202106,9호선,증미,2929,2941,5870
202106,9호선,가양,9733,9698,19431
202106,9호선,양천향교,3857,4091,7948
202106,9호선,마곡나루,4977,5110,10087
202106,9호선,신방화,3203,3217,6420
202106,9호선,공항시장,1635,1744,3379
202106,9호선,김포공항,7797,11972,19769
202106,9호선,개화,989,953,1942
202106,9호선,개화,1257,1197,2454
202106,9호선,김포공항,8282,13151,21433
202106,9호선,공항시장,2185,2171,4356
202106,9호선,신방화,4482,4291,8773
202106,9호선,마곡나루,7538,7540,15078
202106,9호선,양천향교,5695,5344,11039
202106,9호선,가양,13508,12696,26204
202106,9호선,증미,4192,4086,8278
202106,9호선,등촌,7112,6768,13880
202106,9호선,염창,11045,10152,21197
202106,9호선,신목동,2308,1965,4273
202106,9호선,선유도,3821,3633,7454
202106,9호선,당산,12187,11230,23417
202106,9호선,국회의사당,3901,4198,8099
202106,9호선,여의도,11904,11478,23382
202106,9호선,샛강,2486,2596,5082
202106,9호선,노량진,20884,20404,41288
202106,9호선,노들,3287,2725,6012
202106,9호선,흑석,5513,5367,10880
202106,9호선,동작,1630,1273,2903
202106,9호선,구반포,1858,1968,3826
202106,9호선,신반포,2132,2191,4323
202106,9호선,고속터미널,12575,17809,30384
202106,9호선,사평,2104,1877,3981
202106,9호선,신논현,25421,25401,50822
202106,9호선,언주,5633,5738,11371
202106,9호선,선정릉,4473,5051,9524
202106,9호선,삼성중앙,2936,3002,5938
202106,9호선,봉은사,10083,10417,20500
202106,9호선,종합운동장,3330,2929,6259
202106,9호선,삼전,4583,4286,8869
202106,9호선,석촌고분,4043,3818,7861
202106,9호선,석촌,6240,5193,11433
202106,9호선,송파나루,3707,4313,8020
202106,9호선,한성백제,1815,1599,3414
202106,9호선,올림픽공원,7228,6848,14076
202106,9호선,둔촌오륜,593,599,1192
202106,9호선,중앙보훈병원,4181,3871,8052
202106,9호선,개화,1064,979,2043
202106,9호선,김포공항,7735,12157,19892
202106,9호선,공항시장,1648,1838,3486
202106,9호선,신방화,3209,3265,6474
202106,9호선,마곡나루,5243,5308,10551
202106,9호선,양천향교,3902,4137,8039
202106,9호선,가양,9671,9578,19249
202106,9호선,증미,2457,2570,5027
202106,9호선,등촌,4762,4946,9708
202106,9호선,염창,7973,7925,15898
202106,9호선,신목동,1698,1595,3293
202106,9호선,선유도,2790,2814,5604
202106,9호선,당산,8297,8211,16508
202106,9호선,국회의사당,4052,3793,7845
202106,9호선,여의도,9038,7865,16903
202106,9호선,샛강,1604,1694,3298
202106,9호선,노량진,14328,15192,29520
202106,9호선,노들,2530,2262,4792
202106,9호선,흑석,3763,3944,7707
202106,9호선,동작,1255,995,2250
202106,9호선,구반포,1120,1146,2266
202106,9호선,신반포,1570,1756,3326
202106,9호선,고속터미널,10102,13476,23578
202106,9호선,사평,1367,1420,2787
202106,9호선,신논현,15257,14360,29617
202106,9호선,언주,3336,3348,6684
202106,9호선,선정릉,3053,3391,6444
202106,9호선,삼성중앙,1869,1916,3785
202106,9호선,봉은사,7493,7543,15036
202106,9호선,종합운동장,2066,2061,4127
202106,9호선,삼전,3363,3399,6762
202106,9호선,석촌고분,2785,2842,5627
202106,9호선,석촌,4404,3878,8282
202106,9호선,송파나루,2980,3317,6297
202106,9호선,한성백제,1525,1426,2951
202106,9호선,올림픽공원,6384,5949,12333
202106,9호선,둔촌오륜,480,523,1003
202106,9호선,중앙보훈병원,3274,3146,6420
202107,9호선,중앙보훈병원,4075,3786,7861
202107,9호선,둔촌오륜,557,602,1159
202107,9호선,올림픽공원,8847,8652,17499
202107,9호선,한성백제,1681,1543,3224
202107,9호선,송파나루,3968,4284,8252
202107,9호선,석촌,5643,4748,10391
202107,9호선,석촌고분,3814,3849,7663
202107,9호선,삼전,4620,4388,9008
202107,9호선,종합운동장,3279,2813,6092
202107,9호선,봉은사,12877,13542,26419
202107,9호선,삼성중앙,2981,3064,6045
202107,9호선,선정릉,4724,5437,10161
202107,9호선,언주,5962,5937,11899
202107,9호선,신논현,23908,23609,47517
202107,9호선,사평,2138,2024,4162
202107,9호선,고속터미널,10833,15908,26741
202107,9호선,신반포,2083,2170,4253
202107,9호선,구반포,1895,2039,3934
202107,9호선,동작,1294,1089,2383
202107,9호선,흑석,5044,5113,10157
202107,9호선,노들,2821,2554,5375
202107,9호선,노량진,19143,18674,37817
202107,9호선,샛강,2842,2685,5527
202107,9호선,여의도,12483,10585,23068
202107,9호선,국회의사당,4583,4836,9419
202107,9호선,당산,12378,11136,23514
202107,9호선,선유도,3599,3532,7131
202107,9호선,신목동,2171,1872,4043
202107,9호선,염창,10377,9654,20031
202107,9호선,등촌,6674,6870,13544
202107,9호선,증미,3877,3928,7805
202107,9호선,가양,12477,12048,24525
202107,9호선,양천향교,5273,5191,10464
202107,9호선,마곡나루,7270,6666,13936
202107,9호선,신방화,4261,4224,8485
202107,9호선,공항시장,2077,2238,4315
202107,9호선,김포공항,8208,11990,20198
202107,9호선,개화,1405,1127,2532
202107,9호선,개화,785,791,1576
202107,9호선,김포공항,7279,10397,17676
202107,9호선,공항시장,1487,1635,3122
202107,9호선,신방화,2969,2968,5937
202107,9호선,마곡나루,4514,4532,9046
202107,9호선,양천향교,3373,3735,7108
202107,9호선,가양,8330,8529,16859
202107,9호선,증미,2541,2703,5244
202107,9호선,등촌,4288,4288,8576
202107,9호선,염창,6986,6981,13967
202107,9호선,신목동,1346,1247,2593
202107,9호선,선유도,2326,2217,4543
202107,9호선,당산,7387,7334,14721
202107,9호선,국회의사당,4027,3542,7569
202107,9호선,여의도,7545,6603,14148
202107,9호선,샛강,1488,1525,3013
202107,9호선,노량진,12458,12981,25439
202107,9호선,노들,2099,1840,3939
202107,9호선,흑석,3176,3364,6540
202107,9호선,동작,887,736,1623
202107,9호선,구반포,923,976,1899
202107,9호선,신반포,1338,1360,2698
202107,9호선,고속터미널,8578,11127,19705
202107,9호선,사평,1352,1333,2685
202107,9호선,신논현,13603,13172,26775
202107,9호선,언주,3232,3166,6398
202107,9호선,선정릉,2744,2969,5713
202107,9호선,삼성중앙,1722,1749,3471
202107,9호선,봉은사,7741,8030,15771
202107,9호선,종합운동장,2068,1776,3844
202107,9호선,삼전,2988,2944,5932
202107,9호선,석촌고분,2550,2644,5194
202107,9호선,석촌,3851,3348,7199
202107,9호선,송파나루,2431,2667,5098
202107,9호선,한성백제,1195,1100,2295
202107,9호선,올림픽공원,6872,7096,13968
202107,9호선,둔촌오륜,387,388,775
202107,9호선,중앙보훈병원,2897,2755,5652
202107,9호선,개화,1130,1037,2167
202107,9호선,김포공항,6416,11168,17584
202107,9호선,공항시장,2013,2108,4121
202107,9호선,신방화,3953,3713,7666
202107,9호선,마곡나루,6214,6147,12361
202107,9호선,양천향교,4930,4864,9794
202107,9호선,가양,11422,10900,22322
202107,9호선,증미,3533,3513,7046
202107,9호선,등촌,6373,6144,12517
202107,9호선,염창,9643,8775,18418
202107,9호선,신목동,1920,1677,3597
202107,9호선,선유도,3195,3059,6254
202107,9호선,당산,9875,9295,19170
202107,9호선,국회의사당,3064,3197,6261
202107,9호선,여의도,7373,6916,14289
202107,9호선,샛강,1992,1976,3968
202107,9호선,노량진,16970,16497,33467
202107,9호선,노들,2699,2242,4941
202107,9호선,흑석,4404,4353,8757
202107,9호선,동작,1149,878,2027
202107,9호선,구반포,1524,1622,3146
202107,9호선,신반포,1968,1959,3927
202107,9호선,고속터미널,8547,12117,20664
202107,9호선,사평,1746,1626,3372
202107,9호선,신논현,18947,18981,37928
202107,9호선,언주,4722,4643,9365
202107,9호선,선정릉,3630,3938,7568
202107,9호선,삼성중앙,2390,2414,4804
202107,9호선,봉은사,7656,7627,15283
202107,9호선,종합운동장,2632,2361,4993
202107,9호선,삼전,3977,3771,7748
202107,9호선,석촌고분,3400,3219,6619
202107,9호선,석촌,5058,4131,9189
202107,9호선,송파나루,3096,3281,6377
202107,9호선,한성백제,1430,1263,2693
202107,9호선,올림픽공원,3491,3499,6990
202107,9호선,둔촌오륜,606,586,1192
202107,9호선,중앙보훈병원,3716,3369,7085
202107,9호선,개화,813,789,1602
202107,9호선,김포공항,6141,9418,15559
202107,9호선,공항시장,1340,1548,2888
202107,9호선,신방화,2533,2623,5156
202107,9호선,마곡나루,4032,4153,8185
202107,9호선,양천향교,3120,3354,6474
202107,9호선,가양,7674,7735,15409
202107,9호선,증미,1942,1988,3930
202107,9호선,등촌,4070,4152,8222
202107,9호선,염창,6227,6150,12377
202107,9호선,신목동,1284,1179,2463
202107,9호선,선유도,2082,2108,4190
202107,9호선,당산,6292,6306,12598
202107,9호선,국회의사당,3268,3073,6341
202107,9호선,여의도,4916,4596,9512
202107,9호선,샛강,1206,1250,2456
202107,9호선,노량진,11051,11760,22811
202107,9호선,노들,1937,1651,3588
202107,9호선,흑석,2883,3040,5923
202107,9호선,동작,859,677,1536
202107,9호선,구반포,806,875,1681
202107,9호선,신반포,1153,1194,2347
202107,9호선,고속터미널,7002,8439,15441
202107,9호선,사평,999,1072,2071
202107,9호선,신논현,10914,10609,21523
202107,9호선,언주,2677,2750,5427
202107,9호선,선정릉,2242,2571,4813
202107,9호선,삼성중앙,1417,1444,2861
202107,9호선,봉은사,4635,4541,9176
202107,9호선,종합운동장,1697,1563,3260
202107,9호선,삼전,2718,2788,5506
202107,9호선,석촌고분,2349,2397,4746
202107,9호선,석촌,3413,2937,6350
202107,9호선,송파나루,2150,2328,4478
202107,9호선,한성백제,998,907,1905
202107,9호선,올림픽공원,2149,2208,4357
202107,9호선,둔촌오륜,338,384,722
202107,9호선,중앙보훈병원,2426,2370,4796
202107,9호선,중앙보훈병원,3201,3039,6240
202107,9호선,둔촌오륜,475,480,955
202107,9호선,올림픽공원,3180,3156,6336
202107,9호선,한성백제,1340,1216,2556
202107,9호선,송파나루,2944,3112,6056
202107,9호선,석촌,4673,4014,8687
202107,9호선,석촌고분,3261,3065,6326
202107,9호선,삼전,3788,3556,7344
202107,9호선,종합운동장,2554,2313,4867
202107,9호선,봉은사,6202,6387,12589
202107,9호선,삼성중앙,2350,2335,4685
202107,9호선,선정릉,3311,3526,6837
202107,9호선,언주,4124,3982,8106
202107,9호선,신논현,17272,17185,34457
202107,9호선,사평,1673,1567,3240
202107,9호선,고속터미널,7913,11061,18974
202107,9호선,신반포,1773,1682,3455
202107,9호선,구반포,1344,1335,2679
202107,9호선,동작,1064,860,1924
202107,9호선,흑석,4028,4007,8035
202107,9호선,노들,2445,2078,4523
202107,9호선,노량진,16091,15511,31602
202107,9호선,샛강,1798,1806,3604
202107,9호선,여의도,6396,6075,12471
202107,9호선,국회의사당,2328,2382,4710
202107,9호선,당산,9022,8440,17462
202107,9호선,선유도,2861,2707,5568
202107,9호선,신목동,1757,1495,3252
202107,9호선,염창,8403,7723,16126
202107,9호선,등촌,5737,5616,11353
202107,9호선,증미,3310,3228,6538
202107,9호선,가양,10512,10106,20618
202107,9호선,양천향교,4481,4397,8878
202107,9호선,마곡나루,5229,5102,10331
202107,9호선,신방화,3624,3519,7143
202107,9호선,공항시장,1822,1925,3747
202107,9호선,김포공항,6155,10006,16161
202107,9호선,개화,1082,1007,2089
202107,9호선,중앙보훈병원,2324,2258,4582
202107,9호선,둔촌오륜,284,298,582
202107,9호선,올림픽공원,1989,2057,4046
202107,9호선,한성백제,1007,894,1901
202107,9호선,송파나루,2139,2457,4596
202107,9호선,석촌,3214,2780,5994
202107,9호선,석촌고분,2192,2284,4476
202107,9호선,삼전,2559,2575,5134
202107,9호선,종합운동장,1591,1504,3095
202107,9호선,봉은사,4340,4514,8854
202107,9호선,삼성중앙,1463,1502,2965
202107,9호선,선정릉,2232,2405,4637
202107,9호선,언주,2357,2476,4833
202107,9호선,신논현,10029,9891,19920
202107,9호선,사평,1054,1119,2173
202107,9호선,고속터미널,6860,7785,14645
202107,9호선,신반포,959,1012,1971
202107,9호선,구반포,795,847,1642
202107,9호선,동작,862,722,1584
202107,9호선,흑석,2625,2823,5448
202107,9호선,노들,1707,1530,3237
202107,9호선,노량진,10454,11375,21829
202107,9호선,샛강,1212,1264,2476
202107,9호선,여의도,4558,4431,8989
202107,9호선,국회의사당,1879,1919,3798
202107,9호선,당산,5776,5797,11573
202107,9호선,선유도,1942,1982,3924
202107,9호선,신목동,1187,1064,2251
202107,9호선,염창,5856,5824,11680
202107,9호선,등촌,3722,4002,7724
202107,9호선,증미,2133,2306,4439
202107,9호선,가양,6985,7168,14153
202107,9호선,양천향교,2996,3163,6159
202107,9호선,마곡나루,3630,3812,7442
202107,9호선,신방화,2492,2456,4948
202107,9호선,공항시장,1285,1415,2700
202107,9호선,김포공항,6158,8530,14688
202107,9호선,개화,819,810,1629
202107,9호선,김포공항,6283,9817,16100
202107,9호선,공항시장,1775,2054,3829
202107,9호선,신방화,3623,3542,7165
202107,9호선,마곡나루,5250,5161,10411
202107,9호선,양천향교,4450,4362,8812
202107,9호선,가양,10306,9924,20230
202107,9호선,증미,3384,3354,6738
202107,9호선,등촌,5877,5727,11604
202107,9호선,염창,8417,7892,16309
202107,9호선,신목동,1661,1418,3079
202107,9호선,선유도,2792,2663,5455
202107,9호선,당산,8941,8466,17407
202107,9호선,국회의사당,2293,2345,4638
202107,9호선,여의도,7212,6497,13709
202107,9호선,샛강,1876,1847,3723
202107,9호선,노량진,16194,15800,31994
202107,9호선,노들,2400,2029,4429
202107,9호선,흑석,3866,3902,7768
202107,9호선,동작,964,792,1756
202107,9호선,구반포,1352,1379,2731
202107,9호선,신반포,1779,1707,3486
202107,9호선,고속터미널,8036,11262,19298
202107,9호선,사평,1559,1505,3064
202107,9호선,신논현,17759,17379,35138
202107,9호선,언주,3994,3955,7949
202107,9호선,선정릉,3213,3512,6725
202107,9호선,삼성중앙,2312,2384,4696
202107,9호선,봉은사,6733,6887,13620
202107,9호선,종합운동장,2322,2187,4509
202107,9호선,삼전,3812,3565,7377
202107,9호선,석촌고분,3212,3167,6379
202107,9호선,석촌,4677,3916,8593
202107,9호선,송파나루,2975,3283,6258
202107,9호선,한성백제,1281,1208,2489
202107,9호선,올림픽공원,2683,2731,5414
202107,9호선,둔촌오륜,483,496,979
202107,9호선,중앙보훈병원,3392,3247,6639
202107,9호선,개화,1066,985,2051
202107,9호선,개화,775,788,1563
202107,9호선,김포공항,6369,8514,14883
202107,9호선,공항시장,1319,1456,2775
202107,9호선,신방화,2483,2445,4928
202107,9호선,마곡나루,3534,3739,7273
202107,9호선,양천향교,2925,3230,6155
202107,9호선,가양,6747,6899,13646
202107,9호선,증미,1820,1866,3686
202107,9호선,등촌,3774,3995,7769
202107,9호선,염창,5854,5778,11632
202107,9호선,신목동,1119,1060,2179
202107,9호선,선유도,1923,1939,3862
202107,9호선,당산,5840,5868,11708
202107,9호선,국회의사당,2024,2023,4047
202107,9호선,여의도,5340,4906,10246
202107,9호선,샛강,1148,1174,2322
202107,9호선,노량진,10496,11145,21641
202107,9호선,노들,1665,1492,3157
202107,9호선,흑석,2541,2716,5257
202107,9호선,동작,736,605,1341
202107,9호선,구반포,745,819,1564
202107,9호선,신반포,922,930,1852
202107,9호선,고속터미널,6645,8078,14723
202107,9호선,사평,1096,1117,2213
202107,9호선,신논현,10297,9941,20238
202107,9호선,언주,2245,2383,4628
202107,9호선,선정릉,2023,2297,4320
202107,9호선,삼성중앙,1439,1513,2952
202107,9호선,봉은사,4710,4675,9385
202107,9호선,종합운동장,1701,1484,3185
202107,9호선,삼전,2508,2660,5168
202107,9호선,석촌고분,2245,2255,4500
202107,9호선,석촌,3037,2645,5682
202107,9호선,송파나루,2201,2345,4546
202107,9호선,한성백제,928,894,1822
202107,9호선,올림픽공원,2035,1925,3960
202107,9호선,둔촌오륜,322,347,669
202107,9호선,중앙보훈병원,2281,2306,4587
202107,9호선,중앙보훈병원,3393,3174,6567
202107,9호선,둔촌오륜,492,496,988
202107,9호선,올림픽공원,2637,2635,5272
202107,9호선,한성백제,1278,1099,2377
202107,9호선,송파나루,3002,3246,6248
202107,9호선,석촌,4628,3873,8501
202107,9호선,석촌고분,3152,3148,6300
202107,9호선,삼전,3755,3515,7270
202107,9호선,종합운동장,2251,2149,4400
202107,9호선,봉은사,6873,7053,13926
202107,9호선,삼성중앙,2240,2245,4485
202107,9호선,선정릉,3234,3530,6764
202107,9호선,언주,4007,3985,7992
202107,9호선,신논현,17617,17226,34843
202107,9호선,사평,1571,1527,3098
202107,9호선,고속터미널,8054,11373,19427
202107,9호선,신반포,1617,1588,3205
202107,9호선,구반포,1306,1337,2643
202107,9호선,동작,978,804,1782
202107,9호선,흑석,3689,3787,7476
202107,9호선,노들,2428,2074,4502
202107,9호선,노량진,15703,14969,30672
202107,9호선,샛강,1716,1720,3436
202107,9호선,여의도,7254,6755,14009
202107,9호선,국회의사당,2254,2296,4550
202107,9호선,당산,8960,8360,17320
202107,9호선,선유도,2753,2727,5480
202107,9호선,신목동,1626,1451,3077
202107,9호선,염창,8250,7711,15961
202107,9호선,등촌,5631,5492,11123
202107,9호선,증미,3288,3251,6539
202107,9호선,가양,10074,9747,19821
202107,9호선,양천향교,4413,4279,8692
202107,9호선,마곡나루,5001,4964,9965
202107,9호선,신방화,3637,3536,7173
202107,9호선,공항시장,1821,1917,3738
202107,9호선,김포공항,6220,10228,16448
202107,9호선,개화,1087,888,1975
202108,9호선,중앙보훈병원,2376,2371,4747
202108,9호선,둔촌오륜,290,339,629
202108,9호선,올림픽공원,1828,1949,3777
202108,9호선,한성백제,884,875,1759
202108,9호선,송파나루,2139,2314,4453
202108,9호선,석촌,3065,2655,5720
202108,9호선,석촌고분,2131,2234,4365
202108,9호선,삼전,2595,2587,5182
202108,9호선,종합운동장,1389,1365,2754
202108,9호선,봉은사,5278,5282,10560
202108,9호선,삼성중앙,1372,1459,2831
202108,9호선,선정릉,2190,2254,4444
202108,9호선,언주,2220,2311,4531
202108,9호선,신논현,10268,10072,20340
202108,9호선,사평,1003,1051,2054
202108,9호선,고속터미널,6436,7929,14365
202108,9호선,신반포,906,918,1824
202108,9호선,구반포,663,786,1449
202108,9호선,동작,710,608,1318
202108,9호선,흑석,2550,2651,5201
202108,9호선,노들,1641,1422,3063
202108,9호선,노량진,10253,11229,21482
202108,9호선,샛강,1150,1195,2345
202108,9호선,여의도,5344,4698,10042
202108,9호선,국회의사당,2073,2064,4137
202108,9호선,당산,6019,5909,11928
202108,9호선,선유도,1796,1951,3747
202108,9호선,신목동,1243,1113,2356
202108,9호선,염창,5702,5784,11486
202108,9호선,등촌,3648,3927,7575
202108,9호선,증미,2274,2397,4671
202108,9호선,가양,6607,6618,13225
202108,9호선,양천향교,2938,3203,6141
202108,9호선,마곡나루,3492,3507,6999
202108,9호선,신방화,2516,2535,5051
202108,9호선,공항시장,1244,1481,2725
202108,9호선,김포공항,6155,9150,15305
202108,9호선,개화,788,728,1516
202108,9호선,개화,1095,1010,2105
202108,9호선,김포공항,6242,10015,16257
202108,9호선,공항시장,1839,1983,3822
202108,9호선,신방화,3853,3749,7602
202108,9호선,마곡나루,5722,5568,11290
202108,9호선,양천향교,4547,4530,9077
202108,9호선,가양,10557,10184,20741
202108,9호선,증미,3486,3467,6953
202108,9호선,등촌,6026,5817,11843
202108,9호선,염창,8964,8233,17197
202108,9호선,신목동,1704,1497,3201
202108,9호선,선유도,2953,2875,5828
202108,9호선,당산,9488,9046,18534
202108,9호선,국회의사당,2446,2411,4857
202108,9호선,여의도,7883,7450,15333
202108,9호선,샛강,1839,1945,3784
202108,9호선,노량진,16218,15851,32069
202108,9호선,노들,2474,2224,4698
202108,9호선,흑석,4072,4108,8180
202108,9호선,동작,1060,857,1917
202108,9호선,구반포,1242,1350,2592
202108,9호선,신반포,1816,1689,3505
202108,9호선,고속터미널,8480,11790,20270
202108,9호선,사평,1670,1639,3309
202108,9호선,신논현,18794,18640,37434
202108,9호선,언주,4157,4198,8355
202108,9호선,선정릉,3517,3696,7213
202108,9호선,삼성중앙,2466,2382,4848
202108,9호선,봉은사,8160,8410,16570
202108,9호선,종합운동장,2302,2101,4403
202108,9호선,삼전,3980,3790,7770
202108,9호선,석촌고분,3293,3202,6495
202108,9호선,석촌,4858,4139,8997
202108,9호선,송파나루,3228,3538,6766
202108,9호선,한성백제,1374,1257,2631
202108,9호선,올림픽공원,3367,3383,6750
202108,9호선,둔촌오륜,502,507,1009
202108,9호선,중앙보훈병원,3581,3407,6988
202108,9호선,개화,918,827,1745
202108,9호선,김포공항,6172,8875,15047
202108,9호선,공항시장,1315,1533,2848
202108,9호선,신방화,2527,2577,5104
202108,9호선,마곡나루,3734,3941,7675
202108,9호선,양천향교,3026,3226,6252
202108,9호선,가양,6977,7057,14034
202108,9호선,증미,1882,1934,3816
202108,9호선,등촌,3831,3932,7763
202108,9호선,염창,6010,6094,12104
202108,9호선,신목동,1200,1057,2257
202108,9호선,선유도,2028,2093,4121
202108,9호선,당산,6242,6336,12578
202108,9호선,국회의사당,2193,2121,4314
202108,9호선,여의도,5859,5185,11044
202108,9호선,샛강,1138,1192,2330
202108,9호선,노량진,10568,11273,21841
202108,9호선,노들,1683,1434,3117
202108,9호선,흑석,2684,2925,5609
202108,9호선,동작,765,645,1410
202108,9호선,구반포,700,804,1504
202108,9호선,신반포,919,1005,1924
202108,9호선,고속터미널,6840,8420,15260
202108,9호선,사평,1104,1102,2206
202108,9호선,신논현,10967,10604,21571
202108,9호선,언주,2471,2484,4955
202108,9호선,선정릉,2201,2454,4655
202108,9호선,삼성중앙,1401,1523,2924
202108,9호선,봉은사,6374,6717,13091
202108,9호선,종합운동장,1542,1434,2976
202108,9호선,삼전,2666,2694,5360
202108,9호선,석촌고분,2183,2245,4428
202108,9호선,석촌,3276,2862,6138
202108,9호선,송파나루,2244,2618,4862
202108,9호선,한성백제,1017,914,1931
202108,9호선,올림픽공원,2665,2577,5242
202108,9호선,둔촌오륜,273,291,564
202108,9호선,중앙보훈병원,2494,2333,4827
202108,9호선,중앙보훈병원,3720,3499,7219
202108,9호선,둔촌오륜,505,518,1023
202108,9호선,올림픽공원,4926,4514,9440
202108,9호선,한성백제,1559,1348,2907
202108,9호선,송파나루,3090,3447,6537
202108,9호선,석촌,5020,4446,9466
202108,9호선,석촌고분,3323,3192,6515
202108,9호선,삼전,3971,3734,7705
202108,9호선,종합운동장,2545,2122,4667
202108,9호선,봉은사,8097,8453,16550
202108,9호선,삼성중앙,2341,2336,4677
202108,9호선,선정릉,3490,3723,7213
202108,9호선,언주,4241,4316,8557
202108,9호선,신논현,19158,18585,37743
202108,9호선,사평,1659,1620,3279
202108,9호선,고속터미널,8713,13093,21806
202108,9호선,신반포,1804,1700,3504
202108,9호선,구반포,1327,1356,2683
202108,9호선,동작,1195,974,2169
202108,9호선,흑석,4308,4200,8508
202108,9호선,노들,2601,2184,4785
202108,9호선,노량진,16220,15478,31698
202108,9호선,샛강,2016,1935,3951
202108,9호선,여의도,7848,7347,15195
202108,9호선,국회의사당,2537,2597,5134
202108,9호선,당산,9553,8917,18470
202108,9호선,선유도,3252,2976,6228
202108,9호선,신목동,1778,1558,3336
202108,9호선,염창,9135,8296,17431
202108,9호선,등촌,6179,5860,12039
202108,9호선,증미,3547,3466,7013
202108,9호선,가양,10883,10166,21049
202108,9호선,양천향교,4644,4482,9126
202108,9호선,마곡나루,5978,5813,11791
202108,9호선,신방화,3858,3719,7577
202108,9호선,공항시장,1904,2016,3920
202108,9호선,김포공항,6145,11742,17887
202108,9호선,개화,1230,973,2203
202108,9호선,중앙보훈병원,2621,2474,5095
202108,9호선,둔촌오륜,310,324,634
202108,9호선,올림픽공원,3247,3294,6541
202108,9호선,한성백제,1074,969,2043
202108,9호선,송파나루,2371,2695,5066
202108,9호선,석촌,3593,3150,6743
202108,9호선,석촌고분,2378,2358,4736
202108,9호선,삼전,2823,2663,5486
202108,9호선,종합운동장,1654,1551,3205
202108,9호선,봉은사,6055,6149,12204
202108,9호선,삼성중앙,1518,1557,3075
202108,9호선,선정릉,2292,2522,4814
202108,9호선,언주,2468,2451,4919
202108,9호선,신논현,11591,11460,23051
202108,9호선,사평,1133,1146,2279
202108,9호선,고속터미널,7023,8946,15969
202108,9호선,신반포,1192,1234,2426
202108,9호선,구반포,815,900,1715
202108,9호선,동작,1165,986,2151
202108,9호선,흑석,2884,2974,5858
202108,9호선,노들,2004,1672,3676
202108,9호선,노량진,11417,11897,23314
202108,9호선,샛강,1229,1334,2563
202108,9호선,여의도,6068,5846,11914
202108,9호선,국회의사당,2454,2455,4909
202108,9호선,당산,6589,6481,13070
202108,9호선,선유도,2239,2224,4463
202108,9호선,신목동,1283,1150,2433
202108,9호선,염창,6548,6486,13034
202108,9호선,등촌,4168,4227,8395
202108,9호선,증미,2453,2497,4950
202108,9호선,가양,7767,7572,15339
202108,9호선,양천향교,3248,3269,6517
202108,9호선,마곡나루,4195,4285,8480
202108,9호선,신방화,2688,2617,5305
202108,9호선,공항시장,1440,1576,3016
202108,9호선,김포공항,6179,9483,15662
202108,9호선,개화,957,906,1863
202108,9호선,중앙보훈병원,3311,3095,6406
202108,9호선,올림픽공원,2665,2705,5370
202108,9호선,한성백제,1374,1190,2564
202108,9호선,송파나루,3140,3403,6543
202108,9호선,석촌,4674,4022,8696
202108,9호선,석촌고분,3200,3172,6372
202108,9호선,삼전,3868,3713,7581
202108,9호선,종합운동장,2525,2168,4693
202108,9호선,봉은사,7270,7601,14871
202108,9호선,삼성중앙,2267,2256,4523
202108,9호선,선정릉,3370,3652,7022
202108,9호선,언주,4350,4284,8634
202108,9호선,신논현,18305,18110,36415
202108,9호선,사평,2051,1881,3932
202108,9호선,고속터미널,7899,11395,19294
202108,9호선,신반포,1761,1672,3433
202108,9호선,구반포,1234,1310,2544
202108,9호선,동작,976,785,1761
202108,9호선,흑석,3967,3840,7807
202108,9호선,노들,2391,2056,4447
202108,9호선,노량진,16114,15464,31578
202108,9호선,샛강,1743,1808,3551
202108,9호선,여의도,8178,7589,15767
202108,9호선,국회의사당,2585,2654,5239
202108,9호선,당산,9203,8780,17983
202108,9호선,선유도,2778,2709,5487
202108,9호선,신목동,1613,1389,3002
202108,9호선,염창,8321,7872,16193
202108,9호선,등촌,5700,5464,11164
202108,9호선,증미,3135,3223,6358
202108,9호선,가양,9982,9606,19588
202108,9호선,양천향교,4467,4375,8842
202108,9호선,마곡나루,5412,5389,10801
202108,9호선,신방화,3703,3556,7259
202108,9호선,공항시장,1805,1856,3661
202108,9호선,김포공항,5499,8362,13861
202108,9호선,개화,1038,893,1931
202108,9호선,둔촌오륜,441,455,896
202108,9호선,개화,956,911,1867
202108,9호선,김포공항,6197,9396,15593
202108,9호선,공항시장,1444,1540,2984
202108,9호선,신방화,2796,2735,5531
202108,9호선,마곡나루,4332,4487,8819
202108,9호선,양천향교,3413,3619,7032
202108,9호선,가양,7956,7852,15808
202108,9호선,증미,2067,2082,4149
202108,9호선,등촌,4257,4351,8608
202108,9호선,염창,6656,6576,13232
202108,9호선,신목동,1396,1303,2699
202108,9호선,선유도,2299,2300,4599
202108,9호선,당산,6790,6839,13629
202108,9호선,국회의사당,2647,2585,5232
202108,9호선,여의도,6208,5921,12129
202108,9호선,샛강,1242,1295,2537
202108,9호선,노량진,11610,12286,23896
202108,9호선,노들,1984,1736,3720
202108,9호선,흑석,3088,3308,6396
202108,9호선,동작,1044,850,1894
202108,9호선,구반포,875,930,1805
202108,9호선,신반포,1196,1231,2427
202108,9호선,고속터미널,7377,9367,16744
202108,9호선,사평,1140,1279,2419
202108,9호선,신논현,12102,11774,23876
202108,9호선,언주,2608,2611,5219
202108,9호선,선정릉,2568,2762,5330
202108,9호선,삼성중앙,1518,1604,3122
202108,9호선,봉은사,6415,6510,12925
202108,9호선,종합운동장,1617,1522,3139
202108,9호선,삼전,2848,2847,5695
202108,9호선,석촌고분,2466,2445,4911
202108,9호선,석촌,3764,3271,7035
202108,9호선,송파나루,2396,2694,5090
202108,9호선,한성백제,1125,1052,2177
202108,9호선,올림픽공원,2506,2483,4989
202108,9호선,둔촌오륜,339,378,717
202108,9호선,중앙보훈병원,2752,2705,5457
202108,9호선,개화,1413,1171,2584
202108,9호선,김포공항,6751,10978,17729
202108,9호선,공항시장,1997,2155,4152
202108,9호선,신방화,4062,4025,8087
202108,9호선,마곡나루,6883,6882,13765
202108,9호선,양천향교,5254,5110,10364
202108,9호선,가양,11951,11214,23165
202108,9호선,증미,3764,3627,7391
202108,9호선,등촌,6690,6608,13298
202108,9호선,염창,9780,9132,18912
202108,9호선,신목동,2025,1677,3702
202108,9호선,선유도,3378,3221,6599
202108,9호선,당산,10577,9814,20391
202108,9호선,국회의사당,3012,3094,6106
202108,9호선,여의도,9074,9000,18074
202108,9호선,샛강,2192,2194,4386
202108,9호선,노량진,18145,17612,35757
202108,9호선,노들,2897,2384,5281
202108,9호선,흑석,4630,4653,9283
202108,9호선,동작,1371,1052,2423
202108,9호선,구반포,1532,1617,3149
202108,9호선,신반포,2081,2032,4113
202108,9호선,고속터미널,10106,13948,24054
202108,9호선,사평,1854,1748,3602
202108,9호선,신논현,21276,20932,42208
202108,9호선,언주,4607,4637,9244
202108,9호선,선정릉,3919,4312,8231
202108,9호선,삼성중앙,2455,2549,5004
202108,9호선,봉은사,9236,9727,18963
202108,9호선,종합운동장,2417,2434,4851
202108,9호선,삼전,4360,4036,8396
202108,9호선,석촌고분,3679,3545,7224
202108,9호선,석촌,5583,4840,10423
202108,9호선,송파나루,3320,3691,7011
202108,9호선,한성백제,1605,1375,2980
202108,9호선,올림픽공원,3490,3518,7008
202108,9호선,둔촌오륜,533,548,1081
202108,9호선,중앙보훈병원,3997,3802,7799
202108,9호선,개화,942,867,1809
202108,9호선,김포공항,6525,10141,16666
202108,9호선,공항시장,1424,1620,3044
202108,9호선,신방화,2875,2791,5666
202108,9호선,마곡나루,4650,4805,9455
202108,9호선,양천향교,3393,3643,7036
202108,9호선,가양,8037,8195,16232
202108,9호선,증미,2454,2501,4955
202108,9호선,등촌,4576,4593,9169
202108,9호선,염창,6871,6936,13807
202108,9호선,신목동,1374,1246,2620
202108,9호선,선유도,2282,2280,4562
202108,9호선,당산,7150,6981,14131
202108,9호선,국회의사당,2854,2827,5681
202108,9호선,여의도,6468,6132,12600
202108,9호선,샛강,1448,1391,2839
202108,9호선,노량진,12069,12830,24899
202108,9호선,노들,2013,1778,3791
202108,9호선,흑석,3144,3277,6421
202108,9호선,동작,969,801,1770
202108,9호선,구반포,780,834,1614
202108,9호선,신반포,1274,1278,2552
202108,9호선,고속터미널,8146,9939,18085
202108,9호선,사평,1206,1256,2462
202108,9호선,신논현,12636,12125,24761
202108,9호선,언주,2601,2701,5302
202108,9호선,선정릉,2609,2821,5430
202108,9호선,삼성중앙,1602,1626,3228
202108,9호선,봉은사,5608,5606,11214
202108,9호선,종합운동장,1685,1601,3286
202108,9호선,삼전,3015,2919,5934
202108,9호선,석촌고분,2542,2500,5042
202108,9호선,석촌,3801,3297,7098
202108,9호선,송파나루,2316,2766,5082
202108,9호선,한성백제,1068,1000,2068
202108,9호선,올림픽공원,2577,2660,5237
202108,9호선,둔촌오륜,344,396,740
202108,9호선,중앙보훈병원,2773,2675,5448
202109,9호선,개화,1460,1202,2662
202109,9호선,김포공항,6575,10712,17287
202109,9호선,공항시장,1974,2125,4099
202109,9호선,신방화,4196,4098,8294
202109,9호선,마곡나루,6902,6922,13824
202109,9호선,양천향교,5293,5220,10513
202109,9호선,가양,12626,11708,24334
202109,9호선,증미,3840,3719,7559
202109,9호선,등촌,6853,6683,13536
202109,9호선,염창,10303,9581,19884
202109,9호선,신목동,2122,1794,3916
202109,9호선,선유도,3714,3557,7271
202109,9호선,당산,11312,10489,21801
202109,9호선,국회의사당,3307,3347,6654
202109,9호선,여의도,9748,9668,19416
202109,9호선,샛강,2165,2273,4438
202109,9호선,노량진,18974,18666,37640
202109,9호선,노들,3143,2585,5728
202109,9호선,흑석,5031,4999,10030
202109,9호선,동작,1469,1201,2670
202109,9호선,구반포,1573,1640,3213
202109,9호선,신반포,2305,2270,4575
202109,9호선,고속터미널,10817,14872,25689
202109,9호선,사평,1896,1795,3691
202109,9호선,신논현,21641,21223,42864
202109,9호선,언주,4913,5018,9931
202109,9호선,선정릉,4291,4681,8972
202109,9호선,삼성중앙,2572,2593,5165
202109,9호선,봉은사,8171,8409,16580
202109,9호선,종합운동장,2666,2384,5050
202109,9호선,삼전,4557,4302,8859
202109,9호선,석촌고분,3726,3646,7372
202109,9호선,석촌,5749,4985,10734
202109,9호선,송파나루,3480,3931,7411
202109,9호선,한성백제,1842,1573,3415
202109,9호선,올림픽공원,4977,4952,9929
202109,9호선,둔촌오륜,574,551,1125
202109,9호선,중앙보훈병원,4060,3784,7844
202109,9호선,중앙보훈병원,2954,2853,5807
202109,9호선,둔촌오륜,354,380,734
202109,9호선,올림픽공원,3713,3703,7416
202109,9호선,한성백제,1239,1085,2324
202109,9호선,송파나루,2418,2807,5225
202109,9호선,석촌,3989,3396,7385
202109,9호선,석촌고분,2570,2618,5188
202109,9호선,삼전,3072,2989,6061
202109,9호선,종합운동장,1722,1712,3434
202109,9호선,봉은사,5711,5777,11488
202109,9호선,삼성중앙,1654,1716,3370
202109,9호선,선정릉,2577,2967,5544
202109,9호선,언주,2851,2853,5704
202109,9호선,신논현,13001,12489,25490
202109,9호선,사평,1243,1266,2509
202109,9호선,고속터미널,8871,11073,19944
202109,9호선,신반포,1393,1447,2840
202109,9호선,구반포,859,912,1771
202109,9호선,동작,1131,921,2052
202109,9호선,흑석,3249,3396,6645
202109,9호선,노들,2282,2026,4308
202109,9호선,노량진,12855,13678,26533
202109,9호선,샛강,1505,1481,2986
202109,9호선,여의도,7043,6803,13846
202109,9호선,국회의사당,3250,3150,6400
202109,9호선,당산,7515,7593,15108
202109,9호선,선유도,2590,2477,5067
202109,9호선,신목동,1444,1354,2798
202109,9호선,염창,7183,7184,14367
202109,9호선,증미,2589,2584,5173
202109,9호선,가양,8529,8627,17156
202109,9호선,양천향교,3753,3858,7611
202109,9호선,마곡나루,4781,4987,9768
202109,9호선,신방화,3005,2870,5875
202109,9호선,공항시장,1443,1669,3112
202109,9호선,김포공항,6203,9682,15885
202109,9호선,개화,1080,1079,2159
202109,9호선,등촌,4442,4729,9171
202109,9호선,개화,1401,1248,2649
202109,9호선,김포공항,6701,10908,17609
202109,9호선,공항시장,2143,2271,4414
202109,9호선,신방화,4474,4184,8658
202109,9호선,마곡나루,7233,7492,14725
202109,9호선,양천향교,5307,5180,10487
202109,9호선,가양,12727,12014,24741
202109,9호선,증미,3932,3817,7749
202109,9호선,등촌,7017,6866,13883
202109,9호선,염창,10783,9860,20643
202109,9호선,신목동,2166,1906,4072
202109,9호선,선유도,3604,3566,7170
202109,9호선,당산,11604,10789,22393
202109,9호선,국회의사당,3409,3562,6971
202109,9호선,여의도,9906,9713,19619
202109,9호선,샛강,2201,2344,4545
202109,9호선,노량진,19933,19581,39514
202109,9호선,노들,3157,2729,5886
202109,9호선,흑석,5065,5184,10249
202109,9호선,동작,1605,1319,2924
202109,9호선,구반포,1711,1877,3588
202109,9호선,신반포,2434,2467,4901
202109,9호선,고속터미널,11008,15555,26563
202109,9호선,사평,1940,1820,3760
202109,9호선,신논현,22473,21847,44320
202109,9호선,언주,4960,5070,10030
202109,9호선,선정릉,4535,5078,9613
202109,9호선,삼성중앙,2730,2651,5381
202109,9호선,봉은사,8364,8590,16954
202109,9호선,종합운동장,2802,2393,5195
202109,9호선,삼전,4465,4213,8678
202109,9호선,석촌고분,3833,3586,7419
202109,9호선,석촌,5770,4987,10757
202109,9호선,송파나루,3514,4033,7547
202109,9호선,한성백제,1913,1671,3584
202109,9호선,올림픽공원,4896,4781,9677
202109,9호선,둔촌오륜,591,619,1210
202109,9호선,중앙보훈병원,4265,3941,8206
202109,9호선,중앙보훈병원,3103,3118,6221
202109,9호선,둔촌오륜,394,405,799
202109,9호선,올림픽공원,3646,3756,7402
202109,9호선,한성백제,1367,1181,2548
202109,9호선,송파나루,2602,2963,5565
202109,9호선,석촌,4246,3774,8020
202109,9호선,석촌고분,2684,2698,5382
202109,9호선,삼전,3112,3087,6199
202109,9호선,종합운동장,1813,1749,3562
202109,9호선,봉은사,6008,6251,12259
202109,9호선,삼성중앙,1727,1852,3579
202109,9호선,선정릉,2846,3189,6035
202109,9호선,언주,3244,3190,6434
202109,9호선,신논현,13763,13025,26788
202109,9호선,사평,1301,1341,2642
202109,9호선,고속터미널,9142,11769,20911
202109,9호선,신반포,1405,1458,2863
202109,9호선,개화,1076,1028,2104
202109,9호선,김포공항,6564,9734,16298
202109,9호선,공항시장,1505,1655,3160
202109,9호선,신방화,3104,3039,6143
202109,9호선,마곡나루,5316,5309,10625
202109,9호선,양천향교,3803,4055,7858
202109,9호선,가양,8737,8709,17446
202109,9호선,증미,2269,2354,4623
202109,9호선,등촌,4707,4801,9508
202109,9호선,염창,7550,7307,14857
202109,9호선,신목동,1543,1425,2968
202109,9호선,선유도,2958,2911,5869
202109,9호선,당산,7850,7631,15481
202109,9호선,국회의사당,3222,3244,6466
202109,9호선,여의도,7589,6989,14578
202109,9호선,샛강,1500,1544,3044
202109,9호선,노량진,13150,14008,27158
202109,9호선,노들,2393,2061,4454
202109,9호선,흑석,3496,3656,7152
202109,9호선,동작,1367,1158,2525
202109,9호선,구반포,854,950,1804
202109,9호선,개화,1382,1133,2515
202109,9호선,김포공항,6151,13871,20022
202109,9호선,공항시장,1940,2012,3952
202109,9호선,신방화,4099,3828,7927
202109,9호선,마곡나루,5842,5623,11465
202109,9호선,양천향교,4888,4309,9197
202109,9호선,가양,12189,10707,22896
202109,9호선,증미,3852,3592,7444
202109,9호선,등촌,6840,6267,13107
202109,9호선,염창,9985,8617,18602
202109,9호선,신목동,2063,1730,3793
202109,9호선,선유도,3398,3123,6521
202109,9호선,당산,10309,8918,19227
202109,9호선,국회의사당,2611,2613,5224
202109,9호선,여의도,8497,8162,16659
202109,9호선,샛강,2235,2232,4467
202109,9호선,노량진,18733,17062,35795
202109,9호선,노들,2933,2451,5384
202109,9호선,흑석,4842,4707,9549
202109,9호선,동작,1109,839,1948
202109,9호선,구반포,1397,1456,2853
202109,9호선,신반포,2036,1959,3995
202109,9호선,고속터미널,10214,22050,32264
202109,9호선,사평,1948,1791,3739
202109,9호선,신논현,20449,20109,40558
202109,9호선,언주,4239,3915,8154
202109,9호선,선정릉,3677,3733,7410
202109,9호선,삼성중앙,2356,2246,4602
202109,9호선,봉은사,7457,7535,14992
202109,9호선,종합운동장,2422,2134,4556
202109,9호선,삼전,4177,3555,7732
202109,9호선,석촌고분,3618,3153,6771
202109,9호선,석촌,5430,4329,9759
202109,9호선,송파나루,3235,3450,6685
202109,9호선,한성백제,1607,1240,2847
202109,9호선,올림픽공원,4119,4205,8324
202109,9호선,둔촌오륜,464,480,944
202109,9호선,중앙보훈병원,3671,3507,7178
202109,9호선,중앙보훈병원,2657,2467,5124
202109,9호선,둔촌오륜,339,335,674
202109,9호선,올림픽공원,3281,3226,6507
202109,9호선,한성백제,1055,902,1957
202109,9호선,송파나루,2270,2476,4746
202109,9호선,석촌,3709,2928,6637
202109,9호선,석촌고분,2503,2108,4611
202109,9호선,삼전,2838,2355,5193
202109,9호선,종합운동장,1550,1286,2836
202109,9호선,봉은사,5222,5180,10402
202109,9호선,삼성중앙,1458,1401,2859
202109,9호선,선정릉,2268,2326,4594
202109,9호선,언주,2188,2028,4216
202109,9호선,신논현,12166,11349,23515
202109,9호선,사평,1200,1144,2344
202109,9호선,고속터미널,7338,15878,23216
202109,9호선,신반포,1188,1246,2434
202109,9호선,구반포,749,793,1542
202109,9호선,동작,828,638,1466
202109,9호선,흑석,3128,3090,6218
202109,9호선,노들,2277,1837,4114
202109,9호선,노량진,12792,11607,24399
202109,9호선,샛강,1321,1343,2664
202109,9호선,여의도,6320,5889,12209
202109,9호선,국회의사당,2352,2177,4529
202109,9호선,당산,6574,5870,12444
202109,9호선,선유도,2296,2106,4402
202109,9호선,신목동,1397,1278,2675
202109,9호선,염창,7096,6167,13263
202109,9호선,등촌,4825,4443,9268
202109,9호선,증미,2835,2532,5367
202109,9호선,가양,8496,7663,16159
202109,9호선,양천향교,3434,3024,6458
202109,9호선,마곡나루,4014,3676,7690
202109,9호선,신방화,2915,2668,5583
202109,9호선,공항시장,1503,1518,3021
202109,9호선,김포공항,5293,11406,16699
202109,9호선,개화,1051,898,1949
202109,9호선,중앙보훈병원,4086,3913,7999
202109,9호선,둔촌오륜,568,593,1161
202109,9호선,올림픽공원,4219,4642,8861
202109,9호선,한성백제,1759,1538,3297
202109,9호선,송파나루,3331,3877,7208
202109,9호선,석촌,5837,5084,10921
202109,9호선,석촌고분,3654,3604,7258
202109,9호선,삼전,4311,4110,8421
202109,9호선,종합운동장,2490,2346,4836
202109,9호선,봉은사,8065,8352,16417
202109,9호선,삼성중앙,2577,2570,5147
202109,9호선,선정릉,4372,4720,9092
202109,9호선,언주,4991,5042,10033
202109,9호선,신논현,21900,21875,43775
202109,9호선,사평,1877,1769,3646
202109,9호선,고속터미널,10937,14640,25577
202109,9호선,신반포,2302,2228,4530
202109,9호선,구반포,1454,1562,3016
202109,9호선,동작,1335,1171,2506
202109,9호선,흑석,5009,4978,9987
202109,9호선,노들,3097,2737,5834
202109,9호선,노량진,18561,18425,36986
202109,9호선,샛강,2210,2296,4506
202109,9호선,여의도,9528,9231,18759
202109,9호선,국회의사당,3454,3647,7101
202109,9호선,당산,10846,10368,21214
202109,9호선,선유도,3478,3610,7088
202109,9호선,신목동,2082,1801,3883
202109,9호선,염창,10111,9732,19843
202109,9호선,등촌,6599,6388,12987
202109,9호선,증미,3615,3558,7173
202109,9호선,가양,12136,11578,23714
202109,9호선,양천향교,5135,5063,10198
202109,9호선,마곡나루,7001,7139,14140
202109,9호선,신방화,4190,3945,8135
202109,9호선,공항시장,2051,2160,4211
202109,9호선,김포공항,6971,10390,17361
202109,9호선,개화,1372,1192,2564
202109,9호선,중앙보훈병원,3004,2812,5816
202109,9호선,둔촌오륜,366,420,786
202109,9호선,올림픽공원,3685,3999,7684
202109,9호선,한성백제,1438,1157,2595
202109,9호선,송파나루,2435,2785,5220
202109,9호선,석촌,4013,3591,7604
202109,9호선,석촌고분,2579,2560,5139
202109,9호선,삼전,3067,2959,6026
202109,9호선,종합운동장,1683,1676,3359
202109,9호선,봉은사,6068,6173,12241
202109,9호선,삼성중앙,1593,1657,3250
202109,9호선,선정릉,2668,2970,5638
202109,9호선,언주,3017,3133,6150
202109,9호선,신논현,12961,12730,25691
202109,9호선,사평,1168,1273,2441
202109,9호선,고속터미널,8659,11236,19895
202109,9호선,신반포,1380,1458,2838
202109,9호선,구반포,874,942,1816
202109,9호선,동작,1089,935,2024
202109,9호선,흑석,3294,3465,6759
202109,9호선,노들,2568,2259,4827
202109,9호선,노량진,12952,13633,26585
202109,9호선,샛강,1452,1550,3002
202109,9호선,여의도,6936,6506,13442
202109,9호선,국회의사당,3265,3192,6457
202109,9호선,당산,7546,7501,15047
202109,9호선,선유도,2704,2646,5350
202109,9호선,신목동,1512,1297,2809
202109,9호선,염창,7175,7091,14266
202109,9호선,등촌,4518,4529,9047
202109,9호선,증미,2129,2155,4284
202109,9호선,가양,8607,8555,17162
202109,9호선,양천향교,3628,3841,7469
202109,9호선,마곡나루,4909,5111,10020
202109,9호선,신방화,2855,2863,5718
202109,9호선,공항시장,1579,1661,3240
202109,9호선,김포공항,6525,9324,15849
202109,9호선,개화,1040,992,2032
202110,9호선,개화,1462,1198,2660
202110,9호선,김포공항,6845,12880,19725
202110,9호선,공항시장,2139,2264,4403
202110,9호선,신방화,4300,4109,8409
202110,9호선,마곡나루,7284,7135,14419
202110,9호선,양천향교,5442,5204,10646
202110,9호선,가양,13112,12218,25330
202110,9호선,증미,3775,3552,7327
202110,9호선,등촌,7015,6734,13749
202110,9호선,염창,10885,9975,20860
202110,9호선,신목동,2220,1844,4064
202110,9호선,선유도,3923,3725,7648
202110,9호선,당산,11790,10985,22775
202110,9호선,국회의사당,3597,3750,7347
202110,9호선,여의도,10475,10030,20505
202110,9호선,샛강,2247,2356,4603
202110,9호선,노량진,20274,19652,39926
202110,9호선,노들,3334,2837,6171
202110,9호선,흑석,5108,5110,10218
202110,9호선,동작,1464,1216,2680
202110,9호선,구반포,1553,1633,3186
202110,9호선,신반포,2437,2338,4775
202110,9호선,고속터미널,11669,16708,28377
202110,9호선,사평,2025,1852,3877
202110,9호선,신논현,22811,22032,44843
202110,9호선,언주,5401,5516,10917
202110,9호선,선정릉,4519,4988,9507
202110,9호선,삼성중앙,2730,2664,5394
202110,9호선,봉은사,8765,9180,17945
202110,9호선,종합운동장,2911,2621,5532
202110,9호선,삼전,4566,4178,8744
202110,9호선,석촌고분,3731,3617,7348
202110,9호선,석촌,6251,5260,11511
202110,9호선,송파나루,3558,3860,7418
202110,9호선,한성백제,2077,1705,3782
202110,9호선,올림픽공원,5912,6444,12356
202110,9호선,둔촌오륜,620,626,1246
202110,9호선,중앙보훈병원,4133,3891,8024
202110,9호선,개화,1152,1090,2242
202110,9호선,김포공항,6479,10464,16943
202110,9호선,공항시장,1651,1741,3392
202110,9호선,신방화,3293,3147,6440
202110,9호선,마곡나루,5616,5664,11280
202110,9호선,양천향교,3927,4024,7951
202110,9호선,가양,9324,9122,18446
202110,9호선,증미,2836,2772,5608
202110,9호선,등촌,5072,4956,10028
202110,9호선,염창,7931,7666,15597
202110,9호선,신목동,1605,1441,3046
202110,9호선,선유도,2961,2913,5874
202110,9호선,당산,8364,7903,16267
202110,9호선,국회의사당,3575,3550,7125
202110,9호선,여의도,8145,7656,15801
202110,9호선,샛강,1558,1528,3086
202110,9호선,노량진,14314,14684,28998
202110,9호선,노들,2675,2350,5025
202110,9호선,흑석,3652,3714,7366
202110,9호선,동작,1183,964,2147
202110,9호선,구반포,1056,1184,2240
202110,9호선,신반포,1554,1603,3157
202110,9호선,고속터미널,8869,12115,20984
202110,9호선,사평,1277,1283,2560
202110,9호선,신논현,14338,13618,27956
202110,9호선,언주,3361,3461,6822
202110,9호선,선정릉,2819,3181,6000
202110,9호선,삼성중앙,1791,1836,3627
202110,9호선,봉은사,6754,6805,13559
202110,9호선,종합운동장,1857,1659,3516
202110,9호선,삼전,3287,3000,6287
202110,9호선,석촌고분,2783,2739,5522
202110,9호선,석촌,4355,3694,8049
202110,9호선,송파나루,2787,3091,5878
202110,9호선,한성백제,1688,1406,3094
202110,9호선,올림픽공원,4021,4703,8724
202110,9호선,둔촌오륜,369,408,777
202110,9호선,중앙보훈병원,3084,2964,6048
202110,9호선,개화,1484,1253,2737
202110,9호선,김포공항,7541,13036,20577
202110,9호선,공항시장,2040,2075,4115
202110,9호선,신방화,4132,3837,7969
202110,9호선,마곡나루,7341,7381,14722
202110,9호선,양천향교,5156,4861,10017
202110,9호선,가양,12000,11132,23132
202110,9호선,증미,3560,3399,6959
202110,9호선,등촌,6319,5969,12288
202110,9호선,염창,10503,9322,19825
202110,9호선,신목동,2282,1915,4197
202110,9호선,선유도,3604,3423,7027
202110,9호선,당산,10963,10222,21185
202110,9호선,국회의사당,3528,3725,7253
202110,9호선,여의도,10359,10143,20502
202110,9호선,샛강,2113,2239,4352
202110,9호선,노량진,19222,18703,37925
202110,9호선,노들,3140,2601,5741
202110,9호선,흑석,4506,4437,8943
202110,9호선,동작,1348,1165,2513
202110,9호선,구반포,1640,1790,3430
202110,9호선,신반포,2005,1923,3928
202110,9호선,고속터미널,11202,17452,28654
202110,9호선,사평,1723,1593,3316
202110,9호선,신논현,19896,19049,38945
202110,9호선,언주,4776,5002,9778
202110,9호선,선정릉,4056,4590,8646
202110,9호선,삼성중앙,2474,2520,4994
202110,9호선,봉은사,8685,9214,17899
202110,9호선,종합운동장,2948,2539,5487
202110,9호선,삼전,4246,3874,8120
202110,9호선,석촌고분,3506,3383,6889
202110,9호선,석촌,5832,4849,10681
202110,9호선,송파나루,3573,3955,7528
202110,9호선,한성백제,1979,1707,3686
202110,9호선,올림픽공원,5816,6259,12075
202110,9호선,둔촌오륜,581,573,1154
202110,9호선,중앙보훈병원,3921,3710,7631
202110,9호선,중앙보훈병원,2920,2942,5862
202110,9호선,둔촌오륜,396,397,793
202110,9호선,올림픽공원,5319,5491,10810
202110,9호선,한성백제,1383,1200,2583
202110,9호선,송파나루,2863,2966,5829
202110,9호선,석촌,4108,3464,7572
202110,9호선,석촌고분,2583,2645,5228
202110,9호선,삼전,3057,3068,6125
202110,9호선,종합운동장,1856,1668,3524
202110,9호선,봉은사,7555,7674,15229
202110,9호선,삼성중앙,1763,1906,3669
202110,9호선,선정릉,2760,3201,5961
202110,9호선,언주,3551,3609,7160
202110,9호선,신논현,13958,13330,27288
202110,9호선,사평,1271,1247,2518
202110,9호선,고속터미널,8321,11633,19954
202110,9호선,신반포,1327,1355,2682
202110,9호선,구반포,930,985,1915
202110,9호선,동작,944,800,1744
202110,9호선,흑석,3342,3487,6829
202110,9호선,노들,2151,1892,4043
202110,9호선,노량진,13260,13764,27024
202110,9호선,샛강,1448,1554,3002
202110,9호선,여의도,9163,7722,16885
202110,9호선,국회의사당,3376,3530,6906
202110,9호선,당산,7854,7614,15468
202110,9호선,선유도,2548,2562,5110
202110,9호선,신목동,1497,1352,2849
202110,9호선,염창,7508,7319,14827
202110,9호선,등촌,4585,4634,9219
202110,9호선,증미,2221,2259,4480
202110,9호선,가양,8551,8262,16813
202110,9호선,양천향교,3795,3754,7549
202110,9호선,마곡나루,5217,5141,10358
202110,9호선,신방화,2918,2968,5886
202110,9호선,공항시장,1522,1693,3215
202110,9호선,김포공항,6773,11495,18268
202110,9호선,개화,1091,968,2059
202110,9호선,개화,1505,1336,2841
202110,9호선,김포공항,7660,12387,20047
202110,9호선,공항시장,2230,2327,4557
202110,9호선,신방화,4596,4333,8929
202110,9호선,마곡나루,7720,7573,15293
202110,9호선,양천향교,5746,5592,11338
202110,9호선,가양,13562,12868,26430
202110,9호선,증미,3977,3899,7876
202110,9호선,등촌,7082,6948,14030
202110,9호선,염창,11019,10298,21317
202110,9호선,신목동,2240,1960,4200
202110,9호선,선유도,3796,3755,7551
202110,9호선,당산,12360,11589,23949
202110,9호선,국회의사당,3965,4303,8268
202110,9호선,여의도,11848,10474,22322
202110,9호선,샛강,2379,2574,4953
202110,9호선,노량진,20898,20087,40985
202110,9호선,노들,3159,2844,6003
202110,9호선,흑석,5109,5135,10244
202110,9호선,동작,1346,1141,2487
202110,9호선,구반포,1676,1765,3441
202110,9호선,신반포,2433,2508,4941
202110,9호선,고속터미널,11424,16684,28108
202110,9호선,사평,2382,2322,4704
202110,9호선,신논현,24152,23216,47368
202110,9호선,언주,5901,5960,11861
202110,9호선,선정릉,4751,5544,10295
202110,9호선,삼성중앙,3024,3095,6119
202110,9호선,봉은사,11950,12374,24324
202110,9호선,종합운동장,3142,2644,5786
202110,9호선,삼전,4937,4736,9673
202110,9호선,석촌고분,3966,3802,7768
202110,9호선,석촌,6295,5254,11549
202110,9호선,송파나루,4103,4129,8232
202110,9호선,한성백제,2307,1909,4216
202110,9호선,올림픽공원,5448,5979,11427
202110,9호선,둔촌오륜,616,628,1244
202110,9호선,중앙보훈병원,4337,4156,8493
202110,9호선,당산,8131,7982,16113
202110,9호선,개화,1071,987,2058
202110,9호선,김포공항,6912,10749,17661
202110,9호선,공항시장,1558,1672,3230
202110,9호선,신방화,3078,3056,6134
202110,9호선,마곡나루,5126,5195,10321
202110,9호선,양천향교,3949,4089,8038
202110,9호선,가양,8918,8690,17608
202110,9호선,증미,2502,2553,5055
202110,9호선,등촌,4602,4760,9362
202110,9호선,염창,7556,7349,14905
202110,9호선,신목동,1527,1409,2936
202110,9호선,선유도,2613,2574,5187
202110,9호선,국회의사당,3790,3707,7497
202110,9호선,여의도,8066,7168,15234
202110,9호선,샛강,1591,1566,3157
202110,9호선,노량진,13439,14118,27557
202110,9호선,노들,2340,2027,4367
202110,9호선,흑석,3331,3432,6763
202110,9호선,동작,1050,854,1904
202110,9호선,구반포,818,882,1700
202110,9호선,신반포,1425,1466,2891
202110,9호선,고속터미널,8870,11823,20693
202110,9호선,사평,1308,1382,2690
202110,9호선,신논현,13358,12949,26307
202110,9호선,언주,3584,3594,7178
202110,9호선,선정릉,2929,3382,6311
202110,9호선,삼성중앙,1783,1871,3654
202110,9호선,봉은사,8174,8423,16597
202110,9호선,종합운동장,1908,1693,3601
202110,9호선,삼전,3200,3159,6359
202110,9호선,석촌고분,2738,2692,5430
202110,9호선,석촌,4313,3634,7947
202110,9호선,송파나루,2953,2965,5918
202110,9호선,한성백제,1551,1312,2863
202110,9호선,올림픽공원,4250,4668,8918
202110,9호선,둔촌오륜,426,451,877
202110,9호선,중앙보훈병원,3099,3129,6228
202110,9호선,석촌,6613,5447,12060
202110,9호선,중앙보훈병원,4711,4553,9264
202110,9호선,둔촌오륜,597,627,1224
202110,9호선,올림픽공원,7289,7646,14935
202110,9호선,한성백제,2260,1931,4191
202110,9호선,송파나루,3943,4289,8232
202110,9호선,석촌고분,4233,3970,8203
202110,9호선,삼전,4829,4471,9300
202110,9호선,종합운동장,3015,2663,5678
202110,9호선,봉은사,10583,11286,21869
202110,9호선,삼성중앙,2994,2950,5944
202110,9호선,선정릉,4927,5635,10562
202110,9호선,언주,5979,6179,12158
202110,9호선,신논현,25082,24415,49497
202110,9호선,사평,2201,2046,4247
202110,9호선,고속터미널,12117,17484,29601
202110,9호선,신반포,2701,2519,5220
202110,9호선,구반포,1659,1757,3416
202110,9호선,동작,1492,1259,2751
202110,9호선,흑석,5625,5490,11115
202110,9호선,노들,3311,2830,6141
202110,9호선,노량진,21292,20717,42009
202110,9호선,샛강,2444,2520,4964
202110,9호선,여의도,11535,11238,22773
202110,9호선,국회의사당,3932,4156,8088
202110,9호선,당산,12588,12032,24620
202110,9호선,선유도,4003,3788,7791
202110,9호선,신목동,2372,2057,4429
202110,9호선,염창,11705,10780,22485
202110,9호선,등촌,7280,7045,14325
202110,9호선,증미,3999,3870,7869
202110,9호선,가양,14236,13453,27689
202110,9호선,양천향교,5846,5668,11514
202110,9호선,마곡나루,7979,7992,15971
202110,9호선,신방화,4673,4504,9177
202110,9호선,공항시장,2121,2286,4407
202110,9호선,김포공항,7935,12714,20649
202110,9호선,개화,1586,1340,2926
202110,9호선,개화,1229,1122,2351
202110,9호선,김포공항,7248,11702,18950
202110,9호선,공항시장,1675,1913,3588
202110,9호선,신방화,3296,3182,6478
202110,9호선,마곡나루,5639,5786,11425
202110,9호선,양천향교,4191,4358,8549
202110,9호선,가양,9792,9897,19689
202110,9호선,증미,2360,2336,4696
202110,9호선,등촌,4994,5001,9995
202110,9호선,염창,8188,8178,16366
202110,9호선,신목동,1672,1529,3201
202110,9호선,선유도,2920,2842,5762
202110,9호선,당산,8548,8561,17109
202110,9호선,국회의사당,4050,3974,8024
202110,9호선,여의도,8537,7824,16361
202110,9호선,샛강,1603,1642,3245
202110,9호선,노량진,14200,15247,29447
202110,9호선,노들,2450,2244,4694
202110,9호선,흑석,3529,3637,7166
202110,9호선,동작,1122,1003,2125
202110,9호선,신반포,1543,1668,3211
202110,9호선,고속터미널,9919,13239,23158
202110,9호선,사평,1399,1436,2835
202110,9호선,신논현,14608,13624,28232
202110,9호선,언주,3609,3694,7303
202110,9호선,선정릉,2968,3391,6359
202110,9호선,삼성중앙,1886,1965,3851
202110,9호선,봉은사,6905,7025,13930
202110,9호선,종합운동장,2010,1820,3830
202110,9호선,삼전,3374,3289,6663
202110,9호선,석촌고분,2932,2849,5781
202110,9호선,석촌,4598,3972,8570
202110,9호선,송파나루,2824,3114,5938
202110,9호선,한성백제,1851,1515,3366
202110,9호선,올림픽공원,6098,6567,12665
202110,9호선,둔촌오륜,443,440,883
202110,9호선,중앙보훈병원,3103,3169,6272
202110,9호선,구반포,947,981,1928
202110,9호선,중앙보훈병원,4704,4476,9180
202110,9호선,둔촌오륜,655,621,1276
202110,9호선,올림픽공원,7289,7825,15114
202110,9호선,한성백제,2563,2142,4705
202110,9호선,송파나루,4114,4416,8530
202110,9호선,석촌,6962,5719,12681
202110,9호선,석촌고분,4268,3909,8177
202110,9호선,삼전,4801,4551,9352
202110,9호선,종합운동장,3072,2682,5754
202110,9호선,봉은사,9723,10346,20069
202110,9호선,삼성중앙,3010,2997,6007
202110,9호선,선정릉,5149,5956,11105
202110,9호선,언주,6454,6481,12935
202110,9호선,신논현,25609,25052,50661
202110,9호선,사평,2217,2067,4284
202110,9호선,고속터미널,12396,17855,30251
202110,9호선,신반포,2511,2557,5068
202110,9호선,구반포,1719,1782,3501
202110,9호선,동작,1645,1327,2972
202110,9호선,흑석,5557,5564,11121
202110,9호선,노들,3383,2888,6271
202110,9호선,노량진,21559,21312,42871
202110,9호선,샛강,2516,2565,5081
202110,9호선,여의도,11503,10924,22427
202110,9호선,국회의사당,4216,4403,8619
202110,9호선,당산,12812,12135,24947
202110,9호선,선유도,4028,4092,8120
202110,9호선,신목동,2633,2211,4844
202110,9호선,염창,12233,10977,23210
202110,9호선,등촌,7522,7161,14683
202110,9호선,증미,4343,4260,8603
202110,9호선,가양,14087,13286,27373
202110,9호선,양천향교,5823,5630,11453
202110,9호선,마곡나루,8562,8301,16863
202110,9호선,신방화,4726,4424,9150
202110,9호선,공항시장,2317,2465,4782
202110,9호선,김포공항,7899,12421,20320
202110,9호선,개화,1571,1327,2898
202110,9호선,증미,3295,3367,6662
202110,9호선,중앙보훈병원,3411,3345,6756
202110,9호선,둔촌오륜,437,490,927
202110,9호선,올림픽공원,6184,6615,12799
202110,9호선,한성백제,2024,1656,3680
202110,9호선,송파나루,3102,3330,6432
202110,9호선,석촌,4794,4075,8869
202110,9호선,석촌고분,2936,2874,5810
202110,9호선,삼전,3610,3530,7140
202110,9호선,종합운동장,1983,1791,3774
202110,9호선,봉은사,7225,7210,14435
202110,9호선,삼성중앙,1876,1986,3862
202110,9호선,선정릉,3082,3668,6750
202110,9호선,언주,3788,3745,7533
202110,9호선,신논현,15830,15007,30837
202110,9호선,사평,1431,1518,2949
202110,9호선,고속터미널,10200,13597,23797
202110,9호선,신반포,1783,1810,3593
202110,9호선,구반포,815,841,1656
202110,9호선,동작,1235,1025,2260
202110,9호선,흑석,3895,4083,7978
202110,9호선,노들,2636,2308,4944
202110,9호선,노량진,14525,15405,29930
202110,9호선,샛강,1826,1809,3635
202110,9호선,여의도,8341,7886,16227
202110,9호선,국회의사당,4818,4550,9368
202110,9호선,당산,9003,8881,17884
202110,9호선,선유도,3021,2955,5976
202110,9호선,신목동,1815,1641,3456
202110,9호선,염창,8511,8464,16975
202110,9호선,등촌,5157,5280,10437
202110,9호선,가양,10149,9943,20092
202110,9호선,양천향교,4235,4517,8752
202110,9호선,마곡나루,6173,5975,12148
202110,9호선,신방화,3521,3369,6890
202110,9호선,공항시장,1823,1945,3768
202110,9호선,김포공항,7164,11649,18813
202110,9호선,개화,1175,1094,2269
202111,9호선,개화,1589,1368,2957
202111,9호선,김포공항,8350,12857,21207
202111,9호선,공항시장,2374,2430,4804
202111,9호선,신방화,4995,4583,9578
202111,9호선,마곡나루,8663,8413,17076
202111,9호선,양천향교,6111,5749,11860
202111,9호선,가양,14878,13920,28798
202111,9호선,증미,4013,3772,7785
202111,9호선,등촌,7509,7261,14770
202111,9호선,염창,12306,11081,23387
202111,9호선,신목동,2704,2285,4989
202111,9호선,선유도,4132,3924,8056
202111,9호선,당산,12912,11920,24832
202111,9호선,국회의사당,4418,4709,9127
202111,9호선,여의도,11999,11344,23343
202111,9호선,샛강,2595,2644,5239
202111,9호선,노량진,21813,21381,43194
202111,9호선,노들,3377,2771,6148
202111,9호선,흑석,5515,5558,11073
202111,9호선,동작,1780,1546,3326
202111,9호선,구반포,1664,1801,3465
202111,9호선,신반포,2720,2601,5321
202111,9호선,고속터미널,12598,18496,31094
202111,9호선,사평,2303,2123,4426
202111,9호선,신논현,26036,26386,52422
202111,9호선,언주,6595,6576,13171
202111,9호선,선정릉,5020,5524,10544
202111,9호선,삼성중앙,3111,3192,6303
202111,9호선,봉은사,11173,11922,23095
202111,9호선,종합운동장,3019,2689,5708
202111,9호선,삼전,5014,4585,9599
202111,9호선,석촌고분,4317,3933,8250
202111,9호선,석촌,7040,5696,12736
202111,9호선,송파나루,4234,4799,9033
202111,9호선,한성백제,3232,2711,5943
202111,9호선,올림픽공원,7595,7937,15532
202111,9호선,둔촌오륜,655,664,1319
202111,9호선,중앙보훈병원,4663,4458,9121
202111,9호선,중앙보훈병원,3673,3517,7190
202111,9호선,둔촌오륜,511,498,1009
202111,9호선,올림픽공원,6219,6749,12968
202111,9호선,한성백제,1972,1597,3569
202111,9호선,송파나루,3039,3345,6384
202111,9호선,석촌,5017,4414,9431
202111,9호선,석촌고분,3101,3157,6258
202111,9호선,삼전,3449,3333,6782
202111,9호선,종합운동장,2662,2288,4950
202111,9호선,봉은사,7802,7692,15494
202111,9호선,삼성중앙,1973,2049,4022
202111,9호선,선정릉,3209,3602,6811
202111,9호선,언주,3866,3867,7733
202111,9호선,신논현,16024,15215,31239
202111,9호선,사평,1580,1621,3201
202111,9호선,고속터미널,10620,14490,25110
202111,9호선,신반포,1861,1891,3752
202111,9호선,구반포,1062,1152,2214
202111,9호선,동작,1507,1261,2768
202111,9호선,흑석,3945,4089,8034
202111,9호선,노들,2655,2300,4955
202111,9호선,노량진,15062,16048,31110
202111,9호선,샛강,1697,1729,3426
202111,9호선,여의도,8631,7899,16530
202111,9호선,국회의사당,5031,4779,9810
202111,9호선,당산,9304,8939,18243
202111,9호선,선유도,2920,2950,5870
202111,9호선,신목동,1869,1630,3499
202111,9호선,염창,8887,8827,17714
202111,9호선,등촌,5266,5286,10552
202111,9호선,증미,2884,2930,5814
202111,9호선,가양,10640,10618,21258
202111,9호선,양천향교,4213,4553,8766
202111,9호선,마곡나루,6009,6145,12154
202111,9호선,신방화,3420,3442,6862
202111,9호선,공항시장,1786,1934,3720
202111,9호선,김포공항,7343,11781,19124
202111,9호선,개화,1265,1171,2436
202111,9호선,중앙보훈병원,4745,4234,8979
202111,9호선,둔촌오륜,688,654,1342
202111,9호선,올림픽공원,6270,6255,12525
202111,9호선,한성백제,2080,1762,3842
202111,9호선,송파나루,4121,4475,8596
202111,9호선,석촌,6720,5527,12247
202111,9호선,석촌고분,4256,3963,8219
202111,9호선,삼전,5023,4588,9611
202111,9호선,종합운동장,3156,2759,5915
202111,9호선,봉은사,14518,15803,30321
202111,9호선,삼성중앙,3009,3015,6024
202111,9호선,선정릉,4836,5384,10220
202111,9호선,언주,6791,6956,13747
202111,9호선,신논현,26240,26723,52963
202111,9호선,사평,2381,2178,4559
202111,9호선,고속터미널,12773,19090,31863
202111,9호선,신반포,2547,2520,5067
202111,9호선,구반포,1516,1535,3051
202111,9호선,동작,1567,1345,2912
202111,9호선,흑석,5779,5767,11546
202111,9호선,노들,3335,2742,6077
202111,9호선,노량진,21809,21508,43317
202111,9호선,샛강,2646,2611,5257
202111,9호선,여의도,12090,11324,23414
202111,9호선,국회의사당,4667,4711,9378
202111,9호선,당산,13013,12129,25142
202111,9호선,선유도,4013,3841,7854
202111,9호선,신목동,2554,2121,4675
202111,9호선,염창,12253,11061,23314
202111,9호선,등촌,7366,6960,14326
202111,9호선,증미,4121,3878,7999
202111,9호선,가양,14947,13747,28694
202111,9호선,양천향교,5943,5544,11487
202111,9호선,마곡나루,8348,8213,16561
202111,9호선,신방화,4718,4329,9047
202111,9호선,공항시장,2409,2456,4865
202111,9호선,김포공항,8070,13050,21120
202111,9호선,개화,1565,1267,2832
202111,9호선,삼전,3592,3391,6983
202111,9호선,봉은사,7690,7658,15348
202111,9호선,삼성중앙,1873,1994,3867
202111,9호선,선정릉,2949,3383,6332
202111,9호선,언주,4150,4085,8235
202111,9호선,신논현,15775,15094,30869
202111,9호선,사평,1398,1501,2899
202111,9호선,고속터미널,10506,14206,24712
202111,9호선,신반포,1570,1745,3315
202111,9호선,구반포,934,955,1889
202111,9호선,동작,1281,1071,2352
202111,9호선,흑석,3768,3990,7758
202111,9호선,노들,2529,2290,4819
202111,9호선,노량진,14421,15407,29828
202111,9호선,샛강,1613,1599,3212
202111,9호선,여의도,8956,8082,17038
202111,9호선,국회의사당,4753,4524,9277
202111,9호선,당산,9007,8801,17808
202111,9호선,선유도,2894,2905,5799
202111,9호선,신목동,1666,1516,3182
202111,9호선,염창,8563,8514,17077
202111,9호선,등촌,5110,5283,10393
202111,9호선,증미,2519,2460,4979
202111,9호선,가양,10162,10011,20173
202111,9호선,양천향교,4244,4423,8667
202111,9호선,마곡나루,6035,5989,12024
202111,9호선,신방화,3316,3347,6663
202111,9호선,공항시장,1776,1956,3732
202111,9호선,김포공항,7430,11761,19191
202111,9호선,개화,1183,1011,2194
202111,9호선,중앙보훈병원,3347,3230,6577
202111,9호선,둔촌오륜,457,469,926
202111,9호선,올림픽공원,4887,5055,9942
202111,9호선,한성백제,1576,1346,2922
202111,9호선,송파나루,2948,3296,6244
202111,9호선,석촌,4680,3989,8669
202111,9호선,석촌고분,3072,3018,6090
202111,9호선,종합운동장,2161,1984,4145
202111,9호선,중앙보훈병원,4607,4149,8756
202111,9호선,둔촌오륜,634,610,1244
202111,9호선,올림픽공원,4749,4919,9668
202111,9호선,한성백제,1973,1656,3629
202111,9호선,송파나루,4088,4627,8715
202111,9호선,석촌,6747,5561,12308
202111,9호선,석촌고분,4362,3982,8344
202111,9호선,삼전,4861,4378,9239
202111,9호선,종합운동장,3289,2949,6238
202111,9호선,봉은사,12728,13894,26622
202111,9호선,삼성중앙,3157,3184,6341
202111,9호선,선정릉,4945,5502,10447
202111,9호선,언주,6484,6413,12897
202111,9호선,신논현,26436,27464,53900
202111,9호선,사평,2163,2043,4206
202111,9호선,고속터미널,13136,18984,32120
202111,9호선,신반포,2691,2620,5311
202111,9호선,구반포,1644,1799,3443
202111,9호선,동작,1499,1275,2774
202111,9호선,흑석,5649,5704,11353
202111,9호선,노들,3284,2749,6033
202111,9호선,노량진,21566,21101,42667
202111,9호선,샛강,2652,2677,5329
202111,9호선,여의도,12600,11523,24123
202111,9호선,국회의사당,5017,5212,10229
202111,9호선,당산,13113,12153,25266
202111,9호선,선유도,3778,3605,7383
202111,9호선,신목동,2466,2110,4576
202111,9호선,염창,12225,11088,23313
202111,9호선,등촌,7513,7048,14561
202111,9호선,증미,4064,3836,7900
202111,9호선,가양,13883,12977,26860
202111,9호선,양천향교,6126,5629,11755
202111,9호선,마곡나루,8223,8067,16290
202111,9호선,신방화,4794,4409,9203
202111,9호선,공항시장,2332,2293,4625
202111,9호선,김포공항,8103,13071,21174
202111,9호선,개화,1450,1212,2662
202111,9호선,중앙보훈병원,3254,3094,6348
202111,9호선,둔촌오륜,435,469,904
202111,9호선,올림픽공원,4835,5168,10003
202111,9호선,한성백제,1325,1177,2502
202111,9호선,송파나루,2968,3202,6170
202111,9호선,석촌,4666,4088,8754
202111,9호선,석촌고분,2832,2900,5732
202111,9호선,삼전,3506,3420,6926
202111,9호선,종합운동장,2393,2258,4651
202111,9호선,봉은사,9335,9913,19248
202111,9호선,삼성중앙,1938,1986,3924
202111,9호선,선정릉,3288,3782,7070
202111,9호선,언주,4239,4192,8431
202111,9호선,신논현,16398,15425,31823
202111,9호선,사평,1426,1503,2929
202111,9호선,고속터미널,10670,14419,25089
202111,9호선,신반포,1621,1786,3407
202111,9호선,구반포,691,747,1438
202111,9호선,동작,1052,892,1944
202111,9호선,흑석,3772,3920,7692
202111,9호선,노들,2470,2135,4605
202111,9호선,노량진,14502,15223,29725
202111,9호선,샛강,1584,1588,3172
202111,9호선,여의도,9064,7987,17051
202111,9호선,국회의사당,5089,4641,9730
202111,9호선,당산,8974,8773,17747
202111,9호선,선유도,2726,2637,5363
202111,9호선,신목동,1670,1526,3196
202111,9호선,염창,8264,8280,16544
202111,9호선,등촌,4997,5223,10220
202111,9호선,증미,2821,2881,5702
202111,9호선,가양,10106,10035,20141
202111,9호선,양천향교,4069,4389,8458
202111,9호선,마곡나루,5417,5456,10873
202111,9호선,신방화,3365,3361,6726
202111,9호선,공항시장,1628,1846,3474
202111,9호선,김포공항,7364,11440,18804
202111,9호선,개화,1009,981,1990
202111,9호선,개화,1508,1213,2721
202111,9호선,김포공항,8417,13259,21676
202111,9호선,공항시장,2233,2336,4569
202111,9호선,신방화,4835,4614,9449
202111,9호선,마곡나루,8284,8121,16405
202111,9호선,양천향교,5886,5439,11325
202111,9호선,가양,13950,12910,26860
202111,9호선,증미,3853,3755,7608
202111,9호선,등촌,7593,7152,14745
202111,9호선,염창,12128,11003,23131
202111,9호선,신목동,2561,2091,4652
202111,9호선,선유도,4074,3924,7998
202111,9호선,당산,13509,12572,26081
202111,9호선,국회의사당,5028,5076,10104
202111,9호선,여의도,13272,11899,25171
202111,9호선,샛강,2947,2798,5745
202111,9호선,노량진,20573,20107,40680
202111,9호선,노들,3383,2831,6214
202111,9호선,흑석,10788,9638,20426
202111,9호선,동작,1549,1321,2870
202111,9호선,구반포,1594,1697,3291
202111,9호선,신반포,2728,2625,5353
202111,9호선,고속터미널,12971,19106,32077
202111,9호선,사평,2251,2168,4419
202111,9호선,신논현,26680,27664,54344
202111,9호선,언주,6569,6588,13157
202111,9호선,선정릉,4954,5644,10598
202111,9호선,삼성중앙,3213,3255,6468
202111,9호선,봉은사,13205,14446,27651
202111,9호선,종합운동장,3923,3483,7406
202111,9호선,삼전,5013,4522,9535
202111,9호선,석촌고분,4093,3960,8053
202111,9호선,석촌,6627,5389,12016
202111,9호선,송파나루,4027,4545,8572
202111,9호선,한성백제,1931,1604,3535
202111,9호선,올림픽공원,6894,6984,13878
202111,9호선,둔촌오륜,647,648,1295
202111,9호선,중앙보훈병원,4473,4161,8634
202111,9호선,개화,1082,984,2066
202111,9호선,김포공항,7373,11470,18843
202111,9호선,공항시장,1630,1813,3443
202111,9호선,신방화,3263,3314,6577
202111,9호선,마곡나루,5911,5787,11698
202111,9호선,양천향교,4060,4145,8205
202111,9호선,가양,9915,9807,19722
202111,9호선,증미,2385,2433,4818
202111,9호선,등촌,5155,5255,10410
202111,9호선,염창,8579,8511,17090
202111,9호선,신목동,1922,1662,3584
202111,9호선,선유도,2907,2799,5706
202111,9호선,당산,8786,8858,17644
202111,9호선,국회의사당,4992,4676,9668
202111,9호선,여의도,9360,8243,17603
202111,9호선,샛강,1657,1714,3371
202111,9호선,노량진,14046,15241,29287
202111,9호선,노들,2573,2209,4782
202111,9호선,흑석,7247,6694,13941
202111,9호선,동작,1215,1094,2309
202111,9호선,구반포,810,913,1723
202111,9호선,신반포,1679,1736,3415
202111,9호선,고속터미널,10445,14405,24850
202111,9호선,사평,1623,1637,3260
202111,9호선,신논현,15860,15563,31423
202111,9호선,언주,3887,3895,7782
202111,9호선,선정릉,3080,3531,6611
202111,9호선,삼성중앙,2011,2210,4221
202111,9호선,봉은사,8550,8638,17188
202111,9호선,종합운동장,3201,2608,5809
202111,9호선,삼전,3620,3487,7107
202111,9호선,석촌고분,3216,3063,6279
202111,9호선,석촌,4856,4144,9000
202111,9호선,송파나루,2946,3381,6327
202111,9호선,한성백제,1479,1377,2856
202111,9호선,올림픽공원,5003,5025,10028
202111,9호선,둔촌오륜,500,474,974
202111,9호선,중앙보훈병원,3369,3261,6630
202112,9호선,개화,1354,1161,2515
202112,9호선,김포공항,7328,11766,19094
202112,9호선,공항시장,2221,2230,4451
202112,9호선,신방화,4516,4297,8813
202112,9호선,마곡나루,7670,7414,15084
202112,9호선,양천향교,5807,5441,11248
202112,9호선,가양,13667,12656,26323
202112,9호선,증미,3897,3722,7619
202112,9호선,등촌,7153,6794,13947
202112,9호선,염창,11395,10364,21759
202112,9호선,신목동,2240,1901,4141
202112,9호선,선유도,3716,3599,7315
202112,9호선,당산,12329,11605,23934
202112,9호선,국회의사당,4909,4954,9863
202112,9호선,여의도,10925,10348,21273
202112,9호선,샛강,2476,2689,5165
202112,9호선,노량진,20002,19401,39403
202112,9호선,노들,3124,2562,5686
202112,9호선,흑석,5617,5569,11186
202112,9호선,동작,1361,1153,2514
202112,9호선,구반포,1238,1330,2568
202112,9호선,신반포,2554,2416,4970
202112,9호선,고속터미널,11578,16928,28506
202112,9호선,사평,2005,1862,3867
202112,9호선,신논현,24924,25870,50794
202112,9호선,언주,6377,6335,12712
202112,9호선,선정릉,4599,5056,9655
202112,9호선,삼성중앙,2940,3035,5975
202112,9호선,봉은사,10496,11011,21507
202112,9호선,종합운동장,2939,2653,5592
202112,9호선,삼전,4768,4338,9106
202112,9호선,석촌고분,4144,3972,8116
202112,9호선,석촌,6414,5348,11762
202112,9호선,송파나루,4026,4410,8436
202112,9호선,한성백제,1711,1440,3151
202112,9호선,올림픽공원,6064,5895,11959
202112,9호선,둔촌오륜,633,621,1254
202112,9호선,중앙보훈병원,4439,4051,8490
202112,9호선,개화,982,940,1922
202112,9호선,김포공항,6862,10315,17177
202112,9호선,공항시장,1735,1867,3602
202112,9호선,신방화,3274,3234,6508
202112,9호선,마곡나루,5319,5466,10785
202112,9호선,양천향교,4024,4301,8325
202112,9호선,가양,9633,9524,19157
202112,9호선,증미,2694,2836,5530
202112,9호선,등촌,4949,4986,9935
202112,9호선,염창,7952,7825,15777
202112,9호선,신목동,1645,1474,3119
202112,9호선,선유도,2630,2607,5237
202112,9호선,당산,8350,8324,16674
202112,9호선,국회의사당,4651,4387,9038
202112,9호선,여의도,7441,6795,14236
202112,9호선,샛강,1464,1598,3062
202112,9호선,노량진,12908,13644,26552
202112,9호선,노들,2361,2106,4467
202112,9호선,흑석,3998,4012,8010
202112,9호선,동작,1029,835,1864
202112,9호선,구반포,681,659,1340
202112,9호선,신반포,1455,1536,2991
202112,9호선,고속터미널,9077,12475,21552
202112,9호선,사평,1376,1431,2807
202112,9호선,신논현,14557,13836,28393
202112,9호선,언주,3786,3895,7681
202112,9호선,선정릉,2877,3163,6040
202112,9호선,삼성중앙,1870,1952,3822
202112,9호선,봉은사,7475,7752,15227
202112,9호선,종합운동장,2019,1800,3819
202112,9호선,삼전,3230,3293,6523
202112,9호선,석촌고분,2790,2840,5630
202112,9호선,석촌,4513,3744,8257
202112,9호선,송파나루,2702,2998,5700
202112,9호선,한성백제,1194,1142,2336
202112,9호선,올림픽공원,4877,4993,9870
202112,9호선,둔촌오륜,398,451,849
202112,9호선,중앙보훈병원,3061,2928,5989
202112,9호선,올림픽공원,7516,7289,14805
202112,9호선,한성백제,1641,1513,3154
202112,9호선,송파나루,3764,4151,7915
202112,9호선,석촌,6349,5294,11643
202112,9호선,석촌고분,3995,3887,7882
202112,9호선,삼전,4584,4401,8985
202112,9호선,종합운동장,2672,2553,5225
202112,9호선,봉은사,10921,11621,22542
202112,9호선,삼성중앙,2846,2958,5804
202112,9호선,선정릉,4570,5202,9772
202112,9호선,언주,6090,6152,12242
202112,9호선,신논현,24313,25083,49396
202112,9호선,사평,2013,1894,3907
202112,9호선,고속터미널,11255,15600,26855
202112,9호선,신반포,2378,2265,4643
202112,9호선,구반포,1324,1294,2618
202112,9호선,동작,1365,1159,2524
202112,9호선,흑석,5108,5100,10208
202112,9호선,노들,2911,2419,5330
202112,9호선,노량진,19756,18702,38458
202112,9호선,샛강,2256,2278,4534
202112,9호선,여의도,10514,9829,20343
202112,9호선,국회의사당,4282,4454,8736
202112,9호선,당산,12103,11229,23332
202112,9호선,선유도,3710,3362,7072
202112,9호선,신목동,2204,1805,4009
202112,9호선,염창,11182,10081,21263
202112,9호선,등촌,6854,6652,13506
202112,9호선,증미,3757,3675,7432
202112,9호선,가양,13130,12191,25321
202112,9호선,둔촌오륜,590,640,1230
202112,9호선,중앙보훈병원,4250,3832,8082
202112,9호선,양천향교,5722,5367,11089
202112,9호선,마곡나루,7530,7465,14995
202112,9호선,신방화,4390,4044,8434
202112,9호선,공항시장,2118,2220,4338
202112,9호선,김포공항,6810,11294,18104
202112,9호선,개화,1309,1179,2488
202112,9호선,개화,915,837,1752
202112,9호선,김포공항,6622,10078,16700
202112,9호선,공항시장,1586,1692,3278
202112,9호선,신방화,3123,3126,6249
202112,9호선,마곡나루,5200,5118,10318
202112,9호선,양천향교,3751,4062,7813
202112,9호선,가양,9002,8871,17873
202112,9호선,증미,2408,2415,4823
202112,9호선,등촌,4819,4988,9807
202112,9호선,염창,7546,7486,15032
202112,9호선,신목동,1478,1384,2862
202112,9호선,선유도,2555,2623,5178
202112,9호선,당산,8371,8249,16620
202112,9호선,국회의사당,4573,4325,8898
202112,9호선,여의도,7865,7073,14938
202112,9호선,샛강,1508,1614,3122
202112,9호선,노량진,13020,13882,26902
202112,9호선,노들,2271,1931,4202
202112,9호선,흑석,3231,3443,6674
202112,9호선,동작,1100,924,2024
202112,9호선,구반포,667,732,1399
202112,9호선,신반포,1395,1517,2912
202112,9호선,고속터미널,8717,11453,20170
202112,9호선,사평,1287,1458,2745
202112,9호선,신논현,14803,14189,28992
202112,9호선,언주,4056,4042,8098
202112,9호선,선정릉,2918,3447,6365
202112,9호선,삼성중앙,1840,1932,3772
202112,9호선,봉은사,8463,8842,17305
202112,9호선,종합운동장,1971,1774,3745
202112,9호선,삼전,3423,3419,6842
202112,9호선,석촌고분,2836,2895,5731
202112,9호선,석촌,4377,3762,8139
202112,9호선,송파나루,3065,3348,6413
202112,9호선,한성백제,1327,1173,2500
202112,9호선,올림픽공원,6373,6300,12673
202112,9호선,둔촌오륜,420,402,822
202112,9호선,중앙보훈병원,3234,3075,6309
202112,9호선,중앙보훈병원,3970,3783,7753
202112,9호선,둔촌오륜,630,609,1239
202112,9호선,올림픽공원,10218,9569,19787
202112,9호선,한성백제,1915,1626,3541
202112,9호선,송파나루,4082,4557,8639
202112,9호선,석촌,6181,5324,11505
202112,9호선,석촌고분,4207,4204,8411
202112,9호선,삼전,4943,4948,9891
202112,9호선,종합운동장,2906,2673,5579
202112,9호선,봉은사,13450,13656,27106
202112,9호선,삼성중앙,3200,3242,6442
202112,9호선,선정릉,4600,5174,9774
202112,9호선,언주,6880,6711,13591
202112,9호선,신논현,25854,24234,50088
202112,9호선,사평,2311,2268,4579
202112,9호선,고속터미널,11373,15732,27105
202112,9호선,신반포,2509,2356,4865
202112,9호선,구반포,1377,1276,2653
202112,9호선,동작,1233,1021,2254
202112,9호선,흑석,5174,5376,10550
202112,9호선,노들,2966,2754,5720
202112,9호선,노량진,20094,18941,39035
202112,9호선,샛강,2449,2436,4885
202112,9호선,여의도,11942,10611,22553
202112,9호선,국회의사당,5079,5138,10217
202112,9호선,당산,12143,11503,23646
202112,9호선,선유도,4001,3860,7861
202112,9호선,신목동,2116,1983,4099
202112,9호선,염창,11023,10718,21741
202112,9호선,등촌,7295,7165,14460
202112,9호선,증미,3964,3926,7890
202112,9호선,가양,13359,12780,26139
202112,9호선,양천향교,5740,5626,11366
202112,9호선,마곡나루,7411,7304,14715
202112,9호선,신방화,4537,4517,9054
202112,9호선,공항시장,2078,2275,4353
202112,9호선,김포공항,8113,12698,20811
202112,9호선,개화,1208,945,2153
202112,9호선,개화,850,861,1711
202112,9호선,김포공항,7588,11978,19566
202112,9호선,공항시장,1675,1829,3504
202112,9호선,신방화,3223,3269,6492
202112,9호선,마곡나루,5490,5350,10840
202112,9호선,양천향교,3849,4224,8073
202112,9호선,가양,9534,9456,18990
202112,9호선,증미,2894,2928,5822
202112,9호선,등촌,5029,5144,10173
202112,9호선,염창,7971,7928,15899
202112,9호선,신목동,1594,1481,3075
202112,9호선,선유도,2567,2601,5168
202112,9호선,당산,8510,8491,17001
202112,9호선,국회의사당,4247,4008,8255
202112,9호선,여의도,8382,7700,16082
202112,9호선,샛강,1495,1648,3143
202112,9호선,노량진,13508,14095,27603
202112,9호선,노들,2302,2019,4321
202112,9호선,흑석,3409,3540,6949
202112,9호선,동작,978,807,1785
202112,9호선,구반포,550,540,1090
202112,9호선,신반포,1588,1670,3258
202112,9호선,고속터미널,8945,12128,21073
202112,9호선,사평,1515,1590,3105
202112,9호선,신논현,15070,14395,29465
202112,9호선,언주,4120,4204,8324
202112,9호선,선정릉,2956,3352,6308
202112,9호선,삼성중앙,1900,2015,3915
202112,9호선,봉은사,9561,9524,19085
202112,9호선,종합운동장,1997,1783,3780
202112,9호선,삼전,3522,3466,6988
202112,9호선,석촌고분,3050,2996,6046
202112,9호선,석촌,4490,3749,8239
202112,9호선,송파나루,2997,3238,6235
202112,9호선,한성백제,1409,1286,2695
202112,9호선,올림픽공원,7557,7348,14905
202112,9호선,둔촌오륜,458,445,903
202112,9호선,중앙보훈병원,3079,2911,5990
202112,9호선,중앙보훈병원,3035,2791,5826
202112,9호선,둔촌오륜,407,425,832
202112,9호선,올림픽공원,6658,6266,12924
202112,9호선,한성백제,1310,1181,2491
202112,9호선,송파나루,4185,4418,8603
202112,9호선,석촌,4750,4095,8845
202112,9호선,석촌고분,3276,3365,6641
202112,9호선,삼전,3849,3703,7552
202112,9호선,종합운동장,2250,1927,4177
202112,9호선,봉은사,15217,16641,31858
202112,9호선,삼성중앙,2070,2048,4118
202112,9호선,선정릉,2782,3096,5878
202112,9호선,언주,3916,3960,7876
202112,9호선,신논현,17572,16342,33914
202112,9호선,사평,1560,1529,3089
202112,9호선,고속터미널,8505,12528,21033
202112,9호선,신반포,1497,1542,3039
202112,9호선,구반포,655,643,1298
202112,9호선,동작,997,736,1733
202112,9호선,흑석,3619,3921,7540
202112,9호선,노들,2388,2146,4534
202112,9호선,노량진,16448,15931,32379
202112,9호선,샛강,1718,1737,3455
202112,9호선,여의도,9913,8677,18590
202112,9호선,국회의사당,3766,3733,7499
202112,9호선,당산,8948,8571,17519
202112,9호선,선유도,2846,2698,5544
202112,9호선,신목동,1603,1404,3007
202112,9호선,염창,8497,8089,16586
202112,9호선,등촌,5440,5329,10769
202112,9호선,증미,3108,3299,6407
202112,9호선,가양,9989,9554,19543
202112,9호선,양천향교,4391,4158,8549
202112,9호선,마곡나루,5674,5465,11139
202112,9호선,신방화,3583,3526,7109
202112,9호선,공항시장,1799,1889,3688
202112,9호선,김포공항,7123,10893,18016
202112,9호선,개화,984,845,1829
202112,9호선,중앙보훈병원,2637,2524,5161
202112,9호선,둔촌오륜,373,384,757
202112,9호선,올림픽공원,5974,5852,11826
202112,9호선,한성백제,1026,987,2013
202112,9호선,송파나루,2850,3033,5883
202112,9호선,석촌,3660,3212,6872
202112,9호선,석촌고분,2596,2632,5228
202112,9호선,삼전,2922,3054,5976
202112,9호선,종합운동장,1735,1530,3265
202112,9호선,봉은사,11366,12442,23808
202112,9호선,삼성중앙,1577,1732,3309
202112,9호선,선정릉,2422,2657,5079
202112,9호선,언주,3387,3335,6722
202112,9호선,신논현,13516,12405,25921
202112,9호선,사평,1235,1333,2568
202112,9호선,고속터미널,8216,10720,18936
202112,9호선,신반포,1237,1308,2545
202112,9호선,구반포,668,580,1248
202112,9호선,동작,840,672,1512
202112,9호선,흑석,3022,3241,6263
202112,9호선,노들,2038,1813,3851
202112,9호선,노량진,11927,12874,24801
202112,9호선,샛강,1279,1344,2623
202112,9호선,여의도,7666,6731,14397
202112,9호선,국회의사당,3788,3530,7318
202112,9호선,당산,7224,7372,14596
202112,9호선,선유도,2297,2369,4666
202112,9호선,신목동,1352,1209,2561
202112,9호선,염창,6852,6876,13728
202112,9호선,등촌,4190,4330,8520
202112,9호선,증미,2094,2093,4187
202112,9호선,가양,7910,7869,15779
202112,9호선,양천향교,3431,3652,7083
202112,9호선,마곡나루,4119,4047,8166
202112,9호선,신방화,2745,2799,5544
202112,9호선,공항시장,1450,1573,3023
202112,9호선,김포공항,6309,10568,16877
202112,9호선,개화,726,677,1403
