사용일자,호선명,지하철역,승차총승객수,하차총승객수,승하차총승객수
2022-12-01,1호선,동대문,10626,9780,20406
2022-12-01,1호선,동묘앞,7226,7769,14995
2022-12-01,1호선,서울역,50274,47936,98210
2022-12-01,1호선,시청,27381,27020,54401
2022-12-01,1호선,신설동,14059,13419,27478
2022-12-01,1호선,제기동,15135,15341,30476
2022-12-01,1호선,종각,40262,38766,79028
2022-12-01,1호선,종로3가,24380,22222,46602
2022-12-01,1호선,종로5가,22642,22225,44867
2022-12-01,1호선,청량리,18751,18622,37373
2022-12-01,2호선,강남,81369,78715,160084
2022-12-01,2호선,강변,30875,28361,59236
2022-12-01,2호선,건대입구,34902,37424,72326
2022-12-01,2호선,교대,36094,40883,76977
2022-12-01,2호선,구로디지털단지,61997,61289,123286
2022-12-01,2호선,구의,24862,24328,49190
2022-12-01,2호선,낙성대,29197,28328,57525
2022-12-01,2호선,당산,19151,22680,41831
2022-12-01,2호선,대림,23953,24345,48298
2022-12-01,2호선,도림천,1405,1509,2914
2022-12-01,2호선,동대문역사문화공원,13077,15151,28228
2022-12-01,2호선,뚝섬,22409,24284,46693
2022-12-01,2호선,문래,22578,23265,45843
2022-12-01,2호선,방배,19612,20412,40024
2022-12-01,2호선,봉천,24822,23115,47937
2022-12-01,2호선,사당,40102,44190,84292
2022-12-01,2호선,삼성,61444,61750,123194
2022-12-01,2호선,상왕십리,14834,14556,29390
2022-12-01,2호선,서울대입구,48597,46643,95240
2022-12-01,2호선,서초,23951,22897,46848
2022-12-01,2호선,선릉,62077,55312,117389
2022-12-01,2호선,성수,40641,44108,84749
2022-12-01,2호선,시청,27517,26392,53909
2022-12-01,2호선,신답,1783,1993,3776
2022-12-01,2호선,신당,14126,14716,28842
2022-12-01,2호선,신대방,25729,25140,50869
2022-12-01,2호선,신도림,50849,50091,100940
2022-12-01,2호선,신림,58749,56580,115329
2022-12-01,2호선,신설동,3574,3482,7056
2022-12-01,2호선,신정네거리,10708,11095,21803
2022-12-01,2호선,신촌,38204,38028,76232
2022-12-01,2호선,아현,11159,10575,21734
2022-12-01,2호선,양천구청,7162,7570,14732
2022-12-01,2호선,역삼,58124,64780,122904
2022-12-01,2호선,영등포구청,22728,23833,46561
2022-12-01,2호선,왕십리,17610,14936,32546
2022-12-01,2호선,용답,3131,3344,6475
2022-12-01,2호선,용두,2410,2435,4845
2022-12-01,2호선,을지로3가,25380,25500,50880
2022-12-01,2호선,을지로4가,14300,14614,28914
2022-12-01,2호선,을지로입구,47819,49887,97706
2022-12-01,2호선,이대,17683,18933,36616
2022-12-01,2호선,잠실,75721,76247,151968
2022-12-01,2호선,잠실나루,14937,14597,29534
2022-12-01,2호선,잠실새내,22684,22460,45144
2022-12-01,2호선,종합운동장,7740,8353,16093
2022-12-01,2호선,충정로,10734,11566,22300
2022-12-01,2호선,한양대,14280,15466,29746
2022-12-01,2호선,합정,31445,33002,64447
2022-12-01,2호선,홍대입구,59070,62679,121749
2022-12-01,3호선,가락시장,9360,9401,18761
2022-12-01,3호선,경복궁,23575,23384,46959
2022-12-01,3호선,경찰병원,7905,7847,15752
2022-12-01,3호선,고속터미널,43141,40767,83908
2022-12-01,3호선,교대,16229,10828,27057
2022-12-01,3호선,구파발,21562,20612,42174
2022-12-01,3호선,금호,8314,7741,16055
2022-12-01,3호선,남부터미널,30350,30669,61019
2022-12-01,3호선,녹번,16466,14863,31329
2022-12-01,3호선,대청,11142,10466,21608
2022-12-01,3호선,대치,11466,11903,23369
2022-12-01,3호선,도곡,5734,5745,11479
2022-12-01,3호선,독립문,7143,7097,14240
2022-12-01,3호선,동대입구,10907,12015,22922
2022-12-01,3호선,매봉,13338,12988,26326
2022-12-01,3호선,무악재,4183,4294,8477
2022-12-01,3호선,불광,16436,17508,33944
2022-12-01,3호선,수서,18349,18607,36956
2022-12-01,3호선,신사,28953,30400,59353
2022-12-01,3호선,안국,25296,25969,51265
2022-12-01,3호선,압구정,32639,35461,68100
2022-12-01,3호선,약수,13565,12979,26544
2022-12-01,3호선,양재,40943,44430,85373
2022-12-01,3호선,연신내,35766,33956,69722
2022-12-01,3호선,오금,6782,6264,13046
2022-12-01,3호선,옥수,8996,9403,18399
2022-12-01,3호선,을지로3가,11861,11662,23523
2022-12-01,3호선,일원,11305,10702,22007
2022-12-01,3호선,잠원,5110,4926,10036
2022-12-01,3호선,종로3가,10278,11658,21936
2022-12-01,3호선,지축,6100,5973,12073
2022-12-01,3호선,학여울,2191,2210,4401
2022-12-01,3호선,홍제,18317,17437,35754
2022-12-01,4호선,길음,22643,22571,45214
2022-12-01,4호선,남태령,1305,1145,2450
2022-12-01,4호선,노원,18683,21277,39960
2022-12-01,4호선,당고개,9385,8430,17815
2022-12-01,4호선,동대문,19396,20175,39571
2022-12-01,4호선,동대문역사문화공원,16399,15341,31740
2022-12-01,4호선,동작,1110,1226,2336
2022-12-01,4호선,명동,26069,27843,53912
2022-12-01,4호선,미아,15408,14769,30177
2022-12-01,4호선,미아사거리,27010,26272,53282
2022-12-01,4호선,사당,28276,23770,52046
2022-12-01,4호선,삼각지,7252,7607,14859
2022-12-01,4호선,상계,19512,18110,37622
2022-12-01,4호선,서울역,12983,19630,32613
2022-12-01,4호선,성신여대입구,21118,19908,41026
2022-12-01,4호선,수유,34491,34359,68850
2022-12-01,4호선,숙대입구,15602,15166,30768
2022-12-01,4호선,신용산,18563,19296,37859
2022-12-01,4호선,쌍문,29547,27297,56844
2022-12-01,4호선,이촌,8986,9859,18845
2022-12-01,4호선,창동,25460,27386,52846
2022-12-01,4호선,총신대입구,19106,20907,40013
2022-12-01,4호선,충무로,31541,32234,63775
2022-12-01,4호선,한성대입구,14702,13895,28597
2022-12-01,4호선,혜화,34876,33825,68701
2022-12-01,4호선,회현,25753,26864,52617
2022-12-01,5호선,강동,19208,18506,37714
2022-12-01,5호선,강일,5150,4806,9956
2022-12-01,5호선,개롱,6774,6950,13724
2022-12-01,5호선,개화산,5960,5629,11589
2022-12-01,5호선,거여,10580,9969,20549
2022-12-01,5호선,고덕,10088,10008,20096
2022-12-01,5호선,공덕,15351,16245,31596
2022-12-01,5호선,광나루,14258,12856,27114
2022-12-01,5호선,광화문,34292,37005,71297
2022-12-01,5호선,군자,11855,12852,24707
2022-12-01,5호선,굽은다리,9725,9269,18994
2022-12-01,5호선,길동,7874,8037,15911
2022-12-01,5호선,김포공항,7272,6918,14190
2022-12-01,5호선,까치산,29753,28461,58214
2022-12-01,5호선,답십리,16638,15181,31819
2022-12-01,5호선,동대문역사문화공원,3306,3851,7157
2022-12-01,5호선,둔촌동,9216,9278,18494
2022-12-01,5호선,마곡,11321,11346,22667
2022-12-01,5호선,마장,6320,6105,12425
2022-12-01,5호선,마천,7705,7153,14858
2022-12-01,5호선,마포,15608,16182,31790
2022-12-01,5호선,명일,8793,8953,17746
2022-12-01,5호선,목동,17178,18503,35681
2022-12-01,5호선,미사,16815,16702,33517
2022-12-01,5호선,발산,21780,22145,43925
2022-12-01,5호선,방이,7498,7716,15214
2022-12-01,5호선,방화,6910,6788,13698
2022-12-01,5호선,상일동,15164,13944,29108
2022-12-01,5호선,서대문,22024,22975,44999
2022-12-01,5호선,송정,6630,6211,12841
2022-12-01,5호선,신금호,6772,6857,13629
2022-12-01,5호선,신길,4480,4824,9304
2022-12-01,5호선,신정,14125,11701,25826
2022-12-01,5호선,아차산,14694,13954,28648
2022-12-01,5호선,애오개,7091,7005,14096
2022-12-01,5호선,양평,7974,7839,15813
2022-12-01,5호선,여의나루,10487,13008,23495
2022-12-01,5호선,여의도,32464,34339,66803
2022-12-01,5호선,영등포구청,4840,4401,9241
2022-12-01,5호선,영등포시장,10440,10635,21075
2022-12-01,5호선,오금,3978,4010,7988
2022-12-01,5호선,오목교,21877,23449,45326
2022-12-01,5호선,올림픽공원,4724,3970,8694
2022-12-01,5호선,왕십리,4718,5515,10233
2022-12-01,5호선,우장산,15360,15238,30598
2022-12-01,5호선,을지로4가,6539,6684,13223
2022-12-01,5호선,장한평,19815,19426,39241
2022-12-01,5호선,종로3가,13397,13048,26445
2022-12-01,5호선,천호,18081,18063,36144
2022-12-01,5호선,청구,4220,3843,8063
2022-12-01,5호선,충정로,5110,5324,10434
2022-12-01,5호선,하남검단산,5844,5497,11341
2022-12-01,5호선,하남시청,7137,6853,13990
2022-12-01,5호선,하남풍산,4318,4298,8616
2022-12-01,5호선,행당,8791,7666,16457
2022-12-01,5호선,화곡,29827,27963,57790
2022-12-01,6호선,고려대,9958,9757,19715
2022-12-01,6호선,공덕,20398,19836,40234
2022-12-01,6호선,광흥창,9785,9464,19249
2022-12-01,6호선,구산,8292,6152,14444
2022-12-01,6호선,녹사평,4735,4595,9330
2022-12-01,6호선,대흥,9956,10448,20404
2022-12-01,6호선,독바위,2800,2938,5738
2022-12-01,6호선,돌곶이,10235,9528,19763
2022-12-01,6호선,동묘앞,7733,8160,15893
2022-12-01,6호선,디지털미디어시티,15423,17186,32609
2022-12-01,6호선,마포구청,15182,13655,28837
2022-12-01,6호선,망원,14041,14961,29002
2022-12-01,6호선,버티고개,2279,2252,4531
2022-12-01,6호선,보문,8129,7501,15630
2022-12-01,6호선,봉화산,9435,8936,18371
2022-12-01,6호선,불광,4300,4412,8712
2022-12-01,6호선,삼각지,8636,8133,16769
2022-12-01,6호선,상수,10007,11175,21182
2022-12-01,6호선,상월곡,7403,6987,14390
2022-12-01,6호선,새절,13535,12588,26123
2022-12-01,6호선,석계,13053,13935,26988
2022-12-01,6호선,신내,2,0,2
2022-12-01,6호선,신당,8723,9206,17929
2022-12-01,6호선,안암,15171,14888,30059
2022-12-01,6호선,약수,3679,3702,7381
2022-12-01,6호선,역촌,3920,4676,8596
2022-12-01,6호선,월곡,13234,12779,26013
2022-12-01,6호선,월드컵경기장,3802,4047,7849
2022-12-01,6호선,응암,18058,17906,35964
2022-12-01,6호선,이태원,9059,9254,18313
2022-12-01,6호선,증산,10332,10243,20575
2022-12-01,6호선,창신,3974,3514,7488
2022-12-01,6호선,청구,3811,4112,7923
2022-12-01,6호선,태릉입구,6013,6703,12716
2022-12-01,6호선,한강진,7801,8897,16698
2022-12-01,6호선,합정,13836,13579,27415
2022-12-01,6호선,화랑대,13587,10412,23999
2022-12-01,6호선,효창공원앞,7709,7414,15123
2022-12-01,7호선,가산디지털단지,48080,48066,96146
2022-12-01,7호선,강남구청,18133,20016,38149
2022-12-01,7호선,건대입구,13980,14652,28632
2022-12-01,7호선,고속터미널,16275,13828,30103
2022-12-01,7호선,공릉,12977,12762,25739
2022-12-01,7호선,광명사거리,21343,21038,42381
2022-12-01,7호선,군자,15852,12629,28481
2022-12-01,7호선,남구로,16212,17091,33303
2022-12-01,7호선,남성,11972,11239,23211
2022-12-01,7호선,내방,15826,16024,31850
2022-12-01,7호선,노원,20063,21117,41180
2022-12-01,7호선,논현,19447,20324,39771
2022-12-01,7호선,대림,7895,7904,15799
2022-12-01,7호선,도봉산,9892,11051,20943
2022-12-01,7호선,뚝섬유원지,7291,7133,14424
2022-12-01,7호선,마들,13858,13140,26998
2022-12-01,7호선,먹골,10602,10531,21133
2022-12-01,7호선,면목,16674,16057,32731
2022-12-01,7호선,반포,6457,6321,12778
2022-12-01,7호선,보라매,7580,7928,15508
2022-12-01,7호선,사가정,16676,16961,33637
2022-12-01,7호선,상도,13000,12851,25851
2022-12-01,7호선,상봉,17570,16565,34135
2022-12-01,7호선,수락산,12969,12743,25712
2022-12-01,7호선,숭실대입구,16009,16147,32156
2022-12-01,7호선,신대방삼거리,15877,15068,30945
2022-12-01,7호선,신풍,11868,11240,23108
2022-12-01,7호선,어린이대공원,18767,18952,37719
2022-12-01,7호선,온수,11860,11023,22883
2022-12-01,7호선,용마산,6232,5957,12189
2022-12-01,7호선,이수,16700,15699,32399
2022-12-01,7호선,장승배기,9447,9173,18620
2022-12-01,7호선,장암,2479,898,3377
2022-12-01,7호선,중계,15681,14354,30035
2022-12-01,7호선,중곡,11661,10873,22534
2022-12-01,7호선,중화,11217,11062,22279
2022-12-01,7호선,천왕,12165,11642,23807
2022-12-01,7호선,철산,22311,22782,45093
2022-12-01,7호선,청담,20604,23585,44189
2022-12-01,7호선,태릉입구,9963,9157,19120
2022-12-01,7호선,하계,19140,18237,37377
2022-12-01,7호선,학동,26254,27741,53995
2022-12-01,8호선,가락시장,8064,8833,16897
2022-12-01,8호선,강동구청,11195,11486,22681
2022-12-01,8호선,남위례,6264,6457,12721
2022-12-01,8호선,남한산성입구,15361,13975,29336
2022-12-01,8호선,단대오거리,11238,10948,22186
2022-12-01,8호선,모란,4512,3324,7836
2022-12-01,8호선,몽촌토성,6537,6586,13123
2022-12-01,8호선,문정,22781,24053,46834
2022-12-01,8호선,복정,10062,8397,18459
2022-12-01,8호선,산성,5550,5547,11097
2022-12-01,8호선,석촌,7851,8963,16814
2022-12-01,8호선,송파,9466,9320,18786
2022-12-01,8호선,수진,5520,5090,10610
2022-12-01,8호선,신흥,5022,5286,10308
2022-12-01,8호선,암사,19938,17625,37563
2022-12-01,8호선,잠실,15974,18655,34629
2022-12-01,8호선,장지,18230,17200,35430
2022-12-01,8호선,천호,15070,17804,32874
2022-12-01,9호선,가양,22768,22367,45135
2022-12-01,9호선,개화,2796,1823,4619
2022-12-01,9호선,고속터미널,13236,16870,30106
2022-12-01,9호선,공항시장,3034,3376,6410
2022-12-01,9호선,구반포,1281,1398,2679
2022-12-01,9호선,국회의사당,19234,19847,39081
2022-12-01,9호선,김포공항,6725,10322,17047
2022-12-01,9호선,노들,4900,4101,9001
2022-12-01,9호선,노량진,27576,27011,54587
2022-12-01,9호선,당산,20141,20154,40295
2022-12-01,9호선,동작,1690,1253,2943
2022-12-01,9호선,등촌,12200,11739,23939
2022-12-01,9호선,마곡나루,13407,12937,26344
2022-12-01,9호선,사평,4006,3937,7943
2022-12-01,9호선,샛강,6800,6800,13600
2022-12-01,9호선,선유도,9399,8775,18174
2022-12-01,9호선,신논현,30713,29807,60520
2022-12-01,9호선,신목동,4527,3879,8406
2022-12-01,9호선,신반포,3841,3853,7694
2022-12-01,9호선,신방화,7335,7190,14525
2022-12-01,9호선,양천향교,10183,10585,20768
2022-12-01,9호선,여의도,33122,31034,64156
2022-12-01,9호선,염창,18639,18115,36754
2022-12-01,9호선,증미,7683,7233,14916
2022-12-01,9호선,흑석,10157,10463,20620
2022-12-01,9호선2~3단계,둔촌오륜,1266,1142,2408
2022-12-01,9호선2~3단계,봉은사,21102,21840,42942
2022-12-01,9호선2~3단계,삼성중앙,8363,8618,16981
2022-12-01,9호선2~3단계,삼전,7544,7241,14785
2022-12-01,9호선2~3단계,석촌,9220,8112,17332
2022-12-01,9호선2~3단계,석촌고분,6999,6985,13984
2022-12-01,9호선2~3단계,선정릉,10803,11958,22761
2022-12-01,9호선2~3단계,송파나루,5356,5712,11068
2022-12-01,9호선2~3단계,언주,11928,12107,24035
2022-12-01,9호선2~3단계,올림픽공원,6808,6973,13781
2022-12-01,9호선2~3단계,종합운동장,4570,4555,9125
2022-12-01,9호선2~3단계,중앙보훈병원,12064,10767,22831
2022-12-01,9호선2~3단계,한성백제,2924,2690,5614
2022-12-01,경강선,경기광주,8420,7774,16194
2022-12-01,경강선,곤지암,2360,2263,4623
2022-12-01,경강선,부발,2227,2028,4255
2022-12-01,경강선,삼동,2563,2323,4886
2022-12-01,경강선,세종대왕릉,311,319,630
2022-12-01,경강선,신둔도예촌,1716,1511,3227
2022-12-01,경강선,여주,2557,2365,4922
2022-12-01,경강선,이매,1197,1066,2263
2022-12-01,경강선,이천,2578,2681,5259
2022-12-01,경강선,초월,3480,3313,6793
2022-12-01,경강선,판교,5760,5669,11429
2022-12-01,경부선,가산디지털단지,18541,21486,40027
2022-12-01,경부선,관악,7388,6990,14378
2022-12-01,경부선,광명,3410,2906,6316
2022-12-01,경부선,구로,18440,18823,37263
2022-12-01,경부선,군포,7575,7409,14984
2022-12-01,경부선,금정,28191,29136,57327
2022-12-01,경부선,금천구청,11585,11499,23084
2022-12-01,경부선,남영,10021,10804,20825
2022-12-01,경부선,노량진,8398,8879,17277
2022-12-01,경부선,당정,6940,6643,13583
2022-12-01,경부선,대방,11344,12611,23955
2022-12-01,경부선,독산,18613,19503,38116
2022-12-01,경부선,두정,8153,8312,16465
2022-12-01,경부선,명학,10432,10156,20588
2022-12-01,경부선,병점,16533,16620,33153
2022-12-01,경부선,서동탄,1351,1174,2525
2022-12-01,경부선,서울역,7365,2314,9679
2022-12-01,경부선,서정리,8281,7426,15707
2022-12-01,경부선,석수,9411,8580,17991
2022-12-01,경부선,성균관대,15598,15428,31026
2022-12-01,경부선,성환,6850,6186,13036
2022-12-01,경부선,세류,3165,2802,5967
2022-12-01,경부선,세마,2867,2810,5677
2022-12-01,경부선,송탄,4321,4160,8481
2022-12-01,경부선,수원,35773,38599,74372
2022-12-01,경부선,신길,9219,7834,17053
2022-12-01,경부선,신도림,3983,3782,7765
2022-12-01,경부선,안양,26503,26540,53043
2022-12-01,경부선,영등포,38674,38775,77449
2022-12-01,경부선,오산,9780,10009,19789
2022-12-01,경부선,오산대,3901,3559,7460
2022-12-01,경부선,용산,36159,35711,71870
2022-12-01,경부선,의왕,9362,9207,18569
2022-12-01,경부선,직산,874,874,1748
2022-12-01,경부선,진위,1843,1580,3423
2022-12-01,경부선,천안,7097,6339,13436
2022-12-01,경부선,평택,12486,13000,25486
2022-12-01,경부선,평택지제,4178,4212,8390
2022-12-01,경부선,화서,8463,7984,16447
2022-12-01,경원선,가능,6528,6368,12896
2022-12-01,경원선,광운대,9021,8862,17883
2022-12-01,경원선,녹양,4550,4243,8793
2022-12-01,경원선,녹천,4667,3921,8588
2022-12-01,경원선,덕계,3426,2953,6379
2022-12-01,경원선,덕정,6048,5812,11860
2022-12-01,경원선,도봉,5749,5679,11428
2022-12-01,경원선,도봉산,6600,4166,10766
2022-12-01,경원선,동두천,2354,2426,4780
2022-12-01,경원선,동두천중앙,2850,2722,5572
2022-12-01,경원선,망월사,9084,9066,18150
2022-12-01,경원선,방학,9721,9581,19302
2022-12-01,경원선,보산,1428,1284,2712
2022-12-01,경원선,서빙고,2035,1917,3952
2022-12-01,경원선,석계,8068,9122,17190
2022-12-01,경원선,소요산,1728,1425,3153
2022-12-01,경원선,신이문,8560,7887,16447
2022-12-01,경원선,양주,7400,7082,14482
2022-12-01,경원선,옥수,75,52,127
2022-12-01,경원선,왕십리,16234,16850,33084
2022-12-01,경원선,외대앞,10045,9891,19936
2022-12-01,경원선,월계,7745,7206,14951
2022-12-01,경원선,응봉,1857,1573,3430
2022-12-01,경원선,의정부,17941,18457,36398
2022-12-01,경원선,이촌,3763,3018,6781
2022-12-01,경원선,지행,6470,6467,12937
2022-12-01,경원선,청량리,15088,15003,30091
2022-12-01,경원선,한남,3983,3758,7741
2022-12-01,경원선,회룡,12239,12228,24467
2022-12-01,경의선,가좌,5878,5681,11559
2022-12-01,경의선,강매,3350,2927,6277
2022-12-01,경의선,곡산,577,595,1172
2022-12-01,경의선,공덕,3912,3393,7305
2022-12-01,경의선,금릉,5031,4896,9927
2022-12-01,경의선,금촌,6639,6471,13110
2022-12-01,경의선,능곡,3766,3428,7194
2022-12-01,경의선,디지털미디어시티,2753,2567,5320
2022-12-01,경의선,문산,4966,4966,9932
2022-12-01,경의선,백마,7072,6761,13833
2022-12-01,경의선,서강대,2233,2266,4499
2022-12-01,경의선,서울역,4680,5953,10633
2022-12-01,경의선,수색,2668,2897,5565
2022-12-01,경의선,신촌,920,1321,2241
2022-12-01,경의선,야당,7980,8055,16035
2022-12-01,경의선,운정,7189,6636,13825
2022-12-01,경의선,월롱,3132,2633,5765
2022-12-01,경의선,일산,9533,9498,19031
2022-12-01,경의선,임진강,6,6,12
2022-12-01,경의선,탄현,7933,7745,15678
2022-12-01,경의선,파주,1529,1092,2621
2022-12-01,경의선,풍산,5696,5308,11004
2022-12-01,경의선,행신,8434,8270,16704
2022-12-01,경의선,홍대입구,1746,2116,3862
2022-12-01,경의선,화전,3243,2907,6150
2022-12-01,경의선,효창공원앞,3521,3724,7245
2022-12-01,경인선,간석,6091,5822,11913
2022-12-01,경인선,개봉,21323,21468,42791
2022-12-01,경인선,구일,6888,6844,13732
2022-12-01,경인선,도원,3152,3192,6344
2022-12-01,경인선,도화,3904,3618,7522
2022-12-01,경인선,동암,15678,15799,31477
2022-12-01,경인선,동인천,13784,13363,27147
2022-12-01,경인선,백운,6532,6391,12923
2022-12-01,경인선,부개,8697,8107,16804
2022-12-01,경인선,부천,31879,31998,63877
2022-12-01,경인선,부평,27610,29631,57241
2022-12-01,경인선,소사,8504,8535,17039
2022-12-01,경인선,송내,27904,27980,55884
2022-12-01,경인선,역곡,29390,28979,58369
2022-12-01,경인선,오류동,11486,10754,22240
2022-12-01,경인선,온수,6998,6742,13740
2022-12-01,경인선,인천,3291,2300,5591
2022-12-01,경인선,제물포,11176,10506,21682
2022-12-01,경인선,주안,19430,17639,37069
2022-12-01,경인선,중동,9427,8646,18073
2022-12-01,경춘선,가평,1373,1367,2740
2022-12-01,경춘선,갈매,3065,2597,5662
2022-12-01,경춘선,강촌,380,363,743
2022-12-01,경춘선,굴봉산,87,94,181
2022-12-01,경춘선,금곡,1479,1508,2987
2022-12-01,경춘선,김유정,241,283,524
2022-12-01,경춘선,남춘천,2522,2160,4682
2022-12-01,경춘선,대성리,359,358,717
2022-12-01,경춘선,마석,3964,3817,7781
2022-12-01,경춘선,백양리,65,64,129
2022-12-01,경춘선,별내,3186,3002,6188
2022-12-01,경춘선,사릉,2429,2423,4852
2022-12-01,경춘선,상천,161,159,320
2022-12-01,경춘선,신내,2231,2136,4367
2022-12-01,경춘선,천마산,1633,1483,3116
2022-12-01,경춘선,청평,1384,1361,2745
2022-12-01,경춘선,춘천,1768,1347,3115
2022-12-01,경춘선,퇴계원,3584,3373,6957
2022-12-01,경춘선,평내호평,6347,6178,12525
2022-12-01,공항철도,검암,6980,6778,13758
2022-12-01,공항철도,계양,12789,11863,24652
2022-12-01,공항철도,공덕,2713,3573,6286
2022-12-01,공항철도,공항화물청사,2422,2522,4944
2022-12-01,공항철도,김포공항,10087,6556,16643
2022-12-01,공항철도,디지털미디어시티,15373,14552,29925
2022-12-01,공항철도,마곡나루,10676,10359,21035
2022-12-01,공항철도,서울역,10449,8799,19248
2022-12-01,공항철도,영종,3479,3526,7005
2022-12-01,공항철도,운서,8304,8432,16736
2022-12-01,공항철도,인천공항1터미널,10431,9406,19837
2022-12-01,공항철도,인천공항2터미널,4047,3533,7580
2022-12-01,공항철도,청라국제도시,7292,7049,14341
2022-12-01,공항철도,홍대입구,10713,11290,22003
2022-12-01,과천선,경마공원,1297,1323,2620
2022-12-01,과천선,과천,6429,6218,12647
2022-12-01,과천선,대공원,2357,2445,4802
2022-12-01,과천선,범계,26316,26611,52927
2022-12-01,과천선,선바위,8528,7464,15992
2022-12-01,과천선,인덕원,24980,25825,50805
2022-12-01,과천선,정부과천청사,11111,11283,22394
2022-12-01,과천선,평촌,18563,18249,36812
2022-12-01,분당선,가천대,12186,12748,24934
2022-12-01,분당선,강남구청,10071,11664,21735
2022-12-01,분당선,개포동,4284,4272,8556
2022-12-01,분당선,구룡,2556,2466,5022
2022-12-01,분당선,구성,5264,5562,10826
2022-12-01,분당선,기흥,11759,11170,22929
2022-12-01,분당선,대모산입구,5110,4701,9811
2022-12-01,분당선,도곡,7562,7404,14966
2022-12-01,분당선,망포,16081,15388,31469
2022-12-01,분당선,매교,4748,4679,9427
2022-12-01,분당선,매탄권선,5579,5412,10991
2022-12-01,분당선,모란,19910,20479,40389
2022-12-01,분당선,미금,15802,16992,32794
2022-12-01,분당선,보정,2743,2457,5200
2022-12-01,분당선,복정,2,0,2
2022-12-01,분당선,상갈,5784,5595,11379
2022-12-01,분당선,서울숲,10979,11437,22416
2022-12-01,분당선,서현,25244,25853,51097
2022-12-01,분당선,선릉,14879,22571,37450
2022-12-01,분당선,선정릉,8590,9140,17730
2022-12-01,분당선,수내,14603,14839,29442
2022-12-01,분당선,수서,14386,15105,29491
2022-12-01,분당선,수원,8293,6998,15291
2022-12-01,분당선,수원시청,12981,13854,26835
2022-12-01,분당선,신갈,4959,4899,9858
2022-12-01,분당선,압구정로데오,19435,21439,40874
2022-12-01,분당선,야탑,27271,28640,55911
2022-12-01,분당선,영통,9097,9224,18321
2022-12-01,분당선,오리,12188,10107,22295
2022-12-01,분당선,이매,5891,5500,11391
2022-12-01,분당선,정자,19232,20637,39869
2022-12-01,분당선,죽전,15081,16350,31431
2022-12-01,분당선,청명,4664,4599,9263
2022-12-01,분당선,태평,13629,13170,26799
2022-12-01,분당선,한티,15573,16933,32506
2022-12-01,수인선,고색,5263,4886,10149
2022-12-01,수인선,남동인더스파크,2324,2621,4945
2022-12-01,수인선,달월,92,75,167
2022-12-01,수인선,사리,5105,4429,9534
2022-12-01,수인선,소래포구,4559,4274,8833
2022-12-01,수인선,송도,2482,2346,4828
2022-12-01,수인선,숭의,3987,3802,7789
2022-12-01,수인선,신포,1771,1833,3604
2022-12-01,수인선,야목,387,296,683
2022-12-01,수인선,어천,947,939,1886
2022-12-01,수인선,연수,4695,4594,9289
2022-12-01,수인선,오목천,4496,4059,8555
2022-12-01,수인선,원인재,4332,4570,8902
2022-12-01,수인선,월곶,2905,2655,5560
2022-12-01,수인선,인천,912,1463,2375
2022-12-01,수인선,인천논현,5537,6008,11545
2022-12-01,수인선,인하대,7437,7016,14453
2022-12-01,수인선,호구포,4164,4331,8495
2022-12-01,신림선,관악산,2187,2234,4421
2022-12-01,신림선,당곡,4200,4143,8343
2022-12-01,신림선,대방,2419,1885,4304
2022-12-01,신림선,보라매,3536,3178,6714
2022-12-01,신림선,보라매공원,1889,2020,3909
2022-12-01,신림선,보라매병원,7242,7608,14850
2022-12-01,신림선,샛강,2714,3373,6087
2022-12-01,신림선,서울대벤처타운,7684,7628,15312
2022-12-01,신림선,서울지방병무청,2620,2859,5479
2022-12-01,신림선,서원,3314,2846,6160
2022-12-01,신림선,신림,1640,2338,3978
2022-12-01,안산선,고잔,9348,8758,18106
2022-12-01,안산선,대야미,4886,4347,9233
2022-12-01,안산선,반월,4275,4177,8452
2022-12-01,안산선,산본,15843,16917,32760
2022-12-01,안산선,상록수,16383,16887,33270
2022-12-01,안산선,수리산,4285,3471,7756
2022-12-01,안산선,신길온천,1836,1729,3565
2022-12-01,안산선,안산,11336,10354,21690
2022-12-01,안산선,오이도,8269,8320,16589
2022-12-01,안산선,정왕,9930,10197,20127
2022-12-01,안산선,중앙,17966,19134,37100
2022-12-01,안산선,초지,5403,5695,11098
2022-12-01,안산선,한대앞,10437,10466,20903
2022-12-01,우이신설선,4.19민주묘지,4157,4172,8329
2022-12-01,우이신설선,가오리,4243,4176,8419
2022-12-01,우이신설선,보문,1668,1736,3404
2022-12-01,우이신설선,북한산보국문,6524,6145,12669
2022-12-01,우이신설선,북한산우이,2491,2112,4603
2022-12-01,우이신설선,삼양,1988,2174,4162
2022-12-01,우이신설선,삼양사거리,2500,2562,5062
2022-12-01,우이신설선,성신여대입구,3476,4062,7538
2022-12-01,우이신설선,솔밭공원,2571,2499,5070
2022-12-01,우이신설선,솔샘,6273,5834,12107
2022-12-01,우이신설선,신설동,2368,2447,4815
2022-12-01,우이신설선,정릉,4923,4681,9604
2022-12-01,우이신설선,화계,3565,3284,6849
2022-12-01,일산선,대곡,2138,1652,3790
2022-12-01,일산선,대화,13410,10378,23788
2022-12-01,일산선,마두,7611,7753,15364
2022-12-01,일산선,백석,9632,9708,19340
2022-12-01,일산선,삼송,19991,19407,39398
2022-12-01,일산선,원당,11112,10513,21625
2022-12-01,일산선,원흥,11894,11173,23067
2022-12-01,일산선,정발산,6501,6575,13076
2022-12-01,일산선,주엽,9230,9409,18639
2022-12-01,일산선,지축,1,0,1
2022-12-01,일산선,화정,16707,17140,33847
2022-12-01,장항선,배방,1004,1043,2047
2022-12-01,장항선,봉명,1225,1210,2435
2022-12-01,장항선,신창,2990,2488,5478
2022-12-01,장항선,쌍용,2895,2684,5579
2022-12-01,장항선,아산,3782,3337,7119
2022-12-01,장항선,온양온천,3559,3662,7221
2022-12-01,장항선,탕정,1161,952,2113
2022-12-01,중앙선,구리,13260,13467,26727
2022-12-01,중앙선,국수,678,693,1371
2022-12-01,중앙선,덕소,5491,5483,10974
2022-12-01,중앙선,도농,11834,10591,22425
2022-12-01,중앙선,도심,2460,1859,4319
2022-12-01,중앙선,망우,7519,7343,14862
2022-12-01,중앙선,상봉,5591,5771,11362
2022-12-01,중앙선,신원,158,126,284
2022-12-01,중앙선,아신,561,540,1101
2022-12-01,중앙선,양수,1553,1615,3168
2022-12-01,중앙선,양원,3031,2924,5955
2022-12-01,중앙선,양정,633,508,1141
2022-12-01,중앙선,양평,2594,2584,5178
2022-12-01,중앙선,오빈,258,262,520
2022-12-01,중앙선,용문,1356,1368,2724
2022-12-01,중앙선,운길산,531,482,1013
2022-12-01,중앙선,원덕,301,286,587
2022-12-01,중앙선,중랑,5522,5128,10650
2022-12-01,중앙선,지평,44,39,83
2022-12-01,중앙선,팔당,656,718,1374
2022-12-01,중앙선,회기,28576,27524,56100
2022-12-02,1호선,동대문,11717,10477,22194
2022-12-02,1호선,동묘앞,8418,8740,17158
2022-12-02,1호선,서울역,56380,55408,111788
2022-12-02,1호선,시청,27666,28152,55818
2022-12-02,1호선,신설동,15167,14291,29458
2022-12-02,1호선,제기동,17384,17385,34769
2022-12-02,1호선,종각,41940,41629,83569
2022-12-02,1호선,종로3가,27534,25613,53147
2022-12-02,1호선,종로5가,25170,25079,50249
2022-12-02,1호선,청량리,20701,20671,41372
2022-12-02,2호선,강남,87433,85915,173348
2022-12-02,2호선,강변,36699,34606,71305
2022-12-02,2호선,건대입구,37978,42159,80137
2022-12-02,2호선,교대,37630,42801,80431
2022-12-02,2호선,구로디지털단지,63798,63447,127245
2022-12-02,2호선,구의,26159,25348,51507
2022-12-02,2호선,낙성대,30459,27800,58259
2022-12-02,2호선,당산,20201,23867,44068
2022-12-02,2호선,대림,25379,25693,51072
2022-12-02,2호선,도림천,1403,1512,2915
2022-12-02,2호선,동대문역사문화공원,15182,16488,31670
2022-12-02,2호선,뚝섬,24677,26303,50980
2022-12-02,2호선,문래,23552,24253,47805
2022-12-02,2호선,방배,19348,19755,39103
2022-12-02,2호선,봉천,25926,23410,49336
2022-12-02,2호선,사당,45829,50143,95972
2022-12-02,2호선,삼성,63574,63391,126965
2022-12-02,2호선,상왕십리,15638,14892,30530
2022-12-02,2호선,서울대입구,51206,49024,100230
2022-12-02,2호선,서초,24335,22479,46814
2022-12-02,2호선,선릉,62688,55127,117815
2022-12-02,2호선,성수,43107,47733,90840
2022-12-02,2호선,시청,28760,26832,55592
2022-12-02,2호선,신답,1841,1995,3836
2022-12-02,2호선,신당,15274,15754,31028
2022-12-02,2호선,신대방,26886,25746,52632
2022-12-02,2호선,신도림,53068,53158,106226
2022-12-02,2호선,신림,62254,60081,122335
2022-12-02,2호선,신설동,3942,3930,7872
2022-12-02,2호선,신정네거리,11292,11615,22907
2022-12-02,2호선,신촌,39900,41525,81425
2022-12-02,2호선,아현,11951,10979,22930
2022-12-02,2호선,양천구청,7451,7750,15201
2022-12-02,2호선,역삼,56319,63171,119490
2022-12-02,2호선,영등포구청,22994,24202,47196
2022-12-02,2호선,왕십리,18808,16088,34896
2022-12-02,2호선,용답,3285,3371,6656
2022-12-02,2호선,용두,2776,2652,5428
2022-12-02,2호선,을지로3가,26479,27157,53636
2022-12-02,2호선,을지로4가,15278,15211,30489
2022-12-02,2호선,을지로입구,51091,52273,103364
2022-12-02,2호선,이대,18109,18638,36747
2022-12-02,2호선,잠실,81436,81843,163279
2022-12-02,2호선,잠실나루,15544,14654,30198
2022-12-02,2호선,잠실새내,24491,25343,49834
2022-12-02,2호선,종합운동장,12319,13516,25835
2022-12-02,2호선,충정로,10872,11645,22517
2022-12-02,2호선,한양대,12536,13203,25739
2022-12-02,2호선,합정,34433,38469,72902
2022-12-02,2호선,홍대입구,65653,74125,139778
2022-12-02,3호선,가락시장,10413,10290,20703
2022-12-02,3호선,경복궁,26240,25751,51991
2022-12-02,3호선,경찰병원,8351,8269,16620
2022-12-02,3호선,고속터미널,54480,55103,109583
2022-12-02,3호선,교대,17469,11274,28743
2022-12-02,3호선,구파발,22665,21647,44312
2022-12-02,3호선,금호,8602,8002,16604
2022-12-02,3호선,남부터미널,33930,34023,67953
2022-12-02,3호선,녹번,17167,15172,32339
2022-12-02,3호선,대청,11577,10803,22380
2022-12-02,3호선,대치,12177,12384,24561
2022-12-02,3호선,도곡,6040,6069,12109
2022-12-02,3호선,독립문,7828,7669,15497
2022-12-02,3호선,동대입구,10205,10954,21159
2022-12-02,3호선,매봉,13616,13065,26681
2022-12-02,3호선,무악재,4431,4322,8753
2022-12-02,3호선,불광,17334,18148,35482
2022-12-02,3호선,수서,21019,20551,41570
2022-12-02,3호선,신사,32341,33816,66157
2022-12-02,3호선,안국,27338,27802,55140
2022-12-02,3호선,압구정,36301,39345,75646
2022-12-02,3호선,약수,14473,13965,28438
2022-12-02,3호선,양재,43721,45713,89434
2022-12-02,3호선,연신내,37887,36408,74295
2022-12-02,3호선,오금,6950,6285,13235
2022-12-02,3호선,옥수,9683,9792,19475
2022-12-02,3호선,을지로3가,12541,12678,25219
2022-12-02,3호선,일원,11450,10640,22090
2022-12-02,3호선,잠원,5471,5260,10731
2022-12-02,3호선,종로3가,10761,13273,24034
2022-12-02,3호선,지축,6550,6352,12902
2022-12-02,3호선,학여울,4461,4674,9135
2022-12-02,3호선,홍제,19018,18095,37113
2022-12-02,4호선,길음,23016,24313,47329
2022-12-02,4호선,남태령,1516,1854,3370
2022-12-02,4호선,노원,19925,23947,43872
2022-12-02,4호선,당고개,9529,9088,18617
2022-12-02,4호선,동대문,20789,21275,42064
2022-12-02,4호선,동대문역사문화공원,18076,15767,33843
2022-12-02,4호선,동작,1457,1686,3143
2022-12-02,4호선,명동,28668,29315,57983
2022-12-02,4호선,미아,16184,17005,33189
2022-12-02,4호선,미아사거리,28303,29889,58192
2022-12-02,4호선,사당,32676,27810,60486
2022-12-02,4호선,삼각지,6643,8690,15333
2022-12-02,4호선,상계,19895,19116,39011
2022-12-02,4호선,서울역,13479,20935,34414
2022-12-02,4호선,성신여대입구,23204,23203,46407
2022-12-02,4호선,수유,36213,38423,74636
2022-12-02,4호선,숙대입구,14901,13907,28808
2022-12-02,4호선,신용산,19500,18422,37922
2022-12-02,4호선,쌍문,30949,31441,62390
2022-12-02,4호선,이촌,9415,10528,19943
2022-12-02,4호선,창동,27793,29990,57783
2022-12-02,4호선,총신대입구,20635,23419,44054
2022-12-02,4호선,충무로,30926,32187,63113
2022-12-02,4호선,한성대입구,15711,16106,31817
2022-12-02,4호선,혜화,37313,34757,72070
2022-12-02,4호선,회현,27165,25070,52235
2022-12-02,5호선,강동,19855,18782,38637
2022-12-02,5호선,강일,5521,5074,10595
2022-12-02,5호선,개롱,7127,7270,14397
2022-12-02,5호선,개화산,6122,5787,11909
2022-12-02,5호선,거여,10943,10473,21416
2022-12-02,5호선,고덕,10972,10731,21703
2022-12-02,5호선,공덕,15819,16936,32755
2022-12-02,5호선,광나루,14875,13369,28244
2022-12-02,5호선,광화문,36512,38778,75290
2022-12-02,5호선,군자,12516,13988,26504
2022-12-02,5호선,굽은다리,10153,9576,19729
2022-12-02,5호선,길동,8594,9086,17680
2022-12-02,5호선,김포공항,8342,7823,16165
2022-12-02,5호선,까치산,30837,29571,60408
2022-12-02,5호선,답십리,17352,15799,33151
2022-12-02,5호선,동대문역사문화공원,3413,4121,7534
2022-12-02,5호선,둔촌동,9849,9992,19841
2022-12-02,5호선,마곡,11709,11761,23470
2022-12-02,5호선,마장,6581,6141,12722
2022-12-02,5호선,마천,8006,7455,15461
2022-12-02,5호선,마포,15981,16658,32639
2022-12-02,5호선,명일,9436,9784,19220
2022-12-02,5호선,목동,17675,19469,37144
2022-12-02,5호선,미사,17588,18136,35724
2022-12-02,5호선,발산,22042,23382,45424
2022-12-02,5호선,방이,7718,8121,15839
2022-12-02,5호선,방화,7485,7108,14593
2022-12-02,5호선,상일동,15701,14547,30248
2022-12-02,5호선,서대문,22073,21716,43789
2022-12-02,5호선,송정,6996,6535,13531
2022-12-02,5호선,신금호,7158,7270,14428
2022-12-02,5호선,신길,4703,4881,9584
2022-12-02,5호선,신정,15009,12139,27148
2022-12-02,5호선,아차산,15504,14621,30125
2022-12-02,5호선,애오개,7284,7357,14641
2022-12-02,5호선,양평,8033,7751,15784
2022-12-02,5호선,여의나루,11539,13960,25499
2022-12-02,5호선,여의도,32898,34165,67063
2022-12-02,5호선,영등포구청,5122,4568,9690
2022-12-02,5호선,영등포시장,11286,11843,23129
2022-12-02,5호선,오금,4138,4177,8315
2022-12-02,5호선,오목교,23378,24983,48361
2022-12-02,5호선,올림픽공원,5054,4517,9571
2022-12-02,5호선,왕십리,4908,5914,10822
2022-12-02,5호선,우장산,15877,15580,31457
2022-12-02,5호선,을지로4가,6746,6927,13673
2022-12-02,5호선,장한평,20443,20326,40769
2022-12-02,5호선,종로3가,15211,15220,30431
2022-12-02,5호선,천호,19762,20129,39891
2022-12-02,5호선,청구,4275,3842,8117
2022-12-02,5호선,충정로,5064,5159,10223
2022-12-02,5호선,하남검단산,6404,6071,12475
2022-12-02,5호선,하남시청,7644,7489,15133
2022-12-02,5호선,하남풍산,4515,4456,8971
2022-12-02,5호선,행당,9021,7765,16786
2022-12-02,5호선,화곡,31326,28943,60269
2022-12-02,6호선,고려대,10123,9415,19538
2022-12-02,6호선,공덕,20735,20204,40939
2022-12-02,6호선,광흥창,10149,9853,20002
2022-12-02,6호선,구산,8480,6209,14689
2022-12-02,6호선,녹사평,5320,5384,10704
2022-12-02,6호선,대흥,9966,10194,20160
2022-12-02,6호선,독바위,2870,2926,5796
2022-12-02,6호선,돌곶이,10754,9808,20562
2022-12-02,6호선,동묘앞,8514,8553,17067
2022-12-02,6호선,디지털미디어시티,15498,16866,32364
2022-12-02,6호선,마포구청,15703,13846,29549
2022-12-02,6호선,망원,15122,16494,31616
2022-12-02,6호선,버티고개,2384,2264,4648
2022-12-02,6호선,보문,9077,7690,16767
2022-12-02,6호선,봉화산,9776,9073,18849
2022-12-02,6호선,불광,4478,4446,8924
2022-12-02,6호선,삼각지,8100,7158,15258
2022-12-02,6호선,상수,10520,12878,23398
2022-12-02,6호선,상월곡,6986,6294,13280
2022-12-02,6호선,새절,13897,12675,26572
2022-12-02,6호선,석계,13531,14095,27626
2022-12-02,6호선,신내,1,0,1
2022-12-02,6호선,신당,9337,8992,18329
2022-12-02,6호선,안암,13640,13136,26776
2022-12-02,6호선,약수,3898,3932,7830
2022-12-02,6호선,역촌,4010,4666,8676
2022-12-02,6호선,월곡,13627,12851,26478
2022-12-02,6호선,월드컵경기장,4355,4683,9038
2022-12-02,6호선,응암,19242,18784,38026
2022-12-02,6호선,이태원,10452,11680,22132
2022-12-02,6호선,증산,10706,10451,21157
2022-12-02,6호선,창신,3999,3294,7293
2022-12-02,6호선,청구,3966,4125,8091
2022-12-02,6호선,태릉입구,6227,6742,12969
2022-12-02,6호선,한강진,9418,10338,19756
2022-12-02,6호선,합정,14605,14706,29311
2022-12-02,6호선,화랑대,13333,10070,23403
2022-12-02,6호선,효창공원앞,7965,7417,15382
2022-12-02,7호선,가산디지털단지,48417,47785,96202
2022-12-02,7호선,강남구청,18202,20247,38449
2022-12-02,7호선,건대입구,14200,14865,29065
2022-12-02,7호선,고속터미널,20121,15728,35849
2022-12-02,7호선,공릉,13926,13538,27464
2022-12-02,7호선,광명사거리,22782,22511,45293
2022-12-02,7호선,군자,16745,12964,29709
2022-12-02,7호선,남구로,16058,16880,32938
2022-12-02,7호선,남성,12468,11217,23685
2022-12-02,7호선,내방,16166,16349,32515
2022-12-02,7호선,노원,22055,23293,45348
2022-12-02,7호선,논현,20393,21617,42010
2022-12-02,7호선,대림,8481,8678,17159
2022-12-02,7호선,도봉산,9778,10989,20767
2022-12-02,7호선,뚝섬유원지,7712,7599,15311
2022-12-02,7호선,마들,14316,13044,27360
2022-12-02,7호선,먹골,11084,10730,21814
2022-12-02,7호선,면목,17005,16380,33385
2022-12-02,7호선,반포,6966,6502,13468
2022-12-02,7호선,보라매,8032,8202,16234
2022-12-02,7호선,사가정,17400,17559,34959
2022-12-02,7호선,상도,13198,12686,25884
2022-12-02,7호선,상봉,18435,17840,36275
2022-12-02,7호선,수락산,13717,13398,27115
2022-12-02,7호선,숭실대입구,15331,14852,30183
2022-12-02,7호선,신대방삼거리,16532,15325,31857
2022-12-02,7호선,신풍,12532,11772,24304
2022-12-02,7호선,어린이대공원,17572,17438,35010
2022-12-02,7호선,온수,11659,10736,22395
2022-12-02,7호선,용마산,6426,5990,12416
2022-12-02,7호선,이수,18742,17348,36090
2022-12-02,7호선,장승배기,9904,9616,19520
2022-12-02,7호선,장암,2615,1032,3647
2022-12-02,7호선,중계,16138,14330,30468
2022-12-02,7호선,중곡,11986,11196,23182
2022-12-02,7호선,중화,11830,11329,23159
2022-12-02,7호선,천왕,12665,11965,24630
2022-12-02,7호선,철산,23790,24435,48225
2022-12-02,7호선,청담,21141,24049,45190
2022-12-02,7호선,태릉입구,10024,9121,19145
2022-12-02,7호선,하계,19544,18024,37568
2022-12-02,7호선,학동,26019,27422,53441
2022-12-02,8호선,가락시장,8889,10053,18942
2022-12-02,8호선,강동구청,11641,11883,23524
2022-12-02,8호선,남위례,6674,7054,13728
2022-12-02,8호선,남한산성입구,15586,13760,29346
2022-12-02,8호선,단대오거리,11878,11232,23110
2022-12-02,8호선,모란,4714,3728,8442
2022-12-02,8호선,몽촌토성,7180,7495,14675
2022-12-02,8호선,문정,23457,24177,47634
2022-12-02,8호선,복정,10457,8575,19032
2022-12-02,8호선,산성,5654,5482,11136
2022-12-02,8호선,석촌,8342,9983,18325
2022-12-02,8호선,송파,9757,9595,19352
2022-12-02,8호선,수진,5919,5339,11258
2022-12-02,8호선,신흥,5344,5743,11087
2022-12-02,8호선,암사,20558,17849,38407
2022-12-02,8호선,잠실,17144,20276,37420
2022-12-02,8호선,장지,19291,18100,37391
2022-12-02,8호선,천호,16247,19000,35247
2022-12-02,9호선,가양,23643,22848,46491
2022-12-02,9호선,개화,2773,1887,4660
2022-12-02,9호선,고속터미널,15996,21734,37730
2022-12-02,9호선,공항시장,3204,3341,6545
2022-12-02,9호선,구반포,1535,1573,3108
2022-12-02,9호선,국회의사당,18745,18860,37605
2022-12-02,9호선,김포공항,7703,11170,18873
2022-12-02,9호선,노들,5075,4092,9167
2022-12-02,9호선,노량진,30059,28645,58704
2022-12-02,9호선,당산,21275,21021,42296
2022-12-02,9호선,동작,2046,1429,3475
2022-12-02,9호선,등촌,12627,12099,24726
2022-12-02,9호선,마곡나루,13915,13829,27744
2022-12-02,9호선,사평,4334,4128,8462
2022-12-02,9호선,샛강,6752,6764,13516
2022-12-02,9호선,선유도,9506,8888,18394
2022-12-02,9호선,신논현,34257,34469,68726
2022-12-02,9호선,신목동,4670,3918,8588
2022-12-02,9호선,신반포,4051,3949,8000
2022-12-02,9호선,신방화,7486,7262,14748
2022-12-02,9호선,양천향교,10885,10858,21743
2022-12-02,9호선,여의도,33885,31325,65210
2022-12-02,9호선,염창,19336,18498,37834
2022-12-02,9호선,증미,7808,7187,14995
2022-12-02,9호선,흑석,10106,10299,20405
2022-12-02,9호선2~3단계,둔촌오륜,1351,1169,2520
2022-12-02,9호선2~3단계,봉은사,21714,22025,43739
2022-12-02,9호선2~3단계,삼성중앙,8528,8922,17450
2022-12-02,9호선2~3단계,삼전,7822,7176,14998
2022-12-02,9호선2~3단계,석촌,9922,8811,18733
2022-12-02,9호선2~3단계,석촌고분,7292,7049,14341
2022-12-02,9호선2~3단계,선정릉,10976,11919,22895
2022-12-02,9호선2~3단계,송파나루,5916,6374,12290
2022-12-02,9호선2~3단계,언주,12363,12373,24736
2022-12-02,9호선2~3단계,올림픽공원,9119,8808,17927
2022-12-02,9호선2~3단계,종합운동장,6464,6623,13087
2022-12-02,9호선2~3단계,중앙보훈병원,12066,10533,22599
2022-12-02,9호선2~3단계,한성백제,3150,2767,5917
2022-12-02,경강선,경기광주,8787,8215,17002
2022-12-02,경강선,곤지암,2535,2387,4922
2022-12-02,경강선,부발,2962,2239,5201
2022-12-02,경강선,삼동,2615,2386,5001
2022-12-02,경강선,세종대왕릉,352,345,697
2022-12-02,경강선,신둔도예촌,1786,1603,3389
2022-12-02,경강선,여주,2538,2498,5036
2022-12-02,경강선,이매,1266,1103,2369
2022-12-02,경강선,이천,3053,3220,6273
2022-12-02,경강선,초월,3704,3346,7050
2022-12-02,경강선,판교,5881,5928,11809
2022-12-02,경부선,가산디지털단지,18988,21789,40777
2022-12-02,경부선,관악,7850,7532,15382
2022-12-02,경부선,광명,3939,3523,7462
2022-12-02,경부선,구로,19451,19909,39360
2022-12-02,경부선,군포,7881,7624,15505
2022-12-02,경부선,금정,30275,30642,60917
2022-12-02,경부선,금천구청,12338,12523,24861
2022-12-02,경부선,남영,10390,11234,21624
2022-12-02,경부선,노량진,9820,10273,20093
2022-12-02,경부선,당정,7108,6544,13652
2022-12-02,경부선,대방,11981,13110,25091
2022-12-02,경부선,독산,19409,19832,39241
2022-12-02,경부선,두정,8217,7473,15690
2022-12-02,경부선,명학,9763,9542,19305
2022-12-02,경부선,병점,17195,16859,34054
2022-12-02,경부선,서동탄,1475,1361,2836
2022-12-02,경부선,서울역,9742,2962,12704
2022-12-02,경부선,서정리,10391,7988,18379
2022-12-02,경부선,석수,10081,8943,19024
2022-12-02,경부선,성균관대,16123,16033,32156
2022-12-02,경부선,성환,5153,4377,9530
2022-12-02,경부선,세류,3433,3123,6556
2022-12-02,경부선,세마,3175,2998,6173
2022-12-02,경부선,송탄,5280,4807,10087
2022-12-02,경부선,수원,39102,43478,82580
2022-12-02,경부선,신길,9751,8135,17886
2022-12-02,경부선,신도림,4159,3871,8030
2022-12-02,경부선,안양,26490,26534,53024
2022-12-02,경부선,영등포,43824,46538,90362
2022-12-02,경부선,오산,11138,10895,22033
2022-12-02,경부선,오산대,4119,3727,7846
2022-12-02,경부선,용산,42495,44291,86786
2022-12-02,경부선,의왕,9674,9465,19139
2022-12-02,경부선,직산,1056,934,1990
2022-12-02,경부선,진위,2097,1653,3750
2022-12-02,경부선,천안,6997,6735,13732
2022-12-02,경부선,평택,15050,14412,29462
2022-12-02,경부선,평택지제,5202,4879,10081
2022-12-02,경부선,화서,8694,8468,17162
2022-12-02,경원선,가능,6957,6631,13588
2022-12-02,경원선,광운대,8730,8266,16996
2022-12-02,경원선,녹양,4881,4574,9455
2022-12-02,경원선,녹천,4977,3888,8865
2022-12-02,경원선,덕계,3569,3087,6656
2022-12-02,경원선,덕정,6344,5783,12127
2022-12-02,경원선,도봉,6286,6036,12322
2022-12-02,경원선,도봉산,7351,4445,11796
2022-12-02,경원선,동두천,2509,2632,5141
2022-12-02,경원선,동두천중앙,3114,3140,6254
2022-12-02,경원선,망월사,8696,8567,17263
2022-12-02,경원선,방학,10282,10102,20384
2022-12-02,경원선,보산,2008,1663,3671
2022-12-02,경원선,서빙고,2226,1987,4213
2022-12-02,경원선,석계,8547,9522,18069
2022-12-02,경원선,소요산,2131,1926,4057
2022-12-02,경원선,신이문,9006,8273,17279
2022-12-02,경원선,양주,7916,7596,15512
2022-12-02,경원선,옥수,64,36,100
2022-12-02,경원선,왕십리,17013,18707,35720
2022-12-02,경원선,외대앞,10268,9820,20088
2022-12-02,경원선,월계,7848,7137,14985
2022-12-02,경원선,응봉,2025,1663,3688
2022-12-02,경원선,의정부,19230,20946,40176
2022-12-02,경원선,이촌,4085,3274,7359
2022-12-02,경원선,지행,7184,7065,14249
2022-12-02,경원선,청량리,17470,17931,35401
2022-12-02,경원선,한남,4297,4160,8457
2022-12-02,경원선,회룡,13173,13028,26201
2022-12-02,경의선,가좌,5936,5705,11641
2022-12-02,경의선,강매,3472,2879,6351
2022-12-02,경의선,곡산,614,589,1203
2022-12-02,경의선,공덕,4042,3630,7672
2022-12-02,경의선,금릉,5257,5215,10472
2022-12-02,경의선,금촌,6845,6682,13527
2022-12-02,경의선,능곡,4007,3578,7585
2022-12-02,경의선,디지털미디어시티,2875,2648,5523
2022-12-02,경의선,문산,5323,5151,10474
2022-12-02,경의선,백마,7415,7178,14593
2022-12-02,경의선,서강대,2329,2338,4667
2022-12-02,경의선,서울역,4749,6155,10904
2022-12-02,경의선,수색,2738,2777,5515
2022-12-02,경의선,신촌,900,1196,2096
2022-12-02,경의선,야당,8343,8845,17188
2022-12-02,경의선,운정,7362,6810,14172
2022-12-02,경의선,월롱,3421,2235,5656
2022-12-02,경의선,일산,9643,9546,19189
2022-12-02,경의선,임진강,10,4,14
2022-12-02,경의선,탄현,8217,8091,16308
2022-12-02,경의선,파주,1458,962,2420
2022-12-02,경의선,풍산,5802,5496,11298
2022-12-02,경의선,행신,8710,8802,17512
2022-12-02,경의선,홍대입구,1971,2454,4425
2022-12-02,경의선,화전,2669,2390,5059
2022-12-02,경의선,효창공원앞,3351,3723,7074
2022-12-02,경인선,간석,6232,5859,12091
2022-12-02,경인선,개봉,22964,22583,45547
2022-12-02,경인선,구일,7091,6968,14059
2022-12-02,경인선,도원,3441,3601,7042
2022-12-02,경인선,도화,4303,3977,8280
2022-12-02,경인선,동암,16979,17039,34018
2022-12-02,경인선,동인천,14490,13611,28101
2022-12-02,경인선,백운,7074,6938,14012
2022-12-02,경인선,부개,9035,8453,17488
2022-12-02,경인선,부천,33766,34647,68413
2022-12-02,경인선,부평,29949,33726,63675
2022-12-02,경인선,소사,8922,8783,17705
2022-12-02,경인선,송내,28946,29019,57965
2022-12-02,경인선,역곡,30167,29707,59874
2022-12-02,경인선,오류동,12045,11081,23126
2022-12-02,경인선,온수,7237,6803,14040
2022-12-02,경인선,인천,3696,2781,6477
2022-12-02,경인선,제물포,11776,11152,22928
2022-12-02,경인선,주안,20293,18618,38911
2022-12-02,경인선,중동,9914,9296,19210
2022-12-02,경춘선,가평,1616,1791,3407
2022-12-02,경춘선,갈매,3135,2683,5818
2022-12-02,경춘선,강촌,412,419,831
2022-12-02,경춘선,굴봉산,84,85,169
2022-12-02,경춘선,금곡,1470,1463,2933
2022-12-02,경춘선,김유정,280,298,578
2022-12-02,경춘선,남춘천,3524,2940,6464
2022-12-02,경춘선,대성리,486,585,1071
2022-12-02,경춘선,마석,3976,4060,8036
2022-12-02,경춘선,백양리,64,103,167
2022-12-02,경춘선,별내,3352,3225,6577
2022-12-02,경춘선,사릉,2442,2380,4822
2022-12-02,경춘선,상천,223,238,461
2022-12-02,경춘선,신내,2366,2201,4567
2022-12-02,경춘선,천마산,1688,1526,3214
2022-12-02,경춘선,청평,1611,1828,3439
2022-12-02,경춘선,춘천,1892,1324,3216
2022-12-02,경춘선,퇴계원,3681,3438,7119
2022-12-02,경춘선,평내호평,6360,6534,12894
2022-12-02,공항철도,검암,7023,6865,13888
2022-12-02,공항철도,계양,12936,11724,24660
2022-12-02,공항철도,공덕,2678,3702,6380
2022-12-02,공항철도,공항화물청사,2413,2463,4876
2022-12-02,공항철도,김포공항,11770,6491,18261
2022-12-02,공항철도,디지털미디어시티,15246,13856,29102
2022-12-02,공항철도,마곡나루,10715,9763,20478
2022-12-02,공항철도,서울역,12562,10715,23277
2022-12-02,공항철도,영종,3794,3988,7782
2022-12-02,공항철도,운서,8660,8992,17652
2022-12-02,공항철도,인천공항1터미널,10775,9744,20519
2022-12-02,공항철도,인천공항2터미널,4009,3453,7462
2022-12-02,공항철도,청라국제도시,7631,7302,14933
2022-12-02,공항철도,홍대입구,12456,13074,25530
2022-12-02,과천선,경마공원,7362,7573,14935
2022-12-02,과천선,과천,6686,7230,13916
2022-12-02,과천선,대공원,2821,2944,5765
2022-12-02,과천선,범계,27644,29204,56848
2022-12-02,과천선,선바위,9351,8446,17797
2022-12-02,과천선,인덕원,26011,27649,53660
2022-12-02,과천선,정부과천청사,11306,12165,23471
2022-12-02,과천선,평촌,18810,18344,37154
2022-12-02,분당선,가천대,11128,11239,22367
2022-12-02,분당선,강남구청,10686,12104,22790
2022-12-02,분당선,개포동,4389,4473,8862
2022-12-02,분당선,구룡,2749,2450,5199
2022-12-02,분당선,구성,5435,5822,11257
2022-12-02,분당선,기흥,11844,11143,22987
2022-12-02,분당선,대모산입구,5336,4849,10185
2022-12-02,분당선,도곡,7662,7437,15099
2022-12-02,분당선,망포,17539,16172,33711
2022-12-02,분당선,매교,4949,4950,9899
2022-12-02,분당선,매탄권선,6137,5793,11930
2022-12-02,분당선,모란,21286,21896,43182
2022-12-02,분당선,미금,16954,18136,35090
2022-12-02,분당선,보정,2929,2594,5523
2022-12-02,분당선,복정,2,0,2
2022-12-02,분당선,상갈,5985,5779,11764
2022-12-02,분당선,서울숲,11812,11961,23773
2022-12-02,분당선,서현,27574,28772,56346
2022-12-02,분당선,선릉,14752,22662,37414
2022-12-02,분당선,선정릉,8664,8838,17502
2022-12-02,분당선,수내,15572,15401,30973
2022-12-02,분당선,수서,16454,17184,33638
2022-12-02,분당선,수원,9288,8018,17306
2022-12-02,분당선,수원시청,14071,16901,30972
2022-12-02,분당선,신갈,5183,4972,10155
2022-12-02,분당선,압구정로데오,21600,24873,46473
2022-12-02,분당선,야탑,28933,30669,59602
2022-12-02,분당선,영통,9948,10015,19963
2022-12-02,분당선,오리,12818,10421,23239
2022-12-02,분당선,이매,6118,5736,11854
2022-12-02,분당선,정자,20593,21796,42389
2022-12-02,분당선,죽전,15887,16782,32669
2022-12-02,분당선,청명,5129,4703,9832
2022-12-02,분당선,태평,14573,13784,28357
2022-12-02,분당선,한티,16629,17471,34100
2022-12-02,수인선,고색,5335,4916,10251
2022-12-02,수인선,남동인더스파크,2277,2558,4835
2022-12-02,수인선,달월,100,80,180
2022-12-02,수인선,사리,5493,4723,10216
2022-12-02,수인선,소래포구,4839,4630,9469
2022-12-02,수인선,송도,2547,2347,4894
2022-12-02,수인선,숭의,4229,3876,8105
2022-12-02,수인선,신포,1984,2080,4064
2022-12-02,수인선,야목,399,304,703
2022-12-02,수인선,어천,1240,1092,2332
2022-12-02,수인선,연수,5159,5138,10297
2022-12-02,수인선,오목천,4584,3783,8367
2022-12-02,수인선,원인재,4663,4894,9557
2022-12-02,수인선,월곶,2834,2745,5579
2022-12-02,수인선,인천,993,1668,2661
2022-12-02,수인선,인천논현,5964,6459,12423
2022-12-02,수인선,인하대,7205,6864,14069
2022-12-02,수인선,호구포,4430,4460,8890
2022-12-02,신림선,관악산,2461,2345,4806
2022-12-02,신림선,당곡,4337,4242,8579
2022-12-02,신림선,대방,2809,2082,4891
2022-12-02,신림선,보라매,3674,3084,6758
2022-12-02,신림선,보라매공원,1926,1984,3910
2022-12-02,신림선,보라매병원,6834,6940,13774
2022-12-02,신림선,샛강,2631,3415,6046
2022-12-02,신림선,서울대벤처타운,8344,7902,16246
2022-12-02,신림선,서울지방병무청,2919,2982,5901
2022-12-02,신림선,서원,3390,2838,6228
2022-12-02,신림선,신림,1811,2456,4267
2022-12-02,안산선,고잔,9618,9009,18627
2022-12-02,안산선,대야미,5260,4842,10102
2022-12-02,안산선,반월,4587,4468,9055
2022-12-02,안산선,산본,16937,18956,35893
2022-12-02,안산선,상록수,17081,17377,34458
2022-12-02,안산선,수리산,4366,3920,8286
2022-12-02,안산선,신길온천,1895,1733,3628
2022-12-02,안산선,안산,12067,11199,23266
2022-12-02,안산선,오이도,8943,9026,17969
2022-12-02,안산선,정왕,10972,10367,21339
2022-12-02,안산선,중앙,19339,21531,40870
2022-12-02,안산선,초지,5388,5488,10876
2022-12-02,안산선,한대앞,10570,10891,21461
2022-12-02,우이신설선,4.19민주묘지,3609,3358,6967
2022-12-02,우이신설선,가오리,4414,4229,8643
2022-12-02,우이신설선,보문,1696,1688,3384
2022-12-02,우이신설선,북한산보국문,6825,6311,13136
2022-12-02,우이신설선,북한산우이,2805,2349,5154
2022-12-02,우이신설선,삼양,2124,2256,4380
2022-12-02,우이신설선,삼양사거리,2705,2699,5404
2022-12-02,우이신설선,성신여대입구,4098,4618,8716
2022-12-02,우이신설선,솔밭공원,2647,2580,5227
2022-12-02,우이신설선,솔샘,6370,6007,12377
2022-12-02,우이신설선,신설동,2365,2224,4589
2022-12-02,우이신설선,정릉,5156,4654,9810
2022-12-02,우이신설선,화계,3720,3386,7106
2022-12-02,일산선,대곡,2232,1741,3973
2022-12-02,일산선,대화,14147,11529,25676
2022-12-02,일산선,마두,8118,8399,16517
2022-12-02,일산선,백석,10638,10690,21328
2022-12-02,일산선,삼송,20962,20270,41232
2022-12-02,일산선,원당,11962,11211,23173
2022-12-02,일산선,원흥,12627,11767,24394
2022-12-02,일산선,정발산,7615,8388,16003
2022-12-02,일산선,주엽,9653,9781,19434
2022-12-02,일산선,화정,17733,18478,36211
2022-12-02,장항선,배방,1215,1210,2425
2022-12-02,장항선,봉명,1344,1257,2601
2022-12-02,장항선,신창,2902,1954,4856
2022-12-02,장항선,쌍용,2717,2490,5207
2022-12-02,장항선,아산,4630,4271,8901
2022-12-02,장항선,온양온천,4085,4370,8455
2022-12-02,장항선,탕정,1210,1074,2284
2022-12-02,중앙선,구리,14010,14452,28462
2022-12-02,중앙선,국수,833,853,1686
2022-12-02,중앙선,덕소,5698,5700,11398
2022-12-02,중앙선,도농,11850,10763,22613
2022-12-02,중앙선,도심,2546,1969,4515
2022-12-02,중앙선,망우,7907,7994,15901
2022-12-02,중앙선,상봉,6282,6015,12297
2022-12-02,중앙선,신원,149,155,304
2022-12-02,중앙선,아신,602,567,1169
2022-12-02,중앙선,양수,1728,1732,3460
2022-12-02,중앙선,양원,3151,2900,6051
2022-12-02,중앙선,양정,635,531,1166
2022-12-02,중앙선,양평,2876,3084,5960
2022-12-02,중앙선,오빈,271,298,569
2022-12-02,중앙선,용문,1576,1748,3324
2022-12-02,중앙선,운길산,569,529,1098
2022-12-02,중앙선,원덕,328,347,675
2022-12-02,중앙선,중랑,5960,5573,11533
2022-12-02,중앙선,지평,53,45,98
2022-12-02,중앙선,팔당,725,805,1530
2022-12-02,중앙선,회기,28924,26908,55832
2022-12-05,1호선,동대문,11023,10367,21390
2022-12-05,1호선,동묘앞,7486,7825,15311
2022-12-05,1호선,서울역,50578,48790,99368
2022-12-05,1호선,시청,26503,26275,52778
2022-12-05,1호선,신설동,14395,13842,28237
2022-12-05,1호선,제기동,16594,16772,33366
2022-12-05,1호선,종각,39231,38848,78079
2022-12-05,1호선,종로3가,24887,22756,47643
2022-12-05,1호선,종로5가,23570,23224,46794
2022-12-05,1호선,청량리,19385,19321,38706
2022-12-05,2호선,강남,81026,77629,158655
2022-12-05,2호선,강변,31506,29754,61260
2022-12-05,2호선,건대입구,33834,36323,70157
2022-12-05,2호선,교대,35939,40845,76784
2022-12-05,2호선,구로디지털단지,61913,61678,123591
2022-12-05,2호선,구의,24945,24614,49559
2022-12-05,2호선,낙성대,28116,28143,56259
2022-12-05,2호선,당산,18810,22384,41194
2022-12-05,2호선,대림,24998,25286,50284
2022-12-05,2호선,도림천,1460,1590,3050
2022-12-05,2호선,동대문역사문화공원,13075,14648,27723
2022-12-05,2호선,뚝섬,22376,24044,46420
2022-12-05,2호선,문래,22917,23174,46091
2022-12-05,2호선,방배,19913,20528,40441
2022-12-05,2호선,봉천,25156,23841,48997
2022-12-05,2호선,사당,38438,41986,80424
2022-12-05,2호선,삼성,56161,56852,113013
2022-12-05,2호선,상왕십리,15088,14865,29953
2022-12-05,2호선,서울대입구,48205,47273,95478
2022-12-05,2호선,서초,23965,23234,47199
2022-12-05,2호선,선릉,62024,55021,117045
2022-12-05,2호선,성수,39635,42675,82310
2022-12-05,2호선,시청,26685,25806,52491
2022-12-05,2호선,신답,1820,2057,3877
2022-12-05,2호선,신당,14137,14464,28601
2022-12-05,2호선,신대방,26012,25485,51497
2022-12-05,2호선,신도림,49509,48230,97739
2022-12-05,2호선,신림,57933,56032,113965
2022-12-05,2호선,신설동,3522,3649,7171
2022-12-05,2호선,신정네거리,10935,11300,22235
2022-12-05,2호선,신촌,36200,37295,73495
2022-12-05,2호선,아현,10842,10575,21417
2022-12-05,2호선,양천구청,7323,7710,15033
2022-12-05,2호선,역삼,58194,65452,123646
2022-12-05,2호선,영등포구청,23187,23872,47059
2022-12-05,2호선,왕십리,16758,14012,30770
2022-12-05,2호선,용답,3119,3290,6409
2022-12-05,2호선,용두,2475,2478,4953
2022-12-05,2호선,을지로3가,25203,24996,50199
2022-12-05,2호선,을지로4가,14549,14639,29188
2022-12-05,2호선,을지로입구,47911,49528,97439
2022-12-05,2호선,이대,17106,18962,36068
2022-12-05,2호선,잠실,75818,75344,151162
2022-12-05,2호선,잠실나루,15644,15102,30746
2022-12-05,2호선,잠실새내,22695,22458,45153
2022-12-05,2호선,종합운동장,7336,8168,15504
2022-12-05,2호선,충정로,10715,11485,22200
2022-12-05,2호선,한양대,14807,16226,31033
2022-12-05,2호선,합정,29873,31501,61374
2022-12-05,2호선,홍대입구,57334,59687,117021
2022-12-05,3호선,가락시장,9561,9449,19010
2022-12-05,3호선,경복궁,23590,24192,47782
2022-12-05,3호선,경찰병원,8193,8259,16452
2022-12-05,3호선,고속터미널,43652,41361,85013
2022-12-05,3호선,교대,16041,10655,26696
2022-12-05,3호선,구파발,22371,21383,43754
2022-12-05,3호선,금호,8372,7936,16308
2022-12-05,3호선,남부터미널,29873,30853,60726
2022-12-05,3호선,녹번,16579,15196,31775
2022-12-05,3호선,대청,11010,10363,21373
2022-12-05,3호선,대치,11370,11463,22833
2022-12-05,3호선,도곡,5732,5615,11347
2022-12-05,3호선,독립문,7185,7248,14433
2022-12-05,3호선,동대입구,10550,11734,22284
2022-12-05,3호선,매봉,13271,12658,25929
2022-12-05,3호선,무악재,4226,4302,8528
2022-12-05,3호선,불광,16584,17545,34129
2022-12-05,3호선,수서,18642,19184,37826
2022-12-05,3호선,신사,29031,29835,58866
2022-12-05,3호선,안국,24818,25096,49914
2022-12-05,3호선,압구정,33630,36386,70016
2022-12-05,3호선,약수,13445,13071,26516
2022-12-05,3호선,양재,40325,43759,84084
2022-12-05,3호선,연신내,36376,34277,70653
2022-12-05,3호선,오금,6898,6131,13029
2022-12-05,3호선,옥수,8983,9308,18291
2022-12-05,3호선,을지로3가,11841,11711,23552
2022-12-05,3호선,일원,11679,11137,22816
2022-12-05,3호선,잠원,5168,4967,10135
2022-12-05,3호선,종로3가,10130,11664,21794
2022-12-05,3호선,지축,6332,6192,12524
2022-12-05,3호선,충무로,1,0,1
2022-12-05,3호선,학여울,1986,1988,3974
2022-12-05,3호선,홍제,18918,18291,37209
2022-12-05,4호선,길음,22221,22981,45202
2022-12-05,4호선,남태령,1289,1148,2437
2022-12-05,4호선,노원,18309,21062,39371
2022-12-05,4호선,당고개,9305,8263,17568
2022-12-05,4호선,동대문,20503,20908,41411
2022-12-05,4호선,동대문역사문화공원,16317,14279,30596
2022-12-05,4호선,동작,1208,1323,2531
2022-12-05,4호선,명동,26879,27374,54253
2022-12-05,4호선,미아,15487,15164,30651
2022-12-05,4호선,미아사거리,26671,26947,53618
2022-12-05,4호선,사당,27009,22414,49423
2022-12-05,4호선,삼각지,5623,6194,11817
2022-12-05,4호선,상계,19607,18433,38040
2022-12-05,4호선,서울역,12629,18799,31428
2022-12-05,4호선,성신여대입구,21163,20476,41639
2022-12-05,4호선,수유,34083,34960,69043
2022-12-05,4호선,숙대입구,15215,14503,29718
2022-12-05,4호선,신용산,18166,18453,36619
2022-12-05,4호선,쌍문,29534,28199,57733
2022-12-05,4호선,이촌,7919,8839,16758
2022-12-05,4호선,창동,25559,27084,52643
2022-12-05,4호선,총신대입구,19002,20556,39558
2022-12-05,4호선,충무로,30838,31555,62393
2022-12-05,4호선,한성대입구,14374,13924,28298
2022-12-05,4호선,혜화,32961,32074,65035
2022-12-05,4호선,회현,27094,27459,54553
2022-12-05,5호선,강동,19118,18557,37675
2022-12-05,5호선,강일,5467,5171,10638
2022-12-05,5호선,개롱,6969,7311,14280
2022-12-05,5호선,개화산,5957,5772,11729
2022-12-05,5호선,거여,10796,10418,21214
2022-12-05,5호선,고덕,10347,10465,20812
2022-12-05,5호선,공덕,15267,16166,31433
2022-12-05,5호선,광나루,15238,14158,29396
2022-12-05,5호선,광화문,33910,37076,70986
2022-12-05,5호선,군자,11494,12576,24070
2022-12-05,5호선,굽은다리,10040,9621,19661
2022-12-05,5호선,길동,8294,8474,16768
2022-12-05,5호선,김포공항,7471,6938,14409
2022-12-05,5호선,까치산,29824,28912,58736
2022-12-05,5호선,답십리,16696,15413,32109
2022-12-05,5호선,동대문역사문화공원,3474,3908,7382
2022-12-05,5호선,둔촌동,8771,9016,17787
2022-12-05,5호선,마곡,11619,11554,23173
2022-12-05,5호선,마장,6225,5967,12192
2022-12-05,5호선,마천,7970,7586,15556
2022-12-05,5호선,마포,15631,15989,31620
2022-12-05,5호선,명일,8945,9451,18396
2022-12-05,5호선,목동,17217,18849,36066
2022-12-05,5호선,미사,16750,17135,33885
2022-12-05,5호선,발산,22497,23015,45512
2022-12-05,5호선,방이,7391,7644,15035
2022-12-05,5호선,방화,7181,6867,14048
2022-12-05,5호선,상일동,15729,14766,30495
2022-12-05,5호선,서대문,22410,22457,44867
2022-12-05,5호선,송정,6681,6286,12967
2022-12-05,5호선,신금호,6848,7149,13997
2022-12-05,5호선,신길,4460,4986,9446
2022-12-05,5호선,신정,14501,11824,26325
2022-12-05,5호선,아차산,14580,14048,28628
2022-12-05,5호선,애오개,7125,7169,14294
2022-12-05,5호선,양평,7896,7880,15776
2022-12-05,5호선,여의나루,10920,13004,23924
2022-12-05,5호선,여의도,32601,33344,65945
2022-12-05,5호선,영등포구청,4471,4436,8907
2022-12-05,5호선,영등포시장,10612,10990,21602
2022-12-05,5호선,오금,4059,4018,8077
2022-12-05,5호선,오목교,21705,23040,44745
2022-12-05,5호선,올림픽공원,4825,4058,8883
2022-12-05,5호선,왕십리,4663,5330,9993
2022-12-05,5호선,우장산,15620,15327,30947
2022-12-05,5호선,을지로4가,6755,6704,13459
2022-12-05,5호선,장한평,19697,19506,39203
2022-12-05,5호선,종로3가,12532,12289,24821
2022-12-05,5호선,천호,17960,18240,36200
2022-12-05,5호선,청구,4203,3743,7946
2022-12-05,5호선,충정로,5099,5252,10351
2022-12-05,5호선,하남검단산,6020,5722,11742
2022-12-05,5호선,하남시청,7412,7364,14776
2022-12-05,5호선,하남풍산,4446,4300,8746
2022-12-05,5호선,행당,8794,7828,16622
2022-12-05,5호선,화곡,29914,28061,57975
2022-12-05,6호선,고려대,9700,9516,19216
2022-12-05,6호선,공덕,20093,19365,39458
2022-12-05,6호선,광흥창,9757,9515,19272
2022-12-05,6호선,구산,8243,6373,14616
2022-12-05,6호선,녹사평,4363,4469,8832
2022-12-05,6호선,대흥,9590,10210,19800
2022-12-05,6호선,독바위,2817,3004,5821
2022-12-05,6호선,돌곶이,12149,11452,23601
2022-12-05,6호선,동묘앞,8000,8481,16481
2022-12-05,6호선,디지털미디어시티,15502,17190,32692
2022-12-05,6호선,마포구청,15147,13861,29008
2022-12-05,6호선,망원,13748,14645,28393
2022-12-05,6호선,버티고개,2292,2201,4493
2022-12-05,6호선,보문,8168,7436,15604
2022-12-05,6호선,봉화산,9699,9199,18898
2022-12-05,6호선,불광,4270,4286,8556
2022-12-05,6호선,삼각지,6817,6228,13045
2022-12-05,6호선,상수,9504,10706,20210
2022-12-05,6호선,상월곡,7173,6774,13947
2022-12-05,6호선,새절,13581,12623,26204
2022-12-05,6호선,석계,13297,14150,27447
2022-12-05,6호선,신당,8302,8997,17299
2022-12-05,6호선,안암,14625,15525,30150
2022-12-05,6호선,약수,3800,3756,7556
2022-12-05,6호선,역촌,3931,4682,8613
2022-12-05,6호선,월곡,13726,13402,27128
2022-12-05,6호선,월드컵경기장,4080,4267,8347
2022-12-05,6호선,응암,18511,18375,36886
2022-12-05,6호선,이태원,8884,9179,18063
2022-12-05,6호선,증산,10456,10460,20916
2022-12-05,6호선,창신,3981,3402,7383
2022-12-05,6호선,청구,3868,4007,7875
2022-12-05,6호선,태릉입구,5909,6654,12563
2022-12-05,6호선,한강진,6966,7814,14780
2022-12-05,6호선,합정,12828,12566,25394
2022-12-05,6호선,화랑대,13731,10538,24269
2022-12-05,6호선,효창공원앞,7853,7576,15429
2022-12-05,7호선,가산디지털단지,49039,48629,97668
2022-12-05,7호선,강남구청,17435,19209,36644
2022-12-05,7호선,건대입구,13745,14280,28025
2022-12-05,7호선,고속터미널,16773,13830,30603
2022-12-05,7호선,공릉,12838,12995,25833
2022-12-05,7호선,광명사거리,21830,21500,43330
2022-12-05,7호선,군자,15596,12570,28166
2022-12-05,7호선,남구로,16734,17073,33807
2022-12-05,7호선,남성,12139,11606,23745
2022-12-05,7호선,내방,15985,16104,32089
2022-12-05,7호선,노원,20794,21301,42095
2022-12-05,7호선,논현,19349,20105,39454
2022-12-05,7호선,대림,8357,8326,16683
2022-12-05,7호선,도봉산,9935,10855,20790
2022-12-05,7호선,뚝섬유원지,7297,7133,14430
2022-12-05,7호선,마들,14074,13177,27251
2022-12-05,7호선,먹골,10621,10566,21187
2022-12-05,7호선,면목,16726,16265,32991
2022-12-05,7호선,반포,6471,6415,12886
2022-12-05,7호선,보라매,7703,7865,15568
2022-12-05,7호선,사가정,16808,16939,33747
2022-12-05,7호선,상도,12708,13008,25716
2022-12-05,7호선,상봉,17479,16387,33866
2022-12-05,7호선,수락산,13095,12897,25992
2022-12-05,7호선,숭실대입구,16216,16672,32888
2022-12-05,7호선,신대방삼거리,15918,15461,31379
2022-12-05,7호선,신풍,12059,11373,23432
2022-12-05,7호선,어린이대공원,17922,18881,36803
2022-12-05,7호선,온수,11741,10813,22554
2022-12-05,7호선,용마산,6235,6020,12255
2022-12-05,7호선,이수,16452,15537,31989
2022-12-05,7호선,장승배기,9768,9629,19397
2022-12-05,7호선,장암,2559,862,3421
2022-12-05,7호선,중계,15925,14568,30493
2022-12-05,7호선,중곡,11578,10657,22235
2022-12-05,7호선,중화,11228,11218,22446
2022-12-05,7호선,천왕,12300,11646,23946
2022-12-05,7호선,철산,22415,22697,45112
2022-12-05,7호선,청담,20936,23288,44224
2022-12-05,7호선,태릉입구,9730,9172,18902
2022-12-05,7호선,하계,19741,18601,38342
2022-12-05,7호선,학동,26171,27459,53630
2022-12-05,8호선,가락시장,8126,8788,16914
2022-12-05,8호선,강동구청,11474,11757,23231
2022-12-05,8호선,남위례,6375,6486,12861
2022-12-05,8호선,남한산성입구,15326,14214,29540
2022-12-05,8호선,단대오거리,11630,11128,22758
2022-12-05,8호선,모란,4531,3400,7931
2022-12-05,8호선,몽촌토성,6594,6617,13211
2022-12-05,8호선,문정,23183,24455,47638
2022-12-05,8호선,복정,9935,8215,18150
2022-12-05,8호선,산성,5463,5505,10968
2022-12-05,8호선,석촌,7906,8926,16832
2022-12-05,8호선,송파,9399,9187,18586
2022-12-05,8호선,수진,5594,5112,10706
2022-12-05,8호선,신흥,5195,5413,10608
2022-12-05,8호선,암사,20049,17628,37677
2022-12-05,8호선,잠실,15582,18487,34069
2022-12-05,8호선,장지,18007,17164,35171
2022-12-05,8호선,천호,15049,17056,32105
2022-12-05,9호선,가양,22521,22355,44876
2022-12-05,9호선,개화,2887,1924,4811
2022-12-05,9호선,고속터미널,13185,17343,30528
2022-12-05,9호선,공항시장,2994,3298,6292
2022-12-05,9호선,구반포,1196,1262,2458
2022-12-05,9호선,국회의사당,17748,18372,36120
2022-12-05,9호선,김포공항,6818,9953,16771
2022-12-05,9호선,노들,4786,4103,8889
2022-12-05,9호선,노량진,27040,26538,53578
2022-12-05,9호선,당산,19460,19400,38860
2022-12-05,9호선,동작,1933,1140,3073
2022-12-05,9호선,등촌,12410,12035,24445
2022-12-05,9호선,마곡나루,13156,12690,25846
2022-12-05,9호선,사평,3983,3926,7909
2022-12-05,9호선,샛강,6781,6830,13611
2022-12-05,9호선,선유도,9520,9083,18603
2022-12-05,9호선,신논현,30128,29226,59354
2022-12-05,9호선,신목동,4596,3956,8552
2022-12-05,9호선,신반포,3763,3747,7510
2022-12-05,9호선,신방화,7386,7208,14594
2022-12-05,9호선,양천향교,10294,10807,21101
2022-12-05,9호선,여의도,31957,30118,62075
2022-12-05,9호선,염창,18684,18003,36687
2022-12-05,9호선,증미,7722,7309,15031
2022-12-05,9호선,흑석,10093,10658,20751
2022-12-05,9호선2~3단계,둔촌오륜,1238,1194,2432
2022-12-05,9호선2~3단계,봉은사,18643,19038,37681
2022-12-05,9호선2~3단계,삼성중앙,8288,8687,16975
2022-12-05,9호선2~3단계,삼전,7421,7176,14597
2022-12-05,9호선2~3단계,석촌,9091,8139,17230
2022-12-05,9호선2~3단계,석촌고분,6878,6915,13793
2022-12-05,9호선2~3단계,선정릉,10531,11674,22205
2022-12-05,9호선2~3단계,송파나루,5368,5767,11135
2022-12-05,9호선2~3단계,언주,12084,12358,24442
2022-12-05,9호선2~3단계,올림픽공원,6538,6685,13223
2022-12-05,9호선2~3단계,종합운동장,4561,4638,9199
2022-12-05,9호선2~3단계,중앙보훈병원,12239,10684,22923
2022-12-05,9호선2~3단계,한성백제,2839,2482,5321
2022-12-05,경강선,경기광주,8525,7957,16482
2022-12-05,경강선,곤지암,2397,2310,4707
2022-12-05,경강선,부발,2135,2089,4224
2022-12-05,경강선,삼동,2578,2412,4990
2022-12-05,경강선,세종대왕릉,355,330,685
2022-12-05,경강선,신둔도예촌,1652,1573,3225
2022-12-05,경강선,여주,2417,2477,4894
2022-12-05,경강선,이매,1305,1093,2398
2022-12-05,경강선,이천,2693,2746,5439
2022-12-05,경강선,초월,3475,3348,6823
2022-12-05,경강선,판교,5657,5586,11243
2022-12-05,경부선,가산디지털단지,18627,21969,40596
2022-12-05,경부선,관악,7754,7288,15042
2022-12-05,경부선,광명,3719,3029,6748
2022-12-05,경부선,구로,19010,19005,38015
2022-12-05,경부선,군포,7930,7886,15816
2022-12-05,경부선,금정,28363,28809,57172
2022-12-05,경부선,금천구청,12221,12236,24457
2022-12-05,경부선,남영,10075,10974,21049
2022-12-05,경부선,노량진,8144,8664,16808
2022-12-05,경부선,당정,7138,6759,13897
2022-12-05,경부선,대방,11607,12679,24286
2022-12-05,경부선,독산,19496,20252,39748
2022-12-05,경부선,두정,7593,9318,16911
2022-12-05,경부선,명학,10625,10491,21116
2022-12-05,경부선,병점,16831,16834,33665
2022-12-05,경부선,서동탄,1484,1265,2749
2022-12-05,경부선,서울역,8121,2507,10628
2022-12-05,경부선,서정리,8475,8235,16710
2022-12-05,경부선,석수,9938,9053,18991
2022-12-05,경부선,성균관대,15558,15397,30955
2022-12-05,경부선,성환,6759,6705,13464
2022-12-05,경부선,세류,3232,2792,6024
2022-12-05,경부선,세마,3111,2931,6042
2022-12-05,경부선,송탄,4468,4331,8799
2022-12-05,경부선,수원,35117,37584,72701
2022-12-05,경부선,신길,9394,8084,17478
2022-12-05,경부선,신도림,4094,4124,8218
2022-12-05,경부선,안양,26580,26128,52708
2022-12-05,경부선,영등포,37751,39061,76812
2022-12-05,경부선,오산,10301,10443,20744
2022-12-05,경부선,오산대,3857,3583,7440
2022-12-05,경부선,용산,36310,37078,73388
2022-12-05,경부선,의왕,9427,9350,18777
2022-12-05,경부선,직산,935,909,1844
2022-12-05,경부선,진위,1954,1705,3659
2022-12-05,경부선,천안,7153,6590,13743
2022-12-05,경부선,평택,13066,13367,26433
2022-12-05,경부선,평택지제,4438,4407,8845
2022-12-05,경부선,화서,8666,8241,16907
2022-12-05,경원선,가능,6899,6542,13441
2022-12-05,경원선,광운대,9039,8924,17963
2022-12-05,경원선,녹양,4592,4310,8902
2022-12-05,경원선,녹천,4990,4044,9034
2022-12-05,경원선,덕계,3474,3091,6565
2022-12-05,경원선,덕정,6466,6287,12753
2022-12-05,경원선,도봉,6016,5771,11787
2022-12-05,경원선,도봉산,7035,4245,11280
2022-12-05,경원선,동두천,2495,2588,5083
2022-12-05,경원선,동두천중앙,3202,3089,6291
2022-12-05,경원선,망월사,9502,9690,19192
2022-12-05,경원선,방학,10022,9945,19967
2022-12-05,경원선,보산,1470,1291,2761
2022-12-05,경원선,서빙고,2001,1833,3834
2022-12-05,경원선,석계,8345,9465,17810
2022-12-05,경원선,소요산,2059,1624,3683
2022-12-05,경원선,신이문,8916,8170,17086
2022-12-05,경원선,양주,7932,7506,15438
2022-12-05,경원선,옥수,44,47,91
2022-12-05,경원선,왕십리,15419,16581,32000
2022-12-05,경원선,외대앞,9829,10142,19971
2022-12-05,경원선,월계,8042,7379,15421
2022-12-05,경원선,응봉,2004,1711,3715
2022-12-05,경원선,의정부,18146,18875,37021
2022-12-05,경원선,이촌,3920,3100,7020
2022-12-05,경원선,지행,6697,6695,13392
2022-12-05,경원선,창동,1,0,1
2022-12-05,경원선,청량리,15029,15852,30881
2022-12-05,경원선,한남,4021,3930,7951
2022-12-05,경원선,회룡,12917,12614,25531
2022-12-05,경의선,가좌,6158,5873,12031
2022-12-05,경의선,강매,3436,2967,6403
2022-12-05,경의선,곡산,572,571,1143
2022-12-05,경의선,공덕,3940,3498,7438
2022-12-05,경의선,금릉,5295,5017,10312
2022-12-05,경의선,금촌,6643,6350,12993
2022-12-05,경의선,능곡,4044,3646,7690
2022-12-05,경의선,디지털미디어시티,2900,2639,5539
2022-12-05,경의선,문산,5180,4938,10118
2022-12-05,경의선,백마,7444,7025,14469
2022-12-05,경의선,서강대,2255,2332,4587
2022-12-05,경의선,서울역,4920,6397,11317
2022-12-05,경의선,수색,2846,3008,5854
2022-12-05,경의선,신촌,999,1261,2260
2022-12-05,경의선,야당,8130,8018,16148
2022-12-05,경의선,운정,7540,6726,14266
2022-12-05,경의선,월롱,2993,2739,5732
2022-12-05,경의선,일산,9886,9585,19471
2022-12-05,경의선,임진강,2,3,5
2022-12-05,경의선,탄현,8463,7905,16368
2022-12-05,경의선,파주,1631,1218,2849
2022-12-05,경의선,풍산,5831,5327,11158
2022-12-05,경의선,행신,8553,8582,17135
2022-12-05,경의선,홍대입구,1684,1993,3677
2022-12-05,경의선,화전,3067,2844,5911
2022-12-05,경의선,효창공원앞,3469,3808,7277
2022-12-05,경인선,간석,6078,5686,11764
2022-12-05,경인선,개봉,22634,22275,44909
2022-12-05,경인선,구일,7266,7222,14488
2022-12-05,경인선,도원,3426,3386,6812
2022-12-05,경인선,도화,4072,3747,7819
2022-12-05,경인선,동암,16249,16050,32299
2022-12-05,경인선,동인천,13614,12894,26508
2022-12-05,경인선,백운,6883,6624,13507
2022-12-05,경인선,부개,8851,8179,17030
2022-12-05,경인선,부천,32406,32045,64451
2022-12-05,경인선,부평,28021,29410,57431
2022-12-05,경인선,소사,8564,8526,17090
2022-12-05,경인선,송내,28516,28108,56624
2022-12-05,경인선,역곡,29454,29238,58692
2022-12-05,경인선,오류동,12188,11480,23668
2022-12-05,경인선,온수,7356,6959,14315
2022-12-05,경인선,인천,3203,2383,5586
2022-12-05,경인선,제물포,11667,10952,22619
2022-12-05,경인선,주안,19452,17847,37299
2022-12-05,경인선,중동,9682,8994,18676
2022-12-05,경춘선,가평,1499,1441,2940
2022-12-05,경춘선,갈매,3183,2721,5904
2022-12-05,경춘선,강촌,414,394,808
2022-12-05,경춘선,굴봉산,110,101,211
2022-12-05,경춘선,금곡,1591,1472,3063
2022-12-05,경춘선,김유정,243,252,495
2022-12-05,경춘선,남춘천,2438,2758,5196
2022-12-05,경춘선,대성리,380,433,813
2022-12-05,경춘선,마석,4123,3902,8025
2022-12-05,경춘선,백양리,88,96,184
2022-12-05,경춘선,별내,3360,3098,6458
2022-12-05,경춘선,사릉,2643,2388,5031
2022-12-05,경춘선,상천,255,194,449
2022-12-05,경춘선,신내,2415,2281,4696
2022-12-05,경춘선,천마산,1701,1550,3251
2022-12-05,경춘선,청평,1535,1439,2974
2022-12-05,경춘선,춘천,1285,1390,2675
2022-12-05,경춘선,퇴계원,3808,3369,7177
2022-12-05,경춘선,평내호평,6737,6365,13102
2022-12-05,공항철도,검암,6994,6723,13717
2022-12-05,공항철도,계양,12867,11810,24677
2022-12-05,공항철도,공덕,2588,3401,5989
2022-12-05,공항철도,공항화물청사,2336,2470,4806
2022-12-05,공항철도,김포공항,10945,6234,17179
2022-12-05,공항철도,디지털미디어시티,15014,14056,29070
2022-12-05,공항철도,마곡나루,10566,10250,20816
2022-12-05,공항철도,서울역,10497,9360,19857
2022-12-05,공항철도,영종,3698,3603,7301
2022-12-05,공항철도,운서,8400,8580,16980
2022-12-05,공항철도,인천공항1터미널,10677,9590,20267
2022-12-05,공항철도,인천공항2터미널,3982,3542,7524
2022-12-05,공항철도,청라국제도시,7228,6782,14010
2022-12-05,공항철도,홍대입구,10666,10824,21490
2022-12-05,과천선,경마공원,892,891,1783
2022-12-05,과천선,과천,6334,6195,12529
2022-12-05,과천선,대공원,1805,1834,3639
2022-12-05,과천선,범계,26234,26735,52969
2022-12-05,과천선,선바위,8455,7454,15909
2022-12-05,과천선,인덕원,24552,25979,50531
2022-12-05,과천선,정부과천청사,10895,11003,21898
2022-12-05,과천선,평촌,18689,18608,37297
2022-12-05,분당선,가천대,12011,12980,24991
2022-12-05,분당선,강남구청,10123,11610,21733
2022-12-05,분당선,개포동,4329,4361,8690
2022-12-05,분당선,구룡,2779,2676,5455
2022-12-05,분당선,구성,5548,5875,11423
2022-12-05,분당선,기흥,11878,11548,23426
2022-12-05,분당선,대모산입구,5121,4751,9872
2022-12-05,분당선,도곡,7974,7958,15932
2022-12-05,분당선,망포,16015,15642,31657
2022-12-05,분당선,매교,4798,4666,9464
2022-12-05,분당선,매탄권선,5621,5462,11083
2022-12-05,분당선,모란,19990,20436,40426
2022-12-05,분당선,미금,15966,16871,32837
2022-12-05,분당선,보정,2930,2496,5426
2022-12-05,분당선,상갈,5836,5531,11367
2022-12-05,분당선,서울숲,11080,11610,22690
2022-12-05,분당선,서현,25190,25573,50763
2022-12-05,분당선,선릉,14809,22433,37242
2022-12-05,분당선,선정릉,8468,9001,17469
2022-12-05,분당선,수내,14766,14680,29446
2022-12-05,분당선,수서,14761,15142,29903
2022-12-05,분당선,수원,8211,7068,15279
2022-12-05,분당선,수원시청,12945,13920,26865
2022-12-05,분당선,신갈,5137,4959,10096
2022-12-05,분당선,압구정로데오,17946,19212,37158
2022-12-05,분당선,야탑,26972,28473,55445
2022-12-05,분당선,영통,8883,9334,18217
2022-12-05,분당선,오리,12197,10191,22388
2022-12-05,분당선,이매,5858,5508,11366
2022-12-05,분당선,정자,19314,20530,39844
2022-12-05,분당선,죽전,15005,16563,31568
2022-12-05,분당선,청명,4700,4510,9210
2022-12-05,분당선,태평,13696,13196,26892
2022-12-05,분당선,한티,15326,16355,31681
2022-12-05,수인선,고색,5301,4801,10102
2022-12-05,수인선,남동인더스파크,2273,2590,4863
2022-12-05,수인선,달월,100,62,162
2022-12-05,수인선,사리,5210,4427,9637
2022-12-05,수인선,소래포구,4646,4231,8877
2022-12-05,수인선,송도,2474,2213,4687
2022-12-05,수인선,숭의,4235,3950,8185
2022-12-05,수인선,신포,1822,1813,3635
2022-12-05,수인선,야목,372,271,643
2022-12-05,수인선,어천,1045,999,2044
2022-12-05,수인선,연수,4688,4555,9243
2022-12-05,수인선,오목천,4237,3830,8067
2022-12-05,수인선,원인재,4375,4578,8953
2022-12-05,수인선,월곶,2797,2578,5375
2022-12-05,수인선,인천,913,1435,2348
2022-12-05,수인선,인천논현,5693,6036,11729
2022-12-05,수인선,인하대,7127,6942,14069
2022-12-05,수인선,호구포,4158,4395,8553
2022-12-05,신림선,관악산,2307,2365,4672
2022-12-05,신림선,당곡,4205,4255,8460
2022-12-05,신림선,대방,2485,2048,4533
2022-12-05,신림선,보라매,3586,3239,6825
2022-12-05,신림선,보라매공원,1949,2147,4096
2022-12-05,신림선,보라매병원,7404,7700,15104
2022-12-05,신림선,샛강,2820,3424,6244
2022-12-05,신림선,서울대벤처타운,7835,7841,15676
2022-12-05,신림선,서울지방병무청,2682,3065,5747
2022-12-05,신림선,서원,3353,2877,6230
2022-12-05,신림선,신림,1751,2342,4093
2022-12-05,안산선,고잔,9381,8664,18045
2022-12-05,안산선,대야미,4903,4516,9419
2022-12-05,안산선,반월,4404,4358,8762
2022-12-05,안산선,산본,16171,17579,33750
2022-12-05,안산선,상록수,16453,16869,33322
2022-12-05,안산선,수리산,4221,3517,7738
2022-12-05,안산선,신길온천,1908,1737,3645
2022-12-05,안산선,안산,11790,10561,22351
2022-12-05,안산선,오이도,8488,8064,16552
2022-12-05,안산선,정왕,10038,10667,20705
2022-12-05,안산선,중앙,18339,19226,37565
2022-12-05,안산선,초지,5453,5541,10994
2022-12-05,안산선,한대앞,10111,10359,20470
2022-12-05,우이신설선,4.19민주묘지,4230,4426,8656
2022-12-05,우이신설선,가오리,4363,4255,8618
2022-12-05,우이신설선,보문,1608,1590,3198
2022-12-05,우이신설선,북한산보국문,6422,6304,12726
2022-12-05,우이신설선,북한산우이,2621,2206,4827
2022-12-05,우이신설선,삼양,2046,2252,4298
2022-12-05,우이신설선,삼양사거리,2546,2573,5119
2022-12-05,우이신설선,성신여대입구,3626,4019,7645
2022-12-05,우이신설선,솔밭공원,2617,2522,5139
2022-12-05,우이신설선,솔샘,6389,5999,12388
2022-12-05,우이신설선,신설동,2411,2303,4714
2022-12-05,우이신설선,정릉,4870,4800,9670
2022-12-05,우이신설선,화계,3655,3340,6995
2022-12-05,일산선,대곡,2234,1623,3857
2022-12-05,일산선,대화,14073,10660,24733
2022-12-05,일산선,마두,8072,8210,16282
2022-12-05,일산선,백석,9973,9961,19934
2022-12-05,일산선,삼송,20270,19741,40011
2022-12-05,일산선,원당,11504,10721,22225
2022-12-05,일산선,원흥,12136,11457,23593
2022-12-05,일산선,정발산,6995,7021,14016
2022-12-05,일산선,주엽,9793,9608,19401
2022-12-05,일산선,화정,17237,17474,34711
2022-12-05,장항선,배방,1135,1069,2204
2022-12-05,장항선,봉명,1328,1326,2654
2022-12-05,장항선,신창,2605,2918,5523
2022-12-05,장항선,쌍용,2912,2990,5902
2022-12-05,장항선,아산,4065,3385,7450
2022-12-05,장항선,온양온천,3991,4022,8013
2022-12-05,장항선,탕정,1108,1001,2109
2022-12-05,중앙선,구리,14104,14051,28155
2022-12-05,중앙선,국수,796,751,1547
2022-12-05,중앙선,덕소,5716,5598,11314
2022-12-05,중앙선,도농,12346,10939,23285
2022-12-05,중앙선,도심,2631,1974,4605
2022-12-05,중앙선,망우,7522,7428,14950
2022-12-05,중앙선,상봉,5714,5698,11412
2022-12-05,중앙선,신원,161,152,313
2022-12-05,중앙선,아신,512,536,1048
2022-12-05,중앙선,양수,1735,1728,3463
2022-12-05,중앙선,양원,3146,3128,6274
2022-12-05,중앙선,양정,646,530,1176
2022-12-05,중앙선,양평,2843,2764,5607
2022-12-05,중앙선,오빈,332,305,637
2022-12-05,중앙선,용문,2401,2364,4765
2022-12-05,중앙선,운길산,588,542,1130
2022-12-05,중앙선,원덕,362,339,701
2022-12-05,중앙선,중랑,5722,5473,11195
2022-12-05,중앙선,지평,64,56,120
2022-12-05,중앙선,팔당,727,712,1439
2022-12-05,중앙선,회기,27847,27491,55338
2022-12-06,1호선,동대문,11198,10547,21745
2022-12-06,1호선,동묘앞,7712,8179,15891
2022-12-06,1호선,서울역,49796,48317,98113
2022-12-06,1호선,시청,28130,27374,55504
2022-12-06,1호선,신설동,14301,13752,28053
2022-12-06,1호선,제기동,16963,17339,34302
2022-12-06,1호선,종각,40828,39272,80100
2022-12-06,1호선,종로3가,25794,23310,49104
2022-12-06,1호선,종로5가,24145,23999,48144
2022-12-06,1호선,청량리,20094,19781,39875
2022-12-06,2호선,강남,82634,79125,161759
2022-12-06,2호선,강변,31020,28898,59918
2022-12-06,2호선,건대입구,35207,37441,72648
2022-12-06,2호선,교대,36632,42446,79078
2022-12-06,2호선,구로디지털단지,63176,62852,126028
2022-12-06,2호선,구의,25391,24954,50345
2022-12-06,2호선,낙성대,28602,28721,57323
2022-12-06,2호선,당산,19420,23001,42421
2022-12-06,2호선,대림,24810,25292,50102
2022-12-06,2호선,도림천,1426,1519,2945
2022-12-06,2호선,동대문역사문화공원,13293,14878,28171
2022-12-06,2호선,뚝섬,22667,24496,47163
2022-12-06,2호선,문래,23225,23611,46836
2022-12-06,2호선,방배,20856,21705,42561
2022-12-06,2호선,봉천,25563,24043,49606
2022-12-06,2호선,사당,41023,44414,85437
2022-12-06,2호선,삼성,57558,58466,116024
2022-12-06,2호선,상왕십리,15304,15060,30364
2022-12-06,2호선,서울대입구,49383,48107,97490
2022-12-06,2호선,서초,24620,23756,48376
2022-12-06,2호선,선릉,63495,56490,119985
2022-12-06,2호선,성수,40906,44168,85074
2022-12-06,2호선,시청,27741,26806,54547
2022-12-06,2호선,신답,1841,1974,3815
2022-12-06,2호선,신당,14670,15021,29691
2022-12-06,2호선,신대방,26149,25676,51825
2022-12-06,2호선,신도림,51370,50279,101649
2022-12-06,2호선,신림,59149,57020,116169
2022-12-06,2호선,신설동,3452,3467,6919
2022-12-06,2호선,신정네거리,11106,11658,22764
2022-12-06,2호선,신촌,38038,38210,76248
2022-12-06,2호선,아현,11251,10899,22150
2022-12-06,2호선,양천구청,7594,7867,15461
2022-12-06,2호선,역삼,60285,67978,128263
2022-12-06,2호선,영등포구청,23665,24093,47758
2022-12-06,2호선,왕십리,16927,14166,31093
2022-12-06,2호선,용답,3181,3424,6605
2022-12-06,2호선,용두,2537,2510,5047
2022-12-06,2호선,을지로3가,25708,25991,51699
2022-12-06,2호선,을지로4가,14887,14965,29852
2022-12-06,2호선,을지로입구,49415,51216,100631
2022-12-06,2호선,이대,17599,19297,36896
2022-12-06,2호선,잠실,78178,78341,156519
2022-12-06,2호선,잠실나루,15882,15734,31616
2022-12-06,2호선,잠실새내,23406,22979,46385
2022-12-06,2호선,종합운동장,8258,9278,17536
2022-12-06,2호선,충정로,11034,11845,22879
2022-12-06,2호선,한양대,15289,16370,31659
2022-12-06,2호선,합정,31372,32962,64334
2022-12-06,2호선,홍대입구,57865,59433,117298
2022-12-06,3호선,가락시장,9953,9786,19739
2022-12-06,3호선,경복궁,23932,23041,46973
2022-12-06,3호선,경찰병원,8177,8375,16552
2022-12-06,3호선,고속터미널,41932,39911,81843
2022-12-06,3호선,교대,16350,10661,27011
2022-12-06,3호선,구파발,22519,21595,44114
2022-12-06,3호선,금호,8448,7939,16387
2022-12-06,3호선,남부터미널,29946,30682,60628
2022-12-06,3호선,녹번,16948,15545,32493
2022-12-06,3호선,대청,11406,10696,22102
2022-12-06,3호선,대치,11755,11994,23749
2022-12-06,3호선,도곡,5663,5668,11331
2022-12-06,3호선,독립문,7720,7944,15664
2022-12-06,3호선,동대입구,12026,13363,25389
2022-12-06,3호선,매봉,14025,13355,27380
2022-12-06,3호선,무악재,4446,4431,8877
2022-12-06,3호선,불광,17000,18155,35155
2022-12-06,3호선,수서,18434,19032,37466
2022-12-06,3호선,신사,29728,30789,60517
2022-12-06,3호선,안국,25245,25994,51239
2022-12-06,3호선,압구정,35286,37939,73225
2022-12-06,3호선,약수,13854,13409,27263
2022-12-06,3호선,양재,41597,45049,86646
2022-12-06,3호선,연신내,36821,34924,71745
2022-12-06,3호선,오금,7059,6287,13346
2022-12-06,3호선,옥수,9221,9495,18716
2022-12-06,3호선,을지로3가,12016,12149,24165
2022-12-06,3호선,일원,11894,11504,23398
2022-12-06,3호선,잠원,5530,5145,10675
2022-12-06,3호선,종로3가,10617,11865,22482
2022-12-06,3호선,지축,6535,6462,12997
2022-12-06,3호선,충무로,2,0,2
2022-12-06,3호선,학여울,2058,2086,4144
2022-12-06,3호선,홍제,19109,18378,37487
2022-12-06,4호선,길음,23236,23637,46873
2022-12-06,4호선,남태령,1371,1199,2570
2022-12-06,4호선,노원,19227,21962,41189
2022-12-06,4호선,당고개,9546,8662,18208
2022-12-06,4호선,동대문,20594,20879,41473
2022-12-06,4호선,동대문역사문화공원,16652,14376,31028
2022-12-06,4호선,동작,1272,1432,2704
2022-12-06,4호선,명동,27102,27900,55002
2022-12-06,4호선,미아,15728,15664,31392
2022-12-06,4호선,미아사거리,27613,27420,55033
2022-12-06,4호선,사당,27905,23713,51618
2022-12-06,4호선,삼각지,6079,6829,12908
2022-12-06,4호선,상계,19960,18961,38921
2022-12-06,4호선,서울역,12878,18617,31495
2022-12-06,4호선,성신여대입구,21741,21012,42753
2022-12-06,4호선,수유,35292,35546,70838
2022-12-06,4호선,숙대입구,15778,15070,30848
2022-12-06,4호선,신용산,18378,18819,37197
2022-12-06,4호선,쌍문,29851,28476,58327
2022-12-06,4호선,이촌,9651,10529,20180
2022-12-06,4호선,창동,26476,28311,54787
2022-12-06,4호선,총신대입구,19621,21465,41086
2022-12-06,4호선,충무로,31655,31767,63422
2022-12-06,4호선,한성대입구,15144,14455,29599
2022-12-06,4호선,혜화,35884,35258,71142
2022-12-06,4호선,회현,27280,28237,55517
2022-12-06,5호선,강동,19876,19115,38991
2022-12-06,5호선,강일,5478,5197,10675
2022-12-06,5호선,개롱,7023,7436,14459
2022-12-06,5호선,개화산,6035,5803,11838
2022-12-06,5호선,거여,11072,10733,21805
2022-12-06,5호선,고덕,10710,10952,21662
2022-12-06,5호선,공덕,15916,16799,32715
2022-12-06,5호선,광나루,15607,14681,30288
2022-12-06,5호선,광화문,37851,36690,74541
2022-12-06,5호선,군자,12096,13208,25304
2022-12-06,5호선,굽은다리,9932,9488,19420
2022-12-06,5호선,길동,8296,8772,17068
2022-12-06,5호선,김포공항,7185,6892,14077
2022-12-06,5호선,까치산,30494,29303,59797
2022-12-06,5호선,답십리,17248,15737,32985
2022-12-06,5호선,동대문역사문화공원,3437,3937,7374
2022-12-06,5호선,둔촌동,8966,9138,18104
2022-12-06,5호선,마곡,11677,11718,23395
2022-12-06,5호선,마장,6572,6218,12790
2022-12-06,5호선,마천,7923,7476,15399
2022-12-06,5호선,마포,15883,16346,32229
2022-12-06,5호선,명일,9266,9650,18916
2022-12-06,5호선,목동,17918,19309,37227
2022-12-06,5호선,미사,17220,17475,34695
2022-12-06,5호선,발산,22796,23352,46148
2022-12-06,5호선,방이,7768,8021,15789
2022-12-06,5호선,방화,7150,6958,14108
2022-12-06,5호선,상일동,15863,15285,31148
2022-12-06,5호선,서대문,23095,23380,46475
2022-12-06,5호선,송정,6898,6485,13383
2022-12-06,5호선,신금호,6885,7284,14169
2022-12-06,5호선,신길,4596,4941,9537
2022-12-06,5호선,신정,14646,12138,26784
2022-12-06,5호선,아차산,15121,14619,29740
2022-12-06,5호선,애오개,7463,7374,14837
2022-12-06,5호선,양평,8126,7985,16111
2022-12-06,5호선,여의나루,10977,13171,24148
2022-12-06,5호선,여의도,32668,34192,66860
2022-12-06,5호선,영등포구청,4389,4557,8946
2022-12-06,5호선,영등포시장,11111,11337,22448
2022-12-06,5호선,오금,3998,4060,8058
2022-12-06,5호선,오목교,22604,24197,46801
2022-12-06,5호선,올림픽공원,4791,3967,8758
2022-12-06,5호선,왕십리,4678,5205,9883
2022-12-06,5호선,우장산,15180,15214,30394
2022-12-06,5호선,을지로4가,6988,6960,13948
2022-12-06,5호선,장한평,19911,19746,39657
2022-12-06,5호선,종로3가,13717,13104,26821
2022-12-06,5호선,천호,18853,18868,37721
2022-12-06,5호선,청구,4271,3822,8093
2022-12-06,5호선,충정로,5292,5412,10704
2022-12-06,5호선,하남검단산,6211,5961,12172
2022-12-06,5호선,하남시청,7549,7396,14945
2022-12-06,5호선,하남풍산,4590,4543,9133
2022-12-06,5호선,행당,8838,7945,16783
2022-12-06,5호선,화곡,30353,28571,58924
2022-12-06,6호선,고려대,9988,9506,19494
2022-12-06,6호선,공덕,20515,19767,40282
2022-12-06,6호선,광흥창,10089,9784,19873
2022-12-06,6호선,구산,8366,6311,14677
2022-12-06,6호선,녹사평,4694,4642,9336
2022-12-06,6호선,대흥,10078,10526,20604
2022-12-06,6호선,독바위,2893,3073,5966
2022-12-06,6호선,돌곶이,10393,9646,20039
2022-12-06,6호선,동묘앞,8082,8306,16388
2022-12-06,6호선,디지털미디어시티,15865,17546,33411
2022-12-06,6호선,마포구청,15551,14016,29567
2022-12-06,6호선,망원,13847,14770,28617
2022-12-06,6호선,버티고개,2365,2267,4632
2022-12-06,6호선,보문,8246,7535,15781
2022-12-06,6호선,봉화산,9767,9348,19115
2022-12-06,6호선,불광,4380,4360,8740
2022-12-06,6호선,삼각지,8061,7397,15458
2022-12-06,6호선,상수,10067,11031,21098
2022-12-06,6호선,상월곡,7236,6800,14036
2022-12-06,6호선,새절,13879,13009,26888
2022-12-06,6호선,석계,13843,14470,28313
2022-12-06,6호선,신당,9149,9466,18615
2022-12-06,6호선,안암,15089,15185,30274
2022-12-06,6호선,약수,3902,3850,7752
2022-12-06,6호선,역촌,3904,4649,8553
2022-12-06,6호선,연신내,1,0,1
2022-12-06,6호선,월곡,13858,13371,27229
2022-12-06,6호선,월드컵경기장,4128,4404,8532
2022-12-06,6호선,응암,18543,18591,37134
2022-12-06,6호선,이태원,9241,9287,18528
2022-12-06,6호선,증산,10463,10555,21018
2022-12-06,6호선,창신,4045,3567,7612
2022-12-06,6호선,청구,3938,4175,8113
2022-12-06,6호선,태릉입구,6017,6897,12914
2022-12-06,6호선,한강진,7748,8731,16479
2022-12-06,6호선,합정,13195,13180,26375
2022-12-06,6호선,화랑대,13695,10640,24335
2022-12-06,6호선,효창공원앞,8052,7711,15763
2022-12-06,7호선,가산디지털단지,49048,49146,98194
2022-12-06,7호선,강남구청,18242,20225,38467
2022-12-06,7호선,건대입구,14434,14621,29055
2022-12-06,7호선,고속터미널,16001,14258,30259
2022-12-06,7호선,공릉,12999,13013,26012
2022-12-06,7호선,광명사거리,22014,21655,43669
2022-12-06,7호선,군자,16071,12825,28896
2022-12-06,7호선,남구로,16695,17443,34138
2022-12-06,7호선,남성,12378,11511,23889
2022-12-06,7호선,내방,16244,16456,32700
2022-12-06,7호선,노원,20639,21202,41841
2022-12-06,7호선,논현,20147,20759,40906
2022-12-06,7호선,대림,8310,8380,16690
2022-12-06,7호선,도봉산,9834,11305,21139
2022-12-06,7호선,뚝섬유원지,7495,7344,14839
2022-12-06,7호선,마들,14001,13261,27262
2022-12-06,7호선,먹골,10620,10601,21221
2022-12-06,7호선,면목,17099,16754,33853
2022-12-06,7호선,반포,6599,6458,13057
2022-12-06,7호선,보라매,7791,8078,15869
2022-12-06,7호선,사가정,17055,17386,34441
2022-12-06,7호선,상도,13297,13076,26373
2022-12-06,7호선,상봉,17712,16847,34559
2022-12-06,7호선,수락산,13331,13335,26666
2022-12-06,7호선,숭실대입구,16534,16512,33046
2022-12-06,7호선,신대방삼거리,16071,15319,31390
2022-12-06,7호선,신풍,12245,11603,23848
2022-12-06,7호선,어린이대공원,18515,18745,37260
2022-12-06,7호선,온수,11691,10715,22406
2022-12-06,7호선,용마산,6261,6071,12332
2022-12-06,7호선,이수,16791,16025,32816
2022-12-06,7호선,장승배기,9868,9800,19668
2022-12-06,7호선,장암,2618,957,3575
2022-12-06,7호선,중계,15947,14588,30535
2022-12-06,7호선,중곡,11623,10830,22453
2022-12-06,7호선,중화,11456,11419,22875
2022-12-06,7호선,천왕,12581,11928,24509
2022-12-06,7호선,철산,22947,23620,46567
2022-12-06,7호선,청담,21798,24242,46040
2022-12-06,7호선,태릉입구,9834,9229,19063
2022-12-06,7호선,하계,19545,18529,38074
2022-12-06,7호선,학동,26391,27853,54244
2022-12-06,8호선,가락시장,8391,9239,17630
2022-12-06,8호선,강동구청,11531,11963,23494
2022-12-06,8호선,남위례,6515,6808,13323
2022-12-06,8호선,남한산성입구,15967,14956,30923
2022-12-06,8호선,단대오거리,11742,11372,23114
2022-12-06,8호선,모란,4604,3357,7961
2022-12-06,8호선,몽촌토성,6894,7006,13900
2022-12-06,8호선,문정,23395,24824,48219
2022-12-06,8호선,복정,10141,8600,18741
2022-12-06,8호선,산성,5590,5530,11120
2022-12-06,8호선,석촌,8300,9272,17572
2022-12-06,8호선,송파,9790,9448,19238
2022-12-06,8호선,수진,5598,5260,10858
2022-12-06,8호선,신흥,5126,5442,10568
2022-12-06,8호선,암사,20285,17991,38276
2022-12-06,8호선,잠실,15600,18628,34228
2022-12-06,8호선,장지,18987,17807,36794
2022-12-06,8호선,천호,15352,17535,32887
2022-12-06,9호선,가양,22975,22741,45716
2022-12-06,9호선,개화,2906,1894,4800
2022-12-06,9호선,고속터미널,13141,16800,29941
2022-12-06,9호선,공항시장,3130,3372,6502
2022-12-06,9호선,구반포,1200,1268,2468
2022-12-06,9호선,국회의사당,18938,19327,38265
2022-12-06,9호선,김포공항,6667,9802,16469
2022-12-06,9호선,노들,4931,4054,8985
2022-12-06,9호선,노량진,27932,27316,55248
2022-12-06,9호선,당산,20104,20271,40375
2022-12-06,9호선,동작,1708,1307,3015
2022-12-06,9호선,등촌,12587,12215,24802
2022-12-06,9호선,마곡나루,13607,13227,26834
2022-12-06,9호선,사평,4443,4185,8628
2022-12-06,9호선,샛강,6999,6934,13933
2022-12-06,9호선,선유도,9528,8976,18504
2022-12-06,9호선,신논현,30987,29946,60933
2022-12-06,9호선,신목동,4646,4053,8699
2022-12-06,9호선,신반포,3862,3834,7696
2022-12-06,9호선,신방화,7455,7209,14664
2022-12-06,9호선,양천향교,10613,10966,21579
2022-12-06,9호선,여의도,32063,30865,62928
2022-12-06,9호선,염창,18849,18450,37299
2022-12-06,9호선,증미,7722,7365,15087
2022-12-06,9호선,흑석,10251,10647,20898
2022-12-06,9호선2~3단계,둔촌오륜,1247,1148,2395
2022-12-06,9호선2~3단계,봉은사,18958,19252,38210
2022-12-06,9호선2~3단계,삼성중앙,8379,8890,17269
2022-12-06,9호선2~3단계,삼전,7612,7186,14798
2022-12-06,9호선2~3단계,석촌,9261,8541,17802
2022-12-06,9호선2~3단계,석촌고분,7063,6946,14009
2022-12-06,9호선2~3단계,선정릉,11028,12046,23074
2022-12-06,9호선2~3단계,송파나루,5331,5680,11011
2022-12-06,9호선2~3단계,언주,11959,12348,24307
2022-12-06,9호선2~3단계,올림픽공원,6754,6976,13730
2022-12-06,9호선2~3단계,종합운동장,4620,4690,9310
2022-12-06,9호선2~3단계,중앙보훈병원,12588,11114,23702
2022-12-06,9호선2~3단계,한성백제,3024,2754,5778
2022-12-06,경강선,경기광주,8916,8314,17230
2022-12-06,경강선,곤지암,2452,2289,4741
2022-12-06,경강선,부발,2280,2179,4459
2022-12-06,경강선,삼동,2861,2470,5331
2022-12-06,경강선,세종대왕릉,305,302,607
2022-12-06,경강선,신둔도예촌,1717,1577,3294
2022-12-06,경강선,여주,2290,2327,4617
2022-12-06,경강선,이매,1286,1087,2373
2022-12-06,경강선,이천,2909,2821,5730
2022-12-06,경강선,초월,3505,3346,6851
2022-12-06,경강선,판교,5921,5971,11892
2022-12-06,경부선,가산디지털단지,19127,22177,41304
2022-12-06,경부선,관악,7900,7456,15356
2022-12-06,경부선,광명,3431,2945,6376
2022-12-06,경부선,구로,19019,19338,38357
2022-12-06,경부선,군포,8108,7953,16061
2022-12-06,경부선,금정,29188,29912,59100
2022-12-06,경부선,금천구청,12255,12135,24390
2022-12-06,경부선,남영,10115,11167,21282
2022-12-06,경부선,노량진,8498,9045,17543
2022-12-06,경부선,당정,7535,7119,14654
2022-12-06,경부선,대방,12157,13556,25713
2022-12-06,경부선,독산,19704,20753,40457
2022-12-06,경부선,두정,7920,8812,16732
2022-12-06,경부선,명학,11079,10824,21903
2022-12-06,경부선,병점,16885,16879,33764
2022-12-06,경부선,서동탄,1471,1229,2700
2022-12-06,경부선,서울역,6993,2184,9177
2022-12-06,경부선,서정리,8613,7848,16461
2022-12-06,경부선,석수,10049,9220,19269
2022-12-06,경부선,성균관대,15738,15628,31366
2022-12-06,경부선,성환,6417,6179,12596
2022-12-06,경부선,세류,3344,3024,6368
2022-12-06,경부선,세마,3220,3071,6291
2022-12-06,경부선,송탄,4354,4389,8743
2022-12-06,경부선,수원,35436,37505,72941
2022-12-06,경부선,신길,9775,8088,17863
2022-12-06,경부선,신도림,4247,4331,8578
2022-12-06,경부선,안양,26310,26193,52503
2022-12-06,경부선,영등포,38863,39674,78537
2022-12-06,경부선,오산,10072,10230,20302
2022-12-06,경부선,오산대,3973,3637,7610
2022-12-06,경부선,용산,35173,35220,70393
2022-12-06,경부선,의왕,10010,9977,19987
2022-12-06,경부선,직산,932,943,1875
2022-12-06,경부선,진위,1994,1778,3772
2022-12-06,경부선,천안,7093,6426,13519
2022-12-06,경부선,평택,12561,12782,25343
2022-12-06,경부선,평택지제,4517,4387,8904
2022-12-06,경부선,화서,9246,8835,18081
2022-12-06,경원선,가능,6972,6746,13718
2022-12-06,경원선,광운대,9359,9048,18407
2022-12-06,경원선,녹양,4727,4570,9297
2022-12-06,경원선,녹천,4829,3995,8824
2022-12-06,경원선,덕계,3472,3140,6612
2022-12-06,경원선,덕정,6486,6317,12803
2022-12-06,경원선,도봉,6165,5978,12143
2022-12-06,경원선,도봉산,7410,4582,11992
2022-12-06,경원선,동두천,2270,2498,4768
2022-12-06,경원선,동두천중앙,3149,3049,6198
2022-12-06,경원선,망월사,9664,9782,19446
2022-12-06,경원선,방학,10171,10022,20193
2022-12-06,경원선,보산,1389,1325,2714
2022-12-06,경원선,서빙고,2165,1990,4155
2022-12-06,경원선,석계,8582,9653,18235
2022-12-06,경원선,소요산,2014,1648,3662
2022-12-06,경원선,신이문,8957,8295,17252
2022-12-06,경원선,양주,7817,7533,15350
2022-12-06,경원선,옥수,51,36,87
2022-12-06,경원선,왕십리,15929,16271,32200
2022-12-06,경원선,외대앞,10140,10193,20333
2022-12-06,경원선,월계,8426,7889,16315
2022-12-06,경원선,응봉,2006,1690,3696
2022-12-06,경원선,의정부,18447,18698,37145
2022-12-06,경원선,이촌,4220,3298,7518
2022-12-06,경원선,지행,6670,6674,13344
2022-12-06,경원선,청량리,14901,15748,30649
2022-12-06,경원선,한남,4246,4034,8280
2022-12-06,경원선,회룡,13143,13083,26226
2022-12-06,경의선,가좌,6190,5904,12094
2022-12-06,경의선,강매,3518,3038,6556
2022-12-06,경의선,곡산,603,620,1223
2022-12-06,경의선,공덕,4187,3505,7692
2022-12-06,경의선,금릉,5236,5049,10285
2022-12-06,경의선,금촌,6959,6803,13762
2022-12-06,경의선,능곡,4014,3672,7686
2022-12-06,경의선,디지털미디어시티,2832,2631,5463
2022-12-06,경의선,문산,4998,4998,9996
2022-12-06,경의선,백마,7301,7132,14433
2022-12-06,경의선,서강대,2346,2377,4723
2022-12-06,경의선,서울역,4737,5938,10675
2022-12-06,경의선,수색,2889,3029,5918
2022-12-06,경의선,신촌,999,1310,2309
2022-12-06,경의선,야당,8181,8156,16337
2022-12-06,경의선,운정,7369,6861,14230
2022-12-06,경의선,월롱,2820,2561,5381
2022-12-06,경의선,일산,9769,9718,19487
2022-12-06,경의선,임진강,14,1,15
2022-12-06,경의선,탄현,8435,8094,16529
2022-12-06,경의선,파주,1518,1126,2644
2022-12-06,경의선,풍산,5916,5640,11556
2022-12-06,경의선,행신,8488,8593,17081
2022-12-06,경의선,홍대입구,1791,2005,3796
2022-12-06,경의선,화전,2616,2388,5004
2022-12-06,경의선,효창공원앞,3575,3932,7507
2022-12-06,경인선,간석,6269,5848,12117
2022-12-06,경인선,개봉,23033,22760,45793
2022-12-06,경인선,구일,7354,7275,14629
2022-12-06,경인선,도원,3466,3307,6773
2022-12-06,경인선,도화,4210,3927,8137
2022-12-06,경인선,동암,16441,16667,33108
2022-12-06,경인선,동인천,14172,13451,27623
2022-12-06,경인선,백운,7008,6925,13933
2022-12-06,경인선,부개,8847,8331,17178
2022-12-06,경인선,부천,32406,32359,64765
2022-12-06,경인선,부평,28081,29669,57750
2022-12-06,경인선,소사,8762,9005,17767
2022-12-06,경인선,송내,28687,28840,57527
2022-12-06,경인선,역곡,29228,29346,58574
2022-12-06,경인선,오류동,12007,11417,23424
2022-12-06,경인선,온수,7289,6842,14131
2022-12-06,경인선,인천,3434,2550,5984
2022-12-06,경인선,제물포,11526,11089,22615
2022-12-06,경인선,주안,19628,17805,37433
2022-12-06,경인선,중동,9948,9354,19302
2022-12-06,경춘선,가평,1434,1386,2820
2022-12-06,경춘선,갈매,3152,2760,5912
2022-12-06,경춘선,강촌,438,401,839
2022-12-06,경춘선,굴봉산,95,101,196
2022-12-06,경춘선,금곡,1552,1522,3074
2022-12-06,경춘선,김유정,310,280,590
2022-12-06,경춘선,남춘천,2284,2429,4713
2022-12-06,경춘선,대성리,508,413,921
2022-12-06,경춘선,마석,4057,3934,7991
2022-12-06,경춘선,백양리,104,106,210
2022-12-06,경춘선,별내,3334,3072,6406
2022-12-06,경춘선,사릉,2484,2442,4926
2022-12-06,경춘선,상천,201,183,384
2022-12-06,경춘선,신내,2392,2266,4658
2022-12-06,경춘선,천마산,1697,1574,3271
2022-12-06,경춘선,청평,1495,1349,2844
2022-12-06,경춘선,춘천,1496,1387,2883
2022-12-06,경춘선,퇴계원,3698,3469,7167
2022-12-06,경춘선,평내호평,6510,6449,12959
2022-12-06,공항철도,검암,6811,6805,13616
2022-12-06,공항철도,계양,12901,12084,24985
2022-12-06,공항철도,공덕,2688,3576,6264
2022-12-06,공항철도,공항화물청사,2410,2487,4897
2022-12-06,공항철도,김포공항,10475,6448,16923
2022-12-06,공항철도,디지털미디어시티,15558,14548,30106
2022-12-06,공항철도,마곡나루,10908,10548,21456
2022-12-06,공항철도,서울역,9764,8636,18400
2022-12-06,공항철도,영종,3561,3629,7190
2022-12-06,공항철도,운서,8311,8493,16804
2022-12-06,공항철도,인천공항1터미널,9906,8958,18864
2022-12-06,공항철도,인천공항2터미널,3905,3609,7514
2022-12-06,공항철도,청라국제도시,7438,7151,14589
2022-12-06,공항철도,홍대입구,10823,10678,21501
2022-12-06,과천선,경마공원,1458,1419,2877
2022-12-06,과천선,과천,7032,6714,13746
2022-12-06,과천선,대공원,2666,2742,5408
2022-12-06,과천선,범계,27510,27919,55429
2022-12-06,과천선,선바위,8772,7871,16643
2022-12-06,과천선,인덕원,25978,27152,53130
2022-12-06,과천선,정부과천청사,11613,11681,23294
2022-12-06,과천선,평촌,19564,19347,38911
2022-12-06,분당선,가천대,11797,12643,24440
2022-12-06,분당선,강남구청,10530,12164,22694
2022-12-06,분당선,개포동,4327,4433,8760
2022-12-06,분당선,구룡,2694,2536,5230
2022-12-06,분당선,구성,5894,6046,11940
2022-12-06,분당선,기흥,12602,11666,24268
2022-12-06,분당선,대모산입구,5380,4988,10368
2022-12-06,분당선,도곡,8163,8043,16206
2022-12-06,분당선,망포,16841,16172,33013
2022-12-06,분당선,매교,4984,4918,9902
2022-12-06,분당선,매탄권선,6001,5772,11773
2022-12-06,분당선,모란,20522,20747,41269
2022-12-06,분당선,미금,16540,18136,34676
2022-12-06,분당선,보정,3379,2694,6073
2022-12-06,분당선,복정,1,0,1
2022-12-06,분당선,상갈,6250,5951,12201
2022-12-06,분당선,서울숲,11316,11724,23040
2022-12-06,분당선,서현,25981,26343,52324
2022-12-06,분당선,선릉,15422,23201,38623
2022-12-06,분당선,선정릉,8737,9261,17998
2022-12-06,분당선,수내,15568,15668,31236
2022-12-06,분당선,수서,14909,15468,30377
2022-12-06,분당선,수원,8590,7285,15875
2022-12-06,분당선,수원시청,13668,14523,28191
2022-12-06,분당선,신갈,5522,5251,10773
2022-12-06,분당선,압구정로데오,19334,21227,40561
2022-12-06,분당선,야탑,27828,29364,57192
2022-12-06,분당선,영통,9632,9666,19298
2022-12-06,분당선,오리,12754,10409,23163
2022-12-06,분당선,이매,6107,5749,11856
2022-12-06,분당선,정자,20406,21497,41903
2022-12-06,분당선,죽전,15602,17274,32876
2022-12-06,분당선,청명,5072,4791,9863
2022-12-06,분당선,태평,14013,13540,27553
2022-12-06,분당선,한티,16115,17157,33272
2022-12-06,수인선,고색,5425,4975,10400
2022-12-06,수인선,남동인더스파크,2412,2705,5117
2022-12-06,수인선,달월,103,71,174
2022-12-06,수인선,사리,5478,4709,10187
2022-12-06,수인선,소래포구,5152,4635,9787
2022-12-06,수인선,송도,2647,2415,5062
2022-12-06,수인선,숭의,4168,3982,8150
2022-12-06,수인선,신포,1876,1927,3803
2022-12-06,수인선,야목,404,290,694
2022-12-06,수인선,어천,1046,970,2016
2022-12-06,수인선,연수,4930,4804,9734
2022-12-06,수인선,오목천,4555,4172,8727
2022-12-06,수인선,원인재,4533,4617,9150
2022-12-06,수인선,월곶,2929,2678,5607
2022-12-06,수인선,인천,916,1566,2482
2022-12-06,수인선,인천논현,5838,6278,12116
2022-12-06,수인선,인하대,7524,7321,14845
2022-12-06,수인선,호구포,4365,4482,8847
2022-12-06,신림선,관악산,2386,2478,4864
2022-12-06,신림선,당곡,4453,4309,8762
2022-12-06,신림선,대방,2775,2101,4876
2022-12-06,신림선,보라매,3547,3382,6929
2022-12-06,신림선,보라매공원,1941,2123,4064
2022-12-06,신림선,보라매병원,7811,8312,16123
2022-12-06,신림선,샛강,2768,3432,6200
2022-12-06,신림선,서울대벤처타운,7931,7730,15661
2022-12-06,신림선,서울지방병무청,2769,2998,5767
2022-12-06,신림선,서원,3434,2884,6318
2022-12-06,신림선,신림,1755,2334,4089
2022-12-06,안산선,고잔,9824,9291,19115
2022-12-06,안산선,대야미,5057,4612,9669
2022-12-06,안산선,반월,4464,4389,8853
2022-12-06,안산선,산본,16748,18076,34824
2022-12-06,안산선,상록수,16610,16971,33581
2022-12-06,안산선,수리산,4383,3594,7977
2022-12-06,안산선,신길온천,1974,1814,3788
2022-12-06,안산선,안산,12223,10915,23138
2022-12-06,안산선,오이도,8646,8373,17019
2022-12-06,안산선,정왕,10520,10944,21464
2022-12-06,안산선,중앙,18727,19540,38267
2022-12-06,안산선,초지,5690,6008,11698
2022-12-06,안산선,한대앞,10778,10872,21650
2022-12-06,우이신설선,4.19민주묘지,4285,4301,8586
2022-12-06,우이신설선,가오리,4408,4334,8742
2022-12-06,우이신설선,보문,1675,1594,3269
2022-12-06,우이신설선,북한산보국문,6533,6315,12848
2022-12-06,우이신설선,북한산우이,2712,2396,5108
2022-12-06,우이신설선,삼양,2135,2255,4390
2022-12-06,우이신설선,삼양사거리,2626,2650,5276
2022-12-06,우이신설선,성신여대입구,3536,3890,7426
2022-12-06,우이신설선,솔밭공원,2635,2503,5138
2022-12-06,우이신설선,솔샘,6377,6077,12454
2022-12-06,우이신설선,신설동,2501,2311,4812
2022-12-06,우이신설선,정릉,5123,4924,10047
2022-12-06,우이신설선,화계,3651,3421,7072
2022-12-06,일산선,대곡,2244,1723,3967
2022-12-06,일산선,대화,14128,10960,25088
2022-12-06,일산선,마두,8015,8198,16213
2022-12-06,일산선,백석,10293,10338,20631
2022-12-06,일산선,삼송,20522,20053,40575
2022-12-06,일산선,원당,11616,11079,22695
2022-12-06,일산선,원흥,12146,11666,23812
2022-12-06,일산선,정발산,7107,7165,14272
2022-12-06,일산선,주엽,9633,9789,19422
2022-12-06,일산선,화정,17443,17856,35299
2022-12-06,장항선,배방,1190,1144,2334
2022-12-06,장항선,봉명,1533,1426,2959
2022-12-06,장항선,신창,2604,2444,5048
2022-12-06,장항선,쌍용,3258,3053,6311
2022-12-06,장항선,아산,4145,3488,7633
2022-12-06,장항선,온양온천,3989,4136,8125
2022-12-06,장항선,탕정,1244,1080,2324
2022-12-06,중앙선,구리,13829,14222,28051
2022-12-06,중앙선,국수,720,712,1432
2022-12-06,중앙선,덕소,5658,5603,11261
2022-12-06,중앙선,도농,12130,11061,23191
2022-12-06,중앙선,도심,2557,2082,4639
2022-12-06,중앙선,망우,7723,7488,15211
2022-12-06,중앙선,상봉,5875,5920,11795
2022-12-06,중앙선,신원,166,151,317
2022-12-06,중앙선,아신,513,537,1050
2022-12-06,중앙선,양수,1795,1782,3577
2022-12-06,중앙선,양원,3117,3061,6178
2022-12-06,중앙선,양정,666,539,1205
2022-12-06,중앙선,양평,2716,2777,5493
2022-12-06,중앙선,오빈,292,289,581
2022-12-06,중앙선,용문,1576,1629,3205
2022-12-06,중앙선,운길산,546,532,1078
2022-12-06,중앙선,원덕,355,305,660
2022-12-06,중앙선,중랑,5709,5542,11251
2022-12-06,중앙선,지평,47,52,99
2022-12-06,중앙선,팔당,733,738,1471
2022-12-06,중앙선,회기,28695,27795,56490
2022-12-07,1호선,동대문,11687,11171,22858
2022-12-07,1호선,동묘앞,8541,8940,17481
2022-12-07,1호선,서울역,51041,49129,100170
2022-12-07,1호선,시청,27903,28176,56079
2022-12-07,1호선,신설동,15076,14460,29536
2022-12-07,1호선,제기동,18210,18404,36614
2022-12-07,1호선,종각,42116,41006,83122
2022-12-07,1호선,종로3가,27259,24711,51970
2022-12-07,1호선,종로5가,25166,24949,50115
2022-12-07,1호선,청량리,20851,20632,41483
2022-12-07,2호선,강남,83619,80040,163659
2022-12-07,2호선,강변,31177,28727,59904
2022-12-07,2호선,건대입구,35776,38340,74116
2022-12-07,2호선,교대,37858,43381,81239
2022-12-07,2호선,구로디지털단지,64509,64379,128888
2022-12-07,2호선,구의,25855,25344,51199
2022-12-07,2호선,낙성대,29715,29085,58800
2022-12-07,2호선,당산,20329,23933,44262
2022-12-07,2호선,대림,25514,25852,51366
2022-12-07,2호선,도림천,1507,1604,3111
2022-12-07,2호선,동대문역사문화공원,13922,15817,29739
2022-12-07,2호선,뚝섬,23067,25162,48229
2022-12-07,2호선,문래,23904,24221,48125
2022-12-07,2호선,방배,21166,21905,43071
2022-12-07,2호선,봉천,26016,24097,50113
2022-12-07,2호선,사당,42339,46495,88834
2022-12-07,2호선,삼성,61448,62286,123734
2022-12-07,2호선,상왕십리,15774,15447,31221
2022-12-07,2호선,서울대입구,49725,48667,98392
2022-12-07,2호선,서초,25643,25175,50818
2022-12-07,2호선,선릉,64374,57190,121564
2022-12-07,2호선,성수,41771,45262,87033
2022-12-07,2호선,시청,27861,27172,55033
2022-12-07,2호선,신답,1896,2038,3934
2022-12-07,2호선,신당,15269,15790,31059
2022-12-07,2호선,신대방,26870,26084,52954
2022-12-07,2호선,신도림,52508,51600,104108
2022-12-07,2호선,신림,60825,58605,119430
2022-12-07,2호선,신설동,3786,3705,7491
2022-12-07,2호선,신정네거리,11267,11673,22940
2022-12-07,2호선,신촌,38242,38895,77137
2022-12-07,2호선,아현,11326,10735,22061
2022-12-07,2호선,양천구청,7640,7961,15601
2022-12-07,2호선,역삼,59125,67377,126502
2022-12-07,2호선,영등포구청,24194,24873,49067
2022-12-07,2호선,왕십리,17365,14781,32146
2022-12-07,2호선,용답,3151,3361,6512
2022-12-07,2호선,용두,2592,2648,5240
2022-12-07,2호선,을지로3가,26529,26717,53246
2022-12-07,2호선,을지로4가,15297,15223,30520
2022-12-07,2호선,을지로입구,50784,52386,103170
2022-12-07,2호선,이대,17549,18868,36417
2022-12-07,2호선,잠실,78937,79428,158365
2022-12-07,2호선,잠실나루,16444,16175,32619
2022-12-07,2호선,잠실새내,23576,23173,46749
2022-12-07,2호선,종합운동장,8602,9460,18062
2022-12-07,2호선,충정로,11305,11911,23216
2022-12-07,2호선,한양대,14777,16173,30950
2022-12-07,2호선,합정,32265,34517,66782
2022-12-07,2호선,홍대입구,60478,63347,123825
2022-12-07,3호선,가락시장,10079,9982,20061
2022-12-07,3호선,경복궁,25439,25517,50956
2022-12-07,3호선,경찰병원,8289,8256,16545
2022-12-07,3호선,고속터미널,43104,40476,83580
2022-12-07,3호선,교대,16917,11027,27944
2022-12-07,3호선,구파발,23071,22025,45096
2022-12-07,3호선,금호,8760,8137,16897
2022-12-07,3호선,남부터미널,30643,31299,61942
2022-12-07,3호선,녹번,17254,15492,32746
2022-12-07,3호선,대청,11714,11119,22833
2022-12-07,3호선,대치,11682,11951,23633
2022-12-07,3호선,도곡,5887,6032,11919
2022-12-07,3호선,독립문,7868,8183,16051
2022-12-07,3호선,동대입구,11402,12642,24044
2022-12-07,3호선,매봉,13970,13392,27362
2022-12-07,3호선,무악재,4513,4558,9071
2022-12-07,3호선,불광,17458,18667,36125
2022-12-07,3호선,수서,18897,19120,38017
2022-12-07,3호선,신사,30021,31150,61171
2022-12-07,3호선,안국,27071,28080,55151
2022-12-07,3호선,압구정,34991,37862,72853
2022-12-07,3호선,약수,14469,13930,28399
2022-12-07,3호선,양재,42561,46189,88750
2022-12-07,3호선,연신내,38111,36065,74176
2022-12-07,3호선,오금,6898,6221,13119
2022-12-07,3호선,옥수,9624,9779,19403
2022-12-07,3호선,을지로3가,12315,12262,24577
2022-12-07,3호선,일원,12003,11594,23597
2022-12-07,3호선,잠원,5345,5063,10408
2022-12-07,3호선,종로3가,10652,12380,23032
2022-12-07,3호선,지축,6667,6494,13161
2022-12-07,3호선,충무로,2,0,2
2022-12-07,3호선,학여울,2149,2190,4339
2022-12-07,3호선,홍제,19725,18854,38579
2022-12-07,4호선,길음,23770,23913,47683
2022-12-07,4호선,남태령,1396,1243,2639
2022-12-07,4호선,노원,19853,22769,42622
2022-12-07,4호선,당고개,9779,8856,18635
2022-12-07,4호선,동대문,20996,21595,42591
2022-12-07,4호선,동대문역사문화공원,17286,15296,32582
2022-12-07,4호선,동작,1473,1556,3029
2022-12-07,4호선,명동,28362,29677,58039
2022-12-07,4호선,미아,16396,16126,32522
2022-12-07,4호선,미아사거리,28557,28251,56808
2022-12-07,4호선,사당,28968,24669,53637
2022-12-07,4호선,삼각지,6254,7380,13634
2022-12-07,4호선,상계,20639,19384,40023
2022-12-07,4호선,서울역,13068,19066,32134
2022-12-07,4호선,성신여대입구,22578,21709,44287
2022-12-07,4호선,수유,35831,36345,72176
2022-12-07,4호선,숙대입구,15884,15119,31003
2022-12-07,4호선,신용산,19262,19842,39104
2022-12-07,4호선,쌍문,31094,29317,60411
2022-12-07,4호선,이촌,10023,10930,20953
2022-12-07,4호선,창동,27729,29216,56945
2022-12-07,4호선,총신대입구,20572,22171,42743
2022-12-07,4호선,충무로,31645,32341,63986
2022-12-07,4호선,한성대입구,15525,14714,30239
2022-12-07,4호선,혜화,38292,37669,75961
2022-12-07,4호선,회현,28588,29804,58392
2022-12-07,5호선,강동,20169,19295,39464
2022-12-07,5호선,강일,5776,5334,11110
2022-12-07,5호선,개롱,7138,7502,14640
2022-12-07,5호선,개화산,6172,5816,11988
2022-12-07,5호선,거여,11560,10968,22528
2022-12-07,5호선,고덕,11107,11137,22244
2022-12-07,5호선,공덕,16107,17070,33177
2022-12-07,5호선,광나루,14814,13601,28415
2022-12-07,5호선,광화문,35766,37678,73444
2022-12-07,5호선,군자,12422,13405,25827
2022-12-07,5호선,굽은다리,10454,10086,20540
2022-12-07,5호선,길동,8450,8815,17265
2022-12-07,5호선,김포공항,7248,7103,14351
2022-12-07,5호선,까치산,31049,29869,60918
2022-12-07,5호선,답십리,17647,15968,33615
2022-12-07,5호선,동대문역사문화공원,3367,4029,7396
2022-12-07,5호선,둔촌동,9130,9216,18346
2022-12-07,5호선,마곡,11802,11899,23701
2022-12-07,5호선,마장,6667,6258,12925
2022-12-07,5호선,마천,8226,7814,16040
2022-12-07,5호선,마포,16319,16873,33192
2022-12-07,5호선,명일,9585,10041,19626
2022-12-07,5호선,목동,18030,19613,37643
2022-12-07,5호선,미사,17919,18063,35982
2022-12-07,5호선,발산,22918,23499,46417
2022-12-07,5호선,방이,7878,8253,16131
2022-12-07,5호선,방화,7425,7125,14550
2022-12-07,5호선,상일동,16706,15542,32248
2022-12-07,5호선,서대문,23750,24060,47810
2022-12-07,5호선,송정,7145,6542,13687
2022-12-07,5호선,신금호,7104,7479,14583
2022-12-07,5호선,신길,4535,4918,9453
2022-12-07,5호선,신정,15095,12168,27263
2022-12-07,5호선,아차산,15402,14642,30044
2022-12-07,5호선,애오개,7525,7547,15072
2022-12-07,5호선,양평,8198,7993,16191
2022-12-07,5호선,여의나루,11615,14052,25667
2022-12-07,5호선,여의도,33184,34631,67815
2022-12-07,5호선,영등포구청,4515,4580,9095
2022-12-07,5호선,영등포시장,11165,11571,22736
2022-12-07,5호선,오금,4066,4121,8187
2022-12-07,5호선,오목교,23369,24699,48068
2022-12-07,5호선,올림픽공원,4936,4182,9118
2022-12-07,5호선,왕십리,4968,5607,10575
2022-12-07,5호선,우장산,16030,15957,31987
2022-12-07,5호선,을지로4가,7154,7161,14315
2022-12-07,5호선,장한평,20740,20524,41264
2022-12-07,5호선,종로3가,14329,14064,28393
2022-12-07,5호선,천호,19256,19178,38434
2022-12-07,5호선,청구,4390,4012,8402
2022-12-07,5호선,충정로,5236,5455,10691
2022-12-07,5호선,하남검단산,6640,6345,12985
2022-12-07,5호선,하남시청,7917,7592,15509
2022-12-07,5호선,하남풍산,4609,4544,9153
2022-12-07,5호선,행당,9229,8024,17253
2022-12-07,5호선,화곡,31091,29012,60103
2022-12-07,6호선,고려대,10219,9988,20207
2022-12-07,6호선,공덕,20810,20376,41186
2022-12-07,6호선,광흥창,10326,10055,20381
2022-12-07,6호선,구산,8638,6364,15002
2022-12-07,6호선,녹사평,4972,4779,9751
2022-12-07,6호선,대흥,10586,11069,21655
2022-12-07,6호선,독바위,3005,3088,6093
2022-12-07,6호선,돌곶이,10659,9916,20575
2022-12-07,6호선,동묘앞,8432,8658,17090
2022-12-07,6호선,디지털미디어시티,16260,17982,34242
2022-12-07,6호선,마포구청,15819,14218,30037
2022-12-07,6호선,망원,14727,15619,30346
2022-12-07,6호선,버티고개,2391,2378,4769
2022-12-07,6호선,보문,8502,7718,16220
2022-12-07,6호선,봉화산,10056,9415,19471
2022-12-07,6호선,불광,4682,4613,9295
2022-12-07,6호선,삼각지,8785,7820,16605
2022-12-07,6호선,상수,10077,11494,21571
2022-12-07,6호선,상월곡,7194,6930,14124
2022-12-07,6호선,새절,14190,13260,27450
2022-12-07,6호선,석계,13778,14446,28224
2022-12-07,6호선,신내,1,0,1
2022-12-07,6호선,신당,9854,10162,20016
2022-12-07,6호선,안암,14773,15089,29862
2022-12-07,6호선,약수,3961,3970,7931
2022-12-07,6호선,역촌,4066,4764,8830
2022-12-07,6호선,연신내,1,0,1
2022-12-07,6호선,월곡,14273,13754,28027
2022-12-07,6호선,월드컵경기장,4405,4757,9162
2022-12-07,6호선,응암,19291,19023,38314
2022-12-07,6호선,이태원,9393,9648,19041
2022-12-07,6호선,증산,10926,10875,21801
2022-12-07,6호선,창신,4132,3680,7812
2022-12-07,6호선,청구,4129,4240,8369
2022-12-07,6호선,태릉입구,6324,7143,13467
2022-12-07,6호선,한강진,8097,9251,17348
2022-12-07,6호선,합정,13644,13619,27263
2022-12-07,6호선,화랑대,14076,10722,24798
2022-12-07,6호선,효창공원앞,8189,7856,16045
2022-12-07,7호선,가산디지털단지,49195,49381,98576
2022-12-07,7호선,강남구청,18429,20571,39000
2022-12-07,7호선,건대입구,14094,14606,28700
2022-12-07,7호선,고속터미널,16195,14259,30454
2022-12-07,7호선,공릉,13085,13119,26204
2022-12-07,7호선,광명사거리,22930,22555,45485
2022-12-07,7호선,군자,16324,13128,29452
2022-12-07,7호선,남구로,16645,17576,34221
2022-12-07,7호선,남성,12460,11585,24045
2022-12-07,7호선,내방,16375,16768,33143
2022-12-07,7호선,노원,21159,22395,43554
2022-12-07,7호선,논현,20438,21000,41438
2022-12-07,7호선,대림,8341,8476,16817
2022-12-07,7호선,도봉산,10044,11400,21444
2022-12-07,7호선,뚝섬유원지,8056,7663,15719
2022-12-07,7호선,마들,14392,13570,27962
2022-12-07,7호선,먹골,10977,10838,21815
2022-12-07,7호선,면목,17180,16717,33897
2022-12-07,7호선,반포,6662,6644,13306
2022-12-07,7호선,보라매,8164,8487,16651
2022-12-07,7호선,사가정,17519,17568,35087
2022-12-07,7호선,상도,13532,13133,26665
2022-12-07,7호선,상봉,18063,17207,35270
2022-12-07,7호선,수락산,13761,13638,27399
2022-12-07,7호선,숭실대입구,16787,16927,33714
2022-12-07,7호선,신대방삼거리,16451,15597,32048
2022-12-07,7호선,신풍,12379,11707,24086
2022-12-07,7호선,어린이대공원,18413,19152,37565
2022-12-07,7호선,온수,12088,11072,23160
2022-12-07,7호선,용마산,6507,6232,12739
2022-12-07,7호선,이수,17460,16537,33997
2022-12-07,7호선,장승배기,9866,9782,19648
2022-12-07,7호선,장암,2732,984,3716
2022-12-07,7호선,중계,16506,14937,31443
2022-12-07,7호선,중곡,11839,10764,22603
2022-12-07,7호선,중화,11886,11631,23517
2022-12-07,7호선,천왕,12686,12121,24807
2022-12-07,7호선,철산,23591,24100,47691
2022-12-07,7호선,청담,21810,24586,46396
2022-12-07,7호선,태릉입구,10272,9598,19870
2022-12-07,7호선,하계,20376,19178,39554
2022-12-07,7호선,학동,26779,28604,55383
2022-12-07,8호선,가락시장,8645,9431,18076
2022-12-07,8호선,강동구청,11665,12009,23674
2022-12-07,8호선,남위례,6805,6964,13769
2022-12-07,8호선,남한산성입구,16194,14664,30858
2022-12-07,8호선,단대오거리,12159,11782,23941
2022-12-07,8호선,모란,4717,3431,8148
2022-12-07,8호선,몽촌토성,7101,7285,14386
2022-12-07,8호선,문정,23500,24527,48027
2022-12-07,8호선,복정,10552,8712,19264
2022-12-07,8호선,산성,5776,5830,11606
2022-12-07,8호선,석촌,8249,9618,17867
2022-12-07,8호선,송파,9645,9439,19084
2022-12-07,8호선,수진,5661,5189,10850
2022-12-07,8호선,신흥,5376,5698,11074
2022-12-07,8호선,암사,20935,18340,39275
2022-12-07,8호선,잠실,16153,18926,35079
2022-12-07,8호선,장지,19199,18097,37296
2022-12-07,8호선,천호,15503,18080,33583
2022-12-07,9호선,가양,23397,23052,46449
2022-12-07,9호선,개화,2901,1852,4753
2022-12-07,9호선,고속터미널,13559,17172,30731
2022-12-07,9호선,공항시장,3221,3514,6735
2022-12-07,9호선,구반포,1346,1429,2775
2022-12-07,9호선,국회의사당,19534,19844,39378
2022-12-07,9호선,김포공항,6491,10290,16781
2022-12-07,9호선,노들,5039,4173,9212
2022-12-07,9호선,노량진,28566,27904,56470
2022-12-07,9호선,당산,20816,20887,41703
2022-12-07,9호선,동작,1786,1420,3206
2022-12-07,9호선,등촌,12973,12246,25219
2022-12-07,9호선,마곡나루,13913,13525,27438
2022-12-07,9호선,사평,4316,4129,8445
2022-12-07,9호선,샛강,7120,7124,14244
2022-12-07,9호선,선유도,9711,9076,18787
2022-12-07,9호선,신논현,31695,30852,62547
2022-12-07,9호선,신목동,4785,4099,8884
2022-12-07,9호선,신반포,4020,4033,8053
2022-12-07,9호선,신방화,7449,7335,14784
2022-12-07,9호선,양천향교,10704,11125,21829
2022-12-07,9호선,여의도,33376,31844,65220
2022-12-07,9호선,염창,19400,18904,38304
2022-12-07,9호선,증미,7799,7356,15155
2022-12-07,9호선,흑석,10432,10771,21203
2022-12-07,9호선2~3단계,둔촌오륜,1257,1161,2418
2022-12-07,9호선2~3단계,봉은사,21055,21862,42917
2022-12-07,9호선2~3단계,삼성중앙,8376,8763,17139
2022-12-07,9호선2~3단계,삼전,7796,7383,15179
2022-12-07,9호선2~3단계,석촌,9502,8558,18060
2022-12-07,9호선2~3단계,석촌고분,7265,7054,14319
2022-12-07,9호선2~3단계,선정릉,10920,12043,22963
2022-12-07,9호선2~3단계,송파나루,5527,5955,11482
2022-12-07,9호선2~3단계,언주,11984,12458,24442
2022-12-07,9호선2~3단계,올림픽공원,7144,7166,14310
2022-12-07,9호선2~3단계,종합운동장,4722,4805,9527
2022-12-07,9호선2~3단계,중앙보훈병원,12839,11311,24150
2022-12-07,9호선2~3단계,한성백제,3086,2740,5826
2022-12-07,경강선,경기광주,8906,8251,17157
2022-12-07,경강선,곤지암,2571,2394,4965
2022-12-07,경강선,부발,2244,2141,4385
2022-12-07,경강선,삼동,2762,2508,5270
2022-12-07,경강선,세종대왕릉,353,353,706
2022-12-07,경강선,신둔도예촌,1736,1588,3324
2022-12-07,경강선,여주,2457,2433,4890
2022-12-07,경강선,이매,1263,1116,2379
2022-12-07,경강선,이천,2820,2937,5757
2022-12-07,경강선,초월,3581,3366,6947
2022-12-07,경강선,판교,6055,6101,12156
2022-12-07,경부선,가산디지털단지,19467,22583,42050
2022-12-07,경부선,관악,8197,7775,15972
2022-12-07,경부선,광명,3550,2911,6461
2022-12-07,경부선,구로,19528,19854,39382
2022-12-07,경부선,군포,8436,8102,16538
2022-12-07,경부선,금정,29967,30372,60339
2022-12-07,경부선,금천구청,12591,12601,25192
2022-12-07,경부선,남영,10384,11224,21608
2022-12-07,경부선,노량진,9313,9653,18966
2022-12-07,경부선,당정,7333,7029,14362
2022-12-07,경부선,대방,12346,13467,25813
2022-12-07,경부선,독산,19844,20698,40542
2022-12-07,경부선,두정,8081,8839,16920
2022-12-07,경부선,명학,11112,10877,21989
2022-12-07,경부선,병점,17158,17111,34269
2022-12-07,경부선,서동탄,1475,1258,2733
2022-12-07,경부선,서울역,7426,2147,9573
2022-12-07,경부선,서정리,8785,8291,17076
2022-12-07,경부선,석수,10419,9435,19854
2022-12-07,경부선,성균관대,16212,15914,32126
2022-12-07,경부선,성환,6757,6431,13188
2022-12-07,경부선,세류,3342,2941,6283
2022-12-07,경부선,세마,3195,3036,6231
2022-12-07,경부선,송탄,4492,4388,8880
2022-12-07,경부선,수원,35949,38024,73973
2022-12-07,경부선,신길,9781,8444,18225
2022-12-07,경부선,신도림,4436,4605,9041
2022-12-07,경부선,안양,27140,27170,54310
2022-12-07,경부선,영등포,39824,41018,80842
2022-12-07,경부선,오산,10421,10653,21074
2022-12-07,경부선,오산대,3936,3794,7730
2022-12-07,경부선,용산,36556,37042,73598
2022-12-07,경부선,의왕,9781,9833,19614
2022-12-07,경부선,직산,951,951,1902
2022-12-07,경부선,진위,2107,1822,3929
2022-12-07,경부선,천안,7160,6367,13527
2022-12-07,경부선,평택,13109,13159,26268
2022-12-07,경부선,평택지제,4593,4409,9002
2022-12-07,경부선,화서,9083,8694,17777
2022-12-07,경원선,가능,7072,6728,13800
2022-12-07,경원선,광운대,9247,9054,18301
2022-12-07,경원선,녹양,4931,4611,9542
2022-12-07,경원선,녹천,5158,4144,9302
2022-12-07,경원선,덕계,3576,3184,6760
2022-12-07,경원선,덕정,6678,6417,13095
2022-12-07,경원선,도봉,6361,6240,12601
2022-12-07,경원선,도봉산,7719,4888,12607
2022-12-07,경원선,동두천,2537,2613,5150
2022-12-07,경원선,동두천중앙,3182,3007,6189
2022-12-07,경원선,망월사,9779,9923,19702
2022-12-07,경원선,방학,10604,10418,21022
2022-12-07,경원선,보산,1468,1371,2839
2022-12-07,경원선,서빙고,2180,2076,4256
2022-12-07,경원선,석계,8867,9721,18588
2022-12-07,경원선,소요산,2299,1869,4168
2022-12-07,경원선,신이문,9027,8351,17378
2022-12-07,경원선,양주,8067,7498,15565
2022-12-07,경원선,옥수,55,39,94
2022-12-07,경원선,왕십리,16191,16910,33101
2022-12-07,경원선,외대앞,10848,10901,21749
2022-12-07,경원선,월계,8559,7988,16547
2022-12-07,경원선,응봉,2223,1860,4083
2022-12-07,경원선,의정부,19051,19660,38711
2022-12-07,경원선,이촌,4202,3222,7424
2022-12-07,경원선,지행,7152,7118,14270
2022-12-07,경원선,청량리,15644,16108,31752
2022-12-07,경원선,한남,4367,4190,8557
2022-12-07,경원선,회룡,13852,13648,27500
2022-12-07,경의선,가좌,6359,6016,12375
2022-12-07,경의선,강매,3666,3193,6859
2022-12-07,경의선,곡산,612,613,1225
2022-12-07,경의선,공덕,4083,3641,7724
2022-12-07,경의선,금릉,5413,5216,10629
2022-12-07,경의선,금촌,6909,6795,13704
2022-12-07,경의선,능곡,4241,3819,8060
2022-12-07,경의선,디지털미디어시티,3001,2744,5745
2022-12-07,경의선,문산,5298,5188,10486
2022-12-07,경의선,백마,7598,7277,14875
2022-12-07,경의선,서강대,2517,2505,5022
2022-12-07,경의선,서울역,4964,6328,11292
2022-12-07,경의선,수색,2967,3191,6158
2022-12-07,경의선,신촌,1076,1329,2405
2022-12-07,경의선,야당,8453,8425,16878
2022-12-07,경의선,운정,7651,7046,14697
2022-12-07,경의선,월롱,2997,2562,5559
2022-12-07,경의선,일산,10246,10062,20308
2022-12-07,경의선,임진강,7,4,11
2022-12-07,경의선,탄현,8498,8178,16676
2022-12-07,경의선,파주,1533,1099,2632
2022-12-07,경의선,풍산,6080,5556,11636
2022-12-07,경의선,행신,8670,8608,17278
2022-12-07,경의선,홍대입구,1831,2164,3995
2022-12-07,경의선,화전,2674,2393,5067
2022-12-07,경의선,효창공원앞,3533,3946,7479
2022-12-07,경인선,간석,6367,5940,12307
2022-12-07,경인선,개봉,23372,22960,46332
2022-12-07,경인선,구일,7655,7659,15314
2022-12-07,경인선,도원,3577,3572,7149
2022-12-07,경인선,도화,4409,4009,8418
2022-12-07,경인선,동암,16834,16956,33790
2022-12-07,경인선,동인천,14983,14100,29083
2022-12-07,경인선,백운,7274,7100,14374
2022-12-07,경인선,부개,9294,8770,18064
2022-12-07,경인선,부천,33489,33648,67137
2022-12-07,경인선,부평,28983,31010,59993
2022-12-07,경인선,소사,8847,9042,17889
2022-12-07,경인선,송내,29294,29131,58425
2022-12-07,경인선,역곡,29983,29805,59788
2022-12-07,경인선,오류동,12466,11651,24117
2022-12-07,경인선,온수,7593,7202,14795
2022-12-07,경인선,인천,3720,2837,6557
2022-12-07,경인선,제물포,11568,11139,22707
2022-12-07,경인선,주안,20332,18792,39124
2022-12-07,경인선,중동,10123,9480,19603
2022-12-07,경춘선,가평,1653,1625,3278
2022-12-07,경춘선,갈매,3296,2755,6051
2022-12-07,경춘선,강촌,427,390,817
2022-12-07,경춘선,굴봉산,96,100,196
2022-12-07,경춘선,금곡,1570,1595,3165
2022-12-07,경춘선,김유정,314,327,641
2022-12-07,경춘선,남춘천,2843,2901,5744
2022-12-07,경춘선,대성리,463,404,867
2022-12-07,경춘선,마석,4186,4020,8206
2022-12-07,경춘선,백양리,162,135,297
2022-12-07,경춘선,별내,3479,3233,6712
2022-12-07,경춘선,사릉,2594,2461,5055
2022-12-07,경춘선,상천,225,210,435
2022-12-07,경춘선,신내,2457,2375,4832
2022-12-07,경춘선,천마산,1736,1635,3371
2022-12-07,경춘선,청평,1483,1457,2940
2022-12-07,경춘선,춘천,1431,1186,2617
2022-12-07,경춘선,퇴계원,3859,3520,7379
2022-12-07,경춘선,평내호평,6825,6711,13536
2022-12-07,공항철도,검암,7020,7012,14032
2022-12-07,공항철도,계양,13269,12263,25532
2022-12-07,공항철도,공덕,2706,3477,6183
2022-12-07,공항철도,공항화물청사,2426,2555,4981
2022-12-07,공항철도,김포공항,10128,6252,16380
2022-12-07,공항철도,디지털미디어시티,15719,14537,30256
2022-12-07,공항철도,마곡나루,11152,10871,22023
2022-12-07,공항철도,서울역,10096,8617,18713
2022-12-07,공항철도,영종,3819,3846,7665
2022-12-07,공항철도,운서,8768,9068,17836
2022-12-07,공항철도,인천공항1터미널,10662,9843,20505
2022-12-07,공항철도,인천공항2터미널,3801,3440,7241
2022-12-07,공항철도,청라국제도시,7599,7109,14708
2022-12-07,공항철도,홍대입구,11041,11222,22263
2022-12-07,과천선,경마공원,1803,1796,3599
2022-12-07,과천선,과천,6872,6602,13474
2022-12-07,과천선,대공원,2935,3075,6010
2022-12-07,과천선,범계,28337,28571,56908
2022-12-07,과천선,선바위,9047,8109,17156
2022-12-07,과천선,인덕원,26545,27964,54509
2022-12-07,과천선,정부과천청사,11450,11699,23149
2022-12-07,과천선,평촌,19547,19363,38910
2022-12-07,분당선,가천대,11782,12417,24199
2022-12-07,분당선,강남구청,10852,12257,23109
2022-12-07,분당선,개포동,4591,4717,9308
2022-12-07,분당선,구룡,2786,2601,5387
2022-12-07,분당선,구성,5730,6004,11734
2022-12-07,분당선,기흥,12216,11615,23831
2022-12-07,분당선,대모산입구,5509,5008,10517
2022-12-07,분당선,도곡,8209,8142,16351
2022-12-07,분당선,망포,16747,16064,32811
2022-12-07,분당선,매교,4971,4946,9917
2022-12-07,분당선,매탄권선,5947,5712,11659
2022-12-07,분당선,모란,20701,21466,42167
2022-12-07,분당선,미금,16758,18200,34958
2022-12-07,분당선,보정,2994,2687,5681
2022-12-07,분당선,복정,2,0,2
2022-12-07,분당선,상갈,6135,5814,11949
2022-12-07,분당선,서울숲,11862,12302,24164
2022-12-07,분당선,서현,26202,26380,52582
2022-12-07,분당선,선릉,15361,23229,38590
2022-12-07,분당선,선정릉,8521,9117,17638
2022-12-07,분당선,수내,15460,15558,31018
2022-12-07,분당선,수서,15215,15509,30724
2022-12-07,분당선,수원,8412,7169,15581
2022-12-07,분당선,수원시청,13656,14634,28290
2022-12-07,분당선,신갈,5522,5412,10934
2022-12-07,분당선,압구정로데오,19860,22262,42122
2022-12-07,분당선,야탑,28395,30094,58489
2022-12-07,분당선,영통,9577,9664,19241
2022-12-07,분당선,오리,12792,10520,23312
2022-12-07,분당선,이매,6102,5797,11899
2022-12-07,분당선,정자,20381,21788,42169
2022-12-07,분당선,죽전,15638,17231,32869
2022-12-07,분당선,청명,4866,4846,9712
2022-12-07,분당선,태평,14259,13794,28053
2022-12-07,분당선,한티,15833,16848,32681
2022-12-07,수인선,고색,5517,5147,10664
2022-12-07,수인선,남동인더스파크,2356,2584,4940
2022-12-07,수인선,달월,112,74,186
2022-12-07,수인선,사리,5481,4798,10279
2022-12-07,수인선,소래포구,5481,5064,10545
2022-12-07,수인선,송도,2660,2422,5082
2022-12-07,수인선,숭의,4352,4016,8368
2022-12-07,수인선,신포,1939,2049,3988
2022-12-07,수인선,야목,399,310,709
2022-12-07,수인선,어천,1077,965,2042
2022-12-07,수인선,연수,5025,4938,9963
2022-12-07,수인선,오목천,4476,3946,8422
2022-12-07,수인선,원인재,4687,4792,9479
2022-12-07,수인선,월곶,3073,2852,5925
2022-12-07,수인선,인천,982,1632,2614
2022-12-07,수인선,인천논현,6029,6394,12423
2022-12-07,수인선,인하대,7484,7201,14685
2022-12-07,수인선,호구포,4397,4608,9005
2022-12-07,신림선,관악산,2665,2692,5357
2022-12-07,신림선,당곡,4422,4294,8716
2022-12-07,신림선,대방,2809,2269,5078
2022-12-07,신림선,보라매,3760,3414,7174
2022-12-07,신림선,보라매공원,2092,2203,4295
2022-12-07,신림선,보라매병원,7687,8035,15722
2022-12-07,신림선,샛강,2901,3596,6497
2022-12-07,신림선,서울대벤처타운,8104,7803,15907
2022-12-07,신림선,서울지방병무청,2748,3150,5898
2022-12-07,신림선,서원,3446,2900,6346
2022-12-07,신림선,신림,1738,2485,4223
2022-12-07,안산선,고잔,10142,9580,19722
2022-12-07,안산선,대야미,5428,4812,10240
2022-12-07,안산선,반월,4633,4544,9177
2022-12-07,안산선,산본,17280,18702,35982
2022-12-07,안산선,상록수,17045,17344,34389
2022-12-07,안산선,수리산,4516,3692,8208
2022-12-07,안산선,신길온천,1977,1805,3782
2022-12-07,안산선,안산,12121,11035,23156
2022-12-07,안산선,오이도,8761,8631,17392
2022-12-07,안산선,정왕,10463,10763,21226
2022-12-07,안산선,중앙,19223,20064,39287
2022-12-07,안산선,초지,5721,6110,11831
2022-12-07,안산선,한대앞,10706,10889,21595
2022-12-07,우이신설선,4.19민주묘지,4317,4265,8582
2022-12-07,우이신설선,가오리,4499,4382,8881
2022-12-07,우이신설선,보문,1674,1722,3396
2022-12-07,우이신설선,북한산보국문,6768,6389,13157
2022-12-07,우이신설선,북한산우이,2765,2489,5254
2022-12-07,우이신설선,삼양,2166,2224,4390
2022-12-07,우이신설선,삼양사거리,2665,2634,5299
2022-12-07,우이신설선,성신여대입구,3782,4165,7947
2022-12-07,우이신설선,솔밭공원,2661,2557,5218
2022-12-07,우이신설선,솔샘,6533,6142,12675
2022-12-07,우이신설선,신설동,2509,2498,5007
2022-12-07,우이신설선,정릉,5196,4990,10186
2022-12-07,우이신설선,화계,3748,3530,7278
2022-12-07,일산선,대곡,2290,1664,3954
2022-12-07,일산선,대화,14582,11326,25908
2022-12-07,일산선,마두,8344,8585,16929
2022-12-07,일산선,백석,10382,10395,20777
2022-12-07,일산선,삼송,21082,20466,41548
2022-12-07,일산선,원당,12032,11443,23475
2022-12-07,일산선,원흥,12642,11889,24531
2022-12-07,일산선,정발산,7695,7550,15245
2022-12-07,일산선,주엽,9954,10021,19975
2022-12-07,일산선,화정,18337,18934,37271
2022-12-07,장항선,배방,1200,1192,2392
2022-12-07,장항선,봉명,1434,1365,2799
2022-12-07,장항선,신창,2618,2485,5103
2022-12-07,장항선,쌍용,2980,2852,5832
2022-12-07,장항선,아산,3795,3186,6981
2022-12-07,장항선,온양온천,4111,4287,8398
2022-12-07,장항선,탕정,1208,1051,2259
2022-12-07,중앙선,구리,14360,14547,28907
2022-12-07,중앙선,국수,806,761,1567
2022-12-07,중앙선,덕소,5942,5849,11791
2022-12-07,중앙선,도농,12596,11244,23840
2022-12-07,중앙선,도심,2646,2058,4704
2022-12-07,중앙선,망우,8122,7885,16007
2022-12-07,중앙선,상봉,6023,6016,12039
2022-12-07,중앙선,신원,211,195,406
2022-12-07,중앙선,아신,570,545,1115
2022-12-07,중앙선,양수,1887,1893,3780
2022-12-07,중앙선,양원,3345,3286,6631
2022-12-07,중앙선,양정,687,551,1238
2022-12-07,중앙선,양평,2912,2945,5857
2022-12-07,중앙선,오빈,342,339,681
2022-12-07,중앙선,용문,1638,1648,3286
2022-12-07,중앙선,운길산,654,602,1256
2022-12-07,중앙선,원덕,384,341,725
2022-12-07,중앙선,중랑,5918,5759,11677
2022-12-07,중앙선,지평,55,58,113
2022-12-07,중앙선,팔당,784,809,1593
2022-12-07,중앙선,회기,29808,29317,59125
2022-12-08,1호선,동대문,11762,10949,22711
2022-12-08,1호선,동묘앞,8713,9016,17729
2022-12-08,1호선,서울역,53010,51617,104627
2022-12-08,1호선,시청,28866,28902,57768
2022-12-08,1호선,신설동,14868,14302,29170
2022-12-08,1호선,제기동,18564,18789,37353
2022-12-08,1호선,종각,42619,41793,84412
2022-12-08,1호선,종로3가,28457,25630,54087
2022-12-08,1호선,종로5가,25663,25656,51319
2022-12-08,1호선,청량리,21373,21035,42408
2022-12-08,2호선,강남,86079,82864,168943
2022-12-08,2호선,강변,32155,29688,61843
2022-12-08,2호선,건대입구,36305,38738,75043
2022-12-08,2호선,교대,38664,44480,83144
2022-12-08,2호선,구로디지털단지,64828,64330,129158
2022-12-08,2호선,구의,25965,25537,51502
2022-12-08,2호선,낙성대,29594,28548,58142
2022-12-08,2호선,당산,20499,24181,44680
2022-12-08,2호선,대림,25350,25704,51054
2022-12-08,2호선,도림천,1445,1529,2974
2022-12-08,2호선,동대문역사문화공원,14304,16321,30625
2022-12-08,2호선,뚝섬,23498,25357,48855
2022-12-08,2호선,문래,24244,24780,49024
2022-12-08,2호선,방배,20418,21327,41745
2022-12-08,2호선,봉천,25962,24254,50216
2022-12-08,2호선,사당,44229,48631,92860
2022-12-08,2호선,삼성,63448,64098,127546
2022-12-08,2호선,상왕십리,15685,15211,30896
2022-12-08,2호선,서울대입구,51234,49467,100701
2022-12-08,2호선,서초,24980,24356,49336
2022-12-08,2호선,선릉,65063,58250,123313
2022-12-08,2호선,성수,42237,46159,88396
2022-12-08,2호선,시청,28604,27569,56173
2022-12-08,2호선,신답,1928,2084,4012
2022-12-08,2호선,신당,15282,15849,31131
2022-12-08,2호선,신대방,27157,26393,53550
2022-12-08,2호선,신도림,53735,52666,106401
2022-12-08,2호선,신림,61130,58463,119593
2022-12-08,2호선,신설동,3691,3591,7282
2022-12-08,2호선,신정네거리,11409,11715,23124
2022-12-08,2호선,신촌,38432,39540,77972
2022-12-08,2호선,아현,11605,10943,22548
2022-12-08,2호선,양천구청,7760,8038,15798
2022-12-08,2호선,역삼,59636,68338,127974
2022-12-08,2호선,영등포구청,24197,25030,49227
2022-12-08,2호선,왕십리,17865,15257,33122
2022-12-08,2호선,용답,3116,3198,6314
2022-12-08,2호선,용두,2669,2683,5352
2022-12-08,2호선,을지로3가,26760,27122,53882
2022-12-08,2호선,을지로4가,15200,15607,30807
2022-12-08,2호선,을지로입구,51441,53079,104520
2022-12-08,2호선,이대,17789,19034,36823
2022-12-08,2호선,잠실,81636,81110,162746
2022-12-08,2호선,잠실나루,16353,15809,32162
2022-12-08,2호선,잠실새내,23870,23803,47673
2022-12-08,2호선,종합운동장,12761,13902,26663
2022-12-08,2호선,충정로,11449,12246,23695
2022-12-08,2호선,한양대,13930,15156,29086
2022-12-08,2호선,합정,33402,35705,69107
2022-12-08,2호선,홍대입구,62304,65514,127818
2022-12-08,3호선,가락시장,10359,10257,20616
2022-12-08,3호선,경복궁,25896,26149,52045
2022-12-08,3호선,경찰병원,8250,8441,16691
2022-12-08,3호선,고속터미널,44825,42602,87427
2022-12-08,3호선,교대,17664,11497,29161
2022-12-08,3호선,구파발,22816,21760,44576
2022-12-08,3호선,금호,8804,8236,17040
2022-12-08,3호선,남부터미널,31536,32100,63636
2022-12-08,3호선,녹번,17364,15645,33009
2022-12-08,3호선,대청,11753,10942,22695
2022-12-08,3호선,대치,11661,11851,23512
2022-12-08,3호선,도곡,5941,6049,11990
2022-12-08,3호선,독립문,8070,8141,16211
2022-12-08,3호선,동대입구,12824,14194,27018
2022-12-08,3호선,매봉,14243,13808,28051
2022-12-08,3호선,무악재,4539,4540,9079
2022-12-08,3호선,불광,17456,18708,36164
2022-12-08,3호선,수서,19478,19947,39425
2022-12-08,3호선,신사,31142,32600,63742
2022-12-08,3호선,안국,26594,27650,54244
2022-12-08,3호선,압구정,35351,38297,73648
2022-12-08,3호선,약수,14232,13941,28173
2022-12-08,3호선,양재,42853,46867,89720
2022-12-08,3호선,연신내,38035,36141,74176
2022-12-08,3호선,오금,6863,6413,13276
2022-12-08,3호선,옥수,9722,10047,19769
2022-12-08,3호선,을지로3가,12402,12438,24840
2022-12-08,3호선,일원,12068,11631,23699
2022-12-08,3호선,잠원,5779,5386,11165
2022-12-08,3호선,종로3가,10615,12498,23113
2022-12-08,3호선,지축,6887,6617,13504
2022-12-08,3호선,충무로,2,0,2
2022-12-08,3호선,학여울,2292,2380,4672
2022-12-08,3호선,홍제,19401,18542,37943
2022-12-08,4호선,길음,23675,23738,47413
2022-12-08,4호선,남태령,1390,1238,2628
2022-12-08,4호선,노원,19999,22836,42835
2022-12-08,4호선,당고개,9784,8782,18566
2022-12-08,4호선,동대문,21596,22217,43813
2022-12-08,4호선,동대문역사문화공원,18077,16259,34336
2022-12-08,4호선,동작,1439,1529,2968
2022-12-08,4호선,명동,28740,30063,58803
2022-12-08,4호선,미아,16457,15953,32410
2022-12-08,4호선,미아사거리,28783,28500,57283
2022-12-08,4호선,사당,29935,25698,55633
2022-12-08,4호선,삼각지,6590,7429,14019
2022-12-08,4호선,상계,20403,19235,39638
2022-12-08,4호선,서울역,13453,20639,34092
2022-12-08,4호선,성신여대입구,22598,21546,44144
2022-12-08,4호선,수유,35946,36399,72345
2022-12-08,4호선,숙대입구,16300,15352,31652
2022-12-08,4호선,신용산,19524,20059,39583
2022-12-08,4호선,쌍문,31489,29381,60870
2022-12-08,4호선,이촌,9973,10844,20817
2022-12-08,4호선,창동,27149,29028,56177
2022-12-08,4호선,총신대입구,20570,22224,42794
2022-12-08,4호선,충무로,32830,33980,66810
2022-12-08,4호선,한성대입구,15784,14916,30700
2022-12-08,4호선,혜화,39031,38168,77199
2022-12-08,4호선,회현,28810,30368,59178
2022-12-08,5호선,강동,20253,19421,39674
2022-12-08,5호선,강일,5642,5313,10955
2022-12-08,5호선,개롱,7401,7577,14978
2022-12-08,5호선,개화산,6142,5799,11941
2022-12-08,5호선,거여,11286,10803,22089
2022-12-08,5호선,고덕,10785,10720,21505
2022-12-08,5호선,공덕,16316,17218,33534
2022-12-08,5호선,광나루,15596,14616,30212
2022-12-08,5호선,광화문,35820,37858,73678
2022-12-08,5호선,군자,12574,13769,26343
2022-12-08,5호선,굽은다리,10258,9600,19858
2022-12-08,5호선,길동,8486,8881,17367
2022-12-08,5호선,김포공항,7475,7313,14788
2022-12-08,5호선,까치산,31219,29963,61182
2022-12-08,5호선,답십리,17595,15894,33489
2022-12-08,5호선,동대문역사문화공원,3345,4063,7408
2022-12-08,5호선,둔촌동,9289,9187,18476
2022-12-08,5호선,마곡,12016,12067,24083
2022-12-08,5호선,마장,6686,6348,13034
2022-12-08,5호선,마천,8312,7786,16098
2022-12-08,5호선,마포,16478,16985,33463
2022-12-08,5호선,명일,9433,9625,19058
2022-12-08,5호선,목동,18439,19789,38228
2022-12-08,5호선,미사,17870,18188,36058
2022-12-08,5호선,발산,23364,24044,47408
2022-12-08,5호선,방이,7603,7921,15524
2022-12-08,5호선,방화,7390,7090,14480
2022-12-08,5호선,상일동,15992,14925,30917
2022-12-08,5호선,서대문,22899,23422,46321
2022-12-08,5호선,송정,7034,6554,13588
2022-12-08,5호선,신금호,7066,7356,14422
2022-12-08,5호선,신길,4606,4999,9605
2022-12-08,5호선,신정,15070,12343,27413
2022-12-08,5호선,아차산,15942,15451,31393
2022-12-08,5호선,애오개,7499,7460,14959
2022-12-08,5호선,양평,8231,8098,16329
2022-12-08,5호선,여의나루,12440,15079,27519
2022-12-08,5호선,여의도,33812,35261,69073
2022-12-08,5호선,영등포구청,4590,4638,9228
2022-12-08,5호선,영등포시장,11207,11567,22774
2022-12-08,5호선,오금,4165,4190,8355
2022-12-08,5호선,오목교,24143,25545,49688
2022-12-08,5호선,올림픽공원,5030,4256,9286
2022-12-08,5호선,왕십리,4889,5781,10670
2022-12-08,5호선,우장산,15917,15591,31508
2022-12-08,5호선,을지로4가,7198,7321,14519
2022-12-08,5호선,장한평,20581,20356,40937
2022-12-08,5호선,종로3가,14921,14720,29641
2022-12-08,5호선,천호,18988,19382,38370
2022-12-08,5호선,청구,4448,3976,8424
2022-12-08,5호선,충정로,5242,5430,10672
2022-12-08,5호선,하남검단산,6771,6357,13128
2022-12-08,5호선,하남시청,7949,7745,15694
2022-12-08,5호선,하남풍산,4549,4607,9156
2022-12-08,5호선,행당,9124,8019,17143
2022-12-08,5호선,화곡,31025,28950,59975
2022-12-08,6호선,고려대,10087,9891,19978
2022-12-08,6호선,공덕,21030,20680,41710
2022-12-08,6호선,광흥창,10396,10019,20415
2022-12-08,6호선,구산,8735,6464,15199
2022-12-08,6호선,녹사평,4958,4817,9775
2022-12-08,6호선,대흥,10397,10951,21348
2022-12-08,6호선,독바위,2962,3025,5987
2022-12-08,6호선,돌곶이,10543,9839,20382
2022-12-08,6호선,동묘앞,8466,8755,17221
2022-12-08,6호선,디지털미디어시티,15992,17754,33746
2022-12-08,6호선,마포구청,15693,14126,29819
2022-12-08,6호선,망원,14870,15786,30656
2022-12-08,6호선,버티고개,2403,2338,4741
2022-12-08,6호선,보문,8401,7679,16080
2022-12-08,6호선,봉화산,9964,9377,19341
2022-12-08,6호선,불광,4558,4519,9077
2022-12-08,6호선,삼각지,8416,7498,15914
2022-12-08,6호선,상수,10307,11840,22147
2022-12-08,6호선,상월곡,7698,7283,14981
2022-12-08,6호선,새절,13828,12865,26693
2022-12-08,6호선,석계,13698,14354,28052
2022-12-08,6호선,신내,1,0,1
2022-12-08,6호선,신당,9209,9587,18796
2022-12-08,6호선,안암,14943,14931,29874
2022-12-08,6호선,약수,3925,3910,7835
2022-12-08,6호선,역촌,4014,4714,8728
2022-12-08,6호선,연신내,1,0,1
2022-12-08,6호선,월곡,13789,13191,26980
2022-12-08,6호선,월드컵경기장,4351,4528,8879
2022-12-08,6호선,응암,18955,18696,37651
2022-12-08,6호선,이태원,9745,10067,19812
2022-12-08,6호선,증산,10715,10693,21408
2022-12-08,6호선,창신,3995,3527,7522
2022-12-08,6호선,청구,4023,4194,8217
2022-12-08,6호선,태릉입구,6202,6771,12973
2022-12-08,6호선,한강진,8254,9549,17803
2022-12-08,6호선,합정,14082,14115,28197
2022-12-08,6호선,화랑대,13342,10258,23600
2022-12-08,6호선,효창공원앞,8230,7815,16045
2022-12-08,7호선,가산디지털단지,48583,49151,97734
2022-12-08,7호선,강남구청,18416,20652,39068
2022-12-08,7호선,건대입구,14175,14558,28733
2022-12-08,7호선,고속터미널,16281,14053,30334
2022-12-08,7호선,공릉,13229,13119,26348
2022-12-08,7호선,광명사거리,22794,22258,45052
2022-12-08,7호선,군자,16535,12960,29495
2022-12-08,7호선,남구로,16362,17528,33890
2022-12-08,7호선,남성,12566,11786,24352
2022-12-08,7호선,내방,16272,16761,33033
2022-12-08,7호선,노원,21087,22029,43116
2022-12-08,7호선,논현,20502,21074,41576
2022-12-08,7호선,대림,8215,8403,16618
2022-12-08,7호선,도봉산,10020,11350,21370
2022-12-08,7호선,뚝섬유원지,8427,8172,16599
2022-12-08,7호선,마들,14370,13367,27737
2022-12-08,7호선,먹골,11087,10947,22034
2022-12-08,7호선,면목,16810,16171,32981
2022-12-08,7호선,반포,6804,6666,13470
2022-12-08,7호선,보라매,7903,8309,16212
2022-12-08,7호선,사가정,17343,17539,34882
2022-12-08,7호선,상도,13380,13013,26393
2022-12-08,7호선,상봉,18307,17388,35695
2022-12-08,7호선,수락산,13676,13608,27284
2022-12-08,7호선,숭실대입구,16331,16331,32662
2022-12-08,7호선,신대방삼거리,16438,15460,31898
2022-12-08,7호선,신풍,12708,11923,24631
2022-12-08,7호선,어린이대공원,18120,18463,36583
2022-12-08,7호선,온수,11782,10857,22639
2022-12-08,7호선,용마산,6515,6191,12706
2022-12-08,7호선,이수,17538,16529,34067
2022-12-08,7호선,장승배기,9988,9870,19858
2022-12-08,7호선,장암,2736,1104,3840
2022-12-08,7호선,중계,16437,14935,31372
2022-12-08,7호선,중곡,12031,11161,23192
2022-12-08,7호선,중화,11608,11482,23090
2022-12-08,7호선,천왕,12786,12172,24958
2022-12-08,7호선,철산,23637,23918,47555
2022-12-08,7호선,청담,21855,24779,46634
2022-12-08,7호선,태릉입구,9850,9006,18856
2022-12-08,7호선,하계,19968,18549,38517
2022-12-08,7호선,학동,26661,28832,55493
2022-12-08,8호선,가락시장,8856,9754,18610
2022-12-08,8호선,강동구청,11748,12026,23774
2022-12-08,8호선,남위례,6999,7213,14212
2022-12-08,8호선,남한산성입구,16141,14732,30873
2022-12-08,8호선,단대오거리,12114,11580,23694
2022-12-08,8호선,모란,4734,3686,8420
2022-12-08,8호선,몽촌토성,7211,7516,14727
2022-12-08,8호선,문정,23798,25123,48921
2022-12-08,8호선,복정,10553,8733,19286
2022-12-08,8호선,산성,5779,5753,11532
2022-12-08,8호선,석촌,8358,9518,17876
2022-12-08,8호선,송파,9780,9546,19326
2022-12-08,8호선,수진,5640,5289,10929
2022-12-08,8호선,신흥,5331,5699,11030
2022-12-08,8호선,암사,20822,18170,38992
2022-12-08,8호선,잠실,16079,19344,35423
2022-12-08,8호선,장지,19400,18025,37425
2022-12-08,8호선,천호,15767,17908,33675
2022-12-08,9호선,가양,23636,22895,46531
2022-12-08,9호선,개화,2910,1906,4816
2022-12-08,9호선,고속터미널,13929,17725,31654
2022-12-08,9호선,공항시장,3235,3491,6726
2022-12-08,9호선,구반포,1337,1412,2749
2022-12-08,9호선,국회의사당,18701,19544,38245
2022-12-08,9호선,김포공항,6865,10532,17397
2022-12-08,9호선,노들,5051,4243,9294
2022-12-08,9호선,노량진,29006,28199,57205
2022-12-08,9호선,당산,20940,20702,41642
2022-12-08,9호선,동작,1822,1416,3238
2022-12-08,9호선,등촌,12861,12202,25063
2022-12-08,9호선,마곡나루,13959,13525,27484
2022-12-08,9호선,사평,4299,4020,8319
2022-12-08,9호선,샛강,7065,7223,14288
2022-12-08,9호선,선유도,9616,8946,18562
2022-12-08,9호선,신논현,32505,31625,64130
2022-12-08,9호선,신목동,4880,4168,9048
2022-12-08,9호선,신반포,4085,3956,8041
2022-12-08,9호선,신방화,7626,7433,15059
2022-12-08,9호선,양천향교,10576,10995,21571
2022-12-08,9호선,여의도,33772,32447,66219
2022-12-08,9호선,염창,19517,18855,38372
2022-12-08,9호선,증미,7756,7270,15026
2022-12-08,9호선,흑석,10195,10474,20669
2022-12-08,9호선2~3단계,둔촌오륜,1193,1099,2292
2022-12-08,9호선2~3단계,봉은사,22245,23439,45684
2022-12-08,9호선2~3단계,삼성중앙,8378,9011,17389
2022-12-08,9호선2~3단계,삼전,7747,7300,15047
2022-12-08,9호선2~3단계,석촌,9815,8609,18424
2022-12-08,9호선2~3단계,석촌고분,7185,7145,14330
2022-12-08,9호선2~3단계,선정릉,11237,12355,23592
2022-12-08,9호선2~3단계,송파나루,5500,5982,11482
2022-12-08,9호선2~3단계,언주,11973,12417,24390
2022-12-08,9호선2~3단계,올림픽공원,7065,7150,14215
2022-12-08,9호선2~3단계,종합운동장,5321,4912,10233
2022-12-08,9호선2~3단계,중앙보훈병원,12723,11182,23905
2022-12-08,9호선2~3단계,한성백제,3010,2649,5659
2022-12-08,경강선,경기광주,8920,8183,17103
2022-12-08,경강선,곤지암,2538,2350,4888
2022-12-08,경강선,부발,2439,2272,4711
2022-12-08,경강선,삼동,2749,2505,5254
2022-12-08,경강선,세종대왕릉,355,341,696
2022-12-08,경강선,신둔도예촌,1857,1619,3476
2022-12-08,경강선,여주,2596,2452,5048
2022-12-08,경강선,이매,1271,1067,2338
2022-12-08,경강선,이천,2743,2824,5567
2022-12-08,경강선,초월,3612,3431,7043
2022-12-08,경강선,판교,5883,5960,11843
2022-12-08,경부선,가산디지털단지,19850,22694,42544
2022-12-08,경부선,관악,8504,7944,16448
2022-12-08,경부선,광명,3634,3164,6798
2022-12-08,경부선,구로,19416,20194,39610
2022-12-08,경부선,군포,8394,8174,16568
2022-12-08,경부선,금정,30215,30558,60773
2022-12-08,경부선,금천구청,12811,12646,25457
2022-12-08,경부선,남영,10563,11147,21710
2022-12-08,경부선,노량진,9596,10074,19670
2022-12-08,경부선,당정,7276,6881,14157
2022-12-08,경부선,대방,12377,13638,26015
2022-12-08,경부선,독산,20104,20810,40914
2022-12-08,경부선,두정,8462,8709,17171
2022-12-08,경부선,명학,11112,10948,22060
2022-12-08,경부선,병점,17651,17639,35290
2022-12-08,경부선,서동탄,1479,1288,2767
2022-12-08,경부선,서울역,7738,2377,10115
2022-12-08,경부선,서정리,8661,7980,16641
2022-12-08,경부선,석수,10368,9517,19885
2022-12-08,경부선,성균관대,16398,16031,32429
2022-12-08,경부선,성환,6990,6351,13341
2022-12-08,경부선,세류,3464,3053,6517
2022-12-08,경부선,세마,3198,3104,6302
2022-12-08,경부선,송탄,4728,4646,9374
2022-12-08,경부선,수원,36959,39469,76428
2022-12-08,경부선,신길,9891,8624,18515
2022-12-08,경부선,신도림,4479,4580,9059
2022-12-08,경부선,안양,26597,26421,53018
2022-12-08,경부선,영등포,41338,42488,83826
2022-12-08,경부선,오산,11049,11180,22229
2022-12-08,경부선,오산대,4202,3889,8091
2022-12-08,경부선,용산,38682,38804,77486
2022-12-08,경부선,의왕,10080,9895,19975
2022-12-08,경부선,직산,963,957,1920
2022-12-08,경부선,진위,1957,1745,3702
2022-12-08,경부선,천안,7401,6256,13657
2022-12-08,경부선,평택,13366,13432,26798
2022-12-08,경부선,평택지제,4565,4565,9130
2022-12-08,경부선,화서,9360,9060,18420
2022-12-08,경원선,가능,7160,6908,14068
2022-12-08,경원선,광운대,9286,8975,18261
2022-12-08,경원선,녹양,4947,4710,9657
2022-12-08,경원선,녹천,5102,4168,9270
2022-12-08,경원선,덕계,3638,3195,6833
2022-12-08,경원선,덕정,6610,6207,12817
2022-12-08,경원선,도봉,6422,6278,12700
2022-12-08,경원선,도봉산,8004,5029,13033
2022-12-08,경원선,동두천,2339,2664,5003
2022-12-08,경원선,동두천중앙,3251,3153,6404
2022-12-08,경원선,망월사,8692,8815,17507
2022-12-08,경원선,방학,10721,10490,21211
2022-12-08,경원선,보산,1527,1398,2925
2022-12-08,경원선,서빙고,2253,2134,4387
2022-12-08,경원선,석계,8878,9967,18845
2022-12-08,경원선,소요산,2231,1903,4134
2022-12-08,경원선,신이문,9276,8389,17665
2022-12-08,경원선,양주,8159,7746,15905
2022-12-08,경원선,옥수,64,44,108
2022-12-08,경원선,왕십리,16455,16940,33395
2022-12-08,경원선,외대앞,10220,10123,20343
2022-12-08,경원선,월계,8538,7864,16402
2022-12-08,경원선,응봉,2130,1749,3879
2022-12-08,경원선,의정부,18854,19593,38447
2022-12-08,경원선,이촌,4218,3298,7516
2022-12-08,경원선,지행,6942,6986,13928
2022-12-08,경원선,청량리,16236,16497,32733
2022-12-08,경원선,한남,4433,4182,8615
2022-12-08,경원선,회룡,14007,13643,27650
2022-12-08,경의선,가좌,6271,5961,12232
2022-12-08,경의선,강매,3687,3194,6881
2022-12-08,경의선,검암,1,0,1
2022-12-08,경의선,곡산,641,686,1327
2022-12-08,경의선,공덕,4044,3660,7704
2022-12-08,경의선,금릉,5585,5329,10914
2022-12-08,경의선,금촌,6872,6692,13564
2022-12-08,경의선,능곡,4237,3811,8048
2022-12-08,경의선,디지털미디어시티,2957,2681,5638
2022-12-08,경의선,문산,5243,5415,10658
2022-12-08,경의선,백마,7758,7302,15060
2022-12-08,경의선,서강대,2486,2476,4962
2022-12-08,경의선,서울역,5010,6484,11494
2022-12-08,경의선,수색,2946,3255,6201
2022-12-08,경의선,신촌,1089,1402,2491
2022-12-08,경의선,야당,8786,8745,17531
2022-12-08,경의선,운정,7705,7113,14818
2022-12-08,경의선,월롱,2977,2455,5432
2022-12-08,경의선,일산,11397,11336,22733
2022-12-08,경의선,임진강,9,1,10
2022-12-08,경의선,탄현,8782,8494,17276
2022-12-08,경의선,파주,1460,1032,2492
2022-12-08,경의선,풍산,6314,5940,12254
2022-12-08,경의선,행신,8844,8811,17655
2022-12-08,경의선,홍대입구,2035,2440,4475
2022-12-08,경의선,화전,2367,2209,4576
2022-12-08,경의선,효창공원앞,3481,3760,7241
2022-12-08,경인선,간석,6324,6073,12397
2022-12-08,경인선,개봉,23439,22976,46415
2022-12-08,경인선,구일,7536,7506,15042
2022-12-08,경인선,도원,3598,3578,7176
2022-12-08,경인선,도화,4279,4006,8285
2022-12-08,경인선,동암,16886,16949,33835
2022-12-08,경인선,동인천,14960,14134,29094
2022-12-08,경인선,백운,7283,7172,14455
2022-12-08,경인선,부개,9267,8711,17978
2022-12-08,경인선,부천,33822,33921,67743
2022-12-08,경인선,부평,29398,31186,60584
2022-12-08,경인선,소사,9033,9102,18135
2022-12-08,경인선,송내,29540,29422,58962
2022-12-08,경인선,역곡,29716,29237,58953
2022-12-08,경인선,오류동,12616,11705,24321
2022-12-08,경인선,온수,7641,7183,14824
2022-12-08,경인선,인천,3762,2845,6607
2022-12-08,경인선,제물포,11608,11075,22683
2022-12-08,경인선,주안,20330,18628,38958
2022-12-08,경인선,중동,10057,9336,19393
2022-12-08,경춘선,가평,1519,1504,3023
2022-12-08,경춘선,갈매,3308,2824,6132
2022-12-08,경춘선,강촌,460,413,873
2022-12-08,경춘선,굴봉산,111,118,229
2022-12-08,경춘선,금곡,1692,1650,3342
2022-12-08,경춘선,김유정,337,347,684
2022-12-08,경춘선,남춘천,2889,2561,5450
2022-12-08,경춘선,대성리,500,472,972
2022-12-08,경춘선,마석,4419,4460,8879
2022-12-08,경춘선,백양리,155,149,304
2022-12-08,경춘선,별내,3510,3297,6807
2022-12-08,경춘선,사릉,2607,2619,5226
2022-12-08,경춘선,상천,264,231,495
2022-12-08,경춘선,신내,2505,2324,4829
2022-12-08,경춘선,천마산,1790,1606,3396
2022-12-08,경춘선,청평,1569,1587,3156
2022-12-08,경춘선,춘천,1498,1316,2814
2022-12-08,경춘선,퇴계원,3820,3549,7369
2022-12-08,경춘선,평내호평,6880,6696,13576
2022-12-08,공항철도,검암,7181,6992,14173
2022-12-08,공항철도,계양,13432,12498,25930
2022-12-08,공항철도,공덕,2787,3682,6469
2022-12-08,공항철도,공항화물청사,2432,2563,4995
2022-12-08,공항철도,김포공항,10577,6640,17217
2022-12-08,공항철도,디지털미디어시티,15686,14653,30339
2022-12-08,공항철도,마곡나루,11264,11057,22321
2022-12-08,공항철도,서울역,10903,8980,19883
2022-12-08,공항철도,영종,3825,3882,7707
2022-12-08,공항철도,운서,8778,8936,17714
2022-12-08,공항철도,인천공항1터미널,10660,9650,20310
2022-12-08,공항철도,인천공항2터미널,4201,3678,7879
2022-12-08,공항철도,청라국제도시,7638,7420,15058
2022-12-08,공항철도,홍대입구,11663,11860,23523
2022-12-08,과천선,경마공원,1420,1436,2856
2022-12-08,과천선,과천,6906,6559,13465
2022-12-08,과천선,대공원,2844,2989,5833
2022-12-08,과천선,범계,28229,28449,56678
2022-12-08,과천선,선바위,9168,8232,17400
2022-12-08,과천선,인덕원,26763,27917,54680
2022-12-08,과천선,정부과천청사,11917,12068,23985
2022-12-08,과천선,평촌,19560,19470,39030
2022-12-08,분당선,가천대,12469,13020,25489
2022-12-08,분당선,강남구청,10542,12193,22735
2022-12-08,분당선,개포동,4454,4570,9024
2022-12-08,분당선,구룡,2755,2535,5290
2022-12-08,분당선,구성,5776,6053,11829
2022-12-08,분당선,기흥,12085,11434,23519
2022-12-08,분당선,대모산입구,5582,5072,10654
2022-12-08,분당선,도곡,8231,8248,16479
2022-12-08,분당선,망포,16830,16150,32980
2022-12-08,분당선,매교,4998,4968,9966
2022-12-08,분당선,매탄권선,5980,5667,11647
2022-12-08,분당선,모란,21294,21800,43094
2022-12-08,분당선,미금,16699,17947,34646
2022-12-08,분당선,보정,3145,2699,5844
2022-12-08,분당선,상갈,6120,5808,11928
2022-12-08,분당선,서울숲,11973,12600,24573
2022-12-08,분당선,서현,26233,26993,53226
2022-12-08,분당선,선릉,15396,23449,38845
2022-12-08,분당선,선정릉,8773,9202,17975
2022-12-08,분당선,수내,15615,15549,31164
2022-12-08,분당선,수서,15330,15895,31225
2022-12-08,분당선,수원,8719,7390,16109
2022-12-08,분당선,수원시청,13695,14831,28526
2022-12-08,분당선,신갈,5353,5198,10551
2022-12-08,분당선,압구정로데오,20614,23076,43690
2022-12-08,분당선,야탑,29018,30489,59507
2022-12-08,분당선,영통,9681,9765,19446
2022-12-08,분당선,오리,12883,10527,23410
2022-12-08,분당선,이매,6180,5917,12097
2022-12-08,분당선,정자,20474,22071,42545
2022-12-08,분당선,죽전,16000,17406,33406
2022-12-08,분당선,청명,5002,4867,9869
2022-12-08,분당선,태평,14485,13763,28248
2022-12-08,분당선,한티,15724,16489,32213
2022-12-08,수인선,고색,5539,5166,10705
2022-12-08,수인선,남동인더스파크,2320,2646,4966
2022-12-08,수인선,달월,104,65,169
2022-12-08,수인선,사리,5371,4740,10111
2022-12-08,수인선,소래포구,5677,5372,11049
2022-12-08,수인선,송도,2725,2509,5234
2022-12-08,수인선,숭의,4416,4191,8607
2022-12-08,수인선,신포,1932,2049,3981
2022-12-08,수인선,야목,397,299,696
2022-12-08,수인선,어천,1090,1104,2194
2022-12-08,수인선,연수,5037,4870,9907
2022-12-08,수인선,오목천,4533,3912,8445
2022-12-08,수인선,원인재,4666,4749,9415
2022-12-08,수인선,월곶,3069,2898,5967
2022-12-08,수인선,인천,970,1628,2598
2022-12-08,수인선,인천논현,5932,6403,12335
2022-12-08,수인선,인하대,7671,7147,14818
2022-12-08,수인선,호구포,4472,4538,9010
2022-12-08,신림선,관악산,2754,2819,5573
2022-12-08,신림선,당곡,4439,4285,8724
2022-12-08,신림선,대방,2767,2085,4852
2022-12-08,신림선,보라매,3780,3456,7236
2022-12-08,신림선,보라매공원,2073,2203,4276
2022-12-08,신림선,보라매병원,7613,8062,15675
2022-12-08,신림선,샛강,2945,3555,6500
2022-12-08,신림선,서울대벤처타운,8154,7940,16094
2022-12-08,신림선,서울지방병무청,2658,2992,5650
2022-12-08,신림선,서원,3367,2861,6228
2022-12-08,신림선,신림,1756,2297,4053
2022-12-08,안산선,고잔,9940,9323,19263
2022-12-08,안산선,대야미,5378,4810,10188
2022-12-08,안산선,반월,4642,4426,9068
2022-12-08,안산선,산본,17200,18404,35604
2022-12-08,안산선,상록수,17003,17367,34370
2022-12-08,안산선,수리산,4442,3651,8093
2022-12-08,안산선,신길온천,1951,1779,3730
2022-12-08,안산선,안산,11856,10793,22649
2022-12-08,안산선,오이도,8901,8822,17723
2022-12-08,안산선,정왕,10668,10761,21429
2022-12-08,안산선,중앙,19332,20361,39693
2022-12-08,안산선,초지,5558,5935,11493
2022-12-08,안산선,한대앞,10926,10930,21856
2022-12-08,우이신설선,4.19민주묘지,4293,4190,8483
2022-12-08,우이신설선,가오리,4402,4344,8746
2022-12-08,우이신설선,보문,1676,1676,3352
2022-12-08,우이신설선,북한산보국문,6822,6439,13261
2022-12-08,우이신설선,북한산우이,3084,2714,5798
2022-12-08,우이신설선,삼양,2096,2202,4298
2022-12-08,우이신설선,삼양사거리,2652,2580,5232
2022-12-08,우이신설선,성신여대입구,3662,4037,7699
2022-12-08,우이신설선,솔밭공원,2729,2565,5294
2022-12-08,우이신설선,솔샘,6567,6195,12762
2022-12-08,우이신설선,신설동,2548,2451,4999
2022-12-08,우이신설선,정릉,5123,4970,10093
2022-12-08,우이신설선,화계,3797,3585,7382
2022-12-08,일산선,대곡,2317,1759,4076
2022-12-08,일산선,대화,15309,12145,27454
2022-12-08,일산선,마두,8210,8378,16588
2022-12-08,일산선,백석,10445,10481,20926
2022-12-08,일산선,삼송,21291,20267,41558
2022-12-08,일산선,원당,12050,11472,23522
2022-12-08,일산선,원흥,12582,11847,24429
2022-12-08,일산선,정발산,7303,7293,14596
2022-12-08,일산선,주엽,10071,10191,20262
2022-12-08,일산선,화정,18197,18591,36788
2022-12-08,장항선,배방,1218,1164,2382
2022-12-08,장항선,봉명,1443,1333,2776
2022-12-08,장항선,신창,2976,2444,5420
2022-12-08,장항선,쌍용,3195,3007,6202
2022-12-08,장항선,아산,3957,3546,7503
2022-12-08,장항선,온양온천,4174,4258,8432
2022-12-08,장항선,탕정,1259,1061,2320
2022-12-08,중앙선,구리,14358,14564,28922
2022-12-08,중앙선,국수,873,885,1758
2022-12-08,중앙선,덕소,6038,6038,12076
2022-12-08,중앙선,도농,12649,11341,23990
2022-12-08,중앙선,도심,2666,2049,4715
2022-12-08,중앙선,망우,8209,7940,16149
2022-12-08,중앙선,상봉,6249,6049,12298
2022-12-08,중앙선,신원,196,187,383
2022-12-08,중앙선,아신,627,636,1263
2022-12-08,중앙선,양수,1859,1862,3721
2022-12-08,중앙선,양원,3278,3176,6454
2022-12-08,중앙선,양정,730,609,1339
2022-12-08,중앙선,양평,3851,3896,7747
2022-12-08,중앙선,오빈,338,346,684
2022-12-08,중앙선,용문,1716,1793,3509
2022-12-08,중앙선,운길산,756,715,1471
2022-12-08,중앙선,원덕,350,344,694
2022-12-08,중앙선,중랑,5933,5687,11620
2022-12-08,중앙선,지평,63,53,116
2022-12-08,중앙선,팔당,802,823,1625
2022-12-08,중앙선,회기,30282,29334,59616
2022-12-09,1호선,동대문,11974,10694,22668
2022-12-09,1호선,동묘앞,8952,9290,18242
2022-12-09,1호선,서울역,59613,58184,117797
2022-12-09,1호선,시청,28423,28749,57172
2022-12-09,1호선,신설동,15592,14843,30435
2022-12-09,1호선,제기동,18818,18911,37729
2022-12-09,1호선,종각,43088,43431,86519
2022-12-09,1호선,종로3가,30343,28387,58730
2022-12-09,1호선,종로5가,26084,26593,52677
2022-12-09,1호선,청량리,21838,21783,43621
2022-12-09,2호선,강남,90741,89844,180585
2022-12-09,2호선,강변,35555,33851,69406
2022-12-09,2호선,건대입구,38764,43474,82238
2022-12-09,2호선,교대,39211,44909,84120
2022-12-09,2호선,구로디지털단지,65576,65285,130861
2022-12-09,2호선,구의,26966,25950,52916
2022-12-09,2호선,낙성대,30581,28534,59115
2022-12-09,2호선,당산,20845,24492,45337
2022-12-09,2호선,대림,26182,26701,52883
2022-12-09,2호선,도림천,1433,1499,2932
2022-12-09,2호선,동대문역사문화공원,14880,16537,31417
2022-12-09,2호선,뚝섬,25776,27570,53346
2022-12-09,2호선,문래,24082,25013,49095
2022-12-09,2호선,방배,19621,20385,40006
2022-12-09,2호선,봉천,26498,23914,50412
2022-12-09,2호선,사당,47490,52689,100179
2022-12-09,2호선,삼성,64009,64284,128293
2022-12-09,2호선,상왕십리,16078,15372,31450
2022-12-09,2호선,서울대입구,52530,50186,102716
2022-12-09,2호선,서초,25078,24091,49169
2022-12-09,2호선,선릉,63225,56349,119574
2022-12-09,2호선,성수,43740,47917,91657
2022-12-09,2호선,시청,27893,26959,54852
2022-12-09,2호선,신답,1908,2073,3981
2022-12-09,2호선,신당,15904,16534,32438
2022-12-09,2호선,신대방,27692,26468,54160
2022-12-09,2호선,신도림,55428,55591,111019
2022-12-09,2호선,신림,63441,61266,124707
2022-12-09,2호선,신설동,4176,4112,8288
2022-12-09,2호선,신정네거리,11650,11956,23606
2022-12-09,2호선,신촌,39357,40623,79980
2022-12-09,2호선,아현,12060,11236,23296
2022-12-09,2호선,양천구청,7891,8149,16040
2022-12-09,2호선,역삼,56547,65026,121573
2022-12-09,2호선,영등포구청,24494,25390,49884
2022-12-09,2호선,왕십리,18906,16532,35438
2022-12-09,2호선,용답,3178,3101,6279
2022-12-09,2호선,용두,2864,2772,5636
2022-12-09,2호선,을지로3가,27662,28738,56400
2022-12-09,2호선,을지로4가,15567,16231,31798
2022-12-09,2호선,을지로입구,53036,54313,107349
2022-12-09,2호선,이대,17615,18722,36337
2022-12-09,2호선,잠실,85409,85161,170570
2022-12-09,2호선,잠실나루,16582,15685,32267
2022-12-09,2호선,잠실새내,25288,25809,51097
2022-12-09,2호선,종합운동장,9043,9662,18705
2022-12-09,2호선,충정로,11275,12103,23378
2022-12-09,2호선,한양대,12517,13468,25985
2022-12-09,2호선,합정,35811,40269,76080
2022-12-09,2호선,홍대입구,69556,78965,148521
2022-12-09,3호선,가락시장,10802,10632,21434
2022-12-09,3호선,경복궁,25596,25616,51212
2022-12-09,3호선,경찰병원,8168,8376,16544
2022-12-09,3호선,고속터미널,53176,53472,106648
2022-12-09,3호선,교대,18043,11786,29829
2022-12-09,3호선,구파발,23007,21827,44834
2022-12-09,3호선,금호,8912,8258,17170
2022-12-09,3호선,남부터미널,34201,34475,68676
2022-12-09,3호선,녹번,17416,15567,32983
2022-12-09,3호선,대청,11784,10967,22751
2022-12-09,3호선,대치,12069,12066,24135
2022-12-09,3호선,도곡,6169,6057,12226
2022-12-09,3호선,독립문,8070,8187,16257
2022-12-09,3호선,동대입구,11236,12331,23567
2022-12-09,3호선,매봉,14169,13818,27987
2022-12-09,3호선,무악재,4553,4369,8922
2022-12-09,3호선,불광,17945,18954,36899
2022-12-09,3호선,수서,21367,21035,42402
2022-12-09,3호선,신사,33206,35986,69192
2022-12-09,3호선,안국,27792,29272,57064
2022-12-09,3호선,압구정,37795,41576,79371
2022-12-09,3호선,약수,14801,14284,29085
2022-12-09,3호선,양재,45442,48323,93765
2022-12-09,3호선,연신내,39478,37438,76916
2022-12-09,3호선,오금,7220,6375,13595
2022-12-09,3호선,옥수,10186,10242,20428
2022-12-09,3호선,을지로3가,12804,13020,25824
2022-12-09,3호선,일원,12597,11651,24248
2022-12-09,3호선,잠원,5457,5145,10602
2022-12-09,3호선,종로3가,11180,13639,24819
2022-12-09,3호선,지축,6784,6458,13242
2022-12-09,3호선,학여울,3317,3420,6737
2022-12-09,3호선,홍제,19771,18532,38303
2022-12-09,4호선,길음,23602,22823,46425
2022-12-09,4호선,남태령,1628,1259,2887
2022-12-09,4호선,노원,21159,24485,45644
2022-12-09,4호선,당고개,10183,9018,19201
2022-12-09,4호선,동대문,21507,21356,42863
2022-12-09,4호선,동대문역사문화공원,18162,15399,33561
2022-12-09,4호선,동작,1563,1640,3203
2022-12-09,4호선,명동,30919,33089,64008
2022-12-09,4호선,미아,16826,16304,33130
2022-12-09,4호선,미아사거리,29828,29531,59359
2022-12-09,4호선,사당,32205,28503,60708
2022-12-09,4호선,삼각지,6965,8140,15105
2022-12-09,4호선,상계,20679,19420,40099
2022-12-09,4호선,서울역,14016,23804,37820
2022-12-09,4호선,성신여대입구,23521,22595,46116
2022-12-09,4호선,수유,37674,38517,76191
2022-12-09,4호선,숙대입구,15926,15450,31376
2022-12-09,4호선,신용산,20354,21364,41718
2022-12-09,4호선,쌍문,31857,29474,61331
2022-12-09,4호선,이촌,10155,11039,21194
2022-12-09,4호선,창동,28212,30085,58297
2022-12-09,4호선,총신대입구,21497,23798,45295
2022-12-09,4호선,충무로,32516,33953,66469
2022-12-09,4호선,한성대입구,15894,15025,30919
2022-12-09,4호선,혜화,39399,39195,78594
2022-12-09,4호선,회현,29640,31511,61151
2022-12-09,5호선,강동,20425,19395,39820
2022-12-09,5호선,강일,5720,5187,10907
2022-12-09,5호선,개롱,7282,7464,14746
2022-12-09,5호선,개화산,6282,5875,12157
2022-12-09,5호선,거여,11286,10695,21981
2022-12-09,5호선,고덕,11166,10895,22061
2022-12-09,5호선,공덕,16518,17663,34181
2022-12-09,5호선,광나루,15092,13523,28615
2022-12-09,5호선,광화문,34827,37170,71997
2022-12-09,5호선,군자,12880,14092,26972
2022-12-09,5호선,굽은다리,10779,10325,21104
2022-12-09,5호선,길동,9056,9449,18505
2022-12-09,5호선,김포공항,8154,7805,15959
2022-12-09,5호선,까치산,31774,29888,61662
2022-12-09,5호선,답십리,17909,16140,34049
2022-12-09,5호선,동대문역사문화공원,3402,4106,7508
2022-12-09,5호선,둔촌동,9644,9743,19387
2022-12-09,5호선,마곡,11965,12133,24098
2022-12-09,5호선,마장,6675,6298,12973
2022-12-09,5호선,마천,8260,7815,16075
2022-12-09,5호선,마포,16939,17594,34533
2022-12-09,5호선,명일,9850,10118,19968
2022-12-09,5호선,목동,18695,19877,38572
2022-12-09,5호선,미사,18416,18883,37299
2022-12-09,5호선,발산,23089,24592,47681
2022-12-09,5호선,방이,7854,8461,16315
2022-12-09,5호선,방화,7433,6978,14411
2022-12-09,5호선,상일동,16545,15046,31591
2022-12-09,5호선,서대문,22168,22392,44560
2022-12-09,5호선,송정,7219,6557,13776
2022-12-09,5호선,신금호,7203,7368,14571
2022-12-09,5호선,신길,4808,4955,9763
2022-12-09,5호선,신정,15297,12260,27557
2022-12-09,5호선,아차산,15764,15037,30801
2022-12-09,5호선,애오개,7520,7402,14922
2022-12-09,5호선,양평,8294,7860,16154
2022-12-09,5호선,여의나루,12782,15356,28138
2022-12-09,5호선,여의도,33248,35004,68252
2022-12-09,5호선,영등포구청,4675,4686,9361
2022-12-09,5호선,영등포시장,12145,12620,24765
2022-12-09,5호선,오금,4175,4196,8371
2022-12-09,5호선,오목교,24143,25988,50131
2022-12-09,5호선,올림픽공원,6777,6290,13067
2022-12-09,5호선,왕십리,5006,6004,11010
2022-12-09,5호선,우장산,16632,16166,32798
2022-12-09,5호선,을지로4가,7137,7421,14558
2022-12-09,5호선,장한평,20835,20533,41368
2022-12-09,5호선,종로3가,16095,16514,32609
2022-12-09,5호선,천호,20700,20703,41403
2022-12-09,5호선,청구,4277,4010,8287
2022-12-09,5호선,충정로,5046,5112,10158
2022-12-09,5호선,하남검단산,7066,6635,13701
2022-12-09,5호선,하남시청,8442,8246,16688
2022-12-09,5호선,하남풍산,4792,4646,9438
2022-12-09,5호선,행당,9082,7936,17018
2022-12-09,5호선,화곡,31969,29181,61150
2022-12-09,6호선,고려대,9626,9349,18975
2022-12-09,6호선,공덕,21108,21027,42135
2022-12-09,6호선,광흥창,10155,9871,20026
2022-12-09,6호선,구산,8748,6473,15221
2022-12-09,6호선,녹사평,5285,5479,10764
2022-12-09,6호선,대흥,10280,10380,20660
2022-12-09,6호선,독바위,2989,2991,5980
2022-12-09,6호선,돌곶이,10649,9690,20339
2022-12-09,6호선,동묘앞,8775,8589,17364
2022-12-09,6호선,디지털미디어시티,16095,17370,33465
2022-12-09,6호선,마포구청,16347,14502,30849
2022-12-09,6호선,망원,15881,17244,33125
2022-12-09,6호선,버티고개,2401,2369,4770
2022-12-09,6호선,보문,8785,7755,16540
2022-12-09,6호선,봉화산,9869,9311,19180
2022-12-09,6호선,불광,4627,4497,9124
2022-12-09,6호선,삼각지,7997,6867,14864
2022-12-09,6호선,상수,11132,13666,24798
2022-12-09,6호선,상월곡,6967,6283,13250
2022-12-09,6호선,새절,14004,12987,26991
2022-12-09,6호선,석계,13705,14106,27811
2022-12-09,6호선,신내,2,0,2
2022-12-09,6호선,신당,9390,8909,18299
2022-12-09,6호선,안암,12986,12685,25671
2022-12-09,6호선,약수,4071,4145,8216
2022-12-09,6호선,역촌,4017,4749,8766
2022-12-09,6호선,월곡,13859,13116,26975
2022-12-09,6호선,월드컵경기장,4584,4768,9352
2022-12-09,6호선,응암,19381,18779,38160
2022-12-09,6호선,이태원,10805,11818,22623
2022-12-09,6호선,증산,11038,10814,21852
2022-12-09,6호선,창신,3965,3309,7274
2022-12-09,6호선,청구,4120,4117,8237
2022-12-09,6호선,태릉입구,6455,6809,13264
2022-12-09,6호선,한강진,8470,9821,18291
2022-12-09,6호선,합정,15065,15391,30456
2022-12-09,6호선,화랑대,13401,10068,23469
2022-12-09,6호선,효창공원앞,8303,7624,15927
2022-12-09,7호선,가산디지털단지,48644,48227,96871
2022-12-09,7호선,강남구청,18416,21025,39441
2022-12-09,7호선,건대입구,14528,15434,29962
2022-12-09,7호선,고속터미널,20008,16335,36343
2022-12-09,7호선,공릉,13536,13572,27108
2022-12-09,7호선,광명사거리,23705,23347,47052
2022-12-09,7호선,군자,17285,13233,30518
2022-12-09,7호선,남구로,16197,17070,33267
2022-12-09,7호선,남성,12694,11408,24102
2022-12-09,7호선,내방,16361,16572,32933
2022-12-09,7호선,노원,22518,24147,46665
2022-12-09,7호선,논현,20749,22311,43060
2022-12-09,7호선,대림,8572,8704,17276
2022-12-09,7호선,도봉산,10014,11137,21151
2022-12-09,7호선,뚝섬유원지,8607,8292,16899
2022-12-09,7호선,마들,14502,13264,27766
2022-12-09,7호선,먹골,11460,11028,22488
2022-12-09,7호선,면목,17447,16670,34117
2022-12-09,7호선,반포,7033,6839,13872
2022-12-09,7호선,보라매,8351,8421,16772
2022-12-09,7호선,사가정,17680,17822,35502
2022-12-09,7호선,상도,13478,12960,26438
2022-12-09,7호선,상봉,18721,18094,36815
2022-12-09,7호선,수락산,14015,13730,27745
2022-12-09,7호선,숭실대입구,15273,15001,30274
2022-12-09,7호선,신대방삼거리,16753,15636,32389
2022-12-09,7호선,신풍,12637,11724,24361
2022-12-09,7호선,어린이대공원,17029,17190,34219
2022-12-09,7호선,온수,11672,10870,22542
2022-12-09,7호선,용마산,6462,6098,12560
2022-12-09,7호선,이수,19185,18357,37542
2022-12-09,7호선,장승배기,10420,9996,20416
2022-12-09,7호선,장암,2598,1031,3629
2022-12-09,7호선,중계,16362,14409,30771
2022-12-09,7호선,중곡,12355,11404,23759
2022-12-09,7호선,중화,11929,11547,23476
2022-12-09,7호선,천왕,12843,11922,24765
2022-12-09,7호선,철산,24511,24920,49431
2022-12-09,7호선,청담,21408,24647,46055
2022-12-09,7호선,태릉입구,10015,9224,19239
2022-12-09,7호선,하계,19819,18043,37862
2022-12-09,7호선,학동,25895,28067,53962
2022-12-09,8호선,가락시장,9008,10392,19400
2022-12-09,8호선,강동구청,11900,12088,23988
2022-12-09,8호선,남위례,7152,7459,14611
2022-12-09,8호선,남한산성입구,16037,14171,30208
2022-12-09,8호선,단대오거리,12637,11774,24411
2022-12-09,8호선,모란,6716,5238,11954
2022-12-09,8호선,몽촌토성,7131,7721,14852
2022-12-09,8호선,문정,23718,24541,48259
2022-12-09,8호선,복정,10851,8730,19581
2022-12-09,8호선,산성,5985,5748,11733
2022-12-09,8호선,석촌,8526,10120,18646
2022-12-09,8호선,송파,9967,9652,19619
2022-12-09,8호선,수진,5994,5452,11446
2022-12-09,8호선,신흥,5638,5844,11482
2022-12-09,8호선,암사,21173,18255,39428
2022-12-09,8호선,잠실,17317,20868,38185
2022-12-09,8호선,장지,19504,17854,37358
2022-12-09,8호선,천호,16513,19420,35933
2022-12-09,9호선,가양,23967,23195,47162
2022-12-09,9호선,개화,2986,2006,4992
2022-12-09,9호선,고속터미널,16112,22019,38131
2022-12-09,9호선,공항시장,3139,3420,6559
2022-12-09,9호선,구반포,1459,1506,2965
2022-12-09,9호선,국회의사당,19271,19835,39106
2022-12-09,9호선,김포공항,8004,11248,19252
2022-12-09,9호선,노들,5269,4333,9602
2022-12-09,9호선,노량진,30740,29950,60690
2022-12-09,9호선,당산,21858,21412,43270
2022-12-09,9호선,동작,1822,1291,3113
2022-12-09,9호선,등촌,13030,12019,25049
2022-12-09,9호선,마곡나루,14698,14427,29125
2022-12-09,9호선,사평,4419,4164,8583
2022-12-09,9호선,샛강,7200,7195,14395
2022-12-09,9호선,선유도,9665,8872,18537
2022-12-09,9호선,신논현,36322,36607,72929
2022-12-09,9호선,신목동,4916,4170,9086
2022-12-09,9호선,신반포,4270,4176,8446
2022-12-09,9호선,신방화,7675,7372,15047
2022-12-09,9호선,양천향교,10975,10828,21803
2022-12-09,9호선,여의도,34596,32297,66893
2022-12-09,9호선,염창,20068,19065,39133
2022-12-09,9호선,증미,7819,7168,14987
2022-12-09,9호선,흑석,10201,10529,20730
2022-12-09,9호선2~3단계,둔촌오륜,1427,1235,2662
2022-12-09,9호선2~3단계,봉은사,22658,23619,46277
2022-12-09,9호선2~3단계,삼성중앙,8605,9055,17660
2022-12-09,9호선2~3단계,삼전,7890,7462,15352
2022-12-09,9호선2~3단계,석촌,10352,8962,19314
2022-12-09,9호선2~3단계,석촌고분,7557,7263,14820
2022-12-09,9호선2~3단계,선정릉,11126,12178,23304
2022-12-09,9호선2~3단계,송파나루,5998,6655,12653
2022-12-09,9호선2~3단계,언주,12321,12712,25033
2022-12-09,9호선2~3단계,올림픽공원,13058,14234,27292
2022-12-09,9호선2~3단계,종합운동장,5126,5160,10286
2022-12-09,9호선2~3단계,중앙보훈병원,12576,10760,23336
2022-12-09,9호선2~3단계,한성백제,3142,2854,5996
2022-12-09,경강선,경기광주,9352,8551,17903
2022-12-09,경강선,곤지암,2710,2503,5213
2022-12-09,경강선,부발,3100,2393,5493
2022-12-09,경강선,삼동,2980,2539,5519
2022-12-09,경강선,세종대왕릉,382,410,792
2022-12-09,경강선,신둔도예촌,1894,1680,3574
2022-12-09,경강선,여주,2578,2614,5192
2022-12-09,경강선,이매,1372,1191,2563
2022-12-09,경강선,이천,3219,3239,6458
2022-12-09,경강선,초월,3869,3527,7396
2022-12-09,경강선,판교,5924,6006,11930
2022-12-09,경부선,가산디지털단지,19835,22683,42518
2022-12-09,경부선,관악,8324,7791,16115
2022-12-09,경부선,광명,4309,3820,8129
2022-12-09,경부선,구로,19825,20764,40589
2022-12-09,경부선,군포,8417,8114,16531
2022-12-09,경부선,금정,30994,31302,62296
2022-12-09,경부선,금천구청,13043,13052,26095
2022-12-09,경부선,남영,10842,11372,22214
2022-12-09,경부선,노량진,10745,11272,22017
2022-12-09,경부선,당정,7298,6676,13974
2022-12-09,경부선,대방,12479,13691,26170
2022-12-09,경부선,독산,19912,20150,40062
2022-12-09,경부선,두정,8519,7981,16500
2022-12-09,경부선,명학,10104,9805,19909
2022-12-09,경부선,병점,17664,17427,35091
2022-12-09,경부선,서동탄,1632,1526,3158
2022-12-09,경부선,서울역,11007,3382,14389
2022-12-09,경부선,서정리,10504,8063,18567
2022-12-09,경부선,석수,10548,9399,19947
2022-12-09,경부선,성균관대,17326,16937,34263
2022-12-09,경부선,성환,5514,4660,10174
2022-12-09,경부선,세류,3656,3340,6996
2022-12-09,경부선,세마,3359,3100,6459
2022-12-09,경부선,송탄,5643,5032,10675
2022-12-09,경부선,수원,40236,44276,84512
2022-12-09,경부선,신길,10109,8451,18560
2022-12-09,경부선,신도림,4519,4696,9215
2022-12-09,경부선,안양,27414,27427,54841
2022-12-09,경부선,영등포,47314,50462,97776
2022-12-09,경부선,오산,11605,11361,22966
2022-12-09,경부선,오산대,4245,3858,8103
2022-12-09,경부선,용산,46033,46648,92681
2022-12-09,경부선,의왕,10108,9813,19921
2022-12-09,경부선,직산,1131,1002,2133
2022-12-09,경부선,진위,2232,1752,3984
2022-12-09,경부선,천안,7499,6751,14250
2022-12-09,경부선,평택,15415,15007,30422
2022-12-09,경부선,평택지제,5500,5062,10562
2022-12-09,경부선,화서,9364,8986,18350
2022-12-09,경원선,가능,7335,7000,14335
2022-12-09,경원선,광운대,9076,8766,17842
2022-12-09,경원선,녹양,5185,4820,10005
2022-12-09,경원선,녹천,5153,4247,9400
2022-12-09,경원선,덕계,3679,3313,6992
2022-12-09,경원선,덕정,6909,6377,13286
2022-12-09,경원선,도봉,6476,6236,12712
2022-12-09,경원선,도봉산,7826,5021,12847
2022-12-09,경원선,동두천,2684,2806,5490
2022-12-09,경원선,동두천중앙,3339,3289,6628
2022-12-09,경원선,망월사,8760,8772,17532
2022-12-09,경원선,방학,10802,10513,21315
2022-12-09,경원선,보산,1920,1633,3553
2022-12-09,경원선,서빙고,2279,2088,4367
2022-12-09,경원선,석계,8955,10038,18993
2022-12-09,경원선,소요산,2396,2211,4607
2022-12-09,경원선,신이문,9113,8242,17355
2022-12-09,경원선,양주,8556,7828,16384
2022-12-09,경원선,옥수,58,43,101
2022-12-09,경원선,왕십리,17208,18019,35227
2022-12-09,경원선,외대앞,10147,9841,19988
2022-12-09,경원선,월계,8071,7402,15473
2022-12-09,경원선,응봉,2128,1740,3868
2022-12-09,경원선,의정부,20086,21355,41441
2022-12-09,경원선,이촌,4382,3396,7778
2022-12-09,경원선,지행,7488,7289,14777
2022-12-09,경원선,창동,1,0,1
2022-12-09,경원선,청량리,18623,18968,37591
2022-12-09,경원선,한남,4369,4342,8711
2022-12-09,경원선,회룡,13797,13621,27418
2022-12-09,경의선,가좌,6522,6103,12625
2022-12-09,경의선,강매,3627,3130,6757
2022-12-09,경의선,곡산,655,682,1337
2022-12-09,경의선,공덕,4184,3917,8101
2022-12-09,경의선,금릉,5736,5531,11267
2022-12-09,경의선,금촌,7391,7098,14489
2022-12-09,경의선,능곡,4229,3829,8058
2022-12-09,경의선,디지털미디어시티,3068,2758,5826
2022-12-09,경의선,문산,6226,5939,12165
2022-12-09,경의선,백마,7842,7424,15266
2022-12-09,경의선,서강대,2517,2548,5065
2022-12-09,경의선,서울역,5015,6739,11754
2022-12-09,경의선,수색,2855,3019,5874
2022-12-09,경의선,신촌,1038,1369,2407
2022-12-09,경의선,야당,9039,9196,18235
2022-12-09,경의선,운정,7762,7147,14909
2022-12-09,경의선,월롱,3491,2381,5872
2022-12-09,경의선,일산,10235,10065,20300
2022-12-09,경의선,임진강,11,3,14
2022-12-09,경의선,탄현,8907,8409,17316
2022-12-09,경의선,파주,1493,1017,2510
2022-12-09,경의선,풍산,6355,6073,12428
2022-12-09,경의선,행신,9070,9107,18177
2022-12-09,경의선,홍대입구,2094,2701,4795
2022-12-09,경의선,화전,2405,2164,4569
2022-12-09,경의선,효창공원앞,3403,3826,7229
2022-12-09,경인선,간석,6550,6120,12670
2022-12-09,경인선,개봉,23925,23295,47220
2022-12-09,경인선,구일,7561,7313,14874
2022-12-09,경인선,도원,3734,3692,7426
2022-12-09,경인선,도화,4628,4173,8801
2022-12-09,경인선,동암,17744,17966,35710
2022-12-09,경인선,동인천,15515,14569,30084
2022-12-09,경인선,백운,7526,7349,14875
2022-12-09,경인선,부개,9577,8755,18332
2022-12-09,경인선,부천,34979,35978,70957
2022-12-09,경인선,부평,31232,35397,66629
2022-12-09,경인선,소사,9226,8987,18213
2022-12-09,경인선,송내,30151,29711,59862
2022-12-09,경인선,역곡,30732,29885,60617
2022-12-09,경인선,오류동,12805,11570,24375
2022-12-09,경인선,온수,7657,7046,14703
2022-12-09,경인선,인천,4167,3124,7291
2022-12-09,경인선,제물포,12291,11387,23678
2022-12-09,경인선,주안,21636,19364,41000
2022-12-09,경인선,중동,10279,9461,19740
2022-12-09,경춘선,가평,1672,1819,3491
2022-12-09,경춘선,갈매,3300,2841,6141
2022-12-09,경춘선,강촌,367,393,760
2022-12-09,경춘선,굴봉산,90,105,195
2022-12-09,경춘선,금곡,1619,1674,3293
2022-12-09,경춘선,김유정,352,392,744
2022-12-09,경춘선,남춘천,3081,2875,5956
2022-12-09,경춘선,대성리,527,574,1101
2022-12-09,경춘선,마석,4246,4146,8392
2022-12-09,경춘선,백양리,275,284,559
2022-12-09,경춘선,별내,3662,3413,7075
2022-12-09,경춘선,사릉,2556,2484,5040
2022-12-09,경춘선,상천,222,224,446
2022-12-09,경춘선,신내,2428,2301,4729
2022-12-09,경춘선,천마산,1711,1623,3334
2022-12-09,경춘선,청평,1739,1786,3525
2022-12-09,경춘선,춘천,1971,1484,3455
2022-12-09,경춘선,퇴계원,3947,3641,7588
2022-12-09,경춘선,평내호평,6662,6749,13411
2022-12-09,공항철도,검암,7378,7424,14802
2022-12-09,공항철도,계양,13473,12205,25678
2022-12-09,공항철도,공덕,2851,3907,6758
2022-12-09,공항철도,공항화물청사,2411,2433,4844
2022-12-09,공항철도,김포공항,12191,6527,18718
2022-12-09,공항철도,디지털미디어시티,15331,14402,29733
2022-12-09,공항철도,마곡나루,11303,10319,21622
2022-12-09,공항철도,서울역,13315,11927,25242
2022-12-09,공항철도,영종,3973,4174,8147
2022-12-09,공항철도,운서,9341,9485,18826
2022-12-09,공항철도,인천공항1터미널,11035,10359,21394
2022-12-09,공항철도,인천공항2터미널,4138,3366,7504
2022-12-09,공항철도,청라국제도시,8092,7678,15770
2022-12-09,공항철도,홍대입구,13340,14038,27378
2022-12-09,과천선,경마공원,7211,7302,14513
2022-12-09,과천선,과천,7056,6547,13603
2022-12-09,과천선,대공원,3486,3635,7121
2022-12-09,과천선,범계,29385,30549,59934
2022-12-09,과천선,선바위,9699,8215,17914
2022-12-09,과천선,인덕원,28081,28681,56762
2022-12-09,과천선,정부과천청사,12107,12114,24221
2022-12-09,과천선,평촌,19666,19342,39008
2022-12-09,분당선,가천대,11944,11948,23892
2022-12-09,분당선,강남구청,10938,12378,23316
2022-12-09,분당선,개포동,4776,4894,9670
2022-12-09,분당선,구룡,2794,2469,5263
2022-12-09,분당선,구성,5915,6163,12078
2022-12-09,분당선,기흥,12049,11460,23509
2022-12-09,분당선,대모산입구,5828,5091,10919
2022-12-09,분당선,도곡,8509,8329,16838
2022-12-09,분당선,망포,17876,16485,34361
2022-12-09,분당선,매교,5265,5242,10507
2022-12-09,분당선,매탄권선,6266,5946,12212
2022-12-09,분당선,모란,28114,29720,57834
2022-12-09,분당선,미금,17634,18975,36609
2022-12-09,분당선,보정,3098,2791,5889
2022-12-09,분당선,상갈,6392,5896,12288
2022-12-09,분당선,서울숲,12525,13017,25542
2022-12-09,분당선,서현,29050,29537,58587
2022-12-09,분당선,선릉,14827,23087,37914
2022-12-09,분당선,선정릉,8706,9112,17818
2022-12-09,분당선,수내,16174,15873,32047
2022-12-09,분당선,수서,16559,17525,34084
2022-12-09,분당선,수원,9220,8203,17423
2022-12-09,분당선,수원시청,14643,17290,31933
2022-12-09,분당선,신갈,5501,5342,10843
2022-12-09,분당선,압구정로데오,22606,26939,49545
2022-12-09,분당선,야탑,30254,32024,62278
2022-12-09,분당선,영통,10141,10117,20258
2022-12-09,분당선,오리,13169,10630,23799
2022-12-09,분당선,이매,6852,6339,13191
2022-12-09,분당선,정자,21688,22967,44655
2022-12-09,분당선,죽전,16462,17682,34144
2022-12-09,분당선,청명,5304,4845,10149
2022-12-09,분당선,태평,15323,14557,29880
2022-12-09,분당선,한티,16146,16700,32846
2022-12-09,수인선,고색,5578,4991,10569
2022-12-09,수인선,남동인더스파크,2274,2634,4908
2022-12-09,수인선,달월,121,84,205
2022-12-09,수인선,사리,6054,5150,11204
2022-12-09,수인선,소래포구,5733,5494,11227
2022-12-09,수인선,송도,2743,2542,5285
2022-12-09,수인선,숭의,4532,4136,8668
2022-12-09,수인선,신포,2108,2224,4332
2022-12-09,수인선,야목,430,311,741
2022-12-09,수인선,어천,1298,1119,2417
2022-12-09,수인선,연수,5390,5406,10796
2022-12-09,수인선,오목천,4609,3945,8554
2022-12-09,수인선,원인재,4927,5036,9963
2022-12-09,수인선,월곶,3068,2790,5858
2022-12-09,수인선,인천,1120,1805,2925
2022-12-09,수인선,인천논현,6284,6615,12899
2022-12-09,수인선,인하대,7575,7107,14682
2022-12-09,수인선,호구포,4543,4690,9233
2022-12-09,신림선,관악산,2677,2604,5281
2022-12-09,신림선,당곡,4510,4247,8757
2022-12-09,신림선,대방,2990,2177,5167
2022-12-09,신림선,보라매,3722,3369,7091
2022-12-09,신림선,보라매공원,2045,2159,4204
2022-12-09,신림선,보라매병원,7206,7341,14547
2022-12-09,신림선,샛강,2717,3482,6199
2022-12-09,신림선,서울대벤처타운,8664,8030,16694
2022-12-09,신림선,서울지방병무청,2736,2890,5626
2022-12-09,신림선,서원,3450,2761,6211
2022-12-09,신림선,신림,1806,2489,4295
2022-12-09,안산선,고잔,10054,9537,19591
2022-12-09,안산선,대야미,5571,4838,10409
2022-12-09,안산선,반월,5030,4667,9697
2022-12-09,안산선,산본,18082,19580,37662
2022-12-09,안산선,상록수,17548,17649,35197
2022-12-09,안산선,수리산,4540,3582,8122
2022-12-09,안산선,신길온천,2066,1896,3962
2022-12-09,안산선,안산,12450,11452,23902
2022-12-09,안산선,오이도,9370,9342,18712
2022-12-09,안산선,정왕,11146,10860,22006
2022-12-09,안산선,중앙,20882,22594,43476
2022-12-09,안산선,초지,5692,5762,11454
2022-12-09,안산선,한대앞,11082,11095,22177
2022-12-09,우이신설선,4.19민주묘지,3610,3373,6983
2022-12-09,우이신설선,가오리,4584,4327,8911
2022-12-09,우이신설선,보문,1668,1692,3360
2022-12-09,우이신설선,북한산보국문,7006,6277,13283
2022-12-09,우이신설선,북한산우이,2892,2515,5407
2022-12-09,우이신설선,삼양,2107,2224,4331
2022-12-09,우이신설선,삼양사거리,2697,2693,5390
2022-12-09,우이신설선,성신여대입구,3726,4309,8035
2022-12-09,우이신설선,솔밭공원,2763,2538,5301
2022-12-09,우이신설선,솔샘,6475,5795,12270
2022-12-09,우이신설선,신설동,2501,2462,4963
2022-12-09,우이신설선,정릉,5132,4719,9851
2022-12-09,우이신설선,화계,3730,3388,7118
2022-12-09,일산선,대곡,2335,1734,4069
2022-12-09,일산선,대화,14931,11491,26422
2022-12-09,일산선,마두,8462,8654,17116
2022-12-09,일산선,백석,10843,10913,21756
2022-12-09,일산선,삼송,21761,20643,42404
2022-12-09,일산선,원당,12281,11465,23746
2022-12-09,일산선,원흥,13071,12121,25192
2022-12-09,일산선,정발산,8379,9067,17446
2022-12-09,일산선,주엽,10201,10212,20413
2022-12-09,일산선,화정,18785,19103,37888
2022-12-09,장항선,배방,1376,1336,2712
2022-12-09,장항선,봉명,1523,1449,2972
2022-12-09,장항선,신창,3164,2066,5230
2022-12-09,장항선,쌍용,3040,2749,5789
2022-12-09,장항선,아산,4648,4731,9379
2022-12-09,장항선,온양온천,5730,5923,11653
2022-12-09,장항선,탕정,1433,1189,2622
2022-12-09,중앙선,구리,14861,15342,30203
2022-12-09,중앙선,국수,857,829,1686
2022-12-09,중앙선,덕소,6104,6029,12133
2022-12-09,중앙선,도농,12939,11538,24477
2022-12-09,중앙선,도심,2701,2146,4847
2022-12-09,중앙선,망우,8529,8221,16750
2022-12-09,중앙선,상봉,6494,6427,12921
2022-12-09,중앙선,신원,189,176,365
2022-12-09,중앙선,아신,637,623,1260
2022-12-09,중앙선,양수,2109,2108,4217
2022-12-09,중앙선,양원,3338,3154,6492
2022-12-09,중앙선,양정,724,654,1378
2022-12-09,중앙선,양평,3187,3261,6448
2022-12-09,중앙선,오빈,344,346,690
2022-12-09,중앙선,용문,1789,1874,3663
2022-12-09,중앙선,운길산,685,661,1346
2022-12-09,중앙선,원덕,389,395,784
2022-12-09,중앙선,중랑,6175,5848,12023
2022-12-09,중앙선,지평,61,60,121
2022-12-09,중앙선,팔당,870,948,1818
2022-12-09,중앙선,회기,29377,27131,56508
2022-12-12,1호선,동대문,11470,10848,22318
2022-12-12,1호선,동묘앞,7990,8185,16175
2022-12-12,1호선,서울역,53062,50958,104020
2022-12-12,1호선,시청,26455,26303,52758
2022-12-12,1호선,신설동,14303,14006,28309
2022-12-12,1호선,제기동,18057,18490,36547
2022-12-12,1호선,종각,41575,39721,81296
2022-12-12,1호선,종로3가,25935,23961,49896
2022-12-12,1호선,종로5가,25344,24632,49976
2022-12-12,1호선,청량리,20406,20554,40960
2022-12-12,2호선,강남,83018,78768,161786
2022-12-12,2호선,강변,31955,30097,62052
2022-12-12,2호선,건대입구,34193,36227,70420
2022-12-12,2호선,교대,36846,41795,78641
2022-12-12,2호선,구로디지털단지,61890,61388,123278
2022-12-12,2호선,구의,24806,24670,49476
2022-12-12,2호선,낙성대,27863,27892,55755
2022-12-12,2호선,당산,18912,22269,41181
2022-12-12,2호선,대림,24979,25201,50180
2022-12-12,2호선,도림천,1482,1617,3099
2022-12-12,2호선,동대문역사문화공원,13242,15393,28635
2022-12-12,2호선,뚝섬,22214,23677,45891
2022-12-12,2호선,문래,23231,23813,47044
2022-12-12,2호선,방배,20199,20917,41116
2022-12-12,2호선,봉천,25450,23923,49373
2022-12-12,2호선,사당,40593,43441,84034
2022-12-12,2호선,삼성,56759,56888,113647
2022-12-12,2호선,상왕십리,15230,15049,30279
2022-12-12,2호선,서울대입구,47717,46879,94596
2022-12-12,2호선,서초,23930,22859,46789
2022-12-12,2호선,선릉,62349,55418,117767
2022-12-12,2호선,성수,39942,42521,82463
2022-12-12,2호선,시청,27001,25183,52184
2022-12-12,2호선,신답,1811,2185,3996
2022-12-12,2호선,신당,14543,14931,29474
2022-12-12,2호선,신대방,25868,25372,51240
2022-12-12,2호선,신도림,50507,49001,99508
2022-12-12,2호선,신림,58370,56383,114753
2022-12-12,2호선,신설동,3824,3713,7537
2022-12-12,2호선,신정네거리,11193,11571,22764
2022-12-12,2호선,신촌,35898,36827,72725
2022-12-12,2호선,아현,10902,10653,21555
2022-12-12,2호선,양천구청,7493,7950,15443
2022-12-12,2호선,역삼,59563,65679,125242
2022-12-12,2호선,영등포구청,23487,24074,47561
2022-12-12,2호선,왕십리,16337,13997,30334
2022-12-12,2호선,용답,3164,3285,6449
2022-12-12,2호선,용두,2629,2583,5212
2022-12-12,2호선,을지로3가,26150,26197,52347
2022-12-12,2호선,을지로4가,15185,15097,30282
2022-12-12,2호선,을지로입구,48535,49569,98104
2022-12-12,2호선,이대,16768,18475,35243
2022-12-12,2호선,잠실,78496,77584,156080
2022-12-12,2호선,잠실나루,16084,15756,31840
2022-12-12,2호선,잠실새내,23460,23143,46603
2022-12-12,2호선,종합운동장,7352,8597,15949
2022-12-12,2호선,충정로,10896,11520,22416
2022-12-12,2호선,한양대,14098,15426,29524
2022-12-12,2호선,합정,30448,32048,62496
2022-12-12,2호선,홍대입구,57798,59421,117219
2022-12-12,3호선,가락시장,9880,9734,19614
2022-12-12,3호선,경복궁,25178,25247,50425
2022-12-12,3호선,경찰병원,8366,8363,16729
2022-12-12,3호선,고속터미널,44308,42041,86349
2022-12-12,3호선,교대,16324,10587,26911
2022-12-12,3호선,구파발,22165,21320,43485
2022-12-12,3호선,금호,8277,7808,16085
2022-12-12,3호선,남부터미널,29960,30645,60605
2022-12-12,3호선,녹번,16789,15289,32078
2022-12-12,3호선,대청,11242,10412,21654
2022-12-12,3호선,대치,11508,11660,23168
2022-12-12,3호선,도곡,5718,5664,11382
2022-12-12,3호선,독립문,6981,7363,14344
2022-12-12,3호선,동대입구,10461,11341,21802
2022-12-12,3호선,매봉,13631,13054,26685
2022-12-12,3호선,무악재,4351,4449,8800
2022-12-12,3호선,불광,17128,17876,35004
2022-12-12,3호선,수서,19050,19753,38803
2022-12-12,3호선,신사,30126,30867,60993
2022-12-12,3호선,안국,25876,25697,51573
2022-12-12,3호선,압구정,34109,36681,70790
2022-12-12,3호선,약수,13730,13669,27399
2022-12-12,3호선,양재,41475,44470,85945
2022-12-12,3호선,연신내,36728,34709,71437
2022-12-12,3호선,오금,6806,6072,12878
2022-12-12,3호선,옥수,9340,9631,18971
2022-12-12,3호선,을지로3가,12450,11883,24333
2022-12-12,3호선,일원,11507,11272,22779
2022-12-12,3호선,잠원,5237,5181,10418
2022-12-12,3호선,종로3가,10639,11855,22494
2022-12-12,3호선,지축,6423,6336,12759
2022-12-12,3호선,학여울,1928,1995,3923
2022-12-12,3호선,홍제,18772,18230,37002
2022-12-12,4호선,길음,22482,22874,45356
2022-12-12,4호선,남태령,1384,1635,3019
2022-12-12,4호선,노원,19049,21461,40510
2022-12-12,4호선,당고개,9785,8828,18613
2022-12-12,4호선,동대문,21327,21514,42841
2022-12-12,4호선,동대문역사문화공원,17262,14996,32258
2022-12-12,4호선,동작,1269,1331,2600
2022-12-12,4호선,명동,26785,27782,54567
2022-12-12,4호선,미아,15910,15654,31564
2022-12-12,4호선,미아사거리,28085,27985,56070
2022-12-12,4호선,사당,28015,23172,51187
2022-12-12,4호선,삼각지,5858,6612,12470
2022-12-12,4호선,상계,19904,18825,38729
2022-12-12,4호선,서울역,13041,19494,32535
2022-12-12,4호선,성신여대입구,21629,20990,42619
2022-12-12,4호선,수유,35298,35682,70980
2022-12-12,4호선,숙대입구,14974,13882,28856
2022-12-12,4호선,신용산,18353,18458,36811
2022-12-12,4호선,쌍문,30675,29092,59767
2022-12-12,4호선,이촌,10226,11050,21276
2022-12-12,4호선,창동,26025,27424,53449
2022-12-12,4호선,총신대입구,19733,21336,41069
2022-12-12,4호선,충무로,31541,31864,63405
2022-12-12,4호선,한성대입구,13885,14482,28367
2022-12-12,4호선,혜화,34847,34142,68989
2022-12-12,4호선,회현,28755,28492,57247
2022-12-12,5호선,강동,19865,19396,39261
2022-12-12,5호선,강일,5596,5161,10757
2022-12-12,5호선,개롱,6842,7323,14165
2022-12-12,5호선,개화산,6128,5810,11938
2022-12-12,5호선,거여,10960,10725,21685
2022-12-12,5호선,고덕,10734,10543,21277
2022-12-12,5호선,공덕,15609,16471,32080
2022-12-12,5호선,광나루,14575,13309,27884
2022-12-12,5호선,광화문,34945,35806,70751
2022-12-12,5호선,군자,11662,12864,24526
2022-12-12,5호선,굽은다리,10097,9786,19883
2022-12-12,5호선,길동,8375,8833,17208
2022-12-12,5호선,김포공항,7556,7180,14736
2022-12-12,5호선,까치산,30305,29490,59795
2022-12-12,5호선,답십리,16810,15563,32373
2022-12-12,5호선,동대문역사문화공원,3535,3876,7411
2022-12-12,5호선,둔촌동,8955,8885,17840
2022-12-12,5호선,마곡,11769,11648,23417
2022-12-12,5호선,마장,6339,6192,12531
2022-12-12,5호선,마천,8045,7790,15835
2022-12-12,5호선,마포,16117,16406,32523
2022-12-12,5호선,명일,9163,9610,18773
2022-12-12,5호선,목동,17442,19122,36564
2022-12-12,5호선,미사,17275,17562,34837
2022-12-12,5호선,발산,22303,22746,45049
2022-12-12,5호선,방이,7441,7775,15216
2022-12-12,5호선,방화,7117,6941,14058
2022-12-12,5호선,상일동,15861,15087,30948
2022-12-12,5호선,서대문,22778,22596,45374
2022-12-12,5호선,송정,6987,6536,13523
2022-12-12,5호선,신금호,6844,7245,14089
2022-12-12,5호선,신길,4521,5072,9593
2022-12-12,5호선,신정,14645,12264,26909
2022-12-12,5호선,아차산,14744,14358,29102
2022-12-12,5호선,애오개,7191,7398,14589
2022-12-12,5호선,양평,7986,8069,16055
2022-12-12,5호선,여의나루,10874,13909,24783
2022-12-12,5호선,여의도,34423,33819,68242
2022-12-12,5호선,영등포구청,4443,4600,9043
2022-12-12,5호선,영등포시장,10507,11010,21517
2022-12-12,5호선,오금,4000,4081,8081
2022-12-12,5호선,오목교,22580,23790,46370
2022-12-12,5호선,올림픽공원,4685,3995,8680
2022-12-12,5호선,왕십리,4832,5361,10193
2022-12-12,5호선,우장산,15433,15370,30803
2022-12-12,5호선,을지로4가,7080,7014,14094
2022-12-12,5호선,장한평,19695,19583,39278
2022-12-12,5호선,종로3가,13303,12809,26112
2022-12-12,5호선,천호,18638,18882,37520
2022-12-12,5호선,청구,4265,3822,8087
2022-12-12,5호선,충정로,5283,5379,10662
2022-12-12,5호선,하남검단산,6257,6042,12299
2022-12-12,5호선,하남시청,7756,7479,15235
2022-12-12,5호선,하남풍산,4456,4441,8897
2022-12-12,5호선,행당,8646,8004,16650
2022-12-12,5호선,화곡,30424,28730,59154
2022-12-12,6호선,고려대,9900,9622,19522
2022-12-12,6호선,공덕,20197,19619,39816
2022-12-12,6호선,광흥창,9959,9763,19722
2022-12-12,6호선,구산,8323,6423,14746
2022-12-12,6호선,녹사평,4570,4455,9025
2022-12-12,6호선,대흥,9771,10219,19990
2022-12-12,6호선,독바위,2903,3224,6127
2022-12-12,6호선,돌곶이,11158,10538,21696
2022-12-12,6호선,동묘앞,7931,8381,16312
2022-12-12,6호선,디지털미디어시티,15588,17399,32987
2022-12-12,6호선,마포구청,15400,13956,29356
2022-12-12,6호선,망원,13996,14859,28855
2022-12-12,6호선,버티고개,2418,2369,4787
2022-12-12,6호선,보문,8066,7549,15615
2022-12-12,6호선,봉화산,9607,9201,18808
2022-12-12,6호선,불광,4399,4421,8820
2022-12-12,6호선,삼각지,7151,6457,13608
2022-12-12,6호선,상수,9397,10524,19921
2022-12-12,6호선,상월곡,7131,6825,13956
2022-12-12,6호선,새절,13496,12873,26369
2022-12-12,6호선,석계,13285,14295,27580
2022-12-12,6호선,신당,8384,9007,17391
2022-12-12,6호선,안암,14324,14858,29182
2022-12-12,6호선,약수,3931,3908,7839
2022-12-12,6호선,역촌,4009,4751,8760
2022-12-12,6호선,월곡,13827,13361,27188
2022-12-12,6호선,월드컵경기장,4148,4323,8471
2022-12-12,6호선,응암,18572,18829,37401
2022-12-12,6호선,이태원,9176,9296,18472
2022-12-12,6호선,증산,10633,10645,21278
2022-12-12,6호선,창신,3871,3385,7256
2022-12-12,6호선,청구,3909,4091,8000
2022-12-12,6호선,태릉입구,6065,6694,12759
2022-12-12,6호선,한강진,7058,7951,15009
2022-12-12,6호선,합정,12978,12889,25867
2022-12-12,6호선,화랑대,13547,10573,24120
2022-12-12,6호선,효창공원앞,8045,7803,15848
2022-12-12,7호선,가산디지털단지,49259,48341,97600
2022-12-12,7호선,강남구청,17601,19277,36878
2022-12-12,7호선,건대입구,13940,14626,28566
2022-12-12,7호선,고속터미널,16794,14089,30883
2022-12-12,7호선,공릉,12594,12722,25316
2022-12-12,7호선,광명사거리,22223,21942,44165
2022-12-12,7호선,군자,15708,12757,28465
2022-12-12,7호선,남구로,16617,17524,34141
2022-12-12,7호선,남성,12041,11408,23449
2022-12-12,7호선,내방,15789,16092,31881
2022-12-12,7호선,노원,21294,21824,43118
2022-12-12,7호선,논현,19342,20235,39577
2022-12-12,7호선,대림,8435,8393,16828
2022-12-12,7호선,도봉산,9868,11023,20891
2022-12-12,7호선,뚝섬유원지,7318,7181,14499
2022-12-12,7호선,마들,13887,13292,27179
2022-12-12,7호선,먹골,10668,10705,21373
2022-12-12,7호선,면목,17061,16878,33939
2022-12-12,7호선,반포,6548,6451,12999
2022-12-12,7호선,보라매,7800,7866,15666
2022-12-12,7호선,사가정,16915,17144,34059
2022-12-12,7호선,상도,12889,12810,25699
2022-12-12,7호선,상봉,17587,16555,34142
2022-12-12,7호선,수락산,13597,13398,26995
2022-12-12,7호선,숭실대입구,15691,16025,31716
2022-12-12,7호선,신대방삼거리,15858,15464,31322
2022-12-12,7호선,신풍,12188,11697,23885
2022-12-12,7호선,어린이대공원,18052,18469,36521
2022-12-12,7호선,온수,11533,10863,22396
2022-12-12,7호선,용마산,6232,6116,12348
2022-12-12,7호선,이수,17078,15873,32951
2022-12-12,7호선,장승배기,9710,9827,19537
2022-12-12,7호선,장암,2551,971,3522
2022-12-12,7호선,중계,15955,14729,30684
2022-12-12,7호선,중곡,11904,11246,23150
2022-12-12,7호선,중화,11291,11265,22556
2022-12-12,7호선,천왕,12240,11669,23909
2022-12-12,7호선,철산,22880,23361,46241
2022-12-12,7호선,청담,20874,23473,44347
2022-12-12,7호선,태릉입구,9579,9041,18620
2022-12-12,7호선,하계,19628,18665,38293
2022-12-12,7호선,학동,26332,27828,54160
2022-12-12,8호선,가락시장,8286,9150,17436
2022-12-12,8호선,강동구청,11684,12014,23698
2022-12-12,8호선,남위례,6454,6526,12980
2022-12-12,8호선,남한산성입구,15436,14441,29877
2022-12-12,8호선,단대오거리,12040,11660,23700
2022-12-12,8호선,모란,4644,3466,8110
2022-12-12,8호선,몽촌토성,6851,7070,13921
2022-12-12,8호선,문정,23589,24462,48051
2022-12-12,8호선,복정,10213,8594,18807
2022-12-12,8호선,산성,5383,5402,10785
2022-12-12,8호선,석촌,8040,9307,17347
2022-12-12,8호선,송파,9693,9888,19581
2022-12-12,8호선,수진,5685,5218,10903
2022-12-12,8호선,신흥,5178,5446,10624
2022-12-12,8호선,암사,20493,18288,38781
2022-12-12,8호선,잠실,16263,18341,34604
2022-12-12,8호선,장지,18251,17369,35620
2022-12-12,8호선,천호,15266,17187,32453
2022-12-12,9호선,가양,22884,22461,45345
2022-12-12,9호선,개화,2922,1974,4896
2022-12-12,9호선,고속터미널,13419,17470,30889
2022-12-12,9호선,공항시장,3025,3369,6394
2022-12-12,9호선,구반포,1365,1422,2787
2022-12-12,9호선,국회의사당,18518,18477,36995
2022-12-12,9호선,김포공항,7011,10154,17165
2022-12-12,9호선,노들,4870,4178,9048
2022-12-12,9호선,노량진,27231,26607,53838
2022-12-12,9호선,당산,19987,20219,40206
2022-12-12,9호선,동작,1654,1222,2876
2022-12-12,9호선,등촌,12544,12312,24856
2022-12-12,9호선,마곡나루,13128,12759,25887
2022-12-12,9호선,사평,4010,4077,8087
2022-12-12,9호선,샛강,7049,6739,13788
2022-12-12,9호선,선유도,9598,8970,18568
2022-12-12,9호선,신논현,30733,29659,60392
2022-12-12,9호선,신목동,4758,4158,8916
2022-12-12,9호선,신반포,3851,3861,7712
2022-12-12,9호선,신방화,7351,7434,14785
2022-12-12,9호선,양천향교,10245,10794,21039
2022-12-12,9호선,여의도,33122,30766,63888
2022-12-12,9호선,염창,18814,18192,37006
2022-12-12,9호선,증미,7726,7442,15168
2022-12-12,9호선,흑석,9906,10421,20327
2022-12-12,9호선2~3단계,둔촌오륜,1193,1170,2363
2022-12-12,9호선2~3단계,봉은사,18990,19116,38106
2022-12-12,9호선2~3단계,삼성중앙,8456,8803,17259
2022-12-12,9호선2~3단계,삼전,7480,7361,14841
2022-12-12,9호선2~3단계,석촌,9302,8132,17434
2022-12-12,9호선2~3단계,석촌고분,6936,7069,14005
2022-12-12,9호선2~3단계,선정릉,10578,11557,22135
2022-12-12,9호선2~3단계,송파나루,5290,5685,10975
2022-12-12,9호선2~3단계,언주,11969,12071,24040
2022-12-12,9호선2~3단계,올림픽공원,6543,6578,13121
2022-12-12,9호선2~3단계,종합운동장,4707,4649,9356
2022-12-12,9호선2~3단계,중앙보훈병원,12699,11232,23931
2022-12-12,9호선2~3단계,한성백제,2888,2631,5519
2022-12-12,경강선,경기광주,8713,8068,16781
2022-12-12,경강선,곤지암,2508,2406,4914
2022-12-12,경강선,부발,2217,2160,4377
2022-12-12,경강선,삼동,2755,2558,5313
2022-12-12,경강선,세종대왕릉,379,364,743
2022-12-12,경강선,신둔도예촌,1717,1619,3336
2022-12-12,경강선,여주,2671,2639,5310
2022-12-12,경강선,이매,1299,1142,2441
2022-12-12,경강선,이천,2803,2801,5604
2022-12-12,경강선,초월,3562,3467,7029
2022-12-12,경강선,판교,5845,5659,11504
2022-12-12,경부선,가산디지털단지,18913,22211,41124
2022-12-12,경부선,관악,7990,7435,15425
2022-12-12,경부선,광명,3774,3126,6900
2022-12-12,경부선,구로,19483,19281,38764
2022-12-12,경부선,군포,8284,7926,16210
2022-12-12,경부선,금정,31094,32314,63408
2022-12-12,경부선,금천구청,12292,12236,24528
2022-12-12,경부선,남영,10068,11070,21138
2022-12-12,경부선,노량진,8772,9010,17782
2022-12-12,경부선,당정,7122,6732,13854
2022-12-12,경부선,대방,11764,13125,24889
2022-12-12,경부선,독산,19444,20062,39506
2022-12-12,경부선,두정,7434,8808,16242
2022-12-12,경부선,명학,11073,10760,21833
2022-12-12,경부선,병점,16980,16817,33797
2022-12-12,경부선,서동탄,1498,1238,2736
2022-12-12,경부선,서울역,8291,2527,10818
2022-12-12,경부선,서정리,8266,8194,16460
2022-12-12,경부선,석수,9942,9025,18967
2022-12-12,경부선,성균관대,16100,15893,31993
2022-12-12,경부선,성환,5003,5153,10156
2022-12-12,경부선,세류,3319,2905,6224
2022-12-12,경부선,세마,3007,2906,5913
2022-12-12,경부선,송탄,4626,4594,9220
2022-12-12,경부선,수원,36910,37887,74797
2022-12-12,경부선,신길,9293,8216,17509
2022-12-12,경부선,신도림,4108,4347,8455
2022-12-12,경부선,안양,27500,26748,54248
2022-12-12,경부선,영등포,39503,40462,79965
2022-12-12,경부선,오산,10355,10676,21031
2022-12-12,경부선,오산대,3967,3687,7654
2022-12-12,경부선,용산,37256,37943,75199
2022-12-12,경부선,의왕,9686,9485,19171
2022-12-12,경부선,직산,916,905,1821
2022-12-12,경부선,진위,2019,1759,3778
2022-12-12,경부선,천안,6935,6337,13272
2022-12-12,경부선,평택,13210,13441,26651
2022-12-12,경부선,평택지제,4518,4503,9021
2022-12-12,경부선,화서,8974,8567,17541
2022-12-12,경원선,가능,7115,6864,13979
2022-12-12,경원선,광운대,9185,8954,18139
2022-12-12,경원선,녹양,4732,4459,9191
2022-12-12,경원선,녹천,4953,4219,9172
2022-12-12,경원선,덕계,3551,3135,6686
2022-12-12,경원선,덕정,6636,6200,12836
2022-12-12,경원선,도봉,6293,6040,12333
2022-12-12,경원선,도봉산,7263,4664,11927
2022-12-12,경원선,동두천,2631,2811,5442
2022-12-12,경원선,동두천중앙,3223,3117,6340
2022-12-12,경원선,망월사,9646,9626,19272
2022-12-12,경원선,방학,10233,10023,20256
2022-12-12,경원선,보산,1534,1344,2878
2022-12-12,경원선,서빙고,2182,1911,4093
2022-12-12,경원선,석계,8684,9639,18323
2022-12-12,경원선,소요산,2267,1854,4121
2022-12-12,경원선,신이문,9030,8480,17510
2022-12-12,경원선,양주,8014,7612,15626
2022-12-12,경원선,옥수,56,52,108
2022-12-12,경원선,왕십리,15417,16292,31709
2022-12-12,경원선,외대앞,9528,9593,19121
2022-12-12,경원선,월계,8315,7621,15936
2022-12-12,경원선,응봉,2116,1755,3871
2022-12-12,경원선,의정부,18672,18944,37616
2022-12-12,경원선,이촌,4017,3193,7210
2022-12-12,경원선,지행,6919,6793,13712
2022-12-12,경원선,청량리,15775,16595,32370
2022-12-12,경원선,한남,4189,4059,8248
2022-12-12,경원선,회룡,13409,12988,26397
2022-12-12,경의선,가좌,6395,6187,12582
2022-12-12,경의선,강매,3512,2959,6471
2022-12-12,경의선,곡산,614,651,1265
2022-12-12,경의선,공덕,4000,3565,7565
2022-12-12,경의선,금릉,5316,5051,10367
2022-12-12,경의선,금촌,6708,6542,13250
2022-12-12,경의선,능곡,4138,3701,7839
2022-12-12,경의선,디지털미디어시티,2936,2609,5545
2022-12-12,경의선,문산,5323,5402,10725
2022-12-12,경의선,백마,7624,7240,14864
2022-12-12,경의선,서강대,2328,2401,4729
2022-12-12,경의선,서울역,4881,6431,11312
2022-12-12,경의선,수색,2807,3072,5879
2022-12-12,경의선,신촌,1019,1363,2382
2022-12-12,경의선,야당,8337,8054,16391
2022-12-12,경의선,운정,7558,6926,14484
2022-12-12,경의선,월롱,2982,2761,5743
2022-12-12,경의선,일산,10032,9807,19839
2022-12-12,경의선,임진강,7,4,11
2022-12-12,경의선,탄현,8565,8287,16852
2022-12-12,경의선,파주,1650,1245,2895
2022-12-12,경의선,풍산,5997,5560,11557
2022-12-12,경의선,행신,8736,8883,17619
2022-12-12,경의선,홍대입구,1676,2018,3694
2022-12-12,경의선,화전,3074,2772,5846
2022-12-12,경의선,효창공원앞,3485,3824,7309
2022-12-12,경인선,간석,6186,5858,12044
2022-12-12,경인선,개봉,23048,23206,46254
2022-12-12,경인선,구일,7226,7303,14529
2022-12-12,경인선,도원,3291,3337,6628
2022-12-12,경인선,도화,4156,3796,7952
2022-12-12,경인선,동암,16469,16093,32562
2022-12-12,경인선,동인천,13723,12904,26627
2022-12-12,경인선,백운,6975,6916,13891
2022-12-12,경인선,부개,9103,8384,17487
2022-12-12,경인선,부천,33267,32733,66000
2022-12-12,경인선,부평,28177,29381,57558
2022-12-12,경인선,소사,8950,8786,17736
2022-12-12,경인선,송내,28548,28392,56940
2022-12-12,경인선,역곡,29447,29107,58554
2022-12-12,경인선,오류동,12210,11465,23675
2022-12-12,경인선,온수,7325,7138,14463
2022-12-12,경인선,인천,3196,2324,5520
2022-12-12,경인선,제물포,11152,10733,21885
2022-12-12,경인선,주안,19471,17742,37213
2022-12-12,경인선,중동,9823,9230,19053
2022-12-12,경춘선,가평,1714,1642,3356
2022-12-12,경춘선,갈매,3211,2754,5965
2022-12-12,경춘선,강촌,434,396,830
2022-12-12,경춘선,굴봉산,114,119,233
2022-12-12,경춘선,금곡,1557,1477,3034
2022-12-12,경춘선,김유정,280,307,587
2022-12-12,경춘선,남춘천,2733,3000,5733
2022-12-12,경춘선,대성리,456,422,878
2022-12-12,경춘선,마석,4238,4083,8321
2022-12-12,경춘선,백양리,251,260,511
2022-12-12,경춘선,별내,3298,3184,6482
2022-12-12,경춘선,사릉,2619,2415,5034
2022-12-12,경춘선,상천,223,187,410
2022-12-12,경춘선,신내,2464,2230,4694
2022-12-12,경춘선,천마산,1802,1607,3409
2022-12-12,경춘선,청평,1647,1466,3113
2022-12-12,경춘선,춘천,1413,1412,2825
2022-12-12,경춘선,퇴계원,3807,3509,7316
2022-12-12,경춘선,평내호평,6748,6448,13196
2022-12-12,공항철도,검암,6964,6662,13626
2022-12-12,공항철도,계양,13142,12090,25232
2022-12-12,공항철도,공덕,2663,3541,6204
2022-12-12,공항철도,공항화물청사,2346,2530,4876
2022-12-12,공항철도,김포공항,11269,6551,17820
2022-12-12,공항철도,디지털미디어시티,15429,14266,29695
2022-12-12,공항철도,마곡나루,10330,9998,20328
2022-12-12,공항철도,서울역,10989,9379,20368
2022-12-12,공항철도,영종,3730,3775,7505
2022-12-12,공항철도,운서,8427,8777,17204
2022-12-12,공항철도,인천공항1터미널,11071,10184,21255
2022-12-12,공항철도,인천공항2터미널,4396,3988,8384
2022-12-12,공항철도,청라국제도시,7318,6880,14198
2022-12-12,공항철도,홍대입구,10904,10904,21808
2022-12-12,과천선,경마공원,887,934,1821
2022-12-12,과천선,과천,6202,6719,12921
2022-12-12,과천선,대공원,1976,1994,3970
2022-12-12,과천선,범계,25274,26053,51327
2022-12-12,과천선,선바위,8099,8015,16114
2022-12-12,과천선,인덕원,23764,25178,48942
2022-12-12,과천선,정부과천청사,10730,10731,21461
2022-12-12,과천선,평촌,17784,16858,34642
2022-12-12,분당선,가천대,9497,10431,19928
2022-12-12,분당선,강남구청,10476,11987,22463
2022-12-12,분당선,개포동,4431,4548,8979
2022-12-12,분당선,구룡,2652,2541,5193
2022-12-12,분당선,구성,5653,5962,11615
2022-12-12,분당선,기흥,11421,11338,22759
2022-12-12,분당선,대모산입구,5277,5006,10283
2022-12-12,분당선,도곡,7966,8016,15982
2022-12-12,분당선,망포,16037,15586,31623
2022-12-12,분당선,매교,4850,4800,9650
2022-12-12,분당선,매탄권선,5587,5495,11082
2022-12-12,분당선,모란,20441,20890,41331
2022-12-12,분당선,미금,16436,17629,34065
2022-12-12,분당선,보정,2898,2608,5506
2022-12-12,분당선,복정,2,0,2
2022-12-12,분당선,상갈,5931,5671,11602
2022-12-12,분당선,서울숲,11103,11300,22403
2022-12-12,분당선,서현,25645,25968,51613
2022-12-12,분당선,선릉,14829,22593,37422
2022-12-12,분당선,선정릉,8587,9086,17673
2022-12-12,분당선,수내,15184,15061,30245
2022-12-12,분당선,수서,14882,15540,30422
2022-12-12,분당선,수원,8246,7029,15275
2022-12-12,분당선,수원시청,13224,13955,27179
2022-12-12,분당선,신갈,5544,5428,10972
2022-12-12,분당선,압구정로데오,17912,19338,37250
2022-12-12,분당선,야탑,27755,28982,56737
2022-12-12,분당선,영통,9053,9259,18312
2022-12-12,분당선,오리,12352,10167,22519
2022-12-12,분당선,이매,5875,5726,11601
2022-12-12,분당선,정자,19659,20882,40541
2022-12-12,분당선,죽전,15068,15618,30686
2022-12-12,분당선,청명,4680,4659,9339
2022-12-12,분당선,태평,13880,13450,27330
2022-12-12,분당선,한티,15051,16293,31344
2022-12-12,수인선,고색,5394,4775,10169
2022-12-12,수인선,남동인더스파크,2286,2662,4948
2022-12-12,수인선,달월,102,74,176
2022-12-12,수인선,사리,5328,4631,9959
2022-12-12,수인선,소래포구,4905,4546,9451
2022-12-12,수인선,송도,2635,2501,5136
2022-12-12,수인선,숭의,4225,3890,8115
2022-12-12,수인선,신포,1820,1847,3667
2022-12-12,수인선,야목,400,309,709
2022-12-12,수인선,어천,1117,1112,2229
2022-12-12,수인선,연수,4693,4543,9236
2022-12-12,수인선,오목천,3943,3752,7695
2022-12-12,수인선,원인재,4508,5005,9513
2022-12-12,수인선,월곶,2862,2850,5712
2022-12-12,수인선,인천,972,1572,2544
2022-12-12,수인선,인천논현,5716,6071,11787
2022-12-12,수인선,인하대,6739,6487,13226
2022-12-12,수인선,호구포,4211,4356,8567
2022-12-12,신림선,관악산,2377,2457,4834
2022-12-12,신림선,당곡,4350,4421,8771
2022-12-12,신림선,대방,2513,2038,4551
2022-12-12,신림선,보라매,3599,3293,6892
2022-12-12,신림선,보라매공원,1956,2067,4023
2022-12-12,신림선,보라매병원,7828,7837,15665
2022-12-12,신림선,샛강,2814,3403,6217
2022-12-12,신림선,서울대벤처타운,7902,8078,15980
2022-12-12,신림선,서울지방병무청,2826,3290,6116
2022-12-12,신림선,서원,3330,3113,6443
2022-12-12,신림선,신림,1795,2406,4201
2022-12-12,안산선,고잔,9417,8690,18107
2022-12-12,안산선,대야미,4757,5213,9970
2022-12-12,안산선,반월,4573,5053,9626
2022-12-12,안산선,산본,15302,17346,32648
2022-12-12,안산선,상록수,16883,18086,34969
2022-12-12,안산선,수리산,3786,4709,8495
2022-12-12,안산선,신길온천,1920,1956,3876
2022-12-12,안산선,안산,11568,10944,22512
2022-12-12,안산선,오이도,8157,8518,16675
2022-12-12,안산선,정왕,9976,10072,20048
2022-12-12,안산선,중앙,17813,18593,36406
2022-12-12,안산선,초지,5528,5962,11490
2022-12-12,안산선,한대앞,10247,10756,21003
2022-12-12,우이신설선,4.19민주묘지,4118,4199,8317
2022-12-12,우이신설선,가오리,4395,4440,8835
2022-12-12,우이신설선,보문,1579,1635,3214
2022-12-12,우이신설선,북한산보국문,6330,6274,12604
2022-12-12,우이신설선,북한산우이,2763,2427,5190
2022-12-12,우이신설선,삼양,2069,2304,4373
2022-12-12,우이신설선,삼양사거리,2678,2642,5320
2022-12-12,우이신설선,성신여대입구,3734,4126,7860
2022-12-12,우이신설선,솔밭공원,2627,2457,5084
2022-12-12,우이신설선,솔샘,6356,6029,12385
2022-12-12,우이신설선,신설동,2449,2302,4751
2022-12-12,우이신설선,정릉,4887,4683,9570
2022-12-12,우이신설선,화계,3688,3504,7192
2022-12-12,일산선,대곡,2204,1665,3869
2022-12-12,일산선,대화,14521,11006,25527
2022-12-12,일산선,마두,8145,8329,16474
2022-12-12,일산선,백석,10192,10273,20465
2022-12-12,일산선,삼송,20613,20110,40723
2022-12-12,일산선,원당,11723,11038,22761
2022-12-12,일산선,원흥,12146,11501,23647
2022-12-12,일산선,정발산,6833,6795,13628
2022-12-12,일산선,주엽,9801,9795,19596
2022-12-12,일산선,지축,2,0,2
2022-12-12,일산선,화정,17337,17728,35065
2022-12-12,장항선,배방,1160,1097,2257
2022-12-12,장항선,봉명,1421,1372,2793
2022-12-12,장항선,신창,2073,2115,4188
2022-12-12,장항선,쌍용,2815,2867,5682
2022-12-12,장항선,아산,3951,3418,7369
2022-12-12,장항선,온양온천,4193,4252,8445
2022-12-12,장항선,탕정,1194,989,2183
2022-12-12,중앙선,구리,14020,14326,28346
2022-12-12,중앙선,국수,872,819,1691
2022-12-12,중앙선,덕소,5797,5712,11509
2022-12-12,중앙선,도농,12363,11078,23441
2022-12-12,중앙선,도심,2686,2107,4793
2022-12-12,중앙선,망우,7860,7832,15692
2022-12-12,중앙선,상봉,5949,5872,11821
2022-12-12,중앙선,신원,183,167,350
2022-12-12,중앙선,아신,521,571,1092
2022-12-12,중앙선,양수,1789,1752,3541
2022-12-12,중앙선,양원,3169,3179,6348
2022-12-12,중앙선,양정,700,579,1279
2022-12-12,중앙선,양평,2964,2904,5868
2022-12-12,중앙선,오빈,309,312,621
2022-12-12,중앙선,용문,1648,1621,3269
2022-12-12,중앙선,운길산,598,568,1166
2022-12-12,중앙선,원덕,408,377,785
2022-12-12,중앙선,중랑,5784,5528,11312
2022-12-12,중앙선,지평,77,65,142
2022-12-12,중앙선,팔당,770,780,1550
2022-12-12,중앙선,회기,28114,27868,55982
2022-12-13,1호선,동대문,11549,10983,22532
2022-12-13,1호선,동묘앞,7839,8083,15922
2022-12-13,1호선,서울역,53234,50857,104091
2022-12-13,1호선,시청,28772,28481,57253
2022-12-13,1호선,신설동,14532,14218,28750
2022-12-13,1호선,제기동,17699,18226,35925
2022-12-13,1호선,종각,43985,41758,85743
2022-12-13,1호선,종로3가,27284,25268,52552
2022-12-13,1호선,종로5가,26969,25851,52820
2022-12-13,1호선,청량리,21200,20848,42048
2022-12-13,2호선,강남,87279,82833,170112
2022-12-13,2호선,강변,32657,29908,62565
2022-12-13,2호선,건대입구,35576,38334,73910
2022-12-13,2호선,교대,39279,44429,83708
2022-12-13,2호선,구로디지털단지,65091,64505,129596
2022-12-13,2호선,구의,26645,26495,53140
2022-12-13,2호선,낙성대,29733,29446,59179
2022-12-13,2호선,당산,20325,24115,44440
2022-12-13,2호선,대림,25312,25978,51290
2022-12-13,2호선,도림천,1455,1591,3046
2022-12-13,2호선,동대문역사문화공원,14286,16044,30330
2022-12-13,2호선,뚝섬,23979,25650,49629
2022-12-13,2호선,문래,25115,25186,50301
2022-12-13,2호선,방배,21952,22784,44736
2022-12-13,2호선,봉천,26243,25245,51488
2022-12-13,2호선,사당,43568,46849,90417
2022-12-13,2호선,삼성,61879,61136,123015
2022-12-13,2호선,상왕십리,15901,15696,31597
2022-12-13,2호선,서울대입구,50605,49559,100164
2022-12-13,2호선,서초,25368,24368,49736
2022-12-13,2호선,선릉,64967,57449,122416
2022-12-13,2호선,성수,42799,45755,88554
2022-12-13,2호선,시청,29376,27286,56662
2022-12-13,2호선,신답,1892,2087,3979
2022-12-13,2호선,신당,15338,15801,31139
2022-12-13,2호선,신대방,27026,26702,53728
2022-12-13,2호선,신도림,52683,51532,104215
2022-12-13,2호선,신림,61175,59243,120418
2022-12-13,2호선,신설동,3723,3652,7375
2022-12-13,2호선,신정네거리,11587,12217,23804
2022-12-13,2호선,신촌,38393,38844,77237
2022-12-13,2호선,아현,11683,11380,23063
2022-12-13,2호선,양천구청,7663,8275,15938
2022-12-13,2호선,역삼,63641,69836,133477
2022-12-13,2호선,영등포구청,24472,24891,49363
2022-12-13,2호선,왕십리,17400,14491,31891
2022-12-13,2호선,용답,3120,3205,6325
2022-12-13,2호선,용두,2643,2794,5437
2022-12-13,2호선,을지로3가,27387,26942,54329
2022-12-13,2호선,을지로4가,15365,15608,30973
2022-12-13,2호선,을지로입구,51608,52514,104122
2022-12-13,2호선,이대,17718,19078,36796
2022-12-13,2호선,잠실,83919,82861,166780
2022-12-13,2호선,잠실나루,16928,16690,33618
2022-12-13,2호선,잠실새내,24933,24972,49905
2022-12-13,2호선,종합운동장,7615,8546,16161
2022-12-13,2호선,충정로,11160,12046,23206
2022-12-13,2호선,한양대,14301,15258,29559
2022-12-13,2호선,합정,32345,34272,66617
2022-12-13,2호선,홍대입구,61976,63524,125500
2022-12-13,3호선,가락시장,10330,10345,20675
2022-12-13,3호선,경복궁,23760,23169,46929
2022-12-13,3호선,경찰병원,8481,8467,16948
2022-12-13,3호선,고속터미널,45112,42351,87463
2022-12-13,3호선,교대,17331,11189,28520
2022-12-13,3호선,구파발,23352,22401,45753
2022-12-13,3호선,금호,8688,8271,16959
2022-12-13,3호선,남부터미널,31853,32060,63913
2022-12-13,3호선,녹번,17249,15969,33218
2022-12-13,3호선,대청,11623,10881,22504
2022-12-13,3호선,대치,11901,12396,24297
2022-12-13,3호선,도곡,5937,5855,11792
2022-12-13,3호선,독립문,7688,8048,15736
2022-12-13,3호선,동대입구,11100,11759,22859
2022-12-13,3호선,매봉,14756,14035,28791
2022-12-13,3호선,무악재,4555,4661,9216
2022-12-13,3호선,불광,17277,18673,35950
2022-12-13,3호선,수서,19600,19948,39548
2022-12-13,3호선,신사,32415,32864,65279
2022-12-13,3호선,안국,27663,27687,55350
2022-12-13,3호선,압구정,36731,39177,75908
2022-12-13,3호선,약수,14526,14291,28817
2022-12-13,3호선,양재,43501,46291,89792
2022-12-13,3호선,연신내,37988,36436,74424
2022-12-13,3호선,오금,7091,6430,13521
2022-12-13,3호선,옥수,9722,10148,19870
2022-12-13,3호선,을지로3가,12866,12470,25336
2022-12-13,3호선,일원,12172,11797,23969
2022-12-13,3호선,잠원,5553,5413,10966
2022-12-13,3호선,종로3가,11095,12538,23633
2022-12-13,3호선,지축,6690,6546,13236
2022-12-13,3호선,충무로,2,0,2
2022-12-13,3호선,학여울,2100,2163,4263
2022-12-13,3호선,홍제,19303,18750,38053
2022-12-13,4호선,길음,23357,23807,47164
2022-12-13,4호선,남태령,1451,1361,2812
2022-12-13,4호선,노원,20232,23192,43424
2022-12-13,4호선,당고개,9809,8776,18585
2022-12-13,4호선,동대문,21473,21882,43355
2022-12-13,4호선,동대문역사문화공원,18180,15736,33916
2022-12-13,4호선,동작,1263,1398,2661
2022-12-13,4호선,명동,28420,29728,58148
2022-12-13,4호선,미아,16111,15918,32029
2022-12-13,4호선,미아사거리,28850,29096,57946
2022-12-13,4호선,사당,29613,25348,54961
2022-12-13,4호선,삼각지,6356,7455,13811
2022-12-13,4호선,상계,20603,19493,40096
2022-12-13,4호선,서울역,13686,20075,33761
2022-12-13,4호선,성신여대입구,22025,21786,43811
2022-12-13,4호선,수유,36026,36574,72600
2022-12-13,4호선,숙대입구,16043,15173,31216
2022-12-13,4호선,신용산,20105,19987,40092
2022-12-13,4호선,쌍문,31264,30012,61276
2022-12-13,4호선,이촌,10465,11495,21960
2022-12-13,4호선,창동,27246,29077,56323
2022-12-13,4호선,총신대입구,20782,22974,43756
2022-12-13,4호선,충무로,33092,33030,66122
2022-12-13,4호선,한성대입구,14457,14102,28559
2022-12-13,4호선,혜화,40047,38981,79028
2022-12-13,4호선,회현,29922,29826,59748
2022-12-13,5호선,강동,20230,19442,39672
2022-12-13,5호선,강일,5731,5377,11108
2022-12-13,5호선,개롱,6898,7421,14319
2022-12-13,5호선,개화산,6223,5993,12216
2022-12-13,5호선,거여,11556,11335,22891
2022-12-13,5호선,고덕,11336,11216,22552
2022-12-13,5호선,공덕,16664,17766,34430
2022-12-13,5호선,광나루,14876,13708,28584
2022-12-13,5호선,광화문,38477,38750,77227
2022-12-13,5호선,군자,12298,13553,25851
2022-12-13,5호선,굽은다리,10353,10200,20553
2022-12-13,5호선,길동,8553,9078,17631
2022-12-13,5호선,김포공항,7819,7219,15038
2022-12-13,5호선,까치산,31132,30281,61413
2022-12-13,5호선,답십리,17595,16366,33961
2022-12-13,5호선,동대문역사문화공원,3623,4051,7674
2022-12-13,5호선,둔촌동,9342,9500,18842
2022-12-13,5호선,마곡,12515,12399,24914
2022-12-13,5호선,마장,6776,6383,13159
2022-12-13,5호선,마천,8295,7874,16169
2022-12-13,5호선,마포,17337,17806,35143
2022-12-13,5호선,명일,9719,10258,19977
2022-12-13,5호선,목동,18315,20363,38678
2022-12-13,5호선,미사,18036,18658,36694
2022-12-13,5호선,발산,24112,24227,48339
2022-12-13,5호선,방이,8032,8366,16398
2022-12-13,5호선,방화,7354,7240,14594
2022-12-13,5호선,상일동,16269,15736,32005
2022-12-13,5호선,서대문,24144,23926,48070
2022-12-13,5호선,송정,7035,6641,13676
2022-12-13,5호선,신금호,7173,7618,14791
2022-12-13,5호선,신길,4655,5247,9902
2022-12-13,5호선,신정,14973,12754,27727
2022-12-13,5호선,아차산,15629,15328,30957
2022-12-13,5호선,애오개,7726,7818,15544
2022-12-13,5호선,양평,8348,8314,16662
2022-12-13,5호선,여의나루,11900,14523,26423
2022-12-13,5호선,여의도,36301,35151,71452
2022-12-13,5호선,영등포구청,4532,4704,9236
2022-12-13,5호선,영등포시장,11482,11949,23431
2022-12-13,5호선,오금,4147,4221,8368
2022-12-13,5호선,오목교,24110,25459,49569
2022-12-13,5호선,올림픽공원,4884,4126,9010
2022-12-13,5호선,왕십리,4931,5595,10526
2022-12-13,5호선,우장산,16113,16222,32335
2022-12-13,5호선,을지로4가,7264,7213,14477
2022-12-13,5호선,장한평,20361,20523,40884
2022-12-13,5호선,종로3가,15000,14847,29847
2022-12-13,5호선,천호,19849,19574,39423
2022-12-13,5호선,청구,4426,4003,8429
2022-12-13,5호선,충정로,5411,5570,10981
2022-12-13,5호선,하남검단산,6460,6253,12713
2022-12-13,5호선,하남시청,7711,7635,15346
2022-12-13,5호선,하남풍산,4776,4712,9488
2022-12-13,5호선,행당,9301,8446,17747
2022-12-13,5호선,화곡,31110,29913,61023
2022-12-13,6호선,고려대,10352,10173,20525
2022-12-13,6호선,공덕,21176,20802,41978
2022-12-13,6호선,광흥창,10155,10095,20250
2022-12-13,6호선,구산,8628,6769,15397
2022-12-13,6호선,녹사평,4890,4817,9707
2022-12-13,6호선,대흥,10518,10943,21461
2022-12-13,6호선,독바위,2900,3116,6016
2022-12-13,6호선,돌곶이,10690,9904,20594
2022-12-13,6호선,동묘앞,8418,8636,17054
2022-12-13,6호선,디지털미디어시티,16128,18297,34425
2022-12-13,6호선,마포구청,15965,14647,30612
2022-12-13,6호선,망원,14684,15736,30420
2022-12-13,6호선,버티고개,2460,2464,4924
2022-12-13,6호선,보문,8580,7937,16517
2022-12-13,6호선,봉화산,10166,9593,19759
2022-12-13,6호선,불광,4611,4518,9129
2022-12-13,6호선,삼각지,9374,8141,17515
2022-12-13,6호선,상수,10495,11551,22046
2022-12-13,6호선,상월곡,7332,7047,14379
2022-12-13,6호선,새절,13701,13041,26742
2022-12-13,6호선,석계,14051,14949,29000
2022-12-13,6호선,신당,9466,9878,19344
2022-12-13,6호선,안암,14758,14720,29478
2022-12-13,6호선,약수,4015,3989,8004
2022-12-13,6호선,역촌,4071,4907,8978
2022-12-13,6호선,월곡,14021,13555,27576
2022-12-13,6호선,월드컵경기장,4143,4462,8605
2022-12-13,6호선,응암,19224,19456,38680
2022-12-13,6호선,이태원,9520,9812,19332
2022-12-13,6호선,증산,11033,11276,22309
2022-12-13,6호선,창신,3968,3424,7392
2022-12-13,6호선,청구,3994,4258,8252
2022-12-13,6호선,태릉입구,6121,6733,12854
2022-12-13,6호선,한강진,8209,9279,17488
2022-12-13,6호선,합정,14064,13879,27943
2022-12-13,6호선,화랑대,13626,10748,24374
2022-12-13,6호선,효창공원앞,8179,7955,16134
2022-12-13,7호선,가산디지털단지,51338,49879,101217
2022-12-13,7호선,강남구청,18980,20844,39824
2022-12-13,7호선,건대입구,15036,15430,30466
2022-12-13,7호선,고속터미널,17006,14557,31563
2022-12-13,7호선,공릉,13007,13151,26158
2022-12-13,7호선,광명사거리,22787,22584,45371
2022-12-13,7호선,군자,16466,13171,29637
2022-12-13,7호선,남구로,17074,17944,35018
2022-12-13,7호선,남성,12521,11937,24458
2022-12-13,7호선,내방,16876,17189,34065
2022-12-13,7호선,노원,21944,22521,44465
2022-12-13,7호선,논현,20417,21319,41736
2022-12-13,7호선,대림,8807,8826,17633
2022-12-13,7호선,도봉산,10210,11534,21744
2022-12-13,7호선,뚝섬유원지,7602,7533,15135
2022-12-13,7호선,마들,14363,13714,28077
2022-12-13,7호선,먹골,11052,11043,22095
2022-12-13,7호선,면목,17017,16829,33846
2022-12-13,7호선,반포,6804,6745,13549
2022-12-13,7호선,보라매,8140,8539,16679
2022-12-13,7호선,사가정,17886,18101,35987
2022-12-13,7호선,상도,13421,13268,26689
2022-12-13,7호선,상봉,18103,17315,35418
2022-12-13,7호선,수락산,13987,13872,27859
2022-12-13,7호선,숭실대입구,16671,17127,33798
2022-12-13,7호선,신대방삼거리,16477,16158,32635
2022-12-13,7호선,신풍,12685,12262,24947
2022-12-13,7호선,어린이대공원,18524,18651,37175
2022-12-13,7호선,온수,12020,11317,23337
2022-12-13,7호선,용마산,6408,6330,12738
2022-12-13,7호선,이수,17877,16953,34830
2022-12-13,7호선,장승배기,10019,10010,20029
2022-12-13,7호선,장암,2654,959,3613
2022-12-13,7호선,중계,16340,15043,31383
2022-12-13,7호선,중곡,12365,11709,24074
2022-12-13,7호선,중화,11646,11742,23388
2022-12-13,7호선,천왕,12761,12289,25050
2022-12-13,7호선,철산,23512,24504,48016
2022-12-13,7호선,청담,22329,24828,47157
2022-12-13,7호선,태릉입구,9851,9016,18867
2022-12-13,7호선,하계,19845,19047,38892
2022-12-13,7호선,학동,27494,28864,56358
2022-12-13,8호선,가락시장,9109,9883,18992
2022-12-13,8호선,강동구청,12308,12743,25051
2022-12-13,8호선,남위례,6747,6999,13746
2022-12-13,8호선,남한산성입구,15961,15166,31127
2022-12-13,8호선,단대오거리,12517,12157,24674
2022-12-13,8호선,모란,4924,3578,8502
2022-12-13,8호선,몽촌토성,7070,7352,14422
2022-12-13,8호선,문정,24651,25374,50025
2022-12-13,8호선,복정,10874,9121,19995
2022-12-13,8호선,산성,5674,5879,11553
2022-12-13,8호선,석촌,8474,9693,18167
2022-12-13,8호선,송파,10412,10522,20934
2022-12-13,8호선,수진,5842,5457,11299
2022-12-13,8호선,신흥,5459,5810,11269
2022-12-13,8호선,암사,21143,18951,40094
2022-12-13,8호선,잠실,17333,19916,37249
2022-12-13,8호선,장지,19614,18438,38052
2022-12-13,8호선,천호,15883,18260,34143
2022-12-13,9호선,가양,23494,23481,46975
2022-12-13,9호선,개화,2973,1929,4902
2022-12-13,9호선,고속터미널,13571,17622,31193
2022-12-13,9호선,공항시장,3220,3583,6803
2022-12-13,9호선,구반포,1953,2004,3957
2022-12-13,9호선,국회의사당,19714,19554,39268
2022-12-13,9호선,김포공항,7470,10302,17772
2022-12-13,9호선,노들,5158,4438,9596
2022-12-13,9호선,노량진,28324,27472,55796
2022-12-13,9호선,당산,20854,20899,41753
2022-12-13,9호선,동작,1705,1261,2966
2022-12-13,9호선,등촌,13092,12924,26016
2022-12-13,9호선,마곡나루,14214,13639,27853
2022-12-13,9호선,사평,4406,4354,8760
2022-12-13,9호선,샛강,7517,7433,14950
2022-12-13,9호선,선유도,10171,9453,19624
2022-12-13,9호선,신논현,32464,31472,63936
2022-12-13,9호선,신목동,4820,4284,9104
2022-12-13,9호선,신반포,4477,4299,8776
2022-12-13,9호선,신방화,7717,7650,15367
2022-12-13,9호선,양천향교,10969,11205,22174
2022-12-13,9호선,여의도,35254,32223,67477
2022-12-13,9호선,염창,19655,19265,38920
2022-12-13,9호선,증미,8091,7685,15776
2022-12-13,9호선,흑석,10351,10888,21239
2022-12-13,9호선2~3단계,둔촌오륜,1248,1172,2420
2022-12-13,9호선2~3단계,봉은사,20299,20505,40804
2022-12-13,9호선2~3단계,삼성중앙,8966,9268,18234
2022-12-13,9호선2~3단계,삼전,7881,7577,15458
2022-12-13,9호선2~3단계,석촌,9603,8608,18211
2022-12-13,9호선2~3단계,석촌고분,7291,7398,14689
2022-12-13,9호선2~3단계,선정릉,11216,12495,23711
2022-12-13,9호선2~3단계,송파나루,5858,6274,12132
2022-12-13,9호선2~3단계,언주,12963,12988,25951
2022-12-13,9호선2~3단계,올림픽공원,6896,6906,13802
2022-12-13,9호선2~3단계,종합운동장,5098,4917,10015
2022-12-13,9호선2~3단계,중앙보훈병원,12856,11414,24270
2022-12-13,9호선2~3단계,한성백제,3177,2925,6102
2022-12-13,경강선,경기광주,9261,9002,18263
2022-12-13,경강선,곤지암,2694,2507,5201
2022-12-13,경강선,부발,2457,2184,4641
2022-12-13,경강선,삼동,2891,2837,5728
2022-12-13,경강선,세종대왕릉,346,347,693
2022-12-13,경강선,신둔도예촌,1841,1621,3462
2022-12-13,경강선,여주,2643,2510,5153
2022-12-13,경강선,이매,1376,1231,2607
2022-12-13,경강선,이천,2920,2980,5900
2022-12-13,경강선,초월,3782,3661,7443
2022-12-13,경강선,판교,6298,6105,12403
2022-12-13,경부선,가산디지털단지,19562,22838,42400
2022-12-13,경부선,관악,8145,7814,15959
2022-12-13,경부선,광명,3710,3196,6906
2022-12-13,경부선,구로,19613,19726,39339
2022-12-13,경부선,군포,8520,8289,16809
2022-12-13,경부선,금정,30087,30794,60881
2022-12-13,경부선,금천구청,12711,12776,25487
2022-12-13,경부선,남영,10423,11235,21658
2022-12-13,경부선,노량진,8989,9432,18421
2022-12-13,경부선,당정,7121,6886,14007
2022-12-13,경부선,대방,12111,13512,25623
2022-12-13,경부선,독산,20438,21108,41546
2022-12-13,경부선,두정,7646,8612,16258
2022-12-13,경부선,명학,10980,10840,21820
2022-12-13,경부선,병점,17234,17333,34567
2022-12-13,경부선,서동탄,1530,1384,2914
2022-12-13,경부선,서울역,7651,2369,10020
2022-12-13,경부선,서정리,8835,7873,16708
2022-12-13,경부선,석수,10235,9322,19557
2022-12-13,경부선,성균관대,16824,16665,33489
2022-12-13,경부선,성환,4728,4556,9284
2022-12-13,경부선,세류,3559,3263,6822
2022-12-13,경부선,세마,3302,3183,6485
2022-12-13,경부선,송탄,4576,4692,9268
2022-12-13,경부선,수원,37161,39277,76438
2022-12-13,경부선,신길,9753,8629,18382
2022-12-13,경부선,신도림,4276,4400,8676
2022-12-13,경부선,안양,27877,27610,55487
2022-12-13,경부선,영등포,41094,42234,83328
2022-12-13,경부선,오산,10900,11042,21942
2022-12-13,경부선,오산대,4332,3947,8279
2022-12-13,경부선,용산,38199,38679,76878
2022-12-13,경부선,의왕,10260,9993,20253
2022-12-13,경부선,직산,929,887,1816
2022-12-13,경부선,진위,2173,1797,3970
2022-12-13,경부선,천안,6943,6267,13210
2022-12-13,경부선,평택,13083,13006,26089
2022-12-13,경부선,평택지제,4863,4568,9431
2022-12-13,경부선,화서,9300,9104,18404
2022-12-13,경원선,가능,7156,6950,14106
2022-12-13,경원선,광운대,9163,9144,18307
2022-12-13,경원선,녹양,5071,4796,9867
2022-12-13,경원선,녹천,5098,4250,9348
2022-12-13,경원선,덕계,3715,3231,6946
2022-12-13,경원선,덕정,6711,6394,13105
2022-12-13,경원선,도봉,6476,6183,12659
2022-12-13,경원선,도봉산,7294,4578,11872
2022-12-13,경원선,동두천,2729,2836,5565
2022-12-13,경원선,동두천중앙,3146,3138,6284
2022-12-13,경원선,망월사,9078,9247,18325
2022-12-13,경원선,방학,10666,10561,21227
2022-12-13,경원선,보산,1533,1448,2981
2022-12-13,경원선,서빙고,2341,2117,4458
2022-12-13,경원선,석계,8790,9872,18662
2022-12-13,경원선,소요산,1973,1630,3603
2022-12-13,경원선,신이문,9159,8419,17578
2022-12-13,경원선,양주,8035,7610,15645
2022-12-13,경원선,옥수,64,27,91
2022-12-13,경원선,왕십리,15638,16950,32588
2022-12-13,경원선,외대앞,9134,9320,18454
2022-12-13,경원선,월계,8883,8130,17013
2022-12-13,경원선,응봉,2032,1767,3799
2022-12-13,경원선,의정부,19148,19593,38741
2022-12-13,경원선,이촌,4305,3537,7842
2022-12-13,경원선,지행,6895,6800,13695
2022-12-13,경원선,청량리,16021,16734,32755
2022-12-13,경원선,한남,4357,4127,8484
2022-12-13,경원선,회룡,13842,13568,27410
2022-12-13,경의선,가좌,6328,6176,12504
2022-12-13,경의선,강매,3627,3117,6744
2022-12-13,경의선,곡산,635,641,1276
2022-12-13,경의선,공덕,4396,3660,8056
2022-12-13,경의선,금릉,5455,5226,10681
2022-12-13,경의선,금촌,6824,6601,13425
2022-12-13,경의선,능곡,4153,3878,8031
2022-12-13,경의선,디지털미디어시티,3121,2861,5982
2022-12-13,경의선,문산,5521,5283,10804
2022-12-13,경의선,백마,7923,7747,15670
2022-12-13,경의선,서강대,2498,2525,5023
2022-12-13,경의선,서울역,4875,6421,11296
2022-12-13,경의선,수색,3023,3300,6323
2022-12-13,경의선,신촌,1012,1324,2336
2022-12-13,경의선,야당,8581,8652,17233
2022-12-13,경의선,운정,7671,7260,14931
2022-12-13,경의선,월롱,3291,2883,6174
2022-12-13,경의선,일산,11228,11228,22456
2022-12-13,경의선,임진강,3,2,5
2022-12-13,경의선,탄현,8801,8397,17198
2022-12-13,경의선,파주,1665,1236,2901
2022-12-13,경의선,풍산,6366,5940,12306
2022-12-13,경의선,행신,8932,8976,17908
2022-12-13,경의선,홍대입구,1807,2220,4027
2022-12-13,경의선,화전,3095,2784,5879
2022-12-13,경의선,효창공원앞,3574,3900,7474
2022-12-13,경인선,간석,6478,6116,12594
2022-12-13,경인선,개봉,23660,23926,47586
2022-12-13,경인선,구일,7461,7514,14975
2022-12-13,경인선,도원,3357,3296,6653
2022-12-13,경인선,도화,4341,4055,8396
2022-12-13,경인선,동암,16766,16935,33701
2022-12-13,경인선,동인천,14291,13621,27912
2022-12-13,경인선,백운,7221,7145,14366
2022-12-13,경인선,부개,9304,8773,18077
2022-12-13,경인선,부천,33840,33981,67821
2022-12-13,경인선,부평,28806,30577,59383
2022-12-13,경인선,소사,9229,9155,18384
2022-12-13,경인선,송내,29725,29330,59055
2022-12-13,경인선,역곡,30502,30399,60901
2022-12-13,경인선,오류동,12435,11834,24269
2022-12-13,경인선,온수,7605,7168,14773
2022-12-13,경인선,인천,3460,2607,6067
2022-12-13,경인선,제물포,11970,11517,23487
2022-12-13,경인선,주안,19842,18148,37990
2022-12-13,경인선,중동,10257,9552,19809
2022-12-13,경춘선,가평,1720,1669,3389
2022-12-13,경춘선,갈매,3293,2783,6076
2022-12-13,경춘선,강촌,431,390,821
2022-12-13,경춘선,굴봉산,105,143,248
2022-12-13,경춘선,금곡,1587,1587,3174
2022-12-13,경춘선,김유정,312,287,599
2022-12-13,경춘선,남춘천,2525,2592,5117
2022-12-13,경춘선,대성리,463,407,870
2022-12-13,경춘선,마석,4382,4343,8725
2022-12-13,경춘선,백양리,237,207,444
2022-12-13,경춘선,별내,3434,3266,6700
2022-12-13,경춘선,사릉,2619,2469,5088
2022-12-13,경춘선,상천,197,193,390
2022-12-13,경춘선,신내,2438,2281,4719
2022-12-13,경춘선,천마산,1765,1660,3425
2022-12-13,경춘선,청평,1527,1435,2962
2022-12-13,경춘선,춘천,1519,1467,2986
2022-12-13,경춘선,퇴계원,3895,3557,7452
2022-12-13,경춘선,평내호평,6780,6677,13457
2022-12-13,공항철도,검암,7159,6935,14094
2022-12-13,공항철도,계양,13361,12547,25908
2022-12-13,공항철도,공덕,2770,3755,6525
2022-12-13,공항철도,공항화물청사,2464,2517,4981
2022-12-13,공항철도,김포공항,11297,6871,18168
2022-12-13,공항철도,디지털미디어시티,16782,15285,32067
2022-12-13,공항철도,마곡나루,11205,11023,22228
2022-12-13,공항철도,서울역,10473,9105,19578
2022-12-13,공항철도,영종,3863,3803,7666
2022-12-13,공항철도,운서,8505,8887,17392
2022-12-13,공항철도,인천공항1터미널,10963,9939,20902
2022-12-13,공항철도,인천공항2터미널,4046,3604,7650
2022-12-13,공항철도,청라국제도시,7630,7300,14930
2022-12-13,공항철도,홍대입구,11080,11388,22468
2022-12-13,과천선,경마공원,1646,1586,3232
2022-12-13,과천선,과천,7114,7060,14174
2022-12-13,과천선,대공원,4595,4552,9147
2022-12-13,과천선,범계,28284,28928,57212
2022-12-13,과천선,선바위,8776,7976,16752
2022-12-13,과천선,인덕원,27174,28518,55692
2022-12-13,과천선,정부과천청사,12394,12241,24635
2022-12-13,과천선,평촌,20009,19866,39875
2022-12-13,분당선,가천대,9215,10159,19374
2022-12-13,분당선,강남구청,11062,12584,23646
2022-12-13,분당선,개포동,4531,4668,9199
2022-12-13,분당선,구룡,2598,2510,5108
2022-12-13,분당선,구성,5836,6335,12171
2022-12-13,분당선,기흥,12523,12248,24771
2022-12-13,분당선,대모산입구,5479,5189,10668
2022-12-13,분당선,도곡,8367,8311,16678
2022-12-13,분당선,망포,17611,16700,34311
2022-12-13,분당선,매교,5099,5104,10203
2022-12-13,분당선,매탄권선,6077,6130,12207
2022-12-13,분당선,모란,20981,21373,42354
2022-12-13,분당선,미금,17272,18547,35819
2022-12-13,분당선,보정,3174,2761,5935
2022-12-13,분당선,상갈,6266,6130,12396
2022-12-13,분당선,서울숲,11836,12134,23970
2022-12-13,분당선,서현,27298,27778,55076
2022-12-13,분당선,선릉,15681,23299,38980
2022-12-13,분당선,선정릉,9102,9514,18616
2022-12-13,분당선,수내,16311,16151,32462
2022-12-13,분당선,수서,15437,16095,31532
2022-12-13,분당선,수원,8849,7495,16344
2022-12-13,분당선,수원시청,14263,15385,29648
2022-12-13,분당선,신갈,5694,5594,11288
2022-12-13,분당선,압구정로데오,21231,22760,43991
2022-12-13,분당선,야탑,29677,30909,60586
2022-12-13,분당선,영통,9739,10010,19749
2022-12-13,분당선,오리,13309,10758,24067
2022-12-13,분당선,이매,6225,6092,12317
2022-12-13,분당선,정자,21645,22818,44463
2022-12-13,분당선,죽전,16248,16723,32971
2022-12-13,분당선,청명,5188,5046,10234
2022-12-13,분당선,태평,14585,14060,28645
2022-12-13,분당선,한티,16141,17271,33412
2022-12-13,수인선,고색,5582,5050,10632
2022-12-13,수인선,남동인더스파크,2447,2709,5156
2022-12-13,수인선,달월,116,79,195
2022-12-13,수인선,사리,5553,4785,10338
2022-12-13,수인선,소래포구,5116,4768,9884
2022-12-13,수인선,송도,2539,2432,4971
2022-12-13,수인선,숭의,4266,4059,8325
2022-12-13,수인선,신포,1856,1936,3792
2022-12-13,수인선,야목,407,302,709
2022-12-13,수인선,어천,1186,1027,2213
2022-12-13,수인선,연수,4879,4902,9781
2022-12-13,수인선,오목천,4107,3842,7949
2022-12-13,수인선,원인재,4863,5033,9896
2022-12-13,수인선,월곶,2828,2656,5484
2022-12-13,수인선,인천,1043,1725,2768
2022-12-13,수인선,인천논현,6022,6453,12475
2022-12-13,수인선,인하대,6923,6657,13580
2022-12-13,수인선,호구포,4565,4638,9203
2022-12-13,신림선,관악산,2460,2421,4881
2022-12-13,신림선,당곡,4564,4641,9205
2022-12-13,신림선,대방,2730,2195,4925
2022-12-13,신림선,보라매,3823,3463,7286
2022-12-13,신림선,보라매공원,2097,2317,4414
2022-12-13,신림선,보라매병원,8531,8627,17158
2022-12-13,신림선,샛강,2874,3475,6349
2022-12-13,신림선,서울대벤처타운,8515,8362,16877
2022-12-13,신림선,서울지방병무청,2758,3250,6008
2022-12-13,신림선,서원,3459,3210,6669
2022-12-13,신림선,신림,1881,2508,4389
2022-12-13,안산선,고잔,9918,9324,19242
2022-12-13,안산선,대야미,5285,4765,10050
2022-12-13,안산선,반월,4530,4408,8938
2022-12-13,안산선,산본,17039,18646,35685
2022-12-13,안산선,상록수,17401,17862,35263
2022-12-13,안산선,수리산,4399,3672,8071
2022-12-13,안산선,신길온천,1952,1825,3777
2022-12-13,안산선,안산,12156,10948,23104
2022-12-13,안산선,오이도,8767,8644,17411
2022-12-13,안산선,정왕,10835,11007,21842
2022-12-13,안산선,중앙,18956,19781,38737
2022-12-13,안산선,초지,5683,6088,11771
2022-12-13,안산선,한대앞,10775,10920,21695
2022-12-13,우이신설선,4.19민주묘지,4209,4175,8384
2022-12-13,우이신설선,가오리,4450,4560,9010
2022-12-13,우이신설선,보문,1677,1729,3406
2022-12-13,우이신설선,북한산보국문,6663,6439,13102
2022-12-13,우이신설선,북한산우이,2780,2457,5237
2022-12-13,우이신설선,삼양,2104,2296,4400
2022-12-13,우이신설선,삼양사거리,2659,2749,5408
2022-12-13,우이신설선,성신여대입구,3877,4238,8115
2022-12-13,우이신설선,솔밭공원,2654,2514,5168
2022-12-13,우이신설선,솔샘,6577,6334,12911
2022-12-13,우이신설선,신설동,2435,2382,4817
2022-12-13,우이신설선,정릉,5106,4950,10056
2022-12-13,우이신설선,화계,3733,3478,7211
2022-12-13,일산선,대곡,2220,1683,3903
2022-12-13,일산선,대화,14512,11307,25819
2022-12-13,일산선,마두,8215,8642,16857
2022-12-13,일산선,백석,10928,11007,21935
2022-12-13,일산선,삼송,21300,20943,42243
2022-12-13,일산선,원당,12072,11525,23597
2022-12-13,일산선,원흥,12640,11941,24581
2022-12-13,일산선,정발산,7360,7434,14794
2022-12-13,일산선,주엽,10012,10195,20207
2022-12-13,일산선,지축,2,0,2
2022-12-13,일산선,화정,18057,18604,36661
2022-12-13,장항선,배방,1212,1137,2349
2022-12-13,장항선,봉명,1431,1385,2816
2022-12-13,장항선,신창,1796,1718,3514
2022-12-13,장항선,쌍용,3068,2972,6040
2022-12-13,장항선,아산,3775,3328,7103
2022-12-13,장항선,온양온천,4098,4138,8236
2022-12-13,장항선,탕정,1209,1130,2339
2022-12-13,중앙선,구리,14316,14634,28950
2022-12-13,중앙선,국수,861,839,1700
2022-12-13,중앙선,덕소,5832,5861,11693
2022-12-13,중앙선,도농,12689,11677,24366
2022-12-13,중앙선,도심,2671,2140,4811
2022-12-13,중앙선,망우,7864,8041,15905
2022-12-13,중앙선,상봉,5993,6003,11996
2022-12-13,중앙선,신원,194,156,350
2022-12-13,중앙선,아신,595,612,1207
2022-12-13,중앙선,양수,1864,1867,3731
2022-12-13,중앙선,양원,3210,3106,6316
2022-12-13,중앙선,양정,680,568,1248
2022-12-13,중앙선,양평,3646,3592,7238
2022-12-13,중앙선,오빈,347,359,706
2022-12-13,중앙선,용문,1758,1716,3474
2022-12-13,중앙선,운길산,583,555,1138
2022-12-13,중앙선,원덕,377,332,709
2022-12-13,중앙선,중랑,5953,5739,11692
2022-12-13,중앙선,지평,62,64,126
2022-12-13,중앙선,팔당,742,778,1520
2022-12-13,중앙선,회기,28266,27797,56063
2022-12-14,1호선,동대문,10769,10137,20906
2022-12-14,1호선,동묘앞,6958,7246,14204
2022-12-14,1호선,서울역,51393,49508,100901
2022-12-14,1호선,시청,27539,27322,54861
2022-12-14,1호선,신설동,13924,13511,27435
2022-12-14,1호선,제기동,14724,14728,29452
2022-12-14,1호선,종각,41911,40906,82817
2022-12-14,1호선,종로3가,24754,22707,47461
2022-12-14,1호선,종로5가,23119,22508,45627
2022-12-14,1호선,청량리,18057,17754,35811
2022-12-14,2호선,강남,84487,80771,165258
2022-12-14,2호선,강변,31054,28535,59589
2022-12-14,2호선,건대입구,35463,37931,73394
2022-12-14,2호선,교대,37725,43047,80772
2022-12-14,2호선,구로디지털단지,62422,62617,125039
2022-12-14,2호선,구의,25585,25051,50636
2022-12-14,2호선,낙성대,29035,28178,57213
2022-12-14,2호선,당산,19363,22966,42329
2022-12-14,2호선,대림,24596,24794,49390
2022-12-14,2호선,도림천,1467,1629,3096
2022-12-14,2호선,동대문역사문화공원,14241,16433,30674
2022-12-14,2호선,뚝섬,23177,25168,48345
2022-12-14,2호선,문래,23661,24104,47765
2022-12-14,2호선,방배,20800,21559,42359
2022-12-14,2호선,봉천,25304,23791,49095
2022-12-14,2호선,사당,42217,45942,88159
2022-12-14,2호선,삼성,60732,61583,122315
2022-12-14,2호선,상왕십리,15288,14908,30196
2022-12-14,2호선,서울대입구,49648,47519,97167
2022-12-14,2호선,서초,24671,24096,48767
2022-12-14,2호선,선릉,63470,56534,120004
2022-12-14,2호선,성수,41553,45079,86632
2022-12-14,2호선,시청,27917,26482,54399
2022-12-14,2호선,신답,1786,2008,3794
2022-12-14,2호선,신당,14478,15138,29616
2022-12-14,2호선,신대방,26049,25534,51583
2022-12-14,2호선,신도림,52663,51699,104362
2022-12-14,2호선,신림,60558,58344,118902
2022-12-14,2호선,신설동,3564,3610,7174
2022-12-14,2호선,신정네거리,11110,11420,22530
2022-12-14,2호선,신촌,37101,37526,74627
2022-12-14,2호선,아현,11033,10637,21670
2022-12-14,2호선,양천구청,7325,7865,15190
2022-12-14,2호선,역삼,60659,68126,128785
2022-12-14,2호선,영등포구청,23610,24092,47702
2022-12-14,2호선,왕십리,17209,14688,31897
2022-12-14,2호선,용답,2934,2885,5819
2022-12-14,2호선,용두,2530,2525,5055
2022-12-14,2호선,을지로3가,26455,26778,53233
2022-12-14,2호선,을지로4가,14700,14613,29313
2022-12-14,2호선,을지로입구,50521,51467,101988
2022-12-14,2호선,이대,16976,18091,35067
2022-12-14,2호선,잠실,84861,84899,169760
2022-12-14,2호선,잠실나루,15906,15440,31346
2022-12-14,2호선,잠실새내,24015,23613,47628
2022-12-14,2호선,종합운동장,8191,9199,17390
2022-12-14,2호선,충정로,10927,11737,22664
2022-12-14,2호선,한양대,13126,14343,27469
2022-12-14,2호선,합정,32011,33753,65764
2022-12-14,2호선,홍대입구,61065,63516,124581
2022-12-14,3호선,가락시장,9772,9494,19266
2022-12-14,3호선,경복궁,24240,23917,48157
2022-12-14,3호선,경찰병원,8306,8310,16616
2022-12-14,3호선,고속터미널,43460,41017,84477
2022-12-14,3호선,교대,16819,10661,27480
2022-12-14,3호선,구파발,22322,21559,43881
2022-12-14,3호선,금호,8223,7766,15989
2022-12-14,3호선,남부터미널,30607,31247,61854
2022-12-14,3호선,녹번,16757,15104,31861
2022-12-14,3호선,대청,11006,10330,21336
2022-12-14,3호선,대치,10908,11064,21972
2022-12-14,3호선,도곡,5593,5718,11311
2022-12-14,3호선,독립문,7356,7562,14918
2022-12-14,3호선,동대입구,10122,11172,21294
2022-12-14,3호선,매봉,14076,13742,27818
2022-12-14,3호선,무악재,4339,4312,8651
2022-12-14,3호선,불광,16573,17872,34445
2022-12-14,3호선,수서,18935,19338,38273
2022-12-14,3호선,신사,30000,31237,61237
2022-12-14,3호선,안국,26530,27347,53877
2022-12-14,3호선,압구정,33702,36657,70359
2022-12-14,3호선,약수,13920,13488,27408
2022-12-14,3호선,양재,41598,44902,86500
2022-12-14,3호선,연신내,36191,34332,70523
2022-12-14,3호선,오금,6800,6092,12892
2022-12-14,3호선,옥수,9074,9300,18374
2022-12-14,3호선,을지로3가,12645,12411,25056
2022-12-14,3호선,일원,11537,11181,22718
2022-12-14,3호선,잠원,5524,5163,10687
2022-12-14,3호선,종로3가,10713,12116,22829
2022-12-14,3호선,지축,6174,6063,12237
2022-12-14,3호선,충무로,4,0,4
2022-12-14,3호선,학여울,2016,2090,4106
2022-12-14,3호선,홍제,18178,17657,35835
2022-12-14,4호선,길음,22260,22671,44931
2022-12-14,4호선,남태령,1454,1612,3066
2022-12-14,4호선,노원,19526,22264,41790
2022-12-14,4호선,당고개,9287,8329,17616
2022-12-14,4호선,동대문,19642,20248,39890
2022-12-14,4호선,동대문역사문화공원,18306,16198,34504
2022-12-14,4호선,동작,1043,1134,2177
2022-12-14,4호선,명동,27401,28301,55702
2022-12-14,4호선,미아,15762,15491,31253
2022-12-14,4호선,미아사거리,27443,27841,55284
2022-12-14,4호선,사당,28857,24422,53279
2022-12-14,4호선,삼각지,6348,7136,13484
2022-12-14,4호선,상계,19674,18508,38182
2022-12-14,4호선,서울역,13090,20113,33203
2022-12-14,4호선,성신여대입구,22400,21373,43773
2022-12-14,4호선,수유,34751,35466,70217
2022-12-14,4호선,숙대입구,15806,14676,30482
2022-12-14,4호선,신용산,19412,19895,39307
2022-12-14,4호선,쌍문,29985,28645,58630
2022-12-14,4호선,이촌,10240,10998,21238
2022-12-14,4호선,창동,25458,27118,52576
2022-12-14,4호선,총신대입구,19826,21727,41553
2022-12-14,4호선,충무로,32060,31814,63874
2022-12-14,4호선,한성대입구,13856,13389,27245
2022-12-14,4호선,혜화,40334,39324,79658
2022-12-14,4호선,회현,26597,27450,54047
2022-12-14,5호선,강동,19703,19010,38713
2022-12-14,5호선,강일,5550,5134,10684
2022-12-14,5호선,개롱,6672,7028,13700
2022-12-14,5호선,개화산,5932,5648,11580
2022-12-14,5호선,거여,10982,10573,21555
2022-12-14,5호선,고덕,10421,10100,20521
2022-12-14,5호선,공덕,15969,17161,33130
2022-12-14,5호선,광나루,13921,12882,26803
2022-12-14,5호선,광화문,35933,37536,73469
2022-12-14,5호선,군자,11976,13106,25082
2022-12-14,5호선,굽은다리,10549,10378,20927
2022-12-14,5호선,길동,8409,8632,17041
2022-12-14,5호선,김포공항,7928,7433,15361
2022-12-14,5호선,까치산,29958,29036,58994
2022-12-14,5호선,답십리,17060,15667,32727
2022-12-14,5호선,동대문역사문화공원,3511,4124,7635
2022-12-14,5호선,둔촌동,8988,9096,18084
2022-12-14,5호선,마곡,12110,12011,24121
2022-12-14,5호선,마장,6212,5948,12160
2022-12-14,5호선,마천,7760,7338,15098
2022-12-14,5호선,마포,15942,16572,32514
2022-12-14,5호선,명일,9197,9650,18847
2022-12-14,5호선,목동,17490,18917,36407
2022-12-14,5호선,미사,17587,17574,35161
2022-12-14,5호선,발산,22901,23566,46467
2022-12-14,5호선,방이,7710,7918,15628
2022-12-14,5호선,방화,7292,6956,14248
2022-12-14,5호선,상일동,15681,14876,30557
2022-12-14,5호선,서대문,22839,22795,45634
2022-12-14,5호선,송정,6651,6263,12914
2022-12-14,5호선,신금호,6782,7142,13924
2022-12-14,5호선,신길,4559,4939,9498
2022-12-14,5호선,신정,14797,12156,26953
2022-12-14,5호선,아차산,14598,14323,28921
2022-12-14,5호선,애오개,7432,7476,14908
2022-12-14,5호선,양평,8273,8055,16328
2022-12-14,5호선,여의나루,10956,14209,25165
2022-12-14,5호선,여의도,35294,35675,70969
2022-12-14,5호선,영등포구청,4259,4378,8637
2022-12-14,5호선,영등포시장,10797,11082,21879
2022-12-14,5호선,오금,3955,4005,7960
2022-12-14,5호선,오목교,22760,24199,46959
2022-12-14,5호선,올림픽공원,4375,3759,8134
2022-12-14,5호선,왕십리,4851,5341,10192
2022-12-14,5호선,우장산,15281,15106,30387
2022-12-14,5호선,을지로4가,6727,6875,13602
2022-12-14,5호선,장한평,20599,20377,40976
2022-12-14,5호선,종로3가,14462,13856,28318
2022-12-14,5호선,천호,18621,18566,37187
2022-12-14,5호선,청구,4280,4001,8281
2022-12-14,5호선,충정로,5438,5577,11015
2022-12-14,5호선,하남검단산,6389,6026,12415
2022-12-14,5호선,하남시청,7541,7374,14915
2022-12-14,5호선,하남풍산,4436,4458,8894
2022-12-14,5호선,행당,8750,7839,16589
2022-12-14,5호선,화곡,30241,28379,58620
2022-12-14,6호선,고려대,9636,9493,19129
2022-12-14,6호선,공덕,20375,19681,40056
2022-12-14,6호선,광흥창,9691,9519,19210
2022-12-14,6호선,구산,8324,6309,14633
2022-12-14,6호선,녹사평,4961,5028,9989
2022-12-14,6호선,대흥,9815,10261,20076
2022-12-14,6호선,독바위,2916,2993,5909
2022-12-14,6호선,돌곶이,10474,9641,20115
2022-12-14,6호선,동묘앞,7749,7991,15740
2022-12-14,6호선,디지털미디어시티,15676,17543,33219
2022-12-14,6호선,마포구청,15114,13646,28760
2022-12-14,6호선,망원,14048,14936,28984
2022-12-14,6호선,버티고개,2371,2299,4670
2022-12-14,6호선,보문,8204,7462,15666
2022-12-14,6호선,봉화산,9546,9093,18639
2022-12-14,6호선,불광,4587,4466,9053
2022-12-14,6호선,삼각지,8182,7310,15492
2022-12-14,6호선,상수,10258,11504,21762
2022-12-14,6호선,상월곡,7323,6846,14169
2022-12-14,6호선,새절,13340,12447,25787
2022-12-14,6호선,석계,13360,14019,27379
2022-12-14,6호선,신당,9613,9909,19522
2022-12-14,6호선,안암,14083,14174,28257
2022-12-14,6호선,약수,3798,3720,7518
2022-12-14,6호선,역촌,3825,4614,8439
2022-12-14,6호선,연신내,1,0,1
2022-12-14,6호선,월곡,13451,13017,26468
2022-12-14,6호선,월드컵경기장,4182,4605,8787
2022-12-14,6호선,응암,18751,18517,37268
2022-12-14,6호선,이태원,9470,9623,19093
2022-12-14,6호선,증산,10456,10459,20915
2022-12-14,6호선,창신,3933,3344,7277
2022-12-14,6호선,청구,4088,4118,8206
2022-12-14,6호선,태릉입구,5901,6322,12223
2022-12-14,6호선,한강진,7911,9115,17026
2022-12-14,6호선,합정,13579,13608,27187
2022-12-14,6호선,화랑대,13113,10300,23413
2022-12-14,6호선,효창공원앞,7873,7525,15398
2022-12-14,7호선,가산디지털단지,48776,48653,97429
2022-12-14,7호선,강남구청,17798,20096,37894
2022-12-14,7호선,건대입구,14912,15282,30194
2022-12-14,7호선,고속터미널,15924,13779,29703
2022-12-14,7호선,공릉,12602,12465,25067
2022-12-14,7호선,광명사거리,21547,21007,42554
2022-12-14,7호선,군자,16038,12696,28734
2022-12-14,7호선,남구로,16276,17159,33435
2022-12-14,7호선,남성,11977,11114,23091
2022-12-14,7호선,내방,16301,16434,32735
2022-12-14,7호선,노원,21022,21880,42902
2022-12-14,7호선,논현,19607,20401,40008
2022-12-14,7호선,대림,8196,8277,16473
2022-12-14,7호선,도봉산,9523,10842,20365
2022-12-14,7호선,뚝섬유원지,7271,7097,14368
2022-12-14,7호선,마들,13956,13120,27076
2022-12-14,7호선,먹골,10589,10458,21047
2022-12-14,7호선,면목,16165,15701,31866
2022-12-14,7호선,반포,6623,6567,13190
2022-12-14,7호선,보라매,7806,8046,15852
2022-12-14,7호선,사가정,16598,16690,33288
2022-12-14,7호선,상도,12777,12512,25289
2022-12-14,7호선,상봉,17515,16561,34076
2022-12-14,7호선,수락산,13232,13062,26294
2022-12-14,7호선,숭실대입구,16169,16066,32235
2022-12-14,7호선,신대방삼거리,15614,14845,30459
2022-12-14,7호선,신풍,12459,11774,24233
2022-12-14,7호선,어린이대공원,17566,17793,35359
2022-12-14,7호선,온수,11553,10702,22255
2022-12-14,7호선,용마산,6273,6159,12432
2022-12-14,7호선,이수,17668,16446,34114
2022-12-14,7호선,장승배기,9756,9515,19271
2022-12-14,7호선,장암,2514,914,3428
2022-12-14,7호선,중계,15805,14322,30127
2022-12-14,7호선,중곡,11785,11022,22807
2022-12-14,7호선,중화,11330,11224,22554
2022-12-14,7호선,천왕,12347,11683,24030
2022-12-14,7호선,철산,22469,23096,45565
2022-12-14,7호선,청담,20985,23848,44833
2022-12-14,7호선,태릉입구,9494,8835,18329
2022-12-14,7호선,하계,20024,18856,38880
2022-12-14,7호선,학동,26853,28575,55428
2022-12-14,8호선,가락시장,8534,9400,17934
2022-12-14,8호선,강동구청,11748,12214,23962
2022-12-14,8호선,남위례,6424,6671,13095
2022-12-14,8호선,남한산성입구,15715,14254,29969
2022-12-14,8호선,단대오거리,11975,11765,23740
2022-12-14,8호선,모란,5427,4020,9447
2022-12-14,8호선,몽촌토성,7007,7250,14257
2022-12-14,8호선,문정,23580,24875,48455
2022-12-14,8호선,복정,10335,8390,18725
2022-12-14,8호선,산성,5616,5501,11117
2022-12-14,8호선,석촌,8015,9324,17339
2022-12-14,8호선,송파,9939,9676,19615
2022-12-14,8호선,수진,5649,5250,10899
2022-12-14,8호선,신흥,5362,5726,11088
2022-12-14,8호선,암사,20350,17907,38257
2022-12-14,8호선,잠실,17163,19908,37071
2022-12-14,8호선,장지,19542,18649,38191
2022-12-14,8호선,천호,15343,17564,32907
2022-12-14,9호선,가양,22365,22066,44431
2022-12-14,9호선,개화,2642,1782,4424
2022-12-14,9호선,고속터미널,13503,17297,30800
2022-12-14,9호선,공항시장,3082,3342,6424
2022-12-14,9호선,구반포,1288,1410,2698
2022-12-14,9호선,국회의사당,19141,19720,38861
2022-12-14,9호선,김포공항,7255,10929,18184
2022-12-14,9호선,노들,4823,4052,8875
2022-12-14,9호선,노량진,27976,26945,54921
2022-12-14,9호선,당산,20646,20478,41124
2022-12-14,9호선,동작,1668,1156,2824
2022-12-14,9호선,등촌,12544,11996,24540
2022-12-14,9호선,마곡나루,14248,13568,27816
2022-12-14,9호선,사평,4377,4141,8518
2022-12-14,9호선,샛강,7109,7173,14282
2022-12-14,9호선,선유도,9719,9093,18812
2022-12-14,9호선,신논현,31305,30849,62154
2022-12-14,9호선,신목동,4812,4154,8966
2022-12-14,9호선,신반포,4107,3907,8014
2022-12-14,9호선,신방화,7420,7278,14698
2022-12-14,9호선,양천향교,10634,10964,21598
2022-12-14,9호선,여의도,34194,32696,66890
2022-12-14,9호선,염창,18918,18230,37148
2022-12-14,9호선,증미,7742,7397,15139
2022-12-14,9호선,흑석,9651,10037,19688
2022-12-14,9호선2~3단계,둔촌오륜,1222,1141,2363
2022-12-14,9호선2~3단계,봉은사,20857,21398,42255
2022-12-14,9호선2~3단계,삼성중앙,8215,8730,16945
2022-12-14,9호선2~3단계,삼전,7574,7296,14870
2022-12-14,9호선2~3단계,석촌,9239,8098,17337
2022-12-14,9호선2~3단계,석촌고분,7158,7108,14266
2022-12-14,9호선2~3단계,선정릉,10809,12007,22816
2022-12-14,9호선2~3단계,송파나루,5564,5986,11550
2022-12-14,9호선2~3단계,언주,12195,12495,24690
2022-12-14,9호선2~3단계,올림픽공원,6698,6511,13209
2022-12-14,9호선2~3단계,종합운동장,4784,4860,9644
2022-12-14,9호선2~3단계,중앙보훈병원,12356,10791,23147
2022-12-14,9호선2~3단계,한성백제,3086,2675,5761
2022-12-14,경강선,경기광주,8776,8054,16830
2022-12-14,경강선,곤지암,2401,2330,4731
2022-12-14,경강선,부발,2143,2102,4245
2022-12-14,경강선,삼동,2725,2559,5284
2022-12-14,경강선,세종대왕릉,292,304,596
2022-12-14,경강선,신둔도예촌,1626,1524,3150
2022-12-14,경강선,여주,2523,2418,4941
2022-12-14,경강선,이매,1264,1060,2324
2022-12-14,경강선,이천,2701,2778,5479
2022-12-14,경강선,초월,3602,3368,6970
2022-12-14,경강선,판교,5961,6062,12023
2022-12-14,경부선,가산디지털단지,18532,21977,40509
2022-12-14,경부선,관악,7485,7084,14569
2022-12-14,경부선,광명,3569,3028,6597
2022-12-14,경부선,구로,19169,19703,38872
2022-12-14,경부선,군포,8245,7933,16178
2022-12-14,경부선,금정,28940,29548,58488
2022-12-14,경부선,금천구청,11719,11823,23542
2022-12-14,경부선,남영,10099,10888,20987
2022-12-14,경부선,노량진,8429,9280,17709
2022-12-14,경부선,당정,6935,6549,13484
2022-12-14,경부선,대방,11770,13197,24967
2022-12-14,경부선,독산,19181,19991,39172
2022-12-14,경부선,두정,8227,8705,16932
2022-12-14,경부선,명학,10021,9859,19880
2022-12-14,경부선,병점,16111,15984,32095
2022-12-14,경부선,서동탄,1440,1253,2693
2022-12-14,경부선,서울역,7247,2334,9581
2022-12-14,경부선,서정리,8518,7800,16318
2022-12-14,경부선,석수,9609,8677,18286
2022-12-14,경부선,성균관대,16214,15819,32033
2022-12-14,경부선,성환,4674,4664,9338
2022-12-14,경부선,세류,3281,2881,6162
2022-12-14,경부선,세마,3173,3019,6192
2022-12-14,경부선,송탄,4658,4592,9250
2022-12-14,경부선,수원,36633,38738,75371
2022-12-14,경부선,신길,9472,8024,17496
2022-12-14,경부선,신도림,4042,4202,8244
2022-12-14,경부선,안양,26764,26260,53024
2022-12-14,경부선,영등포,40559,41551,82110
2022-12-14,경부선,오산,10309,10363,20672
2022-12-14,경부선,오산대,4021,3738,7759
2022-12-14,경부선,용산,38527,38944,77471
2022-12-14,경부선,의왕,9609,9664,19273
2022-12-14,경부선,직산,946,948,1894
2022-12-14,경부선,진위,2079,1863,3942
2022-12-14,경부선,천안,6938,6173,13111
2022-12-14,경부선,평택,12898,12901,25799
2022-12-14,경부선,평택지제,4784,4733,9517
2022-12-14,경부선,화서,8721,8207,16928
2022-12-14,경원선,가능,6645,6457,13102
2022-12-14,경원선,광운대,8787,8518,17305
2022-12-14,경원선,녹양,4658,4420,9078
2022-12-14,경원선,녹천,4780,3967,8747
2022-12-14,경원선,덕계,3418,3005,6423
2022-12-14,경원선,덕정,6297,5865,12162
2022-12-14,경원선,도봉,5890,5720,11610
2022-12-14,경원선,도봉산,6550,3916,10466
2022-12-14,경원선,동두천,2406,2487,4893
2022-12-14,경원선,동두천중앙,2901,2813,5714
2022-12-14,경원선,망월사,8565,8613,17178
2022-12-14,경원선,방학,9999,9739,19738
2022-12-14,경원선,보산,1370,1290,2660
2022-12-14,경원선,서빙고,2079,1901,3980
2022-12-14,경원선,석계,8079,8994,17073
2022-12-14,경원선,소요산,1524,1295,2819
2022-12-14,경원선,신이문,8722,8134,16856
2022-12-14,경원선,양주,7547,7092,14639
2022-12-14,경원선,옥수,62,36,98
2022-12-14,경원선,왕십리,16068,17045,33113
2022-12-14,경원선,외대앞,8676,8792,17468
2022-12-14,경원선,월계,8027,7401,15428
2022-12-14,경원선,응봉,1894,1627,3521
2022-12-14,경원선,의정부,18276,18700,36976
2022-12-14,경원선,이촌,4171,3181,7352
2022-12-14,경원선,지행,6522,6484,13006
2022-12-14,경원선,청량리,14848,15142,29990
2022-12-14,경원선,한남,4069,3864,7933
2022-12-14,경원선,회룡,12634,12474,25108
2022-12-14,경의선,가좌,5937,5612,11549
2022-12-14,경의선,강매,3407,2940,6347
2022-12-14,경의선,곡산,575,550,1125
2022-12-14,경의선,공덕,4224,3609,7833
2022-12-14,경의선,금릉,5208,5067,10275
2022-12-14,경의선,금촌,6366,6224,12590
2022-12-14,경의선,능곡,3900,3576,7476
2022-12-14,경의선,디지털미디어시티,2846,2603,5449
2022-12-14,경의선,문산,4995,4911,9906
2022-12-14,경의선,백마,7209,6952,14161
2022-12-14,경의선,서강대,2405,2354,4759
2022-12-14,경의선,서울역,4532,5928,10460
2022-12-14,경의선,수색,2739,3020,5759
2022-12-14,경의선,신촌,966,1262,2228
2022-12-14,경의선,야당,8299,8318,16617
2022-12-14,경의선,운정,7158,6639,13797
2022-12-14,경의선,월롱,3225,2747,5972
2022-12-14,경의선,일산,9524,9376,18900
2022-12-14,경의선,임진강,7,4,11
2022-12-14,경의선,탄현,8282,7940,16222
2022-12-14,경의선,파주,1487,1068,2555
2022-12-14,경의선,풍산,5646,5186,10832
2022-12-14,경의선,행신,8474,8461,16935
2022-12-14,경의선,홍대입구,1804,2072,3876
2022-12-14,경의선,화전,3046,2824,5870
2022-12-14,경의선,효창공원앞,3519,3750,7269
2022-12-14,경인선,간석,6038,5713,11751
2022-12-14,경인선,개봉,22561,22261,44822
2022-12-14,경인선,구일,7655,7563,15218
2022-12-14,경인선,도원,3239,3197,6436
2022-12-14,경인선,도화,4050,3795,7845
2022-12-14,경인선,동암,16046,15986,32032
2022-12-14,경인선,동인천,13937,13353,27290
2022-12-14,경인선,백운,6659,6496,13155
2022-12-14,경인선,부개,8784,8146,16930
2022-12-14,경인선,부천,32225,32036,64261
2022-12-14,경인선,부평,27999,29865,57864
2022-12-14,경인선,소사,8222,8237,16459
2022-12-14,경인선,송내,28066,27984,56050
2022-12-14,경인선,역곡,29264,28828,58092
2022-12-14,경인선,오류동,11869,10991,22860
2022-12-14,경인선,온수,7010,6771,13781
2022-12-14,경인선,인천,3106,2360,5466
2022-12-14,경인선,제물포,11160,10568,21728
2022-12-14,경인선,주안,19051,17357,36408
2022-12-14,경인선,중동,9530,8930,18460
2022-12-14,경춘선,가평,1469,1421,2890
2022-12-14,경춘선,갈매,3083,2570,5653
2022-12-14,경춘선,강촌,333,324,657
2022-12-14,경춘선,굴봉산,96,94,190
2022-12-14,경춘선,금곡,1413,1376,2789
2022-12-14,경춘선,김유정,343,344,687
2022-12-14,경춘선,남춘천,2432,2323,4755
2022-12-14,경춘선,대성리,359,333,692
2022-12-14,경춘선,마석,3784,3647,7431
2022-12-14,경춘선,백양리,244,259,503
2022-12-14,경춘선,별내,3048,2856,5904
2022-12-14,경춘선,사릉,2227,2164,4391
2022-12-14,경춘선,상천,151,159,310
2022-12-14,경춘선,신내,2277,2157,4434
2022-12-14,경춘선,천마산,1540,1418,2958
2022-12-14,경춘선,청평,1280,1262,2542
2022-12-14,경춘선,춘천,1228,1046,2274
2022-12-14,경춘선,퇴계원,3491,3268,6759
2022-12-14,경춘선,평내호평,6154,6054,12208
2022-12-14,공항철도,검암,6986,6872,13858
2022-12-14,공항철도,계양,12955,11945,24900
2022-12-14,공항철도,공덕,2783,3663,6446
2022-12-14,공항철도,공항화물청사,2344,2544,4888
2022-12-14,공항철도,김포공항,10514,6812,17326
2022-12-14,공항철도,디지털미디어시티,15873,14554,30427
2022-12-14,공항철도,마곡나루,11150,11169,22319
2022-12-14,공항철도,서울역,10551,8965,19516
2022-12-14,공항철도,영종,3555,3498,7053
2022-12-14,공항철도,운서,8441,8601,17042
2022-12-14,공항철도,인천공항1터미널,10795,10335,21130
2022-12-14,공항철도,인천공항2터미널,4323,3974,8297
2022-12-14,공항철도,청라국제도시,7349,7029,14378
2022-12-14,공항철도,홍대입구,10968,11334,22302
2022-12-14,과천선,경마공원,1583,1737,3320
2022-12-14,과천선,과천,7014,6918,13932
2022-12-14,과천선,대공원,3643,3608,7251
2022-12-14,과천선,범계,27688,27993,55681
2022-12-14,과천선,선바위,8461,8261,16722
2022-12-14,과천선,인덕원,25902,27251,53153
2022-12-14,과천선,정부과천청사,11535,12151,23686
2022-12-14,과천선,평촌,19148,19089,38237
2022-12-14,분당선,가천대,8633,9567,18200
2022-12-14,분당선,강남구청,10580,12116,22696
2022-12-14,분당선,개포동,4426,4571,8997
2022-12-14,분당선,구룡,2489,2343,4832
2022-12-14,분당선,구성,5595,5820,11415
2022-12-14,분당선,기흥,12002,11521,23523
2022-12-14,분당선,대모산입구,5306,4904,10210
2022-12-14,분당선,도곡,8108,8008,16116
2022-12-14,분당선,망포,16746,16047,32793
2022-12-14,분당선,매교,4874,4840,9714
2022-12-14,분당선,매탄권선,5759,5550,11309
2022-12-14,분당선,모란,22617,23452,46069
2022-12-14,분당선,미금,16452,17692,34144
2022-12-14,분당선,보정,2935,2547,5482
2022-12-14,분당선,상갈,5910,5779,11689
2022-12-14,분당선,서울숲,11632,11981,23613
2022-12-14,분당선,서현,26085,26630,52715
2022-12-14,분당선,선릉,14982,22829,37811
2022-12-14,분당선,선정릉,8694,9159,17853
2022-12-14,분당선,수내,15357,15215,30572
2022-12-14,분당선,수서,15234,15788,31022
2022-12-14,분당선,수원,8396,7223,15619
2022-12-14,분당선,수원시청,13911,14727,28638
2022-12-14,분당선,신갈,5317,5141,10458
2022-12-14,분당선,압구정로데오,20044,21979,42023
2022-12-14,분당선,야탑,28806,30401,59207
2022-12-14,분당선,영통,9507,9405,18912
2022-12-14,분당선,오리,12292,10089,22381
2022-12-14,분당선,이매,6162,5898,12060
2022-12-14,분당선,정자,20937,21863,42800
2022-12-14,분당선,죽전,15212,16584,31796
2022-12-14,분당선,청명,4869,4714,9583
2022-12-14,분당선,태평,14302,13600,27902
2022-12-14,분당선,한티,15324,16250,31574
2022-12-14,수인선,고색,5417,4915,10332
2022-12-14,수인선,남동인더스파크,2264,2615,4879
2022-12-14,수인선,달월,93,61,154
2022-12-14,수인선,사리,5376,4535,9911
2022-12-14,수인선,소래포구,4475,4080,8555
2022-12-14,수인선,송도,2659,2360,5019
2022-12-14,수인선,숭의,4063,3800,7863
2022-12-14,수인선,신포,1841,1852,3693
2022-12-14,수인선,야목,365,281,646
2022-12-14,수인선,어천,1073,999,2072
2022-12-14,수인선,연수,4726,4672,9398
2022-12-14,수인선,오목천,3916,3725,7641
2022-12-14,수인선,원인재,4579,4699,9278
2022-12-14,수인선,월곶,2863,2664,5527
2022-12-14,수인선,인천,893,1472,2365
2022-12-14,수인선,인천논현,5757,6158,11915
2022-12-14,수인선,인하대,6441,5882,12323
2022-12-14,수인선,호구포,4368,4501,8869
2022-12-14,신림선,관악산,2337,2319,4656
2022-12-14,신림선,당곡,4417,4463,8880
2022-12-14,신림선,대방,2706,1979,4685
2022-12-14,신림선,보라매,3720,3392,7112
2022-12-14,신림선,보라매공원,2043,2116,4159
2022-12-14,신림선,보라매병원,7689,8060,15749
2022-12-14,신림선,샛강,2764,3396,6160
2022-12-14,신림선,서울대벤처타운,8061,7897,15958
2022-12-14,신림선,서울지방병무청,2648,2942,5590
2022-12-14,신림선,서원,3395,3003,6398
2022-12-14,신림선,신림,1769,2515,4284
2022-12-14,안산선,고잔,9558,9020,18578
2022-12-14,안산선,대야미,4929,4474,9403
2022-12-14,안산선,반월,4307,4134,8441
2022-12-14,안산선,산본,16206,17631,33837
2022-12-14,안산선,상록수,16562,16890,33452
2022-12-14,안산선,수리산,4239,3484,7723
2022-12-14,안산선,신길온천,1847,1675,3522
2022-12-14,안산선,안산,11736,10792,22528
2022-12-14,안산선,오이도,8501,8276,16777
2022-12-14,안산선,정왕,10282,10488,20770
2022-12-14,안산선,중앙,18258,19335,37593
2022-12-14,안산선,초지,5420,5669,11089
2022-12-14,안산선,한대앞,10132,10157,20289
2022-12-14,우이신설선,4.19민주묘지,3827,3720,7547
2022-12-14,우이신설선,가오리,4282,4319,8601
2022-12-14,우이신설선,보문,1621,1659,3280
2022-12-14,우이신설선,북한산보국문,6535,6213,12748
2022-12-14,우이신설선,북한산우이,2459,2116,4575
2022-12-14,우이신설선,삼양,2054,2138,4192
2022-12-14,우이신설선,삼양사거리,2490,2449,4939
2022-12-14,우이신설선,성신여대입구,3760,4255,8015
2022-12-14,우이신설선,솔밭공원,2539,2439,4978
2022-12-14,우이신설선,솔샘,6252,5950,12202
2022-12-14,우이신설선,신설동,2352,2280,4632
2022-12-14,우이신설선,정릉,4926,4762,9688
2022-12-14,우이신설선,화계,3594,3380,6974
2022-12-14,일산선,대곡,2178,1593,3771
2022-12-14,일산선,대화,13931,10904,24835
2022-12-14,일산선,마두,7909,8155,16064
2022-12-14,일산선,백석,9962,10050,20012
2022-12-14,일산선,삼송,20541,19934,40475
2022-12-14,일산선,원당,11235,10545,21780
2022-12-14,일산선,원흥,11942,11272,23214
2022-12-14,일산선,정발산,6900,6984,13884
2022-12-14,일산선,주엽,9271,9240,18511
2022-12-14,일산선,화정,17082,17382,34464
2022-12-14,장항선,배방,1412,1291,2703
2022-12-14,장항선,봉명,1732,1696,3428
2022-12-14,장항선,신창,1780,1671,3451
2022-12-14,장항선,쌍용,3452,3133,6585
2022-12-14,장항선,아산,4203,3906,8109
2022-12-14,장항선,온양온천,4572,4716,9288
2022-12-14,장항선,탕정,1570,1320,2890
2022-12-14,중앙선,구리,13549,13725,27274
2022-12-14,중앙선,국수,688,695,1383
2022-12-14,중앙선,덕소,5464,5465,10929
2022-12-14,중앙선,도농,12040,10646,22686
2022-12-14,중앙선,도심,2514,1945,4459
2022-12-14,중앙선,망우,7547,7515,15062
2022-12-14,중앙선,상봉,5585,5656,11241
2022-12-14,중앙선,신원,153,132,285
2022-12-14,중앙선,아신,526,554,1080
2022-12-14,중앙선,양수,1622,1614,3236
2022-12-14,중앙선,양원,3183,3003,6186
2022-12-14,중앙선,양정,596,533,1129
2022-12-14,중앙선,양평,2580,2588,5168
2022-12-14,중앙선,오빈,265,268,533
2022-12-14,중앙선,용문,1345,1367,2712
2022-12-14,중앙선,운길산,535,472,1007
2022-12-14,중앙선,원덕,297,287,584
2022-12-14,중앙선,중랑,5529,5438,10967
2022-12-14,중앙선,지평,66,47,113
2022-12-14,중앙선,팔당,670,700,1370
2022-12-14,중앙선,회기,27268,26338,53606
2022-12-15,1호선,동대문,11235,10647,21882
2022-12-15,1호선,동묘앞,6584,6888,13472
2022-12-15,1호선,서울역,55622,53440,109062
2022-12-15,1호선,시청,29519,29465,58984
2022-12-15,1호선,신설동,14616,14244,28860
2022-12-15,1호선,제기동,15478,15506,30984
2022-12-15,1호선,종각,45191,43329,88520
2022-12-15,1호선,종로3가,26801,24595,51396
2022-12-15,1호선,종로5가,25146,24447,49593
2022-12-15,1호선,청량리,19495,19047,38542
2022-12-15,2호선,강남,88071,83672,171743
2022-12-15,2호선,강변,32133,29821,61954
2022-12-15,2호선,건대입구,37513,39932,77445
2022-12-15,2호선,교대,39164,44597,83761
2022-12-15,2호선,구로디지털단지,65062,65105,130167
2022-12-15,2호선,구의,26721,26562,53283
2022-12-15,2호선,낙성대,29932,28994,58926
2022-12-15,2호선,당산,19942,23601,43543
2022-12-15,2호선,대림,24875,25237,50112
2022-12-15,2호선,도림천,1566,1698,3264
2022-12-15,2호선,동대문역사문화공원,14715,17051,31766
2022-12-15,2호선,뚝섬,24952,26198,51150
2022-12-15,2호선,문래,25160,25362,50522
2022-12-15,2호선,방배,21407,22277,43684
2022-12-15,2호선,봉천,25791,24228,50019
2022-12-15,2호선,사당,44799,48542,93341
2022-12-15,2호선,삼성,66391,65856,132247
2022-12-15,2호선,상왕십리,15966,15772,31738
2022-12-15,2호선,서울대입구,49663,48817,98480
2022-12-15,2호선,서초,26039,25027,51066
2022-12-15,2호선,선릉,66218,58292,124510
2022-12-15,2호선,성수,44424,47013,91437
2022-12-15,2호선,시청,30364,27483,57847
2022-12-15,2호선,신답,1843,2206,4049
2022-12-15,2호선,신당,15149,15829,30978
2022-12-15,2호선,신대방,26670,26184,52854
2022-12-15,2호선,신도림,55367,55936,111303
2022-12-15,2호선,신림,61561,60035,121596
2022-12-15,2호선,신설동,3954,3923,7877
2022-12-15,2호선,신정네거리,11254,11856,23110
2022-12-15,2호선,신촌,40041,40334,80375
2022-12-15,2호선,아현,11825,11381,23206
2022-12-15,2호선,양천구청,7695,8314,16009
2022-12-15,2호선,역삼,62930,69901,132831
2022-12-15,2호선,영등포구청,24849,25235,50084
2022-12-15,2호선,왕십리,18371,15653,34024
2022-12-15,2호선,용답,3193,3365,6558
2022-12-15,2호선,용두,2624,2633,5257
2022-12-15,2호선,을지로3가,27616,27356,54972
2022-12-15,2호선,을지로4가,15229,15189,30418
2022-12-15,2호선,을지로입구,52609,53122,105731
2022-12-15,2호선,이대,16780,18226,35006
2022-12-15,2호선,잠실,86526,86382,172908
2022-12-15,2호선,잠실나루,16876,16464,33340
2022-12-15,2호선,잠실새내,25013,25099,50112
2022-12-15,2호선,종합운동장,8559,9562,18121
2022-12-15,2호선,충정로,11595,12330,23925
2022-12-15,2호선,한양대,13673,14622,28295
2022-12-15,2호선,합정,33910,36405,70315
2022-12-15,2호선,홍대입구,63710,67152,130862
2022-12-15,3호선,가락시장,10485,10503,20988
2022-12-15,3호선,경복궁,26786,26073,52859
2022-12-15,3호선,경찰병원,8765,8897,17662
2022-12-15,3호선,고속터미널,46599,43697,90296
2022-12-15,3호선,교대,18031,11012,29043
2022-12-15,3호선,구파발,23165,22431,45596
2022-12-15,3호선,금호,8718,8394,17112
2022-12-15,3호선,남부터미널,32845,32868,65713
2022-12-15,3호선,녹번,17320,15715,33035
2022-12-15,3호선,대청,11593,10898,22491
2022-12-15,3호선,대치,11886,12237,24123
2022-12-15,3호선,도곡,6302,6260,12562
2022-12-15,3호선,독립문,7580,7681,15261
2022-12-15,3호선,동대입구,8991,9584,18575
2022-12-15,3호선,매봉,14868,14291,29159
2022-12-15,3호선,무악재,4639,4578,9217
2022-12-15,3호선,불광,17166,18662,35828
2022-12-15,3호선,수서,20150,20629,40779
2022-12-15,3호선,신사,32840,33745,66585
2022-12-15,3호선,안국,27813,28362,56175
2022-12-15,3호선,압구정,36483,39153,75636
2022-12-15,3호선,약수,14440,14007,28447
2022-12-15,3호선,양재,44673,47439,92112
2022-12-15,3호선,연신내,37341,35969,73310
2022-12-15,3호선,오금,7131,6509,13640
2022-12-15,3호선,옥수,9797,10250,20047
2022-12-15,3호선,을지로3가,13317,12931,26248
2022-12-15,3호선,일원,12830,12334,25164
2022-12-15,3호선,잠원,5551,5416,10967
2022-12-15,3호선,종로3가,11408,13176,24584
2022-12-15,3호선,지축,6485,6415,12900
2022-12-15,3호선,학여울,2168,2278,4446
2022-12-15,3호선,홍제,19149,18923,38072
2022-12-15,4호선,길음,23694,23970,47664
2022-12-15,4호선,남태령,1411,1346,2757
2022-12-15,4호선,노원,20051,22886,42937
2022-12-15,4호선,당고개,9733,8741,18474
2022-12-15,4호선,동대문,20613,21003,41616
2022-12-15,4호선,동대문역사문화공원,18852,16625,35477
2022-12-15,4호선,동작,1134,1273,2407
2022-12-15,4호선,명동,28698,30103,58801
2022-12-15,4호선,미아,15778,15220,30998
2022-12-15,4호선,미아사거리,28250,28661,56911
2022-12-15,4호선,사당,29911,26088,55999
2022-12-15,4호선,삼각지,6723,7520,14243
2022-12-15,4호선,상계,20596,19339,39935
2022-12-15,4호선,서울역,13782,21639,35421
2022-12-15,4호선,성신여대입구,21826,21052,42878
2022-12-15,4호선,수유,35789,36436,72225
2022-12-15,4호선,숙대입구,15155,14536,29691
2022-12-15,4호선,신용산,21230,21454,42684
2022-12-15,4호선,쌍문,30663,28987,59650
2022-12-15,4호선,이촌,10556,11573,22129
2022-12-15,4호선,창동,26358,28242,54600
2022-12-15,4호선,총신대입구,19991,22344,42335
2022-12-15,4호선,충무로,32262,32297,64559
2022-12-15,4호선,한성대입구,14595,14332,28927
2022-12-15,4호선,혜화,40467,39649,80116
2022-12-15,4호선,회현,27777,28338,56115
2022-12-15,5호선,강동,20597,19995,40592
2022-12-15,5호선,강일,5802,5405,11207
2022-12-15,5호선,개롱,7121,7505,14626
2022-12-15,5호선,개화산,6135,5807,11942
2022-12-15,5호선,거여,11328,11061,22389
2022-12-15,5호선,고덕,11071,11029,22100
2022-12-15,5호선,공덕,16986,17827,34813
2022-12-15,5호선,광나루,14804,13797,28601
2022-12-15,5호선,광화문,38439,39387,77826
2022-12-15,5호선,군자,12394,13773,26167
2022-12-15,5호선,굽은다리,10690,10448,21138
2022-12-15,5호선,길동,8801,9217,18018
2022-12-15,5호선,김포공항,8624,8104,16728
2022-12-15,5호선,까치산,30915,30040,60955
2022-12-15,5호선,답십리,17939,16602,34541
2022-12-15,5호선,동대문역사문화공원,3856,4163,8019
2022-12-15,5호선,둔촌동,9359,9550,18909
2022-12-15,5호선,마곡,13135,12945,26080
2022-12-15,5호선,마장,6887,6639,13526
2022-12-15,5호선,마천,8096,7825,15921
2022-12-15,5호선,마포,17929,18186,36115
2022-12-15,5호선,명일,9587,10106,19693
2022-12-15,5호선,목동,17878,20061,37939
2022-12-15,5호선,미사,18968,19192,38160
2022-12-15,5호선,발산,25171,24976,50147
2022-12-15,5호선,방이,8152,8571,16723
2022-12-15,5호선,방화,7331,7216,14547
2022-12-15,5호선,상일동,16462,15875,32337
2022-12-15,5호선,서대문,24455,24195,48650
2022-12-15,5호선,송정,6889,6538,13427
2022-12-15,5호선,신금호,7291,7743,15034
2022-12-15,5호선,신길,4724,5202,9926
2022-12-15,5호선,신정,14985,12507,27492
2022-12-15,5호선,아차산,15404,14921,30325
2022-12-15,5호선,애오개,7815,8064,15879
2022-12-15,5호선,양평,8340,8407,16747
2022-12-15,5호선,여의나루,11487,14557,26044
2022-12-15,5호선,여의도,37241,37004,74245
2022-12-15,5호선,영등포구청,4442,4613,9055
2022-12-15,5호선,영등포시장,11487,11923,23410
2022-12-15,5호선,오금,4157,4175,8332
2022-12-15,5호선,오목교,24438,25960,50398
2022-12-15,5호선,올림픽공원,4834,4259,9093
2022-12-15,5호선,왕십리,5057,5903,10960
2022-12-15,5호선,우장산,16172,16092,32264
2022-12-15,5호선,을지로4가,7053,7080,14133
2022-12-15,5호선,장한평,21015,21118,42133
2022-12-15,5호선,종로3가,15500,14434,29934
2022-12-15,5호선,천호,19581,19367,38948
2022-12-15,5호선,청구,4488,4129,8617
2022-12-15,5호선,충정로,5482,5503,10985
2022-12-15,5호선,하남검단산,6594,6450,13044
2022-12-15,5호선,하남시청,7961,7762,15723
2022-12-15,5호선,하남풍산,4903,4855,9758
2022-12-15,5호선,행당,9257,8537,17794
2022-12-15,5호선,화곡,31035,29522,60557
2022-12-15,6호선,고려대,10282,9951,20233
2022-12-15,6호선,공덕,21516,20830,42346
2022-12-15,6호선,광흥창,10448,10164,20612
2022-12-15,6호선,구산,8540,6613,15153
2022-12-15,6호선,녹사평,5591,5588,11179
2022-12-15,6호선,대흥,10165,10657,20822
2022-12-15,6호선,독바위,2984,3149,6133
2022-12-15,6호선,돌곶이,10681,9978,20659
2022-12-15,6호선,동묘앞,8121,8449,16570
2022-12-15,6호선,디지털미디어시티,16198,18330,34528
2022-12-15,6호선,마포구청,16548,15056,31604
2022-12-15,6호선,망원,15034,16054,31088
2022-12-15,6호선,버티고개,2478,2448,4926
2022-12-15,6호선,보문,8620,7841,16461
2022-12-15,6호선,봉화산,10004,9547,19551
2022-12-15,6호선,불광,4697,4581,9278
2022-12-15,6호선,삼각지,8256,7366,15622
2022-12-15,6호선,상수,10320,11596,21916
2022-12-15,6호선,상월곡,7524,6981,14505
2022-12-15,6호선,새절,14179,13414,27593
2022-12-15,6호선,석계,13841,14667,28508
2022-12-15,6호선,신내,1,0,1
2022-12-15,6호선,신당,9719,9939,19658
2022-12-15,6호선,안암,15171,14710,29881
2022-12-15,6호선,약수,3883,3898,7781
2022-12-15,6호선,역촌,4119,4970,9089
2022-12-15,6호선,연신내,2,0,2
2022-12-15,6호선,월곡,12999,12778,25777
2022-12-15,6호선,월드컵경기장,4308,4605,8913
2022-12-15,6호선,응암,18892,19254,38146
2022-12-15,6호선,이태원,10314,10501,20815
2022-12-15,6호선,증산,10677,10955,21632
2022-12-15,6호선,창신,3951,3320,7271
2022-12-15,6호선,청구,4214,4387,8601
2022-12-15,6호선,태릉입구,6101,6902,13003
2022-12-15,6호선,한강진,8905,10110,19015
2022-12-15,6호선,합정,14628,14300,28928
2022-12-15,6호선,화랑대,13905,10576,24481
2022-12-15,6호선,효창공원앞,8108,7678,15786
2022-12-15,7호선,가산디지털단지,50199,49248,99447
2022-12-15,7호선,강남구청,19048,20878,39926
2022-12-15,7호선,건대입구,15485,16043,31528
2022-12-15,7호선,고속터미널,17758,14998,32756
2022-12-15,7호선,공릉,13475,13393,26868
2022-12-15,7호선,광명사거리,22253,22079,44332
2022-12-15,7호선,군자,16792,13400,30192
2022-12-15,7호선,남구로,16747,17708,34455
2022-12-15,7호선,남성,12501,11689,24190
2022-12-15,7호선,내방,16841,17304,34145
2022-12-15,7호선,노원,21737,22637,44374
2022-12-15,7호선,논현,20388,20998,41386
2022-12-15,7호선,대림,8310,8512,16822
2022-12-15,7호선,도봉산,10062,11511,21573
2022-12-15,7호선,뚝섬유원지,7823,7715,15538
2022-12-15,7호선,마들,14549,13867,28416
2022-12-15,7호선,먹골,11136,11015,22151
2022-12-15,7호선,면목,17144,16801,33945
2022-12-15,7호선,반포,6902,6830,13732
2022-12-15,7호선,보라매,7910,8208,16118
2022-12-15,7호선,사가정,17359,17885,35244
2022-12-15,7호선,상도,13262,13009,26271
2022-12-15,7호선,상봉,18669,17897,36566
2022-12-15,7호선,수락산,13869,13794,27663
2022-12-15,7호선,숭실대입구,14415,14562,28977
2022-12-15,7호선,신대방삼거리,16221,15567,31788
2022-12-15,7호선,신풍,12543,12079,24622
2022-12-15,7호선,어린이대공원,18667,18583,37250
2022-12-15,7호선,온수,11737,10986,22723
2022-12-15,7호선,용마산,6515,6222,12737
2022-12-15,7호선,이수,18156,17289,35445
2022-12-15,7호선,장승배기,9794,9728,19522
2022-12-15,7호선,장암,2614,950,3564
2022-12-15,7호선,중계,16480,15418,31898
2022-12-15,7호선,중곡,12374,11531,23905
2022-12-15,7호선,중화,11727,11811,23538
2022-12-15,7호선,천왕,12645,12159,24804
2022-12-15,7호선,철산,23380,24260,47640
2022-12-15,7호선,청담,22320,25064,47384
2022-12-15,7호선,태릉입구,10273,9547,19820
2022-12-15,7호선,하계,20302,19345,39647
2022-12-15,7호선,학동,27842,29279,57121
2022-12-15,8호선,가락시장,9409,10194,19603
2022-12-15,8호선,강동구청,12326,12678,25004
2022-12-15,8호선,남위례,7073,7344,14417
2022-12-15,8호선,남한산성입구,14885,14045,28930
2022-12-15,8호선,단대오거리,12602,12302,24904
2022-12-15,8호선,모란,4815,3676,8491
2022-12-15,8호선,몽촌토성,7105,7343,14448
2022-12-15,8호선,문정,25009,25801,50810
2022-12-15,8호선,복정,10683,9063,19746
2022-12-15,8호선,산성,5677,5668,11345
2022-12-15,8호선,석촌,8642,9823,18465
2022-12-15,8호선,송파,10400,10447,20847
2022-12-15,8호선,수진,5932,5579,11511
2022-12-15,8호선,신흥,5453,5886,11339
2022-12-15,8호선,암사,21118,18803,39921
2022-12-15,8호선,잠실,18501,21633,40134
2022-12-15,8호선,장지,20519,19305,39824
2022-12-15,8호선,천호,16086,18474,34560
2022-12-15,9호선,가양,23479,23373,46852
2022-12-15,9호선,개화,2927,1912,4839
2022-12-15,9호선,고속터미널,13763,18014,31777
2022-12-15,9호선,공항시장,3293,3537,6830
2022-12-15,9호선,구반포,1464,1486,2950
2022-12-15,9호선,국회의사당,20398,20097,40495
2022-12-15,9호선,김포공항,7926,11848,19774
2022-12-15,9호선,노들,4990,4293,9283
2022-12-15,9호선,노량진,29252,28272,57524
2022-12-15,9호선,당산,21494,21652,43146
2022-12-15,9호선,동작,1742,1267,3009
2022-12-15,9호선,등촌,13186,12732,25918
2022-12-15,9호선,마곡나루,14978,14178,29156
2022-12-15,9호선,사평,4469,4497,8966
2022-12-15,9호선,샛강,7906,7513,15419
2022-12-15,9호선,선유도,10207,9535,19742
2022-12-15,9호선,신논현,32829,32012,64841
2022-12-15,9호선,신목동,4905,4322,9227
2022-12-15,9호선,신반포,4412,4358,8770
2022-12-15,9호선,신방화,7866,7782,15648
2022-12-15,9호선,양천향교,10943,11310,22253
2022-12-15,9호선,여의도,36410,33704,70114
2022-12-15,9호선,염창,19460,19370,38830
2022-12-15,9호선,증미,8283,8001,16284
2022-12-15,9호선,흑석,10401,10760,21161
2022-12-15,9호선2~3단계,둔촌오륜,1252,1284,2536
2022-12-15,9호선2~3단계,봉은사,22415,23038,45453
2022-12-15,9호선2~3단계,삼성중앙,8890,9317,18207
2022-12-15,9호선2~3단계,삼전,7932,7842,15774
2022-12-15,9호선2~3단계,석촌,9605,8480,18085
2022-12-15,9호선2~3단계,석촌고분,7369,7331,14700
2022-12-15,9호선2~3단계,선정릉,11161,12363,23524
2022-12-15,9호선2~3단계,송파나루,5976,6428,12404
2022-12-15,9호선2~3단계,언주,13190,13354,26544
2022-12-15,9호선2~3단계,올림픽공원,6937,6990,13927
2022-12-15,9호선2~3단계,종합운동장,4956,4930,9886
2022-12-15,9호선2~3단계,중앙보훈병원,13097,11485,24582
2022-12-15,9호선2~3단계,한성백제,3112,2747,5859
2022-12-15,경강선,경기광주,9202,8826,18028
2022-12-15,경강선,곤지암,2649,2383,5032
2022-12-15,경강선,부발,2843,2189,5032
2022-12-15,경강선,삼동,2903,2741,5644
2022-12-15,경강선,세종대왕릉,351,355,706
2022-12-15,경강선,신둔도예촌,1808,1680,3488
2022-12-15,경강선,여주,2653,2544,5197
2022-12-15,경강선,이매,1368,1174,2542
2022-12-15,경강선,이천,2993,3002,5995
2022-12-15,경강선,초월,3794,3613,7407
2022-12-15,경강선,판교,6423,6326,12749
2022-12-15,경부선,가산디지털단지,19485,22649,42134
2022-12-15,경부선,관악,7928,7442,15370
2022-12-15,경부선,광명,4028,3443,7471
2022-12-15,경부선,구로,20014,20487,40501
2022-12-15,경부선,군포,8382,8011,16393
2022-12-15,경부선,금정,30042,31169,61211
2022-12-15,경부선,금천구청,12267,12149,24416
2022-12-15,경부선,남영,10122,10851,20973
2022-12-15,경부선,노량진,9341,10159,19500
2022-12-15,경부선,당정,7597,7082,14679
2022-12-15,경부선,대방,12024,13386,25410
2022-12-15,경부선,독산,19801,20360,40161
2022-12-15,경부선,두정,8167,8619,16786
2022-12-15,경부선,명학,10686,10506,21192
2022-12-15,경부선,병점,16298,16552,32850
2022-12-15,경부선,서동탄,1523,1314,2837
2022-12-15,경부선,서울역,8767,2655,11422
2022-12-15,경부선,서정리,9049,7661,16710
2022-12-15,경부선,석수,10000,8944,18944
2022-12-15,경부선,성균관대,16896,16904,33800
2022-12-15,경부선,성환,4487,4290,8777
2022-12-15,경부선,세류,3500,3201,6701
2022-12-15,경부선,세마,3336,3183,6519
2022-12-15,경부선,송탄,4546,4635,9181
2022-12-15,경부선,수원,39225,41291,80516
2022-12-15,경부선,신길,9537,8200,17737
2022-12-15,경부선,신도림,4202,4487,8689
2022-12-15,경부선,안양,27827,27279,55106
2022-12-15,경부선,영등포,43277,44891,88168
2022-12-15,경부선,오산,10713,10655,21368
2022-12-15,경부선,오산대,4205,3882,8087
2022-12-15,경부선,용산,42108,42277,84385
2022-12-15,경부선,의왕,10297,10039,20336
2022-12-15,경부선,직산,1010,959,1969
2022-12-15,경부선,진위,2091,1673,3764
2022-12-15,경부선,천안,6875,6215,13090
2022-12-15,경부선,평택,13020,12761,25781
2022-12-15,경부선,평택지제,5032,4773,9805
2022-12-15,경부선,화서,9175,8939,18114
2022-12-15,경원선,가능,6895,6806,13701
2022-12-15,경원선,광운대,8614,8220,16834
2022-12-15,경원선,녹양,4908,4594,9502
2022-12-15,경원선,녹천,5012,4115,9127
2022-12-15,경원선,덕계,3569,3087,6656
2022-12-15,경원선,덕정,6505,6075,12580
2022-12-15,경원선,도봉,6520,6237,12757
2022-12-15,경원선,도봉산,6756,4290,11046
2022-12-15,경원선,동두천,2646,2670,5316
2022-12-15,경원선,동두천중앙,3010,3054,6064
2022-12-15,경원선,망월사,9594,9663,19257
2022-12-15,경원선,방학,10353,10077,20430
2022-12-15,경원선,보산,1481,1362,2843
2022-12-15,경원선,서빙고,2233,2066,4299
2022-12-15,경원선,석계,8414,9651,18065
2022-12-15,경원선,소요산,1617,1438,3055
2022-12-15,경원선,신이문,9017,8255,17272
2022-12-15,경원선,양주,7940,7514,15454
2022-12-15,경원선,옥수,73,41,114
2022-12-15,경원선,왕십리,17376,18177,35553
2022-12-15,경원선,외대앞,9964,10022,19986
2022-12-15,경원선,월계,8229,7691,15920
2022-12-15,경원선,응봉,2020,1782,3802
2022-12-15,경원선,의정부,19736,19940,39676
2022-12-15,경원선,이촌,4696,3605,8301
2022-12-15,경원선,지행,7051,6945,13996
2022-12-15,경원선,창동,1,0,1
2022-12-15,경원선,청량리,16413,16546,32959
2022-12-15,경원선,한남,4416,4075,8491
2022-12-15,경원선,회룡,13093,12856,25949
2022-12-15,경의선,가좌,6095,6066,12161
2022-12-15,경의선,강매,3586,3042,6628
2022-12-15,경의선,곡산,595,582,1177
2022-12-15,경의선,공덕,4417,3753,8170
2022-12-15,경의선,금릉,5398,5301,10699
2022-12-15,경의선,금촌,6815,6552,13367
2022-12-15,경의선,능곡,3971,3686,7657
2022-12-15,경의선,디지털미디어시티,3157,2828,5985
2022-12-15,경의선,문산,4989,5069,10058
2022-12-15,경의선,백마,7595,7358,14953
2022-12-15,경의선,서강대,2457,2357,4814
2022-12-15,경의선,서울역,4786,6357,11143
2022-12-15,경의선,수색,2942,3215,6157
2022-12-15,경의선,신촌,1039,1317,2356
2022-12-15,경의선,야당,8807,9059,17866
2022-12-15,경의선,운정,7484,7207,14691
2022-12-15,경의선,월롱,3476,2716,6192
2022-12-15,경의선,일산,9951,10084,20035
2022-12-15,경의선,임진강,4,0,4
2022-12-15,경의선,탄현,8561,8328,16889
2022-12-15,경의선,파주,1437,986,2423
2022-12-15,경의선,풍산,6289,5892,12181
2022-12-15,경의선,행신,9225,9100,18325
2022-12-15,경의선,홍대입구,1864,2243,4107
2022-12-15,경의선,화전,3123,2756,5879
2022-12-15,경의선,효창공원앞,3289,3792,7081
2022-12-15,경인선,간석,6351,6181,12532
2022-12-15,경인선,개봉,23595,23032,46627
2022-12-15,경인선,구일,7168,7118,14286
2022-12-15,경인선,도원,3467,3394,6861
2022-12-15,경인선,도화,4269,3906,8175
2022-12-15,경인선,동암,16480,16743,33223
2022-12-15,경인선,동인천,14458,13760,28218
2022-12-15,경인선,백운,6980,6947,13927
2022-12-15,경인선,부개,9091,8520,17611
2022-12-15,경인선,부천,32981,32832,65813
2022-12-15,경인선,부평,30181,32093,62274
2022-12-15,경인선,소사,8559,8566,17125
2022-12-15,경인선,송내,29031,28660,57691
2022-12-15,경인선,역곡,30168,29432,59600
2022-12-15,경인선,오류동,12063,11028,23091
2022-12-15,경인선,온수,7221,6916,14137
2022-12-15,경인선,인천,3374,2521,5895
2022-12-15,경인선,제물포,11569,11101,22670
2022-12-15,경인선,주안,19972,18352,38324
2022-12-15,경인선,중동,9873,9277,19150
2022-12-15,경춘선,가평,1724,1715,3439
2022-12-15,경춘선,갈매,3352,2882,6234
2022-12-15,경춘선,강촌,413,371,784
2022-12-15,경춘선,굴봉산,129,122,251
2022-12-15,경춘선,금곡,1568,1563,3131
2022-12-15,경춘선,김유정,304,328,632
2022-12-15,경춘선,남춘천,2759,2570,5329
2022-12-15,경춘선,대성리,499,421,920
2022-12-15,경춘선,마석,4423,4291,8714
2022-12-15,경춘선,백양리,362,320,682
2022-12-15,경춘선,별내,3453,3208,6661
2022-12-15,경춘선,사릉,2432,2366,4798
2022-12-15,경춘선,상천,188,183,371
2022-12-15,경춘선,신내,2358,2362,4720
2022-12-15,경춘선,천마산,1666,1550,3216
2022-12-15,경춘선,청평,1515,1465,2980
2022-12-15,경춘선,춘천,1431,1167,2598
2022-12-15,경춘선,퇴계원,3831,3540,7371
2022-12-15,경춘선,평내호평,7031,6883,13914
2022-12-15,공항철도,검암,7225,7051,14276
2022-12-15,공항철도,계양,13480,12523,26003
2022-12-15,공항철도,공덕,2815,3874,6689
2022-12-15,공항철도,공항화물청사,2502,2599,5101
2022-12-15,공항철도,김포공항,11479,6947,18426
2022-12-15,공항철도,디지털미디어시티,17048,15427,32475
2022-12-15,공항철도,마곡나루,11565,11194,22759
2022-12-15,공항철도,서울역,11607,10076,21683
2022-12-15,공항철도,영종,3808,3857,7665
2022-12-15,공항철도,운서,8688,9015,17703
2022-12-15,공항철도,인천공항1터미널,11472,10446,21918
2022-12-15,공항철도,인천공항2터미널,4777,4104,8881
2022-12-15,공항철도,청라국제도시,7591,7337,14928
2022-12-15,공항철도,홍대입구,11528,12083,23611
2022-12-15,과천선,경마공원,1390,1447,2837
2022-12-15,과천선,과천,7209,6958,14167
2022-12-15,과천선,대공원,3661,3656,7317
2022-12-15,과천선,범계,28671,29525,58196
2022-12-15,과천선,선바위,8702,7910,16612
2022-12-15,과천선,인덕원,27579,28954,56533
2022-12-15,과천선,정부과천청사,12252,12252,24504
2022-12-15,과천선,평촌,20598,20253,40851
2022-12-15,분당선,가천대,8927,9836,18763
2022-12-15,분당선,강남구청,11071,12635,23706
2022-12-15,분당선,개포동,4701,4846,9547
2022-12-15,분당선,구룡,2630,2517,5147
2022-12-15,분당선,구성,5994,6291,12285
2022-12-15,분당선,기흥,12232,11567,23799
2022-12-15,분당선,대모산입구,5640,5370,11010
2022-12-15,분당선,도곡,8642,8588,17230
2022-12-15,분당선,망포,18774,17649,36423
2022-12-15,분당선,매교,5265,5342,10607
2022-12-15,분당선,매탄권선,6442,6220,12662
2022-12-15,분당선,모란,20695,21045,41740
2022-12-15,분당선,미금,17301,18295,35596
2022-12-15,분당선,보정,3305,2955,6260
2022-12-15,분당선,상갈,6483,6237,12720
2022-12-15,분당선,서울숲,12316,12797,25113
2022-12-15,분당선,서현,27811,28553,56364
2022-12-15,분당선,선릉,15881,23844,39725
2022-12-15,분당선,선정릉,9117,9438,18555
2022-12-15,분당선,수내,16583,16298,32881
2022-12-15,분당선,수서,15972,16767,32739
2022-12-15,분당선,수원,9347,7890,17237
2022-12-15,분당선,수원시청,15358,16209,31567
2022-12-15,분당선,신갈,5585,5554,11139
2022-12-15,분당선,압구정로데오,21848,23984,45832
2022-12-15,분당선,야탑,30105,31679,61784
2022-12-15,분당선,영통,10739,10413,21152
2022-12-15,분당선,오리,13600,10840,24440
2022-12-15,분당선,이매,6720,6535,13255
2022-12-15,분당선,정자,22149,23448,45597
2022-12-15,분당선,죽전,15831,17411,33242
2022-12-15,분당선,청명,5326,5359,10685
2022-12-15,분당선,태평,14206,13988,28194
2022-12-15,분당선,한티,16249,17410,33659
2022-12-15,수인선,고색,5810,5195,11005
2022-12-15,수인선,남동인더스파크,2637,2812,5449
2022-12-15,수인선,달월,117,71,188
2022-12-15,수인선,사리,5591,4997,10588
2022-12-15,수인선,소래포구,5005,4735,9740
2022-12-15,수인선,송도,2659,2549,5208
2022-12-15,수인선,숭의,4434,4233,8667
2022-12-15,수인선,신포,1982,2017,3999
2022-12-15,수인선,야목,408,306,714
2022-12-15,수인선,어천,1251,1092,2343
2022-12-15,수인선,연수,5051,4973,10024
2022-12-15,수인선,오목천,4214,3906,8120
2022-12-15,수인선,원인재,5070,5350,10420
2022-12-15,수인선,월곶,3002,2790,5792
2022-12-15,수인선,인천,919,1578,2497
2022-12-15,수인선,인천논현,6239,6459,12698
2022-12-15,수인선,인하대,6850,6663,13513
2022-12-15,수인선,호구포,4751,4737,9488
2022-12-15,신림선,관악산,2147,2249,4396
2022-12-15,신림선,당곡,4503,4395,8898
2022-12-15,신림선,대방,2790,2194,4984
2022-12-15,신림선,보라매,3828,3495,7323
2022-12-15,신림선,보라매공원,2144,2272,4416
2022-12-15,신림선,보라매병원,8300,8508,16808
2022-12-15,신림선,샛강,2869,3657,6526
2022-12-15,신림선,서울대벤처타운,8371,8118,16489
2022-12-15,신림선,서울지방병무청,2784,3164,5948
2022-12-15,신림선,서원,3556,3115,6671
2022-12-15,신림선,신림,1793,2489,4282
2022-12-15,안산선,고잔,10210,9636,19846
2022-12-15,안산선,대야미,5293,4766,10059
2022-12-15,안산선,반월,4507,4338,8845
2022-12-15,안산선,산본,17000,18285,35285
2022-12-15,안산선,상록수,17086,17463,34549
2022-12-15,안산선,수리산,4271,3523,7794
2022-12-15,안산선,신길온천,1969,1740,3709
2022-12-15,안산선,안산,12185,10966,23151
2022-12-15,안산선,오이도,8721,8658,17379
2022-12-15,안산선,정왕,9328,9353,18681
2022-12-15,안산선,중앙,19618,20614,40232
2022-12-15,안산선,초지,5522,5941,11463
2022-12-15,안산선,한대앞,10837,10871,21708
2022-12-15,우이신설선,4.19민주묘지,3513,3414,6927
2022-12-15,우이신설선,가오리,4450,4334,8784
2022-12-15,우이신설선,보문,1634,1663,3297
2022-12-15,우이신설선,북한산보국문,6753,6590,13343
2022-12-15,우이신설선,북한산우이,2569,2253,4822
2022-12-15,우이신설선,삼양,2096,2234,4330
2022-12-15,우이신설선,삼양사거리,2557,2557,5114
2022-12-15,우이신설선,성신여대입구,3740,3996,7736
2022-12-15,우이신설선,솔밭공원,2650,2517,5167
2022-12-15,우이신설선,솔샘,6473,6270,12743
2022-12-15,우이신설선,신설동,2337,2254,4591
2022-12-15,우이신설선,정릉,5057,5063,10120
2022-12-15,우이신설선,화계,3684,3454,7138
2022-12-15,일산선,대곡,2273,1659,3932
2022-12-15,일산선,대화,14767,11778,26545
2022-12-15,일산선,마두,8215,8592,16807
2022-12-15,일산선,백석,11048,11016,22064
2022-12-15,일산선,삼송,21757,21057,42814
2022-12-15,일산선,원당,11679,11188,22867
2022-12-15,일산선,원흥,12481,11743,24224
2022-12-15,일산선,정발산,7736,7934,15670
2022-12-15,일산선,주엽,10028,10278,20306
2022-12-15,일산선,화정,18213,18770,36983
2022-12-15,장항선,배방,1339,1329,2668
2022-12-15,장항선,봉명,1618,1486,3104
2022-12-15,장항선,신창,1748,1573,3321
2022-12-15,장항선,쌍용,3214,2943,6157
2022-12-15,장항선,아산,4257,3708,7965
2022-12-15,장항선,온양온천,4289,4231,8520
2022-12-15,장항선,탕정,1379,1233,2612
2022-12-15,중앙선,구리,14308,14517,28825
2022-12-15,중앙선,국수,740,759,1499
2022-12-15,중앙선,덕소,5787,5952,11739
2022-12-15,중앙선,도농,12662,11582,24244
2022-12-15,중앙선,도심,2740,2072,4812
2022-12-15,중앙선,망우,8090,7958,16048
2022-12-15,중앙선,상봉,5849,5922,11771
2022-12-15,중앙선,신원,152,142,294
2022-12-15,중앙선,아신,525,522,1047
2022-12-15,중앙선,양수,1693,1738,3431
2022-12-15,중앙선,양원,3290,3185,6475
2022-12-15,중앙선,양정,618,504,1122
2022-12-15,중앙선,양평,2871,2840,5711
2022-12-15,중앙선,오빈,280,260,540
2022-12-15,중앙선,용문,2140,2125,4265
2022-12-15,중앙선,운길산,553,499,1052
2022-12-15,중앙선,원덕,313,308,621
2022-12-15,중앙선,중랑,5760,5511,11271
2022-12-15,중앙선,지평,60,49,109
2022-12-15,중앙선,팔당,781,845,1626
2022-12-15,중앙선,회기,28578,27371,55949
2022-12-16,1호선,동대문,11738,10429,22167
2022-12-16,1호선,동묘앞,8053,8374,16427
2022-12-16,1호선,서울역,59873,58758,118631
2022-12-16,1호선,시청,28923,28991,57914
2022-12-16,1호선,신설동,15097,14482,29579
2022-12-16,1호선,제기동,16585,16663,33248
2022-12-16,1호선,종각,45342,45202,90544
2022-12-16,1호선,종로3가,28503,26905,55408
2022-12-16,1호선,종로5가,26281,25882,52163
2022-12-16,1호선,청량리,20293,20142,40435
2022-12-16,2호선,강남,93738,92254,185992
2022-12-16,2호선,강변,37202,35025,72227
2022-12-16,2호선,건대입구,41980,46051,88031
2022-12-16,2호선,교대,39406,45895,85301
2022-12-16,2호선,구로디지털단지,65874,65611,131485
2022-12-16,2호선,구의,27152,26462,53614
2022-12-16,2호선,낙성대,31229,28772,60001
2022-12-16,2호선,당산,20209,23924,44133
2022-12-16,2호선,대림,25646,26364,52010
2022-12-16,2호선,도림천,1498,1606,3104
2022-12-16,2호선,동대문역사문화공원,15757,17806,33563
2022-12-16,2호선,뚝섬,26633,28530,55163
2022-12-16,2호선,문래,24672,25514,50186
2022-12-16,2호선,방배,20732,21437,42169
2022-12-16,2호선,봉천,26290,23982,50272
2022-12-16,2호선,사당,48516,53693,102209
2022-12-16,2호선,삼성,64592,64903,129495
2022-12-16,2호선,상왕십리,16284,15609,31893
2022-12-16,2호선,서울대입구,53023,50116,103139
2022-12-16,2호선,서초,25095,24045,49140
2022-12-16,2호선,선릉,62983,56532,119515
2022-12-16,2호선,성수,45117,49640,94757
2022-12-16,2호선,시청,29248,27498,56746
2022-12-16,2호선,신답,1871,1990,3861
2022-12-16,2호선,신당,15790,16381,32171
2022-12-16,2호선,신대방,27163,25847,53010
2022-12-16,2호선,신도림,56526,56857,113383
2022-12-16,2호선,신림,64017,61947,125964
2022-12-16,2호선,신설동,4357,4252,8609
2022-12-16,2호선,신정네거리,11756,12055,23811
2022-12-16,2호선,신촌,41738,42569,84307
2022-12-16,2호선,아현,11954,11135,23089
2022-12-16,2호선,양천구청,7994,8163,16157
2022-12-16,2호선,역삼,58527,65761,124288
2022-12-16,2호선,영등포구청,24385,25290,49675
2022-12-16,2호선,왕십리,19654,17234,36888
2022-12-16,2호선,용답,3246,3225,6471
2022-12-16,2호선,용두,2696,2697,5393
2022-12-16,2호선,을지로3가,27647,27951,55598
2022-12-16,2호선,을지로4가,15841,16360,32201
2022-12-16,2호선,을지로입구,53519,55059,108578
2022-12-16,2호선,이대,17656,18329,35985
2022-12-16,2호선,잠실,94732,93866,188598
2022-12-16,2호선,잠실나루,16482,15716,32198
2022-12-16,2호선,잠실새내,26688,27438,54126
2022-12-16,2호선,종합운동장,12969,14883,27852
2022-12-16,2호선,충정로,11012,11976,22988
2022-12-16,2호선,한양대,12597,13336,25933
2022-12-16,2호선,합정,37435,41892,79327
2022-12-16,2호선,홍대입구,72345,81703,154048
2022-12-16,3호선,가락시장,10753,10755,21508
2022-12-16,3호선,경복궁,26115,26344,52459
2022-12-16,3호선,경찰병원,8527,8600,17127
2022-12-16,3호선,고속터미널,56414,56160,112574
2022-12-16,3호선,교대,18100,11493,29593
2022-12-16,3호선,구파발,23786,22799,46585
2022-12-16,3호선,금호,8890,8139,17029
2022-12-16,3호선,남부터미널,35356,35334,70690
2022-12-16,3호선,녹번,17384,15337,32721
2022-12-16,3호선,대청,11663,10843,22506
2022-12-16,3호선,대치,12495,12454,24949
2022-12-16,3호선,도곡,6023,6132,12155
2022-12-16,3호선,독립문,7975,7965,15940
2022-12-16,3호선,동대입구,8958,9872,18830
2022-12-16,3호선,매봉,14063,13666,27729
2022-12-16,3호선,무악재,4535,4467,9002
2022-12-16,3호선,불광,17508,18732,36240
2022-12-16,3호선,수서,21366,21163,42529
2022-12-16,3호선,신사,35126,37630,72756
2022-12-16,3호선,안국,28420,29160,57580
2022-12-16,3호선,압구정,37656,41279,78935
2022-12-16,3호선,약수,14921,14276,29197
2022-12-16,3호선,양재,45177,48110,93287
2022-12-16,3호선,연신내,38571,36820,75391
2022-12-16,3호선,오금,7024,6346,13370
2022-12-16,3호선,옥수,9969,10187,20156
2022-12-16,3호선,을지로3가,13169,13411,26580
2022-12-16,3호선,일원,12904,11980,24884
2022-12-16,3호선,잠원,5525,5266,10791
2022-12-16,3호선,종로3가,11380,13908,25288
2022-12-16,3호선,지축,6587,6311,12898
2022-12-16,3호선,충무로,3,0,3
2022-12-16,3호선,학여울,3834,3938,7772
2022-12-16,3호선,홍제,19415,18508,37923
2022-12-16,4호선,길음,23659,22963,46622
2022-12-16,4호선,남태령,1529,1237,2766
2022-12-16,4호선,노원,21491,25047,46538
2022-12-16,4호선,당고개,9731,8765,18496
2022-12-16,4호선,동대문,21070,21284,42354
2022-12-16,4호선,동대문역사문화공원,19525,16739,36264
2022-12-16,4호선,동작,1242,1314,2556
2022-12-16,4호선,명동,30982,33600,64582
2022-12-16,4호선,미아,16133,15567,31700
2022-12-16,4호선,미아사거리,29765,29638,59403
2022-12-16,4호선,사당,32540,28551,61091
2022-12-16,4호선,삼각지,7302,8405,15707
2022-12-16,4호선,상계,20805,19392,40197
2022-12-16,4호선,서울역,13548,24453,38001
2022-12-16,4호선,성신여대입구,24006,23152,47158
2022-12-16,4호선,수유,37488,38283,75771
2022-12-16,4호선,숙대입구,15969,15587,31556
2022-12-16,4호선,신용산,22234,23276,45510
2022-12-16,4호선,쌍문,31692,29359,61051
2022-12-16,4호선,이촌,10403,11237,21640
2022-12-16,4호선,창동,28196,29770,57966
2022-12-16,4호선,총신대입구,21449,23954,45403
2022-12-16,4호선,충무로,31534,33224,64758
2022-12-16,4호선,한성대입구,15405,14529,29934
2022-12-16,4호선,혜화,43050,42689,85739
2022-12-16,4호선,회현,28541,29827,58368
2022-12-16,5호선,강동,20432,19227,39659
2022-12-16,5호선,강일,5553,5077,10630
2022-12-16,5호선,개롱,7048,7237,14285
2022-12-16,5호선,개화산,6088,5751,11839
2022-12-16,5호선,거여,11362,10784,22146
2022-12-16,5호선,고덕,11640,11071,22711
2022-12-16,5호선,공덕,16574,17705,34279
2022-12-16,5호선,광나루,15961,14439,30400
2022-12-16,5호선,광화문,38219,40202,78421
2022-12-16,5호선,군자,12949,14525,27474
2022-12-16,5호선,굽은다리,10965,10487,21452
2022-12-16,5호선,길동,8902,9340,18242
2022-12-16,5호선,김포공항,8761,8351,17112
2022-12-16,5호선,까치산,31300,29585,60885
2022-12-16,5호선,답십리,18020,16210,34230
2022-12-16,5호선,동대문역사문화공원,3458,4141,7599
2022-12-16,5호선,둔촌동,9776,9879,19655
2022-12-16,5호선,마곡,12208,12265,24473
2022-12-16,5호선,마장,6773,6391,13164
2022-12-16,5호선,마천,8067,7626,15693
2022-12-16,5호선,마포,17065,17851,34916
2022-12-16,5호선,명일,9832,9995,19827
2022-12-16,5호선,목동,18924,19897,38821
2022-12-16,5호선,미사,18834,18917,37751
2022-12-16,5호선,발산,23584,25315,48899
2022-12-16,5호선,방이,8117,8563,16680
2022-12-16,5호선,방화,7348,7025,14373
2022-12-16,5호선,상일동,16330,15273,31603
2022-12-16,5호선,서대문,22856,23055,45911
2022-12-16,5호선,송정,7081,6546,13627
2022-12-16,5호선,신금호,7318,7291,14609
2022-12-16,5호선,신길,4913,5009,9922
2022-12-16,5호선,신정,15065,12058,27123
2022-12-16,5호선,아차산,15458,14692,30150
2022-12-16,5호선,애오개,7681,7607,15288
2022-12-16,5호선,양평,8131,8111,16242
2022-12-16,5호선,여의나루,12123,15589,27712
2022-12-16,5호선,여의도,34916,36466,71382
2022-12-16,5호선,영등포구청,4493,4577,9070
2022-12-16,5호선,영등포시장,11763,12154,23917
2022-12-16,5호선,오금,4028,3998,8026
2022-12-16,5호선,오목교,24684,26597,51281
2022-12-16,5호선,올림픽공원,5259,4401,9660
2022-12-16,5호선,왕십리,5121,6421,11542
2022-12-16,5호선,우장산,16213,15683,31896
2022-12-16,5호선,을지로4가,6987,7541,14528
2022-12-16,5호선,장한평,21077,21072,42149
2022-12-16,5호선,종로3가,16940,16994,33934
2022-12-16,5호선,천호,21024,20757,41781
2022-12-16,5호선,청구,4421,4233,8654
2022-12-16,5호선,충정로,5266,5324,10590
2022-12-16,5호선,하남검단산,6910,6428,13338
2022-12-16,5호선,하남시청,8057,7737,15794
2022-12-16,5호선,하남풍산,4831,4870,9701
2022-12-16,5호선,행당,9231,8037,17268
2022-12-16,5호선,화곡,31752,29393,61145
2022-12-16,6호선,고려대,9806,9479,19285
2022-12-16,6호선,공덕,21714,21094,42808
2022-12-16,6호선,광흥창,10066,9911,19977
2022-12-16,6호선,구산,8545,6259,14804
2022-12-16,6호선,녹사평,7941,8116,16057
2022-12-16,6호선,대흥,10324,10592,20916
2022-12-16,6호선,독바위,2954,2952,5906
2022-12-16,6호선,돌곶이,10843,9987,20830
2022-12-16,6호선,동묘앞,8570,8443,17013
2022-12-16,6호선,디지털미디어시티,15622,17541,33163
2022-12-16,6호선,마포구청,16078,14259,30337
2022-12-16,6호선,망원,15999,17288,33287
2022-12-16,6호선,버티고개,2439,2336,4775
2022-12-16,6호선,보문,8710,7726,16436
2022-12-16,6호선,봉화산,10029,9362,19391
2022-12-16,6호선,불광,4789,4508,9297
2022-12-16,6호선,삼각지,8870,7543,16413
2022-12-16,6호선,상수,11399,14197,25596
2022-12-16,6호선,상월곡,6999,6306,13305
2022-12-16,6호선,새절,14246,13395,27641
2022-12-16,6호선,석계,14059,14289,28348
2022-12-16,6호선,신당,9986,9219,19205
2022-12-16,6호선,안암,13161,12687,25848
2022-12-16,6호선,약수,4029,4269,8298
2022-12-16,6호선,역촌,4181,4832,9013
2022-12-16,6호선,월곡,13221,12623,25844
2022-12-16,6호선,월드컵경기장,4340,4726,9066
2022-12-16,6호선,응암,19370,18974,38344
2022-12-16,6호선,이태원,13739,14319,28058
2022-12-16,6호선,증산,10923,10719,21642
2022-12-16,6호선,창신,4011,3316,7327
2022-12-16,6호선,청구,4313,4275,8588
2022-12-16,6호선,태릉입구,6224,6783,13007
2022-12-16,6호선,한강진,10160,11474,21634
2022-12-16,6호선,합정,15915,16067,31982
2022-12-16,6호선,화랑대,13530,9997,23527
2022-12-16,6호선,효창공원앞,8044,7502,15546
2022-12-16,7호선,가산디지털단지,48241,48096,96337
2022-12-16,7호선,강남구청,18374,20714,39088
2022-12-16,7호선,건대입구,15516,16988,32504
2022-12-16,7호선,고속터미널,20722,15966,36688
2022-12-16,7호선,공릉,13750,13331,27081
2022-12-16,7호선,광명사거리,23054,22599,45653
2022-12-16,7호선,군자,16978,13149,30127
2022-12-16,7호선,남구로,16014,17253,33267
2022-12-16,7호선,남성,12540,11488,24028
2022-12-16,7호선,내방,16472,16699,33171
2022-12-16,7호선,노원,22868,24298,47166
2022-12-16,7호선,논현,20314,21870,42184
2022-12-16,7호선,대림,8571,8795,17366
2022-12-16,7호선,도봉산,10042,10862,20904
2022-12-16,7호선,뚝섬유원지,8029,7703,15732
2022-12-16,7호선,마들,14647,13430,28077
2022-12-16,7호선,먹골,11494,11178,22672
2022-12-16,7호선,면목,17008,16340,33348
2022-12-16,7호선,반포,7058,6657,13715
2022-12-16,7호선,보라매,8027,8182,16209
2022-12-16,7호선,사가정,17730,17547,35277
2022-12-16,7호선,상도,13242,12579,25821
2022-12-16,7호선,상봉,19092,18669,37761
2022-12-16,7호선,수락산,14001,13655,27656
2022-12-16,7호선,숭실대입구,14698,14311,29009
2022-12-16,7호선,신대방삼거리,16408,15293,31701
2022-12-16,7호선,신풍,12659,11805,24464
2022-12-16,7호선,어린이대공원,16714,16427,33141
2022-12-16,7호선,온수,11554,10712,22266
2022-12-16,7호선,용마산,6547,6074,12621
2022-12-16,7호선,이수,18858,18036,36894
2022-12-16,7호선,장승배기,10120,9852,19972
2022-12-16,7호선,장암,2579,1036,3615
2022-12-16,7호선,중계,15902,14119,30021
2022-12-16,7호선,중곡,12181,11340,23521
2022-12-16,7호선,중화,11853,11400,23253
2022-12-16,7호선,천왕,13123,12194,25317
2022-12-16,7호선,철산,24295,24882,49177
2022-12-16,7호선,청담,20940,24280,45220
2022-12-16,7호선,태릉입구,10250,9508,19758
2022-12-16,7호선,하계,20038,18528,38566
2022-12-16,7호선,학동,25934,27879,53813
2022-12-16,8호선,가락시장,9304,10469,19773
2022-12-16,8호선,강동구청,12131,12213,24344
2022-12-16,8호선,남위례,6865,7051,13916
2022-12-16,8호선,남한산성입구,15402,13647,29049
2022-12-16,8호선,단대오거리,12535,12114,24649
2022-12-16,8호선,모란,5057,4287,9344
2022-12-16,8호선,몽촌토성,7083,7419,14502
2022-12-16,8호선,문정,23642,24601,48243
2022-12-16,8호선,복정,10352,8567,18919
2022-12-16,8호선,산성,5859,5540,11399
2022-12-16,8호선,석촌,8751,10278,19029
2022-12-16,8호선,송파,10444,10243,20687
2022-12-16,8호선,수진,5958,5441,11399
2022-12-16,8호선,신흥,5674,5791,11465
2022-12-16,8호선,암사,21266,18248,39514
2022-12-16,8호선,잠실,19362,23358,42720
2022-12-16,8호선,장지,20480,19166,39646
2022-12-16,8호선,천호,16615,19620,36235
2022-12-16,9호선,가양,23780,22896,46676
2022-12-16,9호선,개화,2921,1922,4843
2022-12-16,9호선,고속터미널,16434,22602,39036
2022-12-16,9호선,공항시장,3245,3497,6742
2022-12-16,9호선,구반포,1496,1539,3035
2022-12-16,9호선,국회의사당,18317,18856,37173
2022-12-16,9호선,김포공항,8921,12178,21099
2022-12-16,9호선,노들,5065,4232,9297
2022-12-16,9호선,노량진,30768,29498,60266
2022-12-16,9호선,당산,22027,21525,43552
2022-12-16,9호선,동작,1714,1290,3004
2022-12-16,9호선,등촌,13166,12409,25575
2022-12-16,9호선,마곡나루,14355,14178,28533
2022-12-16,9호선,사평,4614,4319,8933
2022-12-16,9호선,샛강,7309,7391,14700
2022-12-16,9호선,선유도,9845,9109,18954
2022-12-16,9호선,신논현,36480,37658,74138
2022-12-16,9호선,신목동,4793,3923,8716
2022-12-16,9호선,신반포,4231,4106,8337
2022-12-16,9호선,신방화,7628,7393,15021
2022-12-16,9호선,양천향교,10910,11006,21916
2022-12-16,9호선,여의도,35935,33423,69358
2022-12-16,9호선,염창,19933,18966,38899
2022-12-16,9호선,증미,8001,7564,15565
2022-12-16,9호선,흑석,10306,10412,20718
2022-12-16,9호선2~3단계,둔촌오륜,1343,1268,2611
2022-12-16,9호선2~3단계,봉은사,22722,23491,46213
2022-12-16,9호선2~3단계,삼성중앙,8703,9231,17934
2022-12-16,9호선2~3단계,삼전,8200,7681,15881
2022-12-16,9호선2~3단계,석촌,10110,8978,19088
2022-12-16,9호선2~3단계,석촌고분,7649,7423,15072
2022-12-16,9호선2~3단계,선정릉,11087,12053,23140
2022-12-16,9호선2~3단계,송파나루,6489,7027,13516
2022-12-16,9호선2~3단계,언주,12673,12681,25354
2022-12-16,9호선2~3단계,올림픽공원,9891,10132,20023
2022-12-16,9호선2~3단계,종합운동장,6629,6461,13090
2022-12-16,9호선2~3단계,중앙보훈병원,12810,10989,23799
2022-12-16,9호선2~3단계,한성백제,3116,2758,5874
2022-12-16,경강선,경기광주,9216,8539,17755
2022-12-16,경강선,곤지암,2578,2463,5041
2022-12-16,경강선,부발,2845,2328,5173
2022-12-16,경강선,삼동,2811,2539,5350
2022-12-16,경강선,세종대왕릉,403,387,790
2022-12-16,경강선,신둔도예촌,1858,1648,3506
2022-12-16,경강선,여주,2796,2655,5451
2022-12-16,경강선,이매,1333,1114,2447
2022-12-16,경강선,이천,3297,3457,6754
2022-12-16,경강선,초월,3802,3326,7128
2022-12-16,경강선,판교,6216,6379,12595
2022-12-16,경부선,가산디지털단지,18655,21983,40638
2022-12-16,경부선,관악,7998,7539,15537
2022-12-16,경부선,광명,4318,3872,8190
2022-12-16,경부선,구로,19919,21118,41037
2022-12-16,경부선,군포,8201,8146,16347
2022-12-16,경부선,금정,30979,31512,62491
2022-12-16,경부선,금천구청,12647,12561,25208
2022-12-16,경부선,남영,10434,11172,21606
2022-12-16,경부선,노량진,10222,11090,21312
2022-12-16,경부선,당정,7253,6582,13835
2022-12-16,경부선,대방,11857,13117,24974
2022-12-16,경부선,독산,19431,19909,39340
2022-12-16,경부선,두정,8644,8003,16647
2022-12-16,경부선,명학,9937,9476,19413
2022-12-16,경부선,병점,17655,17290,34945
2022-12-16,경부선,서동탄,1566,1467,3033
2022-12-16,경부선,서울역,11663,3622,15285
2022-12-16,경부선,서정리,10722,8156,18878
2022-12-16,경부선,석수,10274,9053,19327
2022-12-16,경부선,성균관대,17270,16576,33846
2022-12-16,경부선,성환,4942,4394,9336
2022-12-16,경부선,세류,3646,3235,6881
2022-12-16,경부선,세마,3443,3217,6660
2022-12-16,경부선,송탄,5568,5002,10570
2022-12-16,경부선,수원,42308,46952,89260
2022-12-16,경부선,신길,9468,8144,17612
2022-12-16,경부선,신도림,4121,4341,8462
2022-12-16,경부선,안양,26557,26450,53007
2022-12-16,경부선,영등포,48306,51398,99704
2022-12-16,경부선,오산,11688,11265,22953
2022-12-16,경부선,오산대,4245,3875,8120
2022-12-16,경부선,용산,49969,49808,99777
2022-12-16,경부선,의왕,10111,9855,19966
2022-12-16,경부선,직산,1070,1065,2135
2022-12-16,경부선,진위,2206,1714,3920
2022-12-16,경부선,천안,7278,6919,14197
2022-12-16,경부선,평택,15287,14752,30039
2022-12-16,경부선,평택지제,5626,5411,11037
2022-12-16,경부선,화서,9220,8792,18012
2022-12-16,경원선,가능,7168,6856,14024
2022-12-16,경원선,광운대,8288,7942,16230
2022-12-16,경원선,녹양,5023,4681,9704
2022-12-16,경원선,녹천,4989,3992,8981
2022-12-16,경원선,덕계,3513,3017,6530
2022-12-16,경원선,덕정,6136,5733,11869
2022-12-16,경원선,도봉,6280,5968,12248
2022-12-16,경원선,도봉산,6904,4270,11174
2022-12-16,경원선,동두천,2275,2412,4687
2022-12-16,경원선,동두천중앙,3109,3132,6241
2022-12-16,경원선,망월사,8842,8808,17650
2022-12-16,경원선,방학,10468,10162,20630
2022-12-16,경원선,보산,1859,1562,3421
2022-12-16,경원선,서빙고,2333,2060,4393
2022-12-16,경원선,석계,8884,9726,18610
2022-12-16,경원선,소요산,1990,1811,3801
2022-12-16,경원선,신이문,9094,8094,17188
2022-12-16,경원선,양주,8062,7684,15746
2022-12-16,경원선,옥수,66,44,110
2022-12-16,경원선,왕십리,18430,19226,37656
2022-12-16,경원선,외대앞,9958,9538,19496
2022-12-16,경원선,월계,7937,7236,15173
2022-12-16,경원선,응봉,2021,1671,3692
2022-12-16,경원선,의정부,20521,21727,42248
2022-12-16,경원선,이촌,4287,3392,7679
2022-12-16,경원선,지행,7384,7106,14490
2022-12-16,경원선,청량리,18711,18951,37662
2022-12-16,경원선,한남,4277,4252,8529
2022-12-16,경원선,회룡,13398,13140,26538
2022-12-16,경의선,가좌,6347,6004,12351
2022-12-16,경의선,강매,3502,2818,6320
2022-12-16,경의선,곡산,607,578,1185
2022-12-16,경의선,공덕,4609,3936,8545
2022-12-16,경의선,금릉,5620,5480,11100
2022-12-16,경의선,금촌,7530,7229,14759
2022-12-16,경의선,능곡,4096,3663,7759
2022-12-16,경의선,디지털미디어시티,3192,2913,6105
2022-12-16,경의선,문산,5692,5534,11226
2022-12-16,경의선,백마,7822,7371,15193
2022-12-16,경의선,서강대,2394,2478,4872
2022-12-16,경의선,서울역,4827,6449,11276
2022-12-16,경의선,수색,2759,2901,5660
2022-12-16,경의선,신촌,948,1356,2304
2022-12-16,경의선,야당,9140,9316,18456
2022-12-16,경의선,운정,7724,7124,14848
2022-12-16,경의선,월롱,3506,2312,5818
2022-12-16,경의선,일산,9998,9848,19846
2022-12-16,경의선,임진강,2,3,5
2022-12-16,경의선,탄현,8694,8209,16903
2022-12-16,경의선,파주,1294,801,2095
2022-12-16,경의선,풍산,6246,5846,12092
2022-12-16,경의선,행신,9377,9594,18971
2022-12-16,경의선,홍대입구,2048,2724,4772
2022-12-16,경의선,화전,3134,2759,5893
2022-12-16,경의선,효창공원앞,3350,3709,7059
2022-12-16,경인선,간석,6536,6094,12630
2022-12-16,경인선,개봉,23915,23127,47042
2022-12-16,경인선,구일,7684,7415,15099
2022-12-16,경인선,도원,3271,3240,6511
2022-12-16,경인선,도화,4441,4048,8489
2022-12-16,경인선,동암,17596,17512,35108
2022-12-16,경인선,동인천,15067,14283,29350
2022-12-16,경인선,백운,7337,7057,14394
2022-12-16,경인선,부개,9142,8486,17628
2022-12-16,경인선,부천,35034,35679,70713
2022-12-16,경인선,부평,31596,35448,67044
2022-12-16,경인선,소사,8716,8244,16960
2022-12-16,경인선,송내,29620,29424,59044
2022-12-16,경인선,역곡,30725,29853,60578
2022-12-16,경인선,오류동,12524,11483,24007
2022-12-16,경인선,온수,7496,6799,14295
2022-12-16,경인선,인천,3488,2698,6186
2022-12-16,경인선,제물포,11943,10976,22919
2022-12-16,경인선,주안,21060,18688,39748
2022-12-16,경인선,중동,10026,9261,19287
2022-12-16,경춘선,가평,1860,2010,3870
2022-12-16,경춘선,갈매,3324,2790,6114
2022-12-16,경춘선,강촌,397,464,861
2022-12-16,경춘선,굴봉산,97,126,223
2022-12-16,경춘선,금곡,1514,1502,3016
2022-12-16,경춘선,김유정,265,297,562
2022-12-16,경춘선,남춘천,3266,2995,6261
2022-12-16,경춘선,대성리,512,765,1277
2022-12-16,경춘선,마석,4180,4103,8283
2022-12-16,경춘선,백양리,352,348,700
2022-12-16,경춘선,별내,3457,3212,6669
2022-12-16,경춘선,사릉,2472,2464,4936
2022-12-16,경춘선,상천,195,216,411
2022-12-16,경춘선,신내,2414,2306,4720
2022-12-16,경춘선,천마산,1606,1504,3110
2022-12-16,경춘선,청평,1630,1717,3347
2022-12-16,경춘선,춘천,1712,1371,3083
2022-12-16,경춘선,퇴계원,3748,3524,7272
2022-12-16,경춘선,평내호평,6749,6731,13480
2022-12-16,공항철도,검암,7206,7013,14219
2022-12-16,공항철도,계양,13409,12164,25573
2022-12-16,공항철도,공덕,2848,4082,6930
2022-12-16,공항철도,공항화물청사,2426,2466,4892
2022-12-16,공항철도,김포공항,12779,6668,19447
2022-12-16,공항철도,디지털미디어시티,15884,14435,30319
2022-12-16,공항철도,마곡나루,10625,10052,20677
2022-12-16,공항철도,서울역,13478,12269,25747
2022-12-16,공항철도,영종,3988,4104,8092
2022-12-16,공항철도,운서,9123,9317,18440
2022-12-16,공항철도,인천공항1터미널,11731,11050,22781
2022-12-16,공항철도,인천공항2터미널,4384,3768,8152
2022-12-16,공항철도,청라국제도시,7888,7473,15361
2022-12-16,공항철도,홍대입구,13198,14234,27432
2022-12-16,과천선,경마공원,7341,7468,14809
2022-12-16,과천선,과천,7271,6721,13992
2022-12-16,과천선,대공원,3115,3234,6349
2022-12-16,과천선,범계,30272,30644,60916
2022-12-16,과천선,선바위,9265,8135,17400
2022-12-16,과천선,인덕원,27898,28797,56695
2022-12-16,과천선,정부과천청사,11933,11906,23839
2022-12-16,과천선,평촌,19918,19743,39661
2022-12-16,분당선,가천대,9055,9471,18526
2022-12-16,분당선,강남구청,10809,12454,23263
2022-12-16,분당선,개포동,4523,4564,9087
2022-12-16,분당선,구룡,2686,2438,5124
2022-12-16,분당선,구성,5864,6074,11938
2022-12-16,분당선,기흥,12028,11104,23132
2022-12-16,분당선,대모산입구,5482,4982,10464
2022-12-16,분당선,도곡,8633,8304,16937
2022-12-16,분당선,망포,19029,17310,36339
2022-12-16,분당선,매교,5402,5087,10489
2022-12-16,분당선,매탄권선,6481,6118,12599
2022-12-16,분당선,모란,21686,22158,43844
2022-12-16,분당선,미금,17714,18860,36574
2022-12-16,분당선,보정,3272,2776,6048
2022-12-16,분당선,상갈,6260,5951,12211
2022-12-16,분당선,서울숲,12832,13187,26019
2022-12-16,분당선,서현,29477,30178,59655
2022-12-16,분당선,선릉,14882,22993,37875
2022-12-16,분당선,선정릉,8836,9249,18085
2022-12-16,분당선,수내,16176,16056,32232
2022-12-16,분당선,수서,16452,17221,33673
2022-12-16,분당선,수원,9821,8513,18334
2022-12-16,분당선,수원시청,15390,18197,33587
2022-12-16,분당선,신갈,5754,5363,11117
2022-12-16,분당선,압구정로데오,23649,28166,51815
2022-12-16,분당선,야탑,30606,32503,63109
2022-12-16,분당선,영통,10687,10823,21510
2022-12-16,분당선,오리,13371,10786,24157
2022-12-16,분당선,이매,6346,6083,12429
2022-12-16,분당선,정자,20938,21869,42807
2022-12-16,분당선,죽전,16006,17357,33363
2022-12-16,분당선,청명,5548,5113,10661
2022-12-16,분당선,태평,14954,14152,29106
2022-12-16,분당선,한티,16395,17047,33442
2022-12-16,수인선,고색,5860,5263,11123
2022-12-16,수인선,남동인더스파크,2327,2818,5145
2022-12-16,수인선,달월,123,85,208
2022-12-16,수인선,사리,5895,4835,10730
2022-12-16,수인선,소래포구,5119,4722,9841
2022-12-16,수인선,송도,2803,2585,5388
2022-12-16,수인선,숭의,4336,4001,8337
2022-12-16,수인선,신포,1994,2014,4008
2022-12-16,수인선,야목,397,316,713
2022-12-16,수인선,어천,1226,1097,2323
2022-12-16,수인선,연수,5267,5326,10593
2022-12-16,수인선,오목천,4482,3807,8289
2022-12-16,수인선,원인재,5141,5108,10249
2022-12-16,수인선,월곶,2916,2636,5552
2022-12-16,수인선,인천,939,1561,2500
2022-12-16,수인선,인천논현,6044,6621,12665
2022-12-16,수인선,인하대,7232,6587,13819
2022-12-16,수인선,호구포,4717,4765,9482
2022-12-16,신림선,관악산,2231,2081,4312
2022-12-16,신림선,당곡,4658,4475,9133
2022-12-16,신림선,대방,2772,2119,4891
2022-12-16,신림선,보라매,3873,3383,7256
2022-12-16,신림선,보라매공원,2054,2111,4165
2022-12-16,신림선,보라매병원,7282,7416,14698
2022-12-16,신림선,샛강,2565,3451,6016
2022-12-16,신림선,서울대벤처타운,8685,8075,16760
2022-12-16,신림선,서울지방병무청,2926,3123,6049
2022-12-16,신림선,서원,3558,2977,6535
2022-12-16,신림선,신림,1890,2551,4441
2022-12-16,안산선,고잔,10202,9683,19885
2022-12-16,안산선,대야미,5507,4700,10207
2022-12-16,안산선,반월,4736,4459,9195
2022-12-16,안산선,산본,18054,19269,37323
2022-12-16,안산선,상록수,17339,17441,34780
2022-12-16,안산선,수리산,4453,3476,7929
2022-12-16,안산선,신길온천,1935,1843,3778
2022-12-16,안산선,안산,12530,11805,24335
2022-12-16,안산선,오이도,9089,9019,18108
2022-12-16,안산선,정왕,10252,10231,20483
2022-12-16,안산선,중앙,20876,22461,43337
2022-12-16,안산선,초지,5502,5587,11089
2022-12-16,안산선,한대앞,11105,10680,21785
2022-12-16,우이신설선,4.19민주묘지,3368,3151,6519
2022-12-16,우이신설선,가오리,4410,4328,8738
2022-12-16,우이신설선,보문,1721,1734,3455
2022-12-16,우이신설선,북한산보국문,6782,6179,12961
2022-12-16,우이신설선,북한산우이,2706,2326,5032
2022-12-16,우이신설선,삼양,2065,2148,4213
2022-12-16,우이신설선,삼양사거리,2588,2516,5104
2022-12-16,우이신설선,성신여대입구,3730,4360,8090
2022-12-16,우이신설선,솔밭공원,2583,2376,4959
2022-12-16,우이신설선,솔샘,6535,5884,12419
2022-12-16,우이신설선,신설동,2258,2214,4472
2022-12-16,우이신설선,정릉,5080,4766,9846
2022-12-16,우이신설선,화계,3681,3371,7052
2022-12-16,일산선,대곡,2185,1618,3803
2022-12-16,일산선,대화,14887,11560,26447
2022-12-16,일산선,마두,8391,8641,17032
2022-12-16,일산선,백석,11147,11330,22477
2022-12-16,일산선,삼송,22020,20883,42903
2022-12-16,일산선,원당,11841,11081,22922
2022-12-16,일산선,원흥,12782,11814,24596
2022-12-16,일산선,정발산,8049,8727,16776
2022-12-16,일산선,주엽,10289,10267,20556
2022-12-16,일산선,지축,2,0,2
2022-12-16,일산선,화정,18880,19185,38065
2022-12-16,장항선,배방,1457,1405,2862
2022-12-16,장항선,봉명,1522,1486,3008
2022-12-16,장항선,신창,1770,1385,3155
2022-12-16,장항선,쌍용,3028,2571,5599
2022-12-16,장항선,아산,4679,4817,9496
2022-12-16,장항선,온양온천,4552,4629,9181
2022-12-16,장항선,탕정,1564,1252,2816
2022-12-16,중앙선,구리,14815,15001,29816
2022-12-16,중앙선,국수,768,786,1554
2022-12-16,중앙선,덕소,5978,5927,11905
2022-12-16,중앙선,도농,12507,11336,23843
2022-12-16,중앙선,도심,2653,2045,4698
2022-12-16,중앙선,망우,8282,8081,16363
2022-12-16,중앙선,상봉,6326,6171,12497
2022-12-16,중앙선,신원,134,145,279
2022-12-16,중앙선,아신,552,541,1093
2022-12-16,중앙선,양수,1784,1821,3605
2022-12-16,중앙선,양원,3346,3085,6431
2022-12-16,중앙선,양정,572,516,1088
2022-12-16,중앙선,양평,3077,3246,6323
2022-12-16,중앙선,오빈,277,282,559
2022-12-16,중앙선,용문,1703,1776,3479
2022-12-16,중앙선,운길산,548,541,1089
2022-12-16,중앙선,원덕,324,303,627
2022-12-16,중앙선,중랑,6211,5796,12007
2022-12-16,중앙선,지평,48,73,121
2022-12-16,중앙선,팔당,847,853,1700
2022-12-16,중앙선,회기,29581,27224,56805
2022-12-19,1호선,동대문,11110,10807,21917
2022-12-19,1호선,동묘앞,7117,8338,15455
2022-12-19,1호선,서울역,51494,48234,99728
2022-12-19,1호선,시청,26225,24163,50388
2022-12-19,1호선,신설동,13886,13979,27865
2022-12-19,1호선,제기동,15780,16014,31794
2022-12-19,1호선,종각,40372,36945,77317
2022-12-19,1호선,종로3가,24957,22829,47786
2022-12-19,1호선,종로5가,24051,23674,47725
2022-12-19,1호선,청량리,18862,18592,37454
2022-12-19,2호선,강남,83915,80623,164538
2022-12-19,2호선,강변,32240,30121,62361
2022-12-19,2호선,건대입구,35636,38197,73833
2022-12-19,2호선,교대,35773,40670,76443
2022-12-19,2호선,구로디지털단지,61393,60855,122248
2022-12-19,2호선,구의,25214,24754,49968
2022-12-19,2호선,낙성대,28144,27728,55872
2022-12-19,2호선,당산,18288,21363,39651
2022-12-19,2호선,대림,24421,24648,49069
2022-12-19,2호선,도림천,1456,1598,3054
2022-12-19,2호선,동대문역사문화공원,13585,15405,28990
2022-12-19,2호선,뚝섬,22191,23856,46047
2022-12-19,2호선,문래,22630,23030,45660
2022-12-19,2호선,방배,17085,17613,34698
2022-12-19,2호선,봉천,24755,23579,48334
2022-12-19,2호선,사당,39538,43097,82635
2022-12-19,2호선,삼성,57380,57632,115012
2022-12-19,2호선,상왕십리,14994,14870,29864
2022-12-19,2호선,서울대입구,46903,46374,93277
2022-12-19,2호선,서초,22890,22240,45130
2022-12-19,2호선,선릉,61508,54534,116042
2022-12-19,2호선,성수,40882,43867,84749
2022-12-19,2호선,시청,26636,25878,52514
2022-12-19,2호선,신답,1708,2045,3753
2022-12-19,2호선,신당,14085,14463,28548
2022-12-19,2호선,신대방,25428,24841,50269
2022-12-19,2호선,신도림,49772,49330,99102
2022-12-19,2호선,신림,57160,55141,112301
2022-12-19,2호선,신설동,3497,3617,7114
2022-12-19,2호선,신정네거리,10714,11085,21799
2022-12-19,2호선,신촌,37664,37766,75430
2022-12-19,2호선,아현,10644,10207,20851
2022-12-19,2호선,양천구청,7166,7596,14762
2022-12-19,2호선,역삼,58078,64727,122805
2022-12-19,2호선,영등포구청,22923,23648,46571
2022-12-19,2호선,왕십리,16800,14287,31087
2022-12-19,2호선,용답,3054,3180,6234
2022-12-19,2호선,용두,2513,2504,5017
2022-12-19,2호선,을지로3가,25848,25784,51632
2022-12-19,2호선,을지로4가,14796,15000,29796
2022-12-19,2호선,을지로입구,49619,51615,101234
2022-12-19,2호선,이대,15858,17320,33178
2022-12-19,2호선,잠실,81136,81219,162355
2022-12-19,2호선,잠실나루,15271,15006,30277
2022-12-19,2호선,잠실새내,23095,22989,46084
2022-12-19,2호선,종합운동장,7358,7986,15344
2022-12-19,2호선,충정로,10506,11143,21649
2022-12-19,2호선,한양대,13274,14426,27700
2022-12-19,2호선,합정,31175,32628,63803
2022-12-19,2호선,홍대입구,61653,63654,125307
2022-12-19,3호선,가락시장,9596,9417,19013
2022-12-19,3호선,경복궁,23008,23129,46137
2022-12-19,3호선,경찰병원,8059,8108,16167
2022-12-19,3호선,고속터미널,45149,42907,88056
2022-12-19,3호선,교대,16026,10346,26372
2022-12-19,3호선,구파발,21797,21108,42905
2022-12-19,3호선,금호,8004,7522,15526
2022-12-19,3호선,남부터미널,29701,30436,60137
2022-12-19,3호선,녹번,16312,14707,31019
2022-12-19,3호선,대청,11153,10635,21788
2022-12-19,3호선,대치,11317,11578,22895
2022-12-19,3호선,도곡,5758,5607,11365
2022-12-19,3호선,독립문,6920,6979,13899
2022-12-19,3호선,동대입구,8460,8847,17307
2022-12-19,3호선,매봉,13275,12930,26205
2022-12-19,3호선,무악재,4230,4178,8408
2022-12-19,3호선,불광,16010,16852,32862
2022-12-19,3호선,수서,18288,19156,37444
2022-12-19,3호선,신사,30617,31211,61828
2022-12-19,3호선,안국,24828,25428,50256
2022-12-19,3호선,압구정,34000,36604,70604
2022-12-19,3호선,약수,13446,13029,26475
2022-12-19,3호선,양재,39651,43195,82846
2022-12-19,3호선,연신내,35380,33541,68921
2022-12-19,3호선,오금,6598,5938,12536
2022-12-19,3호선,옥수,8998,9228,18226
2022-12-19,3호선,을지로3가,12122,11833,23955
2022-12-19,3호선,일원,11686,11270,22956
2022-12-19,3호선,잠원,5041,4905,9946
2022-12-19,3호선,종로3가,10611,11833,22444
2022-12-19,3호선,지축,6099,5990,12089
2022-12-19,3호선,학여울,1971,1908,3879
2022-12-19,3호선,홍제,18058,17333,35391
2022-12-19,4호선,길음,21665,21931,43596
2022-12-19,4호선,남태령,1355,1164,2519
2022-12-19,4호선,노원,18852,21065,39917
2022-12-19,4호선,당고개,9077,8011,17088
2022-12-19,4호선,동대문,20119,20779,40898
2022-12-19,4호선,동대문역사문화공원,17328,15026,32354
2022-12-19,4호선,동작,1094,1198,2292
2022-12-19,4호선,명동,27205,28297,55502
2022-12-19,4호선,미아,15492,15196,30688
2022-12-19,4호선,미아사거리,27087,26829,53916
2022-12-19,4호선,사당,26452,23041,49493
2022-12-19,4호선,삼각지,5888,6373,12261
2022-12-19,4호선,상계,19127,18001,37128
2022-12-19,4호선,서울역,12751,20349,33100
2022-12-19,4호선,성신여대입구,21826,21159,42985
2022-12-19,4호선,수유,34310,34457,68767
2022-12-19,4호선,숙대입구,14336,13846,28182
2022-12-19,4호선,신용산,19037,19991,39028
2022-12-19,4호선,쌍문,30156,27844,58000
2022-12-19,4호선,이촌,9839,10699,20538
2022-12-19,4호선,창동,25162,26504,51666
2022-12-19,4호선,총신대입구,18547,20554,39101
2022-12-19,4호선,충무로,28800,29625,58425
2022-12-19,4호선,한성대입구,13000,12547,25547
2022-12-19,4호선,혜화,33808,33596,67404
2022-12-19,4호선,회현,26293,27292,53585
2022-12-19,5호선,강동,19322,18660,37982
2022-12-19,5호선,강일,5416,5022,10438
2022-12-19,5호선,개롱,6463,6808,13271
2022-12-19,5호선,개화산,5756,5548,11304
2022-12-19,5호선,거여,10515,10256,20771
2022-12-19,5호선,고덕,10138,9979,20117
2022-12-19,5호선,공덕,15618,16582,32200
2022-12-19,5호선,광나루,13310,12353,25663
2022-12-19,5호선,광화문,35394,36415,71809
2022-12-19,5호선,군자,11780,12727,24507
2022-12-19,5호선,굽은다리,10041,9864,19905
2022-12-19,5호선,길동,8200,8595,16795
2022-12-19,5호선,김포공항,7857,7562,15419
2022-12-19,5호선,까치산,29539,28463,58002
2022-12-19,5호선,답십리,16701,15366,32067
2022-12-19,5호선,동대문역사문화공원,3491,4038,7529
2022-12-19,5호선,둔촌동,8641,8738,17379
2022-12-19,5호선,마곡,11375,11352,22727
2022-12-19,5호선,마장,6199,5945,12144
2022-12-19,5호선,마천,7662,7314,14976
2022-12-19,5호선,마포,15958,16405,32363
2022-12-19,5호선,명일,8900,9318,18218
2022-12-19,5호선,목동,17072,18704,35776
2022-12-19,5호선,미사,16941,17348,34289
2022-12-19,5호선,발산,22177,22589,44766
2022-12-19,5호선,방이,7401,7589,14990
2022-12-19,5호선,방화,6818,6512,13330
2022-12-19,5호선,상일동,15332,14710,30042
2022-12-19,5호선,서대문,21498,22113,43611
2022-12-19,5호선,송정,6512,5990,12502
2022-12-19,5호선,신금호,6659,7094,13753
2022-12-19,5호선,신길,4528,4971,9499
2022-12-19,5호선,신정,14178,11733,25911
2022-12-19,5호선,아차산,14434,14008,28442
2022-12-19,5호선,애오개,7078,7135,14213
2022-12-19,5호선,양평,7764,7823,15587
2022-12-19,5호선,여의나루,11257,14548,25805
2022-12-19,5호선,여의도,33437,33920,67357
2022-12-19,5호선,영등포구청,4295,4242,8537
2022-12-19,5호선,영등포시장,10716,11098,21814
2022-12-19,5호선,오금,3893,3934,7827
2022-12-19,5호선,오목교,22479,23553,46032
2022-12-19,5호선,올림픽공원,4618,3915,8533
2022-12-19,5호선,왕십리,4723,5429,10152
2022-12-19,5호선,우장산,15259,15027,30286
2022-12-19,5호선,을지로4가,6748,6881,13629
2022-12-19,5호선,장한평,19351,19356,38707
2022-12-19,5호선,종로3가,13880,13304,27184
2022-12-19,5호선,천호,17948,17965,35913
2022-12-19,5호선,청구,4110,3793,7903
2022-12-19,5호선,충정로,5064,5094,10158
2022-12-19,5호선,하남검단산,6278,6067,12345
2022-12-19,5호선,하남시청,7521,7455,14976
2022-12-19,5호선,하남풍산,4398,4329,8727
2022-12-19,5호선,행당,8422,7656,16078
2022-12-19,5호선,화곡,29529,27727,57256
2022-12-19,6호선,고려대,9590,9536,19126
2022-12-19,6호선,공덕,19785,19415,39200
2022-12-19,6호선,광흥창,9426,9325,18751
2022-12-19,6호선,구산,8014,6167,14181
2022-12-19,6호선,녹사평,4686,4502,9188
2022-12-19,6호선,대흥,9356,9883,19239
2022-12-19,6호선,독바위,2816,2931,5747
2022-12-19,6호선,돌곶이,10999,10279,21278
2022-12-19,6호선,동묘앞,7688,8329,16017
2022-12-19,6호선,디지털미디어시티,15084,16797,31881
2022-12-19,6호선,마포구청,14946,13558,28504
2022-12-19,6호선,망원,13598,14620,28218
2022-12-19,6호선,버티고개,2250,2309,4559
2022-12-19,6호선,보문,7999,7358,15357
2022-12-19,6호선,봉화산,9533,8990,18523
2022-12-19,6호선,불광,4305,4250,8555
2022-12-19,6호선,삼각지,6737,6165,12902
2022-12-19,6호선,상수,9292,10377,19669
2022-12-19,6호선,상월곡,6714,6282,12996
2022-12-19,6호선,새절,13630,12792,26422
2022-12-19,6호선,석계,13089,13491,26580
2022-12-19,6호선,신내,1,0,1
2022-12-19,6호선,신당,8476,9026,17502
2022-12-19,6호선,안암,14305,14400,28705
2022-12-19,6호선,약수,3773,3798,7571
2022-12-19,6호선,역촌,3839,4486,8325
2022-12-19,6호선,연신내,3,0,3
2022-12-19,6호선,월곡,12670,12366,25036
2022-12-19,6호선,월드컵경기장,3788,4000,7788
2022-12-19,6호선,응암,17910,18149,36059
2022-12-19,6호선,이태원,9103,9165,18268
2022-12-19,6호선,증산,10097,10162,20259
2022-12-19,6호선,창신,3736,3154,6890
2022-12-19,6호선,청구,3787,3918,7705
2022-12-19,6호선,태릉입구,5777,6587,12364
2022-12-19,6호선,한강진,6799,7739,14538
2022-12-19,6호선,합정,13321,13044,26365
2022-12-19,6호선,화랑대,13094,9722,22816
2022-12-19,6호선,효창공원앞,7625,7144,14769
2022-12-19,7호선,가산디지털단지,48258,48213,96471
2022-12-19,7호선,강남구청,17036,18701,35737
2022-12-19,7호선,건대입구,13519,14197,27716
2022-12-19,7호선,고속터미널,17181,14208,31389
2022-12-19,7호선,공릉,12246,12137,24383
2022-12-19,7호선,광명사거리,21372,20897,42269
2022-12-19,7호선,군자,15647,12596,28243
2022-12-19,7호선,남구로,16484,17048,33532
2022-12-19,7호선,남성,11449,10728,22177
2022-12-19,7호선,내방,15152,15447,30599
2022-12-19,7호선,노원,20869,21396,42265
2022-12-19,7호선,논현,19348,20106,39454
2022-12-19,7호선,대림,8326,8263,16589
2022-12-19,7호선,도봉산,9653,10513,20166
2022-12-19,7호선,뚝섬유원지,7227,7051,14278
2022-12-19,7호선,마들,13565,12662,26227
2022-12-19,7호선,먹골,10731,10671,21402
2022-12-19,7호선,면목,16324,16101,32425
2022-12-19,7호선,반포,6450,6353,12803
2022-12-19,7호선,보라매,7576,7719,15295
2022-12-19,7호선,사가정,16590,16839,33429
2022-12-19,7호선,상도,12559,12346,24905
2022-12-19,7호선,상봉,17283,16927,34210
2022-12-19,7호선,수락산,12694,12479,25173
2022-12-19,7호선,숭실대입구,13171,13468,26639
2022-12-19,7호선,신대방삼거리,15366,14941,30307
2022-12-19,7호선,신풍,11896,11198,23094
2022-12-19,7호선,어린이대공원,16105,16108,32213
2022-12-19,7호선,온수,10579,9691,20270
2022-12-19,7호선,용마산,6087,5703,11790
2022-12-19,7호선,이수,16231,15373,31604
2022-12-19,7호선,장승배기,9465,9498,18963
2022-12-19,7호선,장암,2501,860,3361
2022-12-19,7호선,중계,15130,13877,29007
2022-12-19,7호선,중곡,11301,10751,22052
2022-12-19,7호선,중화,11252,11067,22319
2022-12-19,7호선,천왕,12178,11688,23866
2022-12-19,7호선,철산,22188,22779,44967
2022-12-19,7호선,청담,20471,22868,43339
2022-12-19,7호선,태릉입구,9462,8932,18394
2022-12-19,7호선,하계,18805,18119,36924
2022-12-19,7호선,학동,25743,27103,52846
2022-12-19,8호선,가락시장,8049,9040,17089
2022-12-19,8호선,강동구청,11127,11478,22605
2022-12-19,8호선,남위례,6310,6385,12695
2022-12-19,8호선,남한산성입구,13751,12597,26348
2022-12-19,8호선,단대오거리,11464,11250,22714
2022-12-19,8호선,모란,5552,4340,9892
2022-12-19,8호선,몽촌토성,6440,6836,13276
2022-12-19,8호선,문정,23027,24278,47305
2022-12-19,8호선,복정,8924,7717,16641
2022-12-19,8호선,산성,5324,5361,10685
2022-12-19,8호선,석촌,7990,9117,17107
2022-12-19,8호선,송파,9484,9406,18890
2022-12-19,8호선,수진,5734,5282,11016
2022-12-19,8호선,신흥,5216,5428,10644
2022-12-19,8호선,암사,19439,17293,36732
2022-12-19,8호선,잠실,16704,18907,35611
2022-12-19,8호선,장지,18595,17752,36347
2022-12-19,8호선,천호,14720,16910,31630
2022-12-19,9호선,가양,22219,21875,44094
2022-12-19,9호선,개화,2789,1839,4628
2022-12-19,9호선,고속터미널,13451,17828,31279
2022-12-19,9호선,공항시장,2988,3271,6259
2022-12-19,9호선,구반포,1168,1185,2353
2022-12-19,9호선,국회의사당,17623,18017,35640
2022-12-19,9호선,김포공항,7591,11280,18871
2022-12-19,9호선,노들,4726,4005,8731
2022-12-19,9호선,노량진,26828,26040,52868
2022-12-19,9호선,당산,19627,19799,39426
2022-12-19,9호선,동작,1590,1121,2711
2022-12-19,9호선,등촌,12158,11770,23928
2022-12-19,9호선,마곡나루,13058,12722,25780
2022-12-19,9호선,사평,4006,4014,8020
2022-12-19,9호선,샛강,6805,6713,13518
2022-12-19,9호선,선유도,9330,8914,18244
2022-12-19,9호선,신논현,31529,30590,62119
2022-12-19,9호선,신목동,4383,3896,8279
2022-12-19,9호선,신반포,3705,3666,7371
2022-12-19,9호선,신방화,7177,7128,14305
2022-12-19,9호선,양천향교,9924,10524,20448
2022-12-19,9호선,여의도,33077,31020,64097
2022-12-19,9호선,염창,18463,17895,36358
2022-12-19,9호선,증미,7573,7248,14821
2022-12-19,9호선,흑석,9655,9916,19571
2022-12-19,9호선2~3단계,둔촌오륜,1205,1113,2318
2022-12-19,9호선2~3단계,봉은사,19520,19995,39515
2022-12-19,9호선2~3단계,삼성중앙,8144,8589,16733
2022-12-19,9호선2~3단계,삼전,7463,7145,14608
2022-12-19,9호선2~3단계,석촌,8963,8047,17010
2022-12-19,9호선2~3단계,석촌고분,6954,6888,13842
2022-12-19,9호선2~3단계,선정릉,10651,11713,22364
2022-12-19,9호선2~3단계,송파나루,5490,5885,11375
2022-12-19,9호선2~3단계,언주,12037,12149,24186
2022-12-19,9호선2~3단계,올림픽공원,6076,6109,12185
2022-12-19,9호선2~3단계,종합운동장,4517,4494,9011
2022-12-19,9호선2~3단계,중앙보훈병원,11839,10464,22303
2022-12-19,9호선2~3단계,한성백제,2684,2416,5100
2022-12-19,경강선,경기광주,8325,7797,16122
2022-12-19,경강선,곤지암,2481,2399,4880
2022-12-19,경강선,부발,2069,2119,4188
2022-12-19,경강선,삼동,2629,2428,5057
2022-12-19,경강선,세종대왕릉,333,316,649
2022-12-19,경강선,신둔도예촌,1527,1480,3007
2022-12-19,경강선,여주,2240,2202,4442
2022-12-19,경강선,이매,1195,966,2161
2022-12-19,경강선,이천,2618,2795,5413
2022-12-19,경강선,초월,3412,3266,6678
2022-12-19,경강선,판교,5767,5787,11554
2022-12-19,경부선,가산디지털단지,18059,20468,38527
2022-12-19,경부선,관악,7097,6696,13793
2022-12-19,경부선,광명,3811,3071,6882
2022-12-19,경부선,구로,18552,19173,37725
2022-12-19,경부선,군포,7930,7720,15650
2022-12-19,경부선,금정,27364,28406,55770
2022-12-19,경부선,금천구청,11458,11497,22955
2022-12-19,경부선,남영,9680,10249,19929
2022-12-19,경부선,노량진,8280,8805,17085
2022-12-19,경부선,당정,6559,6236,12795
2022-12-19,경부선,대방,11469,12292,23761
2022-12-19,경부선,독산,18783,18986,37769
2022-12-19,경부선,두정,7192,8306,15498
2022-12-19,경부선,명학,9051,8826,17877
2022-12-19,경부선,병점,14711,14758,29469
2022-12-19,경부선,서동탄,1301,1042,2343
2022-12-19,경부선,서울역,9149,2521,11670
2022-12-19,경부선,서정리,7620,7470,15090
2022-12-19,경부선,석수,9266,8373,17639
2022-12-19,경부선,성균관대,14428,14320,28748
2022-12-19,경부선,성환,3573,3637,7210
2022-12-19,경부선,세류,3110,2726,5836
2022-12-19,경부선,세마,2972,2780,5752
2022-12-19,경부선,송탄,4192,4187,8379
2022-12-19,경부선,수원,34515,36699,71214
2022-12-19,경부선,신길,9127,7844,16971
2022-12-19,경부선,신도림,3905,4017,7922
2022-12-19,경부선,안양,22695,22109,44804
2022-12-19,경부선,영등포,39315,40559,79874
2022-12-19,경부선,오산,9642,9930,19572
2022-12-19,경부선,오산대,3403,3100,6503
2022-12-19,경부선,용산,39589,39679,79268
2022-12-19,경부선,의왕,8937,8974,17911
2022-12-19,경부선,직산,869,881,1750
2022-12-19,경부선,진위,1876,1634,3510
2022-12-19,경부선,천안,6301,5749,12050
2022-12-19,경부선,평택,11912,12195,24107
2022-12-19,경부선,평택지제,4403,4426,8829
2022-12-19,경부선,화서,8301,7943,16244
2022-12-19,경원선,가능,6406,6234,12640
2022-12-19,경원선,광운대,7794,8879,16673
2022-12-19,경원선,녹양,4473,4616,9089
2022-12-19,경원선,녹천,4576,3945,8521
2022-12-19,경원선,덕계,3213,2852,6065
2022-12-19,경원선,덕정,5543,5430,10973
2022-12-19,경원선,도봉,5679,5730,11409
2022-12-19,경원선,도봉산,7007,4465,11472
2022-12-19,경원선,동두천,2064,2244,4308
2022-12-19,경원선,동두천중앙,2980,2826,5806
2022-12-19,경원선,망월사,9203,9789,18992
2022-12-19,경원선,방학,9478,9592,19070
2022-12-19,경원선,보산,1488,1334,2822
2022-12-19,경원선,서빙고,1925,1747,3672
2022-12-19,경원선,석계,7862,9181,17043
2022-12-19,경원선,소요산,1833,1423,3256
2022-12-19,경원선,신이문,8632,8260,16892
2022-12-19,경원선,양주,7203,7485,14688
2022-12-19,경원선,옥수,51,53,104
2022-12-19,경원선,왕십리,16317,16820,33137
2022-12-19,경원선,외대앞,9045,9218,18263
2022-12-19,경원선,월계,7360,7102,14462
2022-12-19,경원선,응봉,1878,1593,3471
2022-12-19,경원선,의정부,17878,18318,36196
2022-12-19,경원선,이촌,3984,3130,7114
2022-12-19,경원선,지행,6632,6449,13081
2022-12-19,경원선,청량리,15269,15710,30979
2022-12-19,경원선,한남,3982,3807,7789
2022-12-19,경원선,회룡,12310,12386,24696
2022-12-19,경의선,가좌,5802,5515,11317
2022-12-19,경의선,강매,3289,2836,6125
2022-12-19,경의선,곡산,553,577,1130
2022-12-19,경의선,공덕,4091,3409,7500
2022-12-19,경의선,금릉,5115,4897,10012
2022-12-19,경의선,금촌,6381,6146,12527
2022-12-19,경의선,능곡,3799,3462,7261
2022-12-19,경의선,디지털미디어시티,2779,2570,5349
2022-12-19,경의선,문산,5202,5076,10278
2022-12-19,경의선,백마,7198,6783,13981
2022-12-19,경의선,서강대,2245,2271,4516
2022-12-19,경의선,서울역,4467,5875,10342
2022-12-19,경의선,수색,2735,2967,5702
2022-12-19,경의선,신촌,930,1221,2151
2022-12-19,경의선,야당,8043,7953,15996
2022-12-19,경의선,운정,7065,6517,13582
2022-12-19,경의선,운천,14,15,29
2022-12-19,경의선,월롱,2558,2364,4922
2022-12-19,경의선,일산,9503,9205,18708
2022-12-19,경의선,임진강,6,1,7
2022-12-19,경의선,탄현,7995,7471,15466
2022-12-19,경의선,파주,1202,786,1988
2022-12-19,경의선,풍산,5573,5258,10831
2022-12-19,경의선,행신,8356,8220,16576
2022-12-19,경의선,홍대입구,1743,2100,3843
2022-12-19,경의선,화전,1697,1616,3313
2022-12-19,경의선,효창공원앞,3199,3609,6808
2022-12-19,경인선,간석,5789,5420,11209
2022-12-19,경인선,개봉,22076,21734,43810
2022-12-19,경인선,구일,6667,6459,13126
2022-12-19,경인선,도원,3138,2989,6127
2022-12-19,경인선,도화,3940,3498,7438
2022-12-19,경인선,동암,15792,15747,31539
2022-12-19,경인선,동인천,13027,12623,25650
2022-12-19,경인선,백운,6642,6409,13051
2022-12-19,경인선,부개,8491,7900,16391
2022-12-19,경인선,부천,31075,30909,61984
2022-12-19,경인선,부평,27811,29537,57348
2022-12-19,경인선,소사,8028,7864,15892
2022-12-19,경인선,송내,27322,26899,54221
2022-12-19,경인선,역곡,26703,26543,53246
2022-12-19,경인선,오류동,11442,10783,22225
2022-12-19,경인선,온수,6683,6319,13002
2022-12-19,경인선,인천,2886,2120,5006
2022-12-19,경인선,제물포,10590,10096,20686
2022-12-19,경인선,주안,18518,16856,35374
2022-12-19,경인선,중동,9550,8560,18110
2022-12-19,경춘선,가평,1571,1646,3217
2022-12-19,경춘선,갈매,3084,2616,5700
2022-12-19,경춘선,강촌,479,458,937
2022-12-19,경춘선,굴봉산,90,109,199
2022-12-19,경춘선,금곡,1439,1357,2796
2022-12-19,경춘선,김유정,235,272,507
2022-12-19,경춘선,남춘천,2486,2664,5150
2022-12-19,경춘선,대성리,492,479,971
2022-12-19,경춘선,마석,3834,3709,7543
2022-12-19,경춘선,백양리,274,290,564
2022-12-19,경춘선,별내,3211,2976,6187
2022-12-19,경춘선,사릉,2416,2249,4665
2022-12-19,경춘선,상천,177,158,335
2022-12-19,경춘선,신내,2268,2156,4424
2022-12-19,경춘선,천마산,1535,1417,2952
2022-12-19,경춘선,청평,1517,1445,2962
2022-12-19,경춘선,춘천,1411,1435,2846
2022-12-19,경춘선,퇴계원,3616,3237,6853
2022-12-19,경춘선,평내호평,6199,6040,12239
2022-12-19,공항철도,검암,6805,6574,13379
2022-12-19,공항철도,계양,12651,11685,24336
2022-12-19,공항철도,공덕,2722,3548,6270
2022-12-19,공항철도,공항화물청사,2347,2470,4817
2022-12-19,공항철도,김포공항,11491,6685,18176
2022-12-19,공항철도,디지털미디어시티,15041,14115,29156
2022-12-19,공항철도,마곡나루,10400,10183,20583
2022-12-19,공항철도,서울역,11021,9385,20406
2022-12-19,공항철도,영종,3654,3702,7356
2022-12-19,공항철도,운서,8410,8751,17161
2022-12-19,공항철도,인천공항1터미널,11088,10547,21635
2022-12-19,공항철도,인천공항2터미널,4238,3576,7814
2022-12-19,공항철도,청라국제도시,7237,6790,14027
2022-12-19,공항철도,홍대입구,11500,11407,22907
2022-12-19,과천선,경마공원,836,853,1689
2022-12-19,과천선,과천,6537,6317,12854
2022-12-19,과천선,대공원,1340,1375,2715
2022-12-19,과천선,범계,26251,26427,52678
2022-12-19,과천선,선바위,8048,7046,15094
2022-12-19,과천선,인덕원,24290,25678,49968
2022-12-19,과천선,정부과천청사,10857,10892,21749
2022-12-19,과천선,평촌,18676,18509,37185
2022-12-19,분당선,가천대,7427,8299,15726
2022-12-19,분당선,강남구청,10116,11463,21579
2022-12-19,분당선,개포동,4137,4170,8307
2022-12-19,분당선,구룡,2416,2380,4796
2022-12-19,분당선,구성,5257,5541,10798
2022-12-19,분당선,기흥,10640,9959,20599
2022-12-19,분당선,대모산입구,5200,4843,10043
2022-12-19,분당선,도곡,8042,7969,16011
2022-12-19,분당선,망포,15765,15165,30930
2022-12-19,분당선,매교,4729,4777,9506
2022-12-19,분당선,매탄권선,5464,5411,10875
2022-12-19,분당선,모란,22979,23551,46530
2022-12-19,분당선,미금,15615,16700,32315
2022-12-19,분당선,보정,2807,2425,5232
2022-12-19,분당선,복정,1,0,1
2022-12-19,분당선,상갈,5772,5436,11208
2022-12-19,분당선,서울숲,11263,11552,22815
2022-12-19,분당선,서현,25603,25447,51050
2022-12-19,분당선,선릉,14597,22175,36772
2022-12-19,분당선,선정릉,8530,9026,17556
2022-12-19,분당선,수내,14819,14601,29420
2022-12-19,분당선,수서,14812,15158,29970
2022-12-19,분당선,수원,8060,6845,14905
2022-12-19,분당선,수원시청,13220,14202,27422
2022-12-19,분당선,신갈,5125,5065,10190
2022-12-19,분당선,압구정로데오,19183,20860,40043
2022-12-19,분당선,야탑,26941,28274,55215
2022-12-19,분당선,영통,9330,9287,18617
2022-12-19,분당선,오리,12025,9898,21923
2022-12-19,분당선,이매,5873,5603,11476
2022-12-19,분당선,정자,19951,20909,40860
2022-12-19,분당선,죽전,14211,15740,29951
2022-12-19,분당선,청명,4695,4528,9223
2022-12-19,분당선,태평,13665,13164,26829
2022-12-19,분당선,한티,14985,16007,30992
2022-12-19,수인선,고색,5050,4578,9628
2022-12-19,수인선,남동인더스파크,2235,2532,4767
2022-12-19,수인선,달월,98,69,167
2022-12-19,수인선,사리,5066,4321,9387
2022-12-19,수인선,소래포구,4315,3950,8265
2022-12-19,수인선,송도,2425,2164,4589
2022-12-19,수인선,숭의,4171,3786,7957
2022-12-19,수인선,신포,1789,1810,3599
2022-12-19,수인선,야목,380,277,657
2022-12-19,수인선,어천,1068,1042,2110
2022-12-19,수인선,연수,4313,4353,8666
2022-12-19,수인선,오목천,3382,3207,6589
2022-12-19,수인선,원인재,4252,4439,8691
2022-12-19,수인선,월곶,2550,2308,4858
2022-12-19,수인선,인천,922,1450,2372
2022-12-19,수인선,인천논현,5440,5779,11219
2022-12-19,수인선,인하대,6133,5773,11906
2022-12-19,수인선,호구포,4151,4351,8502
2022-12-19,신림선,관악산,1938,1939,3877
2022-12-19,신림선,당곡,4330,4334,8664
2022-12-19,신림선,대방,2388,2016,4404
2022-12-19,신림선,보라매,3737,3351,7088
2022-12-19,신림선,보라매공원,1842,1987,3829
2022-12-19,신림선,보라매병원,7529,7908,15437
2022-12-19,신림선,샛강,2785,3332,6117
2022-12-19,신림선,서울대벤처타운,7901,7755,15656
2022-12-19,신림선,서울지방병무청,2722,3090,5812
2022-12-19,신림선,서원,3321,2908,6229
2022-12-19,신림선,신림,1765,2352,4117
2022-12-19,안산선,고잔,9177,8588,17765
2022-12-19,안산선,대야미,4795,4398,9193
2022-12-19,안산선,반월,4334,4167,8501
2022-12-19,안산선,산본,15885,17076,32961
2022-12-19,안산선,상록수,15318,15762,31080
2022-12-19,안산선,수리산,4121,3424,7545
2022-12-19,안산선,신길온천,1741,1581,3322
2022-12-19,안산선,안산,11616,10493,22109
2022-12-19,안산선,오이도,7864,7590,15454
2022-12-19,안산선,정왕,8717,7489,16206
2022-12-19,안산선,중앙,17965,18621,36586
2022-12-19,안산선,초지,4867,4870,9737
2022-12-19,안산선,한대앞,9774,9750,19524
2022-12-19,우이신설선,4.19민주묘지,3422,3534,6956
2022-12-19,우이신설선,가오리,4246,4162,8408
2022-12-19,우이신설선,보문,1567,1556,3123
2022-12-19,우이신설선,북한산보국문,6226,6031,12257
2022-12-19,우이신설선,북한산우이,2467,2073,4540
2022-12-19,우이신설선,삼양,1993,2133,4126
2022-12-19,우이신설선,삼양사거리,2492,2502,4994
2022-12-19,우이신설선,성신여대입구,3543,4027,7570
2022-12-19,우이신설선,솔밭공원,2464,2319,4783
2022-12-19,우이신설선,솔샘,6168,5827,11995
2022-12-19,우이신설선,신설동,2339,2303,4642
2022-12-19,우이신설선,정릉,4751,4584,9335
2022-12-19,우이신설선,화계,3421,3209,6630
2022-12-19,일산선,대곡,2092,1481,3573
2022-12-19,일산선,대화,13527,10272,23799
2022-12-19,일산선,마두,7778,7854,15632
2022-12-19,일산선,백석,9729,9813,19542
2022-12-19,일산선,삼송,19959,19476,39435
2022-12-19,일산선,원당,11122,10547,21669
2022-12-19,일산선,원흥,11609,11115,22724
2022-12-19,일산선,정발산,6783,6828,13611
2022-12-19,일산선,주엽,9264,9207,18471
2022-12-19,일산선,화정,16580,16928,33508
2022-12-19,장항선,배방,1125,1071,2196
2022-12-19,장항선,봉명,1407,1439,2846
2022-12-19,장항선,신창,1133,1211,2344
2022-12-19,장항선,쌍용,2914,2729,5643
2022-12-19,장항선,아산,3686,3098,6784
2022-12-19,장항선,온양온천,4343,4415,8758
2022-12-19,장항선,탕정,1149,1086,2235
2022-12-19,중앙선,구리,13467,13578,27045
2022-12-19,중앙선,국수,732,706,1438
2022-12-19,중앙선,덕소,5472,5443,10915
2022-12-19,중앙선,도농,11738,10441,22179
2022-12-19,중앙선,도심,2501,1866,4367
2022-12-19,중앙선,망우,7488,7313,14801
2022-12-19,중앙선,상봉,5629,5654,11283
2022-12-19,중앙선,신원,147,122,269
2022-12-19,중앙선,아신,477,468,945
2022-12-19,중앙선,양수,1621,1620,3241
2022-12-19,중앙선,양원,3052,2961,6013
2022-12-19,중앙선,양정,568,480,1048
2022-12-19,중앙선,양평,2693,2686,5379
2022-12-19,중앙선,오빈,317,300,617
2022-12-19,중앙선,용문,1425,1447,2872
2022-12-19,중앙선,운길산,525,477,1002
2022-12-19,중앙선,원덕,308,270,578
2022-12-19,중앙선,중랑,5556,5376,10932
2022-12-19,중앙선,지평,55,57,112
2022-12-19,중앙선,팔당,740,688,1428
2022-12-19,중앙선,회기,27474,27165,54639
2022-12-20,1호선,동대문,11992,11346,23338
2022-12-20,1호선,동묘앞,8570,8935,17505
2022-12-20,1호선,서울역,52974,50839,103813
2022-12-20,1호선,시청,29026,28614,57640
2022-12-20,1호선,신설동,14558,14043,28601
2022-12-20,1호선,제기동,19222,19706,38928
2022-12-20,1호선,종각,44119,42911,87030
2022-12-20,1호선,종로3가,28497,26025,54522
2022-12-20,1호선,종로5가,27203,26740,53943
2022-12-20,1호선,청량리,21371,21468,42839
2022-12-20,2호선,강남,89876,86168,176044
2022-12-20,2호선,강변,33176,30293,63469
2022-12-20,2호선,건대입구,37540,40014,77554
2022-12-20,2호선,교대,38747,43829,82576
2022-12-20,2호선,구로디지털단지,64927,64712,129639
2022-12-20,2호선,구의,26313,25922,52235
2022-12-20,2호선,낙성대,29559,28854,58413
2022-12-20,2호선,당산,19649,23303,42952
2022-12-20,2호선,대림,25120,25609,50729
2022-12-20,2호선,도림천,1480,1598,3078
2022-12-20,2호선,동대문역사문화공원,14509,16562,31071
2022-12-20,2호선,뚝섬,24692,26484,51176
2022-12-20,2호선,문래,24234,24418,48652
2022-12-20,2호선,방배,17650,18609,36259
2022-12-20,2호선,봉천,26079,24391,50470
2022-12-20,2호선,사당,43302,47283,90585
2022-12-20,2호선,삼성,62827,62748,125575
2022-12-20,2호선,상왕십리,15888,15486,31374
2022-12-20,2호선,서울대입구,50431,49234,99665
2022-12-20,2호선,서초,24764,24123,48887
2022-12-20,2호선,선릉,65754,58524,124278
2022-12-20,2호선,성수,44169,48118,92287
2022-12-20,2호선,시청,29158,27856,57014
2022-12-20,2호선,신답,1919,2088,4007
2022-12-20,2호선,신당,15262,15772,31034
2022-12-20,2호선,신대방,26508,25916,52424
2022-12-20,2호선,신도림,53085,52294,105379
2022-12-20,2호선,신림,60825,59129,119954
2022-12-20,2호선,신설동,3567,3843,7410
2022-12-20,2호선,신정네거리,11301,11643,22944
2022-12-20,2호선,신촌,39230,39522,78752
2022-12-20,2호선,아현,11651,10987,22638
2022-12-20,2호선,양천구청,7520,7997,15517
2022-12-20,2호선,역삼,61172,68908,130080
2022-12-20,2호선,영등포구청,24258,25001,49259
2022-12-20,2호선,왕십리,18364,15603,33967
2022-12-20,2호선,용답,3225,3349,6574
2022-12-20,2호선,용두,2764,2741,5505
2022-12-20,2호선,을지로3가,27049,27284,54333
2022-12-20,2호선,을지로4가,15713,16089,31802
2022-12-20,2호선,을지로입구,53342,54586,107928
2022-12-20,2호선,이대,15858,17102,32960
2022-12-20,2호선,잠실,88822,88236,177058
2022-12-20,2호선,잠실나루,16376,15841,32217
2022-12-20,2호선,잠실새내,24564,24273,48837
2022-12-20,2호선,종합운동장,8371,8574,16945
2022-12-20,2호선,충정로,11300,11951,23251
2022-12-20,2호선,한양대,12692,13796,26488
2022-12-20,2호선,합정,33968,36119,70087
2022-12-20,2호선,홍대입구,67560,70830,138390
2022-12-20,3호선,가락시장,10353,10160,20513
2022-12-20,3호선,경복궁,24067,23931,47998
2022-12-20,3호선,경찰병원,8410,8569,16979
2022-12-20,3호선,고속터미널,47556,45012,92568
2022-12-20,3호선,교대,17219,11052,28271
2022-12-20,3호선,구파발,23091,22352,45443
2022-12-20,3호선,금호,8671,8216,16887
2022-12-20,3호선,남부터미널,32679,33396,66075
2022-12-20,3호선,녹번,17133,15334,32467
2022-12-20,3호선,대청,11372,10660,22032
2022-12-20,3호선,대치,11977,12145,24122
2022-12-20,3호선,도곡,5895,5944,11839
2022-12-20,3호선,독립문,7628,7851,15479
2022-12-20,3호선,동대입구,8381,9098,17479
2022-12-20,3호선,매봉,14365,13880,28245
2022-12-20,3호선,무악재,4656,4604,9260
2022-12-20,3호선,불광,17230,18517,35747
2022-12-20,3호선,수서,19019,19756,38775
2022-12-20,3호선,신사,32555,33563,66118
2022-12-20,3호선,안국,26610,27987,54597
2022-12-20,3호선,압구정,37153,39846,76999
2022-12-20,3호선,약수,14293,13961,28254
2022-12-20,3호선,양재,42631,46214,88845
2022-12-20,3호선,연신내,37825,36016,73841
2022-12-20,3호선,오금,7027,6297,13324
2022-12-20,3호선,옥수,9722,9948,19670
2022-12-20,3호선,을지로3가,12850,12659,25509
2022-12-20,3호선,일원,12071,11617,23688
2022-12-20,3호선,잠원,5362,5134,10496
2022-12-20,3호선,종로3가,10890,12873,23763
2022-12-20,3호선,지축,6667,6398,13065
2022-12-20,3호선,충무로,2,0,2
2022-12-20,3호선,학여울,1969,2055,4024
2022-12-20,3호선,홍제,19753,18883,38636
2022-12-20,4호선,길음,22933,22850,45783
2022-12-20,4호선,남태령,1483,1366,2849
2022-12-20,4호선,노원,20098,22854,42952
2022-12-20,4호선,당고개,9673,8668,18341
2022-12-20,4호선,동대문,21457,22306,43763
2022-12-20,4호선,동대문역사문화공원,18580,16234,34814
2022-12-20,4호선,동작,1246,1366,2612
2022-12-20,4호선,명동,29191,30909,60100
2022-12-20,4호선,미아,15810,15466,31276
2022-12-20,4호선,미아사거리,28907,28731,57638
2022-12-20,4호선,사당,29091,24871,53962
2022-12-20,4호선,삼각지,6518,7387,13905
2022-12-20,4호선,상계,20727,19395,40122
2022-12-20,4호선,서울역,13287,20792,34079
2022-12-20,4호선,성신여대입구,21906,21257,43163
2022-12-20,4호선,수유,36578,37036,73614
2022-12-20,4호선,숙대입구,14812,14400,29212
2022-12-20,4호선,신용산,20455,21147,41602
2022-12-20,4호선,쌍문,31300,29468,60768
2022-12-20,4호선,이촌,10126,10893,21019
2022-12-20,4호선,창동,26856,28452,55308
2022-12-20,4호선,총신대입구,20600,22494,43094
2022-12-20,4호선,충무로,30481,31306,61787
2022-12-20,4호선,한성대입구,13990,13399,27389
2022-12-20,4호선,혜화,39228,38572,77800
2022-12-20,4호선,회현,29166,31065,60231
2022-12-20,5호선,강동,20061,19261,39322
2022-12-20,5호선,강일,5563,5279,10842
2022-12-20,5호선,개롱,6944,7194,14138
2022-12-20,5호선,개화산,6176,5933,12109
2022-12-20,5호선,거여,10990,10629,21619
2022-12-20,5호선,고덕,11187,11039,22226
2022-12-20,5호선,공덕,16510,17265,33775
2022-12-20,5호선,광나루,14431,13205,27636
2022-12-20,5호선,광화문,38906,39218,78124
2022-12-20,5호선,군자,12102,13366,25468
2022-12-20,5호선,굽은다리,10468,10207,20675
2022-12-20,5호선,길동,8611,9092,17703
2022-12-20,5호선,김포공항,8191,7700,15891
2022-12-20,5호선,까치산,30940,29785,60725
2022-12-20,5호선,답십리,17759,16204,33963
2022-12-20,5호선,동대문역사문화공원,3525,4101,7626
2022-12-20,5호선,둔촌동,9492,9603,19095
2022-12-20,5호선,마곡,12124,12010,24134
2022-12-20,5호선,마장,6439,6218,12657
2022-12-20,5호선,마천,8112,7848,15960
2022-12-20,5호선,마포,16891,17276,34167
2022-12-20,5호선,명일,9414,9847,19261
2022-12-20,5호선,목동,18020,19633,37653
2022-12-20,5호선,미사,17715,17895,35610
2022-12-20,5호선,발산,23906,24070,47976
2022-12-20,5호선,방이,7735,7932,15667
2022-12-20,5호선,방화,7234,6961,14195
2022-12-20,5호선,상일동,15986,15056,31042
2022-12-20,5호선,서대문,23038,23101,46139
2022-12-20,5호선,송정,6884,6435,13319
2022-12-20,5호선,신금호,6944,7296,14240
2022-12-20,5호선,신길,4620,4979,9599
2022-12-20,5호선,신정,14651,12115,26766
2022-12-20,5호선,아차산,15484,14835,30319
2022-12-20,5호선,애오개,7388,7411,14799
2022-12-20,5호선,양평,8056,8062,16118
2022-12-20,5호선,여의나루,12517,15395,27912
2022-12-20,5호선,여의도,35095,35249,70344
2022-12-20,5호선,영등포구청,4547,4557,9104
2022-12-20,5호선,영등포시장,11357,11797,23154
2022-12-20,5호선,오금,4129,4270,8399
2022-12-20,5호선,오목교,23759,25117,48876
2022-12-20,5호선,올림픽공원,4800,4079,8879
2022-12-20,5호선,왕십리,5054,5791,10845
2022-12-20,5호선,우장산,15811,15737,31548
2022-12-20,5호선,을지로4가,7388,7423,14811
2022-12-20,5호선,장한평,20382,20457,40839
2022-12-20,5호선,종로3가,15615,15025,30640
2022-12-20,5호선,천호,20049,19485,39534
2022-12-20,5호선,청구,4314,3935,8249
2022-12-20,5호선,충정로,5155,5298,10453
2022-12-20,5호선,하남검단산,6653,6457,13110
2022-12-20,5호선,하남시청,7732,7544,15276
2022-12-20,5호선,하남풍산,4573,4597,9170
2022-12-20,5호선,행당,8814,7865,16679
2022-12-20,5호선,화곡,30431,28869,59300
2022-12-20,6호선,고려대,9448,9391,18839
2022-12-20,6호선,공덕,21255,20728,41983
2022-12-20,6호선,광흥창,10062,9871,19933
2022-12-20,6호선,구산,8490,6515,15005
2022-12-20,6호선,녹사평,5212,5012,10224
2022-12-20,6호선,대흥,9766,10275,20041
2022-12-20,6호선,독바위,2916,3036,5952
2022-12-20,6호선,돌곶이,10502,9761,20263
2022-12-20,6호선,동묘앞,8465,8561,17026
2022-12-20,6호선,디지털미디어시티,15915,17705,33620
2022-12-20,6호선,마포구청,15771,14289,30060
2022-12-20,6호선,망원,15052,15983,31035
2022-12-20,6호선,버티고개,2357,2344,4701
2022-12-20,6호선,보문,8287,7654,15941
2022-12-20,6호선,봉화산,9860,9227,19087
2022-12-20,6호선,불광,4694,4508,9202
2022-12-20,6호선,삼각지,8287,7491,15778
2022-12-20,6호선,상수,9682,11096,20778
2022-12-20,6호선,상월곡,6870,6142,13012
2022-12-20,6호선,새절,14198,13338,27536
2022-12-20,6호선,석계,13429,14082,27511
2022-12-20,6호선,신내,1,0,1
2022-12-20,6호선,신당,9044,9610,18654
2022-12-20,6호선,안암,13648,13420,27068
2022-12-20,6호선,약수,3825,3912,7737
2022-12-20,6호선,역촌,4006,4886,8892
2022-12-20,6호선,월곡,12723,12427,25150
2022-12-20,6호선,월드컵경기장,4395,4562,8957
2022-12-20,6호선,응암,19142,19057,38199
2022-12-20,6호선,이태원,10038,10168,20206
2022-12-20,6호선,증산,10764,10793,21557
2022-12-20,6호선,창신,3883,3186,7069
2022-12-20,6호선,청구,4004,4177,8181
2022-12-20,6호선,태릉입구,6143,6988,13131
2022-12-20,6호선,한강진,9298,10747,20045
2022-12-20,6호선,합정,14624,14483,29107
2022-12-20,6호선,화랑대,13136,9918,23054
2022-12-20,6호선,효창공원앞,7734,7014,14748
2022-12-20,7호선,가산디지털단지,49462,49407,98869
2022-12-20,7호선,강남구청,18477,20454,38931
2022-12-20,7호선,건대입구,14154,14813,28967
2022-12-20,7호선,고속터미널,17335,14475,31810
2022-12-20,7호선,공릉,12886,12739,25625
2022-12-20,7호선,광명사거리,22630,22458,45088
2022-12-20,7호선,군자,16597,13141,29738
2022-12-20,7호선,남구로,16641,17554,34195
2022-12-20,7호선,남성,12318,11459,23777
2022-12-20,7호선,내방,16281,16677,32958
2022-12-20,7호선,노원,21891,22902,44793
2022-12-20,7호선,논현,20839,21412,42251
2022-12-20,7호선,대림,8452,8613,17065
2022-12-20,7호선,도봉산,9333,10686,20019
2022-12-20,7호선,뚝섬유원지,7843,7569,15412
2022-12-20,7호선,마들,14294,13421,27715
2022-12-20,7호선,먹골,11113,10979,22092
2022-12-20,7호선,면목,16923,16702,33625
2022-12-20,7호선,반포,6718,6526,13244
2022-12-20,7호선,보라매,7895,8235,16130
2022-12-20,7호선,사가정,17401,17438,34839
2022-12-20,7호선,상도,13363,13031,26394
2022-12-20,7호선,상봉,18061,17298,35359
2022-12-20,7호선,수락산,13477,13344,26821
2022-12-20,7호선,숭실대입구,13203,13254,26457
2022-12-20,7호선,신대방삼거리,16183,15542,31725
2022-12-20,7호선,신풍,12380,11656,24036
2022-12-20,7호선,어린이대공원,16513,16400,32913
2022-12-20,7호선,온수,10980,9960,20940
2022-12-20,7호선,용마산,6412,6206,12618
2022-12-20,7호선,이수,17561,16706,34267
2022-12-20,7호선,장승배기,10004,9913,19917
2022-12-20,7호선,장암,2617,959,3576
2022-12-20,7호선,중계,15899,14481,30380
2022-12-20,7호선,중곡,11928,11143,23071
2022-12-20,7호선,중화,11595,11440,23035
2022-12-20,7호선,천왕,12645,11976,24621
2022-12-20,7호선,철산,23310,24014,47324
2022-12-20,7호선,청담,21596,24405,46001
2022-12-20,7호선,태릉입구,10157,9451,19608
2022-12-20,7호선,하계,19490,18260,37750
2022-12-20,7호선,학동,26366,28292,54658
2022-12-20,8호선,가락시장,9058,9935,18993
2022-12-20,8호선,강동구청,11716,12120,23836
2022-12-20,8호선,남위례,6547,6733,13280
2022-12-20,8호선,남한산성입구,14238,12811,27049
2022-12-20,8호선,단대오거리,11920,11764,23684
2022-12-20,8호선,모란,4767,3525,8292
2022-12-20,8호선,몽촌토성,7024,7265,14289
2022-12-20,8호선,문정,23740,25011,48751
2022-12-20,8호선,복정,9693,8113,17806
2022-12-20,8호선,산성,5551,5508,11059
2022-12-20,8호선,석촌,8388,9662,18050
2022-12-20,8호선,송파,10216,9883,20099
2022-12-20,8호선,수진,5806,5408,11214
2022-12-20,8호선,신흥,5310,5759,11069
2022-12-20,8호선,암사,20710,18206,38916
2022-12-20,8호선,잠실,17744,20937,38681
2022-12-20,8호선,장지,19522,18605,38127
2022-12-20,8호선,천호,15694,18274,33968
2022-12-20,9호선,가양,23546,23033,46579
2022-12-20,9호선,개화,2973,1994,4967
2022-12-20,9호선,고속터미널,14483,18497,32980
2022-12-20,9호선,공항시장,3137,3467,6604
2022-12-20,9호선,구반포,1218,1282,2500
2022-12-20,9호선,국회의사당,18925,19377,38302
2022-12-20,9호선,김포공항,7641,11159,18800
2022-12-20,9호선,노들,5000,4196,9196
2022-12-20,9호선,노량진,28611,27764,56375
2022-12-20,9호선,당산,21086,21173,42259
2022-12-20,9호선,동작,1751,1264,3015
2022-12-20,9호선,등촌,12936,12332,25268
2022-12-20,9호선,마곡나루,13989,13499,27488
2022-12-20,9호선,사평,4317,4177,8494
2022-12-20,9호선,샛강,7241,7229,14470
2022-12-20,9호선,선유도,9880,9371,19251
2022-12-20,9호선,신논현,34047,33496,67543
2022-12-20,9호선,신목동,4717,4194,8911
2022-12-20,9호선,신반포,3971,3914,7885
2022-12-20,9호선,신방화,7542,7385,14927
2022-12-20,9호선,양천향교,10457,10759,21216
2022-12-20,9호선,여의도,34932,33103,68035
2022-12-20,9호선,염창,19057,18599,37656
2022-12-20,9호선,증미,7941,7581,15522
2022-12-20,9호선,흑석,10156,10581,20737
2022-12-20,9호선2~3단계,둔촌오륜,1222,1167,2389
2022-12-20,9호선2~3단계,봉은사,21658,22429,44087
2022-12-20,9호선2~3단계,삼성중앙,8632,9121,17753
2022-12-20,9호선2~3단계,삼전,7788,7527,15315
2022-12-20,9호선2~3단계,석촌,9649,8619,18268
2022-12-20,9호선2~3단계,석촌고분,7235,7029,14264
2022-12-20,9호선2~3단계,선정릉,11065,12390,23455
2022-12-20,9호선2~3단계,송파나루,5739,6189,11928
2022-12-20,9호선2~3단계,언주,12281,12617,24898
2022-12-20,9호선2~3단계,올림픽공원,7013,7017,14030
2022-12-20,9호선2~3단계,종합운동장,4640,4880,9520
2022-12-20,9호선2~3단계,중앙보훈병원,12775,11059,23834
2022-12-20,9호선2~3단계,한성백제,2881,2662,5543
2022-12-20,경강선,경기광주,8836,8275,17111
2022-12-20,경강선,곤지암,2757,2464,5221
2022-12-20,경강선,부발,2295,2181,4476
2022-12-20,경강선,삼동,2797,2626,5423
2022-12-20,경강선,세종대왕릉,365,360,725
2022-12-20,경강선,신둔도예촌,1574,1531,3105
2022-12-20,경강선,여주,2310,2242,4552
2022-12-20,경강선,이매,1253,1017,2270
2022-12-20,경강선,이천,2808,2829,5637
2022-12-20,경강선,초월,3665,3471,7136
2022-12-20,경강선,판교,6134,6193,12327
2022-12-20,경부선,가산디지털단지,19211,21913,41124
2022-12-20,경부선,관악,7851,7561,15412
2022-12-20,경부선,광명,3574,3082,6656
2022-12-20,경부선,구로,19106,19609,38715
2022-12-20,경부선,군포,8332,8237,16569
2022-12-20,경부선,금정,29339,30104,59443
2022-12-20,경부선,금천구청,12280,12211,24491
2022-12-20,경부선,남영,10151,10755,20906
2022-12-20,경부선,노량진,9116,9651,18767
2022-12-20,경부선,당정,6998,6650,13648
2022-12-20,경부선,대방,12034,13284,25318
2022-12-20,경부선,독산,19767,20701,40468
2022-12-20,경부선,두정,7298,7954,15252
2022-12-20,경부선,명학,9753,9437,19190
2022-12-20,경부선,병점,15176,15120,30296
2022-12-20,경부선,서동탄,1485,1281,2766
2022-12-20,경부선,서울역,8546,2565,11111
2022-12-20,경부선,서정리,8114,7454,15568
2022-12-20,경부선,석수,9961,8923,18884
2022-12-20,경부선,성균관대,15263,15092,30355
2022-12-20,경부선,성환,3785,3687,7472
2022-12-20,경부선,세류,3411,3009,6420
2022-12-20,경부선,세마,3197,3056,6253
2022-12-20,경부선,송탄,4610,4544,9154
2022-12-20,경부선,수원,36112,38409,74521
2022-12-20,경부선,신길,9784,8279,18063
2022-12-20,경부선,신도림,4173,4329,8502
2022-12-20,경부선,안양,24068,23985,48053
2022-12-20,경부선,영등포,43104,44167,87271
2022-12-20,경부선,오산,10209,10352,20561
2022-12-20,경부선,오산대,3761,3412,7173
2022-12-20,경부선,용산,40505,40786,81291
2022-12-20,경부선,의왕,9766,9593,19359
2022-12-20,경부선,직산,861,907,1768
2022-12-20,경부선,진위,1977,1765,3742
2022-12-20,경부선,천안,6536,5910,12446
2022-12-20,경부선,평택,12478,12492,24970
2022-12-20,경부선,평택지제,4515,4489,9004
2022-12-20,경부선,화서,8884,8705,17589
2022-12-20,경원선,가능,6899,6762,13661
2022-12-20,경원선,광운대,8067,7888,15955
2022-12-20,경원선,녹양,4713,4442,9155
2022-12-20,경원선,녹천,4893,4127,9020
2022-12-20,경원선,덕계,3453,2980,6433
2022-12-20,경원선,덕정,6145,5845,11990
2022-12-20,경원선,도봉,6435,6079,12514
2022-12-20,경원선,도봉산,7283,4493,11776
2022-12-20,경원선,동두천,2108,2321,4429
2022-12-20,경원선,동두천중앙,3307,3270,6577
2022-12-20,경원선,망월사,9807,9795,19602
2022-12-20,경원선,방학,10341,10109,20450
2022-12-20,경원선,보산,1511,1399,2910
2022-12-20,경원선,서빙고,2233,1992,4225
2022-12-20,경원선,석계,8486,9548,18034
2022-12-20,경원선,소요산,2056,1624,3680
2022-12-20,경원선,신이문,9004,8225,17229
2022-12-20,경원선,양주,7700,7326,15026
2022-12-20,경원선,옥수,52,43,95
2022-12-20,경원선,왕십리,17171,17713,34884
2022-12-20,경원선,외대앞,9687,9647,19334
2022-12-20,경원선,월계,7739,7228,14967
2022-12-20,경원선,응봉,1988,1658,3646
2022-12-20,경원선,의정부,19188,19707,38895
2022-12-20,경원선,이촌,4115,3259,7374
2022-12-20,경원선,지행,6975,6778,13753
2022-12-20,경원선,청량리,16672,17053,33725
2022-12-20,경원선,한남,4296,4155,8451
2022-12-20,경원선,회룡,13363,13183,26546
2022-12-20,경의선,가좌,6137,5919,12056
2022-12-20,경의선,강매,3497,3008,6505
2022-12-20,경의선,계양,1,0,1
2022-12-20,경의선,곡산,651,599,1250
2022-12-20,경의선,공덕,4151,3598,7749
2022-12-20,경의선,금릉,5615,5429,11044
2022-12-20,경의선,금촌,6966,6875,13841
2022-12-20,경의선,능곡,4065,3656,7721
2022-12-20,경의선,디지털미디어시티,2970,2646,5616
2022-12-20,경의선,문산,5700,5741,11441
2022-12-20,경의선,백마,7464,7233,14697
2022-12-20,경의선,서강대,2375,2299,4674
2022-12-20,경의선,서울역,4736,6160,10896
2022-12-20,경의선,수색,2830,3095,5925
2022-12-20,경의선,신촌,937,1277,2214
2022-12-20,경의선,야당,8729,8802,17531
2022-12-20,경의선,운정,7561,7098,14659
2022-12-20,경의선,운천,3,4,7
2022-12-20,경의선,월롱,2727,2420,5147
2022-12-20,경의선,일산,10092,9891,19983
2022-12-20,경의선,임진강,7,1,8
2022-12-20,경의선,탄현,8443,8038,16481
2022-12-20,경의선,파주,1383,848,2231
2022-12-20,경의선,풍산,6091,5613,11704
2022-12-20,경의선,행신,8669,8600,17269
2022-12-20,경의선,홍대입구,1870,2348,4218
2022-12-20,경의선,화전,1757,1615,3372
2022-12-20,경의선,효창공원앞,3202,3777,6979
2022-12-20,경인선,간석,6140,5761,11901
2022-12-20,경인선,개봉,23702,23320,47022
2022-12-20,경인선,구일,7508,7389,14897
2022-12-20,경인선,도원,3274,3263,6537
2022-12-20,경인선,도화,4197,3904,8101
2022-12-20,경인선,동암,17034,16723,33757
2022-12-20,경인선,동인천,14077,13373,27450
2022-12-20,경인선,백운,7188,7051,14239
2022-12-20,경인선,부개,9199,8636,17835
2022-12-20,경인선,부천,32926,32828,65754
2022-12-20,경인선,부평,29814,31479,61293
2022-12-20,경인선,소사,8663,8437,17100
2022-12-20,경인선,송내,28580,28349,56929
2022-12-20,경인선,역곡,28351,28175,56526
2022-12-20,경인선,오류동,12075,11322,23397
2022-12-20,경인선,온수,7119,6687,13806
2022-12-20,경인선,인천,3419,2677,6096
2022-12-20,경인선,제물포,11210,10480,21690
2022-12-20,경인선,주안,19428,17649,37077
2022-12-20,경인선,중동,10059,9340,19399
2022-12-20,경춘선,가평,1723,1564,3287
2022-12-20,경춘선,갈매,3228,2795,6023
2022-12-20,경춘선,강촌,674,620,1294
2022-12-20,경춘선,굴봉산,91,101,192
2022-12-20,경춘선,금곡,1610,1520,3130
2022-12-20,경춘선,김유정,273,276,549
2022-12-20,경춘선,남춘천,2557,2577,5134
2022-12-20,경춘선,대성리,555,527,1082
2022-12-20,경춘선,마석,4102,4029,8131
2022-12-20,경춘선,백양리,354,303,657
2022-12-20,경춘선,별내,3356,3163,6519
2022-12-20,경춘선,사릉,2355,2380,4735
2022-12-20,경춘선,상천,205,190,395
2022-12-20,경춘선,신내,2363,2320,4683
2022-12-20,경춘선,천마산,1651,1515,3166
2022-12-20,경춘선,청평,1634,1537,3171
2022-12-20,경춘선,춘천,1834,1582,3416
2022-12-20,경춘선,퇴계원,3805,3496,7301
2022-12-20,경춘선,평내호평,6646,6516,13162
2022-12-20,공항철도,검암,6959,6860,13819
2022-12-20,공항철도,계양,13121,12174,25295
2022-12-20,공항철도,공덕,2713,3793,6506
2022-12-20,공항철도,공항화물청사,2406,2561,4967
2022-12-20,공항철도,김포공항,11270,6852,18122
2022-12-20,공항철도,디지털미디어시티,16055,14849,30904
2022-12-20,공항철도,마곡나루,11270,10949,22219
2022-12-20,공항철도,서울역,10704,9326,20030
2022-12-20,공항철도,영종,3882,3963,7845
2022-12-20,공항철도,운서,8620,8935,17555
2022-12-20,공항철도,인천공항1터미널,10988,10190,21178
2022-12-20,공항철도,인천공항2터미널,4117,3695,7812
2022-12-20,공항철도,청라국제도시,7599,7077,14676
2022-12-20,공항철도,홍대입구,12162,12144,24306
2022-12-20,과천선,경마공원,1526,1531,3057
2022-12-20,과천선,과천,6984,6624,13608
2022-12-20,과천선,대공원,3003,3065,6068
2022-12-20,과천선,범계,28512,28296,56808
2022-12-20,과천선,선바위,8824,7662,16486
2022-12-20,과천선,인덕원,26252,27226,53478
2022-12-20,과천선,정부과천청사,12523,12483,25006
2022-12-20,과천선,평촌,19674,19332,39006
2022-12-20,분당선,가천대,7750,8176,15926
2022-12-20,분당선,강남구청,10884,12367,23251
2022-12-20,분당선,개포동,4380,4489,8869
2022-12-20,분당선,구룡,2541,2336,4877
2022-12-20,분당선,구성,5382,5750,11132
2022-12-20,분당선,기흥,11132,10466,21598
2022-12-20,분당선,대모산입구,5326,4878,10204
2022-12-20,분당선,도곡,8438,8298,16736
2022-12-20,분당선,망포,16702,15935,32637
2022-12-20,분당선,매교,5006,4904,9910
2022-12-20,분당선,매탄권선,5831,5645,11476
2022-12-20,분당선,모란,20541,20978,41519
2022-12-20,분당선,미금,16905,17924,34829
2022-12-20,분당선,보정,2994,2691,5685
2022-12-20,분당선,복정,1,0,1
2022-12-20,분당선,상갈,5979,5778,11757
2022-12-20,분당선,서울숲,12902,13460,26362
2022-12-20,분당선,서현,27634,27976,55610
2022-12-20,분당선,선릉,15550,23422,38972
2022-12-20,분당선,선정릉,8788,9303,18091
2022-12-20,분당선,수내,15938,15873,31811
2022-12-20,분당선,수서,14869,15435,30304
2022-12-20,분당선,수원,8435,7091,15526
2022-12-20,분당선,수원시청,14002,15009,29011
2022-12-20,분당선,신갈,5406,5301,10707
2022-12-20,분당선,압구정로데오,21779,23943,45722
2022-12-20,분당선,야탑,28499,30163,58662
2022-12-20,분당선,영통,9549,9685,19234
2022-12-20,분당선,오리,12657,10407,23064
2022-12-20,분당선,이매,6162,5816,11978
2022-12-20,분당선,정자,21353,22513,43866
2022-12-20,분당선,죽전,14942,16312,31254
2022-12-20,분당선,청명,4787,4692,9479
2022-12-20,분당선,태평,14275,13714,27989
2022-12-20,분당선,한티,15755,16890,32645
2022-12-20,수인선,고색,5300,4877,10177
2022-12-20,수인선,남동인더스파크,2340,2696,5036
2022-12-20,수인선,달월,110,76,186
2022-12-20,수인선,사리,5302,4535,9837
2022-12-20,수인선,소래포구,4882,4646,9528
2022-12-20,수인선,송도,2560,2307,4867
2022-12-20,수인선,숭의,4299,4098,8397
2022-12-20,수인선,신포,1849,1916,3765
2022-12-20,수인선,야목,369,298,667
2022-12-20,수인선,어천,1118,1048,2166
2022-12-20,수인선,연수,4832,4708,9540
2022-12-20,수인선,오목천,3532,3291,6823
2022-12-20,수인선,원인재,4618,4824,9442
2022-12-20,수인선,월곶,2814,2576,5390
2022-12-20,수인선,인천,950,1545,2495
2022-12-20,수인선,인천논현,5975,6237,12212
2022-12-20,수인선,인하대,6312,6013,12325
2022-12-20,수인선,호구포,4441,4510,8951
2022-12-20,신림선,관악산,2339,2219,4558
2022-12-20,신림선,당곡,4597,4566,9163
2022-12-20,신림선,대방,2784,2177,4961
2022-12-20,신림선,보라매,3835,3491,7326
2022-12-20,신림선,보라매공원,1974,2327,4301
2022-12-20,신림선,보라매병원,8212,8537,16749
2022-12-20,신림선,샛강,2885,3463,6348
2022-12-20,신림선,서울대벤처타운,8291,8236,16527
2022-12-20,신림선,서울지방병무청,2821,3125,5946
2022-12-20,신림선,서원,3511,2975,6486
2022-12-20,신림선,신림,1774,2370,4144
2022-12-20,안산선,고잔,9612,9040,18652
2022-12-20,안산선,대야미,5185,4737,9922
2022-12-20,안산선,반월,4465,4331,8796
2022-12-20,안산선,산본,17178,18576,35754
2022-12-20,안산선,상록수,16349,16499,32848
2022-12-20,안산선,수리산,4430,3610,8040
2022-12-20,안산선,신길온천,1835,1683,3518
2022-12-20,안산선,안산,11778,10616,22394
2022-12-20,안산선,오이도,8320,8206,16526
2022-12-20,안산선,정왕,8726,8016,16742
2022-12-20,안산선,중앙,19045,19885,38930
2022-12-20,안산선,초지,5174,5073,10247
2022-12-20,안산선,한대앞,10241,10357,20598
2022-12-20,우이신설선,4.19민주묘지,3270,3089,6359
2022-12-20,우이신설선,가오리,4468,4526,8994
2022-12-20,우이신설선,보문,1718,1674,3392
2022-12-20,우이신설선,북한산보국문,6689,6451,13140
2022-12-20,우이신설선,북한산우이,2956,2603,5559
2022-12-20,우이신설선,삼양,2138,2245,4383
2022-12-20,우이신설선,삼양사거리,2644,2726,5370
2022-12-20,우이신설선,성신여대입구,3717,4121,7838
2022-12-20,우이신설선,솔밭공원,2778,2629,5407
2022-12-20,우이신설선,솔샘,6368,5995,12363
2022-12-20,우이신설선,신설동,2504,2406,4910
2022-12-20,우이신설선,정릉,4957,4786,9743
2022-12-20,우이신설선,화계,3757,3443,7200
2022-12-20,일산선,대곡,2193,1669,3862
2022-12-20,일산선,대화,13972,10812,24784
2022-12-20,일산선,마두,8246,8546,16792
2022-12-20,일산선,백석,10719,10762,21481
2022-12-20,일산선,삼송,21238,20632,41870
2022-12-20,일산선,원당,11868,11212,23080
2022-12-20,일산선,원흥,12237,11501,23738
2022-12-20,일산선,정발산,7354,7437,14791
2022-12-20,일산선,주엽,10103,10112,20215
2022-12-20,일산선,지축,2,0,2
2022-12-20,일산선,화정,17802,18134,35936
2022-12-20,장항선,배방,1169,1157,2326
2022-12-20,장항선,봉명,1436,1440,2876
2022-12-20,장항선,신창,1177,1234,2411
2022-12-20,장항선,쌍용,2800,2675,5475
2022-12-20,장항선,아산,3543,3113,6656
2022-12-20,장항선,온양온천,4436,4436,8872
2022-12-20,장항선,탕정,1204,1110,2314
2022-12-20,중앙선,구리,14440,14530,28970
2022-12-20,중앙선,국수,804,759,1563
2022-12-20,중앙선,덕소,5795,5770,11565
2022-12-20,중앙선,도농,12286,11185,23471
2022-12-20,중앙선,도심,2577,2058,4635
2022-12-20,중앙선,망우,8022,7944,15966
2022-12-20,중앙선,상봉,6179,6108,12287
2022-12-20,중앙선,신원,179,161,340
2022-12-20,중앙선,아신,521,530,1051
2022-12-20,중앙선,양수,1784,1847,3631
2022-12-20,중앙선,양원,3330,3208,6538
2022-12-20,중앙선,양정,648,525,1173
2022-12-20,중앙선,양평,2879,2896,5775
2022-12-20,중앙선,오빈,322,305,627
2022-12-20,중앙선,용문,2487,2543,5030
2022-12-20,중앙선,운길산,591,538,1129
2022-12-20,중앙선,원덕,366,307,673
2022-12-20,중앙선,중랑,5976,5686,11662
2022-12-20,중앙선,지평,58,53,111
2022-12-20,중앙선,팔당,872,864,1736
2022-12-20,중앙선,회기,28185,27167,55352
2022-12-21,1호선,동대문,11664,10879,22543
2022-12-21,1호선,동묘앞,7371,7748,15119
2022-12-21,1호선,서울역,56474,53942,110416
2022-12-21,1호선,시청,30241,30181,60422
2022-12-21,1호선,신설동,15271,14693,29964
2022-12-21,1호선,제기동,16252,16400,32652
2022-12-21,1호선,종각,45163,44203,89366
2022-12-21,1호선,종로3가,27905,25176,53081
2022-12-21,1호선,종로5가,25841,25476,51317
2022-12-21,1호선,청량리,20294,20156,40450
2022-12-21,2호선,강남,91154,87972,179126
2022-12-21,2호선,강변,33846,31277,65123
2022-12-21,2호선,건대입구,39307,41689,80996
2022-12-21,2호선,교대,40645,46360,87005
2022-12-21,2호선,구로디지털단지,66512,66264,132776
2022-12-21,2호선,구의,27358,26760,54118
2022-12-21,2호선,낙성대,30551,29277,59828
2022-12-21,2호선,당산,20127,24075,44202
2022-12-21,2호선,대림,25517,26246,51763
2022-12-21,2호선,도림천,1556,1726,3282
2022-12-21,2호선,동대문역사문화공원,14647,16638,31285
2022-12-21,2호선,뚝섬,26168,27952,54120
2022-12-21,2호선,문래,25389,25831,51220
2022-12-21,2호선,방배,18606,19270,37876
2022-12-21,2호선,봉천,26116,24519,50635
2022-12-21,2호선,사당,43891,47969,91860
2022-12-21,2호선,삼성,67930,68818,136748
2022-12-21,2호선,상왕십리,16859,16167,33026
2022-12-21,2호선,서울대입구,50319,49628,99947
2022-12-21,2호선,서초,25440,25164,50604
2022-12-21,2호선,선릉,66594,58992,125586
2022-12-21,2호선,성수,47143,51025,98168
2022-12-21,2호선,시청,30218,29368,59586
2022-12-21,2호선,신답,2002,2207,4209
2022-12-21,2호선,신당,16310,16910,33220
2022-12-21,2호선,신대방,26979,25984,52963
2022-12-21,2호선,신도림,55380,55110,110490
2022-12-21,2호선,신림,62173,59984,122157
2022-12-21,2호선,신설동,3870,3974,7844
2022-12-21,2호선,신정네거리,12198,12450,24648
2022-12-21,2호선,신촌,41058,42214,83272
2022-12-21,2호선,아현,11998,11340,23338
2022-12-21,2호선,양천구청,8167,8403,16570
2022-12-21,2호선,역삼,62347,71034,133381
2022-12-21,2호선,영등포구청,25233,25955,51188
2022-12-21,2호선,왕십리,19581,16919,36500
2022-12-21,2호선,용답,3275,3291,6566
2022-12-21,2호선,용두,2646,2711,5357
2022-12-21,2호선,을지로3가,28448,28977,57425
2022-12-21,2호선,을지로4가,16008,16583,32591
2022-12-21,2호선,을지로입구,54856,56626,111482
2022-12-21,2호선,이대,16361,17546,33907
2022-12-21,2호선,잠실,91160,92312,183472
2022-12-21,2호선,잠실나루,17537,17153,34690
2022-12-21,2호선,잠실새내,26478,25903,52381
2022-12-21,2호선,종합운동장,9785,10066,19851
2022-12-21,2호선,충정로,11698,12467,24165
2022-12-21,2호선,한양대,11799,13385,25184
2022-12-21,2호선,합정,34934,37649,72583
2022-12-21,2호선,홍대입구,68543,72697,141240
2022-12-21,3호선,가락시장,10804,10445,21249
2022-12-21,3호선,경복궁,26675,27013,53688
2022-12-21,3호선,경찰병원,9076,9240,18316
2022-12-21,3호선,고속터미널,47784,45093,92877
2022-12-21,3호선,교대,18319,11375,29694
2022-12-21,3호선,구파발,23444,22937,46381
2022-12-21,3호선,금호,9311,8517,17828
2022-12-21,3호선,남부터미널,34218,35072,69290
2022-12-21,3호선,녹번,17623,15877,33500
2022-12-21,3호선,대청,12104,11524,23628
2022-12-21,3호선,대치,12809,12775,25584
2022-12-21,3호선,도곡,6581,6598,13179
2022-12-21,3호선,독립문,8044,8127,16171
2022-12-21,3호선,동대입구,8802,9571,18373
2022-12-21,3호선,매봉,15221,14771,29992
2022-12-21,3호선,무악재,4768,5112,9880
2022-12-21,3호선,불광,17234,18651,35885
2022-12-21,3호선,수서,20584,21030,41614
2022-12-21,3호선,신사,33310,34539,67849
2022-12-21,3호선,안국,28241,29486,57727
2022-12-21,3호선,압구정,37876,41299,79175
2022-12-21,3호선,약수,14953,14485,29438
2022-12-21,3호선,양재,44309,47994,92303
2022-12-21,3호선,연신내,38158,36242,74400
2022-12-21,3호선,오금,7259,6604,13863
2022-12-21,3호선,옥수,10436,10592,21028
2022-12-21,3호선,을지로3가,13169,13475,26644
2022-12-21,3호선,일원,13588,13218,26806
2022-12-21,3호선,잠원,5927,5546,11473
2022-12-21,3호선,종로3가,11510,13221,24731
2022-12-21,3호선,지축,6945,6761,13706
2022-12-21,3호선,충무로,1,0,1
2022-12-21,3호선,학여울,2107,2218,4325
2022-12-21,3호선,홍제,19714,18850,38564
2022-12-21,4호선,길음,24399,24245,48644
2022-12-21,4호선,남태령,1429,1344,2773
2022-12-21,4호선,노원,20699,23568,44267
2022-12-21,4호선,당고개,10070,8841,18911
2022-12-21,4호선,동대문,20183,21160,41343
2022-12-21,4호선,동대문역사문화공원,18443,16579,35022
2022-12-21,4호선,동작,1237,1531,2768
2022-12-21,4호선,명동,30342,32555,62897
2022-12-21,4호선,미아,16320,15913,32233
2022-12-21,4호선,미아사거리,29943,28902,58845
2022-12-21,4호선,사당,29115,25439,54554
2022-12-21,4호선,삼각지,6888,7658,14546
2022-12-21,4호선,상계,21663,20020,41683
2022-12-21,4호선,서울역,14298,22923,37221
2022-12-21,4호선,성신여대입구,23759,22811,46570
2022-12-21,4호선,수유,38146,38219,76365
2022-12-21,4호선,숙대입구,15549,15097,30646
2022-12-21,4호선,신용산,21788,22587,44375
2022-12-21,4호선,쌍문,32548,30241,62789
2022-12-21,4호선,이촌,11500,12172,23672
2022-12-21,4호선,창동,27804,29410,57214
2022-12-21,4호선,총신대입구,20860,22946,43806
2022-12-21,4호선,충무로,31475,32446,63921
2022-12-21,4호선,한성대입구,15157,14103,29260
2022-12-21,4호선,혜화,42536,43410,85946
2022-12-21,4호선,회현,28127,29873,58000
2022-12-21,5호선,강동,21465,20860,42325
2022-12-21,5호선,강일,6168,5504,11672
2022-12-21,5호선,개롱,7581,7738,15319
2022-12-21,5호선,개화산,6378,6080,12458
2022-12-21,5호선,거여,12218,11432,23650
2022-12-21,5호선,고덕,11553,11250,22803
2022-12-21,5호선,공덕,17443,18505,35948
2022-12-21,5호선,광나루,15763,14326,30089
2022-12-21,5호선,광화문,40531,42858,83389
2022-12-21,5호선,군자,13228,14657,27885
2022-12-21,5호선,굽은다리,11200,10842,22042
2022-12-21,5호선,길동,9110,9419,18529
2022-12-21,5호선,김포공항,8476,8507,16983
2022-12-21,5호선,까치산,32214,30309,62523
2022-12-21,5호선,답십리,18589,16992,35581
2022-12-21,5호선,동대문역사문화공원,3747,4318,8065
2022-12-21,5호선,둔촌동,10040,10352,20392
2022-12-21,5호선,마곡,13134,13110,26244
2022-12-21,5호선,마장,7088,6510,13598
2022-12-21,5호선,마천,8623,8041,16664
2022-12-21,5호선,마포,18225,18628,36853
2022-12-21,5호선,명일,10403,10745,21148
2022-12-21,5호선,목동,19028,20635,39663
2022-12-21,5호선,미사,20399,19992,40391
2022-12-21,5호선,발산,25442,26353,51795
2022-12-21,5호선,방이,8561,8687,17248
2022-12-21,5호선,방화,7810,7496,15306
2022-12-21,5호선,상일동,17781,16393,34174
2022-12-21,5호선,서대문,23417,24398,47815
2022-12-21,5호선,송정,7090,6629,13719
2022-12-21,5호선,신금호,7509,7732,15241
2022-12-21,5호선,신길,4955,5440,10395
2022-12-21,5호선,신정,15714,12794,28508
2022-12-21,5호선,아차산,16202,15641,31843
2022-12-21,5호선,애오개,8271,8014,16285
2022-12-21,5호선,양평,8662,8599,17261
2022-12-21,5호선,여의나루,12872,16776,29648
2022-12-21,5호선,여의도,37423,38927,76350
2022-12-21,5호선,영등포구청,4718,4713,9431
2022-12-21,5호선,영등포시장,12167,12425,24592
2022-12-21,5호선,오금,4341,4514,8855
2022-12-21,5호선,오목교,25358,27028,52386
2022-12-21,5호선,올림픽공원,5210,4306,9516
2022-12-21,5호선,왕십리,5453,6301,11754
2022-12-21,5호선,우장산,17423,16918,34341
2022-12-21,5호선,을지로4가,7227,7330,14557
2022-12-21,5호선,장한평,22290,22368,44658
2022-12-21,5호선,종로3가,15773,15304,31077
2022-12-21,5호선,천호,20386,20214,40600
2022-12-21,5호선,청구,4532,4206,8738
2022-12-21,5호선,충정로,5486,5549,11035
2022-12-21,5호선,하남검단산,7586,7204,14790
2022-12-21,5호선,하남시청,8566,8199,16765
2022-12-21,5호선,하남풍산,5127,5163,10290
2022-12-21,5호선,행당,9998,8659,18657
2022-12-21,5호선,화곡,32358,30217,62575
2022-12-21,6호선,고려대,10203,10048,20251
2022-12-21,6호선,공덕,22150,21170,43320
2022-12-21,6호선,광흥창,10668,10500,21168
2022-12-21,6호선,구산,8701,6542,15243
2022-12-21,6호선,녹사평,5499,5522,11021
2022-12-21,6호선,대흥,10304,10580,20884
2022-12-21,6호선,독바위,3070,3124,6194
2022-12-21,6호선,돌곶이,11443,10428,21871
2022-12-21,6호선,동묘앞,8362,8685,17047
2022-12-21,6호선,디지털미디어시티,16804,18995,35799
2022-12-21,6호선,마포구청,16261,14505,30766
2022-12-21,6호선,망원,15704,16596,32300
2022-12-21,6호선,버티고개,2591,2496,5087
2022-12-21,6호선,보문,9099,8100,17199
2022-12-21,6호선,봉화산,10344,9725,20069
2022-12-21,6호선,불광,4840,4724,9564
2022-12-21,6호선,삼각지,8535,7746,16281
2022-12-21,6호선,상수,10473,11756,22229
2022-12-21,6호선,상월곡,7160,6435,13595
2022-12-21,6호선,새절,14761,13661,28422
2022-12-21,6호선,석계,14322,14616,28938
2022-12-21,6호선,신당,10546,10699,21245
2022-12-21,6호선,안암,15296,15481,30777
2022-12-21,6호선,약수,4102,4128,8230
2022-12-21,6호선,역촌,4383,4968,9351
2022-12-21,6호선,월곡,13409,13295,26704
2022-12-21,6호선,월드컵경기장,4326,4724,9050
2022-12-21,6호선,응암,19530,19325,38855
2022-12-21,6호선,이태원,10331,10609,20940
2022-12-21,6호선,증산,11145,11034,22179
2022-12-21,6호선,창신,4207,3339,7546
2022-12-21,6호선,청구,4252,4317,8569
2022-12-21,6호선,태릉입구,6462,7294,13756
2022-12-21,6호선,한강진,10576,11934,22510
2022-12-21,6호선,합정,15100,15101,30201
2022-12-21,6호선,화랑대,14430,10763,25193
2022-12-21,6호선,효창공원앞,8253,7466,15719
2022-12-21,7호선,가산디지털단지,50710,51467,102177
2022-12-21,7호선,강남구청,19241,21324,40565
2022-12-21,7호선,건대입구,15029,15893,30922
2022-12-21,7호선,고속터미널,18026,15025,33051
2022-12-21,7호선,공릉,13714,13422,27136
2022-12-21,7호선,광명사거리,23420,23038,46458
2022-12-21,7호선,군자,17358,13673,31031
2022-12-21,7호선,남구로,17250,18365,35615
2022-12-21,7호선,남성,12755,11632,24387
2022-12-21,7호선,내방,17170,17527,34697
2022-12-21,7호선,노원,22829,24134,46963
2022-12-21,7호선,논현,20815,21439,42254
2022-12-21,7호선,대림,8844,8862,17706
2022-12-21,7호선,도봉산,9440,11016,20456
2022-12-21,7호선,뚝섬유원지,8311,7821,16132
2022-12-21,7호선,마들,15185,14133,29318
2022-12-21,7호선,먹골,11833,11662,23495
2022-12-21,7호선,면목,17478,17043,34521
2022-12-21,7호선,반포,7124,6888,14012
2022-12-21,7호선,보라매,8266,8374,16640
2022-12-21,7호선,사가정,17859,17828,35687
2022-12-21,7호선,상도,13814,13395,27209
2022-12-21,7호선,상봉,19221,18451,37672
2022-12-21,7호선,수락산,14447,14342,28789
2022-12-21,7호선,숭실대입구,14019,14039,28058
2022-12-21,7호선,신대방삼거리,16732,15697,32429
2022-12-21,7호선,신풍,13071,12178,25249
2022-12-21,7호선,어린이대공원,16874,16928,33802
2022-12-21,7호선,온수,11330,10368,21698
2022-12-21,7호선,용마산,6616,6245,12861
2022-12-21,7호선,이수,18372,17639,36011
2022-12-21,7호선,장승배기,10044,9901,19945
2022-12-21,7호선,장암,2627,965,3592
2022-12-21,7호선,중계,16567,15073,31640
2022-12-21,7호선,중곡,12787,12043,24830
2022-12-21,7호선,중화,12334,12207,24541
2022-12-21,7호선,천왕,13114,12395,25509
2022-12-21,7호선,철산,24193,24554,48747
2022-12-21,7호선,청담,22386,25395,47781
2022-12-21,7호선,태릉입구,10456,10071,20527
2022-12-21,7호선,하계,21810,20604,42414
2022-12-21,7호선,학동,27704,29482,57186
2022-12-21,8호선,가락시장,9495,10568,20063
2022-12-21,8호선,강동구청,12772,13051,25823
2022-12-21,8호선,남위례,7606,7671,15277
2022-12-21,8호선,남한산성입구,14883,13335,28218
2022-12-21,8호선,단대오거리,12468,12421,24889
2022-12-21,8호선,모란,4921,3794,8715
2022-12-21,8호선,몽촌토성,7558,7729,15287
2022-12-21,8호선,문정,25869,27538,53407
2022-12-21,8호선,복정,10531,8754,19285
2022-12-21,8호선,산성,6085,5909,11994
2022-12-21,8호선,석촌,9114,10257,19371
2022-12-21,8호선,송파,11389,10781,22170
2022-12-21,8호선,수진,6149,5736,11885
2022-12-21,8호선,신흥,5629,5977,11606
2022-12-21,8호선,암사,21982,19345,41327
2022-12-21,8호선,잠실,19172,23010,42182
2022-12-21,8호선,장지,21359,20309,41668
2022-12-21,8호선,천호,16658,19333,35991
2022-12-21,9호선,가양,24355,23969,48324
2022-12-21,9호선,개화,3573,2006,5579
2022-12-21,9호선,고속터미널,14838,18937,33775
2022-12-21,9호선,공항시장,3320,3573,6893
2022-12-21,9호선,구반포,1364,1325,2689
2022-12-21,9호선,국회의사당,20184,21683,41867
2022-12-21,9호선,김포공항,8419,12367,20786
2022-12-21,9호선,노들,5412,4488,9900
2022-12-21,9호선,노량진,29824,28333,58157
2022-12-21,9호선,당산,22066,21962,44028
2022-12-21,9호선,동작,1801,1488,3289
2022-12-21,9호선,등촌,13812,12879,26691
2022-12-21,9호선,마곡나루,15166,14854,30020
2022-12-21,9호선,사평,5059,4745,9804
2022-12-21,9호선,샛강,7588,7849,15437
2022-12-21,9호선,선유도,10539,10155,20694
2022-12-21,9호선,신논현,34691,33607,68298
2022-12-21,9호선,신목동,5178,4467,9645
2022-12-21,9호선,신반포,4383,4238,8621
2022-12-21,9호선,신방화,7994,7781,15775
2022-12-21,9호선,양천향교,11304,11686,22990
2022-12-21,9호선,여의도,37086,35266,72352
2022-12-21,9호선,염창,20223,19502,39725
2022-12-21,9호선,증미,8558,8119,16677
2022-12-21,9호선,흑석,11055,11059,22114
2022-12-21,9호선2~3단계,둔촌오륜,1354,1355,2709
2022-12-21,9호선2~3단계,봉은사,23026,24227,47253
2022-12-21,9호선2~3단계,삼성중앙,8967,9433,18400
2022-12-21,9호선2~3단계,삼전,8443,7945,16388
2022-12-21,9호선2~3단계,석촌,9845,8969,18814
2022-12-21,9호선2~3단계,석촌고분,7842,7548,15390
2022-12-21,9호선2~3단계,선정릉,11393,12480,23873
2022-12-21,9호선2~3단계,송파나루,6385,6749,13134
2022-12-21,9호선2~3단계,언주,12945,13590,26535
2022-12-21,9호선2~3단계,올림픽공원,7320,7489,14809
2022-12-21,9호선2~3단계,종합운동장,5309,5254,10563
2022-12-21,9호선2~3단계,중앙보훈병원,13088,11814,24902
2022-12-21,9호선2~3단계,한성백제,3270,2852,6122
2022-12-21,경강선,경기광주,10314,9058,19372
2022-12-21,경강선,곤지암,2876,2724,5600
2022-12-21,경강선,부발,2626,2456,5082
2022-12-21,경강선,삼동,3283,2854,6137
2022-12-21,경강선,세종대왕릉,376,358,734
2022-12-21,경강선,신둔도예촌,1749,1599,3348
2022-12-21,경강선,여주,2380,2361,4741
2022-12-21,경강선,이매,1476,1220,2696
2022-12-21,경강선,이천,3092,3168,6260
2022-12-21,경강선,초월,4233,3823,8056
2022-12-21,경강선,판교,6637,6869,13506
2022-12-21,경부선,가산디지털단지,19725,23048,42773
2022-12-21,경부선,관악,7997,7668,15665
2022-12-21,경부선,광명,3995,3370,7365
2022-12-21,경부선,구로,20099,20724,40823
2022-12-21,경부선,군포,8627,8443,17070
2022-12-21,경부선,금정,30656,31430,62086
2022-12-21,경부선,금천구청,12505,12542,25047
2022-12-21,경부선,남영,10371,11060,21431
2022-12-21,경부선,노량진,9601,10206,19807
2022-12-21,경부선,당정,7388,6972,14360
2022-12-21,경부선,대방,12415,13672,26087
2022-12-21,경부선,독산,20511,21139,41650
2022-12-21,경부선,두정,7412,7727,15139
2022-12-21,경부선,명학,10140,10074,20214
2022-12-21,경부선,병점,15199,15271,30470
2022-12-21,경부선,서동탄,1539,1350,2889
2022-12-21,경부선,서울역,9517,2825,12342
2022-12-21,경부선,서정리,8093,7403,15496
2022-12-21,경부선,석수,10037,9104,19141
2022-12-21,경부선,성균관대,16129,15731,31860
2022-12-21,경부선,성환,3598,3633,7231
2022-12-21,경부선,세류,3493,3112,6605
2022-12-21,경부선,세마,3180,2904,6084
2022-12-21,경부선,송탄,4579,4588,9167
2022-12-21,경부선,수원,37094,39850,76944
2022-12-21,경부선,신길,9887,8302,18189
2022-12-21,경부선,신도림,4196,4483,8679
2022-12-21,경부선,안양,24666,24393,49059
2022-12-21,경부선,영등포,43448,44937,88385
2022-12-21,경부선,오산,10110,10403,20513
2022-12-21,경부선,오산대,3670,3480,7150
2022-12-21,경부선,용산,43703,43785,87488
2022-12-21,경부선,의왕,10009,10065,20074
2022-12-21,경부선,직산,899,920,1819
2022-12-21,경부선,진위,2032,1746,3778
2022-12-21,경부선,천안,6208,5468,11676
2022-12-21,경부선,평택,12079,11989,24068
2022-12-21,경부선,평택지제,4650,4538,9188
2022-12-21,경부선,화서,9129,8800,17929
2022-12-21,경원선,가능,7190,6975,14165
2022-12-21,경원선,광운대,8374,8055,16429
2022-12-21,경원선,녹양,5225,4843,10068
2022-12-21,경원선,녹천,4998,4136,9134
2022-12-21,경원선,덕계,3650,3189,6839
2022-12-21,경원선,덕정,6272,5928,12200
2022-12-21,경원선,도봉,6568,6278,12846
2022-12-21,경원선,도봉산,7050,4382,11432
2022-12-21,경원선,동두천,2358,2541,4899
2022-12-21,경원선,동두천중앙,3224,3158,6382
2022-12-21,경원선,망월사,10269,10103,20372
2022-12-21,경원선,방학,10630,10426,21056
2022-12-21,경원선,보산,1672,1548,3220
2022-12-21,경원선,서빙고,2339,2183,4522
2022-12-21,경원선,석계,8453,9685,18138
2022-12-21,경원선,소요산,2023,1568,3591
2022-12-21,경원선,신이문,9197,8463,17660
2022-12-21,경원선,양주,8331,7921,16252
2022-12-21,경원선,옥수,63,50,113
2022-12-21,경원선,왕십리,18043,19241,37284
2022-12-21,경원선,외대앞,11176,10939,22115
2022-12-21,경원선,월계,7474,7075,14549
2022-12-21,경원선,응봉,2154,1701,3855
2022-12-21,경원선,의정부,20397,20976,41373
2022-12-21,경원선,이촌,4582,3500,8082
2022-12-21,경원선,지행,7666,7335,15001
2022-12-21,경원선,창동,1,0,1
2022-12-21,경원선,청량리,17025,17288,34313
2022-12-21,경원선,한남,4587,4359,8946
2022-12-21,경원선,회룡,13813,13367,27180
2022-12-21,경의선,가좌,6470,5932,12402
2022-12-21,경의선,강매,3680,3202,6882
2022-12-21,경의선,계양,1,0,1
2022-12-21,경의선,곡산,627,658,1285
2022-12-21,경의선,공덕,4684,3826,8510
2022-12-21,경의선,금릉,6121,5915,12036
2022-12-21,경의선,금촌,7498,7324,14822
2022-12-21,경의선,능곡,4255,3816,8071
2022-12-21,경의선,디지털미디어시티,3249,2894,6143
2022-12-21,경의선,문산,5926,5896,11822
2022-12-21,경의선,백마,8504,7821,16325
2022-12-21,경의선,서강대,2520,2497,5017
2022-12-21,경의선,서울역,4841,6470,11311
2022-12-21,경의선,수색,2932,3385,6317
2022-12-21,경의선,신촌,1036,1362,2398
2022-12-21,경의선,야당,9983,9759,19742
2022-12-21,경의선,운정,8423,7701,16124
2022-12-21,경의선,운천,12,5,17
2022-12-21,경의선,월롱,3297,2828,6125
2022-12-21,경의선,일산,10995,10438,21433
2022-12-21,경의선,임진강,6,4,10
2022-12-21,경의선,탄현,9564,8880,18444
2022-12-21,경의선,파주,1357,914,2271
2022-12-21,경의선,풍산,6572,6131,12703
2022-12-21,경의선,행신,9777,9479,19256
2022-12-21,경의선,홍대입구,2022,2579,4601
2022-12-21,경의선,화전,1907,1816,3723
2022-12-21,경의선,효창공원앞,3470,3923,7393
2022-12-21,경인선,간석,6497,6122,12619
2022-12-21,경인선,개봉,24139,23571,47710
2022-12-21,경인선,구일,6797,6634,13431
2022-12-21,경인선,도원,3460,3494,6954
2022-12-21,경인선,도화,4568,4041,8609
2022-12-21,경인선,동암,17163,17163,34326
2022-12-21,경인선,동인천,15312,14589,29901
2022-12-21,경인선,백운,7127,6915,14042
2022-12-21,경인선,부개,9313,8580,17893
2022-12-21,경인선,부천,33143,33578,66721
2022-12-21,경인선,부평,30859,33098,63957
2022-12-21,경인선,소사,8593,8468,17061
2022-12-21,경인선,송내,29656,29487,59143
2022-12-21,경인선,역곡,28911,28673,57584
2022-12-21,경인선,오류동,12496,11686,24182
2022-12-21,경인선,온수,7202,6814,14016
2022-12-21,경인선,인천,3443,2640,6083
2022-12-21,경인선,제물포,11439,11193,22632
2022-12-21,경인선,주안,20156,18088,38244
2022-12-21,경인선,중동,10423,9601,20024
2022-12-21,경춘선,가평,1887,1992,3879
2022-12-21,경춘선,갈매,3580,2984,6564
2022-12-21,경춘선,강촌,605,601,1206
2022-12-21,경춘선,굴봉산,101,128,229
2022-12-21,경춘선,금곡,1657,1666,3323
2022-12-21,경춘선,김유정,361,370,731
2022-12-21,경춘선,남춘천,3097,2745,5842
2022-12-21,경춘선,대성리,557,587,1144
2022-12-21,경춘선,마석,4901,4353,9254
2022-12-21,경춘선,백양리,474,393,867
2022-12-21,경춘선,별내,3788,3505,7293
2022-12-21,경춘선,사릉,2659,2529,5188
2022-12-21,경춘선,상천,185,180,365
2022-12-21,경춘선,신내,2622,2529,5151
2022-12-21,경춘선,천마산,1737,1556,3293
2022-12-21,경춘선,청평,1703,1575,3278
2022-12-21,경춘선,춘천,1590,1303,2893
2022-12-21,경춘선,퇴계원,4126,3733,7859
2022-12-21,경춘선,평내호평,7528,7181,14709
2022-12-21,공항철도,검암,7136,7354,14490
2022-12-21,공항철도,계양,13602,12676,26278
2022-12-21,공항철도,공덕,3015,3979,6994
2022-12-21,공항철도,공항화물청사,2520,2832,5352
2022-12-21,공항철도,김포공항,11528,7333,18861
2022-12-21,공항철도,디지털미디어시티,16962,16031,32993
2022-12-21,공항철도,마곡나루,12325,12564,24889
2022-12-21,공항철도,서울역,11860,9929,21789
2022-12-21,공항철도,영종,4066,4062,8128
2022-12-21,공항철도,운서,9297,9299,18596
2022-12-21,공항철도,인천공항1터미널,11782,12375,24157
2022-12-21,공항철도,인천공항2터미널,4341,4305,8646
2022-12-21,공항철도,청라국제도시,8203,7721,15924
2022-12-21,공항철도,홍대입구,12726,12989,25715
2022-12-21,과천선,경마공원,1618,1728,3346
2022-12-21,과천선,과천,7715,7018,14733
2022-12-21,과천선,대공원,2342,2438,4780
2022-12-21,과천선,범계,30194,29817,60011
2022-12-21,과천선,선바위,8826,8037,16863
2022-12-21,과천선,인덕원,28261,29446,57707
2022-12-21,과천선,정부과천청사,13062,13272,26334
2022-12-21,과천선,평촌,20983,20586,41569
2022-12-21,분당선,가천대,7644,8504,16148
2022-12-21,분당선,강남구청,11683,13302,24985
2022-12-21,분당선,개포동,4923,4818,9741
2022-12-21,분당선,구룡,2642,2494,5136
2022-12-21,분당선,구성,6377,6287,12664
2022-12-21,분당선,기흥,12176,11129,23305
2022-12-21,분당선,대모산입구,5810,5181,10991
2022-12-21,분당선,도곡,9124,8815,17939
2022-12-21,분당선,망포,18591,17638,36229
2022-12-21,분당선,매교,5403,5147,10550
2022-12-21,분당선,매탄권선,6367,6148,12515
2022-12-21,분당선,모란,20998,21463,42461
2022-12-21,분당선,미금,18393,19638,38031
2022-12-21,분당선,보정,3469,2999,6468
2022-12-21,분당선,복정,3,0,3
2022-12-21,분당선,상갈,6519,6225,12744
2022-12-21,분당선,서울숲,13453,14068,27521
2022-12-21,분당선,서현,29373,29930,59303
2022-12-21,분당선,선릉,15841,24660,40501
2022-12-21,분당선,선정릉,9028,9594,18622
2022-12-21,분당선,수내,17376,17253,34629
2022-12-21,분당선,수서,16253,17266,33519
2022-12-21,분당선,수원,9148,7498,16646
2022-12-21,분당선,수원시청,15166,16175,31341
2022-12-21,분당선,신갈,6018,5683,11701
2022-12-21,분당선,압구정로데오,23318,25723,49041
2022-12-21,분당선,야탑,31429,33261,64690
2022-12-21,분당선,영통,10589,10509,21098
2022-12-21,분당선,오리,13501,11382,24883
2022-12-21,분당선,이매,6994,6525,13519
2022-12-21,분당선,정자,23450,24595,48045
2022-12-21,분당선,죽전,16091,17639,33730
2022-12-21,분당선,청명,5551,5224,10775
2022-12-21,분당선,태평,14926,14268,29194
2022-12-21,분당선,한티,17480,18486,35966
2022-12-21,수인선,고색,5767,5316,11083
2022-12-21,수인선,남동인더스파크,2671,3123,5794
2022-12-21,수인선,달월,112,76,188
2022-12-21,수인선,사리,5648,4789,10437
2022-12-21,수인선,소래포구,5257,4766,10023
2022-12-21,수인선,송도,2856,2631,5487
2022-12-21,수인선,숭의,4656,4411,9067
2022-12-21,수인선,신포,1987,2060,4047
2022-12-21,수인선,야목,378,300,678
2022-12-21,수인선,어천,1235,1210,2445
2022-12-21,수인선,연수,5338,5161,10499
2022-12-21,수인선,오목천,3759,3433,7192
2022-12-21,수인선,원인재,5021,5105,10126
2022-12-21,수인선,월곶,3146,2883,6029
2022-12-21,수인선,인천,979,1601,2580
2022-12-21,수인선,인천논현,6350,6623,12973
2022-12-21,수인선,인하대,6953,6425,13378
2022-12-21,수인선,호구포,4854,5224,10078
2022-12-21,신림선,관악산,2240,2263,4503
2022-12-21,신림선,당곡,4694,4604,9298
2022-12-21,신림선,대방,2843,2255,5098
2022-12-21,신림선,보라매,3959,3642,7601
2022-12-21,신림선,보라매공원,2280,2416,4696
2022-12-21,신림선,보라매병원,8696,9364,18060
2022-12-21,신림선,샛강,2955,3824,6779
2022-12-21,신림선,서울대벤처타운,8696,8238,16934
2022-12-21,신림선,서울지방병무청,3022,3233,6255
2022-12-21,신림선,서원,3693,3152,6845
2022-12-21,신림선,신림,1790,2485,4275
2022-12-21,안산선,고잔,9992,9555,19547
2022-12-21,안산선,대야미,5400,4750,10150
2022-12-21,안산선,반월,4691,4544,9235
2022-12-21,안산선,산본,17716,18914,36630
2022-12-21,안산선,상록수,16654,17133,33787
2022-12-21,안산선,수리산,4516,3642,8158
2022-12-21,안산선,신길온천,1961,1747,3708
2022-12-21,안산선,안산,12405,11310,23715
2022-12-21,안산선,오이도,8818,8604,17422
2022-12-21,안산선,정왕,8971,9434,18405
2022-12-21,안산선,중앙,20093,20667,40760
2022-12-21,안산선,초지,5387,5368,10755
2022-12-21,안산선,한대앞,10367,10366,20733
2022-12-21,우이신설선,4.19민주묘지,3130,2996,6126
2022-12-21,우이신설선,가오리,4686,4478,9164
2022-12-21,우이신설선,보문,1690,1734,3424
2022-12-21,우이신설선,북한산보국문,7381,6884,14265
2022-12-21,우이신설선,북한산우이,2846,2431,5277
2022-12-21,우이신설선,삼양,2120,2163,4283
2022-12-21,우이신설선,삼양사거리,2619,2636,5255
2022-12-21,우이신설선,성신여대입구,3866,4319,8185
2022-12-21,우이신설선,솔밭공원,2704,2524,5228
2022-12-21,우이신설선,솔샘,7043,6448,13491
2022-12-21,우이신설선,신설동,2334,2341,4675
2022-12-21,우이신설선,정릉,5442,5242,10684
2022-12-21,우이신설선,화계,3721,3477,7198
2022-12-21,일산선,대곡,2370,1698,4068
2022-12-21,일산선,대화,15473,11621,27094
2022-12-21,일산선,마두,8839,9250,18089
2022-12-21,일산선,백석,11553,11709,23262
2022-12-21,일산선,삼송,22664,21609,44273
2022-12-21,일산선,원당,12695,11752,24447
2022-12-21,일산선,원흥,13406,12539,25945
2022-12-21,일산선,정발산,7892,8134,16026
2022-12-21,일산선,주엽,10552,10335,20887
2022-12-21,일산선,화정,19641,19482,39123
2022-12-21,장항선,배방,1190,1099,2289
2022-12-21,장항선,봉명,1499,1506,3005
2022-12-21,장항선,신창,1171,1149,2320
2022-12-21,장항선,쌍용,2467,2224,4691
2022-12-21,장항선,아산,3554,3079,6633
2022-12-21,장항선,온양온천,3983,4016,7999
2022-12-21,장항선,탕정,1133,1036,2169
2022-12-21,중앙선,구리,15682,15474,31156
2022-12-21,중앙선,국수,776,753,1529
2022-12-21,중앙선,덕소,6271,6039,12310
2022-12-21,중앙선,도농,13387,11871,25258
2022-12-21,중앙선,도심,2918,2201,5119
2022-12-21,중앙선,망우,8399,8203,16602
2022-12-21,중앙선,상봉,6047,6160,12207
2022-12-21,중앙선,신원,163,178,341
2022-12-21,중앙선,아신,535,521,1056
2022-12-21,중앙선,양수,1945,1888,3833
2022-12-21,중앙선,양원,3411,3294,6705
2022-12-21,중앙선,양정,590,522,1112
2022-12-21,중앙선,양평,3033,3057,6090
2022-12-21,중앙선,오빈,291,283,574
2022-12-21,중앙선,용문,1718,1688,3406
2022-12-21,중앙선,운길산,644,612,1256
2022-12-21,중앙선,원덕,338,306,644
2022-12-21,중앙선,중랑,5955,5687,11642
2022-12-21,중앙선,지평,44,46,90
2022-12-21,중앙선,팔당,856,875,1731
2022-12-21,중앙선,회기,30907,30510,61417
2022-12-22,1호선,동대문,11589,10795,22384
2022-12-22,1호선,동묘앞,7712,7977,15689
2022-12-22,1호선,서울역,57310,54458,111768
2022-12-22,1호선,시청,29419,29273,58692
2022-12-22,1호선,신설동,14424,14132,28556
2022-12-22,1호선,제기동,16593,16945,33538
2022-12-22,1호선,종각,46987,45240,92227
2022-12-22,1호선,종로3가,27140,25098,52238
2022-12-22,1호선,종로5가,26249,25505,51754
2022-12-22,1호선,청량리,20360,19968,40328
2022-12-22,2호선,강남,92812,90005,182817
2022-12-22,2호선,강변,33038,30771,63809
2022-12-22,2호선,건대입구,40576,42839,83415
2022-12-22,2호선,교대,39034,44393,83427
2022-12-22,2호선,구로디지털단지,64899,64275,129174
2022-12-22,2호선,구의,26786,26509,53295
2022-12-22,2호선,낙성대,30309,29228,59537
2022-12-22,2호선,당산,19450,23088,42538
2022-12-22,2호선,대림,25232,25336,50568
2022-12-22,2호선,도림천,1557,1723,3280
2022-12-22,2호선,동대문역사문화공원,14661,16969,31630
2022-12-22,2호선,뚝섬,25420,27289,52709
2022-12-22,2호선,문래,24168,24935,49103
2022-12-22,2호선,방배,18192,19190,37382
2022-12-22,2호선,봉천,25944,24426,50370
2022-12-22,2호선,사당,47416,48218,95634
2022-12-22,2호선,삼성,75630,73791,149421
2022-12-22,2호선,상왕십리,16249,15472,31721
2022-12-22,2호선,서울대입구,50888,49556,100444
2022-12-22,2호선,서초,25524,24608,50132
2022-12-22,2호선,선릉,65956,58637,124593
2022-12-22,2호선,성수,45726,49908,95634
2022-12-22,2호선,시청,30370,27976,58346
2022-12-22,2호선,신답,1886,2104,3990
2022-12-22,2호선,신당,15694,16549,32243
2022-12-22,2호선,신대방,26365,25840,52205
2022-12-22,2호선,신도림,54671,53661,108332
2022-12-22,2호선,신림,61663,59182,120845
2022-12-22,2호선,신설동,4051,3891,7942
2022-12-22,2호선,신정네거리,11167,11524,22691
2022-12-22,2호선,신촌,40962,41917,82879
2022-12-22,2호선,아현,11599,11123,22722
2022-12-22,2호선,양천구청,7484,7846,15330
2022-12-22,2호선,역삼,61480,67727,129207
2022-12-22,2호선,영등포구청,24264,24851,49115
2022-12-22,2호선,왕십리,18841,16538,35379
2022-12-22,2호선,용답,3097,3031,6128
2022-12-22,2호선,용두,2556,2587,5143
2022-12-22,2호선,을지로3가,27802,28365,56167
2022-12-22,2호선,을지로4가,15675,15967,31642
2022-12-22,2호선,을지로입구,55141,56519,111660
2022-12-22,2호선,이대,15867,16498,32365
2022-12-22,2호선,잠실,92683,92661,185344
2022-12-22,2호선,잠실나루,16473,16092,32565
2022-12-22,2호선,잠실새내,25285,25234,50519
2022-12-22,2호선,종합운동장,8838,9436,18274
2022-12-22,2호선,충정로,11408,11972,23380
2022-12-22,2호선,한양대,8973,9657,18630
2022-12-22,2호선,합정,35878,38982,74860
2022-12-22,2호선,홍대입구,71942,76454,148396
2022-12-22,3호선,가락시장,10292,10365,20657
2022-12-22,3호선,경복궁,24803,24970,49773
2022-12-22,3호선,경찰병원,8473,8484,16957
2022-12-22,3호선,고속터미널,50583,47894,98477
2022-12-22,3호선,교대,17158,10931,28089
2022-12-22,3호선,구파발,23471,22663,46134
2022-12-22,3호선,금호,8614,8045,16659
2022-12-22,3호선,남부터미널,33103,33604,66707
2022-12-22,3호선,녹번,17195,15374,32569
2022-12-22,3호선,대청,11385,10871,22256
2022-12-22,3호선,대치,12318,12440,24758
2022-12-22,3호선,도곡,5863,5991,11854
2022-12-22,3호선,독립문,7372,7703,15075
2022-12-22,3호선,동대입구,8515,9490,18005
2022-12-22,3호선,매봉,14408,13848,28256
2022-12-22,3호선,무악재,4566,4565,9131
2022-12-22,3호선,불광,16933,17920,34853
2022-12-22,3호선,수서,19953,20310,40263
2022-12-22,3호선,신사,33737,34896,68633
2022-12-22,3호선,안국,29637,30231,59868
2022-12-22,3호선,압구정,36782,39481,76263
2022-12-22,3호선,약수,14439,13834,28273
2022-12-22,3호선,양재,43493,46875,90368
2022-12-22,3호선,연신내,37463,35708,73171
2022-12-22,3호선,오금,6871,6304,13175
2022-12-22,3호선,옥수,9859,10205,20064
2022-12-22,3호선,을지로3가,13449,13214,26663
2022-12-22,3호선,일원,12495,12015,24510
2022-12-22,3호선,잠원,5462,5277,10739
2022-12-22,3호선,종로3가,11472,13424,24896
2022-12-22,3호선,지축,6439,6251,12690
2022-12-22,3호선,충무로,3,0,3
2022-12-22,3호선,학여울,1953,2048,4001
2022-12-22,3호선,홍제,19055,18329,37384
2022-12-22,4호선,길음,22766,22573,45339
2022-12-22,4호선,남태령,1571,1440,3011
2022-12-22,4호선,노원,20380,24096,44476
2022-12-22,4호선,당고개,10165,9271,19436
2022-12-22,4호선,동대문,20769,21436,42205
2022-12-22,4호선,동대문역사문화공원,18869,16647,35516
2022-12-22,4호선,동작,1110,1152,2262
2022-12-22,4호선,명동,30219,32679,62898
2022-12-22,4호선,미아,15698,15196,30894
2022-12-22,4호선,미아사거리,29035,28700,57735
2022-12-22,4호선,사당,26587,25030,51617
2022-12-22,4호선,삼각지,6772,7698,14470
2022-12-22,4호선,상계,20534,19480,40014
2022-12-22,4호선,서울역,13855,23351,37206
2022-12-22,4호선,성신여대입구,23096,22469,45565
2022-12-22,4호선,수유,36731,36633,73364
2022-12-22,4호선,숙대입구,15627,15127,30754
2022-12-22,4호선,신용산,20876,21350,42226
2022-12-22,4호선,쌍문,31376,29569,60945
2022-12-22,4호선,이촌,10104,10818,20922
2022-12-22,4호선,창동,26279,27945,54224
2022-12-22,4호선,총신대입구,20365,22612,42977
2022-12-22,4호선,충무로,30439,31818,62257
2022-12-22,4호선,한성대입구,15085,14633,29718
2022-12-22,4호선,혜화,42213,41833,84046
2022-12-22,4호선,회현,28729,29681,58410
2022-12-22,5호선,강동,20513,19482,39995
2022-12-22,5호선,강일,5501,5096,10597
2022-12-22,5호선,개롱,6819,7100,13919
2022-12-22,5호선,개화산,6021,5748,11769
2022-12-22,5호선,거여,11115,10756,21871
2022-12-22,5호선,고덕,10840,10551,21391
2022-12-22,5호선,공덕,16835,17746,34581
2022-12-22,5호선,광나루,15043,13986,29029
2022-12-22,5호선,광화문,41333,42031,83364
2022-12-22,5호선,군자,14768,16005,30773
2022-12-22,5호선,굽은다리,10669,10437,21106
2022-12-22,5호선,길동,8762,9199,17961
2022-12-22,5호선,김포공항,8331,7347,15678
2022-12-22,5호선,까치산,30800,29529,60329
2022-12-22,5호선,답십리,17929,16269,34198
2022-12-22,5호선,동대문역사문화공원,3614,4305,7919
2022-12-22,5호선,둔촌동,9607,9985,19592
2022-12-22,5호선,마곡,12242,12318,24560
2022-12-22,5호선,마장,6592,6157,12749
2022-12-22,5호선,마천,7990,7575,15565
2022-12-22,5호선,마포,17452,17813,35265
2022-12-22,5호선,명일,9384,9689,19073
2022-12-22,5호선,목동,17884,19304,37188
2022-12-22,5호선,미사,18352,18162,36514
2022-12-22,5호선,발산,24047,24750,48797
2022-12-22,5호선,방이,8162,8440,16602
2022-12-22,5호선,방화,7336,7118,14454
2022-12-22,5호선,상일동,16130,15251,31381
2022-12-22,5호선,서대문,22671,23019,45690
2022-12-22,5호선,송정,7094,6621,13715
2022-12-22,5호선,신금호,6844,7274,14118
2022-12-22,5호선,신길,4815,5220,10035
2022-12-22,5호선,신정,14944,12322,27266
2022-12-22,5호선,아차산,15963,15441,31404
2022-12-22,5호선,애오개,7501,7707,15208
2022-12-22,5호선,양평,8119,8215,16334
2022-12-22,5호선,여의나루,12118,16134,28252
2022-12-22,5호선,여의도,37049,36817,73866
2022-12-22,5호선,영등포구청,4420,4480,8900
2022-12-22,5호선,영등포시장,11314,11828,23142
2022-12-22,5호선,오금,4174,4170,8344
2022-12-22,5호선,오목교,24312,25612,49924
2022-12-22,5호선,올림픽공원,4889,5543,10432
2022-12-22,5호선,왕십리,5218,6118,11336
2022-12-22,5호선,우장산,15854,15753,31607
2022-12-22,5호선,을지로4가,7199,7308,14507
2022-12-22,5호선,장한평,21079,20997,42076
2022-12-22,5호선,종로3가,16205,15428,31633
2022-12-22,5호선,천호,20017,19358,39375
2022-12-22,5호선,청구,4430,4140,8570
2022-12-22,5호선,충정로,5408,5528,10936
2022-12-22,5호선,하남검단산,6773,6467,13240
2022-12-22,5호선,하남시청,7824,7586,15410
2022-12-22,5호선,하남풍산,4791,4834,9625
2022-12-22,5호선,행당,9236,8194,17430
2022-12-22,5호선,화곡,30763,28734,59497
2022-12-22,6호선,고려대,9403,9237,18640
2022-12-22,6호선,공덕,20937,20533,41470
2022-12-22,6호선,광흥창,10307,10126,20433
2022-12-22,6호선,구산,8407,6501,14908
2022-12-22,6호선,녹사평,5322,5250,10572
2022-12-22,6호선,대흥,9440,9984,19424
2022-12-22,6호선,독바위,2922,3059,5981
2022-12-22,6호선,돌곶이,10647,9705,20352
2022-12-22,6호선,동묘앞,8435,8632,17067
2022-12-22,6호선,디지털미디어시티,15536,17758,33294
2022-12-22,6호선,마포구청,15679,14217,29896
2022-12-22,6호선,망원,15628,16841,32469
2022-12-22,6호선,버티고개,2402,2376,4778
2022-12-22,6호선,보문,8686,7866,16552
2022-12-22,6호선,봉화산,9779,9288,19067
2022-12-22,6호선,불광,4527,4425,8952
2022-12-22,6호선,삼각지,8129,7349,15478
2022-12-22,6호선,상수,10678,12165,22843
2022-12-22,6호선,상월곡,7268,6693,13961
2022-12-22,6호선,새절,13561,12667,26228
2022-12-22,6호선,석계,13563,14042,27605
2022-12-22,6호선,신당,9474,9835,19309
2022-12-22,6호선,안암,13788,13369,27157
2022-12-22,6호선,약수,3923,4018,7941
2022-12-22,6호선,역촌,4080,4845,8925
2022-12-22,6호선,월곡,13025,12667,25692
2022-12-22,6호선,월드컵경기장,4044,4324,8368
2022-12-22,6호선,응암,18973,18895,37868
2022-12-22,6호선,이태원,10185,10558,20743
2022-12-22,6호선,증산,10561,10433,20994
2022-12-22,6호선,창신,3890,3275,7165
2022-12-22,6호선,청구,4155,4263,8418
2022-12-22,6호선,태릉입구,7178,7645,14823
2022-12-22,6호선,한강진,9321,10567,19888
2022-12-22,6호선,합정,15762,14887,30649
2022-12-22,6호선,화랑대,12875,9779,22654
2022-12-22,6호선,효창공원앞,7716,7184,14900
2022-12-22,7호선,가산디지털단지,49097,49531,98628
2022-12-22,7호선,강남구청,17094,20631,37725
2022-12-22,7호선,건대입구,12554,15840,28394
2022-12-22,7호선,고속터미널,17390,14564,31954
2022-12-22,7호선,공릉,11846,11546,23392
2022-12-22,7호선,광명사거리,22377,21852,44229
2022-12-22,7호선,군자,15574,12289,27863
2022-12-22,7호선,남구로,16328,17830,34158
2022-12-22,7호선,남성,12274,11129,23403
2022-12-22,7호선,내방,15910,16307,32217
2022-12-22,7호선,노원,21241,20825,42066
2022-12-22,7호선,논현,18272,20479,38751
2022-12-22,7호선,대림,8428,8381,16809
2022-12-22,7호선,도봉산,9041,9554,18595
2022-12-22,7호선,뚝섬유원지,6978,7254,14232
2022-12-22,7호선,마들,14326,12288,26614
2022-12-22,7호선,먹골,10317,9756,20073
2022-12-22,7호선,면목,15177,14093,29270
2022-12-22,7호선,반포,6544,6326,12870
2022-12-22,7호선,보라매,7781,7909,15690
2022-12-22,7호선,사가정,16053,15035,31088
2022-12-22,7호선,상도,12140,11214,23354
2022-12-22,7호선,상봉,18346,17195,35541
2022-12-22,7호선,수락산,13230,12014,25244
2022-12-22,7호선,숭실대입구,13093,12828,25921
2022-12-22,7호선,신대방삼거리,15784,15094,30878
2022-12-22,7호선,신풍,12384,11596,23980
2022-12-22,7호선,어린이대공원,13689,14213,27902
2022-12-22,7호선,온수,10801,9684,20485
2022-12-22,7호선,용마산,6066,5647,11713
2022-12-22,7호선,이수,17655,16588,34243
2022-12-22,7호선,장승배기,9677,9216,18893
2022-12-22,7호선,장암,2415,814,3229
2022-12-22,7호선,중계,15675,13230,28905
2022-12-22,7호선,중곡,11227,10194,21421
2022-12-22,7호선,중화,10787,9713,20500
2022-12-22,7호선,천왕,12648,11743,24391
2022-12-22,7호선,철산,23136,23616,46752
2022-12-22,7호선,청담,19926,26380,46306
2022-12-22,7호선,태릉입구,8890,10308,19198
2022-12-22,7호선,하계,18596,17249,35845
2022-12-22,7호선,학동,25384,28096,53480
2022-12-22,8호선,가락시장,9037,9807,18844
2022-12-22,8호선,강동구청,12373,12591,24964
2022-12-22,8호선,남위례,6818,6974,13792
2022-12-22,8호선,남한산성입구,14034,12546,26580
2022-12-22,8호선,단대오거리,12016,11780,23796
2022-12-22,8호선,모란,4676,3743,8419
2022-12-22,8호선,몽촌토성,7108,7361,14469
2022-12-22,8호선,문정,24163,25488,49651
2022-12-22,8호선,복정,9736,8229,17965
2022-12-22,8호선,산성,5698,5622,11320
2022-12-22,8호선,석촌,9002,10229,19231
2022-12-22,8호선,송파,10386,10362,20748
2022-12-22,8호선,수진,5941,5584,11525
2022-12-22,8호선,신흥,5601,5788,11389
2022-12-22,8호선,암사,20903,18257,39160
2022-12-22,8호선,잠실,19614,22908,42522
2022-12-22,8호선,장지,19713,18677,38390
2022-12-22,8호선,천호,16164,18642,34806
2022-12-22,9호선,가양,23598,23007,46605
2022-12-22,9호선,개화,2966,1843,4809
2022-12-22,9호선,고속터미널,15285,20048,35333
2022-12-22,9호선,공항시장,3187,3500,6687
2022-12-22,9호선,구반포,1153,1193,2346
2022-12-22,9호선,국회의사당,19903,20287,40190
2022-12-22,9호선,김포공항,7604,9595,17199
2022-12-22,9호선,노들,5288,4328,9616
2022-12-22,9호선,노량진,29641,28537,58178
2022-12-22,9호선,당산,21953,21538,43491
2022-12-22,9호선,동작,1803,1430,3233
2022-12-22,9호선,등촌,13000,12620,25620
2022-12-22,9호선,마곡나루,14463,13904,28367
2022-12-22,9호선,사평,4564,4485,9049
2022-12-22,9호선,샛강,7532,7417,14949
2022-12-22,9호선,선유도,9878,9521,19399
2022-12-22,9호선,신논현,35680,35132,70812
2022-12-22,9호선,신목동,4638,4042,8680
2022-12-22,9호선,신반포,4025,3961,7986
2022-12-22,9호선,신방화,7533,7466,14999
2022-12-22,9호선,양천향교,10683,11118,21801
2022-12-22,9호선,여의도,36294,33917,70211
2022-12-22,9호선,염창,19376,18611,37987
2022-12-22,9호선,증미,7973,7571,15544
2022-12-22,9호선,흑석,9197,9804,19001
2022-12-22,9호선2~3단계,둔촌오륜,2913,2716,5629
2022-12-22,9호선2~3단계,봉은사,29609,30581,60190
2022-12-22,9호선2~3단계,삼성중앙,8958,9372,18330
2022-12-22,9호선2~3단계,삼전,8129,7862,15991
2022-12-22,9호선2~3단계,석촌,9927,8780,18707
2022-12-22,9호선2~3단계,석촌고분,7724,7604,15328
2022-12-22,9호선2~3단계,선정릉,10964,12118,23082
2022-12-22,9호선2~3단계,송파나루,6600,7151,13751
2022-12-22,9호선2~3단계,언주,12939,13105,26044
2022-12-22,9호선2~3단계,올림픽공원,7558,11609,19167
2022-12-22,9호선2~3단계,종합운동장,5240,5002,10242
2022-12-22,9호선2~3단계,중앙보훈병원,12856,11258,24114
2022-12-22,9호선2~3단계,한성백제,3100,2779,5879
2022-12-22,경강선,경기광주,9074,8365,17439
2022-12-22,경강선,곤지암,2823,2615,5438
2022-12-22,경강선,부발,2431,2260,4691
2022-12-22,경강선,삼동,2746,2523,5269
2022-12-22,경강선,세종대왕릉,350,355,705
2022-12-22,경강선,신둔도예촌,1597,1464,3061
2022-12-22,경강선,여주,2236,2192,4428
2022-12-22,경강선,이매,1325,1081,2406
2022-12-22,경강선,이천,2785,2853,5638
2022-12-22,경강선,초월,3780,3422,7202
2022-12-22,경강선,판교,6119,6249,12368
2022-12-22,경부선,가산디지털단지,18821,22026,40847
2022-12-22,경부선,관악,8070,7667,15737
2022-12-22,경부선,광명,3702,3159,6861
2022-12-22,경부선,구로,19296,19961,39257
2022-12-22,경부선,군포,8142,7964,16106
2022-12-22,경부선,금정,28886,29559,58445
2022-12-22,경부선,금천구청,11920,11876,23796
2022-12-22,경부선,남영,10070,10741,20811
2022-12-22,경부선,노량진,9171,10046,19217
2022-12-22,경부선,당정,6566,6258,12824
2022-12-22,경부선,대방,11801,12891,24692
2022-12-22,경부선,독산,19709,20534,40243
2022-12-22,경부선,두정,7188,7064,14252
2022-12-22,경부선,명학,9509,9397,18906
2022-12-22,경부선,병점,15018,14821,29839
2022-12-22,경부선,서동탄,1446,1275,2721
2022-12-22,경부선,서울역,9557,2902,12459
2022-12-22,경부선,서정리,7991,7090,15081
2022-12-22,경부선,석수,9692,8728,18420
2022-12-22,경부선,성균관대,15255,14997,30252
2022-12-22,경부선,성환,3565,3444,7009
2022-12-22,경부선,세류,3293,2829,6122
2022-12-22,경부선,세마,3023,2890,5913
2022-12-22,경부선,송탄,4522,4418,8940
2022-12-22,경부선,수원,36468,39281,75749
2022-12-22,경부선,신길,9386,7993,17379
2022-12-22,경부선,신도림,3904,4150,8054
2022-12-22,경부선,안양,22864,22557,45421
2022-12-22,경부선,영등포,44713,45448,90161
2022-12-22,경부선,오산,9933,9986,19919
2022-12-22,경부선,오산대,3678,3340,7018
2022-12-22,경부선,용산,44518,44347,88865
2022-12-22,경부선,의왕,9495,9360,18855
2022-12-22,경부선,직산,909,923,1832
2022-12-22,경부선,진위,1790,1639,3429
2022-12-22,경부선,천안,6116,5626,11742
2022-12-22,경부선,평택,12399,11847,24246
2022-12-22,경부선,평택지제,4492,4661,9153
2022-12-22,경부선,화서,8757,8218,16975
2022-12-22,경원선,가능,6831,6591,13422
2022-12-22,경원선,광운대,8223,8240,16463
2022-12-22,경원선,녹양,4719,4390,9109
2022-12-22,경원선,녹천,4767,4023,8790
2022-12-22,경원선,덕계,3275,2820,6095
2022-12-22,경원선,덕정,5757,5450,11207
2022-12-22,경원선,도봉,6223,6129,12352
2022-12-22,경원선,도봉산,7170,4469,11639
2022-12-22,경원선,동두천,2165,2310,4475
2022-12-22,경원선,동두천중앙,3143,3059,6202
2022-12-22,경원선,망월사,8089,8078,16167
2022-12-22,경원선,방학,10359,10141,20500
2022-12-22,경원선,보산,1941,1545,3486
2022-12-22,경원선,서빙고,2091,1951,4042
2022-12-22,경원선,석계,8320,9857,18177
2022-12-22,경원선,소요산,1917,1623,3540
2022-12-22,경원선,신이문,9106,8409,17515
2022-12-22,경원선,양주,7504,7262,14766
2022-12-22,경원선,옥수,63,47,110
2022-12-22,경원선,왕십리,17570,18504,36074
2022-12-22,경원선,외대앞,8735,8564,17299
2022-12-22,경원선,월계,6915,6671,13586
2022-12-22,경원선,응봉,1956,1697,3653
2022-12-22,경원선,의정부,19471,20018,39489
2022-12-22,경원선,이촌,4194,3219,7413
2022-12-22,경원선,지행,6942,6744,13686
2022-12-22,경원선,창동,1,0,1
2022-12-22,경원선,청량리,16734,16890,33624
2022-12-22,경원선,한남,4268,4090,8358
2022-12-22,경원선,회룡,13017,12587,25604
2022-12-22,경의선,가좌,6039,5750,11789
2022-12-22,경의선,강매,3419,2862,6281
2022-12-22,경의선,곡산,568,603,1171
2022-12-22,경의선,공덕,4350,3530,7880
2022-12-22,경의선,금릉,5612,5457,11069
2022-12-22,경의선,금촌,6841,6676,13517
2022-12-22,경의선,능곡,4024,3588,7612
2022-12-22,경의선,디지털미디어시티,2965,2588,5553
2022-12-22,경의선,문산,5321,5369,10690
2022-12-22,경의선,백마,7337,7023,14360
2022-12-22,경의선,서강대,2238,2267,4505
2022-12-22,경의선,서울역,4533,6160,10693
2022-12-22,경의선,수색,2846,3104,5950
2022-12-22,경의선,신촌,934,1184,2118
2022-12-22,경의선,야당,8551,8554,17105
2022-12-22,경의선,운정,7506,7007,14513
2022-12-22,경의선,운천,12,10,22
2022-12-22,경의선,월롱,2888,2274,5162
2022-12-22,경의선,일산,9866,9735,19601
2022-12-22,경의선,임진강,15,3,18
2022-12-22,경의선,탄현,8534,8115,16649
2022-12-22,경의선,파주,1224,788,2012
2022-12-22,경의선,풍산,6129,5650,11779
2022-12-22,경의선,행신,8824,8597,17421
2022-12-22,경의선,홍대입구,1907,2361,4268
2022-12-22,경의선,화전,1748,1614,3362
2022-12-22,경의선,효창공원앞,3241,3596,6837
2022-12-22,경인선,간석,6144,5937,12081
2022-12-22,경인선,개봉,23778,23750,47528
2022-12-22,경인선,구일,6593,6556,13149
2022-12-22,경인선,도원,3137,3150,6287
2022-12-22,경인선,도화,4228,3995,8223
2022-12-22,경인선,동암,16508,16260,32768
2022-12-22,경인선,동인천,14211,13695,27906
2022-12-22,경인선,백운,6957,6769,13726
2022-12-22,경인선,부개,8881,8425,17306
2022-12-22,경인선,부천,32933,33156,66089
2022-12-22,경인선,부평,30088,32199,62287
2022-12-22,경인선,소사,8280,8189,16469
2022-12-22,경인선,송내,28832,28857,57689
2022-12-22,경인선,역곡,28079,28041,56120
2022-12-22,경인선,오류동,12467,11509,23976
2022-12-22,경인선,온수,7100,6746,13846
2022-12-22,경인선,인천,3313,2492,5805
2022-12-22,경인선,제물포,11085,10489,21574
2022-12-22,경인선,주안,20237,18319,38556
2022-12-22,경인선,중동,9891,9189,19080
2022-12-22,경춘선,가평,1712,1736,3448
2022-12-22,경춘선,갈매,3172,2606,5778
2022-12-22,경춘선,강촌,561,526,1087
2022-12-22,경춘선,굴봉산,111,153,264
2022-12-22,경춘선,금곡,1471,1429,2900
2022-12-22,경춘선,김유정,266,258,524
2022-12-22,경춘선,남춘천,2786,2622,5408
2022-12-22,경춘선,대성리,614,697,1311
2022-12-22,경춘선,마석,3890,3879,7769
2022-12-22,경춘선,백양리,376,417,793
2022-12-22,경춘선,별내,3281,3051,6332
2022-12-22,경춘선,사릉,2328,2223,4551
2022-12-22,경춘선,상천,208,178,386
2022-12-22,경춘선,신내,2416,2313,4729
2022-12-22,경춘선,천마산,1616,1414,3030
2022-12-22,경춘선,청평,1594,1615,3209
2022-12-22,경춘선,춘천,1412,1157,2569
2022-12-22,경춘선,퇴계원,3643,3328,6971
2022-12-22,경춘선,평내호평,6399,6174,12573
2022-12-22,공항철도,검암,7037,6863,13900
2022-12-22,공항철도,계양,13134,12203,25337
2022-12-22,공항철도,공덕,2844,3907,6751
2022-12-22,공항철도,공항화물청사,2399,2561,4960
2022-12-22,공항철도,김포공항,10342,5523,15865
2022-12-22,공항철도,디지털미디어시티,16545,15280,31825
2022-12-22,공항철도,마곡나루,11598,11249,22847
2022-12-22,공항철도,서울역,12191,10769,22960
2022-12-22,공항철도,영종,3864,3925,7789
2022-12-22,공항철도,운서,8808,9119,17927
2022-12-22,공항철도,인천공항1터미널,11723,11056,22779
2022-12-22,공항철도,인천공항2터미널,4538,4126,8664
2022-12-22,공항철도,청라국제도시,7710,7306,15016
2022-12-22,공항철도,홍대입구,13304,13672,26976
2022-12-22,과천선,경마공원,1378,1409,2787
2022-12-22,과천선,과천,7104,6860,13964
2022-12-22,과천선,대공원,2283,2321,4604
2022-12-22,과천선,범계,28883,28852,57735
2022-12-22,과천선,선바위,8693,7828,16521
2022-12-22,과천선,인덕원,26901,27705,54606
2022-12-22,과천선,정부과천청사,12747,12949,25696
2022-12-22,과천선,평촌,19594,19466,39060
2022-12-22,분당선,가천대,7492,8121,15613
2022-12-22,분당선,강남구청,12136,13120,25256
2022-12-22,분당선,개포동,4631,4710,9341
2022-12-22,분당선,구룡,2527,2355,4882
2022-12-22,분당선,구성,5603,5853,11456
2022-12-22,분당선,기흥,11454,10628,22082
2022-12-22,분당선,대모산입구,5311,4986,10297
2022-12-22,분당선,도곡,8659,8546,17205
2022-12-22,분당선,망포,17038,16319,33357
2022-12-22,분당선,매교,4993,4862,9855
2022-12-22,분당선,매탄권선,5852,5747,11599
2022-12-22,분당선,모란,20472,20562,41034
2022-12-22,분당선,미금,17032,18226,35258
2022-12-22,분당선,보정,3139,2712,5851
2022-12-22,분당선,복정,2,0,2
2022-12-22,분당선,상갈,5907,5711,11618
2022-12-22,분당선,서울숲,13138,13590,26728
2022-12-22,분당선,서현,28433,29157,57590
2022-12-22,분당선,선릉,15500,23423,38923
2022-12-22,분당선,선정릉,9025,9426,18451
2022-12-22,분당선,수내,16404,16435,32839
2022-12-22,분당선,수서,15139,15981,31120
2022-12-22,분당선,수원,8579,7513,16092
2022-12-22,분당선,수원시청,14062,14994,29056
2022-12-22,분당선,신갈,5472,5327,10799
2022-12-22,분당선,압구정로데오,23769,26127,49896
2022-12-22,분당선,야탑,29171,30738,59909
2022-12-22,분당선,영통,9854,9615,19469
2022-12-22,분당선,오리,13114,10547,23661
2022-12-22,분당선,이매,6400,6055,12455
2022-12-22,분당선,정자,21900,22777,44677
2022-12-22,분당선,죽전,14583,15969,30552
2022-12-22,분당선,청명,4914,4877,9791
2022-12-22,분당선,태평,14340,13834,28174
2022-12-22,분당선,한티,16450,17396,33846
2022-12-22,수인선,고색,5266,4897,10163
2022-12-22,수인선,남동인더스파크,2345,2832,5177
2022-12-22,수인선,달월,97,65,162
2022-12-22,수인선,사리,5240,4387,9627
2022-12-22,수인선,소래포구,4540,4214,8754
2022-12-22,수인선,송도,2484,2205,4689
2022-12-22,수인선,숭의,4142,3920,8062
2022-12-22,수인선,신포,1782,1903,3685
2022-12-22,수인선,야목,355,289,644
2022-12-22,수인선,어천,1302,1165,2467
2022-12-22,수인선,연수,4783,4673,9456
2022-12-22,수인선,오목천,3422,3163,6585
2022-12-22,수인선,원인재,4430,4618,9048
2022-12-22,수인선,월곶,2885,2589,5474
2022-12-22,수인선,인천,984,1587,2571
2022-12-22,수인선,인천논현,5857,6143,12000
2022-12-22,수인선,인하대,6378,5908,12286
2022-12-22,수인선,호구포,4273,4528,8801
2022-12-22,신림선,관악산,2114,2157,4271
2022-12-22,신림선,당곡,4744,4687,9431
2022-12-22,신림선,대방,2630,2155,4785
2022-12-22,신림선,보라매,3901,3587,7488
2022-12-22,신림선,보라매공원,2119,2248,4367
2022-12-22,신림선,보라매병원,8249,8628,16877
2022-12-22,신림선,샛강,2762,3522,6284
2022-12-22,신림선,서울대벤처타운,8460,8177,16637
2022-12-22,신림선,서울지방병무청,2924,3236,6160
2022-12-22,신림선,서원,3497,3133,6630
2022-12-22,신림선,신림,1912,2498,4410
2022-12-22,안산선,고잔,9422,8876,18298
2022-12-22,안산선,대야미,5059,4529,9588
2022-12-22,안산선,반월,4323,4220,8543
2022-12-22,안산선,산본,16737,17912,34649
2022-12-22,안산선,상록수,16136,16480,32616
2022-12-22,안산선,수리산,4243,3436,7679
2022-12-22,안산선,신길온천,1758,1654,3412
2022-12-22,안산선,안산,11497,10564,22061
2022-12-22,안산선,오이도,8247,8286,16533
2022-12-22,안산선,정왕,8326,8613,16939
2022-12-22,안산선,중앙,19426,19819,39245
2022-12-22,안산선,초지,5059,5081,10140
2022-12-22,안산선,한대앞,9595,9449,19044
2022-12-22,우이신설선,4.19민주묘지,3118,2894,6012
2022-12-22,우이신설선,가오리,4453,4518,8971
2022-12-22,우이신설선,보문,1799,1799,3598
2022-12-22,우이신설선,북한산보국문,6731,6380,13111
2022-12-22,우이신설선,북한산우이,4167,3875,8042
2022-12-22,우이신설선,삼양,2131,2266,4397
2022-12-22,우이신설선,삼양사거리,2621,2664,5285
2022-12-22,우이신설선,성신여대입구,3781,4150,7931
2022-12-22,우이신설선,솔밭공원,2685,2459,5144
2022-12-22,우이신설선,솔샘,6443,6047,12490
2022-12-22,우이신설선,신설동,2438,2325,4763
2022-12-22,우이신설선,정릉,4986,4880,9866
2022-12-22,우이신설선,화계,3741,3565,7306
2022-12-22,일산선,대곡,2172,1545,3717
2022-12-22,일산선,대화,13998,11000,24998
2022-12-22,일산선,마두,8039,8377,16416
2022-12-22,일산선,백석,10677,10667,21344
2022-12-22,일산선,삼송,21440,20764,42204
2022-12-22,일산선,원당,11723,11002,22725
2022-12-22,일산선,원흥,12094,11206,23300
2022-12-22,일산선,정발산,7430,7661,15091
2022-12-22,일산선,주엽,9782,9896,19678
2022-12-22,일산선,지축,1,0,1
2022-12-22,일산선,화정,18315,18624,36939
2022-12-22,장항선,배방,1223,1194,2417
2022-12-22,장항선,봉명,1484,1436,2920
2022-12-22,장항선,신창,1178,1170,2348
2022-12-22,장항선,쌍용,2472,2228,4700
2022-12-22,장항선,아산,3713,3457,7170
2022-12-22,장항선,온양온천,4012,4062,8074
2022-12-22,장항선,탕정,1272,1135,2407
2022-12-22,중앙선,구리,14034,14040,28074
2022-12-22,중앙선,국수,746,729,1475
2022-12-22,중앙선,덕소,5804,5737,11541
2022-12-22,중앙선,도농,12076,10923,22999
2022-12-22,중앙선,도심,2507,2003,4510
2022-12-22,중앙선,망우,8129,8210,16339
2022-12-22,중앙선,상봉,6039,6015,12054
2022-12-22,중앙선,신원,146,115,261
2022-12-22,중앙선,아신,552,581,1133
2022-12-22,중앙선,양수,1991,1964,3955
2022-12-22,중앙선,양원,3172,3093,6265
2022-12-22,중앙선,양정,633,524,1157
2022-12-22,중앙선,양평,2847,2982,5829
2022-12-22,중앙선,오빈,329,324,653
2022-12-22,중앙선,용문,1745,1667,3412
2022-12-22,중앙선,운길산,634,570,1204
2022-12-22,중앙선,원덕,278,272,550
2022-12-22,중앙선,중랑,6062,5930,11992
2022-12-22,중앙선,지평,42,51,93
2022-12-22,중앙선,팔당,802,823,1625
2022-12-22,중앙선,회기,28789,27146,55935
2022-12-23,1호선,동대문,11213,9907,21120
2022-12-23,1호선,동묘앞,7345,7442,14787
2022-12-23,1호선,서울역,58160,56540,114700
2022-12-23,1호선,시청,28180,27839,56019
2022-12-23,1호선,신설동,14467,13948,28415
2022-12-23,1호선,제기동,14677,14646,29323
2022-12-23,1호선,종각,42535,41955,84490
2022-12-23,1호선,종로3가,25797,24888,50685
2022-12-23,1호선,종로5가,24577,23254,47831
2022-12-23,1호선,청량리,18470,18455,36925
2022-12-23,2호선,강남,89981,88721,178702
2022-12-23,2호선,강변,35177,33673,68850
2022-12-23,2호선,건대입구,40205,44775,84980
2022-12-23,2호선,교대,36125,42038,78163
2022-12-23,2호선,구로디지털단지,60686,60008,120694
2022-12-23,2호선,구의,26109,25307,51416
2022-12-23,2호선,낙성대,30302,27901,58203
2022-12-23,2호선,당산,18285,21447,39732
2022-12-23,2호선,대림,23558,24144,47702
2022-12-23,2호선,도림천,1462,1499,2961
2022-12-23,2호선,동대문역사문화공원,14414,16058,30472
2022-12-23,2호선,뚝섬,24521,26169,50690
2022-12-23,2호선,문래,22833,23839,46672
2022-12-23,2호선,방배,17426,18202,35628
2022-12-23,2호선,봉천,24861,22752,47613
2022-12-23,2호선,사당,42355,47574,89929
2022-12-23,2호선,삼성,74730,71938,146668
2022-12-23,2호선,상왕십리,15762,15134,30896
2022-12-23,2호선,서울대입구,51489,49175,100664
2022-12-23,2호선,서초,23687,22224,45911
2022-12-23,2호선,선릉,60406,53097,113503
2022-12-23,2호선,성수,44542,48180,92722
2022-12-23,2호선,시청,28940,25907,54847
2022-12-23,2호선,신답,1727,1884,3611
2022-12-23,2호선,신당,15204,15974,31178
2022-12-23,2호선,신대방,25911,24577,50488
2022-12-23,2호선,신도림,52672,52555,105227
2022-12-23,2호선,신림,61857,59183,121040
2022-12-23,2호선,신설동,4446,4170,8616
2022-12-23,2호선,신정네거리,10680,11047,21727
2022-12-23,2호선,신촌,41475,42471,83946
2022-12-23,2호선,아현,11006,10343,21349
2022-12-23,2호선,양천구청,7030,7252,14282
2022-12-23,2호선,역삼,55143,59410,114553
2022-12-23,2호선,영등포구청,23132,23615,46747
2022-12-23,2호선,왕십리,18729,16932,35661
2022-12-23,2호선,용답,2921,2840,5761
2022-12-23,2호선,용두,2543,2498,5041
2022-12-23,2호선,을지로3가,26639,28309,54948
2022-12-23,2호선,을지로4가,15302,15886,31188
2022-12-23,2호선,을지로입구,54553,54446,108999
2022-12-23,2호선,이대,15633,16345,31978
2022-12-23,2호선,잠실,93015,92289,185304
2022-12-23,2호선,잠실나루,15071,14392,29463
2022-12-23,2호선,잠실새내,25111,26283,51394
2022-12-23,2호선,종합운동장,14780,16620,31400
2022-12-23,2호선,충정로,10508,11139,21647
2022-12-23,2호선,한양대,9708,10126,19834
2022-12-23,2호선,합정,35983,40454,76437
2022-12-23,2호선,홍대입구,74466,82599,157065
2022-12-23,3호선,가락시장,9577,9296,18873
2022-12-23,3호선,경복궁,22226,19618,41844
2022-12-23,3호선,경찰병원,7512,7674,15186
2022-12-23,3호선,고속터미널,56927,55799,112726
2022-12-23,3호선,교대,15575,9823,25398
2022-12-23,3호선,구파발,22004,25414,47418
2022-12-23,3호선,금호,7459,7798,15257
2022-12-23,3호선,남부터미널,34091,33689,67780
2022-12-23,3호선,녹번,13957,14875,28832
2022-12-23,3호선,대청,12232,11140,23372
2022-12-23,3호선,대치,11612,11910,23522
2022-12-23,3호선,도곡,5564,5327,10891
2022-12-23,3호선,독립문,6797,6612,13409
2022-12-23,3호선,동대입구,8896,9028,17924
2022-12-23,3호선,매봉,12928,12356,25284
2022-12-23,3호선,무악재,3752,3952,7704
2022-12-23,3호선,불광,14967,17324,32291
2022-12-23,3호선,수서,19327,18932,38259
2022-12-23,3호선,신사,32285,33430,65715
2022-12-23,3호선,안국,26455,22217,48672
2022-12-23,3호선,압구정,36084,38547,74631
2022-12-23,3호선,약수,13571,14014,27585
2022-12-23,3호선,양재,40486,40605,81091
2022-12-23,3호선,연신내,38503,35162,73665
2022-12-23,3호선,오금,6390,6008,12398
2022-12-23,3호선,옥수,9051,9435,18486
2022-12-23,3호선,을지로3가,12056,10218,22274
2022-12-23,3호선,일원,11382,10434,21816
2022-12-23,3호선,잠원,4875,4739,9614
2022-12-23,3호선,종로3가,11133,14022,25155
2022-12-23,3호선,지축,5493,5674,11167
2022-12-23,3호선,충무로,4,0,4
2022-12-23,3호선,학여울,1817,1837,3654
2022-12-23,3호선,홍제,15790,17459,33249
2022-12-23,4호선,길음,21835,21079,42914
2022-12-23,4호선,남태령,1418,1160,2578
2022-12-23,4호선,노원,20368,24028,44396
2022-12-23,4호선,당고개,9219,8183,17402
2022-12-23,4호선,동대문,19634,19518,39152
2022-12-23,4호선,동대문역사문화공원,18252,15565,33817
2022-12-23,4호선,동작,1053,1087,2140
2022-12-23,4호선,명동,32048,34813,66861
2022-12-23,4호선,미아,15705,15106,30811
2022-12-23,4호선,미아사거리,28230,28338,56568
2022-12-23,4호선,사당,30126,25305,55431
2022-12-23,4호선,삼각지,6714,7680,14394
2022-12-23,4호선,상계,19366,18049,37415
2022-12-23,4호선,서울역,13182,23631,36813
2022-12-23,4호선,성신여대입구,23120,22835,45955
2022-12-23,4호선,수유,36827,37383,74210
2022-12-23,4호선,숙대입구,15360,14547,29907
2022-12-23,4호선,신용산,20041,20810,40851
2022-12-23,4호선,쌍문,30559,28142,58701
2022-12-23,4호선,이촌,9908,10613,20521
2022-12-23,4호선,창동,25867,27882,53749
2022-12-23,4호선,총신대입구,19537,21495,41032
2022-12-23,4호선,충무로,28808,31368,60176
2022-12-23,4호선,한성대입구,14040,13515,27555
2022-12-23,4호선,혜화,42618,42157,84775
2022-12-23,4호선,회현,27815,28592,56407
2022-12-23,5호선,강동,19498,18386,37884
2022-12-23,5호선,강일,5297,4693,9990
2022-12-23,5호선,개롱,6713,6932,13645
2022-12-23,5호선,개화산,5848,5578,11426
2022-12-23,5호선,거여,10701,10127,20828
2022-12-23,5호선,고덕,10553,10272,20825
2022-12-23,5호선,공덕,15049,15747,30796
2022-12-23,5호선,광나루,14186,12872,27058
2022-12-23,5호선,광화문,38815,40642,79457
2022-12-23,5호선,군자,12280,13475,25755
2022-12-23,5호선,굽은다리,10593,10333,20926
2022-12-23,5호선,길동,8536,9081,17617
2022-12-23,5호선,김포공항,7340,6805,14145
2022-12-23,5호선,까치산,30012,28749,58761
2022-12-23,5호선,답십리,16823,15204,32027
2022-12-23,5호선,동대문역사문화공원,3683,4197,7880
2022-12-23,5호선,둔촌동,9099,9317,18416
2022-12-23,5호선,마곡,11846,11748,23594
2022-12-23,5호선,마장,6125,5824,11949
2022-12-23,5호선,마천,7684,7097,14781
2022-12-23,5호선,마포,16015,16428,32443
2022-12-23,5호선,명일,9032,9354,18386
2022-12-23,5호선,목동,17126,18320,35446
2022-12-23,5호선,미사,16860,17586,34446
2022-12-23,5호선,발산,22100,23791,45891
2022-12-23,5호선,방이,7876,8358,16234
2022-12-23,5호선,방화,6883,6576,13459
2022-12-23,5호선,상일동,15422,14409,29831
2022-12-23,5호선,서대문,22638,21023,43661
2022-12-23,5호선,송정,6810,6364,13174
2022-12-23,5호선,신금호,7049,7003,14052
2022-12-23,5호선,신길,4650,4967,9617
2022-12-23,5호선,신정,14362,11710,26072
2022-12-23,5호선,아차산,15039,14320,29359
2022-12-23,5호선,애오개,7249,7186,14435
2022-12-23,5호선,양평,8114,7812,15926
2022-12-23,5호선,여의나루,11666,15574,27240
2022-12-23,5호선,여의도,35338,34821,70159
2022-12-23,5호선,영등포구청,4154,4203,8357
2022-12-23,5호선,영등포시장,11437,11639,23076
2022-12-23,5호선,오금,4008,3957,7965
2022-12-23,5호선,오목교,23781,25456,49237
2022-12-23,5호선,올림픽공원,5677,5729,11406
2022-12-23,5호선,왕십리,5022,5948,10970
2022-12-23,5호선,우장산,15510,15022,30532
2022-12-23,5호선,을지로4가,6677,6969,13646
2022-12-23,5호선,장한평,19916,19963,39879
2022-12-23,5호선,종로3가,16276,17098,33374
2022-12-23,5호선,천호,20600,20263,40863
2022-12-23,5호선,청구,4244,3894,8138
2022-12-23,5호선,충정로,4854,4688,9542
2022-12-23,5호선,하남검단산,6635,6131,12766
2022-12-23,5호선,하남시청,7417,7195,14612
2022-12-23,5호선,하남풍산,4443,4576,9019
2022-12-23,5호선,행당,8565,7601,16166
2022-12-23,5호선,화곡,30088,27884,57972
2022-12-23,6호선,고려대,8934,8584,17518
2022-12-23,6호선,공덕,19412,19118,38530
2022-12-23,6호선,광흥창,9598,9418,19016
2022-12-23,6호선,구산,8935,6275,15210
2022-12-23,6호선,녹사평,5294,5549,10843
2022-12-23,6호선,대흥,9279,9570,18849
2022-12-23,6호선,독바위,3339,2862,6201
2022-12-23,6호선,돌곶이,10035,9240,19275
2022-12-23,6호선,동묘앞,8446,8124,16570
2022-12-23,6호선,디지털미디어시티,14637,15983,30620
2022-12-23,6호선,마포구청,14844,13468,28312
2022-12-23,6호선,망원,15578,16973,32551
2022-12-23,6호선,버티고개,2200,2278,4478
2022-12-23,6호선,보문,8348,7451,15799
2022-12-23,6호선,봉화산,9059,8716,17775
2022-12-23,6호선,불광,6013,4679,10692
2022-12-23,6호선,삼각지,7572,6719,14291
2022-12-23,6호선,상수,11074,13776,24850
2022-12-23,6호선,상월곡,6584,5860,12444
2022-12-23,6호선,새절,13334,11826,25160
2022-12-23,6호선,석계,12797,13149,25946
2022-12-23,6호선,신당,9506,8817,18323
2022-12-23,6호선,안암,12143,11495,23638
2022-12-23,6호선,약수,3933,4292,8225
2022-12-23,6호선,역촌,4098,4620,8718
2022-12-23,6호선,연신내,3,0,3
2022-12-23,6호선,월곡,12151,11636,23787
2022-12-23,6호선,월드컵경기장,4081,4424,8505
2022-12-23,6호선,응암,18759,18142,36901
2022-12-23,6호선,이태원,11207,12550,23757
2022-12-23,6호선,증산,10404,10101,20505
2022-12-23,6호선,창신,3777,3173,6950
2022-12-23,6호선,청구,3824,4134,7958
2022-12-23,6호선,태릉입구,5940,6275,12215
2022-12-23,6호선,한강진,9398,10900,20298
2022-12-23,6호선,합정,15584,15229,30813
2022-12-23,6호선,화랑대,12389,9187,21576
2022-12-23,6호선,효창공원앞,7588,7014,14602
2022-12-23,7호선,가산디지털단지,45960,44378,90338
2022-12-23,7호선,강남구청,17203,19197,36400
2022-12-23,7호선,건대입구,15040,15875,30915
2022-12-23,7호선,고속터미널,18683,15166,33849
2022-12-23,7호선,공릉,12545,12372,24917
2022-12-23,7호선,광명사거리,21521,21284,42805
2022-12-23,7호선,군자,16041,12667,28708
2022-12-23,7호선,남구로,15127,16193,31320
2022-12-23,7호선,남성,11820,10765,22585
2022-12-23,7호선,내방,15486,15777,31263
2022-12-23,7호선,노원,22627,23866,46493
2022-12-23,7호선,논현,18785,20393,39178
2022-12-23,7호선,대림,8322,8464,16786
2022-12-23,7호선,도봉산,8738,9762,18500
2022-12-23,7호선,뚝섬유원지,7354,7070,14424
2022-12-23,7호선,마들,13637,12698,26335
2022-12-23,7호선,먹골,11067,10984,22051
2022-12-23,7호선,면목,15362,14796,30158
2022-12-23,7호선,반포,6679,6396,13075
2022-12-23,7호선,보라매,7718,7792,15510
2022-12-23,7호선,사가정,16413,16585,32998
2022-12-23,7호선,상도,11802,11212,23014
2022-12-23,7호선,상봉,18322,18085,36407
2022-12-23,7호선,수락산,12994,12931,25925
2022-12-23,7호선,숭실대입구,13014,12480,25494
2022-12-23,7호선,신대방삼거리,15532,14540,30072
2022-12-23,7호선,신풍,11735,11161,22896
2022-12-23,7호선,어린이대공원,14387,14052,28439
2022-12-23,7호선,온수,10057,9260,19317
2022-12-23,7호선,용마산,6033,5764,11797
2022-12-23,7호선,이수,17415,16811,34226
2022-12-23,7호선,장승배기,9518,9104,18622
2022-12-23,7호선,장암,2246,925,3171
2022-12-23,7호선,중계,14980,13335,28315
2022-12-23,7호선,중곡,11636,10843,22479
2022-12-23,7호선,중화,11237,10878,22115
2022-12-23,7호선,천왕,11971,11169,23140
2022-12-23,7호선,철산,22456,23177,45633
2022-12-23,7호선,청담,19700,22564,42264
2022-12-23,7호선,태릉입구,9286,8544,17830
2022-12-23,7호선,하계,19224,17961,37185
2022-12-23,7호선,학동,24637,26429,51066
2022-12-23,8호선,가락시장,8784,9935,18719
2022-12-23,8호선,강동구청,11514,11676,23190
2022-12-23,8호선,남위례,6228,6333,12561
2022-12-23,8호선,남한산성입구,13412,11912,25324
2022-12-23,8호선,단대오거리,11581,11055,22636
2022-12-23,8호선,모란,4582,3942,8524
2022-12-23,8호선,몽촌토성,6869,7216,14085
2022-12-23,8호선,문정,22245,22879,45124
2022-12-23,8호선,복정,9504,7900,17404
2022-12-23,8호선,산성,5331,5175,10506
2022-12-23,8호선,석촌,8535,10087,18622
2022-12-23,8호선,송파,10045,9842,19887
2022-12-23,8호선,수진,5735,5333,11068
2022-12-23,8호선,신흥,5356,5719,11075
2022-12-23,8호선,암사,19579,17233,36812
2022-12-23,8호선,잠실,19714,22878,42592
2022-12-23,8호선,장지,19276,18337,37613
2022-12-23,8호선,천호,16145,19203,35348
2022-12-23,9호선,가양,22430,21829,44259
2022-12-23,9호선,개화,2679,1732,4411
2022-12-23,9호선,고속터미널,16067,23493,39560
2022-12-23,9호선,공항시장,3170,3369,6539
2022-12-23,9호선,구반포,1175,1147,2322
2022-12-23,9호선,국회의사당,17830,17966,35796
2022-12-23,9호선,김포공항,6808,8355,15163
2022-12-23,9호선,노들,4895,3991,8886
2022-12-23,9호선,노량진,29024,27926,56950
2022-12-23,9호선,당산,21235,20332,41567
2022-12-23,9호선,동작,1573,1194,2767
2022-12-23,9호선,등촌,12407,11670,24077
2022-12-23,9호선,마곡나루,13803,13466,27269
2022-12-23,9호선,사평,4295,4204,8499
2022-12-23,9호선,샛강,6778,6684,13462
2022-12-23,9호선,선유도,9206,8575,17781
2022-12-23,9호선,신논현,35111,35316,70427
2022-12-23,9호선,신목동,4313,3770,8083
2022-12-23,9호선,신반포,3696,3706,7402
2022-12-23,9호선,신방화,7628,7454,15082
2022-12-23,9호선,양천향교,10266,10303,20569
2022-12-23,9호선,여의도,35510,31820,67330
2022-12-23,9호선,염창,18666,17593,36259
2022-12-23,9호선,증미,7569,7063,14632
2022-12-23,9호선,흑석,9072,9185,18257
2022-12-23,9호선2~3단계,둔촌오륜,1128,1064,2192
2022-12-23,9호선2~3단계,봉은사,28489,29705,58194
2022-12-23,9호선2~3단계,삼성중앙,8235,8373,16608
2022-12-23,9호선2~3단계,삼전,8034,7599,15633
2022-12-23,9호선2~3단계,석촌,9727,8557,18284
2022-12-23,9호선2~3단계,석촌고분,7593,7526,15119
2022-12-23,9호선2~3단계,선정릉,10362,11294,21656
2022-12-23,9호선2~3단계,송파나루,6858,7665,14523
2022-12-23,9호선2~3단계,언주,12639,12577,25216
2022-12-23,9호선2~3단계,올림픽공원,12083,14115,26198
2022-12-23,9호선2~3단계,종합운동장,8070,7110,15180
2022-12-23,9호선2~3단계,중앙보훈병원,11584,9968,21552
2022-12-23,9호선2~3단계,한성백제,3196,2867,6063
2022-12-23,경강선,경기광주,8536,7898,16434
2022-12-23,경강선,곤지암,2651,2242,4893
2022-12-23,경강선,부발,2762,2076,4838
2022-12-23,경강선,삼동,2546,2301,4847
2022-12-23,경강선,세종대왕릉,340,314,654
2022-12-23,경강선,신둔도예촌,1666,1436,3102
2022-12-23,경강선,여주,2433,2408,4841
2022-12-23,경강선,이매,1181,984,2165
2022-12-23,경강선,이천,3047,3107,6154
2022-12-23,경강선,초월,3429,3105,6534
2022-12-23,경강선,판교,5789,5955,11744
2022-12-23,경부선,가산디지털단지,16957,20180,37137
2022-12-23,경부선,관악,7250,6818,14068
2022-12-23,경부선,광명,3875,3569,7444
2022-12-23,경부선,구로,17979,18974,36953
2022-12-23,경부선,군포,7855,7504,15359
2022-12-23,경부선,금정,28340,28827,57167
2022-12-23,경부선,금천구청,11204,11285,22489
2022-12-23,경부선,남영,9636,10015,19651
2022-12-23,경부선,노량진,9064,9691,18755
2022-12-23,경부선,당정,6153,5796,11949
2022-12-23,경부선,대방,11008,12125,23133
2022-12-23,경부선,독산,18241,18621,36862
2022-12-23,경부선,두정,8398,8063,16461
2022-12-23,경부선,명학,8627,8436,17063
2022-12-23,경부선,병점,15118,14971,30089
2022-12-23,경부선,서동탄,1380,1210,2590
2022-12-23,경부선,서울역,11295,3627,14922
2022-12-23,경부선,서정리,9993,7402,17395
2022-12-23,경부선,석수,9095,8135,17230
2022-12-23,경부선,성균관대,14754,14499,29253
2022-12-23,경부선,성환,4272,3802,8074
2022-12-23,경부선,세류,3252,2949,6201
2022-12-23,경부선,세마,3107,2817,5924
2022-12-23,경부선,송탄,5388,4734,10122
2022-12-23,경부선,수원,39002,43060,82062
2022-12-23,경부선,신길,8919,7293,16212
2022-12-23,경부선,신도림,3710,3769,7479
2022-12-23,경부선,안양,21862,21964,43826
2022-12-23,경부선,영등포,47779,49771,97550
2022-12-23,경부선,오산,10680,10371,21051
2022-12-23,경부선,오산대,3689,3278,6967
2022-12-23,경부선,용산,48362,48587,96949
2022-12-23,경부선,의왕,8899,8701,17600
2022-12-23,경부선,직산,1296,1049,2345
2022-12-23,경부선,진위,2003,1586,3589
2022-12-23,경부선,천안,7295,7063,14358
2022-12-23,경부선,평택,13523,13504,27027
2022-12-23,경부선,평택지제,5434,5000,10434
2022-12-23,경부선,화서,8248,7644,15892
2022-12-23,경원선,가능,6594,6385,12979
2022-12-23,경원선,광운대,7842,7381,15223
2022-12-23,경원선,녹양,4479,4129,8608
2022-12-23,경원선,녹천,4518,3684,8202
2022-12-23,경원선,덕계,3142,2753,5895
2022-12-23,경원선,덕정,5780,5289,11069
2022-12-23,경원선,도봉,5855,5477,11332
2022-12-23,경원선,도봉산,6187,3645,9832
2022-12-23,경원선,동두천,2111,2156,4267
2022-12-23,경원선,동두천중앙,2857,2848,5705
2022-12-23,경원선,망월사,7393,7385,14778
2022-12-23,경원선,방학,9557,9352,18909
2022-12-23,경원선,보산,2045,1734,3779
2022-12-23,경원선,서빙고,2043,1882,3925
2022-12-23,경원선,석계,7556,8554,16110
2022-12-23,경원선,소요산,1855,1462,3317
2022-12-23,경원선,신이문,8641,7821,16462
2022-12-23,경원선,양주,7372,7069,14441
2022-12-23,경원선,옥수,67,37,104
2022-12-23,경원선,왕십리,17461,19099,36560
2022-12-23,경원선,외대앞,8604,8133,16737
2022-12-23,경원선,월계,6345,5950,12295
2022-12-23,경원선,응봉,1772,1489,3261
2022-12-23,경원선,의정부,19693,20858,40551
2022-12-23,경원선,이촌,3957,3121,7078
2022-12-23,경원선,지행,6722,6632,13354
2022-12-23,경원선,청량리,18061,18470,36531
2022-12-23,경원선,한남,3981,3889,7870
2022-12-23,경원선,회룡,12049,11804,23853
2022-12-23,경의선,가좌,5617,5309,10926
2022-12-23,경의선,강매,3222,2642,5864
2022-12-23,경의선,계양,1,0,1
2022-12-23,경의선,곡산,517,526,1043
2022-12-23,경의선,공덕,4092,3268,7360
2022-12-23,경의선,금릉,5159,5041,10200
2022-12-23,경의선,금촌,6655,6361,13016
2022-12-23,경의선,능곡,3763,3297,7060
2022-12-23,경의선,디지털미디어시티,2991,2565,5556
2022-12-23,경의선,문산,5369,5047,10416
2022-12-23,경의선,백마,7069,6797,13866
2022-12-23,경의선,서강대,2133,2063,4196
2022-12-23,경의선,서울역,4350,6071,10421
2022-12-23,경의선,수색,2393,2526,4919
2022-12-23,경의선,신촌,844,1123,1967
2022-12-23,경의선,야당,8459,8595,17054
2022-12-23,경의선,운정,6892,6520,13412
2022-12-23,경의선,운천,4,2,6
2022-12-23,경의선,월롱,3283,2017,5300
2022-12-23,경의선,일산,9484,9338,18822
2022-12-23,경의선,임진강,10,1,11
2022-12-23,경의선,탄현,7970,7631,15601
2022-12-23,경의선,파주,1332,787,2119
2022-12-23,경의선,풍산,6419,5955,12374
2022-12-23,경의선,행신,8866,8389,17255
2022-12-23,경의선,홍대입구,1924,2589,4513
2022-12-23,경의선,화전,1646,1430,3076
2022-12-23,경의선,효창공원앞,3061,3460,6521
2022-12-23,경인선,간석,5995,5515,11510
2022-12-23,경인선,개봉,21866,21549,43415
2022-12-23,경인선,구일,6195,6086,12281
2022-12-23,경인선,도원,3385,3382,6767
2022-12-23,경인선,도화,3991,3706,7697
2022-12-23,경인선,동암,16136,16272,32408
2022-12-23,경인선,동인천,13511,13040,26551
2022-12-23,경인선,백운,6482,6334,12816
2022-12-23,경인선,부개,8564,7858,16422
2022-12-23,경인선,부천,32089,32962,65051
2022-12-23,경인선,부평,30539,34323,64862
2022-12-23,경인선,소사,7766,7541,15307
2022-12-23,경인선,송내,26928,26665,53593
2022-12-23,경인선,역곡,26633,26328,52961
2022-12-23,경인선,오류동,11469,10534,22003
2022-12-23,경인선,온수,6512,6023,12535
2022-12-23,경인선,인천,3059,2282,5341
2022-12-23,경인선,제물포,10565,9919,20484
2022-12-23,경인선,주안,19391,17361,36752
2022-12-23,경인선,중동,9138,8345,17483
2022-12-23,경춘선,가평,1720,1878,3598
2022-12-23,경춘선,갈매,2926,2521,5447
2022-12-23,경춘선,강촌,485,501,986
2022-12-23,경춘선,굴봉산,100,165,265
2022-12-23,경춘선,금곡,1363,1326,2689
2022-12-23,경춘선,김유정,223,223,446
2022-12-23,경춘선,남춘천,2783,2791,5574
2022-12-23,경춘선,대성리,698,459,1157
2022-12-23,경춘선,마석,3877,3740,7617
2022-12-23,경춘선,백양리,510,371,881
2022-12-23,경춘선,별내,3109,2926,6035
2022-12-23,경춘선,사릉,2138,2137,4275
2022-12-23,경춘선,상천,170,141,311
2022-12-23,경춘선,신내,2140,2006,4146
2022-12-23,경춘선,천마산,1444,1259,2703
2022-12-23,경춘선,청평,1718,1656,3374
2022-12-23,경춘선,춘천,1495,1282,2777
2022-12-23,경춘선,퇴계원,3475,3155,6630
2022-12-23,경춘선,평내호평,5899,6021,11920
2022-12-23,공항철도,검암,6630,6599,13229
2022-12-23,공항철도,계양,12472,11511,23983
2022-12-23,공항철도,공덕,2700,3780,6480
2022-12-23,공항철도,공항화물청사,2305,2274,4579
2022-12-23,공항철도,김포공항,7127,4686,11813
2022-12-23,공항철도,디지털미디어시티,14967,13564,28531
2022-12-23,공항철도,마곡나루,10245,9534,19779
2022-12-23,공항철도,서울역,13324,11879,25203
2022-12-23,공항철도,영종,3845,3937,7782
2022-12-23,공항철도,운서,8821,8957,17778
2022-12-23,공항철도,인천공항1터미널,11897,11170,23067
2022-12-23,공항철도,인천공항2터미널,4332,3957,8289
2022-12-23,공항철도,청라국제도시,7269,7033,14302
2022-12-23,공항철도,홍대입구,13730,14500,28230
2022-12-23,과천선,경마공원,7370,7514,14884
2022-12-23,과천선,과천,6953,6430,13383
2022-12-23,과천선,대공원,1836,1854,3690
2022-12-23,과천선,범계,28260,28828,57088
2022-12-23,과천선,선바위,8496,7304,15800
2022-12-23,과천선,인덕원,25428,26530,51958
2022-12-23,과천선,정부과천청사,11116,11021,22137
2022-12-23,과천선,평촌,18444,18102,36546
2022-12-23,분당선,가천대,7391,7734,15125
2022-12-23,분당선,강남구청,10706,12140,22846
2022-12-23,분당선,개포동,4309,4356,8665
2022-12-23,분당선,구룡,2494,2183,4677
2022-12-23,분당선,구성,5078,5260,10338
2022-12-23,분당선,기흥,10796,10139,20935
2022-12-23,분당선,대모산입구,5223,4817,10040
2022-12-23,분당선,도곡,8303,8104,16407
2022-12-23,분당선,망포,16770,15409,32179
2022-12-23,분당선,매교,4877,4757,9634
2022-12-23,분당선,매탄권선,5894,5551,11445
2022-12-23,분당선,모란,20095,20663,40758
2022-12-23,분당선,미금,16419,17269,33688
2022-12-23,분당선,보정,2729,2239,4968
2022-12-23,분당선,복정,2,0,2
2022-12-23,분당선,상갈,5685,5542,11227
2022-12-23,분당선,서울숲,12810,12869,25679
2022-12-23,분당선,서현,28716,29429,58145
2022-12-23,분당선,선릉,14242,21510,35752
2022-12-23,분당선,선정릉,8650,8693,17343
2022-12-23,분당선,수내,14945,14931,29876
2022-12-23,분당선,수서,15447,16444,31891
2022-12-23,분당선,수원,8841,7706,16547
2022-12-23,분당선,수원시청,14025,16919,30944
2022-12-23,분당선,신갈,5138,4774,9912
2022-12-23,분당선,압구정로데오,23946,28706,52652
2022-12-23,분당선,야탑,27906,29368,57274
2022-12-23,분당선,영통,9789,10100,19889
2022-12-23,분당선,오리,11819,9572,21391
2022-12-23,분당선,이매,5957,5534,11491
2022-12-23,분당선,정자,20034,20867,40901
2022-12-23,분당선,죽전,14206,15321,29527
2022-12-23,분당선,청명,4888,4507,9395
2022-12-23,분당선,태평,14246,13448,27694
2022-12-23,분당선,한티,16900,17585,34485
2022-12-23,수인선,고색,5045,4516,9561
2022-12-23,수인선,남동인더스파크,2264,2509,4773
2022-12-23,수인선,달월,106,64,170
2022-12-23,수인선,사리,5080,4239,9319
2022-12-23,수인선,소래포구,4288,4120,8408
2022-12-23,수인선,송도,2410,2088,4498
2022-12-23,수인선,숭의,4018,3664,7682
2022-12-23,수인선,신포,1754,1828,3582
2022-12-23,수인선,야목,345,248,593
2022-12-23,수인선,어천,1042,897,1939
2022-12-23,수인선,연수,4803,4928,9731
2022-12-23,수인선,오목천,3457,2934,6391
2022-12-23,수인선,원인재,4247,4368,8615
2022-12-23,수인선,월곶,2690,2470,5160
2022-12-23,수인선,인천,903,1496,2399
2022-12-23,수인선,인천논현,5595,6013,11608
2022-12-23,수인선,인하대,6107,5610,11717
2022-12-23,수인선,호구포,4240,4280,8520
2022-12-23,신림선,관악산,2100,1987,4087
2022-12-23,신림선,당곡,4610,4548,9158
2022-12-23,신림선,대방,2681,2114,4795
2022-12-23,신림선,보라매,3792,3388,7180
2022-12-23,신림선,보라매공원,1826,1968,3794
2022-12-23,신림선,보라매병원,7145,7104,14249
2022-12-23,신림선,샛강,2587,3304,5891
2022-12-23,신림선,서울대벤처타운,8476,7959,16435
2022-12-23,신림선,서울지방병무청,2765,3022,5787
2022-12-23,신림선,서원,3530,2952,6482
2022-12-23,신림선,신림,1802,2562,4364
2022-12-23,안산선,고잔,8861,8389,17250
2022-12-23,안산선,대야미,4919,4328,9247
2022-12-23,안산선,반월,4274,3994,8268
2022-12-23,안산선,산본,16315,17601,33916
2022-12-23,안산선,상록수,15632,15763,31395
2022-12-23,안산선,수리산,4124,3187,7311
2022-12-23,안산선,신길온천,1806,1599,3405
2022-12-23,안산선,안산,11477,10640,22117
2022-12-23,안산선,오이도,8271,8133,16404
2022-12-23,안산선,정왕,8534,8635,17169
2022-12-23,안산선,중앙,19133,20765,39898
2022-12-23,안산선,초지,4833,4922,9755
2022-12-23,안산선,한대앞,9604,9492,19096
2022-12-23,우이신설선,4.19민주묘지,2831,2605,5436
2022-12-23,우이신설선,가오리,4251,4194,8445
2022-12-23,우이신설선,보문,1652,1677,3329
2022-12-23,우이신설선,북한산보국문,6463,5988,12451
2022-12-23,우이신설선,북한산우이,2716,2357,5073
2022-12-23,우이신설선,삼양,1986,2075,4061
2022-12-23,우이신설선,삼양사거리,2519,2501,5020
2022-12-23,우이신설선,성신여대입구,3848,4397,8245
2022-12-23,우이신설선,솔밭공원,2505,2316,4821
2022-12-23,우이신설선,솔샘,6119,5714,11833
2022-12-23,우이신설선,신설동,2063,2116,4179
2022-12-23,우이신설선,정릉,4669,4471,9140
2022-12-23,우이신설선,화계,3454,3193,6647
2022-12-23,일산선,대곡,2579,1717,4296
2022-12-23,일산선,대화,11245,10196,21441
2022-12-23,일산선,마두,7086,7248,14334
2022-12-23,일산선,백석,9777,10487,20264
2022-12-23,일산선,삼송,18749,19308,38057
2022-12-23,일산선,원당,9663,9680,19343
2022-12-23,일산선,원흥,10781,10337,21118
2022-12-23,일산선,정발산,7337,7614,14951
2022-12-23,일산선,주엽,8404,8784,17188
2022-12-23,일산선,화정,14852,16953,31805
2022-12-23,장항선,배방,1605,1581,3186
2022-12-23,장항선,봉명,1969,1750,3719
2022-12-23,장항선,신창,1453,1184,2637
2022-12-23,장항선,쌍용,3119,3086,6205
2022-12-23,장항선,아산,5807,5435,11242
2022-12-23,장항선,온양온천,4496,4852,9348
2022-12-23,장항선,탕정,1765,1590,3355
2022-12-23,중앙선,구리,13275,13720,26995
2022-12-23,중앙선,국수,634,640,1274
2022-12-23,중앙선,덕소,5275,5264,10539
2022-12-23,중앙선,도농,11342,10372,21714
2022-12-23,중앙선,도심,2365,1811,4176
2022-12-23,중앙선,망우,7773,7567,15340
2022-12-23,중앙선,상봉,5786,5692,11478
2022-12-23,중앙선,신원,134,152,286
2022-12-23,중앙선,아신,496,486,982
2022-12-23,중앙선,양수,1719,1646,3365
2022-12-23,중앙선,양원,3028,2917,5945
2022-12-23,중앙선,양정,573,464,1037
2022-12-23,중앙선,양평,2971,3096,6067
2022-12-23,중앙선,오빈,235,256,491
2022-12-23,중앙선,용문,1580,1695,3275
2022-12-23,중앙선,운길산,468,434,902
2022-12-23,중앙선,원덕,307,293,600
2022-12-23,중앙선,중랑,5805,5551,11356
2022-12-23,중앙선,지평,44,53,97
2022-12-23,중앙선,팔당,798,887,1685
2022-12-23,중앙선,회기,27184,25196,52380
2022-12-26,1호선,동대문,11310,10751,22061
2022-12-26,1호선,동묘앞,7642,7825,15467
2022-12-26,1호선,서울역,53674,50761,104435
2022-12-26,1호선,시청,26518,26650,53168
2022-12-26,1호선,신설동,14048,13593,27641
2022-12-26,1호선,제기동,17789,18137,35926
2022-12-26,1호선,종각,40193,38696,78889
2022-12-26,1호선,종로3가,26582,24409,50991
2022-12-26,1호선,종로5가,25976,25263,51239
2022-12-26,1호선,청량리,20217,20250,40467
2022-12-26,2호선,강남,83556,80559,164115
2022-12-26,2호선,강변,32159,30749,62908
2022-12-26,2호선,건대입구,36232,38415,74647
2022-12-26,2호선,교대,34527,39091,73618
2022-12-26,2호선,구로디지털단지,60104,60315,120419
2022-12-26,2호선,구의,24554,24413,48967
2022-12-26,2호선,낙성대,26964,26757,53721
2022-12-26,2호선,당산,17884,20947,38831
2022-12-26,2호선,대림,24018,24347,48365
2022-12-26,2호선,도림천,1429,1506,2935
2022-12-26,2호선,동대문역사문화공원,14362,16164,30526
2022-12-26,2호선,뚝섬,22910,24046,46956
2022-12-26,2호선,문래,22374,22706,45080
2022-12-26,2호선,방배,16221,16792,33013
2022-12-26,2호선,봉천,23871,22930,46801
2022-12-26,2호선,사당,38025,42209,80234
2022-12-26,2호선,삼성,55825,55492,111317
2022-12-26,2호선,상왕십리,14594,14304,28898
2022-12-26,2호선,서울대입구,47007,46337,93344
2022-12-26,2호선,서초,21647,20899,42546
2022-12-26,2호선,선릉,59607,52588,112195
2022-12-26,2호선,성수,41838,44722,86560
2022-12-26,2호선,시청,26639,25180,51819
2022-12-26,2호선,신답,1758,2066,3824
2022-12-26,2호선,신당,14523,14879,29402
2022-12-26,2호선,신대방,25378,24745,50123
2022-12-26,2호선,신도림,48959,47688,96647
2022-12-26,2호선,신림,57151,54808,111959
2022-12-26,2호선,신설동,3501,3577,7078
2022-12-26,2호선,신정네거리,10565,10815,21380
2022-12-26,2호선,신촌,37179,38078,75257
2022-12-26,2호선,아현,10589,10257,20846
2022-12-26,2호선,양천구청,6980,7349,14329
2022-12-26,2호선,역삼,53262,59235,112497
2022-12-26,2호선,영등포구청,22642,23259,45901
2022-12-26,2호선,왕십리,17051,15169,32220
2022-12-26,2호선,용답,2897,2839,5736
2022-12-26,2호선,용두,2473,2507,4980
2022-12-26,2호선,을지로3가,24819,25204,50023
2022-12-26,2호선,을지로4가,15423,15774,31197
2022-12-26,2호선,을지로입구,49824,50081,99905
2022-12-26,2호선,이대,14336,15653,29989
2022-12-26,2호선,잠실,82026,81866,163892
2022-12-26,2호선,잠실나루,14887,14560,29447
2022-12-26,2호선,잠실새내,22876,22297,45173
2022-12-26,2호선,종합운동장,7567,8691,16258
2022-12-26,2호선,충정로,10203,10700,20903
2022-12-26,2호선,한양대,9193,10033,19226
2022-12-26,2호선,합정,31191,33025,64216
2022-12-26,2호선,홍대입구,66387,68312,134699
2022-12-26,3호선,가락시장,9416,9264,18680
2022-12-26,3호선,경복궁,22232,22705,44937
2022-12-26,3호선,경찰병원,7575,7749,15324
2022-12-26,3호선,고속터미널,47166,44251,91417
2022-12-26,3호선,교대,15066,9806,24872
2022-12-26,3호선,구파발,21157,20260,41417
2022-12-26,3호선,금호,7982,7506,15488
2022-12-26,3호선,남부터미널,29093,29845,58938
2022-12-26,3호선,녹번,15614,14338,29952
2022-12-26,3호선,대청,10508,9979,20487
2022-12-26,3호선,대치,11309,11250,22559
2022-12-26,3호선,도곡,5280,5286,10566
2022-12-26,3호선,독립문,6928,6978,13906
2022-12-26,3호선,동대입구,7450,8119,15569
2022-12-26,3호선,매봉,12869,12378,25247
2022-12-26,3호선,무악재,4162,4128,8290
2022-12-26,3호선,불광,16131,17291,33422
2022-12-26,3호선,수서,18117,18365,36482
2022-12-26,3호선,신사,31102,32104,63206
2022-12-26,3호선,안국,25147,25945,51092
2022-12-26,3호선,압구정,34198,36779,70977
2022-12-26,3호선,약수,13380,12971,26351
2022-12-26,3호선,양재,37328,40564,77892
2022-12-26,3호선,연신내,35687,34079,69766
2022-12-26,3호선,오금,6327,5657,11984
2022-12-26,3호선,옥수,8683,9054,17737
2022-12-26,3호선,을지로3가,12117,11822,23939
2022-12-26,3호선,일원,11241,10869,22110
2022-12-26,3호선,잠원,4904,4771,9675
2022-12-26,3호선,종로3가,11065,12786,23851
2022-12-26,3호선,지축,6129,6035,12164
2022-12-26,3호선,충무로,4,0,4
2022-12-26,3호선,학여울,1771,1768,3539
2022-12-26,3호선,홍제,17941,17161,35102
2022-12-26,4호선,길음,20470,20092,40562
2022-12-26,4호선,남태령,1222,1129,2351
2022-12-26,4호선,노원,19238,21557,40795
2022-12-26,4호선,당고개,9095,8085,17180
2022-12-26,4호선,동대문,20724,21476,42200
2022-12-26,4호선,동대문역사문화공원,18249,15459,33708
2022-12-26,4호선,동작,1109,1294,2403
2022-12-26,4호선,명동,30556,32285,62841
2022-12-26,4호선,미아,15204,14870,30074
2022-12-26,4호선,미아사거리,27589,27397,54986
2022-12-26,4호선,사당,26078,22261,48339
2022-12-26,4호선,삼각지,6049,6751,12800
2022-12-26,4호선,상계,18911,17873,36784
2022-12-26,4호선,서울역,11918,20286,32204
2022-12-26,4호선,성신여대입구,20608,19914,40522
2022-12-26,4호선,수유,34536,34593,69129
2022-12-26,4호선,숙대입구,13741,13280,27021
2022-12-26,4호선,신용산,18729,19450,38179
2022-12-26,4호선,쌍문,29765,27838,57603
2022-12-26,4호선,이촌,9229,9931,19160
2022-12-26,4호선,창동,24968,26192,51160
2022-12-26,4호선,총신대입구,18954,20678,39632
2022-12-26,4호선,충무로,27732,28863,56595
2022-12-26,4호선,한성대입구,12906,12517,25423
2022-12-26,4호선,혜화,33402,33062,66464
2022-12-26,4호선,회현,27240,28604,55844
2022-12-26,5호선,강동,18853,18083,36936
2022-12-26,5호선,강일,5143,4850,9993
2022-12-26,5호선,개롱,6489,6840,13329
2022-12-26,5호선,개화산,5732,5492,11224
2022-12-26,5호선,거여,10427,10147,20574
2022-12-26,5호선,고덕,9927,9958,19885
2022-12-26,5호선,공덕,14980,15443,30423
2022-12-26,5호선,광나루,13206,12289,25495
2022-12-26,5호선,광화문,34872,35199,70071
2022-12-26,5호선,군자,11688,12727,24415
2022-12-26,5호선,굽은다리,9870,9592,19462
2022-12-26,5호선,길동,8235,8648,16883
2022-12-26,5호선,김포공항,7455,7558,15013
2022-12-26,5호선,까치산,29023,28060,57083
2022-12-26,5호선,답십리,16427,15018,31445
2022-12-26,5호선,동대문역사문화공원,3394,3938,7332
2022-12-26,5호선,둔촌동,8586,8758,17344
2022-12-26,5호선,마곡,11233,11205,22438
2022-12-26,5호선,마장,5862,5605,11467
2022-12-26,5호선,마천,7362,7057,14419
2022-12-26,5호선,마포,15389,15655,31044
2022-12-26,5호선,명일,8531,8802,17333
2022-12-26,5호선,목동,16488,17957,34445
2022-12-26,5호선,미사,17216,17169,34385
2022-12-26,5호선,발산,21292,21874,43166
2022-12-26,5호선,방이,7065,7314,14379
2022-12-26,5호선,방화,6834,6601,13435
2022-12-26,5호선,상일동,15077,14014,29091
2022-12-26,5호선,서대문,20491,21056,41547
2022-12-26,5호선,송정,6865,6404,13269
2022-12-26,5호선,신금호,6435,6824,13259
2022-12-26,5호선,신길,4478,4828,9306
2022-12-26,5호선,신정,13855,11497,25352
2022-12-26,5호선,아차산,14299,13922,28221
2022-12-26,5호선,애오개,6726,6871,13597
2022-12-26,5호선,양평,7335,7500,14835
2022-12-26,5호선,여의나루,10637,13819,24456
2022-12-26,5호선,여의도,31516,32286,63802
2022-12-26,5호선,영등포구청,4251,4328,8579
2022-12-26,5호선,영등포시장,10525,10768,21293
2022-12-26,5호선,오금,3847,3820,7667
2022-12-26,5호선,오목교,22523,23939,46462
2022-12-26,5호선,올림픽공원,4380,3749,8129
2022-12-26,5호선,왕십리,4760,5412,10172
2022-12-26,5호선,우장산,15089,14677,29766
2022-12-26,5호선,을지로4가,6895,7193,14088
2022-12-26,5호선,장한평,18892,18931,37823
2022-12-26,5호선,종로3가,15355,14589,29944
2022-12-26,5호선,천호,18510,18378,36888
2022-12-26,5호선,청구,4067,3743,7810
2022-12-26,5호선,충정로,4789,4804,9593
2022-12-26,5호선,하남검단산,6416,6103,12519
2022-12-26,5호선,하남시청,7352,7248,14600
2022-12-26,5호선,하남풍산,4362,4326,8688
2022-12-26,5호선,행당,8301,7343,15644
2022-12-26,5호선,화곡,29850,27806,57656
2022-12-26,6호선,고려대,8556,8380,16936
2022-12-26,6호선,공덕,19485,19018,38503
2022-12-26,6호선,광흥창,9182,9029,18211
2022-12-26,6호선,구산,7824,6001,13825
2022-12-26,6호선,녹사평,4557,4404,8961
2022-12-26,6호선,대흥,8247,8753,17000
2022-12-26,6호선,독바위,2799,2893,5692
2022-12-26,6호선,돌곶이,10678,9981,20659
2022-12-26,6호선,동묘앞,8242,8477,16719
2022-12-26,6호선,디지털미디어시티,14512,16004,30516
2022-12-26,6호선,마포구청,14509,12939,27448
2022-12-26,6호선,망원,13656,14814,28470
2022-12-26,6호선,버티고개,2105,2172,4277
2022-12-26,6호선,보문,7590,7012,14602
2022-12-26,6호선,봉화산,8999,8474,17473
2022-12-26,6호선,불광,4439,4188,8627
2022-12-26,6호선,삼각지,6271,5727,11998
2022-12-26,6호선,상수,9299,10094,19393
2022-12-26,6호선,상월곡,6268,5662,11930
2022-12-26,6호선,새절,12672,11832,24504
2022-12-26,6호선,석계,12358,13074,25432
2022-12-26,6호선,신당,8375,8962,17337
2022-12-26,6호선,안암,11427,11613,23040
2022-12-26,6호선,약수,3765,3794,7559
2022-12-26,6호선,역촌,3808,4445,8253
2022-12-26,6호선,월곡,11608,11462,23070
2022-12-26,6호선,월드컵경기장,4023,4358,8381
2022-12-26,6호선,응암,17836,17854,35690
2022-12-26,6호선,이태원,9831,9934,19765
2022-12-26,6호선,증산,9986,9992,19978
2022-12-26,6호선,창신,3502,2919,6421
2022-12-26,6호선,청구,3792,4004,7796
2022-12-26,6호선,태릉입구,5589,6041,11630
2022-12-26,6호선,한강진,6585,7560,14145
2022-12-26,6호선,합정,13346,13082,26428
2022-12-26,6호선,화랑대,11624,9019,20643
2022-12-26,6호선,효창공원앞,7105,6527,13632
2022-12-26,7호선,가산디지털단지,45869,45386,91255
2022-12-26,7호선,강남구청,16408,17721,34129
2022-12-26,7호선,건대입구,13272,14080,27352
2022-12-26,7호선,고속터미널,17354,13964,31318
2022-12-26,7호선,공릉,11868,11782,23650
2022-12-26,7호선,광명사거리,21372,21243,42615
2022-12-26,7호선,군자,15411,12275,27686
2022-12-26,7호선,남구로,15775,16442,32217
2022-12-26,7호선,남성,11155,10460,21615
2022-12-26,7호선,내방,14709,14969,29678
2022-12-26,7호선,노원,20900,21737,42637
2022-12-26,7호선,논현,18965,19405,38370
2022-12-26,7호선,대림,8246,8252,16498
2022-12-26,7호선,도봉산,8906,8979,17885
2022-12-26,7호선,뚝섬유원지,7377,7321,14698
2022-12-26,7호선,마들,13315,12613,25928
2022-12-26,7호선,먹골,10341,10367,20708
2022-12-26,7호선,면목,15213,14829,30042
2022-12-26,7호선,반포,6174,6023,12197
2022-12-26,7호선,보라매,7370,7638,15008
2022-12-26,7호선,사가정,16192,16288,32480
2022-12-26,7호선,상도,11024,10863,21887
2022-12-26,7호선,상봉,17017,16387,33404
2022-12-26,7호선,수락산,12871,12718,25589
2022-12-26,7호선,숭실대입구,12156,12521,24677
2022-12-26,7호선,신대방삼거리,15229,14707,29936
2022-12-26,7호선,신풍,11749,10967,22716
2022-12-26,7호선,어린이대공원,12812,12762,25574
2022-12-26,7호선,온수,10272,9336,19608
2022-12-26,7호선,용마산,5833,5723,11556
2022-12-26,7호선,이수,16129,15528,31657
2022-12-26,7호선,장승배기,9427,9372,18799
2022-12-26,7호선,장암,2359,839,3198
2022-12-26,7호선,중계,14505,13214,27719
2022-12-26,7호선,중곡,11244,10641,21885
2022-12-26,7호선,중화,10870,10681,21551
2022-12-26,7호선,천왕,11701,11121,22822
2022-12-26,7호선,철산,21710,22150,43860
2022-12-26,7호선,청담,19227,21481,40708
2022-12-26,7호선,태릉입구,8596,8096,16692
2022-12-26,7호선,하계,18167,17227,35394
2022-12-26,7호선,학동,23994,25272,49266
2022-12-26,8호선,가락시장,8222,9090,17312
2022-12-26,8호선,강동구청,10954,11260,22214
2022-12-26,8호선,남위례,6081,6263,12344
2022-12-26,8호선,남한산성입구,13048,11873,24921
2022-12-26,8호선,단대오거리,11353,11109,22462
2022-12-26,8호선,모란,4501,3527,8028
2022-12-26,8호선,몽촌토성,6118,6258,12376
2022-12-26,8호선,문정,21761,22737,44498
2022-12-26,8호선,복정,8719,7357,16076
2022-12-26,8호선,산성,5107,5089,10196
2022-12-26,8호선,석촌,7820,8955,16775
2022-12-26,8호선,송파,9181,9004,18185
2022-12-26,8호선,수진,5553,5088,10641
2022-12-26,8호선,신흥,5189,5435,10624
2022-12-26,8호선,암사,18975,16883,35858
2022-12-26,8호선,잠실,16885,19433,36318
2022-12-26,8호선,장지,17565,16808,34373
2022-12-26,8호선,천호,15049,17135,32184
2022-12-26,9호선,가양,21609,21291,42900
2022-12-26,9호선,개화,2849,1751,4600
2022-12-26,9호선,고속터미널,13600,18390,31990
2022-12-26,9호선,공항시장,3059,3354,6413
2022-12-26,9호선,구반포,1088,1156,2244
2022-12-26,9호선,국회의사당,16871,17438,34309
2022-12-26,9호선,김포공항,6902,10813,17715
2022-12-26,9호선,노들,4784,4057,8841
2022-12-26,9호선,노량진,26079,25634,51713
2022-12-26,9호선,당산,19074,19131,38205
2022-12-26,9호선,동작,1504,1223,2727
2022-12-26,9호선,등촌,11883,11301,23184
2022-12-26,9호선,마곡나루,12693,12243,24936
2022-12-26,9호선,사평,3864,3754,7618
2022-12-26,9호선,샛강,6445,6613,13058
2022-12-26,9호선,선유도,8938,8607,17545
2022-12-26,9호선,신논현,31566,30793,62359
2022-12-26,9호선,신목동,4177,3585,7762
2022-12-26,9호선,신반포,3568,3524,7092
2022-12-26,9호선,신방화,7048,6894,13942
2022-12-26,9호선,양천향교,9668,10015,19683
2022-12-26,9호선,여의도,30902,29054,59956
2022-12-26,9호선,염창,17959,17447,35406
2022-12-26,9호선,증미,7332,7166,14498
2022-12-26,9호선,흑석,8534,8799,17333
2022-12-26,9호선2~3단계,둔촌오륜,985,1073,2058
2022-12-26,9호선2~3단계,봉은사,18542,19266,37808
2022-12-26,9호선2~3단계,삼성중앙,7709,8301,16010
2022-12-26,9호선2~3단계,삼전,7182,6927,14109
2022-12-26,9호선2~3단계,석촌,8853,7800,16653
2022-12-26,9호선2~3단계,석촌고분,6747,6722,13469
2022-12-26,9호선2~3단계,선정릉,9866,10676,20542
2022-12-26,9호선2~3단계,송파나루,5369,5783,11152
2022-12-26,9호선2~3단계,언주,11145,11455,22600
2022-12-26,9호선2~3단계,올림픽공원,5985,5987,11972
2022-12-26,9호선2~3단계,종합운동장,4479,4437,8916
2022-12-26,9호선2~3단계,중앙보훈병원,11560,10094,21654
2022-12-26,9호선2~3단계,한성백제,2548,2260,4808
2022-12-26,경강선,경기광주,7993,7614,15607
2022-12-26,경강선,곤지암,2269,2322,4591
2022-12-26,경강선,부발,1991,2088,4079
2022-12-26,경강선,삼동,2456,2395,4851
2022-12-26,경강선,세종대왕릉,318,333,651
2022-12-26,경강선,신둔도예촌,1451,1396,2847
2022-12-26,경강선,여주,2234,2162,4396
2022-12-26,경강선,이매,1143,994,2137
2022-12-26,경강선,이천,2720,2843,5563
2022-12-26,경강선,초월,3208,3159,6367
2022-12-26,경강선,판교,5550,5410,10960
2022-12-26,경부선,가산디지털단지,17545,20452,37997
2022-12-26,경부선,관악,7099,6792,13891
2022-12-26,경부선,광명,3743,3132,6875
2022-12-26,경부선,구로,18201,18215,36416
2022-12-26,경부선,군포,7708,7571,15279
2022-12-26,경부선,금정,26645,27295,53940
2022-12-26,경부선,금천구청,11410,11268,22678
2022-12-26,경부선,남영,9463,9998,19461
2022-12-26,경부선,노량진,8456,9044,17500
2022-12-26,경부선,당정,5976,5727,11703
2022-12-26,경부선,대방,10887,11944,22831
2022-12-26,경부선,독산,18260,19039,37299
2022-12-26,경부선,두정,5812,5804,11616
2022-12-26,경부선,명학,8602,8649,17251
2022-12-26,경부선,병점,13996,13846,27842
2022-12-26,경부선,서동탄,1382,1136,2518
2022-12-26,경부선,서울역,9421,2967,12388
2022-12-26,경부선,서정리,7794,7628,15422
2022-12-26,경부선,석수,8956,8144,17100
2022-12-26,경부선,성균관대,13975,14025,28000
2022-12-26,경부선,성환,3456,3596,7052
2022-12-26,경부선,세류,3111,2813,5924
2022-12-26,경부선,세마,2866,2787,5653
2022-12-26,경부선,송탄,4421,4559,8980
2022-12-26,경부선,수원,34825,37019,71844
2022-12-26,경부선,신길,8941,7555,16496
2022-12-26,경부선,신도림,3959,3996,7955
2022-12-26,경부선,안양,21224,20863,42087
2022-12-26,경부선,영등포,41392,42395,83787
2022-12-26,경부선,오산,9422,9571,18993
2022-12-26,경부선,오산대,3404,3078,6482
2022-12-26,경부선,용산,41935,42883,84818
2022-12-26,경부선,의왕,8783,8785,17568
2022-12-26,경부선,직산,896,891,1787
2022-12-26,경부선,진위,1865,1621,3486
2022-12-26,경부선,천안,5251,5473,10724
2022-12-26,경부선,평택,11710,12202,23912
2022-12-26,경부선,평택지제,4625,4590,9215
2022-12-26,경부선,화서,8202,7877,16079
2022-12-26,경원선,가능,6549,6428,12977
2022-12-26,경원선,광운대,7515,7334,14849
2022-12-26,경원선,녹양,4453,4155,8608
2022-12-26,경원선,녹천,4577,3815,8392
2022-12-26,경원선,덕계,3183,2791,5974
2022-12-26,경원선,덕정,5351,5294,10645
2022-12-26,경원선,도봉,5956,5623,11579
2022-12-26,경원선,도봉산,6611,5101,11712
2022-12-26,경원선,동두천,2081,2249,4330
2022-12-26,경원선,동두천중앙,3071,2900,5971
2022-12-26,경원선,망월사,7395,7522,14917
2022-12-26,경원선,방학,9873,9660,19533
2022-12-26,경원선,보산,1539,1712,3251
2022-12-26,경원선,서빙고,2068,1950,4018
2022-12-26,경원선,석계,7804,9046,16850
2022-12-26,경원선,소요산,2128,1692,3820
2022-12-26,경원선,신이문,8557,7829,16386
2022-12-26,경원선,양주,7270,6803,14073
2022-12-26,경원선,옥수,49,50,99
2022-12-26,경원선,왕십리,15691,16648,32339
2022-12-26,경원선,외대앞,7912,7942,15854
2022-12-26,경원선,월계,6565,6207,12772
2022-12-26,경원선,응봉,1822,1583,3405
2022-12-26,경원선,의정부,18453,18656,37109
2022-12-26,경원선,이촌,3669,3012,6681
2022-12-26,경원선,지행,6474,6474,12948
2022-12-26,경원선,청량리,16075,16366,32441
2022-12-26,경원선,한남,4005,3840,7845
2022-12-26,경원선,회룡,12444,12278,24722
2022-12-26,경의선,가좌,5773,5418,11191
2022-12-26,경의선,강매,3324,2806,6130
2022-12-26,경의선,계양,1,0,1
2022-12-26,경의선,곡산,494,521,1015
2022-12-26,경의선,공덕,4035,3387,7422
2022-12-26,경의선,금릉,5204,4958,10162
2022-12-26,경의선,금촌,6824,6730,13554
2022-12-26,경의선,능곡,3797,3474,7271
2022-12-26,경의선,디지털미디어시티,2777,2429,5206
2022-12-26,경의선,문산,5169,5272,10441
2022-12-26,경의선,백마,7015,6679,13694
2022-12-26,경의선,서강대,2115,2104,4219
2022-12-26,경의선,서울역,4555,5916,10471
2022-12-26,경의선,수색,2614,2751,5365
2022-12-26,경의선,신촌,907,1158,2065
2022-12-26,경의선,야당,8074,8106,16180
2022-12-26,경의선,운정,7037,6521,13558
2022-12-26,경의선,운천,5,5,10
2022-12-26,경의선,월롱,2399,2311,4710
2022-12-26,경의선,일산,9392,9169,18561
2022-12-26,경의선,임진강,4,4,8
2022-12-26,경의선,탄현,8136,7527,15663
2022-12-26,경의선,파주,1228,769,1997
2022-12-26,경의선,풍산,5606,5188,10794
2022-12-26,경의선,행신,8208,8203,16411
2022-12-26,경의선,홍대입구,1829,2267,4096
2022-12-26,경의선,화전,1468,1392,2860
2022-12-26,경의선,효창공원앞,3008,3391,6399
2022-12-26,경인선,간석,5765,5477,11242
2022-12-26,경인선,개봉,21756,21564,43320
2022-12-26,경인선,구일,5964,5949,11913
2022-12-26,경인선,도원,3214,3124,6338
2022-12-26,경인선,도화,4007,3687,7694
2022-12-26,경인선,동암,15862,15697,31559
2022-12-26,경인선,동인천,13441,12754,26195
2022-12-26,경인선,백운,6567,6364,12931
2022-12-26,경인선,부개,8531,7999,16530
2022-12-26,경인선,부천,31489,31214,62703
2022-12-26,경인선,부평,28632,29759,58391
2022-12-26,경인선,소사,7900,7741,15641
2022-12-26,경인선,송내,26814,26624,53438
2022-12-26,경인선,역곡,26461,26503,52964
2022-12-26,경인선,오류동,11875,10955,22830
2022-12-26,경인선,온수,6435,6147,12582
2022-12-26,경인선,인천,3245,2465,5710
2022-12-26,경인선,제물포,10311,9918,20229
2022-12-26,경인선,주안,18301,16469,34770
2022-12-26,경인선,중동,9383,8638,18021
2022-12-26,경춘선,가평,2041,1917,3958
2022-12-26,경춘선,갈매,2936,2577,5513
2022-12-26,경춘선,강촌,328,357,685
2022-12-26,경춘선,굴봉산,104,121,225
2022-12-26,경춘선,금곡,1451,1341,2792
2022-12-26,경춘선,김유정,258,238,496
2022-12-26,경춘선,남춘천,2471,2547,5018
2022-12-26,경춘선,대성리,433,450,883
2022-12-26,경춘선,마석,3768,3710,7478
2022-12-26,경춘선,백양리,441,350,791
2022-12-26,경춘선,별내,3119,2894,6013
2022-12-26,경춘선,사릉,2311,2206,4517
2022-12-26,경춘선,상천,210,202,412
2022-12-26,경춘선,신내,2213,2047,4260
2022-12-26,경춘선,천마산,1618,1477,3095
2022-12-26,경춘선,청평,1673,1556,3229
2022-12-26,경춘선,춘천,1254,1132,2386
2022-12-26,경춘선,퇴계원,3595,3356,6951
2022-12-26,경춘선,평내호평,6080,6040,12120
2022-12-26,공항철도,검암,6668,6377,13045
2022-12-26,공항철도,계양,12173,11210,23383
2022-12-26,공항철도,공덕,2636,3537,6173
2022-12-26,공항철도,공항화물청사,2239,2394,4633
2022-12-26,공항철도,김포공항,9918,6361,16279
2022-12-26,공항철도,디지털미디어시티,14226,13361,27587
2022-12-26,공항철도,마곡나루,9070,8859,17929
2022-12-26,공항철도,서울역,12266,10462,22728
2022-12-26,공항철도,영종,3884,3798,7682
2022-12-26,공항철도,운서,8692,8854,17546
2022-12-26,공항철도,인천공항1터미널,12295,11501,23796
2022-12-26,공항철도,인천공항2터미널,4409,3888,8297
2022-12-26,공항철도,청라국제도시,6895,6536,13431
2022-12-26,공항철도,홍대입구,12499,12319,24818
2022-12-26,과천선,경마공원,810,829,1639
2022-12-26,과천선,과천,6373,5922,12295
2022-12-26,과천선,대공원,1680,1765,3445
2022-12-26,과천선,범계,26211,26264,52475
2022-12-26,과천선,선바위,7574,6735,14309
2022-12-26,과천선,인덕원,24236,25017,49253
2022-12-26,과천선,정부과천청사,11004,10918,21922
2022-12-26,과천선,평촌,17941,17740,35681
2022-12-26,분당선,가천대,6718,7566,14284
2022-12-26,분당선,강남구청,9545,10872,20417
2022-12-26,분당선,개포동,4088,4208,8296
2022-12-26,분당선,구룡,2327,2186,4513
2022-12-26,분당선,구성,4972,5208,10180
2022-12-26,분당선,기흥,9987,9447,19434
2022-12-26,분당선,대모산입구,4874,4527,9401
2022-12-26,분당선,도곡,7736,7554,15290
2022-12-26,분당선,망포,14931,14344,29275
2022-12-26,분당선,매교,4568,4495,9063
2022-12-26,분당선,매탄권선,5148,4916,10064
2022-12-26,분당선,모란,19197,19797,38994
2022-12-26,분당선,미금,15765,16804,32569
2022-12-26,분당선,보정,2782,2390,5172
2022-12-26,분당선,복정,1,0,1
2022-12-26,분당선,상갈,5343,5133,10476
2022-12-26,분당선,서울숲,11590,12045,23635
2022-12-26,분당선,서현,25800,25866,51666
2022-12-26,분당선,선릉,14002,21268,35270
2022-12-26,분당선,선정릉,7673,7992,15665
2022-12-26,분당선,수내,14295,14106,28401
2022-12-26,분당선,수서,14253,14843,29096
2022-12-26,분당선,수원,7953,6827,14780
2022-12-26,분당선,수원시청,13278,13756,27034
2022-12-26,분당선,신갈,5006,4863,9869
2022-12-26,분당선,압구정로데오,19530,21219,40749
2022-12-26,분당선,야탑,26417,27806,54223
2022-12-26,분당선,영통,8424,8493,16917
2022-12-26,분당선,오리,11674,9765,21439
2022-12-26,분당선,이매,5679,5249,10928
2022-12-26,분당선,정자,18592,19291,37883
2022-12-26,분당선,죽전,13148,14703,27851
2022-12-26,분당선,청명,4359,4238,8597
2022-12-26,분당선,태평,13417,12860,26277
2022-12-26,분당선,한티,14930,16113,31043
2022-12-26,수인선,고색,4778,4392,9170
2022-12-26,수인선,남동인더스파크,2094,2481,4575
2022-12-26,수인선,달월,103,69,172
2022-12-26,수인선,사리,4872,4275,9147
2022-12-26,수인선,소래포구,4629,4128,8757
2022-12-26,수인선,송도,2415,2158,4573
2022-12-26,수인선,숭의,4061,3775,7836
2022-12-26,수인선,신포,1756,1760,3516
2022-12-26,수인선,야목,327,259,586
2022-12-26,수인선,어천,977,964,1941
2022-12-26,수인선,연수,4498,4446,8944
2022-12-26,수인선,오목천,3094,2946,6040
2022-12-26,수인선,원인재,4245,4424,8669
2022-12-26,수인선,월곶,2656,2410,5066
2022-12-26,수인선,인천,1038,1546,2584
2022-12-26,수인선,인천논현,5595,5934,11529
2022-12-26,수인선,인하대,5879,5655,11534
2022-12-26,수인선,호구포,4193,4348,8541
2022-12-26,신림선,관악산,2002,2075,4077
2022-12-26,신림선,당곡,4286,4379,8665
2022-12-26,신림선,대방,2466,2034,4500
2022-12-26,신림선,보라매,3639,3354,6993
2022-12-26,신림선,보라매공원,1851,2000,3851
2022-12-26,신림선,보라매병원,7043,7484,14527
2022-12-26,신림선,샛강,2643,3211,5854
2022-12-26,신림선,서울대벤처타운,7969,7803,15772
2022-12-26,신림선,서울지방병무청,2794,3008,5802
2022-12-26,신림선,서원,3271,2870,6141
2022-12-26,신림선,신림,1717,2284,4001
2022-12-26,안산선,고잔,8836,8346,17182
2022-12-26,안산선,대야미,4818,4461,9279
2022-12-26,안산선,반월,4232,4130,8362
2022-12-26,안산선,산본,15965,17271,33236
2022-12-26,안산선,상록수,14950,15312,30262
2022-12-26,안산선,수리산,4043,3391,7434
2022-12-26,안산선,신길온천,1754,1607,3361
2022-12-26,안산선,안산,11245,10079,21324
2022-12-26,안산선,오이도,7679,7619,15298
2022-12-26,안산선,정왕,7920,8143,16063
2022-12-26,안산선,중앙,17514,18107,35621
2022-12-26,안산선,초지,4752,4754,9506
2022-12-26,안산선,한대앞,8909,8928,17837
2022-12-26,우이신설선,4.19민주묘지,2855,2755,5610
2022-12-26,우이신설선,가오리,4243,4196,8439
2022-12-26,우이신설선,보문,1545,1564,3109
2022-12-26,우이신설선,북한산보국문,6132,5969,12101
2022-12-26,우이신설선,북한산우이,2418,2150,4568
2022-12-26,우이신설선,삼양,2044,2170,4214
2022-12-26,우이신설선,삼양사거리,2449,2527,4976
2022-12-26,우이신설선,성신여대입구,3492,3805,7297
2022-12-26,우이신설선,솔밭공원,2587,2384,4971
2022-12-26,우이신설선,솔샘,6214,5908,12122
2022-12-26,우이신설선,신설동,2250,2120,4370
2022-12-26,우이신설선,정릉,4535,4401,8936
2022-12-26,우이신설선,화계,3391,3155,6546
2022-12-26,일산선,대곡,2047,1510,3557
2022-12-26,일산선,대화,13074,9936,23010
2022-12-26,일산선,마두,7796,7920,15716
2022-12-26,일산선,백석,9906,9904,19810
2022-12-26,일산선,삼송,19714,19199,38913
2022-12-26,일산선,원당,10899,10289,21188
2022-12-26,일산선,원흥,11378,10660,22038
2022-12-26,일산선,정발산,6955,7056,14011
2022-12-26,일산선,주엽,9368,9342,18710
2022-12-26,일산선,화정,16887,17109,33996
2022-12-26,장항선,배방,1162,1058,2220
2022-12-26,장항선,봉명,1372,1373,2745
2022-12-26,장항선,신창,1102,1225,2327
2022-12-26,장항선,쌍용,2116,2013,4129
2022-12-26,장항선,아산,3714,3186,6900
2022-12-26,장항선,온양온천,4154,4324,8478
2022-12-26,장항선,탕정,1069,1031,2100
2022-12-26,중앙선,구리,13302,13380,26682
2022-12-26,중앙선,국수,759,727,1486
2022-12-26,중앙선,덕소,5386,5362,10748
2022-12-26,중앙선,도농,11206,10132,21338
2022-12-26,중앙선,도심,2445,1927,4372
2022-12-26,중앙선,망우,7259,7234,14493
2022-12-26,중앙선,상봉,5723,5693,11416
2022-12-26,중앙선,신원,214,179,393
2022-12-26,중앙선,아신,513,513,1026
2022-12-26,중앙선,양수,1839,1868,3707
2022-12-26,중앙선,양원,3137,2935,6072
2022-12-26,중앙선,양정,615,504,1119
2022-12-26,중앙선,양평,2801,2783,5584
2022-12-26,중앙선,오빈,319,276,595
2022-12-26,중앙선,용문,1568,1529,3097
2022-12-26,중앙선,운길산,544,546,1090
2022-12-26,중앙선,원덕,310,290,600
2022-12-26,중앙선,중랑,5559,5309,10868
2022-12-26,중앙선,지평,52,58,110
2022-12-26,중앙선,팔당,785,747,1532
2022-12-26,중앙선,회기,25284,24488,49772
2022-12-27,1호선,동대문,11957,11237,23194
2022-12-27,1호선,동묘앞,7996,8234,16230
2022-12-27,1호선,서울역,52705,50977,103682
2022-12-27,1호선,시청,28147,28643,56790
2022-12-27,1호선,신설동,14150,13741,27891
2022-12-27,1호선,제기동,18906,19457,38363
2022-12-27,1호선,종각,42389,41224,83613
2022-12-27,1호선,종로3가,29159,26711,55870
2022-12-27,1호선,종로5가,27207,26303,53510
2022-12-27,1호선,청량리,20803,21051,41854
2022-12-27,2호선,강남,88608,85511,174119
2022-12-27,2호선,강변,32369,30077,62446
2022-12-27,2호선,건대입구,37738,40420,78158
2022-12-27,2호선,교대,36853,41603,78456
2022-12-27,2호선,구로디지털단지,63494,63119,126613
2022-12-27,2호선,구의,25869,25466,51335
2022-12-27,2호선,낙성대,28541,27882,56423
2022-12-27,2호선,당산,19281,22414,41695
2022-12-27,2호선,대림,24680,24985,49665
2022-12-27,2호선,도림천,1452,1568,3020
2022-12-27,2호선,동대문역사문화공원,14841,16778,31619
2022-12-27,2호선,뚝섬,24317,26132,50449
2022-12-27,2호선,문래,24252,24591,48843
2022-12-27,2호선,방배,17040,17643,34683
2022-12-27,2호선,봉천,25035,23611,48646
2022-12-27,2호선,사당,42083,46218,88301
2022-12-27,2호선,삼성,58745,58565,117310
2022-12-27,2호선,상왕십리,15189,14838,30027
2022-12-27,2호선,서울대입구,49231,48285,97516
2022-12-27,2호선,서초,23499,22676,46175
2022-12-27,2호선,선릉,63038,55955,118993
2022-12-27,2호선,성수,45003,48399,93402
2022-12-27,2호선,시청,28949,27260,56209
2022-12-27,2호선,신답,1862,2081,3943
2022-12-27,2호선,신당,15146,15723,30869
2022-12-27,2호선,신대방,26022,25310,51332
2022-12-27,2호선,신도림,51731,50963,102694
2022-12-27,2호선,신림,59300,57090,116390
2022-12-27,2호선,신설동,3407,3478,6885
2022-12-27,2호선,신정네거리,11038,11362,22400
2022-12-27,2호선,신촌,38920,39531,78451
2022-12-27,2호선,아현,11026,10444,21470
2022-12-27,2호선,양천구청,7497,7724,15221
2022-12-27,2호선,역삼,56475,63562,120037
2022-12-27,2호선,영등포구청,23819,24623,48442
2022-12-27,2호선,왕십리,17592,15554,33146
2022-12-27,2호선,용답,2933,2858,5791
2022-12-27,2호선,용두,2573,2651,5224
2022-12-27,2호선,을지로3가,26264,26678,52942
2022-12-27,2호선,을지로4가,16121,16609,32730
2022-12-27,2호선,을지로입구,52401,53423,105824
2022-12-27,2호선,이대,15358,16567,31925
2022-12-27,2호선,잠실,86525,85445,171970
2022-12-27,2호선,잠실나루,15209,14797,30006
2022-12-27,2호선,잠실새내,23930,23799,47729
2022-12-27,2호선,종합운동장,8193,8890,17083
2022-12-27,2호선,충정로,10533,11107,21640
2022-12-27,2호선,한양대,9308,10065,19373
2022-12-27,2호선,합정,33921,36460,70381
2022-12-27,2호선,홍대입구,68991,72839,141830
2022-12-27,3호선,가락시장,9989,9956,19945
2022-12-27,3호선,경복궁,22509,22597,45106
2022-12-27,3호선,경찰병원,7853,8035,15888
2022-12-27,3호선,고속터미널,46683,44169,90852
2022-12-27,3호선,교대,15864,10183,26047
2022-12-27,3호선,구파발,22378,21429,43807
2022-12-27,3호선,금호,8253,7704,15957
2022-12-27,3호선,남부터미널,30936,32000,62936
2022-12-27,3호선,녹번,16447,14858,31305
2022-12-27,3호선,대청,11004,10287,21291
2022-12-27,3호선,대치,11838,11963,23801
2022-12-27,3호선,도곡,5415,5461,10876
2022-12-27,3호선,독립문,7706,7686,15392
2022-12-27,3호선,동대입구,7746,8523,16269
2022-12-27,3호선,매봉,13680,13201,26881
2022-12-27,3호선,무악재,4413,4395,8808
2022-12-27,3호선,불광,16948,18129,35077
2022-12-27,3호선,수서,17988,18849,36837
2022-12-27,3호선,신사,33057,34421,67478
2022-12-27,3호선,안국,27016,28468,55484
2022-12-27,3호선,압구정,36136,39059,75195
2022-12-27,3호선,약수,13730,13370,27100
2022-12-27,3호선,양재,39597,43031,82628
2022-12-27,3호선,연신내,37150,35105,72255
2022-12-27,3호선,오금,6655,5952,12607
2022-12-27,3호선,옥수,9179,9451,18630
2022-12-27,3호선,을지로3가,12101,12067,24168
2022-12-27,3호선,일원,11475,10928,22403
2022-12-27,3호선,잠원,5078,4943,10021
2022-12-27,3호선,종로3가,11381,13318,24699
2022-12-27,3호선,지축,6463,6332,12795
2022-12-27,3호선,충무로,1,0,1
2022-12-27,3호선,학여울,1824,1861,3685
2022-12-27,3호선,홍제,18454,17406,35860
2022-12-27,4호선,길음,21891,21270,43161
2022-12-27,4호선,남태령,1274,1154,2428
2022-12-27,4호선,노원,19886,22353,42239
2022-12-27,4호선,당고개,9366,8491,17857
2022-12-27,4호선,동대문,21130,22184,43314
2022-12-27,4호선,동대문역사문화공원,18847,16250,35097
2022-12-27,4호선,동작,1114,1316,2430
2022-12-27,4호선,명동,30019,32282,62301
2022-12-27,4호선,미아,15843,15187,31030
2022-12-27,4호선,미아사거리,28686,28242,56928
2022-12-27,4호선,사당,28002,24165,52167
2022-12-27,4호선,삼각지,6337,7312,13649
2022-12-27,4호선,상계,20024,18549,38573
2022-12-27,4호선,서울역,12761,21128,33889
2022-12-27,4호선,성신여대입구,20985,20400,41385
2022-12-27,4호선,수유,36097,36384,72481
2022-12-27,4호선,숙대입구,14672,14195,28867
2022-12-27,4호선,신용산,19526,20249,39775
2022-12-27,4호선,쌍문,31110,28894,60004
2022-12-27,4호선,이촌,10431,11021,21452
2022-12-27,4호선,창동,26122,27668,53790
2022-12-27,4호선,총신대입구,19690,21606,41296
2022-12-27,4호선,충무로,29185,30347,59532
2022-12-27,4호선,한성대입구,13730,13053,26783
2022-12-27,4호선,혜화,37825,37732,75557
2022-12-27,4호선,회현,28539,30046,58585
2022-12-27,5호선,강동,19430,18696,38126
2022-12-27,5호선,강일,5474,5043,10517
2022-12-27,5호선,개롱,6819,7013,13832
2022-12-27,5호선,개화산,5976,5598,11574
2022-12-27,5호선,거여,10726,10341,21067
2022-12-27,5호선,고덕,10320,10157,20477
2022-12-27,5호선,공덕,15911,16488,32399
2022-12-27,5호선,광나루,14153,13042,27195
2022-12-27,5호선,광화문,37585,38666,76251
2022-12-27,5호선,군자,12232,13767,25999
2022-12-27,5호선,굽은다리,10278,9896,20174
2022-12-27,5호선,길동,8415,8832,17247
2022-12-27,5호선,김포공항,7945,7807,15752
2022-12-27,5호선,까치산,30275,29060,59335
2022-12-27,5호선,답십리,17199,15630,32829
2022-12-27,5호선,동대문역사문화공원,3455,3991,7446
2022-12-27,5호선,둔촌동,8978,9098,18076
2022-12-27,5호선,마곡,11773,11732,23505
2022-12-27,5호선,마장,6395,6066,12461
2022-12-27,5호선,마천,7867,7428,15295
2022-12-27,5호선,마포,16204,16720,32924
2022-12-27,5호선,명일,8943,9206,18149
2022-12-27,5호선,목동,17467,18962,36429
2022-12-27,5호선,미사,17432,17328,34760
2022-12-27,5호선,발산,21921,22905,44826
2022-12-27,5호선,방이,7488,7734,15222
2022-12-27,5호선,방화,7169,6965,14134
2022-12-27,5호선,상일동,15328,14315,29643
2022-12-27,5호선,서대문,21796,22418,44214
2022-12-27,5호선,송정,6883,6254,13137
2022-12-27,5호선,신금호,6704,7016,13720
2022-12-27,5호선,신길,4659,5073,9732
2022-12-27,5호선,신정,14587,11980,26567
2022-12-27,5호선,아차산,15403,14758,30161
2022-12-27,5호선,애오개,7194,7067,14261
2022-12-27,5호선,양평,7792,7625,15417
2022-12-27,5호선,여의나루,10926,13895,24821
2022-12-27,5호선,여의도,32445,33339,65784
2022-12-27,5호선,영등포구청,4428,4439,8867
2022-12-27,5호선,영등포시장,11010,11373,22383
2022-12-27,5호선,오금,3954,4065,8019
2022-12-27,5호선,오목교,23432,24718,48150
2022-12-27,5호선,올림픽공원,4565,3898,8463
2022-12-27,5호선,왕십리,4859,5695,10554
2022-12-27,5호선,우장산,15532,15125,30657
2022-12-27,5호선,을지로4가,7270,7520,14790
2022-12-27,5호선,장한평,19765,19856,39621
2022-12-27,5호선,종로3가,16333,15617,31950
2022-12-27,5호선,천호,19504,19346,38850
2022-12-27,5호선,청구,4136,3791,7927
2022-12-27,5호선,충정로,4859,4927,9786
2022-12-27,5호선,하남검단산,6636,6332,12968
2022-12-27,5호선,하남시청,7604,7531,15135
2022-12-27,5호선,하남풍산,4519,4483,9002
2022-12-27,5호선,행당,8698,7635,16333
2022-12-27,5호선,화곡,30341,28531,58872
2022-12-27,6호선,고려대,8674,8380,17054
2022-12-27,6호선,공덕,20500,19958,40458
2022-12-27,6호선,광흥창,9664,9491,19155
2022-12-27,6호선,구산,8430,6429,14859
2022-12-27,6호선,녹사평,5015,5000,10015
2022-12-27,6호선,대흥,8767,9075,17842
2022-12-27,6호선,독바위,2914,2997,5911
2022-12-27,6호선,돌곶이,10106,9291,19397
2022-12-27,6호선,동묘앞,8492,8647,17139
2022-12-27,6호선,디지털미디어시티,15217,16969,32186
2022-12-27,6호선,마포구청,15058,13727,28785
2022-12-27,6호선,망원,14696,15739,30435
2022-12-27,6호선,버티고개,2133,2196,4329
2022-12-27,6호선,보문,8053,7366,15419
2022-12-27,6호선,봉화산,9332,8884,18216
2022-12-27,6호선,불광,4553,4352,8905
2022-12-27,6호선,삼각지,7876,7007,14883
2022-12-27,6호선,상수,9716,10905,20621
2022-12-27,6호선,상월곡,6469,5703,12172
2022-12-27,6호선,새절,13384,12375,25759
2022-12-27,6호선,석계,13150,13560,26710
2022-12-27,6호선,신내,1,0,1
2022-12-27,6호선,신당,9259,9637,18896
2022-12-27,6호선,안암,11883,11864,23747
2022-12-27,6호선,약수,3867,3961,7828
2022-12-27,6호선,역촌,3844,4595,8439
2022-12-27,6호선,연신내,1,0,1
2022-12-27,6호선,월곡,11974,11846,23820
2022-12-27,6호선,월드컵경기장,4318,4591,8909
2022-12-27,6호선,응암,18444,18388,36832
2022-12-27,6호선,이태원,10364,10570,20934
2022-12-27,6호선,증산,10455,10275,20730
2022-12-27,6호선,창신,3755,3077,6832
2022-12-27,6호선,청구,3996,4114,8110
2022-12-27,6호선,태릉입구,5909,6343,12252
2022-12-27,6호선,한강진,8890,10048,18938
2022-12-27,6호선,합정,14602,14254,28856
2022-12-27,6호선,화랑대,12189,9341,21530
2022-12-27,6호선,효창공원앞,7316,6608,13924
2022-12-27,7호선,가산디지털단지,47305,47206,94511
2022-12-27,7호선,강남구청,17783,19624,37407
2022-12-27,7호선,건대입구,13888,14587,28475
2022-12-27,7호선,고속터미널,17107,14383,31490
2022-12-27,7호선,공릉,12324,12097,24421
2022-12-27,7호선,광명사거리,22043,21875,43918
2022-12-27,7호선,군자,16310,12837,29147
2022-12-27,7호선,남구로,16060,17134,33194
2022-12-27,7호선,남성,11778,11060,22838
2022-12-27,7호선,내방,15438,15902,31340
2022-12-27,7호선,노원,21655,22733,44388
2022-12-27,7호선,논현,20335,21064,41399
2022-12-27,7호선,대림,8392,8591,16983
2022-12-27,7호선,도봉산,9276,10094,19370
2022-12-27,7호선,뚝섬유원지,7934,7708,15642
2022-12-27,7호선,마들,13765,13045,26810
2022-12-27,7호선,먹골,10766,10539,21305
2022-12-27,7호선,면목,15523,15061,30584
2022-12-27,7호선,반포,6376,6286,12662
2022-12-27,7호선,보라매,7662,7869,15531
2022-12-27,7호선,사가정,16976,17015,33991
2022-12-27,7호선,상도,11788,11429,23217
2022-12-27,7호선,상봉,17950,17144,35094
2022-12-27,7호선,수락산,13173,13043,26216
2022-12-27,7호선,숭실대입구,12600,12804,25404
2022-12-27,7호선,신대방삼거리,15688,14982,30670
2022-12-27,7호선,신풍,12085,11513,23598
2022-12-27,7호선,어린이대공원,13553,13459,27012
2022-12-27,7호선,온수,10482,9534,20016
2022-12-27,7호선,용마산,5980,5781,11761
2022-12-27,7호선,이수,17379,16641,34020
2022-12-27,7호선,장승배기,9872,9443,19315
2022-12-27,7호선,장암,2508,955,3463
2022-12-27,7호선,중계,14936,13452,28388
2022-12-27,7호선,중곡,11383,10713,22096
2022-12-27,7호선,중화,11290,11022,22312
2022-12-27,7호선,천왕,12223,11573,23796
2022-12-27,7호선,철산,22650,22927,45577
2022-12-27,7호선,청담,20325,22919,43244
2022-12-27,7호선,태릉입구,9045,8579,17624
2022-12-27,7호선,하계,18584,17384,35968
2022-12-27,7호선,학동,25234,26819,52053
2022-12-27,8호선,가락시장,8887,9610,18497
2022-12-27,8호선,강동구청,11262,11412,22674
2022-12-27,8호선,남위례,6452,6684,13136
2022-12-27,8호선,남한산성입구,13750,12360,26110
2022-12-27,8호선,단대오거리,11816,11442,23258
2022-12-27,8호선,모란,4859,3944,8803
2022-12-27,8호선,몽촌토성,6410,6532,12942
2022-12-27,8호선,문정,22664,23974,46638
2022-12-27,8호선,복정,9359,7820,17179
2022-12-27,8호선,산성,5380,5420,10800
2022-12-27,8호선,석촌,8171,9344,17515
2022-12-27,8호선,송파,9801,9620,19421
2022-12-27,8호선,수진,5755,5309,11064
2022-12-27,8호선,신흥,5361,5678,11039
2022-12-27,8호선,암사,19877,17558,37435
2022-12-27,8호선,잠실,17303,20128,37431
2022-12-27,8호선,장지,18416,17555,35971
2022-12-27,8호선,천호,15577,17903,33480
2022-12-27,9호선,가양,22601,22223,44824
2022-12-27,9호선,개화,2849,1839,4688
2022-12-27,9호선,고속터미널,13753,18594,32347
2022-12-27,9호선,공항시장,3080,3363,6443
2022-12-27,9호선,구반포,1202,1219,2421
2022-12-27,9호선,국회의사당,18330,18338,36668
2022-12-27,9호선,김포공항,7690,10922,18612
2022-12-27,9호선,노들,4769,4000,8769
2022-12-27,9호선,노량진,27942,27105,55047
2022-12-27,9호선,당산,20226,20282,40508
2022-12-27,9호선,동작,1736,1284,3020
2022-12-27,9호선,등촌,12295,11741,24036
2022-12-27,9호선,마곡나루,13768,13508,27276
2022-12-27,9호선,사평,3975,3813,7788
2022-12-27,9호선,샛강,6811,6840,13651
2022-12-27,9호선,선유도,9283,8917,18200
2022-12-27,9호선,신논현,33189,32656,65845
2022-12-27,9호선,신목동,4365,3812,8177
2022-12-27,9호선,신반포,3731,3650,7381
2022-12-27,9호선,신방화,7239,7099,14338
2022-12-27,9호선,양천향교,10065,10422,20487
2022-12-27,9호선,여의도,31917,30366,62283
2022-12-27,9호선,염창,18417,17903,36320
2022-12-27,9호선,증미,7602,7146,14748
2022-12-27,9호선,흑석,8726,9102,17828
2022-12-27,9호선2~3단계,둔촌오륜,1009,1048,2057
2022-12-27,9호선2~3단계,봉은사,19675,20231,39906
2022-12-27,9호선2~3단계,삼성중앙,8101,8628,16729
2022-12-27,9호선2~3단계,삼전,7553,7212,14765
2022-12-27,9호선2~3단계,석촌,9307,8341,17648
2022-12-27,9호선2~3단계,석촌고분,7073,6882,13955
2022-12-27,9호선2~3단계,선정릉,10361,11504,21865
2022-12-27,9호선2~3단계,송파나루,5752,6315,12067
2022-12-27,9호선2~3단계,언주,11804,12258,24062
2022-12-27,9호선2~3단계,올림픽공원,6451,6446,12897
2022-12-27,9호선2~3단계,종합운동장,4601,4797,9398
2022-12-27,9호선2~3단계,중앙보훈병원,12494,10672,23166
2022-12-27,9호선2~3단계,한성백제,2800,2462,5262
2022-12-27,경강선,경기광주,8636,7731,16367
2022-12-27,경강선,곤지암,2411,2254,4665
2022-12-27,경강선,부발,2131,1943,4074
2022-12-27,경강선,삼동,2635,2404,5039
2022-12-27,경강선,세종대왕릉,375,337,712
2022-12-27,경강선,신둔도예촌,1527,1390,2917
2022-12-27,경강선,여주,2186,2095,4281
2022-12-27,경강선,이매,1250,1101,2351
2022-12-27,경강선,이천,2711,2822,5533
2022-12-27,경강선,초월,3374,3154,6528
2022-12-27,경강선,판교,5883,5866,11749
2022-12-27,경부선,가산디지털단지,18223,21056,39279
2022-12-27,경부선,관악,7638,7329,14967
2022-12-27,경부선,광명,3384,2954,6338
2022-12-27,경부선,구로,18695,18929,37624
2022-12-27,경부선,군포,8116,7851,15967
2022-12-27,경부선,금정,28136,28636,56772
2022-12-27,경부선,금천구청,11936,11990,23926
2022-12-27,경부선,남영,9920,10315,20235
2022-12-27,경부선,노량진,8990,9780,18770
2022-12-27,경부선,당정,6212,5927,12139
2022-12-27,경부선,대방,11378,12300,23678
2022-12-27,경부선,독산,19154,19743,38897
2022-12-27,경부선,두정,5783,5736,11519
2022-12-27,경부선,명학,9215,9100,18315
2022-12-27,경부선,병점,14692,14523,29215
2022-12-27,경부선,서동탄,1373,1221,2594
2022-12-27,경부선,서울역,8464,2604,11068
2022-12-27,경부선,서정리,8166,7334,15500
2022-12-27,경부선,석수,9438,8707,18145
2022-12-27,경부선,성균관대,14925,14685,29610
2022-12-27,경부선,성환,3460,3517,6977
2022-12-27,경부선,세류,3134,2883,6017
2022-12-27,경부선,세마,3015,2908,5923
2022-12-27,경부선,송탄,4403,4351,8754
2022-12-27,경부선,수원,34892,37325,72217
2022-12-27,경부선,신길,9000,7708,16708
2022-12-27,경부선,신도림,4184,4219,8403
2022-12-27,경부선,안양,22279,22020,44299
2022-12-27,경부선,영등포,42675,43578,86253
2022-12-27,경부선,오산,9461,9559,19020
2022-12-27,경부선,오산대,3554,3283,6837
2022-12-27,경부선,용산,40970,41643,82613
2022-12-27,경부선,의왕,9163,9079,18242
2022-12-27,경부선,직산,872,900,1772
2022-12-27,경부선,진위,1922,1781,3703
2022-12-27,경부선,천안,5225,5437,10662
2022-12-27,경부선,평택,11652,11442,23094
2022-12-27,경부선,평택지제,4366,4428,8794
2022-12-27,경부선,화서,8602,8262,16864
2022-12-27,경원선,가능,6776,6568,13344
2022-12-27,경원선,광운대,7852,7408,15260
2022-12-27,경원선,녹양,4768,4532,9300
2022-12-27,경원선,녹천,4812,3978,8790
2022-12-27,경원선,덕계,3370,3019,6389
2022-12-27,경원선,덕정,5536,5466,11002
2022-12-27,경원선,도봉,6082,5885,11967
2022-12-27,경원선,도봉산,7112,4743,11855
2022-12-27,경원선,동두천,2074,2222,4296
2022-12-27,경원선,동두천중앙,3048,3012,6060
2022-12-27,경원선,망월사,7724,7850,15574
2022-12-27,경원선,방학,10332,10050,20382
2022-12-27,경원선,보산,1425,1320,2745
2022-12-27,경원선,서빙고,2113,1957,4070
2022-12-27,경원선,석계,8174,9400,17574
2022-12-27,경원선,소요산,2273,1897,4170
2022-12-27,경원선,신이문,8878,8004,16882
2022-12-27,경원선,양주,7579,7028,14607
2022-12-27,경원선,옥수,58,42,100
2022-12-27,경원선,왕십리,16289,17186,33475
2022-12-27,경원선,외대앞,8064,7946,16010
2022-12-27,경원선,월계,6906,6527,13433
2022-12-27,경원선,응봉,1931,1655,3586
2022-12-27,경원선,의정부,18741,19184,37925
2022-12-27,경원선,이촌,3979,3191,7170
2022-12-27,경원선,지행,6654,6570,13224
2022-12-27,경원선,청량리,16471,16853,33324
2022-12-27,경원선,한남,4161,4015,8176
2022-12-27,경원선,회룡,13139,12841,25980
2022-12-27,경의선,가좌,5930,5518,11448
2022-12-27,경의선,강매,3390,2920,6310
2022-12-27,경의선,계양,1,0,1
2022-12-27,경의선,곡산,580,609,1189
2022-12-27,경의선,공덕,4243,3368,7611
2022-12-27,경의선,금릉,5426,5167,10593
2022-12-27,경의선,금촌,6779,6568,13347
2022-12-27,경의선,능곡,4044,3669,7713
2022-12-27,경의선,디지털미디어시티,2828,2503,5331
2022-12-27,경의선,문산,5473,5116,10589
2022-12-27,경의선,백마,7308,6903,14211
2022-12-27,경의선,서강대,2092,2070,4162
2022-12-27,경의선,서울역,4378,5915,10293
2022-12-27,경의선,수색,2752,3031,5783
2022-12-27,경의선,신촌,918,1234,2152
2022-12-27,경의선,야당,8539,8557,17096
2022-12-27,경의선,운정,7278,6676,13954
2022-12-27,경의선,운천,5,6,11
2022-12-27,경의선,월롱,2532,2370,4902
2022-12-27,경의선,일산,9718,9632,19350
2022-12-27,경의선,임진강,7,3,10
2022-12-27,경의선,탄현,8140,7747,15887
2022-12-27,경의선,파주,1218,811,2029
2022-12-27,경의선,풍산,6043,5553,11596
2022-12-27,경의선,행신,8482,8308,16790
2022-12-27,경의선,홍대입구,1841,2335,4176
2022-12-27,경의선,화전,1708,1581,3289
2022-12-27,경의선,효창공원앞,3153,3651,6804
2022-12-27,경인선,간석,6022,5741,11763
2022-12-27,경인선,개봉,22624,22173,44797
2022-12-27,경인선,구일,6423,6289,12712
2022-12-27,경인선,도원,3134,3200,6334
2022-12-27,경인선,도화,4200,3897,8097
2022-12-27,경인선,동암,16545,16574,33119
2022-12-27,경인선,동인천,14105,13329,27434
2022-12-27,경인선,백운,6980,6731,13711
2022-12-27,경인선,부개,8861,8193,17054
2022-12-27,경인선,부천,32517,32299,64816
2022-12-27,경인선,부평,28919,30761,59680
2022-12-27,경인선,소사,8259,8066,16325
2022-12-27,경인선,송내,27867,27743,55610
2022-12-27,경인선,역곡,27514,27320,54834
2022-12-27,경인선,오류동,11801,11238,23039
2022-12-27,경인선,온수,6809,6376,13185
2022-12-27,경인선,인천,3673,2685,6358
2022-12-27,경인선,제물포,10675,10178,20853
2022-12-27,경인선,주안,18988,17093,36081
2022-12-27,경인선,중동,9498,8802,18300
2022-12-27,경춘선,가평,2033,1853,3886
2022-12-27,경춘선,갈매,3102,2621,5723
2022-12-27,경춘선,강촌,361,327,688
2022-12-27,경춘선,굴봉산,138,147,285
2022-12-27,경춘선,금곡,1477,1459,2936
2022-12-27,경춘선,김유정,264,311,575
2022-12-27,경춘선,남춘천,2726,2791,5517
2022-12-27,경춘선,대성리,510,530,1040
2022-12-27,경춘선,마석,3919,3913,7832
2022-12-27,경춘선,백양리,361,332,693
2022-12-27,경춘선,별내,3301,3054,6355
2022-12-27,경춘선,사릉,2308,2264,4572
2022-12-27,경춘선,상천,190,182,372
2022-12-27,경춘선,신내,2335,2139,4474
2022-12-27,경춘선,천마산,1708,1534,3242
2022-12-27,경춘선,청평,1689,1540,3229
2022-12-27,경춘선,춘천,1238,1143,2381
2022-12-27,경춘선,퇴계원,3719,3332,7051
2022-12-27,경춘선,평내호평,6312,6114,12426
2022-12-27,공항철도,검암,6866,6675,13541
2022-12-27,공항철도,계양,12733,11576,24309
2022-12-27,공항철도,공덕,2718,3807,6525
2022-12-27,공항철도,공항화물청사,2298,2488,4786
2022-12-27,공항철도,김포공항,10835,6603,17438
2022-12-27,공항철도,디지털미디어시티,15341,14180,29521
2022-12-27,공항철도,마곡나루,10358,10027,20385
2022-12-27,공항철도,서울역,11281,9971,21252
2022-12-27,공항철도,영종,3912,3846,7758
2022-12-27,공항철도,운서,8710,9022,17732
2022-12-27,공항철도,인천공항1터미널,11906,11247,23153
2022-12-27,공항철도,인천공항2터미널,4080,3610,7690
2022-12-27,공항철도,청라국제도시,7295,6939,14234
2022-12-27,공항철도,홍대입구,13108,13161,26269
2022-12-27,과천선,경마공원,1670,1666,3336
2022-12-27,과천선,과천,7032,6574,13606
2022-12-27,과천선,대공원,3193,3300,6493
2022-12-27,과천선,범계,27991,27747,55738
2022-12-27,과천선,선바위,8070,7288,15358
2022-12-27,과천선,인덕원,25816,26211,52027
2022-12-27,과천선,정부과천청사,12616,12751,25367
2022-12-27,과천선,평촌,18778,18597,37375
2022-12-27,분당선,가천대,12234,12396,24630
2022-12-27,분당선,강남구청,10382,11937,22319
2022-12-27,분당선,개포동,4258,4255,8513
2022-12-27,분당선,구룡,2460,2235,4695
2022-12-27,분당선,구성,5344,5439,10783
2022-12-27,분당선,기흥,10709,9925,20634
2022-12-27,분당선,대모산입구,5147,4788,9935
2022-12-27,분당선,도곡,7982,7749,15731
2022-12-27,분당선,망포,15795,15287,31082
2022-12-27,분당선,매교,4819,4735,9554
2022-12-27,분당선,매탄권선,5516,5244,10760
2022-12-27,분당선,모란,20201,20316,40517
2022-12-27,분당선,미금,16373,17436,33809
2022-12-27,분당선,보정,2848,2515,5363
2022-12-27,분당선,상갈,5481,5286,10767
2022-12-27,분당선,서울숲,12790,13089,25879
2022-12-27,분당선,서현,26751,27252,54003
2022-12-27,분당선,선릉,14672,22642,37314
2022-12-27,분당선,선정릉,8382,8799,17181
2022-12-27,분당선,수내,15233,15188,30421
2022-12-27,분당선,수서,14409,15301,29710
2022-12-27,분당선,수원,8207,7065,15272
2022-12-27,분당선,수원시청,13391,14655,28046
2022-12-27,분당선,신갈,5273,5196,10469
2022-12-27,분당선,압구정로데오,22195,24751,46946
2022-12-27,분당선,야탑,28007,29401,57408
2022-12-27,분당선,영통,8724,8744,17468
2022-12-27,분당선,오리,12476,10216,22692
2022-12-27,분당선,이매,5966,5527,11493
2022-12-27,분당선,정자,19626,20514,40140
2022-12-27,분당선,죽전,13776,15327,29103
2022-12-27,분당선,청명,4603,4592,9195
2022-12-27,분당선,태평,13903,13469,27372
2022-12-27,분당선,한티,15868,16678,32546
2022-12-27,수인선,고색,5079,4598,9677
2022-12-27,수인선,남동인더스파크,2115,2463,4578
2022-12-27,수인선,달월,109,69,178
2022-12-27,수인선,사리,5164,4425,9589
2022-12-27,수인선,소래포구,4902,4665,9567
2022-12-27,수인선,송도,2593,2384,4977
2022-12-27,수인선,숭의,4253,3962,8215
2022-12-27,수인선,신포,1829,1930,3759
2022-12-27,수인선,야목,339,260,599
2022-12-27,수인선,어천,921,923,1844
2022-12-27,수인선,연수,4701,4670,9371
2022-12-27,수인선,오목천,3271,2948,6219
2022-12-27,수인선,원인재,4406,4589,8995
2022-12-27,수인선,월곶,2671,2476,5147
2022-12-27,수인선,인천,944,1617,2561
2022-12-27,수인선,인천논현,5732,5919,11651
2022-12-27,수인선,인하대,6016,5758,11774
2022-12-27,수인선,호구포,4254,4367,8621
2022-12-27,신림선,관악산,2144,2173,4317
2022-12-27,신림선,당곡,4458,4320,8778
2022-12-27,신림선,대방,2712,2072,4784
2022-12-27,신림선,보라매,3820,3371,7191
2022-12-27,신림선,보라매공원,2057,2177,4234
2022-12-27,신림선,보라매병원,7390,7868,15258
2022-12-27,신림선,샛강,2683,3358,6041
2022-12-27,신림선,서울대벤처타운,8147,7967,16114
2022-12-27,신림선,서울지방병무청,2744,3080,5824
2022-12-27,신림선,서원,3339,2824,6163
2022-12-27,신림선,신림,1775,2475,4250
2022-12-27,안산선,고잔,9202,8806,18008
2022-12-27,안산선,대야미,5070,4539,9609
2022-12-27,안산선,반월,4404,4189,8593
2022-12-27,안산선,산본,16628,17920,34548
2022-12-27,안산선,상록수,15815,16033,31848
2022-12-27,안산선,수리산,4261,3451,7712
2022-12-27,안산선,신길온천,1794,1622,3416
2022-12-27,안산선,안산,11359,10268,21627
2022-12-27,안산선,오이도,8364,8168,16532
2022-12-27,안산선,정왕,7923,8333,16256
2022-12-27,안산선,중앙,18461,18954,37415
2022-12-27,안산선,초지,5013,4966,9979
2022-12-27,안산선,한대앞,9116,9223,18339
2022-12-27,우이신설선,4.19민주묘지,2930,2841,5771
2022-12-27,우이신설선,가오리,4273,4251,8524
2022-12-27,우이신설선,보문,1609,1592,3201
2022-12-27,우이신설선,북한산보국문,6424,6019,12443
2022-12-27,우이신설선,북한산우이,2813,2494,5307
2022-12-27,우이신설선,삼양,2074,2173,4247
2022-12-27,우이신설선,삼양사거리,2638,2577,5215
2022-12-27,우이신설선,성신여대입구,3505,3959,7464
2022-12-27,우이신설선,솔밭공원,2646,2534,5180
2022-12-27,우이신설선,솔샘,6302,5951,12253
2022-12-27,우이신설선,신설동,2241,2092,4333
2022-12-27,우이신설선,정릉,4922,4716,9638
2022-12-27,우이신설선,화계,3540,3338,6878
2022-12-27,일산선,대곡,2181,1600,3781
2022-12-27,일산선,대화,13436,10347,23783
2022-12-27,일산선,마두,7837,8087,15924
2022-12-27,일산선,백석,10332,10361,20693
2022-12-27,일산선,삼송,20698,19992,40690
2022-12-27,일산선,원당,11404,10535,21939
2022-12-27,일산선,원흥,12057,11239,23296
2022-12-27,일산선,정발산,7250,7331,14581
2022-12-27,일산선,주엽,9652,9629,19281
2022-12-27,일산선,화정,17591,17962,35553
2022-12-27,장항선,배방,1142,1076,2218
2022-12-27,장항선,봉명,1429,1393,2822
2022-12-27,장항선,신창,1164,1149,2313
2022-12-27,장항선,쌍용,2238,2116,4354
2022-12-27,장항선,아산,3195,2970,6165
2022-12-27,장항선,온양온천,4332,4353,8685
2022-12-27,장항선,탕정,1179,1083,2262
2022-12-27,중앙선,구리,13853,14026,27879
2022-12-27,중앙선,국수,790,760,1550
2022-12-27,중앙선,덕소,5658,5521,11179
2022-12-27,중앙선,도농,11622,10477,22099
2022-12-27,중앙선,도심,2588,2003,4591
2022-12-27,중앙선,망우,7815,7592,15407
2022-12-27,중앙선,상봉,5882,5810,11692
2022-12-27,중앙선,신원,186,151,337
2022-12-27,중앙선,아신,526,502,1028
2022-12-27,중앙선,양수,1903,1961,3864
2022-12-27,중앙선,양원,3170,3034,6204
2022-12-27,중앙선,양정,628,509,1137
2022-12-27,중앙선,양평,2789,2842,5631
2022-12-27,중앙선,오빈,319,290,609
2022-12-27,중앙선,용문,1615,1628,3243
2022-12-27,중앙선,운길산,563,510,1073
2022-12-27,중앙선,원덕,329,298,627
2022-12-27,중앙선,중랑,5871,5625,11496
2022-12-27,중앙선,지평,47,52,99
2022-12-27,중앙선,팔당,737,786,1523
2022-12-27,중앙선,회기,26245,24974,51219
2022-12-28,1호선,동대문,11844,11267,23111
2022-12-28,1호선,동묘앞,7942,8090,16032
2022-12-28,1호선,서울역,53531,51826,105357
2022-12-28,1호선,시청,28575,29077,57652
2022-12-28,1호선,신설동,14437,14090,28527
2022-12-28,1호선,제기동,18701,18834,37535
2022-12-28,1호선,종각,43050,41597,84647
2022-12-28,1호선,종로3가,28601,26072,54673
2022-12-28,1호선,종로5가,27916,27416,55332
2022-12-28,1호선,청량리,20631,20473,41104
2022-12-28,2호선,강남,88892,85526,174418
2022-12-28,2호선,강변,32674,30525,63199
2022-12-28,2호선,건대입구,38938,41809,80747
2022-12-28,2호선,교대,36171,41106,77277
2022-12-28,2호선,구로디지털단지,62800,62918,125718
2022-12-28,2호선,구의,26117,25722,51839
2022-12-28,2호선,낙성대,28983,28049,57032
2022-12-28,2호선,당산,19449,22701,42150
2022-12-28,2호선,대림,24509,25107,49616
2022-12-28,2호선,도림천,1467,1588,3055
2022-12-28,2호선,동대문역사문화공원,14847,17199,32046
2022-12-28,2호선,뚝섬,24672,26316,50988
2022-12-28,2호선,문래,23727,24349,48076
2022-12-28,2호선,방배,16931,17586,34517
2022-12-28,2호선,봉천,25184,23795,48979
2022-12-28,2호선,사당,42759,46690,89449
2022-12-28,2호선,삼성,59680,59679,119359
2022-12-28,2호선,상왕십리,15317,14984,30301
2022-12-28,2호선,서울대입구,49899,48202,98101
2022-12-28,2호선,서초,23195,22196,45391
2022-12-28,2호선,선릉,62371,55738,118109
2022-12-28,2호선,성수,44954,48895,93849
2022-12-28,2호선,시청,29346,27829,57175
2022-12-28,2호선,신답,1821,2048,3869
2022-12-28,2호선,신당,15450,15999,31449
2022-12-28,2호선,신대방,26422,25662,52084
2022-12-28,2호선,신도림,53550,52315,105865
2022-12-28,2호선,신림,60019,57923,117942
2022-12-28,2호선,신설동,3544,3644,7188
2022-12-28,2호선,신정네거리,11465,11891,23356
2022-12-28,2호선,신촌,39294,39866,79160
2022-12-28,2호선,아현,11073,10496,21569
2022-12-28,2호선,양천구청,7360,7730,15090
2022-12-28,2호선,역삼,55660,62562,118222
2022-12-28,2호선,영등포구청,23455,24427,47882
2022-12-28,2호선,왕십리,17574,15557,33131
2022-12-28,2호선,용답,2943,2896,5839
2022-12-28,2호선,용두,2719,2729,5448
2022-12-28,2호선,을지로3가,26468,27262,53730
2022-12-28,2호선,을지로4가,15803,16066,31869
2022-12-28,2호선,을지로입구,52091,53274,105365
2022-12-28,2호선,이대,15128,16363,31491
2022-12-28,2호선,잠실,87877,87032,174909
2022-12-28,2호선,잠실나루,15441,14908,30349
2022-12-28,2호선,잠실새내,24129,23813,47942
2022-12-28,2호선,종합운동장,8699,9209,17908
2022-12-28,2호선,충정로,10553,11214,21767
2022-12-28,2호선,한양대,9342,9989,19331
2022-12-28,2호선,합정,34438,37241,71679
2022-12-28,2호선,홍대입구,70902,74952,145854
2022-12-28,3호선,가락시장,10097,9831,19928
2022-12-28,3호선,경복궁,25585,25848,51433
2022-12-28,3호선,경찰병원,8024,8093,16117
2022-12-28,3호선,고속터미널,47453,45284,92737
2022-12-28,3호선,교대,16109,10470,26579
2022-12-28,3호선,구파발,22034,21232,43266
2022-12-28,3호선,금호,8276,7779,16055
2022-12-28,3호선,남부터미널,30668,31551,62219
2022-12-28,3호선,녹번,16698,14882,31580
2022-12-28,3호선,대청,11203,10372,21575
2022-12-28,3호선,대치,11480,11493,22973
2022-12-28,3호선,도곡,5417,5455,10872
2022-12-28,3호선,독립문,7780,7961,15741
2022-12-28,3호선,동대입구,8040,8633,16673
2022-12-28,3호선,매봉,13422,13060,26482
2022-12-28,3호선,무악재,4454,4323,8777
2022-12-28,3호선,불광,16686,17974,34660
2022-12-28,3호선,수서,18506,19104,37610
2022-12-28,3호선,신사,32365,33454,65819
2022-12-28,3호선,안국,28601,29793,58394
2022-12-28,3호선,압구정,35798,38967,74765
2022-12-28,3호선,약수,13849,13411,27260
2022-12-28,3호선,양재,39630,43224,82854
2022-12-28,3호선,연신내,37334,35321,72655
2022-12-28,3호선,오금,6616,5860,12476
2022-12-28,3호선,옥수,9255,9598,18853
2022-12-28,3호선,을지로3가,12706,12543,25249
2022-12-28,3호선,일원,11434,10990,22424
2022-12-28,3호선,잠원,5066,4975,10041
2022-12-28,3호선,종로3가,11438,13445,24883
2022-12-28,3호선,지축,6472,6194,12666
2022-12-28,3호선,충무로,2,0,2
2022-12-28,3호선,학여울,1871,1939,3810
2022-12-28,3호선,홍제,18325,17475,35800
2022-12-28,4호선,길음,21819,21103,42922
2022-12-28,4호선,남태령,1343,1224,2567
2022-12-28,4호선,노원,20147,23204,43351
2022-12-28,4호선,당고개,9298,8271,17569
2022-12-28,4호선,동대문,21095,22137,43232
2022-12-28,4호선,동대문역사문화공원,19160,16767,35927
2022-12-28,4호선,동작,1173,1308,2481
2022-12-28,4호선,명동,31080,33838,64918
2022-12-28,4호선,미아,15839,15303,31142
2022-12-28,4호선,미아사거리,28940,28480,57420
2022-12-28,4호선,사당,28580,24546,53126
2022-12-28,4호선,삼각지,6660,7578,14238
2022-12-28,4호선,상계,20187,18708,38895
2022-12-28,4호선,서울역,12721,21373,34094
2022-12-28,4호선,성신여대입구,21495,20672,42167
2022-12-28,4호선,수유,36142,36573,72715
2022-12-28,4호선,숙대입구,14724,14311,29035
2022-12-28,4호선,신용산,19807,20580,40387
2022-12-28,4호선,쌍문,30793,28679,59472
2022-12-28,4호선,이촌,12326,13074,25400
2022-12-28,4호선,창동,26205,27543,53748
2022-12-28,4호선,총신대입구,19971,22069,42040
2022-12-28,4호선,충무로,29839,31095,60934
2022-12-28,4호선,한성대입구,13917,13315,27232
2022-12-28,4호선,혜화,40321,40146,80467
2022-12-28,4호선,회현,28004,29624,57628
2022-12-28,5호선,강동,19273,18398,37671
2022-12-28,5호선,강일,5637,5108,10745
2022-12-28,5호선,개롱,6830,7037,13867
2022-12-28,5호선,개화산,6105,5766,11871
2022-12-28,5호선,거여,10977,10541,21518
2022-12-28,5호선,고덕,10575,10178,20753
2022-12-28,5호선,공덕,15873,16594,32467
2022-12-28,5호선,광나루,15329,14226,29555
2022-12-28,5호선,광화문,38824,40067,78891
2022-12-28,5호선,군자,12372,13554,25926
2022-12-28,5호선,굽은다리,10511,10161,20672
2022-12-28,5호선,길동,8460,8844,17304
2022-12-28,5호선,김포공항,7965,7951,15916
2022-12-28,5호선,까치산,30403,29003,59406
2022-12-28,5호선,답십리,17173,15617,32790
2022-12-28,5호선,동대문역사문화공원,3426,4039,7465
2022-12-28,5호선,둔촌동,8978,9006,17984
2022-12-28,5호선,마곡,11551,11639,23190
2022-12-28,5호선,마장,6487,6218,12705
2022-12-28,5호선,마천,7656,7211,14867
2022-12-28,5호선,마포,16257,16687,32944
2022-12-28,5호선,명일,9113,9543,18656
2022-12-28,5호선,목동,17481,18914,36395
2022-12-28,5호선,미사,17920,18031,35951
2022-12-28,5호선,발산,21897,22897,44794
2022-12-28,5호선,방이,7654,7900,15554
2022-12-28,5호선,방화,7031,6811,13842
2022-12-28,5호선,상일동,15500,14429,29929
2022-12-28,5호선,서대문,21737,22209,43946
2022-12-28,5호선,송정,6928,6331,13259
2022-12-28,5호선,신금호,6784,7022,13806
2022-12-28,5호선,신길,4713,5156,9869
2022-12-28,5호선,신정,14586,11983,26569
2022-12-28,5호선,아차산,15430,14847,30277
2022-12-28,5호선,애오개,7285,7183,14468
2022-12-28,5호선,양평,7906,7839,15745
2022-12-28,5호선,여의나루,10449,13543,23992
2022-12-28,5호선,여의도,33277,33924,67201
2022-12-28,5호선,영등포구청,4525,4447,8972
2022-12-28,5호선,영등포시장,11412,11694,23106
2022-12-28,5호선,오금,3900,3911,7811
2022-12-28,5호선,오목교,23641,24987,48628
2022-12-28,5호선,올림픽공원,4614,3970,8584
2022-12-28,5호선,왕십리,5017,5962,10979
2022-12-28,5호선,우장산,15479,15015,30494
2022-12-28,5호선,을지로4가,7313,7571,14884
2022-12-28,5호선,장한평,20153,19949,40102
2022-12-28,5호선,종로3가,17187,16379,33566
2022-12-28,5호선,천호,19950,19545,39495
2022-12-28,5호선,청구,4197,3869,8066
2022-12-28,5호선,충정로,4956,5039,9995
2022-12-28,5호선,하남검단산,6658,6252,12910
2022-12-28,5호선,하남시청,7749,7544,15293
2022-12-28,5호선,하남풍산,4544,4455,8999
2022-12-28,5호선,행당,8490,7588,16078
2022-12-28,5호선,화곡,30586,28373,58959
2022-12-28,6호선,고려대,8765,8474,17239
2022-12-28,6호선,공덕,20640,20068,40708
2022-12-28,6호선,광흥창,9877,9590,19467
2022-12-28,6호선,구산,8123,6094,14217
2022-12-28,6호선,녹사평,5147,5296,10443
2022-12-28,6호선,대흥,8851,9263,18114
2022-12-28,6호선,독바위,2840,2968,5808
2022-12-28,6호선,돌곶이,10285,9499,19784
2022-12-28,6호선,동묘앞,8404,8427,16831
2022-12-28,6호선,디지털미디어시티,15245,16863,32108
2022-12-28,6호선,마포구청,14983,13490,28473
2022-12-28,6호선,망원,15207,16270,31477
2022-12-28,6호선,버티고개,2187,2241,4428
2022-12-28,6호선,보문,8037,7432,15469
2022-12-28,6호선,봉화산,9636,9117,18753
2022-12-28,6호선,불광,4671,4498,9169
2022-12-28,6호선,삼각지,7926,7184,15110
2022-12-28,6호선,상수,10072,11471,21543
2022-12-28,6호선,상월곡,6364,5692,12056
2022-12-28,6호선,새절,13351,12206,25557
2022-12-28,6호선,석계,13178,13527,26705
2022-12-28,6호선,신당,10013,10122,20135
2022-12-28,6호선,안암,11641,11668,23309
2022-12-28,6호선,약수,3945,3946,7891
2022-12-28,6호선,역촌,4064,4832,8896
2022-12-28,6호선,월곡,12119,11790,23909
2022-12-28,6호선,월드컵경기장,4512,4749,9261
2022-12-28,6호선,응암,18635,18356,36991
2022-12-28,6호선,이태원,10505,10792,21297
2022-12-28,6호선,증산,10467,10249,20716
2022-12-28,6호선,창신,3753,3156,6909
2022-12-28,6호선,청구,4047,4158,8205
2022-12-28,6호선,태릉입구,6029,6491,12520
2022-12-28,6호선,한강진,10128,11252,21380
2022-12-28,6호선,합정,14713,14410,29123
2022-12-28,6호선,화랑대,12384,9357,21741
2022-12-28,6호선,효창공원앞,7429,6853,14282
2022-12-28,7호선,가산디지털단지,46736,46800,93536
2022-12-28,7호선,강남구청,17698,19534,37232
2022-12-28,7호선,건대입구,14094,14882,28976
2022-12-28,7호선,고속터미널,16763,14368,31131
2022-12-28,7호선,공릉,12299,12134,24433
2022-12-28,7호선,광명사거리,22129,21763,43892
2022-12-28,7호선,군자,16269,12789,29058
2022-12-28,7호선,남구로,15717,16804,32521
2022-12-28,7호선,남성,11667,10788,22455
2022-12-28,7호선,내방,15284,15704,30988
2022-12-28,7호선,노원,22101,23141,45242
2022-12-28,7호선,논현,19604,20585,40189
2022-12-28,7호선,대림,8369,8474,16843
2022-12-28,7호선,도봉산,8914,10045,18959
2022-12-28,7호선,뚝섬유원지,7914,7699,15613
2022-12-28,7호선,마들,14039,13099,27138
2022-12-28,7호선,먹골,10677,10567,21244
2022-12-28,7호선,면목,15624,15245,30869
2022-12-28,7호선,반포,6467,6428,12895
2022-12-28,7호선,보라매,7678,7914,15592
2022-12-28,7호선,사가정,17112,16788,33900
2022-12-28,7호선,상도,11727,11097,22824
2022-12-28,7호선,상봉,18051,17217,35268
2022-12-28,7호선,수락산,13320,13320,26640
2022-12-28,7호선,숭실대입구,12887,12953,25840
2022-12-28,7호선,신대방삼거리,15836,14876,30712
2022-12-28,7호선,신풍,12212,11484,23696
2022-12-28,7호선,어린이대공원,13352,13213,26565
2022-12-28,7호선,온수,10488,9607,20095
2022-12-28,7호선,용마산,6127,5924,12051
2022-12-28,7호선,이수,17453,16315,33768
2022-12-28,7호선,장승배기,9727,9545,19272
2022-12-28,7호선,장암,2488,923,3411
2022-12-28,7호선,중계,14789,13390,28179
2022-12-28,7호선,중곡,11776,11012,22788
2022-12-28,7호선,중화,11422,11141,22563
2022-12-28,7호선,천왕,12370,11664,24034
2022-12-28,7호선,철산,22860,23151,46011
2022-12-28,7호선,청담,20015,22769,42784
2022-12-28,7호선,태릉입구,9281,8654,17935
2022-12-28,7호선,하계,19273,18004,37277
2022-12-28,7호선,학동,24927,27021,51948
2022-12-28,8호선,가락시장,8807,9776,18583
2022-12-28,8호선,강동구청,11342,11661,23003
2022-12-28,8호선,남위례,6407,6586,12993
2022-12-28,8호선,남한산성입구,13517,12136,25653
2022-12-28,8호선,단대오거리,11833,11643,23476
2022-12-28,8호선,모란,4766,3775,8541
2022-12-28,8호선,몽촌토성,6551,6773,13324
2022-12-28,8호선,문정,22084,23571,45655
2022-12-28,8호선,복정,9268,7729,16997
2022-12-28,8호선,산성,5373,5301,10674
2022-12-28,8호선,석촌,8285,9615,17900
2022-12-28,8호선,송파,9625,9476,19101
2022-12-28,8호선,수진,5504,5122,10626
2022-12-28,8호선,신흥,5349,5640,10989
2022-12-28,8호선,암사,20104,17693,37797
2022-12-28,8호선,잠실,17859,20836,38695
2022-12-28,8호선,장지,18644,17748,36392
2022-12-28,8호선,천호,15709,18288,33997
2022-12-28,9호선,가양,22774,22348,45122
2022-12-28,9호선,개화,2840,1858,4698
2022-12-28,9호선,고속터미널,14100,18822,32922
2022-12-28,9호선,공항시장,3162,3404,6566
2022-12-28,9호선,구반포,1891,1945,3836
2022-12-28,9호선,국회의사당,19250,19270,38520
2022-12-28,9호선,김포공항,7638,11124,18762
2022-12-28,9호선,노들,4911,4066,8977
2022-12-28,9호선,노량진,28124,27058,55182
2022-12-28,9호선,당산,20513,20295,40808
2022-12-28,9호선,동작,1682,1268,2950
2022-12-28,9호선,등촌,12325,11781,24106
2022-12-28,9호선,마곡나루,13627,13199,26826
2022-12-28,9호선,사평,4294,4081,8375
2022-12-28,9호선,샛강,7006,7033,14039
2022-12-28,9호선,선유도,9546,9165,18711
2022-12-28,9호선,신논현,33073,32488,65561
2022-12-28,9호선,신목동,4443,3867,8310
2022-12-28,9호선,신반포,3728,3815,7543
2022-12-28,9호선,신방화,7225,7165,14390
2022-12-28,9호선,양천향교,10210,10554,20764
2022-12-28,9호선,여의도,32260,30535,62795
2022-12-28,9호선,염창,18914,18274,37188
2022-12-28,9호선,증미,7649,7242,14891
2022-12-28,9호선,흑석,8821,9070,17891
2022-12-28,9호선2~3단계,둔촌오륜,1078,1071,2149
2022-12-28,9호선2~3단계,봉은사,19903,20634,40537
2022-12-28,9호선2~3단계,삼성중앙,7990,8393,16383
2022-12-28,9호선2~3단계,삼전,7548,7271,14819
2022-12-28,9호선2~3단계,석촌,9268,8270,17538
2022-12-28,9호선2~3단계,석촌고분,6949,6974,13923
2022-12-28,9호선2~3단계,선정릉,10197,11386,21583
2022-12-28,9호선2~3단계,송파나루,5929,6457,12386
2022-12-28,9호선2~3단계,언주,11720,11974,23694
2022-12-28,9호선2~3단계,올림픽공원,6641,6793,13434
2022-12-28,9호선2~3단계,종합운동장,4910,4867,9777
2022-12-28,9호선2~3단계,중앙보훈병원,11865,10314,22179
2022-12-28,9호선2~3단계,한성백제,2740,2406,5146
2022-12-28,경강선,경기광주,8427,7755,16182
2022-12-28,경강선,곤지암,2483,2388,4871
2022-12-28,경강선,부발,2066,1941,4007
2022-12-28,경강선,삼동,2616,2435,5051
2022-12-28,경강선,세종대왕릉,322,334,656
2022-12-28,경강선,신둔도예촌,1452,1394,2846
2022-12-28,경강선,여주,2204,2178,4382
2022-12-28,경강선,이매,1199,1073,2272
2022-12-28,경강선,이천,2749,2788,5537
2022-12-28,경강선,초월,3414,3188,6602
2022-12-28,경강선,판교,5714,5693,11407
2022-12-28,경부선,가산디지털단지,17747,20892,38639
2022-12-28,경부선,관악,7658,7238,14896
2022-12-28,경부선,광명,3551,3101,6652
2022-12-28,경부선,구로,18605,19104,37709
2022-12-28,경부선,군포,7909,7729,15638
2022-12-28,경부선,금정,28310,29046,57356
2022-12-28,경부선,금천구청,12075,12012,24087
2022-12-28,경부선,남영,10164,10454,20618
2022-12-28,경부선,노량진,9299,9929,19228
2022-12-28,경부선,당정,6279,5963,12242
2022-12-28,경부선,대방,11194,12235,23429
2022-12-28,경부선,독산,18707,19506,38213
2022-12-28,경부선,두정,5760,5741,11501
2022-12-28,경부선,명학,8930,8962,17892
2022-12-28,경부선,병점,14658,14359,29017
2022-12-28,경부선,서동탄,1425,1279,2704
2022-12-28,경부선,서울역,8791,2862,11653
2022-12-28,경부선,서정리,8006,7104,15110
2022-12-28,경부선,석수,9589,8664,18253
2022-12-28,경부선,성균관대,14597,14346,28943
2022-12-28,경부선,성환,3426,3371,6797
2022-12-28,경부선,세류,3162,2829,5991
2022-12-28,경부선,세마,3105,2897,6002
2022-12-28,경부선,송탄,4484,4392,8876
2022-12-28,경부선,수원,35266,38098,73364
2022-12-28,경부선,신길,9225,7919,17144
2022-12-28,경부선,신도림,4087,4254,8341
2022-12-28,경부선,안양,22243,21877,44120
2022-12-28,경부선,영등포,43445,44849,88294
2022-12-28,경부선,오산,9858,9892,19750
2022-12-28,경부선,오산대,3578,3291,6869
2022-12-28,경부선,용산,41331,42163,83494
2022-12-28,경부선,의왕,9341,9157,18498
2022-12-28,경부선,직산,842,837,1679
2022-12-28,경부선,진위,1991,1753,3744
2022-12-28,경부선,천안,5201,5387,10588
2022-12-28,경부선,평택,11759,11696,23455
2022-12-28,경부선,평택지제,4437,4512,8949
2022-12-28,경부선,화서,8567,8096,16663
2022-12-28,경원선,가능,6652,6369,13021
2022-12-28,경원선,광운대,7808,7564,15372
2022-12-28,경원선,녹양,4622,4300,8922
2022-12-28,경원선,녹천,4695,4005,8700
2022-12-28,경원선,덕계,3336,2980,6316
2022-12-28,경원선,덕정,5429,5152,10581
2022-12-28,경원선,도봉,6178,5877,12055
2022-12-28,경원선,도봉산,7176,4431,11607
2022-12-28,경원선,동두천,2143,2316,4459
2022-12-28,경원선,동두천중앙,3110,2980,6090
2022-12-28,경원선,망월사,7547,7647,15194
2022-12-28,경원선,방학,10384,10181,20565
2022-12-28,경원선,보산,1451,1404,2855
2022-12-28,경원선,서빙고,2083,2008,4091
2022-12-28,경원선,석계,8162,9302,17464
2022-12-28,경원선,소요산,2005,1722,3727
2022-12-28,경원선,신이문,8883,7944,16827
2022-12-28,경원선,양주,7437,7007,14444
2022-12-28,경원선,옥수,64,41,105
2022-12-28,경원선,왕십리,16642,17737,34379
2022-12-28,경원선,외대앞,8135,8006,16141
2022-12-28,경원선,월계,6861,6371,13232
2022-12-28,경원선,응봉,2002,1665,3667
2022-12-28,경원선,의정부,19301,19626,38927
2022-12-28,경원선,이촌,3966,3125,7091
2022-12-28,경원선,지행,6513,6336,12849
2022-12-28,경원선,청량리,16029,16825,32854
2022-12-28,경원선,한남,4092,4052,8144
2022-12-28,경원선,회룡,13095,12847,25942
2022-12-28,경의선,가좌,6040,5701,11741
2022-12-28,경의선,강매,3407,2833,6240
2022-12-28,경의선,곡산,564,572,1136
2022-12-28,경의선,공덕,4337,3503,7840
2022-12-28,경의선,금릉,5435,5101,10536
2022-12-28,경의선,금촌,6748,6588,13336
2022-12-28,경의선,능곡,3936,3546,7482
2022-12-28,경의선,디지털미디어시티,2966,2617,5583
2022-12-28,경의선,문산,5158,5118,10276
2022-12-28,경의선,백마,7215,6897,14112
2022-12-28,경의선,서강대,2120,2147,4267
2022-12-28,경의선,서울역,4436,6083,10519
2022-12-28,경의선,수색,2944,3168,6112
2022-12-28,경의선,신촌,872,1163,2035
2022-12-28,경의선,야당,8721,8644,17365
2022-12-28,경의선,운정,7201,6675,13876
2022-12-28,경의선,운천,5,2,7
2022-12-28,경의선,월롱,2709,2266,4975
2022-12-28,경의선,일산,10355,10118,20473
2022-12-28,경의선,임진강,7,3,10
2022-12-28,경의선,탄현,8238,7772,16010
2022-12-28,경의선,파주,1196,777,1973
2022-12-28,경의선,풍산,5936,5327,11263
2022-12-28,경의선,행신,8468,8312,16780
2022-12-28,경의선,홍대입구,1925,2529,4454
2022-12-28,경의선,화전,1691,1538,3229
2022-12-28,경의선,효창공원앞,3154,3625,6779
2022-12-28,경인선,간석,5941,5515,11456
2022-12-28,경인선,개봉,22556,22039,44595
2022-12-28,경인선,구일,6390,6146,12536
2022-12-28,경인선,도원,3225,3129,6354
2022-12-28,경인선,도화,4190,3870,8060
2022-12-28,경인선,동암,16437,16444,32881
2022-12-28,경인선,동인천,14136,13515,27651
2022-12-28,경인선,백운,6834,6590,13424
2022-12-28,경인선,부개,8859,8183,17042
2022-12-28,경인선,부천,32522,32488,65010
2022-12-28,경인선,부평,29859,31567,61426
2022-12-28,경인선,소사,8059,7951,16010
2022-12-28,경인선,송내,27820,27495,55315
2022-12-28,경인선,역곡,28034,27670,55704
2022-12-28,경인선,오류동,12099,11196,23295
2022-12-28,경인선,온수,7058,6553,13611
2022-12-28,경인선,인천,3319,2565,5884
2022-12-28,경인선,제물포,10588,10044,20632
2022-12-28,경인선,주안,19133,17430,36563
2022-12-28,경인선,중동,9635,8950,18585
2022-12-28,경춘선,가평,1968,1897,3865
2022-12-28,경춘선,갈매,3244,2718,5962
2022-12-28,경춘선,강촌,312,325,637
2022-12-28,경춘선,굴봉산,146,157,303
2022-12-28,경춘선,금곡,1533,1423,2956
2022-12-28,경춘선,김유정,294,282,576
2022-12-28,경춘선,남춘천,2509,2485,4994
2022-12-28,경춘선,대성리,546,563,1109
2022-12-28,경춘선,마석,4125,4043,8168
2022-12-28,경춘선,백양리,390,316,706
2022-12-28,경춘선,별내,3374,3112,6486
2022-12-28,경춘선,사릉,2279,2244,4523
2022-12-28,경춘선,상천,216,192,408
2022-12-28,경춘선,신내,2288,2210,4498
2022-12-28,경춘선,천마산,1604,1473,3077
2022-12-28,경춘선,청평,1696,1610,3306
2022-12-28,경춘선,춘천,1203,1056,2259
2022-12-28,경춘선,퇴계원,3638,3382,7020
2022-12-28,경춘선,평내호평,6369,6043,12412
2022-12-28,공항철도,검암,6921,6689,13610
2022-12-28,공항철도,계양,12728,11667,24395
2022-12-28,공항철도,공덕,2762,3827,6589
2022-12-28,공항철도,공항화물청사,2276,2374,4650
2022-12-28,공항철도,김포공항,10926,6632,17558
2022-12-28,공항철도,디지털미디어시티,15490,14422,29912
2022-12-28,공항철도,마곡나루,9655,9502,19157
2022-12-28,공항철도,서울역,11467,9763,21230
2022-12-28,공항철도,영종,3874,3908,7782
2022-12-28,공항철도,운서,8893,8998,17891
2022-12-28,공항철도,인천공항1터미널,11684,11345,23029
2022-12-28,공항철도,인천공항2터미널,4216,3919,8135
2022-12-28,공항철도,청라국제도시,7103,6680,13783
2022-12-28,공항철도,홍대입구,13194,13351,26545
2022-12-28,과천선,경마공원,1384,1493,2877
2022-12-28,과천선,과천,6869,6446,13315
2022-12-28,과천선,대공원,2775,2902,5677
2022-12-28,과천선,범계,28184,27829,56013
2022-12-28,과천선,선바위,8147,7423,15570
2022-12-28,과천선,인덕원,25589,26519,52108
2022-12-28,과천선,정부과천청사,11468,11502,22970
2022-12-28,과천선,평촌,18924,18363,37287
2022-12-28,분당선,가천대,7136,7747,14883
2022-12-28,분당선,강남구청,10359,11955,22314
2022-12-28,분당선,개포동,4432,4509,8941
2022-12-28,분당선,구룡,2354,2226,4580
2022-12-28,분당선,구성,5416,5596,11012
2022-12-28,분당선,기흥,10650,9841,20491
2022-12-28,분당선,대모산입구,5033,4548,9581
2022-12-28,분당선,도곡,7902,7742,15644
2022-12-28,분당선,망포,16297,15384,31681
2022-12-28,분당선,매교,4789,4744,9533
2022-12-28,분당선,매탄권선,5618,5367,10985
2022-12-28,분당선,모란,19948,20321,40269
2022-12-28,분당선,미금,16615,17636,34251
2022-12-28,분당선,보정,2890,2512,5402
2022-12-28,분당선,복정,5,0,5
2022-12-28,분당선,상갈,5650,5445,11095
2022-12-28,분당선,서울숲,12391,12870,25261
2022-12-28,분당선,서현,27136,27382,54518
2022-12-28,분당선,선릉,14643,22116,36759
2022-12-28,분당선,선정릉,8068,8461,16529
2022-12-28,분당선,수내,15326,15206,30532
2022-12-28,분당선,수서,14308,15111,29419
2022-12-28,분당선,수원,8391,6999,15390
2022-12-28,분당선,수원시청,14149,15012,29161
2022-12-28,분당선,신갈,5298,5084,10382
2022-12-28,분당선,압구정로데오,22448,25305,47753
2022-12-28,분당선,야탑,27486,28776,56262
2022-12-28,분당선,영통,9148,9090,18238
2022-12-28,분당선,오리,12345,10058,22403
2022-12-28,분당선,이매,6103,5804,11907
2022-12-28,분당선,정자,19787,20749,40536
2022-12-28,분당선,죽전,13846,15357,29203
2022-12-28,분당선,청명,4622,4447,9069
2022-12-28,분당선,태평,14006,13495,27501
2022-12-28,분당선,한티,15851,16783,32634
2022-12-28,수인선,고색,5132,4717,9849
2022-12-28,수인선,남동인더스파크,2162,2534,4696
2022-12-28,수인선,달월,109,73,182
2022-12-28,수인선,사리,5135,4282,9417
2022-12-28,수인선,소래포구,4853,4493,9346
2022-12-28,수인선,송도,2544,2319,4863
2022-12-28,수인선,숭의,4133,3766,7899
2022-12-28,수인선,신포,1834,1923,3757
2022-12-28,수인선,야목,348,261,609
2022-12-28,수인선,어천,986,936,1922
2022-12-28,수인선,연수,4782,4729,9511
2022-12-28,수인선,오목천,3433,3110,6543
2022-12-28,수인선,원인재,4445,4553,8998
2022-12-28,수인선,월곶,2779,2572,5351
2022-12-28,수인선,인천,960,1564,2524
2022-12-28,수인선,인천논현,5716,6146,11862
2022-12-28,수인선,인하대,6055,5656,11711
2022-12-28,수인선,호구포,4339,4446,8785
2022-12-28,신림선,관악산,2170,2174,4344
2022-12-28,신림선,당곡,4513,4394,8907
2022-12-28,신림선,대방,2682,2147,4829
2022-12-28,신림선,보라매,3879,3443,7322
2022-12-28,신림선,보라매공원,1946,2189,4135
2022-12-28,신림선,보라매병원,7546,7845,15391
2022-12-28,신림선,샛강,2631,3293,5924
2022-12-28,신림선,서울대벤처타운,8183,8040,16223
2022-12-28,신림선,서울지방병무청,2768,2931,5699
2022-12-28,신림선,서원,3321,2934,6255
2022-12-28,신림선,신림,1802,2508,4310
2022-12-28,안산선,고잔,8958,8698,17656
2022-12-28,안산선,대야미,5134,4558,9692
2022-12-28,안산선,반월,4430,4259,8689
2022-12-28,안산선,산본,16903,18046,34949
2022-12-28,안산선,상록수,15663,15750,31413
2022-12-28,안산선,수리산,4226,3407,7633
2022-12-28,안산선,신길온천,1806,1602,3408
2022-12-28,안산선,안산,11235,10295,21530
2022-12-28,안산선,오이도,8220,8010,16230
2022-12-28,안산선,정왕,7914,8290,16204
2022-12-28,안산선,중앙,18455,19259,37714
2022-12-28,안산선,초지,4859,4927,9786
2022-12-28,안산선,한대앞,9259,9295,18554
2022-12-28,우이신설선,4.19민주묘지,2989,2780,5769
2022-12-28,우이신설선,가오리,4392,4229,8621
2022-12-28,우이신설선,보문,1588,1585,3173
2022-12-28,우이신설선,북한산보국문,6412,6061,12473
2022-12-28,우이신설선,북한산우이,2597,2336,4933
2022-12-28,우이신설선,삼양,2064,2173,4237
2022-12-28,우이신설선,삼양사거리,2597,2672,5269
2022-12-28,우이신설선,성신여대입구,3488,3942,7430
2022-12-28,우이신설선,솔밭공원,2708,2447,5155
2022-12-28,우이신설선,솔샘,6304,5910,12214
2022-12-28,우이신설선,신설동,2337,2173,4510
2022-12-28,우이신설선,정릉,4760,4584,9344
2022-12-28,우이신설선,화계,3631,3353,6984
2022-12-28,일산선,대곡,2054,1576,3630
2022-12-28,일산선,대화,13447,10500,23947
2022-12-28,일산선,마두,8026,8310,16336
2022-12-28,일산선,백석,9971,10117,20088
2022-12-28,일산선,삼송,20615,19891,40506
2022-12-28,일산선,원당,11388,10650,22038
2022-12-28,일산선,원흥,12002,11188,23190
2022-12-28,일산선,정발산,7923,8237,16160
2022-12-28,일산선,주엽,9572,9541,19113
2022-12-28,일산선,지축,2,0,2
2022-12-28,일산선,화정,17840,18422,36262
2022-12-28,장항선,배방,1198,1074,2272
2022-12-28,장항선,봉명,1370,1358,2728
2022-12-28,장항선,신창,1095,1069,2164
2022-12-28,장항선,쌍용,2109,2007,4116
2022-12-28,장항선,아산,3249,3018,6267
2022-12-28,장항선,온양온천,4094,4213,8307
2022-12-28,장항선,탕정,1189,1092,2281
2022-12-28,중앙선,구리,14008,14203,28211
2022-12-28,중앙선,국수,770,761,1531
2022-12-28,중앙선,덕소,5672,5676,11348
2022-12-28,중앙선,도농,11671,10580,22251
2022-12-28,중앙선,도심,2546,1951,4497
2022-12-28,중앙선,망우,7833,7683,15516
2022-12-28,중앙선,상봉,5788,5760,11548
2022-12-28,중앙선,신원,178,175,353
2022-12-28,중앙선,아신,485,488,973
2022-12-28,중앙선,양수,1801,1771,3572
2022-12-28,중앙선,양원,3222,3015,6237
2022-12-28,중앙선,양정,617,513,1130
2022-12-28,중앙선,양평,3565,3491,7056
2022-12-28,중앙선,오빈,309,329,638
2022-12-28,중앙선,용문,1639,1611,3250
2022-12-28,중앙선,운길산,575,563,1138
2022-12-28,중앙선,원덕,348,308,656
2022-12-28,중앙선,중랑,5885,5608,11493
2022-12-28,중앙선,지평,55,77,132
2022-12-28,중앙선,팔당,752,790,1542
2022-12-28,중앙선,회기,25897,24547,50444
2022-12-29,1호선,동대문,12076,11182,23258
2022-12-29,1호선,동묘앞,8107,8378,16485
2022-12-29,1호선,서울역,52937,52354,105291
2022-12-29,1호선,시청,27757,28423,56180
2022-12-29,1호선,신설동,14464,13713,28177
2022-12-29,1호선,제기동,18509,18667,37176
2022-12-29,1호선,종각,41319,40119,81438
2022-12-29,1호선,종로3가,29170,26596,55766
2022-12-29,1호선,종로5가,27301,27019,54320
2022-12-29,1호선,청량리,20305,20513,40818
2022-12-29,2호선,강남,86670,84321,170991
2022-12-29,2호선,강변,31873,31271,63144
2022-12-29,2호선,건대입구,41083,42806,83889
2022-12-29,2호선,교대,35012,39555,74567
2022-12-29,2호선,구로디지털단지,62330,61679,124009
2022-12-29,2호선,구의,25516,24987,50503
2022-12-29,2호선,낙성대,28530,27366,55896
2022-12-29,2호선,당산,19188,22159,41347
2022-12-29,2호선,대림,24346,24775,49121
2022-12-29,2호선,도림천,1341,1445,2786
2022-12-29,2호선,동대문역사문화공원,15158,17443,32601
2022-12-29,2호선,뚝섬,24599,26408,51007
2022-12-29,2호선,문래,23183,24113,47296
2022-12-29,2호선,방배,17078,17555,34633
2022-12-29,2호선,봉천,24627,22953,47580
2022-12-29,2호선,사당,41645,45815,87460
2022-12-29,2호선,삼성,58489,58113,116602
2022-12-29,2호선,상왕십리,14999,14302,29301
2022-12-29,2호선,서울대입구,49236,47456,96692
2022-12-29,2호선,서초,22144,21375,43519
2022-12-29,2호선,선릉,60198,53443,113641
2022-12-29,2호선,성수,44160,48348,92508
2022-12-29,2호선,시청,28087,26456,54543
2022-12-29,2호선,신답,1796,2001,3797
2022-12-29,2호선,신당,15042,15655,30697
2022-12-29,2호선,신대방,25705,24851,50556
2022-12-29,2호선,신도림,51928,50798,102726
2022-12-29,2호선,신림,59783,56904,116687
2022-12-29,2호선,신설동,3497,3603,7100
2022-12-29,2호선,신정네거리,10701,11036,21737
2022-12-29,2호선,신촌,39358,40111,79469
2022-12-29,2호선,아현,10961,10141,21102
2022-12-29,2호선,양천구청,7263,7576,14839
2022-12-29,2호선,역삼,52963,59953,112916
2022-12-29,2호선,영등포구청,23025,23741,46766
2022-12-29,2호선,왕십리,17222,15294,32516
2022-12-29,2호선,용답,2870,2802,5672
2022-12-29,2호선,용두,2561,2586,5147
2022-12-29,2호선,을지로3가,26724,27442,54166
2022-12-29,2호선,을지로4가,15560,16253,31813
2022-12-29,2호선,을지로입구,51702,52842,104544
2022-12-29,2호선,이대,15283,16252,31535
2022-12-29,2호선,잠실,88054,86376,174430
2022-12-29,2호선,잠실나루,14864,14324,29188
2022-12-29,2호선,잠실새내,23765,23778,47543
2022-12-29,2호선,종합운동장,8375,8718,17093
2022-12-29,2호선,충정로,10293,10621,20914
2022-12-29,2호선,한양대,9053,9830,18883
2022-12-29,2호선,합정,34792,37771,72563
2022-12-29,2호선,홍대입구,72405,77545,149950
2022-12-29,3호선,가락시장,9780,9770,19550
2022-12-29,3호선,경복궁,24161,24241,48402
2022-12-29,3호선,경찰병원,7806,7804,15610
2022-12-29,3호선,고속터미널,48082,48214,96296
2022-12-29,3호선,교대,15485,10098,25583
2022-12-29,3호선,구파발,21595,20795,42390
2022-12-29,3호선,금호,8276,7544,15820
2022-12-29,3호선,남부터미널,30565,31546,62111
2022-12-29,3호선,녹번,16301,14651,30952
2022-12-29,3호선,대청,10802,9990,20792
2022-12-29,3호선,대치,11563,11649,23212
2022-12-29,3호선,도곡,4910,4877,9787
2022-12-29,3호선,독립문,7365,7544,14909
2022-12-29,3호선,동대입구,7630,8505,16135
2022-12-29,3호선,매봉,13014,12743,25757
2022-12-29,3호선,무악재,4321,4222,8543
2022-12-29,3호선,불광,16702,17650,34352
2022-12-29,3호선,수서,18364,18484,36848
2022-12-29,3호선,신사,32510,33907,66417
2022-12-29,3호선,안국,27079,28326,55405
2022-12-29,3호선,압구정,34993,37893,72886
2022-12-29,3호선,약수,13805,13183,26988
2022-12-29,3호선,양재,38432,41792,80224
2022-12-29,3호선,연신내,36828,35111,71939
2022-12-29,3호선,오금,6447,5818,12265
2022-12-29,3호선,옥수,9177,9387,18564
2022-12-29,3호선,을지로3가,12368,12354,24722
2022-12-29,3호선,일원,11693,11025,22718
2022-12-29,3호선,잠원,5128,4771,9899
2022-12-29,3호선,종로3가,11399,13563,24962
2022-12-29,3호선,지축,6334,6089,12423
2022-12-29,3호선,충무로,2,0,2
2022-12-29,3호선,학여울,1780,1843,3623
2022-12-29,3호선,홍제,18156,17075,35231
2022-12-29,4호선,길음,21308,20628,41936
2022-12-29,4호선,남태령,1330,1197,2527
2022-12-29,4호선,노원,20143,22884,43027
2022-12-29,4호선,당고개,9201,8330,17531
2022-12-29,4호선,동대문,21625,22441,44066
2022-12-29,4호선,동대문역사문화공원,19080,16403,35483
2022-12-29,4호선,동작,1150,1281,2431
2022-12-29,4호선,명동,30706,33906,64612
2022-12-29,4호선,미아,15558,15162,30720
2022-12-29,4호선,미아사거리,28467,27732,56199
2022-12-29,4호선,사당,27825,24395,52220
2022-12-29,4호선,삼각지,6597,7487,14084
2022-12-29,4호선,상계,19897,18489,38386
2022-12-29,4호선,서울역,12108,21626,33734
2022-12-29,4호선,성신여대입구,21258,20412,41670
2022-12-29,4호선,수유,35921,36141,72062
2022-12-29,4호선,숙대입구,14278,13940,28218
2022-12-29,4호선,신용산,19444,20540,39984
2022-12-29,4호선,쌍문,30587,28280,58867
2022-12-29,4호선,이촌,10522,11281,21803
2022-12-29,4호선,창동,26123,27446,53569
2022-12-29,4호선,총신대입구,19539,21312,40851
2022-12-29,4호선,충무로,29174,30353,59527
2022-12-29,4호선,한성대입구,13344,12763,26107
2022-12-29,4호선,혜화,37058,37097,74155
2022-12-29,4호선,회현,28231,29784,58015
2022-12-29,5호선,강동,18841,17918,36759
2022-12-29,5호선,강일,5279,4857,10136
2022-12-29,5호선,개롱,6777,7024,13801
2022-12-29,5호선,개화산,5826,5620,11446
2022-12-29,5호선,거여,10411,9949,20360
2022-12-29,5호선,고덕,10204,9786,19990
2022-12-29,5호선,공덕,15249,16063,31312
2022-12-29,5호선,광나루,13800,12720,26520
2022-12-29,5호선,광화문,37083,37978,75061
2022-12-29,5호선,군자,12199,13489,25688
2022-12-29,5호선,굽은다리,10203,9820,20023
2022-12-29,5호선,길동,8429,8815,17244
2022-12-29,5호선,김포공항,8170,7753,15923
2022-12-29,5호선,까치산,29880,28373,58253
2022-12-29,5호선,답십리,17023,15446,32469
2022-12-29,5호선,동대문역사문화공원,3285,3839,7124
2022-12-29,5호선,둔촌동,8982,9051,18033
2022-12-29,5호선,마곡,11195,11336,22531
2022-12-29,5호선,마장,6395,5984,12379
2022-12-29,5호선,마천,7581,7196,14777
2022-12-29,5호선,마포,15542,16299,31841
2022-12-29,5호선,명일,8982,9098,18080
2022-12-29,5호선,목동,16823,18076,34899
2022-12-29,5호선,미사,17731,17702,35433
2022-12-29,5호선,발산,21000,22461,43461
2022-12-29,5호선,방이,7386,7505,14891
2022-12-29,5호선,방화,6902,6559,13461
2022-12-29,5호선,상일동,15186,13885,29071
2022-12-29,5호선,서대문,20782,21373,42155
2022-12-29,5호선,송정,6782,6332,13114
2022-12-29,5호선,신금호,6625,6831,13456
2022-12-29,5호선,신길,4684,4893,9577
2022-12-29,5호선,신정,14131,11775,25906
2022-12-29,5호선,아차산,15126,14539,29665
2022-12-29,5호선,애오개,7088,7058,14146
2022-12-29,5호선,양평,7652,7614,15266
2022-12-29,5호선,여의나루,10612,13628,24240
2022-12-29,5호선,여의도,31916,32901,64817
2022-12-29,5호선,영등포구청,4346,4416,8762
2022-12-29,5호선,영등포시장,11319,11380,22699
2022-12-29,5호선,오금,3774,3882,7656
2022-12-29,5호선,오목교,23294,24739,48033
2022-12-29,5호선,올림픽공원,4484,3931,8415
2022-12-29,5호선,왕십리,4870,5700,10570
2022-12-29,5호선,우장산,14980,14343,29323
2022-12-29,5호선,을지로4가,7281,7513,14794
2022-12-29,5호선,장한평,19453,19479,38932
2022-12-29,5호선,종로3가,16649,16338,32987
2022-12-29,5호선,천호,19442,19195,38637
2022-12-29,5호선,청구,4052,3824,7876
2022-12-29,5호선,충정로,4822,4826,9648
2022-12-29,5호선,하남검단산,6921,6612,13533
2022-12-29,5호선,하남시청,7976,7643,15619
2022-12-29,5호선,하남풍산,4491,4597,9088
2022-12-29,5호선,행당,8297,7385,15682
2022-12-29,5호선,화곡,30070,27771,57841
2022-12-29,6호선,고려대,8818,8325,17143
2022-12-29,6호선,공덕,19959,19466,39425
2022-12-29,6호선,광흥창,9345,9131,18476
2022-12-29,6호선,구산,8060,6038,14098
2022-12-29,6호선,녹사평,5255,5331,10586
2022-12-29,6호선,대흥,8712,8983,17695
2022-12-29,6호선,독바위,2759,2789,5548
2022-12-29,6호선,돌곶이,9912,9210,19122
2022-12-29,6호선,동묘앞,8296,8371,16667
2022-12-29,6호선,디지털미디어시티,14813,16349,31162
2022-12-29,6호선,마포구청,14939,13404,28343
2022-12-29,6호선,망원,15312,16460,31772
2022-12-29,6호선,버티고개,2168,2262,4430
2022-12-29,6호선,보문,7984,7189,15173
2022-12-29,6호선,봉화산,9188,8645,17833
2022-12-29,6호선,불광,4635,4441,9076
2022-12-29,6호선,삼각지,7578,6777,14355
2022-12-29,6호선,상수,10415,12107,22522
2022-12-29,6호선,상월곡,7092,6375,13467
2022-12-29,6호선,새절,13277,12116,25393
2022-12-29,6호선,석계,12766,12967,25733
2022-12-29,6호선,신내,1,0,1
2022-12-29,6호선,신당,8985,9295,18280
2022-12-29,6호선,안암,11375,11406,22781
2022-12-29,6호선,약수,3751,3907,7658
2022-12-29,6호선,역촌,3924,4487,8411
2022-12-29,6호선,월곡,11923,11681,23604
2022-12-29,6호선,월드컵경기장,4414,4759,9173
2022-12-29,6호선,응암,18041,18036,36077
2022-12-29,6호선,이태원,10520,10766,21286
2022-12-29,6호선,증산,10379,9985,20364
2022-12-29,6호선,창신,3694,3171,6865
2022-12-29,6호선,청구,4005,3990,7995
2022-12-29,6호선,태릉입구,5796,6135,11931
2022-12-29,6호선,한강진,9317,10792,20109
2022-12-29,6호선,합정,15003,14479,29482
2022-12-29,6호선,화랑대,11977,9291,21268
2022-12-29,6호선,효창공원앞,7470,6746,14216
2022-12-29,7호선,가산디지털단지,44264,44781,89045
2022-12-29,7호선,강남구청,16789,19005,35794
2022-12-29,7호선,건대입구,17572,17946,35518
2022-12-29,7호선,고속터미널,16803,13895,30698
2022-12-29,7호선,공릉,12051,11936,23987
2022-12-29,7호선,광명사거리,22038,21764,43802
2022-12-29,7호선,군자,15896,12372,28268
2022-12-29,7호선,남구로,15132,16354,31486
2022-12-29,7호선,남성,11591,10749,22340
2022-12-29,7호선,내방,14811,14982,29793
2022-12-29,7호선,노원,21451,22401,43852
2022-12-29,7호선,논현,18932,20201,39133
2022-12-29,7호선,대림,8091,8273,16364
2022-12-29,7호선,도봉산,8858,10323,19181
2022-12-29,7호선,뚝섬유원지,7890,7640,15530
2022-12-29,7호선,마들,13916,12814,26730
2022-12-29,7호선,먹골,10755,10511,21266
2022-12-29,7호선,면목,15548,15065,30613
2022-12-29,7호선,반포,6541,6298,12839
2022-12-29,7호선,보라매,7251,7374,14625
2022-12-29,7호선,사가정,16659,16447,33106
2022-12-29,7호선,상도,11337,10804,22141
2022-12-29,7호선,상봉,17977,17046,35023
2022-12-29,7호선,수락산,13312,12975,26287
2022-12-29,7호선,숭실대입구,12375,12416,24791
2022-12-29,7호선,신대방삼거리,15327,14275,29602
2022-12-29,7호선,신풍,11800,11193,22993
2022-12-29,7호선,어린이대공원,15716,16025,31741
2022-12-29,7호선,온수,10088,9287,19375
2022-12-29,7호선,용마산,5986,5755,11741
2022-12-29,7호선,이수,16747,15990,32737
2022-12-29,7호선,장승배기,9470,9151,18621
2022-12-29,7호선,장암,2373,938,3311
2022-12-29,7호선,중계,14772,13341,28113
2022-12-29,7호선,중곡,11264,10423,21687
2022-12-29,7호선,중화,11099,10867,21966
2022-12-29,7호선,천왕,11988,11133,23121
2022-12-29,7호선,철산,22362,22677,45039
2022-12-29,7호선,청담,19527,22263,41790
2022-12-29,7호선,태릉입구,9000,8261,17261
2022-12-29,7호선,하계,18647,17353,36000
2022-12-29,7호선,학동,24051,26019,50070
2022-12-29,8호선,가락시장,8755,9776,18531
2022-12-29,8호선,강동구청,11137,11363,22500
2022-12-29,8호선,남위례,6493,6668,13161
2022-12-29,8호선,남한산성입구,13490,12162,25652
2022-12-29,8호선,단대오거리,11819,11513,23332
2022-12-29,8호선,모란,6535,5166,11701
2022-12-29,8호선,몽촌토성,6277,6489,12766
2022-12-29,8호선,문정,21212,22653,43865
2022-12-29,8호선,복정,8930,7420,16350
2022-12-29,8호선,산성,5308,5233,10541
2022-12-29,8호선,석촌,8320,9655,17975
2022-12-29,8호선,송파,9638,9361,18999
2022-12-29,8호선,수진,5645,5125,10770
2022-12-29,8호선,신흥,5467,5685,11152
2022-12-29,8호선,암사,19761,17264,37025
2022-12-29,8호선,잠실,17800,20789,38589
2022-12-29,8호선,장지,18002,17185,35187
2022-12-29,8호선,천호,15544,17839,33383
2022-12-29,9호선,가양,22409,21634,44043
2022-12-29,9호선,개화,2817,1805,4622
2022-12-29,9호선,고속터미널,13920,19164,33084
2022-12-29,9호선,공항시장,3011,3224,6235
2022-12-29,9호선,구반포,1130,1214,2344
2022-12-29,9호선,국회의사당,17798,17986,35784
2022-12-29,9호선,김포공항,7636,11023,18659
2022-12-29,9호선,노들,4815,3960,8775
2022-12-29,9호선,노량진,27768,26513,54281
2022-12-29,9호선,당산,20473,20028,40501
2022-12-29,9호선,동작,1598,1198,2796
2022-12-29,9호선,등촌,12174,11492,23666
2022-12-29,9호선,마곡나루,13330,13288,26618
2022-12-29,9호선,사평,3775,3744,7519
2022-12-29,9호선,샛강,6702,6680,13382
2022-12-29,9호선,선유도,9089,8706,17795
2022-12-29,9호선,신논현,33016,32764,65780
2022-12-29,9호선,신목동,4328,3748,8076
2022-12-29,9호선,신반포,3610,3619,7229
2022-12-29,9호선,신방화,7157,6967,14124
2022-12-29,9호선,양천향교,10120,10282,20402
2022-12-29,9호선,여의도,31271,29461,60732
2022-12-29,9호선,염창,18418,17541,35959
2022-12-29,9호선,증미,7170,6883,14053
2022-12-29,9호선,흑석,8435,8664,17099
2022-12-29,9호선2~3단계,둔촌오륜,1030,977,2007
2022-12-29,9호선2~3단계,봉은사,20220,20917,41137
2022-12-29,9호선2~3단계,삼성중앙,7762,8113,15875
2022-12-29,9호선2~3단계,삼전,7509,7086,14595
2022-12-29,9호선2~3단계,석촌,9322,8144,17466
2022-12-29,9호선2~3단계,석촌고분,6833,6709,13542
2022-12-29,9호선2~3단계,선정릉,9828,10821,20649
2022-12-29,9호선2~3단계,송파나루,6008,6401,12409
2022-12-29,9호선2~3단계,언주,11069,11494,22563
2022-12-29,9호선2~3단계,올림픽공원,6297,6376,12673
2022-12-29,9호선2~3단계,종합운동장,4553,4692,9245
2022-12-29,9호선2~3단계,중앙보훈병원,11483,9949,21432
2022-12-29,9호선2~3단계,한성백제,2685,2373,5058
2022-12-29,경강선,경기광주,8325,7594,15919
2022-12-29,경강선,곤지암,2418,2266,4684
2022-12-29,경강선,부발,2245,1980,4225
2022-12-29,경강선,삼동,2614,2360,4974
2022-12-29,경강선,세종대왕릉,320,311,631
2022-12-29,경강선,신둔도예촌,1466,1351,2817
2022-12-29,경강선,여주,2115,2140,4255
2022-12-29,경강선,이매,1178,989,2167
2022-12-29,경강선,이천,2654,2744,5398
2022-12-29,경강선,초월,3336,3091,6427
2022-12-29,경강선,판교,5593,5635,11228
2022-12-29,경부선,가산디지털단지,17270,20242,37512
2022-12-29,경부선,관악,7421,7088,14509
2022-12-29,경부선,광명,3509,3082,6591
2022-12-29,경부선,구로,18506,19182,37688
2022-12-29,경부선,군포,7741,7579,15320
2022-12-29,경부선,금정,27439,28056,55495
2022-12-29,경부선,금천구청,11607,11618,23225
2022-12-29,경부선,남영,10034,10455,20489
2022-12-29,경부선,노량진,9461,9947,19408
2022-12-29,경부선,당정,6351,5997,12348
2022-12-29,경부선,대방,10952,11710,22662
2022-12-29,경부선,독산,18310,18919,37229
2022-12-29,경부선,두정,6027,5807,11834
2022-12-29,경부선,명학,8902,8737,17639
2022-12-29,경부선,병점,14485,14249,28734
2022-12-29,경부선,서동탄,1380,1213,2593
2022-12-29,경부선,서울역,9245,3065,12310
2022-12-29,경부선,서정리,8396,7042,15438
2022-12-29,경부선,석수,9040,8361,17401
2022-12-29,경부선,성균관대,14520,14320,28840
2022-12-29,경부선,성환,3486,3373,6859
2022-12-29,경부선,세류,3189,2879,6068
2022-12-29,경부선,세마,2947,2808,5755
2022-12-29,경부선,송탄,4768,4514,9282
2022-12-29,경부선,수원,35987,38621,74608
2022-12-29,경부선,신길,9009,7638,16647
2022-12-29,경부선,신도림,3950,4117,8067
2022-12-29,경부선,안양,22222,22186,44408
2022-12-29,경부선,영등포,43940,45253,89193
2022-12-29,경부선,오산,9597,9693,19290
2022-12-29,경부선,오산대,3592,3294,6886
2022-12-29,경부선,용산,41917,43932,85849
2022-12-29,경부선,의왕,9189,9028,18217
2022-12-29,경부선,직산,898,853,1751
2022-12-29,경부선,진위,1698,1471,3169
2022-12-29,경부선,천안,5369,5537,10906
2022-12-29,경부선,평택,12470,11946,24416
2022-12-29,경부선,평택지제,4438,4548,8986
2022-12-29,경부선,화서,8340,7956,16296
2022-12-29,경원선,가능,6687,6472,13159
2022-12-29,경원선,광운대,7770,7387,15157
2022-12-29,경원선,녹양,4596,4291,8887
2022-12-29,경원선,녹천,4606,3817,8423
2022-12-29,경원선,덕계,3335,2933,6268
2022-12-29,경원선,덕정,5436,5160,10596
2022-12-29,경원선,도봉,5930,5795,11725
2022-12-29,경원선,도봉산,7242,4448,11690
2022-12-29,경원선,동두천,2019,2122,4141
2022-12-29,경원선,동두천중앙,3010,2893,5903
2022-12-29,경원선,망월사,7569,7538,15107
2022-12-29,경원선,방학,10255,9872,20127
2022-12-29,경원선,보산,1777,1368,3145
2022-12-29,경원선,서빙고,1966,1900,3866
2022-12-29,경원선,석계,8127,9203,17330
2022-12-29,경원선,소요산,1953,1774,3727
2022-12-29,경원선,신이문,8762,7840,16602
2022-12-29,경원선,양주,7325,6977,14302
2022-12-29,경원선,옥수,61,36,97
2022-12-29,경원선,왕십리,16300,17440,33740
2022-12-29,경원선,외대앞,8110,7822,15932
2022-12-29,경원선,월계,6816,6252,13068
2022-12-29,경원선,응봉,1843,1537,3380
2022-12-29,경원선,의정부,18867,19594,38461
2022-12-29,경원선,이촌,3954,3116,7070
2022-12-29,경원선,지행,6652,6500,13152
2022-12-29,경원선,청량리,16364,16997,33361
2022-12-29,경원선,한남,4077,3882,7959
2022-12-29,경원선,회룡,12757,12558,25315
2022-12-29,경의선,가좌,5738,5471,11209
2022-12-29,경의선,강매,3301,2849,6150
2022-12-29,경의선,곡산,566,595,1161
2022-12-29,경의선,공덕,4359,3459,7818
2022-12-29,경의선,금릉,5368,5042,10410
2022-12-29,경의선,금촌,6566,6384,12950
2022-12-29,경의선,능곡,3805,3505,7310
2022-12-29,경의선,디지털미디어시티,2850,2502,5352
2022-12-29,경의선,문산,5332,5367,10699
2022-12-29,경의선,백마,7094,6667,13761
2022-12-29,경의선,서강대,2179,2127,4306
2022-12-29,경의선,서울역,4373,5713,10086
2022-12-29,경의선,수색,2814,2976,5790
2022-12-29,경의선,신촌,886,1156,2042
2022-12-29,경의선,야당,8482,8611,17093
2022-12-29,경의선,운정,7207,6635,13842
2022-12-29,경의선,운천,13,4,17
2022-12-29,경의선,월롱,2793,2038,4831
2022-12-29,경의선,일산,9300,9045,18345
2022-12-29,경의선,임진강,5,2,7
2022-12-29,경의선,탄현,8055,7552,15607
2022-12-29,경의선,파주,1206,756,1962
2022-12-29,경의선,풍산,5879,5578,11457
2022-12-29,경의선,행신,8385,8297,16682
2022-12-29,경의선,홍대입구,2042,2617,4659
2022-12-29,경의선,화전,1610,1494,3104
2022-12-29,경의선,효창공원앞,3151,3581,6732
2022-12-29,경인선,간석,5976,5643,11619
2022-12-29,경인선,개봉,22319,21856,44175
2022-12-29,경인선,구일,6149,5984,12133
2022-12-29,경인선,도원,3270,3285,6555
2022-12-29,경인선,도화,4140,3730,7870
2022-12-29,경인선,동암,16335,16147,32482
2022-12-29,경인선,동인천,13880,13319,27199
2022-12-29,경인선,백운,6644,6280,12924
2022-12-29,경인선,부개,8771,8076,16847
2022-12-29,경인선,부천,32345,32446,64791
2022-12-29,경인선,부평,30234,32242,62476
2022-12-29,경인선,소사,7900,7886,15786
2022-12-29,경인선,송내,27586,27217,54803
2022-12-29,경인선,역곡,27368,27128,54496
2022-12-29,경인선,오류동,12006,11005,23011
2022-12-29,경인선,온수,6787,6228,13015
2022-12-29,경인선,인천,3409,2688,6097
2022-12-29,경인선,제물포,10489,9855,20344
2022-12-29,경인선,주안,19268,17012,36280
2022-12-29,경인선,중동,9465,8762,18227
2022-12-29,경춘선,가평,1867,1884,3751
2022-12-29,경춘선,갈매,2990,2546,5536
2022-12-29,경춘선,강촌,341,355,696
2022-12-29,경춘선,굴봉산,97,142,239
2022-12-29,경춘선,금곡,1430,1442,2872
2022-12-29,경춘선,김유정,339,327,666
2022-12-29,경춘선,남춘천,2378,2484,4862
2022-12-29,경춘선,대성리,562,516,1078
2022-12-29,경춘선,마석,3850,3745,7595
2022-12-29,경춘선,백양리,434,345,779
2022-12-29,경춘선,별내,3192,2930,6122
2022-12-29,경춘선,사릉,2248,2236,4484
2022-12-29,경춘선,상천,217,183,400
2022-12-29,경춘선,신내,2211,2078,4289
2022-12-29,경춘선,천마산,1658,1500,3158
2022-12-29,경춘선,청평,1707,1620,3327
2022-12-29,경춘선,춘천,1316,1166,2482
2022-12-29,경춘선,퇴계원,3535,3204,6739
2022-12-29,경춘선,평내호평,6138,5990,12128
2022-12-29,공항철도,검암,6817,6623,13440
2022-12-29,공항철도,계양,12455,11309,23764
2022-12-29,공항철도,공덕,2748,3860,6608
2022-12-29,공항철도,공항화물청사,2239,2428,4667
2022-12-29,공항철도,김포공항,11106,6285,17391
2022-12-29,공항철도,디지털미디어시티,14689,13600,28289
2022-12-29,공항철도,마곡나루,8853,9562,18415
2022-12-29,공항철도,서울역,11864,10206,22070
2022-12-29,공항철도,영종,3902,3823,7725
2022-12-29,공항철도,운서,8600,8747,17347
2022-12-29,공항철도,인천공항1터미널,11942,11121,23063
2022-12-29,공항철도,인천공항2터미널,4176,3759,7935
2022-12-29,공항철도,청라국제도시,7271,6763,14034
2022-12-29,공항철도,홍대입구,13982,14334,28316
2022-12-29,과천선,경마공원,1245,1260,2505
2022-12-29,과천선,과천,6998,6467,13465
2022-12-29,과천선,대공원,2728,2815,5543
2022-12-29,과천선,범계,27720,28010,55730
2022-12-29,과천선,선바위,8190,7293,15483
2022-12-29,과천선,인덕원,27518,27341,54859
2022-12-29,과천선,정부과천청사,12559,12022,24581
2022-12-29,과천선,평촌,18396,18225,36621
2022-12-29,분당선,가천대,7188,7700,14888
2022-12-29,분당선,강남구청,9903,11379,21282
2022-12-29,분당선,개포동,4260,4217,8477
2022-12-29,분당선,구룡,2220,2125,4345
2022-12-29,분당선,구성,5243,5400,10643
2022-12-29,분당선,기흥,10359,9553,19912
2022-12-29,분당선,대모산입구,5105,4646,9751
2022-12-29,분당선,도곡,7390,7178,14568
2022-12-29,분당선,망포,15517,14613,30130
2022-12-29,분당선,매교,4656,4567,9223
2022-12-29,분당선,매탄권선,5438,5107,10545
2022-12-29,분당선,모란,25753,26551,52304
2022-12-29,분당선,미금,16101,17091,33192
2022-12-29,분당선,보정,2828,2435,5263
2022-12-29,분당선,상갈,5403,5249,10652
2022-12-29,분당선,서울숲,12684,13096,25780
2022-12-29,분당선,서현,26548,26858,53406
2022-12-29,분당선,선릉,13855,21128,34983
2022-12-29,분당선,선정릉,7333,7948,15281
2022-12-29,분당선,수내,14755,14587,29342
2022-12-29,분당선,수서,14181,15201,29382
2022-12-29,분당선,수원,8360,7171,15531
2022-12-29,분당선,수원시청,13190,14566,27756
2022-12-29,분당선,신갈,5191,4905,10096
2022-12-29,분당선,압구정로데오,22809,26041,48850
2022-12-29,분당선,야탑,27015,28365,55380
2022-12-29,분당선,영통,8806,6105,14911
2022-12-29,분당선,오리,11972,9631,21603
2022-12-29,분당선,이매,5866,5546,11412
2022-12-29,분당선,정자,19214,19845,39059
2022-12-29,분당선,죽전,13491,14983,28474
2022-12-29,분당선,청명,4390,4149,8539
2022-12-29,분당선,태평,13938,13350,27288
2022-12-29,분당선,한티,15404,16332,31736
2022-12-29,수인선,고색,4805,4500,9305
2022-12-29,수인선,남동인더스파크,2071,2347,4418
2022-12-29,수인선,달월,120,90,210
2022-12-29,수인선,사리,4954,4170,9124
2022-12-29,수인선,소래포구,4869,4553,9422
2022-12-29,수인선,송도,2518,2320,4838
2022-12-29,수인선,숭의,4190,3775,7965
2022-12-29,수인선,신포,1805,1940,3745
2022-12-29,수인선,야목,370,265,635
2022-12-29,수인선,어천,959,913,1872
2022-12-29,수인선,연수,4809,4795,9604
2022-12-29,수인선,오목천,3296,3005,6301
2022-12-29,수인선,원인재,4379,4429,8808
2022-12-29,수인선,월곶,2727,2456,5183
2022-12-29,수인선,인천,1039,1662,2701
2022-12-29,수인선,인천논현,5705,5981,11686
2022-12-29,수인선,인하대,5980,5664,11644
2022-12-29,수인선,호구포,4100,4331,8431
2022-12-29,신림선,관악산,2052,2085,4137
2022-12-29,신림선,당곡,4304,4234,8538
2022-12-29,신림선,대방,2561,2038,4599
2022-12-29,신림선,보라매,3493,3242,6735
2022-12-29,신림선,보라매공원,1836,1985,3821
2022-12-29,신림선,보라매병원,6969,7254,14223
2022-12-29,신림선,샛강,2676,3307,5983
2022-12-29,신림선,서울대벤처타운,8238,7830,16068
2022-12-29,신림선,서울지방병무청,2606,2906,5512
2022-12-29,신림선,서원,3235,2744,5979
2022-12-29,신림선,신림,1713,2362,4075
2022-12-29,안산선,고잔,8968,8614,17582
2022-12-29,안산선,대야미,4964,4383,9347
2022-12-29,안산선,반월,4271,4129,8400
2022-12-29,안산선,산본,16653,17739,34392
2022-12-29,안산선,상록수,15419,15524,30943
2022-12-29,안산선,수리산,4131,3405,7536
2022-12-29,안산선,신길온천,1787,1646,3433
2022-12-29,안산선,안산,10994,10130,21124
2022-12-29,안산선,오이도,8219,8128,16347
2022-12-29,안산선,정왕,7787,8076,15863
2022-12-29,안산선,중앙,18461,19126,37587
2022-12-29,안산선,초지,4834,4834,9668
2022-12-29,안산선,한대앞,9169,9226,18395
2022-12-29,우이신설선,4.19민주묘지,2837,2691,5528
2022-12-29,우이신설선,가오리,4270,4179,8449
2022-12-29,우이신설선,보문,1509,1571,3080
2022-12-29,우이신설선,북한산보국문,6251,5956,12207
2022-12-29,우이신설선,북한산우이,2657,2411,5068
2022-12-29,우이신설선,삼양,1984,2104,4088
2022-12-29,우이신설선,삼양사거리,2622,2523,5145
2022-12-29,우이신설선,성신여대입구,3413,3846,7259
2022-12-29,우이신설선,솔밭공원,2681,2442,5123
2022-12-29,우이신설선,솔샘,6154,5631,11785
2022-12-29,우이신설선,신설동,2247,2222,4469
2022-12-29,우이신설선,정릉,4766,4549,9315
2022-12-29,우이신설선,화계,3600,3348,6948
2022-12-29,일산선,대곡,2033,1569,3602
2022-12-29,일산선,대화,12956,10318,23274
2022-12-29,일산선,마두,7784,8025,15809
2022-12-29,일산선,백석,10402,10415,20817
2022-12-29,일산선,삼송,20106,19241,39347
2022-12-29,일산선,원당,11227,10535,21762
2022-12-29,일산선,원흥,11651,10898,22549
2022-12-29,일산선,정발산,8574,9398,17972
2022-12-29,일산선,주엽,9380,9361,18741
2022-12-29,일산선,지축,1,0,1
2022-12-29,일산선,화정,17343,17881,35224
2022-12-29,장항선,배방,1168,1060,2228
2022-12-29,장항선,봉명,1368,1355,2723
2022-12-29,장항선,신창,1192,1124,2316
2022-12-29,장항선,쌍용,2269,2168,4437
2022-12-29,장항선,아산,3324,3313,6637
2022-12-29,장항선,온양온천,5098,5151,10249
2022-12-29,장항선,탕정,1242,1069,2311
2022-12-29,중앙선,구리,13602,13736,27338
2022-12-29,중앙선,국수,755,759,1514
2022-12-29,중앙선,덕소,5503,5520,11023
2022-12-29,중앙선,도농,11359,10288,21647
2022-12-29,중앙선,도심,2383,1848,4231
2022-12-29,중앙선,망우,7730,7354,15084
2022-12-29,중앙선,상봉,5861,5878,11739
2022-12-29,중앙선,신원,221,196,417
2022-12-29,중앙선,아신,513,507,1020
2022-12-29,중앙선,양수,1893,1788,3681
2022-12-29,중앙선,양원,3058,2926,5984
2022-12-29,중앙선,양정,573,504,1077
2022-12-29,중앙선,양평,2758,2789,5547
2022-12-29,중앙선,오빈,289,272,561
2022-12-29,중앙선,용문,1603,1631,3234
2022-12-29,중앙선,운길산,603,534,1137
2022-12-29,중앙선,원덕,308,275,583
2022-12-29,중앙선,중랑,5776,5341,11117
2022-12-29,중앙선,지평,50,57,107
2022-12-29,중앙선,팔당,759,786,1545
2022-12-29,중앙선,회기,25636,24047,49683
2022-12-30,1호선,동대문,12171,11017,23188
2022-12-30,1호선,동묘앞,8633,8884,17517
2022-12-30,1호선,서울역,53890,54534,108424
2022-12-30,1호선,시청,26963,27195,54158
2022-12-30,1호선,신설동,14443,13440,27883
2022-12-30,1호선,제기동,18927,19311,38238
2022-12-30,1호선,종각,39419,38318,77737
2022-12-30,1호선,종로3가,29723,28038,57761
2022-12-30,1호선,종로5가,27648,27462,55110
2022-12-30,1호선,청량리,21184,21199,42383
2022-12-30,2호선,강남,83723,83171,166894
2022-12-30,2호선,강변,33839,35588,69427
2022-12-30,2호선,건대입구,40289,44332,84621
2022-12-30,2호선,교대,31965,36395,68360
2022-12-30,2호선,구로디지털단지,58852,57865,116717
2022-12-30,2호선,구의,25485,24292,49777
2022-12-30,2호선,낙성대,27941,25025,52966
2022-12-30,2호선,당산,18217,21005,39222
2022-12-30,2호선,대림,24440,25180,49620
2022-12-30,2호선,도림천,1370,1439,2809
2022-12-30,2호선,동대문역사문화공원,15866,17405,33271
2022-12-30,2호선,뚝섬,22987,24208,47195
2022-12-30,2호선,문래,22409,23322,45731
2022-12-30,2호선,방배,15526,15967,31493
2022-12-30,2호선,봉천,24428,21982,46410
2022-12-30,2호선,사당,40262,44340,84602
2022-12-30,2호선,삼성,54320,53637,107957
2022-12-30,2호선,상왕십리,14428,13679,28107
2022-12-30,2호선,서울대입구,49956,46472,96428
2022-12-30,2호선,서초,20229,18828,39057
2022-12-30,2호선,선릉,52250,46636,98886
2022-12-30,2호선,성수,40522,44529,85051
2022-12-30,2호선,시청,26269,24330,50599
2022-12-30,2호선,신답,1697,1806,3503
2022-12-30,2호선,신당,15379,15839,31218
2022-12-30,2호선,신대방,25784,24106,49890
2022-12-30,2호선,신도림,51823,51234,103057
2022-12-30,2호선,신림,61387,57944,119331
2022-12-30,2호선,신설동,3649,3564,7213
2022-12-30,2호선,신정네거리,10707,10964,21671
2022-12-30,2호선,신촌,41609,42157,83766
2022-12-30,2호선,아현,11025,10211,21236
2022-12-30,2호선,양천구청,6988,7276,14264
2022-12-30,2호선,역삼,44228,48814,93042
2022-12-30,2호선,영등포구청,21970,22632,44602
2022-12-30,2호선,왕십리,17266,15535,32801
2022-12-30,2호선,용답,2919,2776,5695
2022-12-30,2호선,용두,2676,2582,5258
2022-12-30,2호선,을지로3가,25462,25982,51444
2022-12-30,2호선,을지로4가,15226,16021,31247
2022-12-30,2호선,을지로입구,51718,51971,103689
2022-12-30,2호선,이대,15671,15950,31621
2022-12-30,2호선,잠실,87390,86873,174263
2022-12-30,2호선,잠실나루,14539,13790,28329
2022-12-30,2호선,잠실새내,23922,24718,48640
2022-12-30,2호선,종합운동장,11701,12182,23883
2022-12-30,2호선,충정로,9642,10137,19779
2022-12-30,2호선,한양대,8772,8894,17666
2022-12-30,2호선,합정,35340,40151,75491
2022-12-30,2호선,홍대입구,78557,86930,165487
2022-12-30,3호선,가락시장,9323,9381,18704
2022-12-30,3호선,경복궁,23431,23986,47417
2022-12-30,3호선,경찰병원,7165,7089,14254
2022-12-30,3호선,고속터미널,53139,58303,111442
2022-12-30,3호선,교대,13875,8746,22621
2022-12-30,3호선,구파발,21839,20738,42577
2022-12-30,3호선,금호,8247,7584,15831
2022-12-30,3호선,남부터미널,30547,32162,62709
2022-12-30,3호선,녹번,15724,13736,29460
2022-12-30,3호선,대청,10535,9757,20292
2022-12-30,3호선,대치,12012,11939,23951
2022-12-30,3호선,도곡,4710,4691,9401
2022-12-30,3호선,독립문,7496,7334,14830
2022-12-30,3호선,동대입구,9236,10441,19677
2022-12-30,3호선,매봉,11967,11598,23565
2022-12-30,3호선,무악재,4204,4031,8235
2022-12-30,3호선,불광,16584,17805,34389
2022-12-30,3호선,수서,18147,18574,36721
2022-12-30,3호선,신사,30942,33515,64457
2022-12-30,3호선,안국,24662,25968,50630
2022-12-30,3호선,압구정,35168,38607,73775
2022-12-30,3호선,약수,13712,12915,26627
2022-12-30,3호선,양재,36022,37407,73429
2022-12-30,3호선,연신내,37972,35777,73749
2022-12-30,3호선,오금,6161,5402,11563
2022-12-30,3호선,옥수,9303,9414,18717
2022-12-30,3호선,을지로3가,11984,12111,24095
2022-12-30,3호선,일원,10512,9567,20079
2022-12-30,3호선,잠원,5002,4786,9788
2022-12-30,3호선,종로3가,11298,14312,25610
2022-12-30,3호선,지축,6219,5928,12147
2022-12-30,3호선,충무로,3,0,3
2022-12-30,3호선,학여울,1724,1710,3434
2022-12-30,3호선,홍제,17987,17052,35039
2022-12-30,4호선,길음,21187,20291,41478
2022-12-30,4호선,남태령,1332,1061,2393
2022-12-30,4호선,노원,21315,24704,46019
2022-12-30,4호선,당고개,9404,8458,17862
2022-12-30,4호선,동대문,20517,21085,41602
2022-12-30,4호선,동대문역사문화공원,19629,16718,36347
2022-12-30,4호선,동작,1176,1313,2489
2022-12-30,4호선,명동,32364,35690,68054
2022-12-30,4호선,미아,15620,14778,30398
2022-12-30,4호선,미아사거리,29550,29255,58805
2022-12-30,4호선,사당,27149,24077,51226
2022-12-30,4호선,삼각지,6653,7527,14180
2022-12-30,4호선,상계,19475,18195,37670
2022-12-30,4호선,서울역,11108,21448,32556
2022-12-30,4호선,성신여대입구,22018,21161,43179
2022-12-30,4호선,수유,37041,37557,74598
2022-12-30,4호선,숙대입구,13690,13404,27094
2022-12-30,4호선,신용산,18981,20603,39584
2022-12-30,4호선,쌍문,30726,28076,58802
2022-12-30,4호선,이촌,10583,11175,21758
2022-12-30,4호선,창동,26142,27914,54056
2022-12-30,4호선,총신대입구,19482,21663,41145
2022-12-30,4호선,충무로,27221,28792,56013
2022-12-30,4호선,한성대입구,13735,12832,26567
2022-12-30,4호선,혜화,39803,39790,79593
2022-12-30,4호선,회현,27961,29128,57089
2022-12-30,5호선,강동,18201,16849,35050
2022-12-30,5호선,강일,5340,4658,9998
2022-12-30,5호선,개롱,6302,6565,12867
2022-12-30,5호선,개화산,5741,5371,11112
2022-12-30,5호선,거여,10272,9582,19854
2022-12-30,5호선,고덕,9967,9772,19739
2022-12-30,5호선,공덕,14182,14829,29011
2022-12-30,5호선,광나루,14415,13236,27651
2022-12-30,5호선,광화문,37549,38506,76055
2022-12-30,5호선,군자,12340,13666,26006
2022-12-30,5호선,굽은다리,10309,9802,20111
2022-12-30,5호선,길동,8640,9127,17767
2022-12-30,5호선,김포공항,8582,8675,17257
2022-12-30,5호선,까치산,30082,28176,58258
2022-12-30,5호선,답십리,16668,15064,31732
2022-12-30,5호선,동대문역사문화공원,3085,3540,6625
2022-12-30,5호선,둔촌동,8891,8866,17757
2022-12-30,5호선,마곡,10600,10790,21390
2022-12-30,5호선,마장,6291,5919,12210
2022-12-30,5호선,마천,7424,6964,14388
2022-12-30,5호선,마포,14200,14604,28804
2022-12-30,5호선,명일,8779,8910,17689
2022-12-30,5호선,목동,16979,17945,34924
2022-12-30,5호선,미사,17576,17692,35268
2022-12-30,5호선,발산,20701,22560,43261
2022-12-30,5호선,방이,7030,7381,14411
2022-12-30,5호선,방화,7168,6596,13764
2022-12-30,5호선,상일동,14676,13596,28272
2022-12-30,5호선,서대문,18626,18746,37372
2022-12-30,5호선,송정,6934,6451,13385
2022-12-30,5호선,신금호,6669,6779,13448
2022-12-30,5호선,신길,4598,4640,9238
2022-12-30,5호선,신정,14133,11527,25660
2022-12-30,5호선,아차산,15492,14626,30118
2022-12-30,5호선,애오개,6865,6625,13490
2022-12-30,5호선,양평,7158,6869,14027
2022-12-30,5호선,여의나루,10191,13204,23395
2022-12-30,5호선,여의도,29291,29821,59112
2022-12-30,5호선,영등포구청,4159,4117,8276
2022-12-30,5호선,영등포시장,11080,11277,22357
2022-12-30,5호선,오금,3643,3627,7270
2022-12-30,5호선,오목교,23073,24736,47809
2022-12-30,5호선,올림픽공원,6212,5695,11907
2022-12-30,5호선,왕십리,4773,5883,10656
2022-12-30,5호선,우장산,15153,14674,29827
2022-12-30,5호선,을지로4가,7064,7606,14670
2022-12-30,5호선,장한평,19599,19223,38822
2022-12-30,5호선,종로3가,16961,16948,33909
2022-12-30,5호선,천호,20490,20219,40709
2022-12-30,5호선,청구,3942,3682,7624
2022-12-30,5호선,충정로,4241,4299,8540
2022-12-30,5호선,하남검단산,7158,6662,13820
2022-12-30,5호선,하남시청,7773,7461,15234
2022-12-30,5호선,하남풍산,4490,4420,8910
2022-12-30,5호선,행당,8179,7000,15179
2022-12-30,5호선,화곡,30287,27725,58012
2022-12-30,6호선,고려대,8442,7876,16318
2022-12-30,6호선,공덕,18853,18247,37100
2022-12-30,6호선,광흥창,8805,8549,17354
2022-12-30,6호선,구산,8027,6115,14142
2022-12-30,6호선,녹사평,5819,6103,11922
2022-12-30,6호선,대흥,8650,8638,17288
2022-12-30,6호선,독바위,2772,2724,5496
2022-12-30,6호선,돌곶이,9650,8826,18476
2022-12-30,6호선,동묘앞,8555,8139,16694
2022-12-30,6호선,디지털미디어시티,13667,15125,28792
2022-12-30,6호선,마포구청,14526,12811,27337
2022-12-30,6호선,망원,16289,17849,34138
2022-12-30,6호선,버티고개,2036,2098,4134
2022-12-30,6호선,보문,7921,6827,14748
2022-12-30,6호선,봉화산,8962,8493,17455
2022-12-30,6호선,불광,4663,4517,9180
2022-12-30,6호선,삼각지,7972,6984,14956
2022-12-30,6호선,상수,10843,13756,24599
2022-12-30,6호선,상월곡,6314,5427,11741
2022-12-30,6호선,새절,12855,11792,24647
2022-12-30,6호선,석계,12427,12605,25032
2022-12-30,6호선,신당,9450,8776,18226
2022-12-30,6호선,안암,10645,9974,20619
2022-12-30,6호선,약수,3816,3856,7672
2022-12-30,6호선,역촌,3883,4378,8261
2022-12-30,6호선,월곡,11796,11129,22925
2022-12-30,6호선,월드컵경기장,4548,4738,9286
2022-12-30,6호선,응암,18239,17711,35950
2022-12-30,6호선,이태원,12081,13346,25427
2022-12-30,6호선,증산,10406,9927,20333
2022-12-30,6호선,창신,3592,2907,6499
2022-12-30,6호선,청구,3843,3849,7692
2022-12-30,6호선,태릉입구,5904,6303,12207
2022-12-30,6호선,한강진,9986,11855,21841
2022-12-30,6호선,합정,15939,15417,31356
2022-12-30,6호선,화랑대,11610,8643,20253
2022-12-30,6호선,효창공원앞,7126,6274,13400
2022-12-30,7호선,가산디지털단지,39248,38543,77791
2022-12-30,7호선,강남구청,15413,17260,32673
2022-12-30,7호선,건대입구,14338,14858,29196
2022-12-30,7호선,고속터미널,18528,15141,33669
2022-12-30,7호선,공릉,11771,11749,23520
2022-12-30,7호선,광명사거리,22861,22644,45505
2022-12-30,7호선,군자,15846,12128,27974
2022-12-30,7호선,남구로,14210,15193,29403
2022-12-30,7호선,남성,11242,10200,21442
2022-12-30,7호선,내방,14101,14266,28367
2022-12-30,7호선,노원,23029,24491,47520
2022-12-30,7호선,논현,17019,18267,35286
2022-12-30,7호선,대림,8631,8901,17532
2022-12-30,7호선,도봉산,8302,9802,18104
2022-12-30,7호선,뚝섬유원지,8039,7824,15863
2022-12-30,7호선,마들,13281,12130,25411
2022-12-30,7호선,먹골,10886,10527,21413
2022-12-30,7호선,면목,15509,14839,30348
2022-12-30,7호선,반포,6576,6248,12824
2022-12-30,7호선,보라매,7175,7128,14303
2022-12-30,7호선,사가정,16747,16840,33587
2022-12-30,7호선,상도,11175,10132,21307
2022-12-30,7호선,상봉,17945,17511,35456
2022-12-30,7호선,수락산,13198,12818,26016
2022-12-30,7호선,숭실대입구,12129,11561,23690
2022-12-30,7호선,신대방삼거리,15092,14016,29108
2022-12-30,7호선,신풍,11478,10794,22272
2022-12-30,7호선,어린이대공원,12916,12255,25171
2022-12-30,7호선,온수,9575,8586,18161
2022-12-30,7호선,용마산,5863,5618,11481
2022-12-30,7호선,이수,16840,15938,32778
2022-12-30,7호선,장승배기,9331,8756,18087
2022-12-30,7호선,장암,2224,979,3203
2022-12-30,7호선,중계,14121,12443,26564
2022-12-30,7호선,중곡,10919,10183,21102
2022-12-30,7호선,중화,11095,10616,21711
2022-12-30,7호선,천왕,11791,10860,22651
2022-12-30,7호선,철산,22191,22499,44690
2022-12-30,7호선,청담,18122,20409,38531
2022-12-30,7호선,태릉입구,8691,8292,16983
2022-12-30,7호선,하계,17722,16302,34024
2022-12-30,7호선,학동,20991,22461,43452
2022-12-30,8호선,가락시장,8514,9642,18156
2022-12-30,8호선,강동구청,10536,10681,21217
2022-12-30,8호선,남위례,5951,6035,11986
2022-12-30,8호선,남한산성입구,13324,11503,24827
2022-12-30,8호선,단대오거리,11574,11136,22710
2022-12-30,8호선,모란,4831,4109,8940
2022-12-30,8호선,몽촌토성,6155,6204,12359
2022-12-30,8호선,문정,17951,18448,36399
2022-12-30,8호선,복정,8629,7281,15910
2022-12-30,8호선,산성,5115,4849,9964
2022-12-30,8호선,석촌,8070,9511,17581
2022-12-30,8호선,송파,9320,9009,18329
2022-12-30,8호선,수진,5612,5009,10621
2022-12-30,8호선,신흥,5441,5506,10947
2022-12-30,8호선,암사,19076,16574,35650
2022-12-30,8호선,잠실,18534,21654,40188
2022-12-30,8호선,장지,17460,16478,33938
2022-12-30,8호선,천호,15589,18535,34124
2022-12-30,9호선,가양,21826,20902,42728
2022-12-30,9호선,개화,2474,1717,4191
2022-12-30,9호선,고속터미널,15249,23148,38397
2022-12-30,9호선,공항시장,3070,3295,6365
2022-12-30,9호선,구반포,1030,1050,2080
2022-12-30,9호선,국회의사당,14075,14516,28591
2022-12-30,9호선,김포공항,8083,11413,19496
2022-12-30,9호선,노들,4652,3824,8476
2022-12-30,9호선,노량진,28269,26862,55131
2022-12-30,9호선,당산,19726,18724,38450
2022-12-30,9호선,동작,1664,1239,2903
2022-12-30,9호선,등촌,11734,11145,22879
2022-12-30,9호선,마곡나루,12446,12292,24738
2022-12-30,9호선,사평,3836,3603,7439
2022-12-30,9호선,샛강,6070,6055,12125
2022-12-30,9호선,선유도,7825,7165,14990
2022-12-30,9호선,신논현,32874,33036,65910
2022-12-30,9호선,신목동,4070,3481,7551
2022-12-30,9호선,신반포,3687,3532,7219
2022-12-30,9호선,신방화,7033,6726,13759
2022-12-30,9호선,양천향교,9328,9297,18625
2022-12-30,9호선,여의도,29057,26545,55602
2022-12-30,9호선,염창,17917,16426,34343
2022-12-30,9호선,증미,6762,6190,12952
2022-12-30,9호선,흑석,8340,8486,16826
2022-12-30,9호선2~3단계,둔촌오륜,929,932,1861
2022-12-30,9호선2~3단계,봉은사,18999,19414,38413
2022-12-30,9호선2~3단계,삼성중앙,7006,7258,14264
2022-12-30,9호선2~3단계,삼전,7432,6743,14175
2022-12-30,9호선2~3단계,석촌,9348,8060,17408
2022-12-30,9호선2~3단계,석촌고분,6996,6696,13692
2022-12-30,9호선2~3단계,선정릉,8603,9286,17889
2022-12-30,9호선2~3단계,송파나루,6192,6622,12814
2022-12-30,9호선2~3단계,언주,10031,10034,20065
2022-12-30,9호선2~3단계,올림픽공원,11869,12010,23879
2022-12-30,9호선2~3단계,종합운동장,4706,4863,9569
2022-12-30,9호선2~3단계,중앙보훈병원,10419,9035,19454
2022-12-30,9호선2~3단계,한성백제,2670,2337,5007
2022-12-30,경강선,경기광주,8224,7596,15820
2022-12-30,경강선,곤지암,2568,2496,5064
2022-12-30,경강선,부발,2727,2153,4880
2022-12-30,경강선,삼동,2433,2174,4607
2022-12-30,경강선,세종대왕릉,373,336,709
2022-12-30,경강선,신둔도예촌,1559,1527,3086
2022-12-30,경강선,여주,2397,2635,5032
2022-12-30,경강선,이매,1117,970,2087
2022-12-30,경강선,이천,3060,3378,6438
2022-12-30,경강선,초월,3481,3119,6600
2022-12-30,경강선,판교,5344,5349,10693
2022-12-30,경부선,가산디지털단지,14913,17876,32789
2022-12-30,경부선,관악,7245,6893,14138
2022-12-30,경부선,광명,3564,3345,6909
2022-12-30,경부선,구로,18063,18845,36908
2022-12-30,경부선,군포,7281,6941,14222
2022-12-30,경부선,금정,27004,27576,54580
2022-12-30,경부선,금천구청,11784,11529,23313
2022-12-30,경부선,남영,9389,9643,19032
2022-12-30,경부선,노량진,10030,10462,20492
2022-12-30,경부선,당정,6014,5554,11568
2022-12-30,경부선,대방,10448,11309,21757
2022-12-30,경부선,독산,17064,17281,34345
2022-12-30,경부선,두정,6700,6380,13080
2022-12-30,경부선,명학,8084,7782,15866
2022-12-30,경부선,병점,15290,14959,30249
2022-12-30,경부선,서동탄,1332,1253,2585
2022-12-30,경부선,서울역,9456,3514,12970
2022-12-30,경부선,서정리,11650,7645,19295
2022-12-30,경부선,석수,9051,8046,17097
2022-12-30,경부선,성균관대,14570,14081,28651
2022-12-30,경부선,성환,4097,3713,7810
2022-12-30,경부선,세류,3400,3114,6514
2022-12-30,경부선,세마,3057,2784,5841
2022-12-30,경부선,송탄,6003,5036,11039
2022-12-30,경부선,수원,39430,44668,84098
2022-12-30,경부선,신길,8872,7382,16254
2022-12-30,경부선,신도림,3913,4085,7998
2022-12-30,경부선,안양,22765,22859,45624
2022-12-30,경부선,영등포,47157,49597,96754
2022-12-30,경부선,오산,10762,10296,21058
2022-12-30,경부선,오산대,3727,3361,7088
2022-12-30,경부선,용산,46182,48894,95076
2022-12-30,경부선,의왕,8650,8347,16997
2022-12-30,경부선,직산,938,876,1814
2022-12-30,경부선,진위,1709,1457,3166
2022-12-30,경부선,천안,6502,6872,13374
2022-12-30,경부선,평택,15023,14665,29688
2022-12-30,경부선,평택지제,5746,4743,10489
2022-12-30,경부선,화서,7845,7487,15332
2022-12-30,경원선,가능,6910,6550,13460
2022-12-30,경원선,광운대,7553,7226,14779
2022-12-30,경원선,녹양,4624,4308,8932
2022-12-30,경원선,녹천,4626,3797,8423
2022-12-30,경원선,덕계,3377,3012,6389
2022-12-30,경원선,덕정,5722,5429,11151
2022-12-30,경원선,도봉,5917,5649,11566
2022-12-30,경원선,도봉산,7649,4650,12299
2022-12-30,경원선,동두천,2207,2412,4619
2022-12-30,경원선,동두천중앙,3236,3258,6494
2022-12-30,경원선,망월사,7581,7527,15108
2022-12-30,경원선,방학,10229,10021,20250
2022-12-30,경원선,보산,2082,1829,3911
2022-12-30,경원선,서빙고,1992,1832,3824
2022-12-30,경원선,석계,8140,9158,17298
2022-12-30,경원선,소요산,2319,2183,4502
2022-12-30,경원선,신이문,8839,7826,16665
2022-12-30,경원선,양주,7802,7280,15082
2022-12-30,경원선,옥수,59,33,92
2022-12-30,경원선,왕십리,16949,17910,34859
2022-12-30,경원선,외대앞,8107,7721,15828
2022-12-30,경원선,월계,6868,6221,13089
2022-12-30,경원선,응봉,1869,1532,3401
2022-12-30,경원선,의정부,20325,21900,42225
2022-12-30,경원선,이촌,3864,3001,6865
2022-12-30,경원선,지행,7093,7027,14120
2022-12-30,경원선,창동,1,0,1
2022-12-30,경원선,청량리,18422,19726,38148
2022-12-30,경원선,한남,4033,3934,7967
2022-12-30,경원선,회룡,12669,12760,25429
2022-12-30,경의선,가좌,5878,5470,11348
2022-12-30,경의선,강매,3098,2545,5643
2022-12-30,경의선,곡산,523,534,1057
2022-12-30,경의선,공덕,3927,3218,7145
2022-12-30,경의선,금릉,5393,5197,10590
2022-12-30,경의선,금촌,7184,6842,14026
2022-12-30,경의선,능곡,3818,3477,7295
2022-12-30,경의선,디지털미디어시티,2892,2475,5367
2022-12-30,경의선,문산,5585,5478,11063
2022-12-30,경의선,백마,6721,6473,13194
2022-12-30,경의선,서강대,2213,2104,4317
2022-12-30,경의선,서울역,4169,5575,9744
2022-12-30,경의선,수색,2583,2563,5146
2022-12-30,경의선,신촌,863,1251,2114
2022-12-30,경의선,야당,8853,9311,18164
2022-12-30,경의선,운정,7075,6555,13630
2022-12-30,경의선,운천,8,2,10
2022-12-30,경의선,월롱,2922,1789,4711
2022-12-30,경의선,일산,9151,9034,18185
2022-12-30,경의선,임진강,11,6,17
2022-12-30,경의선,탄현,8079,7569,15648
2022-12-30,경의선,파주,1211,867,2078
2022-12-30,경의선,풍산,5807,5501,11308
2022-12-30,경의선,행신,8471,8296,16767
2022-12-30,경의선,홍대입구,2219,2941,5160
2022-12-30,경의선,화전,1402,1270,2672
2022-12-30,경의선,효창공원앞,3016,3397,6413
2022-12-30,경인선,간석,6232,5693,11925
2022-12-30,경인선,개봉,22882,22044,44926
2022-12-30,경인선,구일,6184,5809,11993
2022-12-30,경인선,도원,3491,3363,6854
2022-12-30,경인선,도화,4318,3889,8207
2022-12-30,경인선,동암,16802,17099,33901
2022-12-30,경인선,동인천,14821,14251,29072
2022-12-30,경인선,백운,6829,6587,13416
2022-12-30,경인선,부개,8805,8185,16990
2022-12-30,경인선,부천,34154,35230,69384
2022-12-30,경인선,부평,32226,36380,68606
2022-12-30,경인선,소사,8070,7792,15862
2022-12-30,경인선,송내,27509,27015,54524
2022-12-30,경인선,역곡,27331,27254,54585
2022-12-30,경인선,오류동,11855,10895,22750
2022-12-30,경인선,온수,6732,6201,12933
2022-12-30,경인선,인천,3748,2872,6620
2022-12-30,경인선,제물포,10803,10025,20828
2022-12-30,경인선,주안,19909,18006,37915
2022-12-30,경인선,중동,9396,8573,17969
2022-12-30,경춘선,가평,1951,2038,3989
2022-12-30,경춘선,갈매,2947,2512,5459
2022-12-30,경춘선,강촌,408,387,795
2022-12-30,경춘선,굴봉산,124,154,278
2022-12-30,경춘선,금곡,1495,1452,2947
2022-12-30,경춘선,김유정,317,344,661
2022-12-30,경춘선,남춘천,2900,3043,5943
2022-12-30,경춘선,대성리,558,515,1073
2022-12-30,경춘선,마석,3938,3873,7811
2022-12-30,경춘선,백양리,515,402,917
2022-12-30,경춘선,별내,3189,2976,6165
2022-12-30,경춘선,사릉,2221,2254,4475
2022-12-30,경춘선,상천,214,223,437
2022-12-30,경춘선,신내,2004,1938,3942
2022-12-30,경춘선,천마산,1573,1455,3028
2022-12-30,경춘선,청평,1691,1771,3462
2022-12-30,경춘선,춘천,1468,1388,2856
2022-12-30,경춘선,퇴계원,3514,3213,6727
2022-12-30,경춘선,평내호평,6164,6041,12205
2022-12-30,공항철도,검암,6526,6422,12948
2022-12-30,공항철도,계양,12053,11126,23179
2022-12-30,공항철도,공덕,2625,3624,6249
2022-12-30,공항철도,공항화물청사,2270,2216,4486
2022-12-30,공항철도,김포공항,10862,5852,16714
2022-12-30,공항철도,디지털미디어시티,13254,12057,25311
2022-12-30,공항철도,마곡나루,7700,8013,15713
2022-12-30,공항철도,서울역,12721,11793,24514
2022-12-30,공항철도,영종,4013,4057,8070
2022-12-30,공항철도,운서,9285,9100,18385
2022-12-30,공항철도,인천공항1터미널,11992,11176,23168
2022-12-30,공항철도,인천공항2터미널,4148,3568,7716
2022-12-30,공항철도,청라국제도시,7133,6681,13814
2022-12-30,공항철도,홍대입구,15047,15564,30611
2022-12-30,과천선,경마공원,1165,1236,2401
2022-12-30,과천선,과천,6811,6169,12980
2022-12-30,과천선,대공원,3160,3126,6286
2022-12-30,과천선,범계,27771,28139,55910
2022-12-30,과천선,선바위,7526,6619,14145
2022-12-30,과천선,인덕원,23972,24596,48568
2022-12-30,과천선,정부과천청사,10567,10673,21240
2022-12-30,과천선,평촌,16503,16203,32706
2022-12-30,분당선,가천대,6950,7258,14208
2022-12-30,분당선,강남구청,8989,10375,19364
2022-12-30,분당선,개포동,4019,4112,8131
2022-12-30,분당선,구룡,2255,1927,4182
2022-12-30,분당선,구성,4946,5246,10192
2022-12-30,분당선,기흥,10054,9306,19360
2022-12-30,분당선,대모산입구,4883,4265,9148
2022-12-30,분당선,도곡,7156,6814,13970
2022-12-30,분당선,망포,15643,13724,29367
2022-12-30,분당선,매교,4603,4493,9096
2022-12-30,분당선,매탄권선,5713,4862,10575
2022-12-30,분당선,모란,20234,20901,41135
2022-12-30,분당선,미금,16133,16727,32860
2022-12-30,분당선,보정,2711,2360,5071
2022-12-30,분당선,복정,2,0,2
2022-12-30,분당선,상갈,5539,5195,10734
2022-12-30,분당선,서울숲,12436,12889,25325
2022-12-30,분당선,서현,27022,27490,54512
2022-12-30,분당선,선릉,11875,18108,29983
2022-12-30,분당선,선정릉,6575,6807,13382
2022-12-30,분당선,수내,13999,13802,27801
2022-12-30,분당선,수서,13516,15064,28580
2022-12-30,분당선,수원,8737,7687,16424
2022-12-30,분당선,수원시청,13868,16416,30284
2022-12-30,분당선,신갈,4971,4684,9655
2022-12-30,분당선,압구정로데오,23188,27756,50944
2022-12-30,분당선,야탑,26701,28442,55143
2022-12-30,분당선,영통,9293,9373,18666
2022-12-30,분당선,오리,11428,9123,20551
2022-12-30,분당선,이매,6010,5581,11591
2022-12-30,분당선,정자,18024,18910,36934
2022-12-30,분당선,죽전,13737,14737,28474
2022-12-30,분당선,청명,4341,4113,8454
2022-12-30,분당선,태평,14202,13602,27804
2022-12-30,분당선,한티,15749,16408,32157
2022-12-30,수인선,고색,4367,4046,8413
2022-12-30,수인선,남동인더스파크,1891,2186,4077
2022-12-30,수인선,달월,108,87,195
2022-12-30,수인선,사리,5177,4222,9399
2022-12-30,수인선,소래포구,5214,4916,10130
2022-12-30,수인선,송도,2628,2356,4984
2022-12-30,수인선,숭의,4143,3806,7949
2022-12-30,수인선,신포,1844,1925,3769
2022-12-30,수인선,야목,332,278,610
2022-12-30,수인선,어천,1145,951,2096
2022-12-30,수인선,연수,5070,5084,10154
2022-12-30,수인선,오목천,3679,3108,6787
2022-12-30,수인선,원인재,4566,4598,9164
2022-12-30,수인선,월곶,2783,2590,5373
2022-12-30,수인선,인천,1056,1715,2771
2022-12-30,수인선,인천논현,6045,6212,12257
2022-12-30,수인선,인하대,5871,5312,11183
2022-12-30,수인선,호구포,4177,4190,8367
2022-12-30,신림선,관악산,2511,2327,4838
2022-12-30,신림선,당곡,4361,4153,8514
2022-12-30,신림선,대방,2662,2058,4720
2022-12-30,신림선,보라매,3581,3175,6756
2022-12-30,신림선,보라매공원,1717,1866,3583
2022-12-30,신림선,보라매병원,6274,6489,12763
2022-12-30,신림선,샛강,2408,3093,5501
2022-12-30,신림선,서울대벤처타운,8659,7853,16512
2022-12-30,신림선,서울지방병무청,2615,2664,5279
2022-12-30,신림선,서원,3351,2747,6098
2022-12-30,신림선,신림,1782,2370,4152
2022-12-30,안산선,고잔,8853,8578,17431
2022-12-30,안산선,대야미,5193,4384,9577
2022-12-30,안산선,반월,4553,4233,8786
2022-12-30,안산선,산본,17122,18438,35560
2022-12-30,안산선,상록수,15785,15573,31358
2022-12-30,안산선,수리산,4129,3273,7402
2022-12-30,안산선,신길온천,1852,1801,3653
2022-12-30,안산선,안산,11931,11587,23518
2022-12-30,안산선,오이도,8659,8553,17212
2022-12-30,안산선,정왕,8446,8614,17060
2022-12-30,안산선,중앙,19354,21111,40465
2022-12-30,안산선,초지,4974,4878,9852
2022-12-30,안산선,한대앞,9560,9398,18958
2022-12-30,우이신설선,4.19민주묘지,2878,2641,5519
2022-12-30,우이신설선,가오리,4281,4070,8351
2022-12-30,우이신설선,보문,1564,1644,3208
2022-12-30,우이신설선,북한산보국문,6362,5618,11980
2022-12-30,우이신설선,북한산우이,2740,2367,5107
2022-12-30,우이신설선,삼양,1995,2069,4064
2022-12-30,우이신설선,삼양사거리,2481,2513,4994
2022-12-30,우이신설선,성신여대입구,3720,4214,7934
2022-12-30,우이신설선,솔밭공원,2524,2374,4898
2022-12-30,우이신설선,솔샘,5985,5379,11364
2022-12-30,우이신설선,신설동,2221,2135,4356
2022-12-30,우이신설선,정릉,4890,4583,9473
2022-12-30,우이신설선,화계,3461,3106,6567
2022-12-30,일산선,대곡,1993,1572,3565
2022-12-30,일산선,대화,12906,10578,23484
2022-12-30,일산선,마두,7955,7974,15929
2022-12-30,일산선,백석,10450,10557,21007
2022-12-30,일산선,삼송,20563,19865,40428
2022-12-30,일산선,원당,11251,10486,21737
2022-12-30,일산선,원흥,11558,10596,22154
2022-12-30,일산선,정발산,9100,9420,18520
2022-12-30,일산선,주엽,9340,9393,18733
2022-12-30,일산선,지축,1,0,1
2022-12-30,일산선,화정,17474,17936,35410
2022-12-30,장항선,배방,1362,1331,2693
2022-12-30,장항선,봉명,1347,1279,2626
2022-12-30,장항선,신창,1471,1166,2637
2022-12-30,장항선,쌍용,2273,2122,4395
2022-12-30,장항선,아산,4020,4392,8412
2022-12-30,장항선,온양온천,4781,5023,9804
2022-12-30,장항선,탕정,1311,1117,2428
2022-12-30,중앙선,구리,13494,13968,27462
2022-12-30,중앙선,국수,830,826,1656
2022-12-30,중앙선,덕소,5512,5462,10974
2022-12-30,중앙선,도농,10970,10156,21126
2022-12-30,중앙선,도심,2434,1907,4341
2022-12-30,중앙선,망우,8235,7932,16167
2022-12-30,중앙선,상봉,5950,6105,12055
2022-12-30,중앙선,신원,152,141,293
2022-12-30,중앙선,아신,510,558,1068
2022-12-30,중앙선,양수,1744,1812,3556
2022-12-30,중앙선,양원,2823,2693,5516
2022-12-30,중앙선,양정,619,521,1140
2022-12-30,중앙선,양평,2962,3205,6167
2022-12-30,중앙선,오빈,306,304,610
2022-12-30,중앙선,용문,2618,2787,5405
2022-12-30,중앙선,운길산,605,572,1177
2022-12-30,중앙선,원덕,339,359,698
2022-12-30,중앙선,중랑,5769,5447,11216
2022-12-30,중앙선,지평,49,69,118
2022-12-30,중앙선,팔당,763,848,1611
2022-12-30,중앙선,회기,25985,23359,49344
