사용일자,호선명,지하철역,승차총승객수,하차총승객수,승하차총승객수
2022-05-02,1호선,동대문,11656,10962,22618
2022-05-02,1호선,동묘앞,8083,8483,16566
2022-05-02,1호선,서울역,45673,43758,89431
2022-05-02,1호선,시청,23408,23673,47081
2022-05-02,1호선,신설동,14255,13997,28252
2022-05-02,1호선,제기동,18008,18507,36515
2022-05-02,1호선,종각,36817,36210,73027
2022-05-02,1호선,종로3가,25480,23165,48645
2022-05-02,1호선,종로5가,22917,22841,45758
2022-05-02,1호선,청량리,20887,20708,41595
2022-05-02,2호선,강남,85393,85295,170688
2022-05-02,2호선,강변,31134,29732,60866
2022-05-02,2호선,건대입구,36652,38913,75565
2022-05-02,2호선,교대,35297,39828,75125
2022-05-02,2호선,구로디지털단지,62297,62595,124892
2022-05-02,2호선,구의,24401,24118,48519
2022-05-02,2호선,낙성대,28023,27968,55991
2022-05-02,2호선,당산,19724,22889,42613
2022-05-02,2호선,대림,24919,25469,50388
2022-05-02,2호선,도림천,1448,1532,2980
2022-05-02,2호선,동대문역사문화공원,12113,13688,25801
2022-05-02,2호선,뚝섬,22860,24716,47576
2022-05-02,2호선,문래,23014,23676,46690
2022-05-02,2호선,방배,20116,20873,40989
2022-05-02,2호선,봉천,24800,22773,47573
2022-05-02,2호선,사당,37312,42186,79498
2022-05-02,2호선,삼성,52814,53784,106598
2022-05-02,2호선,상왕십리,14949,14392,29341
2022-05-02,2호선,서울대입구,49696,49285,98981
2022-05-02,2호선,서초,22220,21324,43544
2022-05-02,2호선,선릉,59566,53209,112775
2022-05-02,2호선,성수,38284,42075,80359
2022-05-02,2호선,시청,24505,24079,48584
2022-05-02,2호선,신답,1763,2048,3811
2022-05-02,2호선,신당,14348,14767,29115
2022-05-02,2호선,신대방,27731,26822,54553
2022-05-02,2호선,신도림,49407,49037,98444
2022-05-02,2호선,신림,64672,62554,127226
2022-05-02,2호선,신설동,3429,3318,6747
2022-05-02,2호선,신정네거리,10797,11159,21956
2022-05-02,2호선,신촌,34473,35096,69569
2022-05-02,2호선,아현,10857,10414,21271
2022-05-02,2호선,양천구청,7322,7435,14757
2022-05-02,2호선,역삼,55204,62723,117927
2022-05-02,2호선,영등포구청,23499,24446,47945
2022-05-02,2호선,왕십리,17195,13757,30952
2022-05-02,2호선,용답,3297,3523,6820
2022-05-02,2호선,용두,2468,2561,5029
2022-05-02,2호선,을지로3가,23705,23660,47365
2022-05-02,2호선,을지로4가,13355,13338,26693
2022-05-02,2호선,을지로입구,40719,42203,82922
2022-05-02,2호선,이대,14625,15966,30591
2022-05-02,2호선,잠실,68721,68507,137228
2022-05-02,2호선,잠실나루,15631,15502,31133
2022-05-02,2호선,잠실새내,21809,21522,43331
2022-05-02,2호선,종합운동장,9422,10868,20290
2022-05-02,2호선,충정로,10579,11189,21768
2022-05-02,2호선,한양대,14949,17055,32004
2022-05-02,2호선,합정,30140,31875,62015
2022-05-02,2호선,홍대입구,53960,56177,110137
2022-05-02,3호선,가락시장,9310,9278,18588
2022-05-02,3호선,경복궁,22388,22380,44768
2022-05-02,3호선,경찰병원,7689,7648,15337
2022-05-02,3호선,고속터미널,40678,39063,79741
2022-05-02,3호선,교대,15171,10233,25404
2022-05-02,3호선,구파발,21815,20658,42473
2022-05-02,3호선,금호,8267,7620,15887
2022-05-02,3호선,남부터미널,29658,30538,60196
2022-05-02,3호선,녹번,16416,14834,31250
2022-05-02,3호선,대청,10943,10136,21079
2022-05-02,3호선,대치,11419,11391,22810
2022-05-02,3호선,도곡,5790,5860,11650
2022-05-02,3호선,독립문,7211,7626,14837
2022-05-02,3호선,동대입구,10789,11899,22688
2022-05-02,3호선,매봉,13107,12507,25614
2022-05-02,3호선,무악재,4128,4291,8419
2022-05-02,3호선,불광,16960,18002,34962
2022-05-02,3호선,수서,17889,18415,36304
2022-05-02,3호선,신사,30782,32316,63098
2022-05-02,3호선,안국,22069,22848,44917
2022-05-02,3호선,압구정,31849,34383,66232
2022-05-02,3호선,약수,13612,13310,26922
2022-05-02,3호선,양재,39952,44164,84116
2022-05-02,3호선,연신내,37805,35243,73048
2022-05-02,3호선,오금,6634,5949,12583
2022-05-02,3호선,옥수,9341,9673,19014
2022-05-02,3호선,을지로3가,11097,11219,22316
2022-05-02,3호선,일원,11077,10892,21969
2022-05-02,3호선,잠원,5302,5026,10328
2022-05-02,3호선,종로3가,9926,11481,21407
2022-05-02,3호선,지축,5336,4925,10261
2022-05-02,3호선,충무로,2,0,2
2022-05-02,3호선,학여울,1889,1929,3818
2022-05-02,3호선,홍제,18840,17890,36730
2022-05-02,4호선,길음,22684,22756,45440
2022-05-02,4호선,남태령,1219,1075,2294
2022-05-02,4호선,노원,19321,21732,41053
2022-05-02,4호선,당고개,9522,8360,17882
2022-05-02,4호선,동대문,20785,21390,42175
2022-05-02,4호선,동대문역사문화공원,14778,13586,28364
2022-05-02,4호선,동작,1620,1851,3471
2022-05-02,4호선,명동,20840,21700,42540
2022-05-02,4호선,미아,16057,15640,31697
2022-05-02,4호선,미아사거리,28484,27609,56093
2022-05-02,4호선,사당,26638,21942,48580
2022-05-02,4호선,삼각지,5142,5700,10842
2022-05-02,4호선,상계,21196,19351,40547
2022-05-02,4호선,서울역,11835,17148,28983
2022-05-02,4호선,성신여대입구,21784,20961,42745
2022-05-02,4호선,수유,34860,35000,69860
2022-05-02,4호선,숙대입구,14835,14324,29159
2022-05-02,4호선,신용산,17117,17948,35065
2022-05-02,4호선,쌍문,30522,28113,58635
2022-05-02,4호선,이촌,8310,9188,17498
2022-05-02,4호선,창동,26330,27646,53976
2022-05-02,4호선,총신대입구,19713,21077,40790
2022-05-02,4호선,충무로,29495,30765,60260
2022-05-02,4호선,한성대입구,15101,14682,29783
2022-05-02,4호선,혜화,31587,31740,63327
2022-05-02,4호선,회현,26868,28401,55269
2022-05-02,5호선,강동,19339,18585,37924
2022-05-02,5호선,강일,4624,4297,8921
2022-05-02,5호선,개롱,6829,7052,13881
2022-05-02,5호선,개화산,6130,5771,11901
2022-05-02,5호선,거여,10969,10469,21438
2022-05-02,5호선,고덕,10475,10328,20803
2022-05-02,5호선,공덕,14965,15904,30869
2022-05-02,5호선,광나루,13890,12764,26654
2022-05-02,5호선,광화문,30988,32513,63501
2022-05-02,5호선,군자,11359,12450,23809
2022-05-02,5호선,굽은다리,9855,9326,19181
2022-05-02,5호선,길동,8218,8483,16701
2022-05-02,5호선,김포공항,7144,7177,14321
2022-05-02,5호선,까치산,30237,28903,59140
2022-05-02,5호선,답십리,16493,15082,31575
2022-05-02,5호선,동대문역사문화공원,3003,3632,6635
2022-05-02,5호선,둔촌동,8620,8605,17225
2022-05-02,5호선,마곡,11284,11320,22604
2022-05-02,5호선,마장,6039,5721,11760
2022-05-02,5호선,마천,7619,7300,14919
2022-05-02,5호선,마포,15310,15553,30863
2022-05-02,5호선,명일,9273,9433,18706
2022-05-02,5호선,목동,17397,18586,35983
2022-05-02,5호선,미사,16668,16578,33246
2022-05-02,5호선,발산,21792,22398,44190
2022-05-02,5호선,방이,7425,7682,15107
2022-05-02,5호선,방화,7086,6746,13832
2022-05-02,5호선,상일동,15878,14795,30673
2022-05-02,5호선,서대문,21288,21749,43037
2022-05-02,5호선,송정,6860,6335,13195
2022-05-02,5호선,신금호,6927,7274,14201
2022-05-02,5호선,신길,4312,4527,8839
2022-05-02,5호선,신정,14705,11845,26550
2022-05-02,5호선,아차산,15235,14635,29870
2022-05-02,5호선,애오개,7007,7001,14008
2022-05-02,5호선,양평,8026,7830,15856
2022-05-02,5호선,여의나루,13900,15243,29143
2022-05-02,5호선,여의도,29904,31985,61889
2022-05-02,5호선,영등포구청,4254,4392,8646
2022-05-02,5호선,영등포시장,10262,10532,20794
2022-05-02,5호선,오금,3992,3981,7973
2022-05-02,5호선,오목교,21713,23259,44972
2022-05-02,5호선,올림픽공원,4809,4220,9029
2022-05-02,5호선,왕십리,4553,5199,9752
2022-05-02,5호선,우장산,15661,15299,30960
2022-05-02,5호선,을지로4가,6422,6663,13085
2022-05-02,5호선,장한평,18823,18558,37381
2022-05-02,5호선,종로3가,12651,12612,25263
2022-05-02,5호선,천호,18000,18054,36054
2022-05-02,5호선,청구,4297,3774,8071
2022-05-02,5호선,충정로,4937,5050,9987
2022-05-02,5호선,하남검단산,5894,5655,11549
2022-05-02,5호선,하남시청,7346,6873,14219
2022-05-02,5호선,하남풍산,4547,4387,8934
2022-05-02,5호선,행당,8453,7529,15982
2022-05-02,5호선,화곡,29999,27680,57679
2022-05-02,6호선,고려대,8931,8773,17704
2022-05-02,6호선,공덕,19347,18937,38284
2022-05-02,6호선,광흥창,9557,9140,18697
2022-05-02,6호선,구산,8233,5955,14188
2022-05-02,6호선,녹사평,4800,4736,9536
2022-05-02,6호선,대흥,8981,9319,18300
2022-05-02,6호선,독바위,2815,2926,5741
2022-05-02,6호선,돌곶이,9940,9305,19245
2022-05-02,6호선,동묘앞,7965,8293,16258
2022-05-02,6호선,디지털미디어시티,14918,16396,31314
2022-05-02,6호선,마포구청,14683,13156,27839
2022-05-02,6호선,망원,13756,14445,28201
2022-05-02,6호선,버티고개,2184,2156,4340
2022-05-02,6호선,보문,7585,7009,14594
2022-05-02,6호선,봉화산,9472,8778,18250
2022-05-02,6호선,불광,4310,4346,8656
2022-05-02,6호선,삼각지,6609,5752,12361
2022-05-02,6호선,상수,8734,9850,18584
2022-05-02,6호선,상월곡,6813,6413,13226
2022-05-02,6호선,새절,13897,12986,26883
2022-05-02,6호선,석계,13123,13867,26990
2022-05-02,6호선,신내,2,0,2
2022-05-02,6호선,신당,7815,8376,16191
2022-05-02,6호선,안암,13908,14438,28346
2022-05-02,6호선,약수,3732,3721,7453
2022-05-02,6호선,역촌,3836,4507,8343
2022-05-02,6호선,연신내,1,0,1
2022-05-02,6호선,월곡,13584,13015,26599
2022-05-02,6호선,월드컵경기장,4635,4815,9450
2022-05-02,6호선,응암,18393,18076,36469
2022-05-02,6호선,이태원,11245,11493,22738
2022-05-02,6호선,증산,10615,10577,21192
2022-05-02,6호선,창신,3955,3302,7257
2022-05-02,6호선,청구,3756,4048,7804
2022-05-02,6호선,태릉입구,5789,6482,12271
2022-05-02,6호선,한강진,7079,8110,15189
2022-05-02,6호선,합정,13049,12927,25976
2022-05-02,6호선,화랑대,13293,10397,23690
2022-05-02,6호선,효창공원앞,7884,7238,15122
2022-05-02,7호선,가산디지털단지,47794,48108,95902
2022-05-02,7호선,강남구청,16430,17970,34400
2022-05-02,7호선,건대입구,13196,14096,27292
2022-05-02,7호선,고속터미널,16532,13743,30275
2022-05-02,7호선,공릉,13454,13617,27071
2022-05-02,7호선,광명사거리,22862,22446,45308
2022-05-02,7호선,군자,15393,12386,27779
2022-05-02,7호선,남구로,16559,17429,33988
2022-05-02,7호선,남성,11928,11104,23032
2022-05-02,7호선,내방,15303,15646,30949
2022-05-02,7호선,노원,19673,20888,40561
2022-05-02,7호선,논현,21208,22913,44121
2022-05-02,7호선,대림,8260,8146,16406
2022-05-02,7호선,도봉산,10370,11488,21858
2022-05-02,7호선,뚝섬유원지,11161,10937,22098
2022-05-02,7호선,마들,13411,12618,26029
2022-05-02,7호선,먹골,10577,10326,20903
2022-05-02,7호선,면목,17135,16493,33628
2022-05-02,7호선,반포,6117,6050,12167
2022-05-02,7호선,보라매,10722,10780,21502
2022-05-02,7호선,사가정,17125,17012,34137
2022-05-02,7호선,상도,11981,11951,23932
2022-05-02,7호선,상봉,17427,16332,33759
2022-05-02,7호선,수락산,13149,12818,25967
2022-05-02,7호선,숭실대입구,15462,15999,31461
2022-05-02,7호선,신대방삼거리,17614,16925,34539
2022-05-02,7호선,신풍,12495,11771,24266
2022-05-02,7호선,어린이대공원,15766,16439,32205
2022-05-02,7호선,온수,11814,10995,22809
2022-05-02,7호선,용마산,6404,6078,12482
2022-05-02,7호선,이수,15954,15565,31519
2022-05-02,7호선,장승배기,9348,9122,18470
2022-05-02,7호선,장암,2407,917,3324
2022-05-02,7호선,중계,15806,14456,30262
2022-05-02,7호선,중곡,11334,10541,21875
2022-05-02,7호선,중화,11361,11225,22586
2022-05-02,7호선,천왕,12178,11622,23800
2022-05-02,7호선,철산,22177,22530,44707
2022-05-02,7호선,청담,20436,23025,43461
2022-05-02,7호선,태릉입구,9364,9067,18431
2022-05-02,7호선,하계,19273,17999,37272
2022-05-02,7호선,학동,25190,26986,52176
2022-05-02,8호선,가락시장,7860,8819,16679
2022-05-02,8호선,강동구청,10847,11323,22170
2022-05-02,8호선,남위례,5399,5536,10935
2022-05-02,8호선,남한산성입구,16261,15152,31413
2022-05-02,8호선,단대오거리,11810,11075,22885
2022-05-02,8호선,모란,4642,3746,8388
2022-05-02,8호선,몽촌토성,6409,6634,13043
2022-05-02,8호선,문정,23043,24552,47595
2022-05-02,8호선,복정,10504,8853,19357
2022-05-02,8호선,산성,5663,5656,11319
2022-05-02,8호선,석촌,7823,8857,16680
2022-05-02,8호선,송파,8868,8548,17416
2022-05-02,8호선,수진,5623,5255,10878
2022-05-02,8호선,신흥,4299,4581,8880
2022-05-02,8호선,암사,19783,17138,36921
2022-05-02,8호선,잠실,13864,16577,30441
2022-05-02,8호선,장지,17624,16925,34549
2022-05-02,8호선,천호,14703,17011,31714
2022-05-02,9호선,가양,21972,21002,42974
2022-05-02,9호선,개화,2822,1936,4758
2022-05-02,9호선,고속터미널,12893,16168,29061
2022-05-02,9호선,공항시장,3119,3328,6447
2022-05-02,9호선,구반포,1325,1403,2728
2022-05-02,9호선,국회의사당,16592,17507,34099
2022-05-02,9호선,김포공항,7274,10787,18061
2022-05-02,9호선,노들,4723,3986,8709
2022-05-02,9호선,노량진,27319,26608,53927
2022-05-02,9호선,당산,18982,19312,38294
2022-05-02,9호선,동작,2038,1717,3755
2022-05-02,9호선,등촌,12079,11523,23602
2022-05-02,9호선,마곡나루,12959,12822,25781
2022-05-02,9호선,사평,3815,3626,7441
2022-05-02,9호선,샛강,6496,6841,13337
2022-05-02,9호선,선유도,9350,8911,18261
2022-05-02,9호선,신논현,32965,32506,65471
2022-05-02,9호선,신목동,4443,3871,8314
2022-05-02,9호선,신반포,3778,3642,7420
2022-05-02,9호선,신방화,7091,6807,13898
2022-05-02,9호선,양천향교,10274,10458,20732
2022-05-02,9호선,여의도,29155,29064,58219
2022-05-02,9호선,염창,18327,17778,36105
2022-05-02,9호선,증미,7707,7548,15255
2022-05-02,9호선,흑석,9570,9887,19457
2022-05-02,9호선2~3단계,둔촌오륜,1221,1125,2346
2022-05-02,9호선2~3단계,봉은사,17517,18129,35646
2022-05-02,9호선2~3단계,삼성중앙,7388,7832,15220
2022-05-02,9호선2~3단계,삼전,7090,6743,13833
2022-05-02,9호선2~3단계,석촌,8878,7807,16685
2022-05-02,9호선2~3단계,석촌고분,6130,6002,12132
2022-05-02,9호선2~3단계,선정릉,10352,11287,21639
2022-05-02,9호선2~3단계,송파나루,5149,5371,10520
2022-05-02,9호선2~3단계,언주,10830,11278,22108
2022-05-02,9호선2~3단계,올림픽공원,6385,6365,12750
2022-05-02,9호선2~3단계,종합운동장,4568,4574,9142
2022-05-02,9호선2~3단계,중앙보훈병원,11589,10334,21923
2022-05-02,9호선2~3단계,한성백제,2660,2359,5019
2022-05-02,경강선,경기광주,8313,7908,16221
2022-05-02,경강선,곤지암,2374,2402,4776
2022-05-02,경강선,부발,2149,2313,4462
2022-05-02,경강선,삼동,2549,2358,4907
2022-05-02,경강선,세종대왕릉,344,338,682
2022-05-02,경강선,신둔도예촌,1714,1590,3304
2022-05-02,경강선,여주,2642,2620,5262
2022-05-02,경강선,이매,1171,1049,2220
2022-05-02,경강선,이천,2677,2873,5550
2022-05-02,경강선,초월,3493,3294,6787
2022-05-02,경강선,판교,5208,5050,10258
2022-05-02,경부선,가산디지털단지,19659,22744,42403
2022-05-02,경부선,관악,7794,7302,15096
2022-05-02,경부선,광명,3528,3060,6588
2022-05-02,경부선,구로,19447,19665,39112
2022-05-02,경부선,군포,8169,8072,16241
2022-05-02,경부선,금정,28541,29089,57630
2022-05-02,경부선,금천구청,12722,12484,25206
2022-05-02,경부선,남영,9894,10812,20706
2022-05-02,경부선,노량진,8497,8692,17189
2022-05-02,경부선,당정,7733,7169,14902
2022-05-02,경부선,대방,14050,14469,28519
2022-05-02,경부선,독산,19875,20535,40410
2022-05-02,경부선,두정,8025,9392,17417
2022-05-02,경부선,명학,10897,10806,21703
2022-05-02,경부선,병점,17658,17858,35516
2022-05-02,경부선,서동탄,1544,1292,2836
2022-05-02,경부선,서울역,6963,2105,9068
2022-05-02,경부선,서정리,8316,8095,16411
2022-05-02,경부선,석수,10388,9224,19612
2022-05-02,경부선,성균관대,17094,17729,34823
2022-05-02,경부선,성환,7286,7385,14671
2022-05-02,경부선,세류,3241,2968,6209
2022-05-02,경부선,세마,3115,2938,6053
2022-05-02,경부선,송탄,4731,4570,9301
2022-05-02,경부선,수원,38021,40279,78300
2022-05-02,경부선,신길,9790,8277,18067
2022-05-02,경부선,신도림,4332,4458,8790
2022-05-02,경부선,안양,28557,28108,56665
2022-05-02,경부선,영등포,37119,38412,75531
2022-05-02,경부선,오산,11079,11134,22213
2022-05-02,경부선,오산대,4460,4089,8549
2022-05-02,경부선,용산,33175,33879,67054
2022-05-02,경부선,의왕,9874,9986,19860
2022-05-02,경부선,직산,900,843,1743
2022-05-02,경부선,진위,1977,1702,3679
2022-05-02,경부선,천안,7320,7155,14475
2022-05-02,경부선,평택,13858,14352,28210
2022-05-02,경부선,평택지제,3903,3815,7718
2022-05-02,경부선,화서,8835,8374,17209
2022-05-02,경원선,가능,7273,7056,14329
2022-05-02,경원선,광운대,9881,9906,19787
2022-05-02,경원선,녹양,5022,4672,9694
2022-05-02,경원선,녹천,5059,4211,9270
2022-05-02,경원선,덕계,3722,3344,7066
2022-05-02,경원선,덕정,7121,6873,13994
2022-05-02,경원선,도봉,6362,5999,12361
2022-05-02,경원선,도봉산,8067,5673,13740
2022-05-02,경원선,동두천,2727,3141,5868
2022-05-02,경원선,동두천중앙,3528,3318,6846
2022-05-02,경원선,망월사,10105,10324,20429
2022-05-02,경원선,방학,10336,10095,20431
2022-05-02,경원선,보산,1973,1762,3735
2022-05-02,경원선,서빙고,2024,1905,3929
2022-05-02,경원선,석계,8812,9949,18761
2022-05-02,경원선,소요산,2980,2407,5387
2022-05-02,경원선,신이문,8902,8128,17030
2022-05-02,경원선,양주,8683,8103,16786
2022-05-02,경원선,옥수,50,55,105
2022-05-02,경원선,왕십리,14629,15972,30601
2022-05-02,경원선,외대앞,9016,9193,18209
2022-05-02,경원선,월계,9032,8271,17303
2022-05-02,경원선,응봉,2005,1730,3735
2022-05-02,경원선,의정부,19155,19667,38822
2022-05-02,경원선,이촌,4037,3033,7070
2022-05-02,경원선,지행,7269,7309,14578
2022-05-02,경원선,청량리,15544,16706,32250
2022-05-02,경원선,한남,4283,4051,8334
2022-05-02,경원선,회룡,13491,13333,26824
2022-05-02,경의선,가좌,6023,5750,11773
2022-05-02,경의선,강매,3721,3127,6848
2022-05-02,경의선,곡산,708,747,1455
2022-05-02,경의선,공덕,3799,3402,7201
2022-05-02,경의선,금릉,5451,5181,10632
2022-05-02,경의선,금촌,6881,6860,13741
2022-05-02,경의선,능곡,4298,3922,8220
2022-05-02,경의선,디지털미디어시티,2868,2577,5445
2022-05-02,경의선,문산,5547,5426,10973
2022-05-02,경의선,백마,7814,7403,15217
2022-05-02,경의선,서강대,2317,2381,4698
2022-05-02,경의선,서울역,4883,6358,11241
2022-05-02,경의선,수색,3065,3254,6319
2022-05-02,경의선,신촌,879,1256,2135
2022-05-02,경의선,야당,8349,8125,16474
2022-05-02,경의선,운정,7802,7149,14951
2022-05-02,경의선,월롱,3192,3118,6310
2022-05-02,경의선,일산,10459,10028,20487
2022-05-02,경의선,임진강,19,8,27
2022-05-02,경의선,탄현,8550,7925,16475
2022-05-02,경의선,파주,1826,1368,3194
2022-05-02,경의선,풍산,6151,5577,11728
2022-05-02,경의선,행신,8569,8742,17311
2022-05-02,경의선,홍대입구,1761,2052,3813
2022-05-02,경의선,화전,3931,3724,7655
2022-05-02,경의선,효창공원앞,3345,3622,6967
2022-05-02,경인선,간석,6431,5966,12397
2022-05-02,경인선,개봉,22847,22236,45083
2022-05-02,경인선,구일,7981,7718,15699
2022-05-02,경인선,도원,3328,3323,6651
2022-05-02,경인선,도화,4556,4236,8792
2022-05-02,경인선,동암,15247,15169,30416
2022-05-02,경인선,동인천,14211,13435,27646
2022-05-02,경인선,백운,7440,7253,14693
2022-05-02,경인선,부개,9259,8604,17863
2022-05-02,경인선,부천,34428,34161,68589
2022-05-02,경인선,부평,29854,31657,61511
2022-05-02,경인선,소사,9910,9336,19246
2022-05-02,경인선,송내,29127,29092,58219
2022-05-02,경인선,역곡,30608,30280,60888
2022-05-02,경인선,오류동,12590,11655,24245
2022-05-02,경인선,온수,7670,7305,14975
2022-05-02,경인선,인천,3856,3056,6912
2022-05-02,경인선,제물포,12215,11535,23750
2022-05-02,경인선,주안,20892,19030,39922
2022-05-02,경인선,중동,10167,9527,19694
2022-05-02,경춘선,가평,1838,1684,3522
2022-05-02,경춘선,갈매,3289,2859,6148
2022-05-02,경춘선,강촌,474,468,942
2022-05-02,경춘선,굴봉산,167,154,321
2022-05-02,경춘선,금곡,1767,1670,3437
2022-05-02,경춘선,김유정,356,339,695
2022-05-02,경춘선,남춘천,3113,3521,6634
2022-05-02,경춘선,대성리,652,533,1185
2022-05-02,경춘선,마석,4592,4332,8924
2022-05-02,경춘선,백양리,143,135,278
2022-05-02,경춘선,별내,3440,3168,6608
2022-05-02,경춘선,사릉,2837,2720,5557
2022-05-02,경춘선,상천,465,400,865
2022-05-02,경춘선,신내,2555,2376,4931
2022-05-02,경춘선,천마산,1907,1718,3625
2022-05-02,경춘선,청평,1840,1716,3556
2022-05-02,경춘선,춘천,1702,1797,3499
2022-05-02,경춘선,퇴계원,3856,3442,7298
2022-05-02,경춘선,평내호평,7124,6766,13890
2022-05-02,공항철도,검암,7084,6953,14037
2022-05-02,공항철도,계양,11581,10667,22248
2022-05-02,공항철도,공덕,2396,3081,5477
2022-05-02,공항철도,공항화물청사,2314,2499,4813
2022-05-02,공항철도,김포공항,12093,6908,19001
2022-05-02,공항철도,디지털미디어시티,15309,14160,29469
2022-05-02,공항철도,마곡나루,10122,9956,20078
2022-05-02,공항철도,서울역,7919,7837,15756
2022-05-02,공항철도,영종,3414,3229,6643
2022-05-02,공항철도,운서,7276,7204,14480
2022-05-02,공항철도,인천공항1터미널,5293,4868,10161
2022-05-02,공항철도,인천공항2터미널,3504,2780,6284
2022-05-02,공항철도,청라국제도시,7670,7116,14786
2022-05-02,공항철도,홍대입구,9418,9507,18925
2022-05-02,과천선,경마공원,972,969,1941
2022-05-02,과천선,과천,6765,6117,12882
2022-05-02,과천선,대공원,4367,4474,8841
2022-05-02,과천선,범계,27353,27358,54711
2022-05-02,과천선,선바위,9009,7887,16896
2022-05-02,과천선,인덕원,25903,26709,52612
2022-05-02,과천선,정부과천청사,11373,11292,22665
2022-05-02,과천선,평촌,18773,18389,37162
2022-05-02,분당선,가천대,13607,14680,28287
2022-05-02,분당선,강남구청,10457,11932,22389
2022-05-02,분당선,개포동,4133,4206,8339
2022-05-02,분당선,구룡,2573,2431,5004
2022-05-02,분당선,구성,5448,5604,11052
2022-05-02,분당선,기흥,11076,10244,21320
2022-05-02,분당선,대모산입구,4907,4510,9417
2022-05-02,분당선,도곡,7477,7416,14893
2022-05-02,분당선,망포,15362,14649,30011
2022-05-02,분당선,매교,3482,3317,6799
2022-05-02,분당선,매탄권선,5542,5334,10876
2022-05-02,분당선,모란,20695,20879,41574
2022-05-02,분당선,미금,16349,17362,33711
2022-05-02,분당선,보정,2822,2540,5362
2022-05-02,분당선,복정,1,0,1
2022-05-02,분당선,상갈,5777,5555,11332
2022-05-02,분당선,서울숲,12045,12440,24485
2022-05-02,분당선,서현,25187,25512,50699
2022-05-02,분당선,선릉,14087,21845,35932
2022-05-02,분당선,선정릉,8600,9441,18041
2022-05-02,분당선,수내,13788,13684,27472
2022-05-02,분당선,수서,14598,14669,29267
2022-05-02,분당선,수원,8663,7331,15994
2022-05-02,분당선,수원시청,13068,13607,26675
2022-05-02,분당선,신갈,4854,4781,9635
2022-05-02,분당선,압구정로데오,17789,19624,37413
2022-05-02,분당선,야탑,27072,28292,55364
2022-05-02,분당선,영통,8471,8788,17259
2022-05-02,분당선,오리,12298,9958,22256
2022-05-02,분당선,이매,6151,5575,11726
2022-05-02,분당선,정자,18294,19333,37627
2022-05-02,분당선,죽전,14706,16390,31096
2022-05-02,분당선,청명,4572,4444,9016
2022-05-02,분당선,태평,13939,13510,27449
2022-05-02,분당선,한티,14659,15456,30115
2022-05-02,수인선,고색,5058,4892,9950
2022-05-02,수인선,남동인더스파크,2257,2591,4848
2022-05-02,수인선,달월,111,66,177
2022-05-02,수인선,사리,5333,4696,10029
2022-05-02,수인선,소래포구,6600,6070,12670
2022-05-02,수인선,송도,2763,2559,5322
2022-05-02,수인선,숭의,4320,3950,8270
2022-05-02,수인선,신포,2096,2085,4181
2022-05-02,수인선,야목,439,311,750
2022-05-02,수인선,어천,784,821,1605
2022-05-02,수인선,연수,4875,4750,9625
2022-05-02,수인선,오목천,4183,3885,8068
2022-05-02,수인선,원인재,4733,4863,9596
2022-05-02,수인선,월곶,2847,2694,5541
2022-05-02,수인선,인천,1189,1816,3005
2022-05-02,수인선,인천논현,6062,6412,12474
2022-05-02,수인선,인하대,7808,7591,15399
2022-05-02,수인선,호구포,4346,4610,8956
2022-05-02,안산선,고잔,9794,9197,18991
2022-05-02,안산선,대야미,5602,5044,10646
2022-05-02,안산선,반월,4651,4501,9152
2022-05-02,안산선,산본,17139,18367,35506
2022-05-02,안산선,상록수,17676,17727,35403
2022-05-02,안산선,수리산,5164,4585,9749
2022-05-02,안산선,신길온천,1932,1756,3688
2022-05-02,안산선,안산,12843,11316,24159
2022-05-02,안산선,오이도,9409,8874,18283
2022-05-02,안산선,정왕,10660,11349,22009
2022-05-02,안산선,중앙,19549,20144,39693
2022-05-02,안산선,초지,5635,5995,11630
2022-05-02,안산선,한대앞,10892,11282,22174
2022-05-02,우이신설선,4.19민주묘지,4053,3932,7985
2022-05-02,우이신설선,가오리,4452,4338,8790
2022-05-02,우이신설선,보문,1627,1605,3232
2022-05-02,우이신설선,북한산보국문,6386,6079,12465
2022-05-02,우이신설선,북한산우이,3063,2842,5905
2022-05-02,우이신설선,삼양,2175,2329,4504
2022-05-02,우이신설선,삼양사거리,2601,2579,5180
2022-05-02,우이신설선,성신여대입구,3521,3901,7422
2022-05-02,우이신설선,솔밭공원,2613,2501,5114
2022-05-02,우이신설선,솔샘,6258,5789,12047
2022-05-02,우이신설선,신설동,2261,2207,4468
2022-05-02,우이신설선,정릉,5028,4512,9540
2022-05-02,우이신설선,화계,3685,3367,7052
2022-05-02,일산선,대곡,2395,1943,4338
2022-05-02,일산선,대화,13593,10537,24130
2022-05-02,일산선,마두,8122,8289,16411
2022-05-02,일산선,백석,10127,10073,20200
2022-05-02,일산선,삼송,21135,20446,41581
2022-05-02,일산선,원당,12043,11307,23350
2022-05-02,일산선,원흥,11607,11217,22824
2022-05-02,일산선,정발산,7601,7537,15138
2022-05-02,일산선,주엽,9733,9565,19298
2022-05-02,일산선,화정,17780,17907,35687
2022-05-02,장항선,배방,1235,1218,2453
2022-05-02,장항선,봉명,1377,1315,2692
2022-05-02,장항선,신창,2861,3587,6448
2022-05-02,장항선,쌍용,3083,3123,6206
2022-05-02,장항선,아산,4309,3536,7845
2022-05-02,장항선,온양온천,4033,4057,8090
2022-05-02,장항선,탕정,937,831,1768
2022-05-02,중앙선,구리,14324,14346,28670
2022-05-02,중앙선,국수,858,865,1723
2022-05-02,중앙선,덕소,5967,6027,11994
2022-05-02,중앙선,도농,11727,10547,22274
2022-05-02,중앙선,도심,2712,2078,4790
2022-05-02,중앙선,망우,8148,7915,16063
2022-05-02,중앙선,상봉,6027,6026,12053
2022-05-02,중앙선,신원,289,213,502
2022-05-02,중앙선,아신,598,615,1213
2022-05-02,중앙선,양수,2114,2201,4315
2022-05-02,중앙선,양원,3330,3078,6408
2022-05-02,중앙선,양정,817,663,1480
2022-05-02,중앙선,양평,2970,3041,6011
2022-05-02,중앙선,오빈,349,332,681
2022-05-02,중앙선,용문,1980,1856,3836
2022-05-02,중앙선,운길산,936,843,1779
2022-05-02,중앙선,원덕,443,392,835
2022-05-02,중앙선,중랑,5992,5687,11679
2022-05-02,중앙선,지평,82,84,166
2022-05-02,중앙선,팔당,951,955,1906
2022-05-02,중앙선,회기,27337,26692,54029
2022-05-03,1호선,동대문,11928,11294,23222
2022-05-03,1호선,동묘앞,8561,8987,17548
2022-05-03,1호선,서울역,45870,44727,90597
2022-05-03,1호선,시청,25077,25061,50138
2022-05-03,1호선,신설동,14516,14188,28704
2022-05-03,1호선,제기동,18558,19067,37625
2022-05-03,1호선,종각,38218,37531,75749
2022-05-03,1호선,종로3가,26656,24076,50732
2022-05-03,1호선,종로5가,23724,23827,47551
2022-05-03,1호선,청량리,21587,21235,42822
2022-05-03,2호선,강남,89088,88707,177795
2022-05-03,2호선,강변,31325,29394,60719
2022-05-03,2호선,건대입구,38021,40752,78773
2022-05-03,2호선,교대,36853,41925,78778
2022-05-03,2호선,구로디지털단지,64059,63795,127854
2022-05-03,2호선,구의,25566,24680,50246
2022-05-03,2호선,낙성대,28983,28198,57181
2022-05-03,2호선,당산,20610,23944,44554
2022-05-03,2호선,대림,25409,25742,51151
2022-05-03,2호선,도림천,1514,1618,3132
2022-05-03,2호선,동대문역사문화공원,12594,14434,27028
2022-05-03,2호선,뚝섬,23476,25645,49121
2022-05-03,2호선,문래,24042,24490,48532
2022-05-03,2호선,방배,21165,22114,43279
2022-05-03,2호선,봉천,25400,23154,48554
2022-05-03,2호선,사당,39709,44972,84681
2022-05-03,2호선,삼성,54551,55952,110503
2022-05-03,2호선,상왕십리,15185,14601,29786
2022-05-03,2호선,서울대입구,51212,50238,101450
2022-05-03,2호선,서초,23030,22352,45382
2022-05-03,2호선,선릉,61813,55197,117010
2022-05-03,2호선,성수,39119,43118,82237
2022-05-03,2호선,시청,26278,25568,51846
2022-05-03,2호선,신답,1765,2011,3776
2022-05-03,2호선,신당,14951,15436,30387
2022-05-03,2호선,신대방,28521,27397,55918
2022-05-03,2호선,신도림,51722,51522,103244
2022-05-03,2호선,신림,66239,63909,130148
2022-05-03,2호선,신설동,3353,3339,6692
2022-05-03,2호선,신정네거리,11490,11697,23187
2022-05-03,2호선,신촌,35932,36291,72223
2022-05-03,2호선,아현,11616,11010,22626
2022-05-03,2호선,양천구청,7689,7835,15524
2022-05-03,2호선,역삼,56496,64453,120949
2022-05-03,2호선,영등포구청,23954,24779,48733
2022-05-03,2호선,왕십리,17976,14152,32128
2022-05-03,2호선,용답,3331,3435,6766
2022-05-03,2호선,용두,2501,2554,5055
2022-05-03,2호선,을지로3가,24457,24590,49047
2022-05-03,2호선,을지로4가,13656,13834,27490
2022-05-03,2호선,을지로입구,41874,43788,85662
2022-05-03,2호선,이대,15211,16136,31347
2022-05-03,2호선,잠실,75014,74545,149559
2022-05-03,2호선,잠실나루,16001,15712,31713
2022-05-03,2호선,잠실새내,22740,22759,45499
2022-05-03,2호선,종합운동장,12782,14269,27051
2022-05-03,2호선,충정로,10855,11615,22470
2022-05-03,2호선,한양대,15842,17831,33673
2022-05-03,2호선,합정,31882,33804,65686
2022-05-03,2호선,홍대입구,57602,60311,117913
2022-05-03,3호선,가락시장,9540,9276,18816
2022-05-03,3호선,경복궁,23301,22793,46094
2022-05-03,3호선,경찰병원,7764,7756,15520
2022-05-03,3호선,고속터미널,41179,39470,80649
2022-05-03,3호선,교대,15942,10589,26531
2022-05-03,3호선,구파발,22185,21382,43567
2022-05-03,3호선,금호,8363,7792,16155
2022-05-03,3호선,남부터미널,30519,31147,61666
2022-05-03,3호선,녹번,16947,15296,32243
2022-05-03,3호선,대청,11064,10190,21254
2022-05-03,3호선,대치,11362,11546,22908
2022-05-03,3호선,도곡,5907,5926,11833
2022-05-03,3호선,독립문,7598,8180,15778
2022-05-03,3호선,동대입구,9469,10377,19846
2022-05-03,3호선,매봉,13359,12948,26307
2022-05-03,3호선,무악재,4258,4373,8631
2022-05-03,3호선,불광,17299,18726,36025
2022-05-03,3호선,수서,17751,18488,36239
2022-05-03,3호선,신사,32742,34114,66856
2022-05-03,3호선,안국,24109,25067,49176
2022-05-03,3호선,압구정,33270,35739,69009
2022-05-03,3호선,약수,13913,13599,27512
2022-05-03,3호선,양재,41227,45016,86243
2022-05-03,3호선,연신내,38645,36090,74735
2022-05-03,3호선,오금,6705,6190,12895
2022-05-03,3호선,옥수,9543,9763,19306
2022-05-03,3호선,을지로3가,11242,11532,22774
2022-05-03,3호선,일원,11607,11029,22636
2022-05-03,3호선,잠원,5358,5119,10477
2022-05-03,3호선,종로3가,10545,12001,22546
2022-05-03,3호선,지축,5465,5191,10656
2022-05-03,3호선,충무로,1,0,1
2022-05-03,3호선,학여울,2025,2027,4052
2022-05-03,3호선,홍제,19344,18464,37808
2022-05-03,4호선,길음,23348,22888,46236
2022-05-03,4호선,남태령,1340,1150,2490
2022-05-03,4호선,노원,20754,23168,43922
2022-05-03,4호선,당고개,9801,8840,18641
2022-05-03,4호선,동대문,21132,22097,43229
2022-05-03,4호선,동대문역사문화공원,15034,14181,29215
2022-05-03,4호선,동작,1783,1984,3767
2022-05-03,4호선,명동,21095,22011,43106
2022-05-03,4호선,미아,16280,15766,32046
2022-05-03,4호선,미아사거리,29099,27893,56992
2022-05-03,4호선,사당,27975,23626,51601
2022-05-03,4호선,삼각지,5396,6075,11471
2022-05-03,4호선,상계,21628,19741,41369
2022-05-03,4호선,서울역,11900,17304,29204
2022-05-03,4호선,성신여대입구,22377,21437,43814
2022-05-03,4호선,수유,35920,35676,71596
2022-05-03,4호선,숙대입구,15371,14991,30362
2022-05-03,4호선,신용산,17572,18713,36285
2022-05-03,4호선,쌍문,31163,28424,59587
2022-05-03,4호선,이촌,9266,10214,19480
2022-05-03,4호선,창동,27426,29136,56562
2022-05-03,4호선,총신대입구,20487,22012,42499
2022-05-03,4호선,충무로,30237,31323,61560
2022-05-03,4호선,한성대입구,16203,15685,31888
2022-05-03,4호선,혜화,34999,35367,70366
2022-05-03,4호선,회현,27857,29853,57710
2022-05-03,5호선,강동,19743,18932,38675
2022-05-03,5호선,강일,4838,4502,9340
2022-05-03,5호선,개롱,7154,7315,14469
2022-05-03,5호선,개화산,6118,5756,11874
2022-05-03,5호선,거여,11223,10650,21873
2022-05-03,5호선,고덕,10783,10470,21253
2022-05-03,5호선,공덕,15576,16361,31937
2022-05-03,5호선,광나루,14699,13375,28074
2022-05-03,5호선,광화문,32529,34672,67201
2022-05-03,5호선,군자,11901,12936,24837
2022-05-03,5호선,굽은다리,10183,9423,19606
2022-05-03,5호선,길동,8370,8621,16991
2022-05-03,5호선,김포공항,7260,7282,14542
2022-05-03,5호선,까치산,30651,29257,59908
2022-05-03,5호선,답십리,17027,15353,32380
2022-05-03,5호선,동대문역사문화공원,3094,3647,6741
2022-05-03,5호선,둔촌동,8829,8813,17642
2022-05-03,5호선,마곡,11618,11754,23372
2022-05-03,5호선,마장,6215,5897,12112
2022-05-03,5호선,마천,8036,7532,15568
2022-05-03,5호선,마포,15503,15836,31339
2022-05-03,5호선,명일,9430,9624,19054
2022-05-03,5호선,목동,18095,19279,37374
2022-05-03,5호선,미사,17314,16907,34221
2022-05-03,5호선,발산,22358,23148,45506
2022-05-03,5호선,방이,7436,7668,15104
2022-05-03,5호선,방화,7172,6817,13989
2022-05-03,5호선,상일동,16411,15073,31484
2022-05-03,5호선,서대문,21783,22229,44012
2022-05-03,5호선,송정,7087,6572,13659
2022-05-03,5호선,신금호,7174,7440,14614
2022-05-03,5호선,신길,4394,4685,9079
2022-05-03,5호선,신정,14949,12008,26957
2022-05-03,5호선,아차산,15878,15324,31202
2022-05-03,5호선,애오개,7286,7232,14518
2022-05-03,5호선,양평,8178,8021,16199
2022-05-03,5호선,여의나루,16716,18090,34806
2022-05-03,5호선,여의도,30683,32982,63665
2022-05-03,5호선,영등포구청,4283,4418,8701
2022-05-03,5호선,영등포시장,10633,10807,21440
2022-05-03,5호선,오금,3997,4116,8113
2022-05-03,5호선,오목교,22700,24259,46959
2022-05-03,5호선,올림픽공원,4798,4117,8915
2022-05-03,5호선,왕십리,4859,5458,10317
2022-05-03,5호선,우장산,16183,15700,31883
2022-05-03,5호선,을지로4가,6742,6875,13617
2022-05-03,5호선,장한평,19314,19021,38335
2022-05-03,5호선,종로3가,13370,13103,26473
2022-05-03,5호선,천호,18748,18825,37573
2022-05-03,5호선,청구,4310,3864,8174
2022-05-03,5호선,충정로,5192,5232,10424
2022-05-03,5호선,하남검단산,6283,5975,12258
2022-05-03,5호선,하남시청,7317,7108,14425
2022-05-03,5호선,하남풍산,4588,4490,9078
2022-05-03,5호선,행당,8779,7703,16482
2022-05-03,5호선,화곡,30442,28134,58576
2022-05-03,6호선,고려대,9182,9000,18182
2022-05-03,6호선,공덕,19973,19421,39394
2022-05-03,6호선,광흥창,9955,9672,19627
2022-05-03,6호선,구산,8234,5926,14160
2022-05-03,6호선,녹사평,5004,4947,9951
2022-05-03,6호선,대흥,9284,9562,18846
2022-05-03,6호선,독바위,2927,2976,5903
2022-05-03,6호선,돌곶이,10120,9243,19363
2022-05-03,6호선,동묘앞,8197,8643,16840
2022-05-03,6호선,디지털미디어시티,15220,16922,32142
2022-05-03,6호선,마포구청,15099,13366,28465
2022-05-03,6호선,망원,14115,15112,29227
2022-05-03,6호선,버티고개,2392,2307,4699
2022-05-03,6호선,보문,8020,7326,15346
2022-05-03,6호선,봉화산,9547,8986,18533
2022-05-03,6호선,불광,4513,4538,9051
2022-05-03,6호선,삼각지,7470,6614,14084
2022-05-03,6호선,상수,9138,10290,19428
2022-05-03,6호선,상월곡,6980,6529,13509
2022-05-03,6호선,새절,14354,13322,27676
2022-05-03,6호선,석계,13678,14341,28019
2022-05-03,6호선,신당,8776,9239,18015
2022-05-03,6호선,안암,14223,14416,28639
2022-05-03,6호선,약수,3962,3937,7899
2022-05-03,6호선,역촌,3915,4565,8480
2022-05-03,6호선,월곡,13604,13053,26657
2022-05-03,6호선,월드컵경기장,4635,4859,9494
2022-05-03,6호선,응암,18716,18221,36937
2022-05-03,6호선,이태원,10385,10716,21101
2022-05-03,6호선,증산,10830,10907,21737
2022-05-03,6호선,창신,4017,3437,7454
2022-05-03,6호선,청구,3926,4171,8097
2022-05-03,6호선,태릉입구,6163,6955,13118
2022-05-03,6호선,한강진,7937,9357,17294
2022-05-03,6호선,합정,13613,13397,27010
2022-05-03,6호선,화랑대,13835,10835,24670
2022-05-03,6호선,효창공원앞,7842,7291,15133
2022-05-03,7호선,가산디지털단지,47871,48686,96557
2022-05-03,7호선,강남구청,17557,19636,37193
2022-05-03,7호선,건대입구,13690,14738,28428
2022-05-03,7호선,고속터미널,16032,13840,29872
2022-05-03,7호선,공릉,14104,13814,27918
2022-05-03,7호선,광명사거리,23111,22739,45850
2022-05-03,7호선,군자,15817,12506,28323
2022-05-03,7호선,남구로,16704,17741,34445
2022-05-03,7호선,남성,12335,11290,23625
2022-05-03,7호선,내방,15706,16212,31918
2022-05-03,7호선,노원,20519,21625,42144
2022-05-03,7호선,논현,21902,23860,45762
2022-05-03,7호선,대림,7956,8014,15970
2022-05-03,7호선,도봉산,10632,12260,22892
2022-05-03,7호선,뚝섬유원지,12680,12196,24876
2022-05-03,7호선,마들,13955,12941,26896
2022-05-03,7호선,먹골,10936,10657,21593
2022-05-03,7호선,면목,17961,17256,35217
2022-05-03,7호선,반포,6282,6093,12375
2022-05-03,7호선,보라매,11115,11153,22268
2022-05-03,7호선,사가정,17497,17366,34863
2022-05-03,7호선,상도,12518,12118,24636
2022-05-03,7호선,상봉,17822,16545,34367
2022-05-03,7호선,수락산,13477,13034,26511
2022-05-03,7호선,숭실대입구,16331,16678,33009
2022-05-03,7호선,신대방삼거리,18227,17417,35644
2022-05-03,7호선,신풍,12692,12001,24693
2022-05-03,7호선,어린이대공원,16598,17142,33740
2022-05-03,7호선,온수,11935,11312,23247
2022-05-03,7호선,용마산,6485,6268,12753
2022-05-03,7호선,이수,16727,16324,33051
2022-05-03,7호선,장승배기,9504,9289,18793
2022-05-03,7호선,장암,2509,931,3440
2022-05-03,7호선,중계,16117,14737,30854
2022-05-03,7호선,중곡,11708,10821,22529
2022-05-03,7호선,중화,11596,11192,22788
2022-05-03,7호선,천왕,12467,11844,24311
2022-05-03,7호선,철산,23064,23426,46490
2022-05-03,7호선,청담,20991,23836,44827
2022-05-03,7호선,태릉입구,9936,9474,19410
2022-05-03,7호선,하계,20018,18658,38676
2022-05-03,7호선,학동,26128,28001,54129
2022-05-03,8호선,가락시장,7908,9032,16940
2022-05-03,8호선,강동구청,11038,11347,22385
2022-05-03,8호선,남위례,5508,5745,11253
2022-05-03,8호선,남한산성입구,16554,15333,31887
2022-05-03,8호선,단대오거리,11930,11243,23173
2022-05-03,8호선,모란,4865,3723,8588
2022-05-03,8호선,몽촌토성,7786,7951,15737
2022-05-03,8호선,문정,22843,24467,47310
2022-05-03,8호선,복정,11096,9197,20293
2022-05-03,8호선,산성,5904,5897,11801
2022-05-03,8호선,석촌,8146,9299,17445
2022-05-03,8호선,송파,9099,8784,17883
2022-05-03,8호선,수진,5531,5034,10565
2022-05-03,8호선,신흥,4239,4548,8787
2022-05-03,8호선,암사,20190,17549,37739
2022-05-03,8호선,잠실,14184,17385,31569
2022-05-03,8호선,장지,18695,17826,36521
2022-05-03,8호선,천호,15240,17644,32884
2022-05-03,9호선,가양,22453,21654,44107
2022-05-03,9호선,개화,2895,1979,4874
2022-05-03,9호선,고속터미널,13331,16138,29469
2022-05-03,9호선,공항시장,3156,3418,6574
2022-05-03,9호선,구반포,1398,1439,2837
2022-05-03,9호선,국회의사당,18376,18938,37314
2022-05-03,9호선,김포공항,7250,11310,18560
2022-05-03,9호선,노들,4817,4062,8879
2022-05-03,9호선,노량진,27780,26876,54656
2022-05-03,9호선,당산,19776,19782,39558
2022-05-03,9호선,동작,2140,1743,3883
2022-05-03,9호선,등촌,12111,11745,23856
2022-05-03,9호선,마곡나루,13311,13128,26439
2022-05-03,9호선,사평,3904,3852,7756
2022-05-03,9호선,샛강,6762,6767,13529
2022-05-03,9호선,선유도,9474,9085,18559
2022-05-03,9호선,신논현,34030,33934,67964
2022-05-03,9호선,신목동,4648,3934,8582
2022-05-03,9호선,신반포,3909,3827,7736
2022-05-03,9호선,신방화,7325,6876,14201
2022-05-03,9호선,양천향교,10435,10617,21052
2022-05-03,9호선,여의도,29945,29558,59503
2022-05-03,9호선,염창,18654,17901,36555
2022-05-03,9호선,증미,7843,7660,15503
2022-05-03,9호선,흑석,10153,10296,20449
2022-05-03,9호선2~3단계,둔촌오륜,1245,1146,2391
2022-05-03,9호선2~3단계,봉은사,17801,18455,36256
2022-05-03,9호선2~3단계,삼성중앙,7578,7990,15568
2022-05-03,9호선2~3단계,삼전,7272,6937,14209
2022-05-03,9호선2~3단계,석촌,9102,7907,17009
2022-05-03,9호선2~3단계,석촌고분,6460,6252,12712
2022-05-03,9호선2~3단계,선정릉,10691,11902,22593
2022-05-03,9호선2~3단계,송파나루,5318,5483,10801
2022-05-03,9호선2~3단계,언주,11154,11507,22661
2022-05-03,9호선2~3단계,올림픽공원,6490,6550,13040
2022-05-03,9호선2~3단계,종합운동장,4485,4556,9041
2022-05-03,9호선2~3단계,중앙보훈병원,12084,10668,22752
2022-05-03,9호선2~3단계,한성백제,2934,2719,5653
2022-05-03,경강선,경기광주,8489,7993,16482
2022-05-03,경강선,곤지암,2341,2371,4712
2022-05-03,경강선,부발,2326,2207,4533
2022-05-03,경강선,삼동,2680,2363,5043
2022-05-03,경강선,세종대왕릉,363,374,737
2022-05-03,경강선,신둔도예촌,1786,1591,3377
2022-05-03,경강선,여주,2617,2655,5272
2022-05-03,경강선,이매,1205,1078,2283
2022-05-03,경강선,이천,2694,2771,5465
2022-05-03,경강선,초월,3563,3297,6860
2022-05-03,경강선,판교,5332,5206,10538
2022-05-03,경부선,가산디지털단지,19964,22908,42872
2022-05-03,경부선,관악,8106,7564,15670
2022-05-03,경부선,광명,3468,3064,6532
2022-05-03,경부선,구로,19628,20312,39940
2022-05-03,경부선,군포,8165,8177,16342
2022-05-03,경부선,금정,29201,29741,58942
2022-05-03,경부선,금천구청,13061,13003,26064
2022-05-03,경부선,남영,10374,11028,21402
2022-05-03,경부선,노량진,8937,9005,17942
2022-05-03,경부선,당정,7841,7322,15163
2022-05-03,경부선,대방,14353,14880,29233
2022-05-03,경부선,독산,20182,21022,41204
2022-05-03,경부선,두정,8368,9235,17603
2022-05-03,경부선,명학,11584,11398,22982
2022-05-03,경부선,병점,18112,18290,36402
2022-05-03,경부선,서동탄,1607,1388,2995
2022-05-03,경부선,서울역,6039,2073,8112
2022-05-03,경부선,서정리,8091,7617,15708
2022-05-03,경부선,석수,10617,9578,20195
2022-05-03,경부선,성균관대,18200,18081,36281
2022-05-03,경부선,성환,6914,6697,13611
2022-05-03,경부선,세류,3367,2973,6340
2022-05-03,경부선,세마,3290,3045,6335
2022-05-03,경부선,송탄,4736,4536,9272
2022-05-03,경부선,수원,38868,41618,80486
2022-05-03,경부선,신길,9931,8285,18216
2022-05-03,경부선,신도림,4335,4511,8846
2022-05-03,경부선,안양,28847,28299,57146
2022-05-03,경부선,영등포,38421,39970,78391
2022-05-03,경부선,오산,11462,11465,22927
2022-05-03,경부선,오산대,4791,4379,9170
2022-05-03,경부선,용산,33430,34342,67772
2022-05-03,경부선,의왕,10263,10260,20523
2022-05-03,경부선,직산,971,949,1920
2022-05-03,경부선,진위,1991,1757,3748
2022-05-03,경부선,천안,7312,6841,14153
2022-05-03,경부선,평택,13803,14119,27922
2022-05-03,경부선,평택지제,3857,3788,7645
2022-05-03,경부선,화서,9444,8888,18332
2022-05-03,경원선,가능,7550,7264,14814
2022-05-03,경원선,광운대,9823,9626,19449
2022-05-03,경원선,녹양,5159,4770,9929
2022-05-03,경원선,녹천,5245,4165,9410
2022-05-03,경원선,덕계,3708,3308,7016
2022-05-03,경원선,덕정,7376,7051,14427
2022-05-03,경원선,도봉,6654,6325,12979
2022-05-03,경원선,도봉산,8765,6011,14776
2022-05-03,경원선,동두천,2815,3283,6098
2022-05-03,경원선,동두천중앙,3381,3350,6731
2022-05-03,경원선,망월사,10298,10473,20771
2022-05-03,경원선,방학,10596,10402,20998
2022-05-03,경원선,보산,1767,1701,3468
2022-05-03,경원선,서빙고,2156,2015,4171
2022-05-03,경원선,석계,9051,10123,19174
2022-05-03,경원선,소요산,3125,2628,5753
2022-05-03,경원선,신이문,9032,8226,17258
2022-05-03,경원선,양주,8804,8329,17133
2022-05-03,경원선,옥수,54,33,87
2022-05-03,경원선,왕십리,15172,16538,31710
2022-05-03,경원선,외대앞,9127,9176,18303
2022-05-03,경원선,월계,8990,8390,17380
2022-05-03,경원선,응봉,2131,1773,3904
2022-05-03,경원선,의정부,19768,20537,40305
2022-05-03,경원선,이촌,4149,3157,7306
2022-05-03,경원선,지행,7517,7515,15032
2022-05-03,경원선,창동,1,0,1
2022-05-03,경원선,청량리,15628,16369,31997
2022-05-03,경원선,한남,4330,4152,8482
2022-05-03,경원선,회룡,13775,13678,27453
2022-05-03,경의선,가좌,5923,5735,11658
2022-05-03,경의선,강매,3804,3241,7045
2022-05-03,경의선,곡산,790,826,1616
2022-05-03,경의선,공덕,3860,3571,7431
2022-05-03,경의선,금릉,5441,5229,10670
2022-05-03,경의선,금촌,6899,6802,13701
2022-05-03,경의선,능곡,4488,4119,8607
2022-05-03,경의선,디지털미디어시티,2940,2693,5633
2022-05-03,경의선,문산,5568,5440,11008
2022-05-03,경의선,백마,8050,7771,15821
2022-05-03,경의선,서강대,2422,2385,4807
2022-05-03,경의선,서울역,4793,6354,11147
2022-05-03,경의선,수색,3252,3386,6638
2022-05-03,경의선,신촌,946,1326,2272
2022-05-03,경의선,야당,8788,8588,17376
2022-05-03,경의선,운정,7910,7403,15313
2022-05-03,경의선,월롱,3328,3109,6437
2022-05-03,경의선,일산,11761,11729,23490
2022-05-03,경의선,임진강,21,48,69
2022-05-03,경의선,탄현,8793,8240,17033
2022-05-03,경의선,파주,1776,1294,3070
2022-05-03,경의선,풍산,6222,5747,11969
2022-05-03,경의선,행신,8741,8884,17625
2022-05-03,경의선,홍대입구,1875,2108,3983
2022-05-03,경의선,화전,4010,3736,7746
2022-05-03,경의선,효창공원앞,3348,3649,6997
2022-05-03,경인선,간석,6374,6073,12447
2022-05-03,경인선,개봉,23329,22943,46272
2022-05-03,경인선,구일,8204,7989,16193
2022-05-03,경인선,도원,3632,3592,7224
2022-05-03,경인선,도화,4678,4297,8975
2022-05-03,경인선,동암,15490,15475,30965
2022-05-03,경인선,동인천,14654,13889,28543
2022-05-03,경인선,백운,7507,7391,14898
2022-05-03,경인선,부개,9390,5584,14974
2022-05-03,경인선,부천,34799,34676,69475
2022-05-03,경인선,부평,30246,32207,62453
2022-05-03,경인선,소사,10096,9779,19875
2022-05-03,경인선,송내,30272,30209,60481
2022-05-03,경인선,역곡,31530,30818,62348
2022-05-03,경인선,오류동,12910,11903,24813
2022-05-03,경인선,온수,8006,7622,15628
2022-05-03,경인선,인천,4034,3096,7130
2022-05-03,경인선,제물포,12349,11654,24003
2022-05-03,경인선,주안,21171,19344,40515
2022-05-03,경인선,중동,10313,9612,19925
2022-05-03,경춘선,가평,1861,1886,3747
2022-05-03,경춘선,갈매,3356,2865,6221
2022-05-03,경춘선,강촌,601,551,1152
2022-05-03,경춘선,굴봉산,206,218,424
2022-05-03,경춘선,금곡,1799,1762,3561
2022-05-03,경춘선,김유정,373,424,797
2022-05-03,경춘선,남춘천,2615,2613,5228
2022-05-03,경춘선,대성리,645,586,1231
2022-05-03,경춘선,마석,4814,4808,9622
2022-05-03,경춘선,백양리,106,102,208
2022-05-03,경춘선,별내,3482,3270,6752
2022-05-03,경춘선,사릉,2872,2776,5648
2022-05-03,경춘선,상천,438,442,880
2022-05-03,경춘선,신내,2487,2383,4870
2022-05-03,경춘선,천마산,1967,1765,3732
2022-05-03,경춘선,청평,1802,1753,3555
2022-05-03,경춘선,춘천,1782,1623,3405
2022-05-03,경춘선,퇴계원,3984,3532,7516
2022-05-03,경춘선,평내호평,7100,6848,13948
2022-05-03,공항철도,검암,7188,7149,14337
2022-05-03,공항철도,계양,12027,11022,23049
2022-05-03,공항철도,공덕,2481,3262,5743
2022-05-03,공항철도,공항화물청사,2403,2623,5026
2022-05-03,공항철도,김포공항,11647,6829,18476
2022-05-03,공항철도,디지털미디어시티,15677,14651,30328
2022-05-03,공항철도,마곡나루,10412,10204,20616
2022-05-03,공항철도,서울역,8096,7653,15749
2022-05-03,공항철도,영종,3510,3490,7000
2022-05-03,공항철도,운서,7627,7468,15095
2022-05-03,공항철도,인천공항1터미널,5122,5330,10452
2022-05-03,공항철도,인천공항2터미널,2808,2730,5538
2022-05-03,공항철도,청라국제도시,7798,7471,15269
2022-05-03,공항철도,홍대입구,10003,9838,19841
2022-05-03,과천선,경마공원,1721,1651,3372
2022-05-03,과천선,과천,7035,6377,13412
2022-05-03,과천선,대공원,5543,5655,11198
2022-05-03,과천선,범계,28394,28277,56671
2022-05-03,과천선,선바위,9163,8166,17329
2022-05-03,과천선,인덕원,26749,27183,53932
2022-05-03,과천선,정부과천청사,11766,11595,23361
2022-05-03,과천선,평촌,19370,18968,38338
2022-05-03,분당선,가천대,14346,15262,29608
2022-05-03,분당선,강남구청,11055,12762,23817
2022-05-03,분당선,개포동,4425,4413,8838
2022-05-03,분당선,구룡,2600,2460,5060
2022-05-03,분당선,구성,5577,5838,11415
2022-05-03,분당선,기흥,11324,10605,21929
2022-05-03,분당선,대모산입구,5066,4717,9783
2022-05-03,분당선,도곡,7968,7616,15584
2022-05-03,분당선,망포,15847,15118,30965
2022-05-03,분당선,매교,3501,3474,6975
2022-05-03,분당선,매탄권선,5974,5698,11672
2022-05-03,분당선,모란,22251,22321,44572
2022-05-03,분당선,미금,16337,17690,34027
2022-05-03,분당선,보정,2998,2566,5564
2022-05-03,분당선,상갈,6046,5745,11791
2022-05-03,분당선,서울숲,13132,13388,26520
2022-05-03,분당선,서현,26288,26844,53132
2022-05-03,분당선,선릉,14493,22756,37249
2022-05-03,분당선,선정릉,8708,9575,18283
2022-05-03,분당선,수내,14624,14721,29345
2022-05-03,분당선,수서,14697,15128,29825
2022-05-03,분당선,수원,9089,7520,16609
2022-05-03,분당선,수원시청,13514,14450,27964
2022-05-03,분당선,신갈,4990,4961,9951
2022-05-03,분당선,압구정로데오,19867,21906,41773
2022-05-03,분당선,야탑,27688,29112,56800
2022-05-03,분당선,영통,9193,9323,18516
2022-05-03,분당선,오리,12673,10327,23000
2022-05-03,분당선,이매,6256,5792,12048
2022-05-03,분당선,정자,18927,20303,39230
2022-05-03,분당선,죽전,15597,17015,32612
2022-05-03,분당선,청명,4741,4578,9319
2022-05-03,분당선,태평,14389,13755,28144
2022-05-03,분당선,한티,15484,16445,31929
2022-05-03,수인선,고색,5384,5193,10577
2022-05-03,수인선,남동인더스파크,2370,2681,5051
2022-05-03,수인선,달월,107,65,172
2022-05-03,수인선,사리,5284,4738,10022
2022-05-03,수인선,소래포구,6933,6522,13455
2022-05-03,수인선,송도,2854,2671,5525
2022-05-03,수인선,숭의,4463,4165,8628
2022-05-03,수인선,신포,2093,2102,4195
2022-05-03,수인선,야목,485,356,841
2022-05-03,수인선,어천,836,864,1700
2022-05-03,수인선,연수,5011,5039,10050
2022-05-03,수인선,오목천,4599,4032,8631
2022-05-03,수인선,원인재,4783,5016,9799
2022-05-03,수인선,월곶,2984,2739,5723
2022-05-03,수인선,인천,1147,1866,3013
2022-05-03,수인선,인천논현,5997,6421,12418
2022-05-03,수인선,인하대,8243,7885,16128
2022-05-03,수인선,호구포,4347,4579,8926
2022-05-03,안산선,고잔,9793,9462,19255
2022-05-03,안산선,대야미,5733,5111,10844
2022-05-03,안산선,반월,4708,4556,9264
2022-05-03,안산선,산본,17511,18695,36206
2022-05-03,안산선,상록수,17868,17900,35768
2022-05-03,안산선,수리산,5292,4688,9980
2022-05-03,안산선,신길온천,1956,1800,3756
2022-05-03,안산선,안산,12375,11147,23522
2022-05-03,안산선,오이도,9347,9098,18445
2022-05-03,안산선,정왕,11091,11400,22491
2022-05-03,안산선,중앙,20102,20966,41068
2022-05-03,안산선,초지,5784,6190,11974
2022-05-03,안산선,한대앞,11570,11624,23194
2022-05-03,우이신설선,4.19민주묘지,3673,3571,7244
2022-05-03,우이신설선,가오리,4543,4378,8921
2022-05-03,우이신설선,보문,1650,1651,3301
2022-05-03,우이신설선,북한산보국문,6645,6179,12824
2022-05-03,우이신설선,북한산우이,3353,2973,6326
2022-05-03,우이신설선,삼양,2101,2224,4325
2022-05-03,우이신설선,삼양사거리,2615,2566,5181
2022-05-03,우이신설선,성신여대입구,3635,3902,7537
2022-05-03,우이신설선,솔밭공원,2697,2511,5208
2022-05-03,우이신설선,솔샘,6356,5897,12253
2022-05-03,우이신설선,신설동,2349,2304,4653
2022-05-03,우이신설선,정릉,5171,4645,9816
2022-05-03,우이신설선,화계,3734,3523,7257
2022-05-03,일산선,대곡,2399,1927,4326
2022-05-03,일산선,대화,13601,10773,24374
2022-05-03,일산선,마두,8032,8366,16398
2022-05-03,일산선,백석,10417,10265,20682
2022-05-03,일산선,삼송,21532,20788,42320
2022-05-03,일산선,원당,12403,11608,24011
2022-05-03,일산선,원흥,11928,11322,23250
2022-05-03,일산선,정발산,7884,7875,15759
2022-05-03,일산선,주엽,9961,9839,19800
2022-05-03,일산선,화정,18003,18288,36291
2022-05-03,장항선,배방,1270,1221,2491
2022-05-03,장항선,봉명,1390,1368,2758
2022-05-03,장항선,신창,3084,2997,6081
2022-05-03,장항선,쌍용,3228,2989,6217
2022-05-03,장항선,아산,3994,3527,7521
2022-05-03,장항선,온양온천,3905,4002,7907
2022-05-03,장항선,탕정,961,863,1824
2022-05-03,중앙선,구리,14733,15014,29747
2022-05-03,중앙선,국수,926,919,1845
2022-05-03,중앙선,덕소,6157,6185,12342
2022-05-03,중앙선,도농,11990,10832,22822
2022-05-03,중앙선,도심,2836,2200,5036
2022-05-03,중앙선,망우,8383,8302,16685
2022-05-03,중앙선,상봉,6150,6075,12225
2022-05-03,중앙선,신원,245,233,478
2022-05-03,중앙선,아신,588,606,1194
2022-05-03,중앙선,양수,2339,2263,4602
2022-05-03,중앙선,양원,3369,3253,6622
2022-05-03,중앙선,양정,833,689,1522
2022-05-03,중앙선,양평,4571,4609,9180
2022-05-03,중앙선,오빈,391,369,760
2022-05-03,중앙선,용문,2211,2139,4350
2022-05-03,중앙선,운길산,1110,1039,2149
2022-05-03,중앙선,원덕,437,445,882
2022-05-03,중앙선,중랑,6206,5888,12094
2022-05-03,중앙선,지평,101,104,205
2022-05-03,중앙선,팔당,1019,1081,2100
2022-05-03,중앙선,회기,27841,26954,54795
2022-05-04,1호선,동대문,12152,11686,23838
2022-05-04,1호선,동묘앞,8658,9185,17843
2022-05-04,1호선,서울역,52571,53277,105848
2022-05-04,1호선,시청,25734,26222,51956
2022-05-04,1호선,신설동,15123,14522,29645
2022-05-04,1호선,제기동,18795,18833,37628
2022-05-04,1호선,종각,39812,39262,79074
2022-05-04,1호선,종로3가,28591,26215,54806
2022-05-04,1호선,종로5가,24653,24810,49463
2022-05-04,1호선,청량리,22469,21984,44453
2022-05-04,2호선,강남,92790,96266,189056
2022-05-04,2호선,강변,37214,35736,72950
2022-05-04,2호선,건대입구,42918,47586,90504
2022-05-04,2호선,교대,37722,42863,80585
2022-05-04,2호선,구로디지털단지,65587,65275,130862
2022-05-04,2호선,구의,26405,25155,51560
2022-05-04,2호선,낙성대,30913,28414,59327
2022-05-04,2호선,당산,21810,25248,47058
2022-05-04,2호선,대림,26202,26410,52612
2022-05-04,2호선,도림천,1477,1502,2979
2022-05-04,2호선,동대문역사문화공원,13353,15780,29133
2022-05-04,2호선,뚝섬,25106,27202,52308
2022-05-04,2호선,문래,24260,25190,49450
2022-05-04,2호선,방배,21337,21859,43196
2022-05-04,2호선,봉천,26120,22965,49085
2022-05-04,2호선,사당,42733,48600,91333
2022-05-04,2호선,삼성,57384,58526,115910
2022-05-04,2호선,상왕십리,16009,15026,31035
2022-05-04,2호선,서울대입구,53966,51550,105516
2022-05-04,2호선,서초,23945,22809,46754
2022-05-04,2호선,선릉,62292,55563,117855
2022-05-04,2호선,성수,40880,45532,86412
2022-05-04,2호선,시청,26489,25823,52312
2022-05-04,2호선,신답,1879,2002,3881
2022-05-04,2호선,신당,15647,16079,31726
2022-05-04,2호선,신대방,29716,27778,57494
2022-05-04,2호선,신도림,55132,56178,111310
2022-05-04,2호선,신림,70417,67157,137574
2022-05-04,2호선,신설동,3625,3577,7202
2022-05-04,2호선,신정네거리,11736,11829,23565
2022-05-04,2호선,신촌,38373,39445,77818
2022-05-04,2호선,아현,11902,10793,22695
2022-05-04,2호선,양천구청,7953,8054,16007
2022-05-04,2호선,역삼,56129,64515,120644
2022-05-04,2호선,영등포구청,24369,25465,49834
2022-05-04,2호선,왕십리,19909,16348,36257
2022-05-04,2호선,용답,3426,3416,6842
2022-05-04,2호선,용두,2681,2592,5273
2022-05-04,2호선,을지로3가,25905,27291,53196
2022-05-04,2호선,을지로4가,14232,14448,28680
2022-05-04,2호선,을지로입구,43234,45598,88832
2022-05-04,2호선,이대,16146,16610,32756
2022-05-04,2호선,잠실,89416,88746,178162
2022-05-04,2호선,잠실나루,17625,16622,34247
2022-05-04,2호선,잠실새내,24405,25051,49456
2022-05-04,2호선,종합운동장,16835,20006,36841
2022-05-04,2호선,충정로,11119,11715,22834
2022-05-04,2호선,한양대,15636,17409,33045
2022-05-04,2호선,합정,34119,38175,72294
2022-05-04,2호선,홍대입구,64057,73255,137312
2022-05-04,3호선,가락시장,10000,9756,19756
2022-05-04,3호선,경복궁,27747,27616,55363
2022-05-04,3호선,경찰병원,8072,7856,15928
2022-05-04,3호선,고속터미널,50211,54701,104912
2022-05-04,3호선,교대,16391,10722,27113
2022-05-04,3호선,구파발,23279,22350,45629
2022-05-04,3호선,금호,8874,8056,16930
2022-05-04,3호선,남부터미널,33750,34151,67901
2022-05-04,3호선,녹번,17482,15156,32638
2022-05-04,3호선,대청,11482,10268,21750
2022-05-04,3호선,대치,11375,11299,22674
2022-05-04,3호선,도곡,6177,5913,12090
2022-05-04,3호선,독립문,7974,8510,16484
2022-05-04,3호선,동대입구,10256,11524,21780
2022-05-04,3호선,매봉,14155,13452,27607
2022-05-04,3호선,무악재,4300,4261,8561
2022-05-04,3호선,불광,18063,19254,37317
2022-05-04,3호선,수서,18869,19093,37962
2022-05-04,3호선,신사,33957,36529,70486
2022-05-04,3호선,안국,25816,26664,52480
2022-05-04,3호선,압구정,34151,37195,71346
2022-05-04,3호선,약수,14580,14028,28608
2022-05-04,3호선,양재,42736,46116,88852
2022-05-04,3호선,연신내,40603,37752,78355
2022-05-04,3호선,오금,6927,6275,13202
2022-05-04,3호선,옥수,10091,10108,20199
2022-05-04,3호선,을지로3가,12025,13040,25065
2022-05-04,3호선,일원,11766,10842,22608
2022-05-04,3호선,잠원,5615,5362,10977
2022-05-04,3호선,종로3가,10802,13498,24300
2022-05-04,3호선,지축,5655,5052,10707
2022-05-04,3호선,학여울,2045,2008,4053
2022-05-04,3호선,홍제,20154,18646,38800
2022-05-04,4호선,길음,24360,23518,47878
2022-05-04,4호선,남태령,1508,1195,2703
2022-05-04,4호선,노원,21865,24884,46749
2022-05-04,4호선,당고개,10130,8727,18857
2022-05-04,4호선,동대문,21595,22177,43772
2022-05-04,4호선,동대문역사문화공원,16437,15528,31965
2022-05-04,4호선,동작,2054,2327,4381
2022-05-04,4호선,명동,22285,23655,45940
2022-05-04,4호선,미아,17074,15991,33065
2022-05-04,4호선,미아사거리,30801,29722,60523
2022-05-04,4호선,사당,30185,26472,56657
2022-05-04,4호선,삼각지,5748,6469,12217
2022-05-04,4호선,상계,22142,19932,42074
2022-05-04,4호선,서울역,12991,21562,34553
2022-05-04,4호선,성신여대입구,24749,23580,48329
2022-05-04,4호선,수유,37902,38319,76221
2022-05-04,4호선,숙대입구,15994,15678,31672
2022-05-04,4호선,신용산,19609,21505,41114
2022-05-04,4호선,쌍문,32489,28990,61479
2022-05-04,4호선,이촌,10211,11268,21479
2022-05-04,4호선,창동,28558,29732,58290
2022-05-04,4호선,총신대입구,21514,23102,44616
2022-05-04,4호선,충무로,30936,32642,63578
2022-05-04,4호선,한성대입구,16950,16374,33324
2022-05-04,4호선,혜화,39400,38423,77823
2022-05-04,4호선,회현,27774,29819,57593
2022-05-04,5호선,강동,20435,18936,39371
2022-05-04,5호선,강일,5155,4726,9881
2022-05-04,5호선,개롱,7193,7189,14382
2022-05-04,5호선,개화산,6316,5907,12223
2022-05-04,5호선,거여,11563,10681,22244
2022-05-04,5호선,고덕,11734,11346,23080
2022-05-04,5호선,공덕,16077,17115,33192
2022-05-04,5호선,광나루,15508,13892,29400
2022-05-04,5호선,광화문,33615,36201,69816
2022-05-04,5호선,군자,12434,13746,26180
2022-05-04,5호선,굽은다리,11260,10843,22103
2022-05-04,5호선,길동,8779,8958,17737
2022-05-04,5호선,김포공항,8467,8423,16890
2022-05-04,5호선,까치산,32089,29457,61546
2022-05-04,5호선,답십리,17627,15546,33173
2022-05-04,5호선,동대문역사문화공원,3063,3702,6765
2022-05-04,5호선,둔촌동,9034,8761,17795
2022-05-04,5호선,마곡,11847,11907,23754
2022-05-04,5호선,마장,6407,5919,12326
2022-05-04,5호선,마천,8106,7571,15677
2022-05-04,5호선,마포,15895,16409,32304
2022-05-04,5호선,명일,10331,10413,20744
2022-05-04,5호선,목동,18948,19727,38675
2022-05-04,5호선,미사,18641,18523,37164
2022-05-04,5호선,발산,23460,24748,48208
2022-05-04,5호선,방이,7417,7777,15194
2022-05-04,5호선,방화,7404,6963,14367
2022-05-04,5호선,상일동,17448,15772,33220
2022-05-04,5호선,서대문,21932,22219,44151
2022-05-04,5호선,송정,7256,6802,14058
2022-05-04,5호선,신금호,7427,7415,14842
2022-05-04,5호선,신길,4669,4553,9222
2022-05-04,5호선,신정,15570,12022,27592
2022-05-04,5호선,아차산,17562,16370,33932
2022-05-04,5호선,애오개,7568,7442,15010
2022-05-04,5호선,양평,8310,7808,16118
2022-05-04,5호선,여의나루,22427,23182,45609
2022-05-04,5호선,여의도,30951,34069,65020
2022-05-04,5호선,영등포구청,4510,4545,9055
2022-05-04,5호선,영등포시장,11184,11357,22541
2022-05-04,5호선,오금,4214,4190,8404
2022-05-04,5호선,오목교,24341,26520,50861
2022-05-04,5호선,올림픽공원,5163,4384,9547
2022-05-04,5호선,왕십리,4912,6313,11225
2022-05-04,5호선,우장산,17068,16077,33145
2022-05-04,5호선,을지로4가,6650,7015,13665
2022-05-04,5호선,장한평,20556,20046,40602
2022-05-04,5호선,종로3가,14680,15745,30425
2022-05-04,5호선,천호,20298,20536,40834
2022-05-04,5호선,청구,4402,3898,8300
2022-05-04,5호선,충정로,5280,5264,10544
2022-05-04,5호선,하남검단산,6696,6235,12931
2022-05-04,5호선,하남시청,7911,7664,15575
2022-05-04,5호선,하남풍산,4814,4727,9541
2022-05-04,5호선,행당,9164,7759,16923
2022-05-04,5호선,화곡,31975,29019,60994
2022-05-04,6호선,고려대,9970,9263,19233
2022-05-04,6호선,공덕,20613,19971,40584
2022-05-04,6호선,광흥창,10160,9948,20108
2022-05-04,6호선,구산,8766,5963,14729
2022-05-04,6호선,녹사평,5541,5851,11392
2022-05-04,6호선,대흥,9515,9756,19271
2022-05-04,6호선,독바위,2961,3057,6018
2022-05-04,6호선,돌곶이,10623,9369,19992
2022-05-04,6호선,동묘앞,8581,8778,17359
2022-05-04,6호선,디지털미디어시티,15857,17057,32914
2022-05-04,6호선,마포구청,15801,13521,29322
2022-05-04,6호선,망원,15211,16097,31308
2022-05-04,6호선,버티고개,2459,2272,4731
2022-05-04,6호선,보문,8156,7248,15404
2022-05-04,6호선,봉화산,9894,9086,18980
2022-05-04,6호선,불광,5008,4969,9977
2022-05-04,6호선,삼각지,7517,6462,13979
2022-05-04,6호선,상수,9739,11865,21604
2022-05-04,6호선,상월곡,7394,6666,14060
2022-05-04,6호선,새절,14561,13368,27929
2022-05-04,6호선,석계,14493,14723,29216
2022-05-04,6호선,신당,8955,9555,18510
2022-05-04,6호선,안암,16241,15628,31869
2022-05-04,6호선,약수,4045,4016,8061
2022-05-04,6호선,역촌,4121,4676,8797
2022-05-04,6호선,연신내,1,0,1
2022-05-04,6호선,월곡,14176,13246,27422
2022-05-04,6호선,월드컵경기장,5969,6241,12210
2022-05-04,6호선,응암,19551,18307,37858
2022-05-04,6호선,이태원,11599,16212,27811
2022-05-04,6호선,증산,11438,10965,22403
2022-05-04,6호선,창신,4157,3481,7638
2022-05-04,6호선,청구,4015,4223,8238
2022-05-04,6호선,태릉입구,6502,7063,13565
2022-05-04,6호선,한강진,8857,10873,19730
2022-05-04,6호선,합정,14708,15315,30023
2022-05-04,6호선,화랑대,14531,10901,25432
2022-05-04,6호선,효창공원앞,8114,7260,15374
2022-05-04,7호선,가산디지털단지,48803,49217,98020
2022-05-04,7호선,강남구청,17489,19984,37473
2022-05-04,7호선,건대입구,15060,16604,31664
2022-05-04,7호선,고속터미널,18902,16020,34922
2022-05-04,7호선,공릉,14392,13841,28233
2022-05-04,7호선,광명사거리,24564,23667,48231
2022-05-04,7호선,군자,16597,13087,29684
2022-05-04,7호선,남구로,16623,17679,34302
2022-05-04,7호선,남성,12572,10834,23406
2022-05-04,7호선,내방,16101,16740,32841
2022-05-04,7호선,노원,21691,24089,45780
2022-05-04,7호선,논현,22259,25011,47270
2022-05-04,7호선,대림,8139,8250,16389
2022-05-04,7호선,도봉산,10635,11902,22537
2022-05-04,7호선,뚝섬유원지,15780,15346,31126
2022-05-04,7호선,마들,14698,13058,27756
2022-05-04,7호선,먹골,11348,10645,21993
2022-05-04,7호선,면목,18222,16972,35194
2022-05-04,7호선,반포,6686,6525,13211
2022-05-04,7호선,보라매,11471,11252,22723
2022-05-04,7호선,사가정,18086,17653,35739
2022-05-04,7호선,상도,13148,12137,25285
2022-05-04,7호선,상봉,18825,17714,36539
2022-05-04,7호선,수락산,14323,13671,27994
2022-05-04,7호선,숭실대입구,16551,16126,32677
2022-05-04,7호선,신대방삼거리,18641,17097,35738
2022-05-04,7호선,신풍,12794,11884,24678
2022-05-04,7호선,어린이대공원,20009,19823,39832
2022-05-04,7호선,온수,12148,11520,23668
2022-05-04,7호선,용마산,6755,6088,12843
2022-05-04,7호선,이수,17956,17602,35558
2022-05-04,7호선,장승배기,10008,9430,19438
2022-05-04,7호선,장암,2570,940,3510
2022-05-04,7호선,중계,16822,14729,31551
2022-05-04,7호선,중곡,11935,10819,22754
2022-05-04,7호선,중화,12074,11539,23613
2022-05-04,7호선,천왕,12994,12065,25059
2022-05-04,7호선,철산,24391,24644,49035
2022-05-04,7호선,청담,21008,24122,45130
2022-05-04,7호선,태릉입구,10481,9880,20361
2022-05-04,7호선,하계,21511,19774,41285
2022-05-04,7호선,학동,25684,28015,53699
2022-05-04,8호선,가락시장,8498,9701,18199
2022-05-04,8호선,강동구청,11674,11582,23256
2022-05-04,8호선,남위례,5731,5912,11643
2022-05-04,8호선,남한산성입구,17420,15614,33034
2022-05-04,8호선,단대오거리,13558,12202,25760
2022-05-04,8호선,모란,7284,6031,13315
2022-05-04,8호선,몽촌토성,8372,8675,17047
2022-05-04,8호선,문정,23895,25014,48909
2022-05-04,8호선,복정,11331,9238,20569
2022-05-04,8호선,산성,6215,5947,12162
2022-05-04,8호선,석촌,8675,10035,18710
2022-05-04,8호선,송파,9830,9357,19187
2022-05-04,8호선,수진,6150,5339,11489
2022-05-04,8호선,신흥,4964,5474,10438
2022-05-04,8호선,암사,21276,18098,39374
2022-05-04,8호선,잠실,16210,20896,37106
2022-05-04,8호선,장지,20009,18421,38430
2022-05-04,8호선,천호,16168,19493,35661
2022-05-04,9호선,가양,23640,22306,45946
2022-05-04,9호선,개화,3031,2019,5050
2022-05-04,9호선,고속터미널,16179,22042,38221
2022-05-04,9호선,공항시장,3389,3425,6814
2022-05-04,9호선,구반포,1344,1446,2790
2022-05-04,9호선,국회의사당,17500,18253,35753
2022-05-04,9호선,김포공항,8174,12314,20488
2022-05-04,9호선,노들,5037,4105,9142
2022-05-04,9호선,노량진,29514,28484,57998
2022-05-04,9호선,당산,21026,20554,41580
2022-05-04,9호선,동작,2318,1967,4285
2022-05-04,9호선,등촌,12387,11617,24004
2022-05-04,9호선,마곡나루,13896,13823,27719
2022-05-04,9호선,사평,4184,3849,8033
2022-05-04,9호선,샛강,6627,6961,13588
2022-05-04,9호선,선유도,9830,9187,19017
2022-05-04,9호선,신논현,36398,37092,73490
2022-05-04,9호선,신목동,4939,4066,9005
2022-05-04,9호선,신반포,4427,4232,8659
2022-05-04,9호선,신방화,7731,7188,14919
2022-05-04,9호선,양천향교,11153,10931,22084
2022-05-04,9호선,여의도,31305,30699,62004
2022-05-04,9호선,염창,19518,18168,37686
2022-05-04,9호선,증미,8158,7738,15896
2022-05-04,9호선,흑석,10676,10486,21162
2022-05-04,9호선2~3단계,둔촌오륜,1290,1146,2436
2022-05-04,9호선2~3단계,봉은사,19107,19867,38974
2022-05-04,9호선2~3단계,삼성중앙,7640,7929,15569
2022-05-04,9호선2~3단계,삼전,7518,7049,14567
2022-05-04,9호선2~3단계,석촌,9591,8047,17638
2022-05-04,9호선2~3단계,석촌고분,6744,6245,12989
2022-05-04,9호선2~3단계,선정릉,10862,11988,22850
2022-05-04,9호선2~3단계,송파나루,5559,5870,11429
2022-05-04,9호선2~3단계,언주,11675,11798,23473
2022-05-04,9호선2~3단계,올림픽공원,7285,6899,14184
2022-05-04,9호선2~3단계,종합운동장,5083,5036,10119
2022-05-04,9호선2~3단계,중앙보훈병원,11948,10409,22357
2022-05-04,9호선2~3단계,한성백제,3026,2496,5522
2022-05-04,경강선,경기광주,8980,8398,17378
2022-05-04,경강선,곤지암,2697,2609,5306
2022-05-04,경강선,부발,2796,2450,5246
2022-05-04,경강선,삼동,2771,2390,5161
2022-05-04,경강선,세종대왕릉,402,421,823
2022-05-04,경강선,신둔도예촌,1905,1622,3527
2022-05-04,경강선,여주,3356,3234,6590
2022-05-04,경강선,이매,1216,990,2206
2022-05-04,경강선,이천,3118,3481,6599
2022-05-04,경강선,초월,3720,3308,7028
2022-05-04,경강선,판교,5644,5713,11357
2022-05-04,경부선,가산디지털단지,20774,23558,44332
2022-05-04,경부선,관악,8688,7952,16640
2022-05-04,경부선,광명,4198,3969,8167
2022-05-04,경부선,구로,20785,22547,43332
2022-05-04,경부선,군포,8497,8320,16817
2022-05-04,경부선,금정,30520,30657,61177
2022-05-04,경부선,금천구청,13542,13449,26991
2022-05-04,경부선,남영,10558,11433,21991
2022-05-04,경부선,노량진,9754,9888,19642
2022-05-04,경부선,당정,8329,7612,15941
2022-05-04,경부선,대방,15139,15168,30307
2022-05-04,경부선,독산,21065,21126,42191
2022-05-04,경부선,두정,10224,10238,20462
2022-05-04,경부선,명학,11696,11346,23042
2022-05-04,경부선,병점,20444,20181,40625
2022-05-04,경부선,서동탄,1692,1589,3281
2022-05-04,경부선,서울역,8460,3087,11547
2022-05-04,경부선,서정리,9405,8204,17609
2022-05-04,경부선,석수,11239,9892,21131
2022-05-04,경부선,성균관대,21787,24287,46074
2022-05-04,경부선,성환,8351,7245,15596
2022-05-04,경부선,세류,3603,3390,6993
2022-05-04,경부선,세마,3612,3233,6845
2022-05-04,경부선,송탄,5320,4871,10191
2022-05-04,경부선,수원,45627,50728,96355
2022-05-04,경부선,신길,10097,8487,18584
2022-05-04,경부선,신도림,4783,4975,9758
2022-05-04,경부선,안양,30214,29977,60191
2022-05-04,경부선,영등포,43386,46699,90085
2022-05-04,경부선,오산,12254,12057,24311
2022-05-04,경부선,오산대,4900,4589,9489
2022-05-04,경부선,용산,42267,45898,88165
2022-05-04,경부선,의왕,10832,10473,21305
2022-05-04,경부선,직산,1092,994,2086
2022-05-04,경부선,진위,2177,1821,3998
2022-05-04,경부선,천안,9156,8235,17391
2022-05-04,경부선,평택,15826,16046,31872
2022-05-04,경부선,평택지제,4324,4128,8452
2022-05-04,경부선,화서,9704,9142,18846
2022-05-04,경원선,가능,7703,7242,14945
2022-05-04,경원선,광운대,10521,10154,20675
2022-05-04,경원선,녹양,5231,4867,10098
2022-05-04,경원선,녹천,5223,4230,9453
2022-05-04,경원선,덕계,3826,3420,7246
2022-05-04,경원선,덕정,7314,6730,14044
2022-05-04,경원선,도봉,6650,6262,12912
2022-05-04,경원선,도봉산,8842,6027,14869
2022-05-04,경원선,동두천,3040,3374,6414
2022-05-04,경원선,동두천중앙,3583,3517,7100
2022-05-04,경원선,망월사,10816,10739,21555
2022-05-04,경원선,방학,11117,10658,21775
2022-05-04,경원선,보산,1656,1524,3180
2022-05-04,경원선,서빙고,2421,2201,4622
2022-05-04,경원선,석계,9590,10616,20206
2022-05-04,경원선,소요산,3218,2727,5945
2022-05-04,경원선,신이문,9510,8494,18004
2022-05-04,경원선,양주,9321,8735,18056
2022-05-04,경원선,옥수,71,32,103
2022-05-04,경원선,왕십리,17926,19590,37516
2022-05-04,경원선,외대앞,9725,9338,19063
2022-05-04,경원선,월계,9384,8488,17872
2022-05-04,경원선,응봉,2296,1850,4146
2022-05-04,경원선,의정부,21600,22951,44551
2022-05-04,경원선,이촌,4567,3170,7737
2022-05-04,경원선,지행,8037,7847,15884
2022-05-04,경원선,청량리,18107,18911,37018
2022-05-04,경원선,한남,4495,4333,8828
2022-05-04,경원선,회룡,14226,14207,28433
2022-05-04,경의선,가좌,6400,6003,12403
2022-05-04,경의선,강매,3777,3123,6900
2022-05-04,경의선,곡산,799,782,1581
2022-05-04,경의선,공덕,4064,3814,7878
2022-05-04,경의선,금릉,5909,5656,11565
2022-05-04,경의선,금촌,7441,7351,14792
2022-05-04,경의선,능곡,4422,4048,8470
2022-05-04,경의선,디지털미디어시티,3019,2778,5797
2022-05-04,경의선,문산,6863,6785,13648
2022-05-04,경의선,백마,8239,7570,15809
2022-05-04,경의선,서강대,2513,2477,4990
2022-05-04,경의선,서울역,5117,6976,12093
2022-05-04,경의선,수색,3179,3314,6493
2022-05-04,경의선,신촌,1049,1430,2479
2022-05-04,경의선,야당,9119,9462,18581
2022-05-04,경의선,운정,8381,7674,16055
2022-05-04,경의선,월롱,3921,3049,6970
2022-05-04,경의선,일산,10792,10584,21376
2022-05-04,경의선,임진강,11,11,22
2022-05-04,경의선,탄현,9435,8843,18278
2022-05-04,경의선,파주,1787,1267,3054
2022-05-04,경의선,풍산,6418,5905,12323
2022-05-04,경의선,행신,9485,9573,19058
2022-05-04,경의선,홍대입구,2135,2792,4927
2022-05-04,경의선,화전,4106,3756,7862
2022-05-04,경의선,효창공원앞,3370,3731,7101
2022-05-04,경인선,간석,6964,6347,13311
2022-05-04,경인선,개봉,24779,23573,48352
2022-05-04,경인선,구일,8631,8111,16742
2022-05-04,경인선,도원,3841,3687,7528
2022-05-04,경인선,도화,4957,4471,9428
2022-05-04,경인선,동암,16498,16390,32888
2022-05-04,경인선,동인천,15949,15201,31150
2022-05-04,경인선,백운,7957,7557,15514
2022-05-04,경인선,부개,9861,5818,15679
2022-05-04,경인선,부천,37716,38500,76216
2022-05-04,경인선,부평,32489,36654,69143
2022-05-04,경인선,소사,10511,9708,20219
2022-05-04,경인선,송내,31326,31137,62463
2022-05-04,경인선,역곡,32871,31884,64755
2022-05-04,경인선,오류동,13593,12143,25736
2022-05-04,경인선,온수,8670,7702,16372
2022-05-04,경인선,인천,4719,3686,8405
2022-05-04,경인선,제물포,13119,12059,25178
2022-05-04,경인선,주안,23137,20903,44040
2022-05-04,경인선,중동,10804,9922,20726
2022-05-04,경춘선,가평,1903,2175,4078
2022-05-04,경춘선,갈매,3508,3026,6534
2022-05-04,경춘선,강촌,576,692,1268
2022-05-04,경춘선,굴봉산,217,227,444
2022-05-04,경춘선,금곡,1828,1737,3565
2022-05-04,경춘선,김유정,627,676,1303
2022-05-04,경춘선,남춘천,3546,3239,6785
2022-05-04,경춘선,대성리,639,1045,1684
2022-05-04,경춘선,마석,4786,4688,9474
2022-05-04,경춘선,백양리,127,173,300
2022-05-04,경춘선,별내,3727,3421,7148
2022-05-04,경춘선,사릉,2907,2807,5714
2022-05-04,경춘선,상천,386,371,757
2022-05-04,경춘선,신내,2533,2422,4955
2022-05-04,경춘선,천마산,1993,1820,3813
2022-05-04,경춘선,청평,1865,2163,4028
2022-05-04,경춘선,춘천,2157,1811,3968
2022-05-04,경춘선,퇴계원,4048,3634,7682
2022-05-04,경춘선,평내호평,7705,7566,15271
2022-05-04,공항철도,검암,7591,7614,15205
2022-05-04,공항철도,계양,12262,11336,23598
2022-05-04,공항철도,공덕,2640,3474,6114
2022-05-04,공항철도,공항화물청사,2408,2632,5040
2022-05-04,공항철도,김포공항,12558,6865,19423
2022-05-04,공항철도,디지털미디어시티,16189,14870,31059
2022-05-04,공항철도,마곡나루,11088,10331,21419
2022-05-04,공항철도,서울역,10310,9666,19976
2022-05-04,공항철도,영종,3874,4038,7912
2022-05-04,공항철도,운서,7766,7862,15628
2022-05-04,공항철도,인천공항1터미널,5546,5591,11137
2022-05-04,공항철도,인천공항2터미널,2737,2655,5392
2022-05-04,공항철도,청라국제도시,8290,7902,16192
2022-05-04,공항철도,홍대입구,11673,12357,24030
2022-05-04,과천선,경마공원,1656,1669,3325
2022-05-04,과천선,과천,7720,6797,14517
2022-05-04,과천선,대공원,10850,10803,21653
2022-05-04,과천선,범계,31015,31465,62480
2022-05-04,과천선,선바위,9592,8227,17819
2022-05-04,과천선,인덕원,28060,28179,56239
2022-05-04,과천선,정부과천청사,12113,11823,23936
2022-05-04,과천선,평촌,19810,19410,39220
2022-05-04,분당선,가천대,14173,14635,28808
2022-05-04,분당선,강남구청,11260,13137,24397
2022-05-04,분당선,개포동,4720,4681,9401
2022-05-04,분당선,구룡,2850,2515,5365
2022-05-04,분당선,구성,6066,6121,12187
2022-05-04,분당선,기흥,12067,11445,23512
2022-05-04,분당선,대모산입구,5171,4592,9763
2022-05-04,분당선,도곡,8065,7668,15733
2022-05-04,분당선,망포,18368,16732,35100
2022-05-04,분당선,매교,3996,3761,7757
2022-05-04,분당선,매탄권선,6310,5862,12172
2022-05-04,분당선,모란,29857,31295,61152
2022-05-04,분당선,미금,17657,18681,36338
2022-05-04,분당선,보정,3094,2645,5739
2022-05-04,분당선,상갈,6772,6540,13312
2022-05-04,분당선,서울숲,14464,14898,29362
2022-05-04,분당선,서현,27899,28842,56741
2022-05-04,분당선,선릉,14701,22749,37450
2022-05-04,분당선,선정릉,8750,9429,18179
2022-05-04,분당선,수내,15126,14994,30120
2022-05-04,분당선,수서,15507,16581,32088
2022-05-04,분당선,수원,10236,8856,19092
2022-05-04,분당선,수원시청,14508,17093,31601
2022-05-04,분당선,신갈,5182,5010,10192
2022-05-04,분당선,압구정로데오,20876,24526,45402
2022-05-04,분당선,야탑,30526,31884,62410
2022-05-04,분당선,영통,10239,10300,20539
2022-05-04,분당선,오리,13732,11098,24830
2022-05-04,분당선,이매,6890,6226,13116
2022-05-04,분당선,정자,20343,21486,41829
2022-05-04,분당선,죽전,16944,18097,35041
2022-05-04,분당선,청명,5199,4812,10011
2022-05-04,분당선,태평,15243,14264,29507
2022-05-04,분당선,한티,15840,16084,31924
2022-05-04,수인선,고색,5841,5552,11393
2022-05-04,수인선,남동인더스파크,2419,2647,5066
2022-05-04,수인선,달월,112,77,189
2022-05-04,수인선,사리,5804,4932,10736
2022-05-04,수인선,소래포구,6845,6594,13439
2022-05-04,수인선,송도,3273,3066,6339
2022-05-04,수인선,숭의,4560,4124,8684
2022-05-04,수인선,신포,2225,2300,4525
2022-05-04,수인선,야목,514,370,884
2022-05-04,수인선,어천,959,948,1907
2022-05-04,수인선,연수,5345,5403,10748
2022-05-04,수인선,오목천,4852,4290,9142
2022-05-04,수인선,원인재,5145,5315,10460
2022-05-04,수인선,월곶,3343,3077,6420
2022-05-04,수인선,인천,1372,2227,3599
2022-05-04,수인선,인천논현,6447,7014,13461
2022-05-04,수인선,인하대,8736,8019,16755
2022-05-04,수인선,호구포,4721,4773,9494
2022-05-04,안산선,고잔,10289,10013,20302
2022-05-04,안산선,대야미,5982,5116,11098
2022-05-04,안산선,반월,4999,4764,9763
2022-05-04,안산선,산본,18133,19674,37807
2022-05-04,안산선,상록수,19386,19013,38399
2022-05-04,안산선,수리산,5123,4185,9308
2022-05-04,안산선,신길온천,2137,1904,4041
2022-05-04,안산선,안산,12959,11589,24548
2022-05-04,안산선,오이도,10074,10073,20147
2022-05-04,안산선,정왕,11796,11673,23469
2022-05-04,안산선,중앙,22567,24941,47508
2022-05-04,안산선,초지,5840,6280,12120
2022-05-04,안산선,한대앞,11976,11632,23608
2022-05-04,우이신설선,4.19민주묘지,4428,4261,8689
2022-05-04,우이신설선,가오리,4759,4509,9268
2022-05-04,우이신설선,보문,1697,1709,3406
2022-05-04,우이신설선,북한산보국문,6972,6366,13338
2022-05-04,우이신설선,북한산우이,3311,2901,6212
2022-05-04,우이신설선,삼양,2239,2251,4490
2022-05-04,우이신설선,삼양사거리,2775,2659,5434
2022-05-04,우이신설선,성신여대입구,3950,4495,8445
2022-05-04,우이신설선,솔밭공원,2941,2731,5672
2022-05-04,우이신설선,솔샘,6778,5973,12751
2022-05-04,우이신설선,신설동,2358,2356,4714
2022-05-04,우이신설선,정릉,5550,4836,10386
2022-05-04,우이신설선,화계,3862,3471,7333
2022-05-04,일산선,대곡,2540,2011,4551
2022-05-04,일산선,대화,14317,11177,25494
2022-05-04,일산선,마두,8590,8602,17192
2022-05-04,일산선,백석,11002,11083,22085
2022-05-04,일산선,삼송,22584,21531,44115
2022-05-04,일산선,원당,12698,11723,24421
2022-05-04,일산선,원흥,12328,11242,23570
2022-05-04,일산선,정발산,8494,9348,17842
2022-05-04,일산선,주엽,10482,10321,20803
2022-05-04,일산선,화정,18955,19148,38103
2022-05-04,장항선,배방,1549,1400,2949
2022-05-04,장항선,봉명,1519,1456,2975
2022-05-04,장항선,신창,4337,3045,7382
2022-05-04,장항선,쌍용,3889,3380,7269
2022-05-04,장항선,아산,5431,5149,10580
2022-05-04,장항선,온양온천,5540,5909,11449
2022-05-04,장항선,탕정,1080,899,1979
2022-05-04,중앙선,구리,15721,15967,31688
2022-05-04,중앙선,국수,809,846,1655
2022-05-04,중앙선,덕소,6487,6526,13013
2022-05-04,중앙선,도농,12212,11059,23271
2022-05-04,중앙선,도심,2786,2146,4932
2022-05-04,중앙선,망우,9030,8656,17686
2022-05-04,중앙선,상봉,6560,6602,13162
2022-05-04,중앙선,신원,269,233,502
2022-05-04,중앙선,아신,607,676,1283
2022-05-04,중앙선,양수,2403,2260,4663
2022-05-04,중앙선,양원,3467,3175,6642
2022-05-04,중앙선,양정,768,705,1473
2022-05-04,중앙선,양평,3225,3394,6619
2022-05-04,중앙선,오빈,335,351,686
2022-05-04,중앙선,용문,2021,2337,4358
2022-05-04,중앙선,운길산,1038,960,1998
2022-05-04,중앙선,원덕,474,478,952
2022-05-04,중앙선,중랑,6393,5937,12330
2022-05-04,중앙선,지평,86,101,187
2022-05-04,중앙선,팔당,1064,1224,2288
2022-05-04,중앙선,회기,29647,27704,57351
2022-05-05,1호선,동대문,12065,12237,24302
2022-05-05,1호선,동묘앞,10707,10997,21704
2022-05-05,1호선,서울역,30025,33845,63870
2022-05-05,1호선,시청,11447,11372,22819
2022-05-05,1호선,신설동,8146,7642,15788
2022-05-05,1호선,제기동,14421,15039,29460
2022-05-05,1호선,종각,19703,16928,36631
2022-05-05,1호선,종로3가,22327,19653,41980
2022-05-05,1호선,종로5가,19567,19213,38780
2022-05-05,1호선,청량리,17256,17404,34660
2022-05-05,2호선,강남,42209,41967,84176
2022-05-05,2호선,강변,24823,26089,50912
2022-05-05,2호선,건대입구,38668,39233,77901
2022-05-05,2호선,교대,12327,13756,26083
2022-05-05,2호선,구로디지털단지,29179,28181,57360
2022-05-05,2호선,구의,14804,13724,28528
2022-05-05,2호선,낙성대,19205,17473,36678
2022-05-05,2호선,당산,11699,12354,24053
2022-05-05,2호선,대림,16335,16701,33036
2022-05-05,2호선,도림천,689,692,1381
2022-05-05,2호선,동대문역사문화공원,12243,14181,26424
2022-05-05,2호선,뚝섬,17267,17221,34488
2022-05-05,2호선,문래,10119,10766,20885
2022-05-05,2호선,방배,7554,7637,15191
2022-05-05,2호선,봉천,14692,13258,27950
2022-05-05,2호선,사당,25763,28714,54477
2022-05-05,2호선,삼성,23962,23772,47734
2022-05-05,2호선,상왕십리,8952,8414,17366
2022-05-05,2호선,서울대입구,33866,32930,66796
2022-05-05,2호선,서초,7229,5939,13168
2022-05-05,2호선,선릉,17092,14839,31931
2022-05-05,2호선,성수,21348,24880,46228
2022-05-05,2호선,시청,8823,7437,16260
2022-05-05,2호선,신답,988,955,1943
2022-05-05,2호선,신당,10349,11260,21609
2022-05-05,2호선,신대방,18968,17624,36592
2022-05-05,2호선,신도림,33109,33626,66735
2022-05-05,2호선,신림,45124,42941,88065
2022-05-05,2호선,신설동,2608,2457,5065
2022-05-05,2호선,신정네거리,6614,6562,13176
2022-05-05,2호선,신촌,27414,27247,54661
2022-05-05,2호선,아현,6742,6253,12995
2022-05-05,2호선,양천구청,4065,4019,8084
2022-05-05,2호선,역삼,12733,13987,26720
2022-05-05,2호선,영등포구청,9307,9612,18919
2022-05-05,2호선,왕십리,12695,11193,23888
2022-05-05,2호선,용답,2211,2003,4214
2022-05-05,2호선,용두,1577,1554,3131
2022-05-05,2호선,을지로3가,10650,10798,21448
2022-05-05,2호선,을지로4가,7064,7368,14432
2022-05-05,2호선,을지로입구,21668,21202,42870
2022-05-05,2호선,이대,9388,9693,19081
2022-05-05,2호선,잠실,63053,61565,124618
2022-05-05,2호선,잠실나루,6566,6351,12917
2022-05-05,2호선,잠실새내,15644,15754,31398
2022-05-05,2호선,종합운동장,14171,16245,30416
2022-05-05,2호선,충정로,4183,4487,8670
2022-05-05,2호선,한양대,4079,4141,8220
2022-05-05,2호선,합정,27073,29720,56793
2022-05-05,2호선,홍대입구,74028,78388,152416
2022-05-05,3호선,가락시장,5042,4953,9995
2022-05-05,3호선,경복궁,21801,24776,46577
2022-05-05,3호선,경찰병원,3226,3157,6383
2022-05-05,3호선,고속터미널,49069,50519,99588
2022-05-05,3호선,교대,5090,3148,8238
2022-05-05,3호선,구파발,14703,15107,29810
2022-05-05,3호선,금호,5230,4626,9856
2022-05-05,3호선,남부터미널,16365,16871,33236
2022-05-05,3호선,녹번,9060,7890,16950
2022-05-05,3호선,대청,4919,4578,9497
2022-05-05,3호선,대치,6283,5707,11990
2022-05-05,3호선,도곡,2348,2300,4648
2022-05-05,3호선,독립문,6368,7238,13606
2022-05-05,3호선,동대입구,6500,7651,14151
2022-05-05,3호선,매봉,5333,5326,10659
2022-05-05,3호선,무악재,2407,2529,4936
2022-05-05,3호선,불광,11871,13440,25311
2022-05-05,3호선,수서,10967,11438,22405
2022-05-05,3호선,신사,16996,18307,35303
2022-05-05,3호선,안국,19541,22488,42029
2022-05-05,3호선,압구정,15620,16940,32560
2022-05-05,3호선,약수,7706,7149,14855
2022-05-05,3호선,양재,14921,16582,31503
2022-05-05,3호선,연신내,26688,24905,51593
2022-05-05,3호선,오금,3001,2778,5779
2022-05-05,3호선,옥수,6282,6300,12582
2022-05-05,3호선,을지로3가,5310,5307,10617
2022-05-05,3호선,일원,3986,3857,7843
2022-05-05,3호선,잠원,3004,2833,5837
2022-05-05,3호선,종로3가,5910,8267,14177
2022-05-05,3호선,지축,3224,3054,6278
2022-05-05,3호선,학여울,846,829,1675
2022-05-05,3호선,홍제,12060,11258,23318
2022-05-05,4호선,길음,13751,12670,26421
2022-05-05,4호선,남태령,1030,672,1702
2022-05-05,4호선,노원,15639,17176,32815
2022-05-05,4호선,당고개,6954,6553,13507
2022-05-05,4호선,동대문,18917,19500,38417
2022-05-05,4호선,동대문역사문화공원,13939,12675,26614
2022-05-05,4호선,동작,1750,1951,3701
2022-05-05,4호선,명동,15520,18277,33797
2022-05-05,4호선,미아,9967,9194,19161
2022-05-05,4호선,미아사거리,20444,19230,39674
2022-05-05,4호선,사당,19545,16729,36274
2022-05-05,4호선,삼각지,3395,4600,7995
2022-05-05,4호선,상계,13943,12895,26838
2022-05-05,4호선,서울역,5295,13504,18799
2022-05-05,4호선,성신여대입구,16644,15643,32287
2022-05-05,4호선,수유,25036,24195,49231
2022-05-05,4호선,숙대입구,8395,7797,16192
2022-05-05,4호선,신용산,11328,12361,23689
2022-05-05,4호선,쌍문,19809,17718,37527
2022-05-05,4호선,이촌,8965,10030,18995
2022-05-05,4호선,창동,18186,18936,37122
2022-05-05,4호선,총신대입구,12597,13706,26303
2022-05-05,4호선,충무로,12674,14481,27155
2022-05-05,4호선,한성대입구,10398,10213,20611
2022-05-05,4호선,혜화,30383,31896,62279
2022-05-05,4호선,회현,20049,21437,41486
2022-05-05,5호선,강동,11120,10393,21513
2022-05-05,5호선,강일,2974,2639,5613
2022-05-05,5호선,개롱,3669,3681,7350
2022-05-05,5호선,개화산,3540,3420,6960
2022-05-05,5호선,거여,5718,5228,10946
2022-05-05,5호선,고덕,5723,5607,11330
2022-05-05,5호선,공덕,5755,5866,11621
2022-05-05,5호선,광나루,9413,8896,18309
2022-05-05,5호선,광화문,17046,16985,34031
2022-05-05,5호선,군자,7828,8553,16381
2022-05-05,5호선,굽은다리,7383,6989,14372
2022-05-05,5호선,길동,5158,5308,10466
2022-05-05,5호선,김포공항,8665,8752,17417
2022-05-05,5호선,까치산,19475,17977,37452
2022-05-05,5호선,답십리,9307,8430,17737
2022-05-05,5호선,동대문역사문화공원,900,1256,2156
2022-05-05,5호선,둔촌동,5219,5060,10279
2022-05-05,5호선,마곡,4796,4991,9787
2022-05-05,5호선,마장,3547,3259,6806
2022-05-05,5호선,마천,4436,4477,8913
2022-05-05,5호선,마포,6286,6308,12594
2022-05-05,5호선,명일,5479,5396,10875
2022-05-05,5호선,목동,9462,9540,19002
2022-05-05,5호선,미사,11905,11816,23721
2022-05-05,5호선,발산,11472,12397,23869
2022-05-05,5호선,방이,3758,3713,7471
2022-05-05,5호선,방화,4378,4309,8687
2022-05-05,5호선,상일동,8701,7985,16686
2022-05-05,5호선,서대문,6290,6306,12596
2022-05-05,5호선,송정,4388,4196,8584
2022-05-05,5호선,신금호,3844,4016,7860
2022-05-05,5호선,신길,2486,2561,5047
2022-05-05,5호선,신정,8433,7163,15596
2022-05-05,5호선,아차산,18147,17273,35420
2022-05-05,5호선,애오개,2983,2840,5823
2022-05-05,5호선,양평,3284,3029,6313
2022-05-05,5호선,여의나루,34396,37409,71805
2022-05-05,5호선,여의도,11403,11672,23075
2022-05-05,5호선,영등포구청,1795,1663,3458
2022-05-05,5호선,영등포시장,6225,6386,12611
2022-05-05,5호선,오금,1797,1701,3498
2022-05-05,5호선,오목교,14215,15311,29526
2022-05-05,5호선,올림픽공원,3164,2964,6128
2022-05-05,5호선,왕십리,3447,4344,7791
2022-05-05,5호선,우장산,8737,8458,17195
2022-05-05,5호선,을지로4가,3645,4044,7689
2022-05-05,5호선,장한평,10288,9896,20184
2022-05-05,5호선,종로3가,13904,13783,27687
2022-05-05,5호선,천호,16050,15393,31443
2022-05-05,5호선,청구,2569,2384,4953
2022-05-05,5호선,충정로,1788,1671,3459
2022-05-05,5호선,하남검단산,6248,6206,12454
2022-05-05,5호선,하남시청,5140,4795,9935
2022-05-05,5호선,하남풍산,2711,2572,5283
2022-05-05,5호선,행당,4775,4037,8812
2022-05-05,5호선,화곡,18349,16826,35175
2022-05-05,6호선,고려대,5213,5135,10348
2022-05-05,6호선,공덕,8566,7937,16503
2022-05-05,6호선,광흥창,4543,4085,8628
2022-05-05,6호선,구산,4792,3379,8171
2022-05-05,6호선,녹사평,5578,5768,11346
2022-05-05,6호선,대흥,4862,4752,9614
2022-05-05,6호선,독바위,1900,2150,4050
2022-05-05,6호선,돌곶이,5805,5269,11074
2022-05-05,6호선,동묘앞,7883,7969,15852
2022-05-05,6호선,디지털미디어시티,6602,6826,13428
2022-05-05,6호선,마포구청,8365,7147,15512
2022-05-05,6호선,망원,13532,15058,28590
2022-05-05,6호선,버티고개,1279,1347,2626
2022-05-05,6호선,보문,4905,4349,9254
2022-05-05,6호선,봉화산,5069,4880,9949
2022-05-05,6호선,불광,3794,3583,7377
2022-05-05,6호선,삼각지,5509,4253,9762
2022-05-05,6호선,상수,8227,9170,17397
2022-05-05,6호선,상월곡,3935,3453,7388
2022-05-05,6호선,새절,8326,7498,15824
2022-05-05,6호선,석계,8217,8058,16275
2022-05-05,6호선,신내,1,0,1
2022-05-05,6호선,신당,6919,6461,13380
2022-05-05,6호선,안암,7534,6808,14342
2022-05-05,6호선,약수,2066,2114,4180
2022-05-05,6호선,역촌,2406,2694,5100
2022-05-05,6호선,월곡,7313,6927,14240
2022-05-05,6호선,월드컵경기장,6311,6538,12849
2022-05-05,6호선,응암,11713,11913,23626
2022-05-05,6호선,이태원,14204,13903,28107
2022-05-05,6호선,증산,7271,7077,14348
2022-05-05,6호선,창신,1905,1724,3629
2022-05-05,6호선,청구,2452,2432,4884
2022-05-05,6호선,태릉입구,4364,4785,9149
2022-05-05,6호선,한강진,7471,9246,16717
2022-05-05,6호선,합정,12459,11481,23940
2022-05-05,6호선,화랑대,7038,5685,12723
2022-05-05,6호선,효창공원앞,4257,3733,7990
2022-05-05,7호선,가산디지털단지,13551,12431,25982
2022-05-05,7호선,강남구청,6937,7871,14808
2022-05-05,7호선,건대입구,11550,12803,24353
2022-05-05,7호선,고속터미널,12595,9784,22379
2022-05-05,7호선,공릉,8876,8542,17418
2022-05-05,7호선,광명사거리,14774,14440,29214
2022-05-05,7호선,군자,10010,7323,17333
2022-05-05,7호선,남구로,7076,7109,14185
2022-05-05,7호선,남성,6641,6116,12757
2022-05-05,7호선,내방,6356,6376,12732
2022-05-05,7호선,노원,14665,15605,30270
2022-05-05,7호선,논현,7718,8220,15938
2022-05-05,7호선,대림,6102,6247,12349
2022-05-05,7호선,도봉산,6637,9069,15706
2022-05-05,7호선,뚝섬유원지,23477,22462,45939
2022-05-05,7호선,마들,7989,7422,15411
2022-05-05,7호선,먹골,7149,6681,13830
2022-05-05,7호선,면목,10137,9581,19718
2022-05-05,7호선,반포,3906,3784,7690
2022-05-05,7호선,보라매,5026,4821,9847
2022-05-05,7호선,사가정,11124,10526,21650
2022-05-05,7호선,상도,6859,6240,13099
2022-05-05,7호선,상봉,11933,11401,23334
2022-05-05,7호선,수락산,9397,9084,18481
2022-05-05,7호선,숭실대입구,8069,7915,15984
2022-05-05,7호선,신대방삼거리,9694,8869,18563
2022-05-05,7호선,신풍,6918,6466,13384
2022-05-05,7호선,어린이대공원,18086,19298,37384
2022-05-05,7호선,온수,4911,4742,9653
2022-05-05,7호선,용마산,4207,4453,8660
2022-05-05,7호선,이수,10042,9199,19241
2022-05-05,7호선,장승배기,5191,4897,10088
2022-05-05,7호선,장암,1697,1180,2877
2022-05-05,7호선,중계,8571,7821,16392
2022-05-05,7호선,중곡,6548,5929,12477
2022-05-05,7호선,중화,7190,6733,13923
2022-05-05,7호선,천왕,6193,5990,12183
2022-05-05,7호선,철산,12669,12632,25301
2022-05-05,7호선,청담,7868,8631,16499
2022-05-05,7호선,태릉입구,6656,6273,12929
2022-05-05,7호선,하계,12100,11560,23660
2022-05-05,7호선,학동,6893,7109,14002
2022-05-05,8호선,가락시장,4620,5067,9687
2022-05-05,8호선,강동구청,5573,5533,11106
2022-05-05,8호선,남위례,3062,3186,6248
2022-05-05,8호선,남한산성입구,8854,7939,16793
2022-05-05,8호선,단대오거리,7208,6769,13977
2022-05-05,8호선,모란,3472,2932,6404
2022-05-05,8호선,몽촌토성,4498,4311,8809
2022-05-05,8호선,문정,6405,6281,12686
2022-05-05,8호선,복정,5475,4706,10181
2022-05-05,8호선,산성,3838,3855,7693
2022-05-05,8호선,석촌,4928,6400,11328
2022-05-05,8호선,송파,4878,4637,9515
2022-05-05,8호선,수진,3679,3105,6784
2022-05-05,8호선,신흥,3351,3682,7033
2022-05-05,8호선,암사,11297,10151,21448
2022-05-05,8호선,잠실,13254,15228,28482
2022-05-05,8호선,장지,11581,11502,23083
2022-05-05,8호선,천호,10305,12304,22609
2022-05-05,9호선,가양,12065,11363,23428
2022-05-05,9호선,개화,1526,1280,2806
2022-05-05,9호선,고속터미널,14246,20604,34850
2022-05-05,9호선,공항시장,2059,2052,4111
2022-05-05,9호선,구반포,575,574,1149
2022-05-05,9호선,국회의사당,3697,3744,7441
2022-05-05,9호선,김포공항,7795,12114,19909
2022-05-05,9호선,노들,3249,2849,6098
2022-05-05,9호선,노량진,19164,18931,38095
2022-05-05,9호선,당산,10746,10045,20791
2022-05-05,9호선,동작,1700,1449,3149
2022-05-05,9호선,등촌,6317,6003,12320
2022-05-05,9호선,마곡나루,7397,7111,14508
2022-05-05,9호선,사평,1973,1810,3783
2022-05-05,9호선,샛강,2478,2332,4810
2022-05-05,9호선,선유도,4193,4025,8218
2022-05-05,9호선,신논현,19798,18479,38277
2022-05-05,9호선,신목동,2200,1998,4198
2022-05-05,9호선,신반포,2760,3076,5836
2022-05-05,9호선,신방화,4029,3706,7735
2022-05-05,9호선,양천향교,5395,4901,10296
2022-05-05,9호선,여의도,12302,11922,24224
2022-05-05,9호선,염창,10461,9712,20173
2022-05-05,9호선,증미,3697,3398,7095
2022-05-05,9호선,흑석,5512,5280,10792
2022-05-05,9호선2~3단계,둔촌오륜,555,555,1110
2022-05-05,9호선2~3단계,봉은사,11026,11581,22607
2022-05-05,9호선2~3단계,삼성중앙,2432,2331,4763
2022-05-05,9호선2~3단계,삼전,4279,4023,8302
2022-05-05,9호선2~3단계,석촌,5795,4820,10615
2022-05-05,9호선2~3단계,석촌고분,3774,3450,7224
2022-05-05,9호선2~3단계,선정릉,3425,3830,7255
2022-05-05,9호선2~3단계,송파나루,3617,3995,7612
2022-05-05,9호선2~3단계,언주,3882,3929,7811
2022-05-05,9호선2~3단계,올림픽공원,4767,5100,9867
2022-05-05,9호선2~3단계,종합운동장,2983,2429,5412
2022-05-05,9호선2~3단계,중앙보훈병원,4287,4020,8307
2022-05-05,9호선2~3단계,한성백제,1841,1559,3400
2022-05-05,경강선,경기광주,5458,5085,10543
2022-05-05,경강선,곤지암,1900,2010,3910
2022-05-05,경강선,부발,1683,1796,3479
2022-05-05,경강선,삼동,1494,1386,2880
2022-05-05,경강선,세종대왕릉,339,368,707
2022-05-05,경강선,신둔도예촌,1171,1154,2325
2022-05-05,경강선,여주,2930,2973,5903
2022-05-05,경강선,이매,857,635,1492
2022-05-05,경강선,이천,2447,2550,4997
2022-05-05,경강선,초월,2155,1986,4141
2022-05-05,경강선,판교,3419,3450,6869
2022-05-05,경부선,가산디지털단지,5842,7423,13265
2022-05-05,경부선,관악,5545,5315,10860
2022-05-05,경부선,광명,2481,2521,5002
2022-05-05,경부선,구로,11864,11988,23852
2022-05-05,경부선,군포,3896,3672,7568
2022-05-05,경부선,금정,17019,16581,33600
2022-05-05,경부선,금천구청,7774,7632,15406
2022-05-05,경부선,남영,5055,5169,10224
2022-05-05,경부선,노량진,7965,7093,15058
2022-05-05,경부선,당정,4073,3800,7873
2022-05-05,경부선,대방,7389,7147,14536
2022-05-05,경부선,독산,8390,8193,16583
2022-05-05,경부선,두정,5506,5109,10615
2022-05-05,경부선,명학,4244,4076,8320
2022-05-05,경부선,병점,12171,12039,24210
2022-05-05,경부선,서동탄,969,1009,1978
2022-05-05,경부선,서울역,7148,2203,9351
2022-05-05,경부선,서정리,5800,5643,11443
2022-05-05,경부선,석수,6346,6086,12432
2022-05-05,경부선,성균관대,11938,10196,22134
2022-05-05,경부선,성환,3315,2814,6129
2022-05-05,경부선,세류,2311,2396,4707
2022-05-05,경부선,세마,2456,2211,4667
2022-05-05,경부선,송탄,4016,3835,7851
2022-05-05,경부선,수원,40700,43677,84377
2022-05-05,경부선,신길,5759,4896,10655
2022-05-05,경부선,신도림,3004,2911,5915
2022-05-05,경부선,안양,17465,17239,34704
2022-05-05,경부선,영등포,38066,39006,77072
2022-05-05,경부선,오산,8706,8461,17167
2022-05-05,경부선,오산대,3312,3084,6396
2022-05-05,경부선,용산,38055,41438,79493
2022-05-05,경부선,의왕,6383,6279,12662
2022-05-05,경부선,직산,622,645,1267
2022-05-05,경부선,진위,1007,937,1944
2022-05-05,경부선,천안,6514,6509,13023
2022-05-05,경부선,평택,12135,12254,24389
2022-05-05,경부선,평택지제,2943,2874,5817
2022-05-05,경부선,화서,5305,5291,10596
2022-05-05,경원선,가능,4799,4515,9314
2022-05-05,경원선,광운대,5486,5252,10738
2022-05-05,경원선,녹양,3351,3192,6543
2022-05-05,경원선,녹천,3055,2539,5594
2022-05-05,경원선,덕계,2500,2296,4796
2022-05-05,경원선,덕정,4310,4067,8377
2022-05-05,경원선,도봉,4350,4018,8368
2022-05-05,경원선,도봉산,9871,7198,17069
2022-05-05,경원선,동두천,1832,2402,4234
2022-05-05,경원선,동두천중앙,2785,2828,5613
2022-05-05,경원선,망월사,5798,5879,11677
2022-05-05,경원선,방학,7150,6826,13976
2022-05-05,경원선,보산,1341,1281,2622
2022-05-05,경원선,서빙고,1768,1976,3744
2022-05-05,경원선,석계,6357,6614,12971
2022-05-05,경원선,소요산,4533,3844,8377
2022-05-05,경원선,신이문,5990,5443,11433
2022-05-05,경원선,양주,6688,6391,13079
2022-05-05,경원선,옥수,47,34,81
2022-05-05,경원선,왕십리,12564,13737,26301
2022-05-05,경원선,외대앞,6194,5740,11934
2022-05-05,경원선,월계,4748,4338,9086
2022-05-05,경원선,응봉,1605,1443,3048
2022-05-05,경원선,의정부,17297,17929,35226
2022-05-05,경원선,이촌,3437,2183,5620
2022-05-05,경원선,지행,5638,5560,11198
2022-05-05,경원선,창동,2,0,2
2022-05-05,경원선,청량리,16007,16355,32362
2022-05-05,경원선,한남,2752,2558,5310
2022-05-05,경원선,회룡,9441,9389,18830
2022-05-05,경의선,가좌,3773,3544,7317
2022-05-05,경의선,강매,1866,1773,3639
2022-05-05,경의선,곡산,457,466,923
2022-05-05,경의선,공덕,2124,1863,3987
2022-05-05,경의선,금릉,3816,3799,7615
2022-05-05,경의선,금촌,5334,5183,10517
2022-05-05,경의선,능곡,2767,2688,5455
2022-05-05,경의선,디지털미디어시티,1874,1583,3457
2022-05-05,경의선,문산,4493,4606,9099
2022-05-05,경의선,백마,4510,4185,8695
2022-05-05,경의선,서강대,1591,1512,3103
2022-05-05,경의선,서울역,1514,1514,3028
2022-05-05,경의선,수색,1409,1419,2828
2022-05-05,경의선,신촌,388,415,803
2022-05-05,경의선,야당,6355,6427,12782
2022-05-05,경의선,운정,4770,4391,9161
2022-05-05,경의선,월롱,1719,1714,3433
2022-05-05,경의선,일산,6161,5796,11957
2022-05-05,경의선,임진강,185,133,318
2022-05-05,경의선,탄현,5071,4789,9860
2022-05-05,경의선,파주,868,751,1619
2022-05-05,경의선,풍산,4194,4042,8236
2022-05-05,경의선,행신,5136,5282,10418
2022-05-05,경의선,홍대입구,2504,3105,5609
2022-05-05,경의선,화전,1302,1286,2588
2022-05-05,경의선,효창공원앞,1690,1834,3524
2022-05-05,경인선,간석,4066,3899,7965
2022-05-05,경인선,개봉,15142,14540,29682
2022-05-05,경인선,구일,4196,4007,8203
2022-05-05,경인선,도원,1759,1878,3637
2022-05-05,경인선,도화,2965,2791,5756
2022-05-05,경인선,동암,11133,11298,22431
2022-05-05,경인선,동인천,11971,12336,24307
2022-05-05,경인선,백운,5022,4888,9910
2022-05-05,경인선,부개,6070,5586,11656
2022-05-05,경인선,부천,26989,27506,54495
2022-05-05,경인선,부평,27427,29687,57114
2022-05-05,경인선,소사,6150,5787,11937
2022-05-05,경인선,송내,16553,16276,32829
2022-05-05,경인선,역곡,19247,18712,37959
2022-05-05,경인선,오류동,8630,7666,16296
2022-05-05,경인선,온수,4800,4335,9135
2022-05-05,경인선,인천,8772,7074,15846
2022-05-05,경인선,제물포,6774,6248,13022
2022-05-05,경인선,주안,15209,13192,28401
2022-05-05,경인선,중동,6253,5740,11993
2022-05-05,경춘선,가평,2615,3063,5678
2022-05-05,경춘선,갈매,2039,1753,3792
2022-05-05,경춘선,강촌,1155,989,2144
2022-05-05,경춘선,굴봉산,386,372,758
2022-05-05,경춘선,금곡,1242,1225,2467
2022-05-05,경춘선,김유정,921,1040,1961
2022-05-05,경춘선,남춘천,3401,3482,6883
2022-05-05,경춘선,대성리,1453,1522,2975
2022-05-05,경춘선,마석,3677,3639,7316
2022-05-05,경춘선,백양리,198,222,420
2022-05-05,경춘선,별내,2401,2301,4702
2022-05-05,경춘선,사릉,1844,1828,3672
2022-05-05,경춘선,상천,623,567,1190
2022-05-05,경춘선,신내,1347,1376,2723
2022-05-05,경춘선,천마산,1488,1482,2970
2022-05-05,경춘선,청평,2340,2314,4654
2022-05-05,경춘선,춘천,3224,2547,5771
2022-05-05,경춘선,퇴계원,2691,2499,5190
2022-05-05,경춘선,평내호평,5089,4775,9864
2022-05-05,공항철도,검암,4401,4377,8778
2022-05-05,공항철도,계양,7098,6524,13622
2022-05-05,공항철도,공덕,1408,1948,3356
2022-05-05,공항철도,공항화물청사,1294,1324,2618
2022-05-05,공항철도,김포공항,11355,5481,16836
2022-05-05,공항철도,디지털미디어시티,4787,4458,9245
2022-05-05,공항철도,마곡나루,3529,3822,7351
2022-05-05,공항철도,서울역,7702,8862,16564
2022-05-05,공항철도,영종,3269,3363,6632
2022-05-05,공항철도,운서,6524,6796,13320
2022-05-05,공항철도,인천공항1터미널,6158,5650,11808
2022-05-05,공항철도,인천공항2터미널,2931,2502,5433
2022-05-05,공항철도,청라국제도시,4478,4196,8674
2022-05-05,공항철도,홍대입구,14645,14071,28716
2022-05-05,과천선,경마공원,1367,1270,2637
2022-05-05,과천선,과천,4906,4255,9161
2022-05-05,과천선,대공원,19371,19565,38936
2022-05-05,과천선,범계,20006,19760,39766
2022-05-05,과천선,선바위,5191,4857,10048
2022-05-05,과천선,인덕원,15165,14783,29948
2022-05-05,과천선,정부과천청사,6571,6536,13107
2022-05-05,과천선,평촌,8211,7789,16000
2022-05-05,분당선,가천대,5603,5642,11245
2022-05-05,분당선,강남구청,3998,4548,8546
2022-05-05,분당선,개포동,2265,2238,4503
2022-05-05,분당선,구룡,1064,997,2061
2022-05-05,분당선,구성,3314,3363,6677
2022-05-05,분당선,기흥,6605,6127,12732
2022-05-05,분당선,대모산입구,2495,2201,4696
2022-05-05,분당선,도곡,3496,3226,6722
2022-05-05,분당선,망포,8371,7640,16011
2022-05-05,분당선,매교,1970,2001,3971
2022-05-05,분당선,매탄권선,3367,3174,6541
2022-05-05,분당선,모란,14084,14589,28673
2022-05-05,분당선,미금,9306,9530,18836
2022-05-05,분당선,보정,1447,1350,2797
2022-05-05,분당선,복정,4,0,4
2022-05-05,분당선,상갈,3999,3913,7912
2022-05-05,분당선,서울숲,13774,15034,28808
2022-05-05,분당선,서현,17737,17850,35587
2022-05-05,분당선,선릉,3421,5388,8809
2022-05-05,분당선,선정릉,2423,2382,4805
2022-05-05,분당선,수내,7696,7321,15017
2022-05-05,분당선,수서,8476,9543,18019
2022-05-05,분당선,수원,7633,6437,14070
2022-05-05,분당선,수원시청,8493,8765,17258
2022-05-05,분당선,신갈,2516,2495,5011
2022-05-05,분당선,압구정로데오,14579,16812,31391
2022-05-05,분당선,야탑,16151,16976,33127
2022-05-05,분당선,영통,6346,6240,12586
2022-05-05,분당선,오리,7024,5691,12715
2022-05-05,분당선,이매,3671,3613,7284
2022-05-05,분당선,정자,9994,10183,20177
2022-05-05,분당선,죽전,10012,11177,21189
2022-05-05,분당선,청명,2474,2354,4828
2022-05-05,분당선,태평,9772,8871,18643
2022-05-05,분당선,한티,8136,8131,16267
2022-05-05,수인선,고색,2613,2687,5300
2022-05-05,수인선,남동인더스파크,844,884,1728
2022-05-05,수인선,달월,52,64,116
2022-05-05,수인선,사리,3854,3183,7037
2022-05-05,수인선,소래포구,7769,7601,15370
2022-05-05,수인선,송도,2020,2063,4083
2022-05-05,수인선,숭의,2557,2400,4957
2022-05-05,수인선,신포,1652,1542,3194
2022-05-05,수인선,야목,301,274,575
2022-05-05,수인선,어천,669,662,1331
2022-05-05,수인선,연수,3767,3735,7502
2022-05-05,수인선,오목천,2220,1871,4091
2022-05-05,수인선,원인재,3444,3525,6969
2022-05-05,수인선,월곶,2409,2218,4627
2022-05-05,수인선,인천,2144,3570,5714
2022-05-05,수인선,인천논현,4050,4369,8419
2022-05-05,수인선,인하대,4815,4559,9374
2022-05-05,수인선,호구포,2473,2468,4941
2022-05-05,안산선,고잔,6238,6499,12737
2022-05-05,안산선,대야미,4069,3523,7592
2022-05-05,안산선,반월,3286,3068,6354
2022-05-05,안산선,산본,12084,12796,24880
2022-05-05,안산선,상록수,11742,11513,23255
2022-05-05,안산선,수리산,3468,3562,7030
2022-05-05,안산선,신길온천,1629,1525,3154
2022-05-05,안산선,안산,8735,8316,17051
2022-05-05,안산선,오이도,8895,8983,17878
2022-05-05,안산선,정왕,6313,6198,12511
2022-05-05,안산선,중앙,16182,16815,32997
2022-05-05,안산선,초지,3305,3316,6621
2022-05-05,안산선,한대앞,6982,6830,13812
2022-05-05,우이신설선,4.19민주묘지,2487,2178,4665
2022-05-05,우이신설선,가오리,2857,2646,5503
2022-05-05,우이신설선,보문,1053,1049,2102
2022-05-05,우이신설선,북한산보국문,4604,3875,8479
2022-05-05,우이신설선,북한산우이,4119,4116,8235
2022-05-05,우이신설선,삼양,1442,1439,2881
2022-05-05,우이신설선,삼양사거리,1790,1767,3557
2022-05-05,우이신설선,성신여대입구,2711,3138,5849
2022-05-05,우이신설선,솔밭공원,1752,1785,3537
2022-05-05,우이신설선,솔샘,3864,3454,7318
2022-05-05,우이신설선,신설동,1462,1340,2802
2022-05-05,우이신설선,정릉,3567,2828,6395
2022-05-05,우이신설선,화계,2476,2255,4731
2022-05-05,일산선,대곡,1410,1154,2564
2022-05-05,일산선,대화,7390,6658,14048
2022-05-05,일산선,마두,4554,4470,9024
2022-05-05,일산선,백석,6691,6572,13263
2022-05-05,일산선,삼송,14684,13963,28647
2022-05-05,일산선,원당,7840,7431,15271
2022-05-05,일산선,원흥,7089,6626,13715
2022-05-05,일산선,정발산,7663,7840,15503
2022-05-05,일산선,주엽,6112,5862,11974
2022-05-05,일산선,화정,11977,12318,24295
2022-05-05,장항선,배방,1056,1013,2069
2022-05-05,장항선,봉명,606,648,1254
2022-05-05,장항선,신창,1961,1407,3368
2022-05-05,장항선,쌍용,1651,1487,3138
2022-05-05,장항선,아산,3210,3281,6491
2022-05-05,장항선,온양온천,3765,3769,7534
2022-05-05,장항선,탕정,627,590,1217
2022-05-05,중앙선,구리,10184,10523,20707
2022-05-05,중앙선,국수,770,774,1544
2022-05-05,중앙선,덕소,4676,4743,9419
2022-05-05,중앙선,도농,6895,6679,13574
2022-05-05,중앙선,도심,1778,1524,3302
2022-05-05,중앙선,망우,6428,6146,12574
2022-05-05,중앙선,상봉,4839,4818,9657
2022-05-05,중앙선,신원,392,275,667
2022-05-05,중앙선,아신,722,737,1459
2022-05-05,중앙선,양수,2841,2747,5588
2022-05-05,중앙선,양원,1808,1733,3541
2022-05-05,중앙선,양정,706,604,1310
2022-05-05,중앙선,양평,2991,3127,6118
2022-05-05,중앙선,오빈,363,338,701
2022-05-05,중앙선,용문,5696,5837,11533
2022-05-05,중앙선,운길산,1846,1780,3626
2022-05-05,중앙선,원덕,505,527,1032
2022-05-05,중앙선,중랑,4397,4205,8602
2022-05-05,중앙선,지평,106,112,218
2022-05-05,중앙선,팔당,2075,2296,4371
2022-05-05,중앙선,회기,18800,17723,36523
2022-05-06,1호선,동대문,12405,11325,23730
2022-05-06,1호선,동묘앞,8728,9074,17802
2022-05-06,1호선,서울역,46752,49960,96712
2022-05-06,1호선,시청,22315,22286,44601
2022-05-06,1호선,신설동,14106,13425,27531
2022-05-06,1호선,제기동,17293,17737,35030
2022-05-06,1호선,종각,34085,32666,66751
2022-05-06,1호선,종로3가,28097,25720,53817
2022-05-06,1호선,종로5가,24716,24499,49215
2022-05-06,1호선,청량리,21493,21508,43001
2022-05-06,2호선,강남,83589,86126,169715
2022-05-06,2호선,강변,36890,36905,73795
2022-05-06,2호선,건대입구,42387,45998,88385
2022-05-06,2호선,교대,31938,36185,68123
2022-05-06,2호선,구로디지털단지,54011,52957,106968
2022-05-06,2호선,구의,22985,22040,45025
2022-05-06,2호선,낙성대,27020,24514,51534
2022-05-06,2호선,당산,18943,21408,40351
2022-05-06,2호선,대림,23616,23726,47342
2022-05-06,2호선,도림천,1307,1334,2641
2022-05-06,2호선,동대문역사문화공원,14499,15783,30282
2022-05-06,2호선,뚝섬,23055,24445,47500
2022-05-06,2호선,문래,20325,20902,41227
2022-05-06,2호선,방배,17637,18077,35714
2022-05-06,2호선,봉천,22945,20509,43454
2022-05-06,2호선,사당,37182,43002,80184
2022-05-06,2호선,삼성,45660,46462,92122
2022-05-06,2호선,상왕십리,14142,13258,27400
2022-05-06,2호선,서울대입구,49193,46803,95996
2022-05-06,2호선,서초,18810,17430,36240
2022-05-06,2호선,선릉,49472,43978,93450
2022-05-06,2호선,성수,35492,40258,75750
2022-05-06,2호선,시청,22416,21209,43625
2022-05-06,2호선,신답,1717,1758,3475
2022-05-06,2호선,신당,14548,14998,29546
2022-05-06,2호선,신대방,26737,25008,51745
2022-05-06,2호선,신도림,48204,49032,97236
2022-05-06,2호선,신림,64454,61364,125818
2022-05-06,2호선,신설동,3648,3483,7131
2022-05-06,2호선,신정네거리,10461,10659,21120
2022-05-06,2호선,신촌,37960,37765,75725
2022-05-06,2호선,아현,10705,9858,20563
2022-05-06,2호선,양천구청,6722,6711,13433
2022-05-06,2호선,역삼,41579,46863,88442
2022-05-06,2호선,영등포구청,20845,21634,42479
2022-05-06,2호선,왕십리,18101,14636,32737
2022-05-06,2호선,용답,3123,3109,6232
2022-05-06,2호선,용두,2451,2428,4879
2022-05-06,2호선,을지로3가,22243,23426,45669
2022-05-06,2호선,을지로4가,12915,13229,26144
2022-05-06,2호선,을지로입구,39067,40072,79139
2022-05-06,2호선,이대,14878,15238,30116
2022-05-06,2호선,잠실,97288,95576,192864
2022-05-06,2호선,잠실나루,14434,13809,28243
2022-05-06,2호선,잠실새내,22581,23194,45775
2022-05-06,2호선,종합운동장,14390,15188,29578
2022-05-06,2호선,충정로,9137,9684,18821
2022-05-06,2호선,한양대,12046,12860,24906
2022-05-06,2호선,합정,34151,38546,72697
2022-05-06,2호선,홍대입구,75514,83336,158850
2022-05-06,3호선,가락시장,8296,8202,16498
2022-05-06,3호선,경복궁,25983,26782,52765
2022-05-06,3호선,경찰병원,6621,6367,12988
2022-05-06,3호선,고속터미널,55473,59848,115321
2022-05-06,3호선,교대,13634,8478,22112
2022-05-06,3호선,구파발,21029,20656,41685
2022-05-06,3호선,금호,7844,7088,14932
2022-05-06,3호선,남부터미널,29588,30498,60086
2022-05-06,3호선,녹번,15284,13175,28459
2022-05-06,3호선,대청,9456,8472,17928
2022-05-06,3호선,대치,10624,10360,20984
2022-05-06,3호선,도곡,4691,4856,9547
2022-05-06,3호선,독립문,8047,8385,16432
2022-05-06,3호선,동대입구,8299,9232,17531
2022-05-06,3호선,매봉,11331,10987,22318
2022-05-06,3호선,무악재,3836,3764,7600
2022-05-06,3호선,불광,16359,17478,33837
2022-05-06,3호선,수서,16843,17393,34236
2022-05-06,3호선,신사,31340,33748,65088
2022-05-06,3호선,안국,23743,25477,49220
2022-05-06,3호선,압구정,32674,35285,67959
2022-05-06,3호선,약수,12546,12302,24848
2022-05-06,3호선,양재,33827,36777,70604
2022-05-06,3호선,연신내,37468,35484,72952
2022-05-06,3호선,오금,5786,5265,11051
2022-05-06,3호선,옥수,9023,9046,18069
2022-05-06,3호선,을지로3가,10409,11160,21569
2022-05-06,3호선,일원,9686,8984,18670
2022-05-06,3호선,잠원,4845,4588,9433
2022-05-06,3호선,종로3가,10641,13347,23988
2022-05-06,3호선,지축,4950,4511,9461
2022-05-06,3호선,충무로,2,0,2
2022-05-06,3호선,학여울,1578,1640,3218
2022-05-06,3호선,홍제,18259,16904,35163
2022-05-06,4호선,길음,21635,20342,41977
2022-05-06,4호선,남태령,1457,1052,2509
2022-05-06,4호선,노원,20927,24387,45314
2022-05-06,4호선,당고개,9494,8357,17851
2022-05-06,4호선,동대문,23274,22997,46271
2022-05-06,4호선,동대문역사문화공원,16672,14312,30984
2022-05-06,4호선,동작,1751,1884,3635
2022-05-06,4호선,명동,23050,24389,47439
2022-05-06,4호선,미아,15212,14462,29674
2022-05-06,4호선,미아사거리,28430,27281,55711
2022-05-06,4호선,사당,27143,22819,49962
2022-05-06,4호선,삼각지,5108,6004,11112
2022-05-06,4호선,상계,19274,17577,36851
2022-05-06,4호선,서울역,10566,20249,30815
2022-05-06,4호선,성신여대입구,22434,21187,43621
2022-05-06,4호선,수유,35452,35656,71108
2022-05-06,4호선,숙대입구,13546,13157,26703
2022-05-06,4호선,신용산,16150,17906,34056
2022-05-06,4호선,쌍문,30169,26897,57066
2022-05-06,4호선,이촌,10490,11447,21937
2022-05-06,4호선,창동,26773,28274,55047
2022-05-06,4호선,총신대입구,19022,20744,39766
2022-05-06,4호선,충무로,27099,29136,56235
2022-05-06,4호선,한성대입구,14975,14444,29419
2022-05-06,4호선,혜화,37616,37524,75140
2022-05-06,4호선,회현,27159,28307,55466
2022-05-06,5호선,강동,17473,16124,33597
2022-05-06,5호선,강일,4273,3865,8138
2022-05-06,5호선,개롱,6139,6254,12393
2022-05-06,5호선,개화산,5538,5163,10701
2022-05-06,5호선,거여,9700,9151,18851
2022-05-06,5호선,고덕,9596,9588,19184
2022-05-06,5호선,공덕,12539,13174,25713
2022-05-06,5호선,광나루,13307,11922,25229
2022-05-06,5호선,광화문,29835,31731,61566
2022-05-06,5호선,군자,11331,12208,23539
2022-05-06,5호선,굽은다리,10239,9599,19838
2022-05-06,5호선,길동,8354,8627,16981
2022-05-06,5호선,김포공항,8768,8883,17651
2022-05-06,5호선,까치산,28938,26963,55901
2022-05-06,5호선,답십리,15538,13959,29497
2022-05-06,5호선,동대문역사문화공원,2284,2814,5098
2022-05-06,5호선,둔촌동,8355,8312,16667
2022-05-06,5호선,마곡,9905,10002,19907
2022-05-06,5호선,마장,5637,5163,10800
2022-05-06,5호선,마천,7027,6595,13622
2022-05-06,5호선,마포,13428,13849,27277
2022-05-06,5호선,명일,8598,8825,17423
2022-05-06,5호선,목동,16676,17320,33996
2022-05-06,5호선,미사,16328,16037,32365
2022-05-06,5호선,발산,19328,20472,39800
2022-05-06,5호선,방이,6428,6553,12981
2022-05-06,5호선,방화,6683,6201,12884
2022-05-06,5호선,상일동,14225,12913,27138
2022-05-06,5호선,서대문,17217,17031,34248
2022-05-06,5호선,송정,6720,6344,13064
2022-05-06,5호선,신금호,6159,6253,12412
2022-05-06,5호선,신길,4037,3932,7969
2022-05-06,5호선,신정,13501,10684,24185
2022-05-06,5호선,아차산,16405,15781,32186
2022-05-06,5호선,애오개,6199,6148,12347
2022-05-06,5호선,양평,6661,6148,12809
2022-05-06,5호선,여의나루,28835,30364,59199
2022-05-06,5호선,여의도,26948,29465,56413
2022-05-06,5호선,영등포구청,3791,3747,7538
2022-05-06,5호선,영등포시장,10302,10414,20716
2022-05-06,5호선,오금,3370,3337,6707
2022-05-06,5호선,오목교,22183,24039,46222
2022-05-06,5호선,올림픽공원,4571,3938,8509
2022-05-06,5호선,왕십리,4539,5583,10122
2022-05-06,5호선,우장산,14387,13887,28274
2022-05-06,5호선,을지로4가,6094,6556,12650
2022-05-06,5호선,장한평,17832,17255,35087
2022-05-06,5호선,종로3가,15852,15563,31415
2022-05-06,5호선,천호,20085,19983,40068
2022-05-06,5호선,청구,4034,3534,7568
2022-05-06,5호선,충정로,4236,4256,8492
2022-05-06,5호선,하남검단산,6430,6122,12552
2022-05-06,5호선,하남시청,7205,6723,13928
2022-05-06,5호선,하남풍산,4082,3994,8076
2022-05-06,5호선,행당,7629,6570,14199
2022-05-06,5호선,화곡,28930,26182,55112
2022-05-06,6호선,고려대,8826,8214,17040
2022-05-06,6호선,공덕,16901,16287,33188
2022-05-06,6호선,광흥창,8658,7936,16594
2022-05-06,6호선,구산,7564,5516,13080
2022-05-06,6호선,녹사평,5672,6320,11992
2022-05-06,6호선,대흥,8206,8184,16390
2022-05-06,6호선,독바위,2616,2655,5271
2022-05-06,6호선,돌곶이,9146,8205,17351
2022-05-06,6호선,동묘앞,8647,8427,17074
2022-05-06,6호선,디지털미디어시티,12832,13486,26318
2022-05-06,6호선,마포구청,13961,11959,25920
2022-05-06,6호선,망원,15219,16614,31833
2022-05-06,6호선,버티고개,2167,2069,4236
2022-05-06,6호선,보문,7502,6559,14061
2022-05-06,6호선,봉화산,8593,7946,16539
2022-05-06,6호선,불광,4652,4521,9173
2022-05-06,6호선,삼각지,6965,5766,12731
2022-05-06,6호선,상수,10556,12526,23082
2022-05-06,6호선,상월곡,6387,5593,11980
2022-05-06,6호선,새절,12911,11735,24646
2022-05-06,6호선,석계,12290,12660,24950
2022-05-06,6호선,신당,8357,7905,16262
2022-05-06,6호선,안암,12962,12011,24973
2022-05-06,6호선,약수,3558,3597,7155
2022-05-06,6호선,역촌,3710,4170,7880
2022-05-06,6호선,연신내,1,0,1
2022-05-06,6호선,월곡,11991,11377,23368
2022-05-06,6호선,월드컵경기장,5179,5574,10753
2022-05-06,6호선,응암,17852,17097,34949
2022-05-06,6호선,이태원,12890,17106,29996
2022-05-06,6호선,증산,10201,9806,20007
2022-05-06,6호선,창신,3337,2626,5963
2022-05-06,6호선,청구,3764,3833,7597
2022-05-06,6호선,태릉입구,5842,6471,12313
2022-05-06,6호선,한강진,8659,10506,19165
2022-05-06,6호선,합정,14497,14594,29091
2022-05-06,6호선,화랑대,11137,8478,19615
2022-05-06,6호선,효창공원앞,7195,6304,13499
2022-05-06,7호선,가산디지털단지,36084,35425,71509
2022-05-06,7호선,강남구청,14746,16403,31149
2022-05-06,7호선,건대입구,14104,15813,29917
2022-05-06,7호선,고속터미널,19146,15054,34200
2022-05-06,7호선,공릉,12972,12425,25397
2022-05-06,7호선,광명사거리,21868,21691,43559
2022-05-06,7호선,군자,14626,11379,26005
2022-05-06,7호선,남구로,13562,14152,27714
2022-05-06,7호선,남성,11011,9828,20839
2022-05-06,7호선,내방,13731,13880,27611
2022-05-06,7호선,노원,21883,23759,45642
2022-05-06,7호선,논현,18790,20918,39708
2022-05-06,7호선,대림,8040,8229,16269
2022-05-06,7호선,도봉산,9215,10772,19987
2022-05-06,7호선,뚝섬유원지,18429,17106,35535
2022-05-06,7호선,마들,12864,11736,24600
2022-05-06,7호선,먹골,10335,9864,20199
2022-05-06,7호선,면목,16367,15397,31764
2022-05-06,7호선,반포,6018,5831,11849
2022-05-06,7호선,보라매,9097,8689,17786
2022-05-06,7호선,사가정,16298,16315,32613
2022-05-06,7호선,상도,11202,10493,21695
2022-05-06,7호선,상봉,17384,16665,34049
2022-05-06,7호선,수락산,12800,12322,25122
2022-05-06,7호선,숭실대입구,13891,13484,27375
2022-05-06,7호선,신대방삼거리,16283,15017,31300
2022-05-06,7호선,신풍,11005,10353,21358
2022-05-06,7호선,어린이대공원,15943,15507,31450
2022-05-06,7호선,온수,10011,9388,19399
2022-05-06,7호선,용마산,6046,5701,11747
2022-05-06,7호선,이수,15702,15378,31080
2022-05-06,7호선,장승배기,8780,8281,17061
2022-05-06,7호선,장암,2257,956,3213
2022-05-06,7호선,중계,14373,12555,26928
2022-05-06,7호선,중곡,10547,9631,20178
2022-05-06,7호선,중화,10814,10328,21142
2022-05-06,7호선,천왕,10659,9819,20478
2022-05-06,7호선,철산,20908,21461,42369
2022-05-06,7호선,청담,17459,19565,37024
2022-05-06,7호선,태릉입구,9060,8405,17465
2022-05-06,7호선,하계,18545,16946,35491
2022-05-06,7호선,학동,20140,21521,41661
2022-05-06,8호선,가락시장,7307,8315,15622
2022-05-06,8호선,강동구청,10190,10144,20334
2022-05-06,8호선,남위례,4894,5018,9912
2022-05-06,8호선,남한산성입구,14962,13184,28146
2022-05-06,8호선,단대오거리,11537,10506,22043
2022-05-06,8호선,모란,4725,3908,8633
2022-05-06,8호선,몽촌토성,5922,5860,11782
2022-05-06,8호선,문정,16571,17201,33772
2022-05-06,8호선,복정,9265,8021,17286
2022-05-06,8호선,산성,5269,5134,10403
2022-05-06,8호선,석촌,7697,9043,16740
2022-05-06,8호선,송파,7987,7544,15531
2022-05-06,8호선,수진,5312,4704,10016
2022-05-06,8호선,신흥,4503,4845,9348
2022-05-06,8호선,암사,17895,15708,33603
2022-05-06,8호선,잠실,15891,20512,36403
2022-05-06,8호선,장지,16536,15968,32504
2022-05-06,8호선,천호,14800,17657,32457
2022-05-06,9호선,가양,20314,19217,39531
2022-05-06,9호선,개화,2419,1766,4185
2022-05-06,9호선,고속터미널,16847,23636,40483
2022-05-06,9호선,공항시장,2942,3012,5954
2022-05-06,9호선,구반포,1206,1228,2434
2022-05-06,9호선,국회의사당,13971,13904,27875
2022-05-06,9호선,김포공항,8402,13432,21834
2022-05-06,9호선,노들,4605,3676,8281
2022-05-06,9호선,노량진,26746,25777,52523
2022-05-06,9호선,당산,17809,17137,34946
2022-05-06,9호선,동작,2025,1729,3754
2022-05-06,9호선,등촌,10889,10369,21258
2022-05-06,9호선,마곡나루,11582,11232,22814
2022-05-06,9호선,사평,3482,3164,6646
2022-05-06,9호선,샛강,5444,5487,10931
2022-05-06,9호선,선유도,7520,6846,14366
2022-05-06,9호선,신논현,33243,33638,66881
2022-05-06,9호선,신목동,4226,3596,7822
2022-05-06,9호선,신반포,4043,4182,8225
2022-05-06,9호선,신방화,6702,6164,12866
2022-05-06,9호선,양천향교,9407,9182,18589
2022-05-06,9호선,여의도,27167,26135,53302
2022-05-06,9호선,염창,17017,15879,32896
2022-05-06,9호선,증미,7277,6732,14009
2022-05-06,9호선,흑석,9300,9235,18535
2022-05-06,9호선2~3단계,둔촌오륜,972,883,1855
2022-05-06,9호선2~3단계,봉은사,16180,16652,32832
2022-05-06,9호선2~3단계,삼성중앙,6062,6346,12408
2022-05-06,9호선2~3단계,삼전,6767,6271,13038
2022-05-06,9호선2~3단계,석촌,8763,7369,16132
2022-05-06,9호선2~3단계,석촌고분,6040,5557,11597
2022-05-06,9호선2~3단계,선정릉,8374,9147,17521
2022-05-06,9호선2~3단계,송파나루,5172,5492,10664
2022-05-06,9호선2~3단계,언주,9108,9139,18247
2022-05-06,9호선2~3단계,올림픽공원,6786,6944,13730
2022-05-06,9호선2~3단계,종합운동장,4857,4867,9724
2022-05-06,9호선2~3단계,중앙보훈병원,9318,8278,17596
2022-05-06,9호선2~3단계,한성백제,2626,2198,4824
2022-05-06,경강선,경기광주,8086,7507,15593
2022-05-06,경강선,곤지암,2485,2508,4993
2022-05-06,경강선,부발,2808,2446,5254
2022-05-06,경강선,삼동,2389,2193,4582
2022-05-06,경강선,세종대왕릉,436,445,881
2022-05-06,경강선,신둔도예촌,1799,1619,3418
2022-05-06,경강선,여주,2768,3255,6023
2022-05-06,경강선,이매,1138,896,2034
2022-05-06,경강선,이천,3264,3549,6813
2022-05-06,경강선,초월,3533,3196,6729
2022-05-06,경강선,판교,4959,4845,9804
2022-05-06,경부선,가산디지털단지,14773,17562,32335
2022-05-06,경부선,관악,7435,6997,14432
2022-05-06,경부선,광명,3525,3459,6984
2022-05-06,경부선,구로,18154,18761,36915
2022-05-06,경부선,군포,7219,6997,14216
2022-05-06,경부선,금정,25707,26079,51786
2022-05-06,경부선,금천구청,12073,11875,23948
2022-05-06,경부선,남영,8910,9410,18320
2022-05-06,경부선,노량진,9457,9063,18520
2022-05-06,경부선,당정,6191,5735,11926
2022-05-06,경부선,대방,12724,12626,25350
2022-05-06,경부선,독산,16925,16862,33787
2022-05-06,경부선,두정,8148,7618,15766
2022-05-06,경부선,명학,8604,8295,16899
2022-05-06,경부선,병점,16547,16274,32821
2022-05-06,경부선,서동탄,1402,1335,2737
2022-05-06,경부선,서울역,8787,2901,11688
2022-05-06,경부선,서정리,8409,7053,15462
2022-05-06,경부선,석수,9463,8314,17777
2022-05-06,경부선,성균관대,15833,14908,30741
2022-05-06,경부선,성환,4902,4337,9239
2022-05-06,경부선,세류,3207,2970,6177
2022-05-06,경부선,세마,3106,2812,5918
2022-05-06,경부선,송탄,5393,4800,10193
2022-05-06,경부선,수원,44315,48166,92481
2022-05-06,경부선,신길,8855,7514,16369
2022-05-06,경부선,신도림,4033,4177,8210
2022-05-06,경부선,안양,26968,26866,53834
2022-05-06,경부선,영등포,44613,46652,91265
2022-05-06,경부선,오산,11221,10915,22136
2022-05-06,경부선,오산대,3890,3721,7611
2022-05-06,경부선,용산,43528,48128,91656
2022-05-06,경부선,의왕,9163,8855,18018
2022-05-06,경부선,직산,980,916,1896
2022-05-06,경부선,진위,1575,1451,3026
2022-05-06,경부선,천안,7427,7415,14842
2022-05-06,경부선,평택,15773,15726,31499
2022-05-06,경부선,평택지제,4024,3861,7885
2022-05-06,경부선,화서,7956,7443,15399
2022-05-06,경원선,가능,6891,6565,13456
2022-05-06,경원선,광운대,8917,8406,17323
2022-05-06,경원선,녹양,4903,4618,9521
2022-05-06,경원선,녹천,4508,3745,8253
2022-05-06,경원선,덕계,3507,3138,6645
2022-05-06,경원선,덕정,6024,5563,11587
2022-05-06,경원선,도봉,6097,5743,11840
2022-05-06,경원선,도봉산,8363,5745,14108
2022-05-06,경원선,동두천,2550,2937,5487
2022-05-06,경원선,동두천중앙,3376,3292,6668
2022-05-06,경원선,망월사,8684,8509,17193
2022-05-06,경원선,방학,10060,9822,19882
2022-05-06,경원선,보산,2097,1717,3814
2022-05-06,경원선,서빙고,2252,2159,4411
2022-05-06,경원선,석계,8536,9444,17980
2022-05-06,경원선,소요산,3243,2831,6074
2022-05-06,경원선,신이문,8561,7648,16209
2022-05-06,경원선,양주,8626,8054,16680
2022-05-06,경원선,옥수,55,40,95
2022-05-06,경원선,왕십리,16424,17782,34206
2022-05-06,경원선,외대앞,9259,8797,18056
2022-05-06,경원선,월계,7960,7298,15258
2022-05-06,경원선,응봉,2001,1669,3670
2022-05-06,경원선,의정부,21358,22926,44284
2022-05-06,경원선,이촌,4172,2965,7137
2022-05-06,경원선,지행,7594,7583,15177
2022-05-06,경원선,창동,1,0,1
2022-05-06,경원선,청량리,19130,20034,39164
2022-05-06,경원선,한남,4086,3997,8083
2022-05-06,경원선,회룡,13211,13118,26329
2022-05-06,경의선,가좌,5673,5416,11089
2022-05-06,경의선,강매,3232,2742,5974
2022-05-06,경의선,곡산,646,654,1300
2022-05-06,경의선,공덕,3340,3025,6365
2022-05-06,경의선,금릉,5594,5356,10950
2022-05-06,경의선,금촌,7780,7528,15308
2022-05-06,경의선,능곡,3939,3726,7665
2022-05-06,경의선,디지털미디어시티,2652,2450,5102
2022-05-06,경의선,문산,5994,5762,11756
2022-05-06,경의선,백마,7231,6816,14047
2022-05-06,경의선,서강대,2519,2332,4851
2022-05-06,경의선,서울역,4241,5880,10121
2022-05-06,경의선,수색,2672,2678,5350
2022-05-06,경의선,신촌,995,1275,2270
2022-05-06,경의선,야당,8639,8832,17471
2022-05-06,경의선,운정,7423,6767,14190
2022-05-06,경의선,월롱,2742,2272,5014
2022-05-06,경의선,일산,9652,9405,19057
2022-05-06,경의선,임진강,15,30,45
2022-05-06,경의선,탄현,8144,7712,15856
2022-05-06,경의선,파주,1326,1003,2329
2022-05-06,경의선,풍산,5990,5620,11610
2022-05-06,경의선,행신,8251,8404,16655
2022-05-06,경의선,홍대입구,2521,3310,5831
2022-05-06,경의선,화전,2999,2691,5690
2022-05-06,경의선,효창공원앞,2958,3301,6259
2022-05-06,경인선,간석,6254,5841,12095
2022-05-06,경인선,개봉,22021,21204,43225
2022-05-06,경인선,구일,9189,9181,18370
2022-05-06,경인선,도원,3058,3054,6112
2022-05-06,경인선,도화,4398,3939,8337
2022-05-06,경인선,동암,15266,15438,30704
2022-05-06,경인선,동인천,15127,14736,29863
2022-05-06,경인선,백운,7412,7128,14540
2022-05-06,경인선,부개,8917,8174,17091
2022-05-06,경인선,부천,36021,36592,72613
2022-05-06,경인선,부평,33300,37683,70983
2022-05-06,경인선,소사,9531,8780,18311
2022-05-06,경인선,송내,27945,27720,55665
2022-05-06,경인선,역곡,30006,29153,59159
2022-05-06,경인선,오류동,12157,10915,23072
2022-05-06,경인선,온수,7362,6859,14221
2022-05-06,경인선,인천,5291,4193,9484
2022-05-06,경인선,제물포,11092,10425,21517
2022-05-06,경인선,주안,21695,19340,41035
2022-05-06,경인선,중동,9640,8729,18369
2022-05-06,경춘선,가평,2600,2666,5266
2022-05-06,경춘선,갈매,2996,2597,5593
2022-05-06,경춘선,강촌,616,769,1385
2022-05-06,경춘선,굴봉산,243,215,458
2022-05-06,경춘선,금곡,1610,1513,3123
2022-05-06,경춘선,김유정,519,631,1150
2022-05-06,경춘선,남춘천,4306,3868,8174
2022-05-06,경춘선,대성리,1391,2595,3986
2022-05-06,경춘선,마석,4473,4427,8900
2022-05-06,경춘선,백양리,125,133,258
2022-05-06,경춘선,별내,3413,3204,6617
2022-05-06,경춘선,사릉,2627,2635,5262
2022-05-06,경춘선,상천,344,368,712
2022-05-06,경춘선,신내,2182,1986,4168
2022-05-06,경춘선,천마산,1855,1650,3505
2022-05-06,경춘선,청평,2127,2309,4436
2022-05-06,경춘선,춘천,2711,2157,4868
2022-05-06,경춘선,퇴계원,3697,3446,7143
2022-05-06,경춘선,평내호평,7059,6997,14056
2022-05-06,공항철도,검암,6896,6914,13810
2022-05-06,공항철도,계양,10764,9917,20681
2022-05-06,공항철도,공덕,2210,2982,5192
2022-05-06,공항철도,공항화물청사,2210,2357,4567
2022-05-06,공항철도,김포공항,13105,6883,19988
2022-05-06,공항철도,디지털미디어시티,12418,11225,23643
2022-05-06,공항철도,마곡나루,7235,7113,14348
2022-05-06,공항철도,서울역,9752,10099,19851
2022-05-06,공항철도,영종,3760,3758,7518
2022-05-06,공항철도,운서,7722,7453,15175
2022-05-06,공항철도,인천공항1터미널,6156,6129,12285
2022-05-06,공항철도,인천공항2터미널,2905,2806,5711
2022-05-06,공항철도,청라국제도시,7432,6983,14415
2022-05-06,공항철도,홍대입구,14443,14153,28596
2022-05-06,과천선,경마공원,7637,7824,15461
2022-05-06,과천선,과천,6751,5926,12677
2022-05-06,과천선,대공원,12660,12760,25420
2022-05-06,과천선,범계,28321,29073,57394
2022-05-06,과천선,선바위,8301,7370,15671
2022-05-06,과천선,인덕원,24240,24195,48435
2022-05-06,과천선,정부과천청사,10081,9904,19985
2022-05-06,과천선,평촌,15676,15231,30907
2022-05-06,분당선,가천대,11601,11547,23148
2022-05-06,분당선,강남구청,9498,10746,20244
2022-05-06,분당선,개포동,3846,3905,7751
2022-05-06,분당선,구룡,2005,1835,3840
2022-05-06,분당선,구성,5001,5181,10182
2022-05-06,분당선,기흥,9947,9491,19438
2022-05-06,분당선,대모산입구,4420,4058,8478
2022-05-06,분당선,도곡,6700,6265,12965
2022-05-06,분당선,망포,14358,13010,27368
2022-05-06,분당선,매교,2857,2893,5750
2022-05-06,분당선,매탄권선,5251,4885,10136
2022-05-06,분당선,모란,20672,21291,41963
2022-05-06,분당선,미금,15754,16957,32711
2022-05-06,분당선,보정,2632,2323,4955
2022-05-06,분당선,상갈,5682,5365,11047
2022-05-06,분당선,서울숲,13791,14159,27950
2022-05-06,분당선,서현,27015,27364,54379
2022-05-06,분당선,선릉,11441,17668,29109
2022-05-06,분당선,선정릉,6746,7248,13994
2022-05-06,분당선,수내,13022,12630,25652
2022-05-06,분당선,수서,13636,14480,28116
2022-05-06,분당선,수원,9461,8175,17636
2022-05-06,분당선,수원시청,13430,15151,28581
2022-05-06,분당선,신갈,4498,4428,8926
2022-05-06,분당선,압구정로데오,20394,24034,44428
2022-05-06,분당선,야탑,26252,27769,54021
2022-05-06,분당선,영통,9126,9125,18251
2022-05-06,분당선,오리,11523,9316,20839
2022-05-06,분당선,이매,5829,5343,11172
2022-05-06,분당선,정자,16867,17640,34507
2022-05-06,분당선,죽전,14763,16082,30845
2022-05-06,분당선,청명,4083,3949,8032
2022-05-06,분당선,태평,14081,13300,27381
2022-05-06,분당선,한티,14534,15138,29672
2022-05-06,수인선,고색,4662,4371,9033
2022-05-06,수인선,남동인더스파크,1916,2117,4033
2022-05-06,수인선,달월,126,92,218
2022-05-06,수인선,사리,5428,4753,10181
2022-05-06,수인선,소래포구,6261,6068,12329
2022-05-06,수인선,송도,2750,2595,5345
2022-05-06,수인선,숭의,4115,3690,7805
2022-05-06,수인선,신포,2003,2018,4021
2022-05-06,수인선,야목,451,358,809
2022-05-06,수인선,어천,910,828,1738
2022-05-06,수인선,연수,5132,5147,10279
2022-05-06,수인선,오목천,3894,3307,7201
2022-05-06,수인선,원인재,4570,4861,9431
2022-05-06,수인선,월곶,2840,2593,5433
2022-05-06,수인선,인천,1553,2307,3860
2022-05-06,수인선,인천논현,5811,6260,12071
2022-05-06,수인선,인하대,7417,6887,14304
2022-05-06,수인선,호구포,4111,4068,8179
2022-05-06,안산선,고잔,9538,9328,18866
2022-05-06,안산선,대야미,5351,4601,9952
2022-05-06,안산선,반월,4596,4343,8939
2022-05-06,안산선,산본,17598,19039,36637
2022-05-06,안산선,상록수,16800,16577,33377
2022-05-06,안산선,수리산,4383,3688,8071
2022-05-06,안산선,신길온천,1936,1786,3722
2022-05-06,안산선,안산,12143,11438,23581
2022-05-06,안산선,오이도,9788,10047,19835
2022-05-06,안산선,정왕,10850,10198,21048
2022-05-06,안산선,중앙,21342,23385,44727
2022-05-06,안산선,초지,5073,5223,10296
2022-05-06,안산선,한대앞,11001,10574,21575
2022-05-06,우이신설선,4.19민주묘지,3840,3510,7350
2022-05-06,우이신설선,가오리,4307,4075,8382
2022-05-06,우이신설선,보문,1579,1555,3134
2022-05-06,우이신설선,북한산보국문,6369,5684,12053
2022-05-06,우이신설선,북한산우이,3412,3200,6612
2022-05-06,우이신설선,삼양,2042,2073,4115
2022-05-06,우이신설선,삼양사거리,2592,2498,5090
2022-05-06,우이신설선,성신여대입구,3488,4073,7561
2022-05-06,우이신설선,솔밭공원,2536,2403,4939
2022-05-06,우이신설선,솔샘,5789,5146,10935
2022-05-06,우이신설선,신설동,2239,2119,4358
2022-05-06,우이신설선,정릉,4869,4157,9026
2022-05-06,우이신설선,화계,3532,3298,6830
2022-05-06,일산선,대곡,2214,1751,3965
2022-05-06,일산선,대화,13924,12261,26185
2022-05-06,일산선,마두,7814,7801,15615
2022-05-06,일산선,백석,10547,9188,19735
2022-05-06,일산선,삼송,20498,19573,40071
2022-05-06,일산선,원당,11832,10904,22736
2022-05-06,일산선,원흥,11158,10313,21471
2022-05-06,일산선,정발산,9156,9739,18895
2022-05-06,일산선,주엽,9911,9827,19738
2022-05-06,일산선,화정,18346,18704,37050
2022-05-06,장항선,배방,1417,1364,2781
2022-05-06,장항선,봉명,1274,1134,2408
2022-05-06,장항선,신창,3086,2154,5240
2022-05-06,장항선,쌍용,2855,2506,5361
2022-05-06,장항선,아산,4197,4481,8678
2022-05-06,장항선,온양온천,4366,4671,9037
2022-05-06,장항선,탕정,928,769,1697
2022-05-06,중앙선,구리,14243,14721,28964
2022-05-06,중앙선,국수,811,789,1600
2022-05-06,중앙선,덕소,6034,6045,12079
2022-05-06,중앙선,도농,10723,9747,20470
2022-05-06,중앙선,도심,2473,1955,4428
2022-05-06,중앙선,망우,8528,8162,16690
2022-05-06,중앙선,상봉,6277,6230,12507
2022-05-06,중앙선,신원,304,239,543
2022-05-06,중앙선,아신,701,704,1405
2022-05-06,중앙선,양수,2481,2530,5011
2022-05-06,중앙선,양원,2909,2517,5426
2022-05-06,중앙선,양정,740,615,1355
2022-05-06,중앙선,양평,3250,3544,6794
2022-05-06,중앙선,오빈,379,382,761
2022-05-06,중앙선,용문,2223,2615,4838
2022-05-06,중앙선,운길산,1117,1060,2177
2022-05-06,중앙선,원덕,450,464,914
2022-05-06,중앙선,중랑,6015,5535,11550
2022-05-06,중앙선,지평,87,95,182
2022-05-06,중앙선,팔당,1242,1369,2611
2022-05-06,중앙선,회기,27481,25394,52875
2022-05-09,1호선,동대문,11542,10841,22383
2022-05-09,1호선,동묘앞,7920,8308,16228
2022-05-09,1호선,서울역,49727,44700,94427
2022-05-09,1호선,시청,23955,24233,48188
2022-05-09,1호선,신설동,14252,14175,28427
2022-05-09,1호선,제기동,17311,17976,35287
2022-05-09,1호선,종각,36885,36258,73143
2022-05-09,1호선,종로3가,26127,24010,50137
2022-05-09,1호선,종로5가,23599,23521,47120
2022-05-09,1호선,청량리,20747,20350,41097
2022-05-09,2호선,강남,85160,85124,170284
2022-05-09,2호선,강변,33477,30483,63960
2022-05-09,2호선,건대입구,35827,39409,75236
2022-05-09,2호선,교대,35546,40515,76061
2022-05-09,2호선,구로디지털단지,61683,62005,123688
2022-05-09,2호선,구의,24058,23817,47875
2022-05-09,2호선,낙성대,27916,28025,55941
2022-05-09,2호선,당산,19738,23004,42742
2022-05-09,2호선,대림,25176,25525,50701
2022-05-09,2호선,도림천,1498,1532,3030
2022-05-09,2호선,동대문역사문화공원,11942,13671,25613
2022-05-09,2호선,뚝섬,22253,24221,46474
2022-05-09,2호선,문래,22829,23279,46108
2022-05-09,2호선,방배,20190,21094,41284
2022-05-09,2호선,봉천,24586,22965,47551
2022-05-09,2호선,사당,38307,42562,80869
2022-05-09,2호선,삼성,51794,53268,105062
2022-05-09,2호선,상왕십리,14888,14374,29262
2022-05-09,2호선,서울대입구,49384,49541,98925
2022-05-09,2호선,서초,22029,21473,43502
2022-05-09,2호선,선릉,59743,53654,113397
2022-05-09,2호선,성수,37435,41072,78507
2022-05-09,2호선,시청,24587,24340,48927
2022-05-09,2호선,신답,1764,1970,3734
2022-05-09,2호선,신당,14176,14653,28829
2022-05-09,2호선,신대방,27867,27331,55198
2022-05-09,2호선,신도림,48909,48761,97670
2022-05-09,2호선,신림,65102,63476,128578
2022-05-09,2호선,신설동,3271,3424,6695
2022-05-09,2호선,신정네거리,11105,11330,22435
2022-05-09,2호선,신촌,33991,35547,69538
2022-05-09,2호선,아현,10902,10354,21256
2022-05-09,2호선,양천구청,7268,7547,14815
2022-05-09,2호선,역삼,54904,62911,117815
2022-05-09,2호선,영등포구청,23296,24592,47888
2022-05-09,2호선,왕십리,17388,14001,31389
2022-05-09,2호선,용답,3321,3450,6771
2022-05-09,2호선,용두,2451,2531,4982
2022-05-09,2호선,을지로3가,23526,23723,47249
2022-05-09,2호선,을지로4가,13199,13411,26610
2022-05-09,2호선,을지로입구,40436,42376,82812
2022-05-09,2호선,이대,14331,16111,30442
2022-05-09,2호선,잠실,69671,69438,139109
2022-05-09,2호선,잠실나루,15679,15480,31159
2022-05-09,2호선,잠실새내,21715,21576,43291
2022-05-09,2호선,종합운동장,7486,8574,16060
2022-05-09,2호선,충정로,10573,11086,21659
2022-05-09,2호선,한양대,14859,17077,31936
2022-05-09,2호선,합정,30578,32296,62874
2022-05-09,2호선,홍대입구,54109,57113,111222
2022-05-09,3호선,가락시장,9634,9257,18891
2022-05-09,3호선,경복궁,26711,27737,54448
2022-05-09,3호선,경찰병원,7667,7639,15306
2022-05-09,3호선,고속터미널,43935,39263,83198
2022-05-09,3호선,교대,15499,10247,25746
2022-05-09,3호선,구파발,22257,21273,43530
2022-05-09,3호선,금호,8274,7725,15999
2022-05-09,3호선,남부터미널,31200,31001,62201
2022-05-09,3호선,녹번,16751,15064,31815
2022-05-09,3호선,대청,10791,10182,20973
2022-05-09,3호선,대치,11376,11421,22797
2022-05-09,3호선,도곡,5744,5947,11691
2022-05-09,3호선,독립문,7436,7886,15322
2022-05-09,3호선,동대입구,9504,10419,19923
2022-05-09,3호선,매봉,13312,12718,26030
2022-05-09,3호선,무악재,4187,4257,8444
2022-05-09,3호선,불광,16951,18296,35247
2022-05-09,3호선,수서,17858,18253,36111
2022-05-09,3호선,신사,31146,32788,63934
2022-05-09,3호선,안국,22465,22864,45329
2022-05-09,3호선,압구정,32193,34596,66789
2022-05-09,3호선,약수,13656,13454,27110
2022-05-09,3호선,양재,40259,44660,84919
2022-05-09,3호선,연신내,37919,35972,73891
2022-05-09,3호선,오금,6747,6108,12855
2022-05-09,3호선,옥수,9325,9539,18864
2022-05-09,3호선,을지로3가,10900,11319,22219
2022-05-09,3호선,일원,11445,11052,22497
2022-05-09,3호선,잠원,5118,4920,10038
2022-05-09,3호선,종로3가,10213,11755,21968
2022-05-09,3호선,지축,5499,5087,10586
2022-05-09,3호선,충무로,1,0,1
2022-05-09,3호선,학여울,1888,1889,3777
2022-05-09,3호선,홍제,19037,18181,37218
2022-05-09,4호선,길음,22777,22923,45700
2022-05-09,4호선,남태령,1332,1141,2473
2022-05-09,4호선,노원,19873,22450,42323
2022-05-09,4호선,당고개,9559,8371,17930
2022-05-09,4호선,동대문,20836,21750,42586
2022-05-09,4호선,동대문역사문화공원,14535,13693,28228
2022-05-09,4호선,동작,1666,1864,3530
2022-05-09,4호선,명동,21216,21863,43079
2022-05-09,4호선,미아,16284,15802,32086
2022-05-09,4호선,미아사거리,28606,27877,56483
2022-05-09,4호선,사당,26695,22575,49270
2022-05-09,4호선,삼각지,5080,5634,10714
2022-05-09,4호선,상계,21022,18997,40019
2022-05-09,4호선,서울역,11927,17205,29132
2022-05-09,4호선,성신여대입구,21376,20797,42173
2022-05-09,4호선,수유,35242,35450,70692
2022-05-09,4호선,숙대입구,14568,14346,28914
2022-05-09,4호선,신용산,17930,18796,36726
2022-05-09,4호선,쌍문,30794,28401,59195
2022-05-09,4호선,이촌,8439,9378,17817
2022-05-09,4호선,창동,26387,27653,54040
2022-05-09,4호선,총신대입구,19701,21302,41003
2022-05-09,4호선,충무로,29356,30872,60228
2022-05-09,4호선,한성대입구,14996,14349,29345
2022-05-09,4호선,혜화,32004,32617,64621
2022-05-09,4호선,회현,23671,25374,49045
2022-05-09,5호선,강동,19475,18731,38206
2022-05-09,5호선,강일,4727,4342,9069
2022-05-09,5호선,개롱,6942,6999,13941
2022-05-09,5호선,개화산,6050,5736,11786
2022-05-09,5호선,거여,11000,10489,21489
2022-05-09,5호선,고덕,10413,10193,20606
2022-05-09,5호선,공덕,14977,15856,30833
2022-05-09,5호선,광나루,14546,13240,27786
2022-05-09,5호선,광화문,32064,33721,65785
2022-05-09,5호선,군자,11499,12671,24170
2022-05-09,5호선,굽은다리,10208,9633,19841
2022-05-09,5호선,길동,8296,8602,16898
2022-05-09,5호선,김포공항,7551,7242,14793
2022-05-09,5호선,까치산,30224,28768,58992
2022-05-09,5호선,답십리,16744,15258,32002
2022-05-09,5호선,동대문역사문화공원,3019,3629,6648
2022-05-09,5호선,둔촌동,8501,8516,17017
2022-05-09,5호선,마곡,11367,11450,22817
2022-05-09,5호선,마장,6002,5753,11755
2022-05-09,5호선,마천,7871,7333,15204
2022-05-09,5호선,마포,15162,15619,30781
2022-05-09,5호선,명일,9382,9610,18992
2022-05-09,5호선,목동,17573,18887,36460
2022-05-09,5호선,미사,16805,16855,33660
2022-05-09,5호선,발산,21295,22398,43693
2022-05-09,5호선,방이,7267,7576,14843
2022-05-09,5호선,방화,7101,6836,13937
2022-05-09,5호선,상일동,15980,14735,30715
2022-05-09,5호선,서대문,21007,21686,42693
2022-05-09,5호선,송정,6789,6444,13233
2022-05-09,5호선,신금호,6970,7203,14173
2022-05-09,5호선,신길,4291,4607,8898
2022-05-09,5호선,신정,14728,11976,26704
2022-05-09,5호선,아차산,15893,15167,31060
2022-05-09,5호선,애오개,6980,6979,13959
2022-05-09,5호선,양평,7830,7721,15551
2022-05-09,5호선,여의나루,14364,15441,29805
2022-05-09,5호선,여의도,29588,32222,61810
2022-05-09,5호선,영등포구청,4327,4487,8814
2022-05-09,5호선,영등포시장,10178,10530,20708
2022-05-09,5호선,오금,4130,4149,8279
2022-05-09,5호선,오목교,21830,23425,45255
2022-05-09,5호선,올림픽공원,4745,4066,8811
2022-05-09,5호선,왕십리,4614,5282,9896
2022-05-09,5호선,우장산,16015,15447,31462
2022-05-09,5호선,을지로4가,6461,6444,12905
2022-05-09,5호선,장한평,19207,19097,38304
2022-05-09,5호선,종로3가,12537,12517,25054
2022-05-09,5호선,천호,18187,18865,37052
2022-05-09,5호선,청구,4202,3863,8065
2022-05-09,5호선,충정로,4976,5040,10016
2022-05-09,5호선,하남검단산,6000,5703,11703
2022-05-09,5호선,하남시청,7739,7350,15089
2022-05-09,5호선,하남풍산,4633,4476,9109
2022-05-09,5호선,행당,8534,7563,16097
2022-05-09,5호선,화곡,30255,28159,58414
2022-05-09,6호선,고려대,9148,8933,18081
2022-05-09,6호선,공덕,19576,19242,38818
2022-05-09,6호선,광흥창,9731,9266,18997
2022-05-09,6호선,구산,8150,5916,14066
2022-05-09,6호선,녹사평,4759,4747,9506
2022-05-09,6호선,대흥,9064,9454,18518
2022-05-09,6호선,독바위,2940,3031,5971
2022-05-09,6호선,돌곶이,9980,9320,19300
2022-05-09,6호선,동묘앞,7952,8336,16288
2022-05-09,6호선,디지털미디어시티,15201,16485,31686
2022-05-09,6호선,마포구청,14605,13110,27715
2022-05-09,6호선,망원,13714,14525,28239
2022-05-09,6호선,버티고개,2352,2197,4549
2022-05-09,6호선,보문,7795,7203,14998
2022-05-09,6호선,봉화산,9523,8844,18367
2022-05-09,6호선,불광,4326,4326,8652
2022-05-09,6호선,삼각지,6738,5866,12604
2022-05-09,6호선,상수,8624,9948,18572
2022-05-09,6호선,상월곡,6910,6411,13321
2022-05-09,6호선,새절,14021,12978,26999
2022-05-09,6호선,석계,13093,14092,27185
2022-05-09,6호선,신내,2,0,2
2022-05-09,6호선,신당,8014,8515,16529
2022-05-09,6호선,안암,14572,15454,30026
2022-05-09,6호선,약수,3912,3886,7798
2022-05-09,6호선,역촌,3846,4535,8381
2022-05-09,6호선,월곡,13488,13128,26616
2022-05-09,6호선,월드컵경기장,4774,5053,9827
2022-05-09,6호선,응암,18497,18180,36677
2022-05-09,6호선,이태원,9852,10313,20165
2022-05-09,6호선,증산,10686,10648,21334
2022-05-09,6호선,창신,3921,3314,7235
2022-05-09,6호선,청구,3784,3989,7773
2022-05-09,6호선,태릉입구,6041,6722,12763
2022-05-09,6호선,한강진,6996,8270,15266
2022-05-09,6호선,합정,12833,12999,25832
2022-05-09,6호선,화랑대,13285,10395,23680
2022-05-09,6호선,효창공원앞,7727,7035,14762
2022-05-09,7호선,가산디지털단지,47705,48044,95749
2022-05-09,7호선,강남구청,16392,18354,34746
2022-05-09,7호선,건대입구,13423,14334,27757
2022-05-09,7호선,고속터미널,18523,14135,32658
2022-05-09,7호선,공릉,13554,13704,27258
2022-05-09,7호선,광명사거리,22869,22424,45293
2022-05-09,7호선,군자,15331,12452,27783
2022-05-09,7호선,남구로,16812,17649,34461
2022-05-09,7호선,남성,12051,11202,23253
2022-05-09,7호선,내방,15557,16003,31560
2022-05-09,7호선,노원,20070,21509,41579
2022-05-09,7호선,논현,21724,23505,45229
2022-05-09,7호선,대림,8230,8140,16370
2022-05-09,7호선,도봉산,10457,11503,21960
2022-05-09,7호선,뚝섬유원지,11366,10873,22239
2022-05-09,7호선,마들,13578,12610,26188
2022-05-09,7호선,먹골,10576,10303,20879
2022-05-09,7호선,면목,17191,16631,33822
2022-05-09,7호선,반포,6012,5962,11974
2022-05-09,7호선,보라매,10870,10957,21827
2022-05-09,7호선,사가정,17129,17022,34151
2022-05-09,7호선,상도,12036,12006,24042
2022-05-09,7호선,상봉,17400,16324,33724
2022-05-09,7호선,수락산,13232,12878,26110
2022-05-09,7호선,숭실대입구,15818,16318,32136
2022-05-09,7호선,신대방삼거리,17651,17084,34735
2022-05-09,7호선,신풍,12370,11785,24155
2022-05-09,7호선,어린이대공원,16232,17302,33534
2022-05-09,7호선,온수,11653,10944,22597
2022-05-09,7호선,용마산,6429,6142,12571
2022-05-09,7호선,이수,16173,15748,31921
2022-05-09,7호선,장승배기,9477,9289,18766
2022-05-09,7호선,장암,2522,862,3384
2022-05-09,7호선,중계,16002,14805,30807
2022-05-09,7호선,중곡,11642,10801,22443
2022-05-09,7호선,중화,11304,10926,22230
2022-05-09,7호선,천왕,12189,11602,23791
2022-05-09,7호선,철산,22226,22526,44752
2022-05-09,7호선,청담,20763,23261,44024
2022-05-09,7호선,태릉입구,9529,9465,18994
2022-05-09,7호선,하계,19096,17528,36624
2022-05-09,7호선,학동,25197,27159,52356
2022-05-09,8호선,가락시장,7787,8753,16540
2022-05-09,8호선,강동구청,10997,11350,22347
2022-05-09,8호선,남위례,5460,5672,11132
2022-05-09,8호선,남한산성입구,16471,15368,31839
2022-05-09,8호선,단대오거리,12330,11505,23835
2022-05-09,8호선,모란,6422,5134,11556
2022-05-09,8호선,몽촌토성,6369,6441,12810
2022-05-09,8호선,문정,22815,24413,47228
2022-05-09,8호선,복정,10335,8705,19040
2022-05-09,8호선,산성,5856,5944,11800
2022-05-09,8호선,석촌,7756,9033,16789
2022-05-09,8호선,송파,8970,8596,17566
2022-05-09,8호선,수진,5795,5325,11120
2022-05-09,8호선,신흥,4469,4774,9243
2022-05-09,8호선,암사,19996,17446,37442
2022-05-09,8호선,잠실,13402,16420,29822
2022-05-09,8호선,장지,17517,17042,34559
2022-05-09,8호선,천호,14840,17055,31895
2022-05-09,9호선,가양,22146,21490,43636
2022-05-09,9호선,개화,2887,1934,4821
2022-05-09,9호선,고속터미널,13766,16295,30061
2022-05-09,9호선,공항시장,3140,3324,6464
2022-05-09,9호선,구반포,1355,1436,2791
2022-05-09,9호선,국회의사당,17288,18425,35713
2022-05-09,9호선,김포공항,7501,10859,18360
2022-05-09,9호선,노들,4718,4029,8747
2022-05-09,9호선,노량진,27321,27034,54355
2022-05-09,9호선,당산,18950,19371,38321
2022-05-09,9호선,동작,2095,1689,3784
2022-05-09,9호선,등촌,12065,11619,23684
2022-05-09,9호선,마곡나루,13149,13151,26300
2022-05-09,9호선,사평,3772,3601,7373
2022-05-09,9호선,샛강,6455,6778,13233
2022-05-09,9호선,선유도,9317,8974,18291
2022-05-09,9호선,신논현,32838,32616,65454
2022-05-09,9호선,신목동,4655,4192,8847
2022-05-09,9호선,신반포,4110,3786,7896
2022-05-09,9호선,신방화,7424,7183,14607
2022-05-09,9호선,양천향교,10471,10756,21227
2022-05-09,9호선,여의도,28795,29254,58049
2022-05-09,9호선,염창,18418,17746,36164
2022-05-09,9호선,증미,7754,7647,15401
2022-05-09,9호선,흑석,9862,10103,19965
2022-05-09,9호선2~3단계,둔촌오륜,1248,1142,2390
2022-05-09,9호선2~3단계,봉은사,16444,16888,33332
2022-05-09,9호선2~3단계,삼성중앙,7528,8028,15556
2022-05-09,9호선2~3단계,삼전,7215,6859,14074
2022-05-09,9호선2~3단계,석촌,8958,7912,16870
2022-05-09,9호선2~3단계,석촌고분,6203,6066,12269
2022-05-09,9호선2~3단계,선정릉,10430,11556,21986
2022-05-09,9호선2~3단계,송파나루,5078,5377,10455
2022-05-09,9호선2~3단계,언주,10874,11466,22340
2022-05-09,9호선2~3단계,올림픽공원,6336,6395,12731
2022-05-09,9호선2~3단계,종합운동장,4387,4498,8885
2022-05-09,9호선2~3단계,중앙보훈병원,11679,10241,21920
2022-05-09,9호선2~3단계,한성백제,2795,2590,5385
2022-05-09,경강선,경기광주,8583,8074,16657
2022-05-09,경강선,곤지암,2463,2562,5025
2022-05-09,경강선,부발,2234,2337,4571
2022-05-09,경강선,삼동,2661,2400,5061
2022-05-09,경강선,세종대왕릉,330,312,642
2022-05-09,경강선,신둔도예촌,1802,1617,3419
2022-05-09,경강선,여주,2791,2771,5562
2022-05-09,경강선,이매,1214,1059,2273
2022-05-09,경강선,이천,2808,2879,5687
2022-05-09,경강선,초월,3548,3319,6867
2022-05-09,경강선,판교,5211,5124,10335
2022-05-09,경부선,가산디지털단지,19980,23063,43043
2022-05-09,경부선,관악,7988,7337,15325
2022-05-09,경부선,광명,3972,3094,7066
2022-05-09,경부선,구로,19749,19981,39730
2022-05-09,경부선,군포,8251,8132,16383
2022-05-09,경부선,금정,28701,29033,57734
2022-05-09,경부선,금천구청,12726,12529,25255
2022-05-09,경부선,남영,9918,10781,20699
2022-05-09,경부선,노량진,8620,8869,17489
2022-05-09,경부선,당정,7603,7206,14809
2022-05-09,경부선,대방,14055,14675,28730
2022-05-09,경부선,독산,20066,20825,40891
2022-05-09,경부선,두정,8041,9583,17624
2022-05-09,경부선,명학,11033,10823,21856
2022-05-09,경부선,병점,17730,17737,35467
2022-05-09,경부선,서동탄,1569,1326,2895
2022-05-09,경부선,서울역,9424,2152,11576
2022-05-09,경부선,서정리,8139,7858,15997
2022-05-09,경부선,석수,10324,9303,19627
2022-05-09,경부선,성균관대,16461,16885,33346
2022-05-09,경부선,성환,7360,7422,14782
2022-05-09,경부선,세류,3362,2953,6315
2022-05-09,경부선,세마,3155,2983,6138
2022-05-09,경부선,송탄,4807,4592,9399
2022-05-09,경부선,수원,39377,41063,80440
2022-05-09,경부선,신길,9962,8557,18519
2022-05-09,경부선,신도림,4341,4518,8859
2022-05-09,경부선,안양,28689,28153,56842
2022-05-09,경부선,영등포,37918,39369,77287
2022-05-09,경부선,오산,11467,11267,22734
2022-05-09,경부선,오산대,4341,4033,8374
2022-05-09,경부선,용산,38416,36716,75132
2022-05-09,경부선,의왕,10317,10221,20538
2022-05-09,경부선,직산,933,900,1833
2022-05-09,경부선,진위,1957,1678,3635
2022-05-09,경부선,천안,7437,7309,14746
2022-05-09,경부선,평택,14431,14715,29146
2022-05-09,경부선,평택지제,3946,3875,7821
2022-05-09,경부선,화서,9110,8709,17819
2022-05-09,경원선,가능,7397,7070,14467
2022-05-09,경원선,광운대,9825,9892,19717
2022-05-09,경원선,녹양,5065,4654,9719
2022-05-09,경원선,녹천,5176,4219,9395
2022-05-09,경원선,덕계,3817,3384,7201
2022-05-09,경원선,덕정,6925,6716,13641
2022-05-09,경원선,도봉,6304,5952,12256
2022-05-09,경원선,도봉산,8189,5653,13842
2022-05-09,경원선,동두천,2934,3172,6106
2022-05-09,경원선,동두천중앙,3541,3289,6830
2022-05-09,경원선,망월사,10202,10381,20583
2022-05-09,경원선,방학,10614,10370,20984
2022-05-09,경원선,보산,1725,1492,3217
2022-05-09,경원선,서빙고,2077,1881,3958
2022-05-09,경원선,석계,8826,9936,18762
2022-05-09,경원선,소요산,2962,2435,5397
2022-05-09,경원선,신이문,8941,8132,17073
2022-05-09,경원선,양주,8718,8093,16811
2022-05-09,경원선,옥수,59,57,116
2022-05-09,경원선,왕십리,15345,17001,32346
2022-05-09,경원선,외대앞,8869,9356,18225
2022-05-09,경원선,월계,8704,8161,16865
2022-05-09,경원선,응봉,2066,1760,3826
2022-05-09,경원선,의정부,19273,19936,39209
2022-05-09,경원선,이촌,4189,3139,7328
2022-05-09,경원선,지행,7423,7308,14731
2022-05-09,경원선,청량리,16362,17067,33429
2022-05-09,경원선,한남,4279,4149,8428
2022-05-09,경원선,회룡,13680,13431,27111
2022-05-09,경의선,가좌,6152,5857,12009
2022-05-09,경의선,강매,3655,3124,6779
2022-05-09,경의선,계양,1,0,1
2022-05-09,경의선,곡산,719,775,1494
2022-05-09,경의선,공덕,3868,3476,7344
2022-05-09,경의선,금릉,5526,5226,10752
2022-05-09,경의선,금촌,6896,6877,13773
2022-05-09,경의선,능곡,4310,3835,8145
2022-05-09,경의선,디지털미디어시티,2965,2643,5608
2022-05-09,경의선,문산,5986,5964,11950
2022-05-09,경의선,백마,7919,7480,15399
2022-05-09,경의선,서강대,2347,2465,4812
2022-05-09,경의선,서울역,5085,6493,11578
2022-05-09,경의선,수색,3121,3341,6462
2022-05-09,경의선,신촌,981,1339,2320
2022-05-09,경의선,야당,8456,8305,16761
2022-05-09,경의선,운정,7815,7070,14885
2022-05-09,경의선,월롱,3064,3187,6251
2022-05-09,경의선,일산,10664,10244,20908
2022-05-09,경의선,임진강,13,23,36
2022-05-09,경의선,탄현,8906,8197,17103
2022-05-09,경의선,파주,1802,1380,3182
2022-05-09,경의선,풍산,6165,5611,11776
2022-05-09,경의선,행신,8956,8856,17812
2022-05-09,경의선,홍대입구,1766,2039,3805
2022-05-09,경의선,화전,3933,3804,7737
2022-05-09,경의선,효창공원앞,3326,3668,6994
2022-05-09,경인선,간석,6451,6011,12462
2022-05-09,경인선,개봉,22958,22464,45422
2022-05-09,경인선,구일,7981,7763,15744
2022-05-09,경인선,도원,3654,3543,7197
2022-05-09,경인선,도화,4582,4202,8784
2022-05-09,경인선,동암,15529,15471,31000
2022-05-09,경인선,동인천,14355,13648,28003
2022-05-09,경인선,백운,7589,7348,14937
2022-05-09,경인선,부개,9364,8490,17854
2022-05-09,경인선,부천,34739,34643,69382
2022-05-09,경인선,부평,29911,32015,61926
2022-05-09,경인선,소사,9907,9475,19382
2022-05-09,경인선,송내,29736,29472,59208
2022-05-09,경인선,역곡,30979,30351,61330
2022-05-09,경인선,오류동,12585,11822,24407
2022-05-09,경인선,온수,7719,7355,15074
2022-05-09,경인선,인천,3641,2857,6498
2022-05-09,경인선,제물포,12200,11618,23818
2022-05-09,경인선,주안,21184,19217,40401
2022-05-09,경인선,중동,10407,9541,19948
2022-05-09,경춘선,가평,1835,1776,3611
2022-05-09,경춘선,갈매,3342,2834,6176
2022-05-09,경춘선,강촌,482,506,988
2022-05-09,경춘선,굴봉산,201,183,384
2022-05-09,경춘선,금곡,1719,1618,3337
2022-05-09,경춘선,김유정,444,434,878
2022-05-09,경춘선,남춘천,2688,3135,5823
2022-05-09,경춘선,대성리,692,482,1174
2022-05-09,경춘선,마석,4573,4450,9023
2022-05-09,경춘선,백양리,93,98,191
2022-05-09,경춘선,별내,3628,3235,6863
2022-05-09,경춘선,사릉,2892,2671,5563
2022-05-09,경춘선,상천,347,323,670
2022-05-09,경춘선,신내,2503,2279,4782
2022-05-09,경춘선,천마산,1853,1663,3516
2022-05-09,경춘선,청평,1821,1739,3560
2022-05-09,경춘선,춘천,1742,1819,3561
2022-05-09,경춘선,퇴계원,3996,3520,7516
2022-05-09,경춘선,평내호평,7192,6763,13955
2022-05-09,공항철도,검암,7213,7032,14245
2022-05-09,공항철도,계양,11785,10727,22512
2022-05-09,공항철도,공덕,2427,3199,5626
2022-05-09,공항철도,공항화물청사,2370,2576,4946
2022-05-09,공항철도,김포공항,12739,6899,19638
2022-05-09,공항철도,디지털미디어시티,15259,14479,29738
2022-05-09,공항철도,마곡나루,10371,10005,20376
2022-05-09,공항철도,서울역,9469,8195,17664
2022-05-09,공항철도,영종,3609,3385,6994
2022-05-09,공항철도,운서,7343,7611,14954
2022-05-09,공항철도,인천공항1터미널,5237,5065,10302
2022-05-09,공항철도,인천공항2터미널,3372,3058,6430
2022-05-09,공항철도,청라국제도시,7725,7189,14914
2022-05-09,공항철도,홍대입구,9586,9863,19449
2022-05-09,과천선,경마공원,1040,957,1997
2022-05-09,과천선,과천,6636,6086,12722
2022-05-09,과천선,대공원,3835,3946,7781
2022-05-09,과천선,범계,27557,27561,55118
2022-05-09,과천선,선바위,8926,7799,16725
2022-05-09,과천선,인덕원,26304,26872,53176
2022-05-09,과천선,정부과천청사,11552,11369,22921
2022-05-09,과천선,평촌,19267,18796,38063
2022-05-09,분당선,가천대,10453,11879,22332
2022-05-09,분당선,강남구청,10605,11959,22564
2022-05-09,분당선,개포동,4275,4324,8599
2022-05-09,분당선,구룡,2603,2568,5171
2022-05-09,분당선,구성,5716,5805,11521
2022-05-09,분당선,기흥,11333,10660,21993
2022-05-09,분당선,대모산입구,5053,4622,9675
2022-05-09,분당선,도곡,7640,7506,15146
2022-05-09,분당선,망포,15483,14783,30266
2022-05-09,분당선,매교,3503,3369,6872
2022-05-09,분당선,매탄권선,5504,5360,10864
2022-05-09,분당선,모란,26989,27898,54887
2022-05-09,분당선,미금,16566,17537,34103
2022-05-09,분당선,보정,2854,2508,5362
2022-05-09,분당선,상갈,5949,5665,11614
2022-05-09,분당선,서울숲,11889,12233,24122
2022-05-09,분당선,서현,25351,25942,51293
2022-05-09,분당선,선릉,14194,22064,36258
2022-05-09,분당선,선정릉,8704,9289,17993
2022-05-09,분당선,수내,14022,13927,27949
2022-05-09,분당선,수서,15326,14928,30254
2022-05-09,분당선,수원,8751,7250,16001
2022-05-09,분당선,수원시청,13265,14118,27383
2022-05-09,분당선,신갈,4906,4936,9842
2022-05-09,분당선,압구정로데오,17712,19621,37333
2022-05-09,분당선,야탑,27706,28738,56444
2022-05-09,분당선,영통,8548,9042,17590
2022-05-09,분당선,오리,12650,10246,22896
2022-05-09,분당선,이매,6382,5770,12152
2022-05-09,분당선,정자,18323,19411,37734
2022-05-09,분당선,죽전,14808,16650,31458
2022-05-09,분당선,청명,4653,4484,9137
2022-05-09,분당선,태평,14151,13609,27760
2022-05-09,분당선,한티,14441,15581,30022
2022-05-09,수인선,고색,5348,5088,10436
2022-05-09,수인선,남동인더스파크,2325,2676,5001
2022-05-09,수인선,달월,139,92,231
2022-05-09,수인선,사리,5533,4836,10369
2022-05-09,수인선,소래포구,5870,5373,11243
2022-05-09,수인선,송도,2766,2549,5315
2022-05-09,수인선,숭의,4406,4100,8506
2022-05-09,수인선,신포,2060,2019,4079
2022-05-09,수인선,야목,448,298,746
2022-05-09,수인선,어천,773,886,1659
2022-05-09,수인선,연수,4846,4686,9532
2022-05-09,수인선,오목천,4367,3885,8252
2022-05-09,수인선,원인재,4730,5066,9796
2022-05-09,수인선,월곶,2883,2698,5581
2022-05-09,수인선,인천,1111,1714,2825
2022-05-09,수인선,인천논현,5972,6368,12340
2022-05-09,수인선,인하대,7835,7773,15608
2022-05-09,수인선,호구포,4349,4544,8893
2022-05-09,안산선,고잔,9921,9271,19192
2022-05-09,안산선,대야미,5554,4996,10550
2022-05-09,안산선,반월,4804,4572,9376
2022-05-09,안산선,산본,16893,18168,35061
2022-05-09,안산선,상록수,17508,17562,35070
2022-05-09,안산선,수리산,4648,3870,8518
2022-05-09,안산선,신길온천,2094,1808,3902
2022-05-09,안산선,안산,12600,11218,23818
2022-05-09,안산선,오이도,9472,8832,18304
2022-05-09,안산선,정왕,10698,11656,22354
2022-05-09,안산선,중앙,19672,20330,40002
2022-05-09,안산선,초지,5690,6002,11692
2022-05-09,안산선,한대앞,11005,11296,22301
2022-05-09,우이신설선,4.19민주묘지,3994,3988,7982
2022-05-09,우이신설선,가오리,4478,4395,8873
2022-05-09,우이신설선,보문,1597,1583,3180
2022-05-09,우이신설선,북한산보국문,6412,6183,12595
2022-05-09,우이신설선,북한산우이,2925,2650,5575
2022-05-09,우이신설선,삼양,2143,2224,4367
2022-05-09,우이신설선,삼양사거리,2661,2653,5314
2022-05-09,우이신설선,성신여대입구,3444,3871,7315
2022-05-09,우이신설선,솔밭공원,2667,2589,5256
2022-05-09,우이신설선,솔샘,6309,5963,12272
2022-05-09,우이신설선,신설동,2247,2178,4425
2022-05-09,우이신설선,정릉,5052,4570,9622
2022-05-09,우이신설선,화계,3660,3390,7050
2022-05-09,일산선,대곡,2534,1985,4519
2022-05-09,일산선,대화,13907,10727,24634
2022-05-09,일산선,마두,8020,8121,16141
2022-05-09,일산선,백석,10365,10300,20665
2022-05-09,일산선,삼송,21209,20512,41721
2022-05-09,일산선,원당,12454,11407,23861
2022-05-09,일산선,원흥,11780,11318,23098
2022-05-09,일산선,정발산,7767,7907,15674
2022-05-09,일산선,주엽,9897,9783,19680
2022-05-09,일산선,지축,1,0,1
2022-05-09,일산선,화정,17956,18229,36185
2022-05-09,장항선,배방,1246,1187,2433
2022-05-09,장항선,봉명,1464,1443,2907
2022-05-09,장항선,신창,2897,3785,6682
2022-05-09,장항선,쌍용,3340,3381,6721
2022-05-09,장항선,아산,4905,3717,8622
2022-05-09,장항선,온양온천,5116,5205,10321
2022-05-09,장항선,탕정,992,896,1888
2022-05-09,중앙선,구리,14459,14540,28999
2022-05-09,중앙선,국수,921,875,1796
2022-05-09,중앙선,덕소,6134,5998,12132
2022-05-09,중앙선,도농,12105,10681,22786
2022-05-09,중앙선,도심,2748,2101,4849
2022-05-09,중앙선,망우,8086,7994,16080
2022-05-09,중앙선,상봉,6192,6174,12366
2022-05-09,중앙선,신원,247,208,455
2022-05-09,중앙선,아신,630,591,1221
2022-05-09,중앙선,양수,2155,2143,4298
2022-05-09,중앙선,양원,3252,3149,6401
2022-05-09,중앙선,양정,824,678,1502
2022-05-09,중앙선,양평,3117,3055,6172
2022-05-09,중앙선,오빈,341,320,661
2022-05-09,중앙선,용문,1994,1957,3951
2022-05-09,중앙선,운길산,984,895,1879
2022-05-09,중앙선,원덕,458,437,895
2022-05-09,중앙선,중랑,6046,5725,11771
2022-05-09,중앙선,지평,80,96,176
2022-05-09,중앙선,팔당,1007,1011,2018
2022-05-09,중앙선,회기,26959,27217,54176
2022-05-10,1호선,동대문,11612,10904,22516
2022-05-10,1호선,동묘앞,8216,8821,17037
2022-05-10,1호선,서울역,48574,46887,95461
2022-05-10,1호선,시청,25177,25080,50257
2022-05-10,1호선,신설동,14518,14025,28543
2022-05-10,1호선,제기동,17805,18010,35815
2022-05-10,1호선,종각,38366,37819,76185
2022-05-10,1호선,종로3가,26942,24331,51273
2022-05-10,1호선,종로5가,23572,23441,47013
2022-05-10,1호선,청량리,21761,20939,42700
2022-05-10,2호선,강남,88221,88430,176651
2022-05-10,2호선,강변,31641,29024,60665
2022-05-10,2호선,건대입구,37162,40327,77489
2022-05-10,2호선,교대,37045,41960,79005
2022-05-10,2호선,구로디지털단지,63675,63944,127619
2022-05-10,2호선,구의,24892,24251,49143
2022-05-10,2호선,낙성대,29285,28776,58061
2022-05-10,2호선,당산,20514,24043,44557
2022-05-10,2호선,대림,25560,25710,51270
2022-05-10,2호선,도림천,1421,1599,3020
2022-05-10,2호선,동대문역사문화공원,12668,14225,26893
2022-05-10,2호선,뚝섬,23713,25824,49537
2022-05-10,2호선,문래,23814,23981,47795
2022-05-10,2호선,방배,21446,22152,43598
2022-05-10,2호선,봉천,25380,23250,48630
2022-05-10,2호선,사당,40351,44976,85327
2022-05-10,2호선,삼성,53744,55377,109121
2022-05-10,2호선,상왕십리,15171,14656,29827
2022-05-10,2호선,서울대입구,51010,50235,101245
2022-05-10,2호선,서초,23609,23024,46633
2022-05-10,2호선,선릉,62600,55994,118594
2022-05-10,2호선,성수,39462,43152,82614
2022-05-10,2호선,시청,25508,25471,50979
2022-05-10,2호선,신답,1809,1996,3805
2022-05-10,2호선,신당,14566,15184,29750
2022-05-10,2호선,신대방,28549,27639,56188
2022-05-10,2호선,신도림,50074,49826,99900
2022-05-10,2호선,신림,66885,64838,131723
2022-05-10,2호선,신설동,3271,3301,6572
2022-05-10,2호선,신정네거리,11249,11523,22772
2022-05-10,2호선,신촌,35990,36984,72974
2022-05-10,2호선,아현,11581,10992,22573
2022-05-10,2호선,양천구청,7445,7649,15094
2022-05-10,2호선,역삼,56980,65088,122068
2022-05-10,2호선,영등포구청,24019,24945,48964
2022-05-10,2호선,왕십리,18113,14707,32820
2022-05-10,2호선,용답,3268,3417,6685
2022-05-10,2호선,용두,2455,2442,4897
2022-05-10,2호선,을지로3가,24458,24337,48795
2022-05-10,2호선,을지로4가,13830,14017,27847
2022-05-10,2호선,을지로입구,42150,44158,86308
2022-05-10,2호선,이대,15292,16275,31567
2022-05-10,2호선,잠실,70874,70460,141334
2022-05-10,2호선,잠실나루,16306,15939,32245
2022-05-10,2호선,잠실새내,22635,22603,45238
2022-05-10,2호선,종합운동장,13337,15218,28555
2022-05-10,2호선,충정로,10849,11540,22389
2022-05-10,2호선,한양대,15922,17861,33783
2022-05-10,2호선,합정,32029,34261,66290
2022-05-10,2호선,홍대입구,56509,59369,115878
2022-05-10,3호선,가락시장,9681,9409,19090
2022-05-10,3호선,경복궁,29761,31027,60788
2022-05-10,3호선,경찰병원,7825,7745,15570
2022-05-10,3호선,고속터미널,41378,38980,80358
2022-05-10,3호선,교대,16155,10517,26672
2022-05-10,3호선,구파발,23262,22238,45500
2022-05-10,3호선,금호,8460,7821,16281
2022-05-10,3호선,남부터미널,31171,31554,62725
2022-05-10,3호선,녹번,16969,15316,32285
2022-05-10,3호선,대청,11272,10465,21737
2022-05-10,3호선,대치,11729,11759,23488
2022-05-10,3호선,도곡,5799,6031,11830
2022-05-10,3호선,독립문,7927,8304,16231
2022-05-10,3호선,동대입구,10028,10823,20851
2022-05-10,3호선,매봉,13506,13135,26641
2022-05-10,3호선,무악재,4298,4394,8692
2022-05-10,3호선,불광,17417,18546,35963
2022-05-10,3호선,수서,18171,18680,36851
2022-05-10,3호선,신사,32290,33924,66214
2022-05-10,3호선,안국,24778,25345,50123
2022-05-10,3호선,압구정,33554,36129,69683
2022-05-10,3호선,약수,14063,13805,27868
2022-05-10,3호선,양재,41927,45886,87813
2022-05-10,3호선,연신내,38706,36655,75361
2022-05-10,3호선,오금,6812,6182,12994
2022-05-10,3호선,옥수,9614,9810,19424
2022-05-10,3호선,을지로3가,11334,11711,23045
2022-05-10,3호선,일원,11866,11478,23344
2022-05-10,3호선,잠원,5371,5152,10523
2022-05-10,3호선,종로3가,10480,12243,22723
2022-05-10,3호선,지축,5602,5223,10825
2022-05-10,3호선,충무로,2,0,2
2022-05-10,3호선,학여울,1974,1962,3936
2022-05-10,3호선,홍제,19560,18553,38113
2022-05-10,4호선,길음,24122,23757,47879
2022-05-10,4호선,남태령,1354,1214,2568
2022-05-10,4호선,노원,20105,22689,42794
2022-05-10,4호선,당고개,9674,8586,18260
2022-05-10,4호선,동대문,20918,21778,42696
2022-05-10,4호선,동대문역사문화공원,15258,13928,29186
2022-05-10,4호선,동작,1785,1988,3773
2022-05-10,4호선,명동,21648,22506,44154
2022-05-10,4호선,미아,16377,15826,32203
2022-05-10,4호선,미아사거리,29134,28005,57139
2022-05-10,4호선,사당,28265,23747,52012
2022-05-10,4호선,삼각지,5856,6442,12298
2022-05-10,4호선,상계,20997,19352,40349
2022-05-10,4호선,서울역,12657,18416,31073
2022-05-10,4호선,성신여대입구,22261,21452,43713
2022-05-10,4호선,수유,35983,35777,71760
2022-05-10,4호선,숙대입구,15798,15217,31015
2022-05-10,4호선,신용산,18302,19631,37933
2022-05-10,4호선,쌍문,31282,28873,60155
2022-05-10,4호선,이촌,9438,10593,20031
2022-05-10,4호선,창동,27095,28618,55713
2022-05-10,4호선,총신대입구,20315,22178,42493
2022-05-10,4호선,충무로,30164,31662,61826
2022-05-10,4호선,한성대입구,16385,15904,32289
2022-05-10,4호선,혜화,35737,36083,71820
2022-05-10,4호선,회현,27439,28817,56256
2022-05-10,5호선,강동,19751,19125,38876
2022-05-10,5호선,강일,4798,4481,9279
2022-05-10,5호선,개롱,6888,7176,14064
2022-05-10,5호선,개화산,6046,5744,11790
2022-05-10,5호선,거여,11219,10605,21824
2022-05-10,5호선,고덕,10610,10399,21009
2022-05-10,5호선,공덕,16111,16664,32775
2022-05-10,5호선,광나루,14781,13320,28101
2022-05-10,5호선,광화문,34260,36171,70431
2022-05-10,5호선,군자,11894,13232,25126
2022-05-10,5호선,굽은다리,10181,9654,19835
2022-05-10,5호선,길동,8543,8708,17251
2022-05-10,5호선,김포공항,7232,7128,14360
2022-05-10,5호선,까치산,30797,29255,60052
2022-05-10,5호선,답십리,17278,15540,32818
2022-05-10,5호선,동대문역사문화공원,3064,3553,6617
2022-05-10,5호선,둔촌동,8674,8714,17388
2022-05-10,5호선,마곡,11717,11816,23533
2022-05-10,5호선,마장,6365,5935,12300
2022-05-10,5호선,마천,8024,7513,15537
2022-05-10,5호선,마포,16337,16473,32810
2022-05-10,5호선,명일,9554,9789,19343
2022-05-10,5호선,목동,18205,19337,37542
2022-05-10,5호선,미사,17242,17120,34362
2022-05-10,5호선,발산,22304,22931,45235
2022-05-10,5호선,방이,7539,7729,15268
2022-05-10,5호선,방화,7099,6803,13902
2022-05-10,5호선,상일동,16205,15040,31245
2022-05-10,5호선,서대문,22157,22321,44478
2022-05-10,5호선,송정,6997,6578,13575
2022-05-10,5호선,신금호,7158,7362,14520
2022-05-10,5호선,신길,4607,4715,9322
2022-05-10,5호선,신정,14962,11987,26949
2022-05-10,5호선,아차산,15879,15229,31108
2022-05-10,5호선,애오개,7449,7421,14870
2022-05-10,5호선,양평,8136,7923,16059
2022-05-10,5호선,여의나루,16075,17859,33934
2022-05-10,5호선,여의도,33715,37094,70809
2022-05-10,5호선,영등포구청,4338,4477,8815
2022-05-10,5호선,영등포시장,11054,11068,22122
2022-05-10,5호선,오금,4028,4150,8178
2022-05-10,5호선,오목교,22703,24587,47290
2022-05-10,5호선,올림픽공원,4896,4267,9163
2022-05-10,5호선,왕십리,4867,5636,10503
2022-05-10,5호선,우장산,16154,15581,31735
2022-05-10,5호선,을지로4가,6673,6727,13400
2022-05-10,5호선,장한평,19176,19095,38271
2022-05-10,5호선,종로3가,13156,13077,26233
2022-05-10,5호선,천호,18500,18843,37343
2022-05-10,5호선,청구,4425,3883,8308
2022-05-10,5호선,충정로,5218,5384,10602
2022-05-10,5호선,하남검단산,6187,5839,12026
2022-05-10,5호선,하남시청,7425,7221,14646
2022-05-10,5호선,하남풍산,4760,4629,9389
2022-05-10,5호선,행당,8770,7685,16455
2022-05-10,5호선,화곡,30375,28291,58666
2022-05-10,6호선,고려대,9782,9625,19407
2022-05-10,6호선,공덕,20562,20086,40648
2022-05-10,6호선,광흥창,10295,9464,19759
2022-05-10,6호선,구산,8452,6114,14566
2022-05-10,6호선,녹사평,5023,5010,10033
2022-05-10,6호선,대흥,9531,9786,19317
2022-05-10,6호선,독바위,2925,3039,5964
2022-05-10,6호선,돌곶이,10036,9257,19293
2022-05-10,6호선,동묘앞,8193,8293,16486
2022-05-10,6호선,디지털미디어시티,15314,16839,32153
2022-05-10,6호선,마포구청,15444,13835,29279
2022-05-10,6호선,망원,14187,15038,29225
2022-05-10,6호선,버티고개,2478,2370,4848
2022-05-10,6호선,보문,7957,7396,15353
2022-05-10,6호선,봉화산,9700,9019,18719
2022-05-10,6호선,불광,4505,4424,8929
2022-05-10,6호선,삼각지,8093,6879,14972
2022-05-10,6호선,상수,9455,10830,20285
2022-05-10,6호선,상월곡,7056,6606,13662
2022-05-10,6호선,새절,14414,13233,27647
2022-05-10,6호선,석계,13585,14126,27711
2022-05-10,6호선,신당,8722,9229,17951
2022-05-10,6호선,안암,15075,15379,30454
2022-05-10,6호선,약수,3839,3889,7728
2022-05-10,6호선,역촌,3959,4626,8585
2022-05-10,6호선,월곡,13537,12986,26523
2022-05-10,6호선,월드컵경기장,4790,5102,9892
2022-05-10,6호선,응암,18935,18383,37318
2022-05-10,6호선,이태원,10272,10967,21239
2022-05-10,6호선,증산,10966,10868,21834
2022-05-10,6호선,창신,4051,3317,7368
2022-05-10,6호선,청구,3923,4131,8054
2022-05-10,6호선,태릉입구,6265,7058,13323
2022-05-10,6호선,한강진,8816,10119,18935
2022-05-10,6호선,합정,13758,13614,27372
2022-05-10,6호선,화랑대,14563,10863,25426
2022-05-10,6호선,효창공원앞,8292,7576,15868
2022-05-10,7호선,가산디지털단지,48553,48963,97516
2022-05-10,7호선,강남구청,17305,19638,36943
2022-05-10,7호선,건대입구,13707,14671,28378
2022-05-10,7호선,고속터미널,16391,14175,30566
2022-05-10,7호선,공릉,14055,13733,27788
2022-05-10,7호선,광명사거리,23059,22645,45704
2022-05-10,7호선,군자,15918,12622,28540
2022-05-10,7호선,남구로,16731,17795,34526
2022-05-10,7호선,남성,12187,11181,23368
2022-05-10,7호선,내방,15871,16326,32197
2022-05-10,7호선,노원,19887,21513,41400
2022-05-10,7호선,논현,21899,23949,45848
2022-05-10,7호선,대림,8068,8185,16253
2022-05-10,7호선,도봉산,10482,11700,22182
2022-05-10,7호선,뚝섬유원지,11352,10997,22349
2022-05-10,7호선,마들,13848,13005,26853
2022-05-10,7호선,먹골,10893,10405,21298
2022-05-10,7호선,면목,17747,17032,34779
2022-05-10,7호선,반포,6222,6026,12248
2022-05-10,7호선,보라매,11220,11091,22311
2022-05-10,7호선,사가정,17449,17277,34726
2022-05-10,7호선,상도,12350,12056,24406
2022-05-10,7호선,상봉,17736,16529,34265
2022-05-10,7호선,수락산,13588,13097,26685
2022-05-10,7호선,숭실대입구,16077,16346,32423
2022-05-10,7호선,신대방삼거리,18116,17353,35469
2022-05-10,7호선,신풍,12483,11787,24270
2022-05-10,7호선,어린이대공원,17037,17403,34440
2022-05-10,7호선,온수,11998,11461,23459
2022-05-10,7호선,용마산,6323,6099,12422
2022-05-10,7호선,이수,17010,16508,33518
2022-05-10,7호선,장승배기,9460,9184,18644
2022-05-10,7호선,장암,2510,951,3461
2022-05-10,7호선,중계,16237,14781,31018
2022-05-10,7호선,중곡,12096,11075,23171
2022-05-10,7호선,중화,11410,11076,22486
2022-05-10,7호선,천왕,12454,11824,24278
2022-05-10,7호선,철산,22647,23096,45743
2022-05-10,7호선,청담,21189,23824,45013
2022-05-10,7호선,태릉입구,10058,9826,19884
2022-05-10,7호선,하계,19387,18097,37484
2022-05-10,7호선,학동,26237,28093,54330
2022-05-10,8호선,가락시장,8159,9264,17423
2022-05-10,8호선,강동구청,11107,11330,22437
2022-05-10,8호선,남위례,5631,5883,11514
2022-05-10,8호선,남한산성입구,16795,15505,32300
2022-05-10,8호선,단대오거리,12009,11341,23350
2022-05-10,8호선,모란,4588,3552,8140
2022-05-10,8호선,몽촌토성,6977,6981,13958
2022-05-10,8호선,문정,23315,24785,48100
2022-05-10,8호선,복정,11070,9191,20261
2022-05-10,8호선,산성,5976,6030,12006
2022-05-10,8호선,석촌,8151,9208,17359
2022-05-10,8호선,송파,8971,8798,17769
2022-05-10,8호선,수진,5605,5134,10739
2022-05-10,8호선,신흥,4375,4736,9111
2022-05-10,8호선,암사,20317,17697,38014
2022-05-10,8호선,잠실,13803,16857,30660
2022-05-10,8호선,장지,18351,17433,35784
2022-05-10,8호선,천호,15388,17603,32991
2022-05-10,9호선,가양,22818,21953,44771
2022-05-10,9호선,개화,2868,2064,4932
2022-05-10,9호선,고속터미널,13644,16406,30050
2022-05-10,9호선,공항시장,3192,3441,6633
2022-05-10,9호선,구반포,1472,1504,2976
2022-05-10,9호선,국회의사당,24492,28063,52555
2022-05-10,9호선,김포공항,7157,10560,17717
2022-05-10,9호선,노들,5009,4141,9150
2022-05-10,9호선,노량진,28510,27764,56274
2022-05-10,9호선,당산,20710,20479,41189
2022-05-10,9호선,동작,2232,1807,4039
2022-05-10,9호선,등촌,12336,11675,24011
2022-05-10,9호선,마곡나루,13998,13556,27554
2022-05-10,9호선,사평,3966,3712,7678
2022-05-10,9호선,샛강,7032,7300,14332
2022-05-10,9호선,선유도,9818,9175,18993
2022-05-10,9호선,신논현,34214,33724,67938
2022-05-10,9호선,신목동,4722,4077,8799
2022-05-10,9호선,신반포,4339,4085,8424
2022-05-10,9호선,신방화,7364,6929,14293
2022-05-10,9호선,양천향교,10674,10967,21641
2022-05-10,9호선,여의도,34126,32680,66806
2022-05-10,9호선,염창,18976,18140,37116
2022-05-10,9호선,증미,7827,7590,15417
2022-05-10,9호선,흑석,10276,10394,20670
2022-05-10,9호선2~3단계,둔촌오륜,1263,1152,2415
2022-05-10,9호선2~3단계,봉은사,17196,17622,34818
2022-05-10,9호선2~3단계,삼성중앙,7705,8205,15910
2022-05-10,9호선2~3단계,삼전,7212,6858,14070
2022-05-10,9호선2~3단계,석촌,9297,8163,17460
2022-05-10,9호선2~3단계,석촌고분,6491,6240,12731
2022-05-10,9호선2~3단계,선정릉,10840,11904,22744
2022-05-10,9호선2~3단계,송파나루,5246,5509,10755
2022-05-10,9호선2~3단계,언주,11171,11662,22833
2022-05-10,9호선2~3단계,올림픽공원,6871,6782,13653
2022-05-10,9호선2~3단계,종합운동장,4667,4830,9497
2022-05-10,9호선2~3단계,중앙보훈병원,11849,10385,22234
2022-05-10,9호선2~3단계,한성백제,2783,2598,5381
2022-05-10,경강선,경기광주,8612,8156,16768
2022-05-10,경강선,곤지암,2527,2485,5012
2022-05-10,경강선,부발,2216,2220,4436
2022-05-10,경강선,삼동,2651,2391,5042
2022-05-10,경강선,세종대왕릉,374,336,710
2022-05-10,경강선,신둔도예촌,1794,1608,3402
2022-05-10,경강선,여주,2750,2716,5466
2022-05-10,경강선,이매,1203,1042,2245
2022-05-10,경강선,이천,2677,2815,5492
2022-05-10,경강선,초월,3524,3299,6823
2022-05-10,경강선,판교,5225,5220,10445
2022-05-10,경부선,가산디지털단지,20145,23169,43314
2022-05-10,경부선,관악,8310,7696,16006
2022-05-10,경부선,광명,3495,2962,6457
2022-05-10,경부선,구로,19676,20361,40037
2022-05-10,경부선,군포,8467,8273,16740
2022-05-10,경부선,금정,29262,29483,58745
2022-05-10,경부선,금천구청,12992,12947,25939
2022-05-10,경부선,남영,10488,11296,21784
2022-05-10,경부선,노량진,9081,9062,18143
2022-05-10,경부선,당정,7964,7608,15572
2022-05-10,경부선,대방,14725,14859,29584
2022-05-10,경부선,독산,20253,21108,41361
2022-05-10,경부선,두정,8270,9180,17450
2022-05-10,경부선,명학,11589,11368,22957
2022-05-10,경부선,병점,17940,17773,35713
2022-05-10,경부선,서동탄,1554,1306,2860
2022-05-10,경부선,서울역,6532,1935,8467
2022-05-10,경부선,서정리,8108,7719,15827
2022-05-10,경부선,석수,10828,9690,20518
2022-05-10,경부선,성균관대,16901,16664,33565
2022-05-10,경부선,성환,6840,6589,13429
2022-05-10,경부선,세류,3365,3163,6528
2022-05-10,경부선,세마,3181,3008,6189
2022-05-10,경부선,송탄,4709,4446,9155
2022-05-10,경부선,수원,38260,40903,79163
2022-05-10,경부선,신길,10187,8727,18914
2022-05-10,경부선,신도림,4305,4470,8775
2022-05-10,경부선,안양,28897,28425,57322
2022-05-10,경부선,영등포,39172,40269,79441
2022-05-10,경부선,오산,11166,11181,22347
2022-05-10,경부선,오산대,4733,4339,9072
2022-05-10,경부선,용산,35568,36706,72274
2022-05-10,경부선,의왕,10531,10375,20906
2022-05-10,경부선,직산,960,935,1895
2022-05-10,경부선,진위,2000,1759,3759
2022-05-10,경부선,천안,7288,6775,14063
2022-05-10,경부선,평택,13491,13796,27287
2022-05-10,경부선,평택지제,3832,3662,7494
2022-05-10,경부선,화서,9313,8883,18196
2022-05-10,경원선,가능,7629,7227,14856
2022-05-10,경원선,광운대,9786,9559,19345
2022-05-10,경원선,녹양,5022,4733,9755
2022-05-10,경원선,녹천,5220,4329,9549
2022-05-10,경원선,덕계,3722,3333,7055
2022-05-10,경원선,덕정,7242,6776,14018
2022-05-10,경원선,도봉,6463,6274,12737
2022-05-10,경원선,도봉산,8385,5663,14048
2022-05-10,경원선,동두천,2430,2768,5198
2022-05-10,경원선,동두천중앙,3719,3605,7324
2022-05-10,경원선,망월사,10371,10451,20822
2022-05-10,경원선,방학,10692,10391,21083
2022-05-10,경원선,보산,1637,1465,3102
2022-05-10,경원선,서빙고,2180,2038,4218
2022-05-10,경원선,석계,9162,10167,19329
2022-05-10,경원선,소요산,2890,2429,5319
2022-05-10,경원선,신이문,9094,8237,17331
2022-05-10,경원선,양주,8854,8162,17016
2022-05-10,경원선,옥수,61,50,111
2022-05-10,경원선,왕십리,15785,17147,32932
2022-05-10,경원선,외대앞,9087,9236,18323
2022-05-10,경원선,월계,9061,8417,17478
2022-05-10,경원선,응봉,2112,1793,3905
2022-05-10,경원선,의정부,19447,20322,39769
2022-05-10,경원선,이촌,4157,3146,7303
2022-05-10,경원선,지행,7444,7467,14911
2022-05-10,경원선,청량리,14942,16492,31434
2022-05-10,경원선,한남,4403,4114,8517
2022-05-10,경원선,회룡,13791,13763,27554
2022-05-10,경의선,가좌,6352,6014,12366
2022-05-10,경의선,강매,3789,3210,6999
2022-05-10,경의선,곡산,749,819,1568
2022-05-10,경의선,공덕,3950,3525,7475
2022-05-10,경의선,금릉,5413,5318,10731
2022-05-10,경의선,금촌,6924,6748,13672
2022-05-10,경의선,능곡,4393,3969,8362
2022-05-10,경의선,디지털미디어시티,2964,2691,5655
2022-05-10,경의선,문산,5472,5422,10894
2022-05-10,경의선,백마,8021,7572,15593
2022-05-10,경의선,서강대,2390,2391,4781
2022-05-10,경의선,서울역,4956,6526,11482
2022-05-10,경의선,수색,3166,3370,6536
2022-05-10,경의선,신촌,972,1370,2342
2022-05-10,경의선,야당,8509,8351,16860
2022-05-10,경의선,운정,7867,7262,15129
2022-05-10,경의선,월롱,3388,3078,6466
2022-05-10,경의선,일산,10725,10367,21092
2022-05-10,경의선,임진강,19,21,40
2022-05-10,경의선,탄현,8632,8202,16834
2022-05-10,경의선,파주,1747,1283,3030
2022-05-10,경의선,풍산,6433,5998,12431
2022-05-10,경의선,행신,8816,8866,17682
2022-05-10,경의선,홍대입구,1799,2141,3940
2022-05-10,경의선,화전,3919,3639,7558
2022-05-10,경의선,효창공원앞,3453,3800,7253
2022-05-10,경인선,간석,6553,6100,12653
2022-05-10,경인선,개봉,23204,22620,45824
2022-05-10,경인선,구일,9729,9846,19575
2022-05-10,경인선,도원,3773,3748,7521
2022-05-10,경인선,도화,4717,4183,8900
2022-05-10,경인선,동암,15714,15830,31544
2022-05-10,경인선,동인천,14579,13903,28482
2022-05-10,경인선,백운,7634,7516,15150
2022-05-10,경인선,부개,9411,8759,18170
2022-05-10,경인선,부천,34582,34610,69192
2022-05-10,경인선,부평,29740,31968,61708
2022-05-10,경인선,소사,9985,9479,19464
2022-05-10,경인선,송내,30597,30672,61269
2022-05-10,경인선,역곡,31662,30798,62460
2022-05-10,경인선,오류동,12863,11814,24677
2022-05-10,경인선,온수,7820,7505,15325
2022-05-10,경인선,인천,3959,3135,7094
2022-05-10,경인선,제물포,12542,11829,24371
2022-05-10,경인선,주안,21462,19501,40963
2022-05-10,경인선,중동,10388,9720,20108
2022-05-10,경춘선,가평,1832,1895,3727
2022-05-10,경춘선,갈매,3402,2940,6342
2022-05-10,경춘선,강촌,549,529,1078
2022-05-10,경춘선,굴봉산,157,153,310
2022-05-10,경춘선,금곡,1891,1745,3636
2022-05-10,경춘선,김유정,438,436,874
2022-05-10,경춘선,남춘천,2603,2596,5199
2022-05-10,경춘선,대성리,567,586,1153
2022-05-10,경춘선,마석,5197,5022,10219
2022-05-10,경춘선,백양리,73,91,164
2022-05-10,경춘선,별내,3565,3293,6858
2022-05-10,경춘선,사릉,2982,2828,5810
2022-05-10,경춘선,상천,487,471,958
2022-05-10,경춘선,신내,2558,2341,4899
2022-05-10,경춘선,천마산,1917,1809,3726
2022-05-10,경춘선,청평,1823,1721,3544
2022-05-10,경춘선,춘천,1796,1709,3505
2022-05-10,경춘선,퇴계원,3908,3502,7410
2022-05-10,경춘선,평내호평,7200,6993,14193
2022-05-10,공항철도,검암,7303,7212,14515
2022-05-10,공항철도,계양,12035,11191,23226
2022-05-10,공항철도,공덕,2503,3278,5781
2022-05-10,공항철도,공항화물청사,2396,2602,4998
2022-05-10,공항철도,김포공항,12177,6893,19070
2022-05-10,공항철도,디지털미디어시티,15591,14627,30218
2022-05-10,공항철도,마곡나루,11090,10886,21976
2022-05-10,공항철도,서울역,8760,7781,16541
2022-05-10,공항철도,영종,3468,3466,6934
2022-05-10,공항철도,운서,7502,7533,15035
2022-05-10,공항철도,인천공항1터미널,5016,5294,10310
2022-05-10,공항철도,인천공항2터미널,2692,2629,5321
2022-05-10,공항철도,청라국제도시,7852,7439,15291
2022-05-10,공항철도,홍대입구,10109,10417,20526
2022-05-10,과천선,경마공원,1619,1514,3133
2022-05-10,과천선,과천,7019,6370,13389
2022-05-10,과천선,대공원,4367,4345,8712
2022-05-10,과천선,범계,28422,28462,56884
2022-05-10,과천선,선바위,9202,8194,17396
2022-05-10,과천선,인덕원,26761,27254,54015
2022-05-10,과천선,정부과천청사,11807,11665,23472
2022-05-10,과천선,평촌,19500,19173,38673
2022-05-10,분당선,가천대,14192,15044,29236
2022-05-10,분당선,강남구청,11115,12753,23868
2022-05-10,분당선,개포동,4376,4431,8807
2022-05-10,분당선,구룡,2654,2481,5135
2022-05-10,분당선,구성,5587,5760,11347
2022-05-10,분당선,기흥,11359,10679,22038
2022-05-10,분당선,대모산입구,5085,4680,9765
2022-05-10,분당선,도곡,7805,7515,15320
2022-05-10,분당선,망포,15963,15108,31071
2022-05-10,분당선,매교,3385,3379,6764
2022-05-10,분당선,매탄권선,5706,5377,11083
2022-05-10,분당선,모란,21402,21484,42886
2022-05-10,분당선,미금,16539,17890,34429
2022-05-10,분당선,보정,2957,2568,5525
2022-05-10,분당선,복정,1,0,1
2022-05-10,분당선,상갈,5999,5729,11728
2022-05-10,분당선,서울숲,12949,13125,26074
2022-05-10,분당선,서현,25491,26148,51639
2022-05-10,분당선,선릉,14923,23038,37961
2022-05-10,분당선,선정릉,8612,9532,18144
2022-05-10,분당선,수내,14358,14441,28799
2022-05-10,분당선,수서,14829,14826,29655
2022-05-10,분당선,수원,8666,7310,15976
2022-05-10,분당선,수원시청,13426,14462,27888
2022-05-10,분당선,신갈,4941,4872,9813
2022-05-10,분당선,압구정로데오,19909,22359,42268
2022-05-10,분당선,야탑,27999,29136,57135
2022-05-10,분당선,영통,8841,8970,17811
2022-05-10,분당선,오리,12533,10321,22854
2022-05-10,분당선,이매,6337,5895,12232
2022-05-10,분당선,정자,19298,20414,39712
2022-05-10,분당선,죽전,15573,17010,32583
2022-05-10,분당선,청명,4786,4663,9449
2022-05-10,분당선,태평,14266,13819,28085
2022-05-10,분당선,한티,15267,16276,31543
2022-05-10,수인선,고색,5387,5149,10536
2022-05-10,수인선,남동인더스파크,2395,2678,5073
2022-05-10,수인선,달월,113,72,185
2022-05-10,수인선,사리,5393,4802,10195
2022-05-10,수인선,소래포구,6362,5930,12292
2022-05-10,수인선,송도,2696,2541,5237
2022-05-10,수인선,숭의,4387,4107,8494
2022-05-10,수인선,신포,2053,2053,4106
2022-05-10,수인선,야목,474,336,810
2022-05-10,수인선,어천,761,825,1586
2022-05-10,수인선,연수,5029,4969,9998
2022-05-10,수인선,오목천,4519,4008,8527
2022-05-10,수인선,원인재,4736,4863,9599
2022-05-10,수인선,월곶,2971,2690,5661
2022-05-10,수인선,인천,1164,1852,3016
2022-05-10,수인선,인천논현,6040,6426,12466
2022-05-10,수인선,인하대,8040,7774,15814
2022-05-10,수인선,호구포,4483,4624,9107
2022-05-10,안산선,고잔,10075,9629,19704
2022-05-10,안산선,대야미,5684,5047,10731
2022-05-10,안산선,반월,4763,4535,9298
2022-05-10,안산선,산본,17384,18573,35957
2022-05-10,안산선,상록수,17706,17961,35667
2022-05-10,안산선,수리산,4811,3939,8750
2022-05-10,안산선,신길온천,1967,1837,3804
2022-05-10,안산선,안산,12355,11066,23421
2022-05-10,안산선,오이도,9465,9261,18726
2022-05-10,안산선,정왕,11103,11457,22560
2022-05-10,안산선,중앙,19965,20791,40756
2022-05-10,안산선,초지,5830,6015,11845
2022-05-10,안산선,한대앞,11466,11611,23077
2022-05-10,우이신설선,4.19민주묘지,3763,3647,7410
2022-05-10,우이신설선,가오리,4464,4304,8768
2022-05-10,우이신설선,보문,1644,1717,3361
2022-05-10,우이신설선,북한산보국문,6555,6294,12849
2022-05-10,우이신설선,북한산우이,2888,2670,5558
2022-05-10,우이신설선,삼양,2118,2162,4280
2022-05-10,우이신설선,삼양사거리,2626,2553,5179
2022-05-10,우이신설선,성신여대입구,3513,3822,7335
2022-05-10,우이신설선,솔밭공원,2689,2568,5257
2022-05-10,우이신설선,솔샘,6418,5964,12382
2022-05-10,우이신설선,신설동,2257,2223,4480
2022-05-10,우이신설선,정릉,5141,4590,9731
2022-05-10,우이신설선,화계,3714,3452,7166
2022-05-10,일산선,대곡,2553,1962,4515
2022-05-10,일산선,대화,14043,10964,25007
2022-05-10,일산선,마두,7981,8245,16226
2022-05-10,일산선,백석,10729,10199,20928
2022-05-10,일산선,삼송,21595,20917,42512
2022-05-10,일산선,원당,12562,11769,24331
2022-05-10,일산선,원흥,12084,11615,23699
2022-05-10,일산선,정발산,7803,7972,15775
2022-05-10,일산선,주엽,10048,9972,20020
2022-05-10,일산선,화정,18272,18534,36806
2022-05-10,장항선,배방,1222,1170,2392
2022-05-10,장항선,봉명,1388,1367,2755
2022-05-10,장항선,신창,3132,3034,6166
2022-05-10,장항선,쌍용,3304,3061,6365
2022-05-10,장항선,아산,4065,3501,7566
2022-05-10,장항선,온양온천,3944,4090,8034
2022-05-10,장항선,탕정,976,832,1808
2022-05-10,중앙선,구리,14748,14904,29652
2022-05-10,중앙선,국수,848,819,1667
2022-05-10,중앙선,덕소,6122,6164,12286
2022-05-10,중앙선,도농,12178,10935,23113
2022-05-10,중앙선,도심,2821,2173,4994
2022-05-10,중앙선,망우,8429,8218,16647
2022-05-10,중앙선,상봉,6134,6193,12327
2022-05-10,중앙선,신원,229,203,432
2022-05-10,중앙선,아신,617,626,1243
2022-05-10,중앙선,양수,2103,2118,4221
2022-05-10,중앙선,양원,3377,3219,6596
2022-05-10,중앙선,양정,808,685,1493
2022-05-10,중앙선,양평,3039,3006,6045
2022-05-10,중앙선,오빈,383,355,738
2022-05-10,중앙선,용문,3834,3845,7679
2022-05-10,중앙선,운길산,1072,970,2042
2022-05-10,중앙선,원덕,429,403,832
2022-05-10,중앙선,중랑,6124,5806,11930
2022-05-10,중앙선,지평,107,120,227
2022-05-10,중앙선,팔당,975,1033,2008
2022-05-10,중앙선,회기,27895,27226,55121
2022-05-11,1호선,동대문,11803,11071,22874
2022-05-11,1호선,동묘앞,8553,9186,17739
2022-05-11,1호선,서울역,47203,45505,92708
2022-05-11,1호선,시청,25501,25925,51426
2022-05-11,1호선,신설동,14807,14442,29249
2022-05-11,1호선,제기동,18062,18412,36474
2022-05-11,1호선,종각,38959,38270,77229
2022-05-11,1호선,종로3가,27776,24969,52745
2022-05-11,1호선,종로5가,24615,24512,49127
2022-05-11,1호선,청량리,21685,20960,42645
2022-05-11,2호선,강남,88738,88348,177086
2022-05-11,2호선,강변,31903,29489,61392
2022-05-11,2호선,건대입구,38038,40676,78714
2022-05-11,2호선,교대,37436,42960,80396
2022-05-11,2호선,구로디지털단지,63856,63572,127428
2022-05-11,2호선,구의,25235,24687,49922
2022-05-11,2호선,낙성대,29743,28704,58447
2022-05-11,2호선,당산,20838,24274,45112
2022-05-11,2호선,대림,25555,26152,51707
2022-05-11,2호선,도림천,1469,1536,3005
2022-05-11,2호선,동대문역사문화공원,12827,14298,27125
2022-05-11,2호선,뚝섬,23866,25832,49698
2022-05-11,2호선,문래,23788,24583,48371
2022-05-11,2호선,방배,21007,21958,42965
2022-05-11,2호선,봉천,25395,23361,48756
2022-05-11,2호선,사당,41518,45744,87262
2022-05-11,2호선,삼성,56609,58150,114759
2022-05-11,2호선,상왕십리,15482,14888,30370
2022-05-11,2호선,서울대입구,51265,50574,101839
2022-05-11,2호선,서초,23676,23258,46934
2022-05-11,2호선,선릉,61834,54903,116737
2022-05-11,2호선,성수,39717,43874,83591
2022-05-11,2호선,시청,26063,25605,51668
2022-05-11,2호선,신답,1841,1991,3832
2022-05-11,2호선,신당,15071,15554,30625
2022-05-11,2호선,신대방,29185,28067,57252
2022-05-11,2호선,신도림,51464,51665,103129
2022-05-11,2호선,신림,68116,65609,133725
2022-05-11,2호선,신설동,3427,3434,6861
2022-05-11,2호선,신정네거리,11363,11608,22971
2022-05-11,2호선,신촌,35647,36321,71968
2022-05-11,2호선,아현,11671,10817,22488
2022-05-11,2호선,양천구청,7451,7662,15113
2022-05-11,2호선,역삼,56401,64214,120615
2022-05-11,2호선,영등포구청,24063,24820,48883
2022-05-11,2호선,왕십리,18348,14765,33113
2022-05-11,2호선,용답,3368,3417,6785
2022-05-11,2호선,용두,2449,2546,4995
2022-05-11,2호선,을지로3가,25088,25244,50332
2022-05-11,2호선,을지로4가,13981,14052,28033
2022-05-11,2호선,을지로입구,42771,44978,87749
2022-05-11,2호선,이대,15332,16289,31621
2022-05-11,2호선,잠실,72020,71627,143647
2022-05-11,2호선,잠실나루,16506,16005,32511
2022-05-11,2호선,잠실새내,22587,22550,45137
2022-05-11,2호선,종합운동장,11993,13515,25508
2022-05-11,2호선,충정로,10845,11523,22368
2022-05-11,2호선,한양대,15305,17117,32422
2022-05-11,2호선,합정,32251,34637,66888
2022-05-11,2호선,홍대입구,57766,61402,119168
2022-05-11,3호선,가락시장,9795,9712,19507
2022-05-11,3호선,경복궁,30739,32197,62936
2022-05-11,3호선,경찰병원,8052,8064,16116
2022-05-11,3호선,고속터미널,41975,39582,81557
2022-05-11,3호선,교대,16504,10607,27111
2022-05-11,3호선,구파발,22632,21748,44380
2022-05-11,3호선,금호,8646,7913,16559
2022-05-11,3호선,남부터미널,31005,31618,62623
2022-05-11,3호선,녹번,16976,15321,32297
2022-05-11,3호선,대청,11579,10663,22242
2022-05-11,3호선,대치,11516,11658,23174
2022-05-11,3호선,도곡,5882,6121,12003
2022-05-11,3호선,독립문,7970,8470,16440
2022-05-11,3호선,동대입구,9345,10484,19829
2022-05-11,3호선,매봉,13831,13207,27038
2022-05-11,3호선,무악재,4269,4408,8677
2022-05-11,3호선,불광,17659,19069,36728
2022-05-11,3호선,수서,18341,18508,36849
2022-05-11,3호선,신사,32427,33825,66252
2022-05-11,3호선,안국,25956,26277,52233
2022-05-11,3호선,압구정,33127,35479,68606
2022-05-11,3호선,약수,14205,13678,27883
2022-05-11,3호선,양재,42580,46570,89150
2022-05-11,3호선,연신내,38854,36519,75373
2022-05-11,3호선,오금,6788,6193,12981
2022-05-11,3호선,옥수,9903,10142,20045
2022-05-11,3호선,을지로3가,11713,12067,23780
2022-05-11,3호선,일원,11676,11304,22980
2022-05-11,3호선,잠원,5402,5158,10560
2022-05-11,3호선,종로3가,10692,12284,22976
2022-05-11,3호선,지축,5634,5128,10762
2022-05-11,3호선,충무로,2,0,2
2022-05-11,3호선,학여울,2025,2064,4089
2022-05-11,3호선,홍제,19501,18490,37991
2022-05-11,4호선,길음,24247,24249,48496
2022-05-11,4호선,남태령,1402,1195,2597
2022-05-11,4호선,노원,20273,23023,43296
2022-05-11,4호선,당고개,9694,8585,18279
2022-05-11,4호선,동대문,21245,21914,43159
2022-05-11,4호선,동대문역사문화공원,15550,14370,29920
2022-05-11,4호선,동작,1798,2000,3798
2022-05-11,4호선,명동,22261,22849,45110
2022-05-11,4호선,미아,16490,15925,32415
2022-05-11,4호선,미아사거리,29594,28457,58051
2022-05-11,4호선,사당,28543,24164,52707
2022-05-11,4호선,삼각지,5694,6362,12056
2022-05-11,4호선,상계,21215,19395,40610
2022-05-11,4호선,서울역,12539,18231,30770
2022-05-11,4호선,성신여대입구,22679,21519,44198
2022-05-11,4호선,수유,36378,36489,72867
2022-05-11,4호선,숙대입구,15698,15136,30834
2022-05-11,4호선,신용산,18185,19338,37523
2022-05-11,4호선,쌍문,31551,28697,60248
2022-05-11,4호선,이촌,9562,10591,20153
2022-05-11,4호선,창동,27544,29142,56686
2022-05-11,4호선,총신대입구,20970,22546,43516
2022-05-11,4호선,충무로,30534,31967,62501
2022-05-11,4호선,한성대입구,16512,15925,32437
2022-05-11,4호선,혜화,39316,40142,79458
2022-05-11,4호선,회현,27451,29228,56679
2022-05-11,5호선,강동,19888,19166,39054
2022-05-11,5호선,강일,4742,4366,9108
2022-05-11,5호선,개롱,7168,7291,14459
2022-05-11,5호선,개화산,6199,5808,12007
2022-05-11,5호선,거여,11490,10813,22303
2022-05-11,5호선,고덕,10928,10706,21634
2022-05-11,5호선,공덕,16059,17206,33265
2022-05-11,5호선,광나루,14847,13491,28338
2022-05-11,5호선,광화문,34286,36324,70610
2022-05-11,5호선,군자,12016,13463,25479
2022-05-11,5호선,굽은다리,10457,9955,20412
2022-05-11,5호선,길동,8491,8765,17256
2022-05-11,5호선,김포공항,7136,7240,14376
2022-05-11,5호선,까치산,31209,29516,60725
2022-05-11,5호선,답십리,17224,15502,32726
2022-05-11,5호선,동대문역사문화공원,3002,3665,6667
2022-05-11,5호선,둔촌동,8841,8694,17535
2022-05-11,5호선,마곡,11670,11620,23290
2022-05-11,5호선,마장,6327,5861,12188
2022-05-11,5호선,마천,8099,7601,15700
2022-05-11,5호선,마포,15754,16228,31982
2022-05-11,5호선,명일,9651,9933,19584
2022-05-11,5호선,목동,18332,19564,37896
2022-05-11,5호선,미사,17815,17493,35308
2022-05-11,5호선,발산,22307,23091,45398
2022-05-11,5호선,방이,7478,7772,15250
2022-05-11,5호선,방화,7154,6774,13928
2022-05-11,5호선,상일동,16419,15327,31746
2022-05-11,5호선,서대문,21843,22289,44132
2022-05-11,5호선,송정,6919,6544,13463
2022-05-11,5호선,신금호,7150,7483,14633
2022-05-11,5호선,신길,4417,4655,9072
2022-05-11,5호선,신정,15085,12207,27292
2022-05-11,5호선,아차산,16470,15685,32155
2022-05-11,5호선,애오개,7482,7395,14877
2022-05-11,5호선,양평,8095,7755,15850
2022-05-11,5호선,여의나루,14229,15364,29593
2022-05-11,5호선,여의도,30750,33191,63941
2022-05-11,5호선,영등포구청,4316,4458,8774
2022-05-11,5호선,영등포시장,10964,11198,22162
2022-05-11,5호선,오금,4126,4143,8269
2022-05-11,5호선,오목교,22890,24220,47110
2022-05-11,5호선,올림픽공원,5059,4539,9598
2022-05-11,5호선,왕십리,4938,5798,10736
2022-05-11,5호선,우장산,16349,15864,32213
2022-05-11,5호선,을지로4가,6777,6868,13645
2022-05-11,5호선,장한평,20166,20046,40212
2022-05-11,5호선,종로3가,13889,13987,27876
2022-05-11,5호선,천호,19337,19708,39045
2022-05-11,5호선,청구,4423,3990,8413
2022-05-11,5호선,충정로,5162,5203,10365
2022-05-11,5호선,하남검단산,6254,5853,12107
2022-05-11,5호선,하남시청,7609,7303,14912
2022-05-11,5호선,하남풍산,4657,4456,9113
2022-05-11,5호선,행당,9110,7860,16970
2022-05-11,5호선,화곡,30718,28395,59113
2022-05-11,6호선,고려대,9556,9233,18789
2022-05-11,6호선,공덕,20423,19996,40419
2022-05-11,6호선,광흥창,10120,9644,19764
2022-05-11,6호선,구산,8273,6017,14290
2022-05-11,6호선,녹사평,5396,5265,10661
2022-05-11,6호선,대흥,9521,9863,19384
2022-05-11,6호선,독바위,2868,3029,5897
2022-05-11,6호선,돌곶이,10222,9545,19767
2022-05-11,6호선,동묘앞,8339,8587,16926
2022-05-11,6호선,디지털미디어시티,15760,17047,32807
2022-05-11,6호선,마포구청,15374,13821,29195
2022-05-11,6호선,망원,14318,15139,29457
2022-05-11,6호선,버티고개,2465,2351,4816
2022-05-11,6호선,보문,8060,7294,15354
2022-05-11,6호선,봉화산,9754,8962,18716
2022-05-11,6호선,불광,4677,4538,9215
2022-05-11,6호선,삼각지,7819,6859,14678
2022-05-11,6호선,상수,9389,10794,20183
2022-05-11,6호선,상월곡,7095,6646,13741
2022-05-11,6호선,새절,14276,13191,27467
2022-05-11,6호선,석계,13682,14245,27927
2022-05-11,6호선,신당,9460,9762,19222
2022-05-11,6호선,안암,15457,15723,31180
2022-05-11,6호선,약수,3836,3868,7704
2022-05-11,6호선,역촌,4039,4810,8849
2022-05-11,6호선,월곡,13707,13143,26850
2022-05-11,6호선,월드컵경기장,4939,5276,10215
2022-05-11,6호선,응암,18972,18388,37360
2022-05-11,6호선,이태원,10669,11467,22136
2022-05-11,6호선,증산,10973,10973,21946
2022-05-11,6호선,창신,4124,3505,7629
2022-05-11,6호선,청구,3981,4218,8199
2022-05-11,6호선,태릉입구,6339,7254,13593
2022-05-11,6호선,한강진,8925,10420,19345
2022-05-11,6호선,합정,13747,13403,27150
2022-05-11,6호선,화랑대,14056,10800,24856
2022-05-11,6호선,효창공원앞,8186,7486,15672
2022-05-11,7호선,가산디지털단지,48308,48771,97079
2022-05-11,7호선,강남구청,17695,19647,37342
2022-05-11,7호선,건대입구,13712,14777,28489
2022-05-11,7호선,고속터미널,16123,14221,30344
2022-05-11,7호선,공릉,13917,13746,27663
2022-05-11,7호선,광명사거리,23354,22848,46202
2022-05-11,7호선,군자,15796,12468,28264
2022-05-11,7호선,남구로,16696,17775,34471
2022-05-11,7호선,남성,12273,11153,23426
2022-05-11,7호선,내방,16026,16625,32651
2022-05-11,7호선,노원,20181,21729,41910
2022-05-11,7호선,논현,21944,23928,45872
2022-05-11,7호선,대림,8004,8123,16127
2022-05-11,7호선,도봉산,10548,11914,22462
2022-05-11,7호선,뚝섬유원지,11452,11076,22528
2022-05-11,7호선,마들,14069,13134,27203
2022-05-11,7호선,먹골,10927,10345,21272
2022-05-11,7호선,면목,17416,16843,34259
2022-05-11,7호선,반포,6412,6313,12725
2022-05-11,7호선,보라매,11209,11271,22480
2022-05-11,7호선,사가정,17502,17432,34934
2022-05-11,7호선,상도,12680,12302,24982
2022-05-11,7호선,상봉,17658,16536,34194
2022-05-11,7호선,수락산,13769,13305,27074
2022-05-11,7호선,숭실대입구,15990,16338,32328
2022-05-11,7호선,신대방삼거리,18343,17499,35842
2022-05-11,7호선,신풍,12498,11990,24488
2022-05-11,7호선,어린이대공원,17604,18085,35689
2022-05-11,7호선,온수,11953,11298,23251
2022-05-11,7호선,용마산,6518,6233,12751
2022-05-11,7호선,이수,17106,16665,33771
2022-05-11,7호선,장승배기,9711,9461,19172
2022-05-11,7호선,장암,2531,961,3492
2022-05-11,7호선,중계,16776,15179,31955
2022-05-11,7호선,중곡,12134,11109,23243
2022-05-11,7호선,중화,11638,11275,22913
2022-05-11,7호선,천왕,12420,11938,24358
2022-05-11,7호선,철산,22726,23088,45814
2022-05-11,7호선,청담,21248,24058,45306
2022-05-11,7호선,태릉입구,10155,9841,19996
2022-05-11,7호선,하계,20357,19098,39455
2022-05-11,7호선,학동,26594,28362,54956
2022-05-11,8호선,가락시장,8187,9157,17344
2022-05-11,8호선,강동구청,11381,11506,22887
2022-05-11,8호선,남위례,5654,5858,11512
2022-05-11,8호선,남한산성입구,16684,15537,32221
2022-05-11,8호선,단대오거리,12262,11647,23909
2022-05-11,8호선,모란,4756,3730,8486
2022-05-11,8호선,몽촌토성,6845,6802,13647
2022-05-11,8호선,문정,23629,25224,48853
2022-05-11,8호선,복정,11112,9155,20267
2022-05-11,8호선,산성,5966,6012,11978
2022-05-11,8호선,석촌,8197,9440,17637
2022-05-11,8호선,송파,9199,8873,18072
2022-05-11,8호선,수진,5576,5165,10741
2022-05-11,8호선,신흥,4453,4688,9141
2022-05-11,8호선,암사,20454,17635,38089
2022-05-11,8호선,잠실,14106,17560,31666
2022-05-11,8호선,장지,18547,17643,36190
2022-05-11,8호선,천호,15582,17955,33537
2022-05-11,9호선,가양,22686,21917,44603
2022-05-11,9호선,개화,2826,1942,4768
2022-05-11,9호선,고속터미널,13578,16428,30006
2022-05-11,9호선,공항시장,3208,3440,6648
2022-05-11,9호선,구반포,1400,1466,2866
2022-05-11,9호선,국회의사당,17380,18233,35613
2022-05-11,9호선,김포공항,7070,11457,18527
2022-05-11,9호선,노들,5084,4187,9271
2022-05-11,9호선,노량진,28802,27656,56458
2022-05-11,9호선,당산,20056,20050,40106
2022-05-11,9호선,동작,2134,1828,3962
2022-05-11,9호선,등촌,12379,11626,24005
2022-05-11,9호선,마곡나루,13993,13715,27708
2022-05-11,9호선,사평,3934,3771,7705
2022-05-11,9호선,샛강,6519,7011,13530
2022-05-11,9호선,선유도,9536,9126,18662
2022-05-11,9호선,신논현,33806,33586,67392
2022-05-11,9호선,신목동,4721,4043,8764
2022-05-11,9호선,신반포,4177,3925,8102
2022-05-11,9호선,신방화,7508,7118,14626
2022-05-11,9호선,양천향교,10715,10879,21594
2022-05-11,9호선,여의도,30396,30085,60481
2022-05-11,9호선,염창,18797,17999,36796
2022-05-11,9호선,증미,7780,7492,15272
2022-05-11,9호선,흑석,10343,10259,20602
2022-05-11,9호선2~3단계,둔촌오륜,1304,1165,2469
2022-05-11,9호선2~3단계,봉은사,18514,19058,37572
2022-05-11,9호선2~3단계,삼성중앙,7437,7872,15309
2022-05-11,9호선2~3단계,삼전,7376,6943,14319
2022-05-11,9호선2~3단계,석촌,9260,7992,17252
2022-05-11,9호선2~3단계,석촌고분,6454,6155,12609
2022-05-11,9호선2~3단계,선정릉,10763,11845,22608
2022-05-11,9호선2~3단계,송파나루,5248,5678,10926
2022-05-11,9호선2~3단계,언주,11169,11510,22679
2022-05-11,9호선2~3단계,올림픽공원,6776,6641,13417
2022-05-11,9호선2~3단계,종합운동장,4590,4790,9380
2022-05-11,9호선2~3단계,중앙보훈병원,11833,10520,22353
2022-05-11,9호선2~3단계,한성백제,2756,2465,5221
2022-05-11,경강선,경기광주,8611,8049,16660
2022-05-11,경강선,곤지암,2496,2502,4998
2022-05-11,경강선,부발,2285,2239,4524
2022-05-11,경강선,삼동,2603,2413,5016
2022-05-11,경강선,세종대왕릉,350,345,695
2022-05-11,경강선,신둔도예촌,1784,1571,3355
2022-05-11,경강선,여주,2684,2717,5401
2022-05-11,경강선,이매,1257,1114,2371
2022-05-11,경강선,이천,2763,2802,5565
2022-05-11,경강선,초월,3577,3298,6875
2022-05-11,경강선,판교,5401,5352,10753
2022-05-11,경부선,가산디지털단지,20286,23316,43602
2022-05-11,경부선,관악,8243,7719,15962
2022-05-11,경부선,광명,3540,2994,6534
2022-05-11,경부선,구로,19888,20608,40496
2022-05-11,경부선,군포,8383,8354,16737
2022-05-11,경부선,금정,29520,29873,59393
2022-05-11,경부선,금천구청,13164,13283,26447
2022-05-11,경부선,남영,10296,11152,21448
2022-05-11,경부선,노량진,9087,9267,18354
2022-05-11,경부선,당정,8049,7655,15704
2022-05-11,경부선,대방,14443,14979,29422
2022-05-11,경부선,독산,20461,20851,41312
2022-05-11,경부선,두정,8541,9281,17822
2022-05-11,경부선,명학,11482,11282,22764
2022-05-11,경부선,병점,17831,18012,35843
2022-05-11,경부선,서동탄,1592,1387,2979
2022-05-11,경부선,서울역,6347,2068,8415
2022-05-11,경부선,서정리,8238,7771,16009
2022-05-11,경부선,석수,10819,9778,20597
2022-05-11,경부선,성균관대,17254,16836,34090
2022-05-11,경부선,성환,7324,6988,14312
2022-05-11,경부선,세류,3362,3079,6441
2022-05-11,경부선,세마,3327,3145,6472
2022-05-11,경부선,송탄,4797,4570,9367
2022-05-11,경부선,수원,39010,41285,80295
2022-05-11,경부선,신길,10011,8709,18720
2022-05-11,경부선,신도림,4521,4666,9187
2022-05-11,경부선,안양,29204,28886,58090
2022-05-11,경부선,영등포,38833,40155,78988
2022-05-11,경부선,오산,11025,11148,22173
2022-05-11,경부선,오산대,4826,4432,9258
2022-05-11,경부선,용산,35483,35698,71181
2022-05-11,경부선,의왕,10532,10363,20895
2022-05-11,경부선,직산,994,955,1949
2022-05-11,경부선,진위,2037,1791,3828
2022-05-11,경부선,천안,7424,6803,14227
2022-05-11,경부선,평택,13767,13879,27646
2022-05-11,경부선,평택지제,3862,3728,7590
2022-05-11,경부선,화서,9207,8748,17955
2022-05-11,경원선,가능,7565,7200,14765
2022-05-11,경원선,광운대,10178,9942,20120
2022-05-11,경원선,녹양,5056,4823,9879
2022-05-11,경원선,녹천,5211,4280,9491
2022-05-11,경원선,덕계,3759,3394,7153
2022-05-11,경원선,덕정,6892,6469,13361
2022-05-11,경원선,도봉,6606,6377,12983
2022-05-11,경원선,도봉산,8590,5768,14358
2022-05-11,경원선,동두천,2914,3263,6177
2022-05-11,경원선,동두천중앙,3395,3256,6651
2022-05-11,경원선,망월사,10721,10802,21523
2022-05-11,경원선,방학,10665,10512,21177
2022-05-11,경원선,보산,1616,1498,3114
2022-05-11,경원선,서빙고,2227,2018,4245
2022-05-11,경원선,석계,9159,10247,19406
2022-05-11,경원선,소요산,2898,2442,5340
2022-05-11,경원선,신이문,9223,8385,17608
2022-05-11,경원선,양주,8666,8280,16946
2022-05-11,경원선,옥수,78,44,122
2022-05-11,경원선,왕십리,15728,17290,33018
2022-05-11,경원선,외대앞,9094,9189,18283
2022-05-11,경원선,월계,9167,8459,17626
2022-05-11,경원선,응봉,2196,1804,4000
2022-05-11,경원선,의정부,19870,20639,40509
2022-05-11,경원선,이촌,4307,3247,7554
2022-05-11,경원선,지행,7741,7730,15471
2022-05-11,경원선,청량리,15464,16764,32228
2022-05-11,경원선,한남,4488,4256,8744
2022-05-11,경원선,회룡,14132,14079,28211
2022-05-11,경의선,가좌,6333,5912,12245
2022-05-11,경의선,강매,3745,3252,6997
2022-05-11,경의선,계양,1,0,1
2022-05-11,경의선,곡산,691,747,1438
2022-05-11,경의선,공덕,3879,3521,7400
2022-05-11,경의선,금릉,5546,5264,10810
2022-05-11,경의선,금촌,7342,7397,14739
2022-05-11,경의선,능곡,4363,3968,8331
2022-05-11,경의선,디지털미디어시티,2942,2672,5614
2022-05-11,경의선,문산,5611,5468,11079
2022-05-11,경의선,백마,7869,7576,15445
2022-05-11,경의선,서강대,2427,2393,4820
2022-05-11,경의선,서울역,4917,6510,11427
2022-05-11,경의선,수색,3189,3314,6503
2022-05-11,경의선,신촌,1029,1358,2387
2022-05-11,경의선,야당,8697,8539,17236
2022-05-11,경의선,운정,7992,7254,15246
2022-05-11,경의선,월롱,3457,3216,6673
2022-05-11,경의선,일산,10770,10598,21368
2022-05-11,경의선,임진강,10,15,25
2022-05-11,경의선,탄현,8725,8261,16986
2022-05-11,경의선,파주,1666,1235,2901
2022-05-11,경의선,풍산,6121,5720,11841
2022-05-11,경의선,행신,8829,8854,17683
2022-05-11,경의선,홍대입구,1867,2255,4122
2022-05-11,경의선,화전,4043,3751,7794
2022-05-11,경의선,효창공원앞,3374,3801,7175
2022-05-11,경인선,간석,6501,6110,12611
2022-05-11,경인선,개봉,23596,22774,46370
2022-05-11,경인선,구일,9190,9222,18412
2022-05-11,경인선,도원,3743,3688,7431
2022-05-11,경인선,도화,4692,4375,9067
2022-05-11,경인선,동암,15859,16092,31951
2022-05-11,경인선,동인천,15584,14703,30287
2022-05-11,경인선,백운,7568,7459,15027
2022-05-11,경인선,부개,9498,8830,18328
2022-05-11,경인선,부천,35446,35509,70955
2022-05-11,경인선,부평,30602,33048,63650
2022-05-11,경인선,소사,10120,9559,19679
2022-05-11,경인선,송내,30368,30510,60878
2022-05-11,경인선,역곡,31572,31048,62620
2022-05-11,경인선,오류동,13068,12144,25212
2022-05-11,경인선,온수,8029,7524,15553
2022-05-11,경인선,인천,4090,3121,7211
2022-05-11,경인선,제물포,12486,11988,24474
2022-05-11,경인선,주안,21590,19846,41436
2022-05-11,경인선,중동,10415,9656,20071
2022-05-11,경춘선,가평,1771,1740,3511
2022-05-11,경춘선,갈매,3417,2947,6364
2022-05-11,경춘선,강촌,534,528,1062
2022-05-11,경춘선,굴봉산,196,168,364
2022-05-11,경춘선,금곡,1674,1673,3347
2022-05-11,경춘선,김유정,421,415,836
2022-05-11,경춘선,남춘천,2709,2770,5479
2022-05-11,경춘선,대성리,618,586,1204
2022-05-11,경춘선,마석,4389,4314,8703
2022-05-11,경춘선,백양리,123,101,224
2022-05-11,경춘선,별내,3405,3084,6489
2022-05-11,경춘선,사릉,2867,2717,5584
2022-05-11,경춘선,상천,389,355,744
2022-05-11,경춘선,신내,2532,2335,4867
2022-05-11,경춘선,천마산,1928,1766,3694
2022-05-11,경춘선,청평,1781,1724,3505
2022-05-11,경춘선,춘천,1721,1626,3347
2022-05-11,경춘선,퇴계원,3921,3543,7464
2022-05-11,경춘선,평내호평,7105,6838,13943
2022-05-11,공항철도,검암,7316,7299,14615
2022-05-11,공항철도,계양,12047,11206,23253
2022-05-11,공항철도,공덕,2454,3206,5660
2022-05-11,공항철도,공항화물청사,2364,2632,4996
2022-05-11,공항철도,김포공항,11268,7005,18273
2022-05-11,공항철도,디지털미디어시티,16107,14964,31071
2022-05-11,공항철도,마곡나루,11293,11114,22407
2022-05-11,공항철도,서울역,8522,7732,16254
2022-05-11,공항철도,영종,3378,3326,6704
2022-05-11,공항철도,운서,7587,7487,15074
2022-05-11,공항철도,인천공항1터미널,5392,5470,10862
2022-05-11,공항철도,인천공항2터미널,2761,2654,5415
2022-05-11,공항철도,청라국제도시,7849,7401,15250
2022-05-11,공항철도,홍대입구,10363,10559,20922
2022-05-11,과천선,경마공원,1623,1601,3224
2022-05-11,과천선,과천,7058,6562,13620
2022-05-11,과천선,대공원,5481,5539,11020
2022-05-11,과천선,범계,28737,28805,57542
2022-05-11,과천선,선바위,9112,8182,17294
2022-05-11,과천선,인덕원,27109,27818,54927
2022-05-11,과천선,정부과천청사,11888,11631,23519
2022-05-11,과천선,평촌,19881,19455,39336
2022-05-11,분당선,가천대,13486,14383,27869
2022-05-11,분당선,강남구청,11309,13001,24310
2022-05-11,분당선,개포동,4533,4572,9105
2022-05-11,분당선,구룡,2677,2522,5199
2022-05-11,분당선,구성,5656,5927,11583
2022-05-11,분당선,기흥,11485,10947,22432
2022-05-11,분당선,대모산입구,5075,4601,9676
2022-05-11,분당선,도곡,7816,7496,15312
2022-05-11,분당선,망포,16007,15359,31366
2022-05-11,분당선,매교,3509,3444,6953
2022-05-11,분당선,매탄권선,5835,5412,11247
2022-05-11,분당선,모란,21436,21698,43134
2022-05-11,분당선,미금,16797,17945,34742
2022-05-11,분당선,보정,2941,2590,5531
2022-05-11,분당선,복정,1,0,1
2022-05-11,분당선,상갈,6030,5777,11807
2022-05-11,분당선,서울숲,13033,13266,26299
2022-05-11,분당선,서현,26293,26517,52810
2022-05-11,분당선,선릉,14599,22811,37410
2022-05-11,분당선,선정릉,8993,9527,18520
2022-05-11,분당선,수내,14726,14785,29511
2022-05-11,분당선,수서,14527,14857,29384
2022-05-11,분당선,수원,8982,7363,16345
2022-05-11,분당선,수원시청,13816,14891,28707
2022-05-11,분당선,신갈,4989,4929,9918
2022-05-11,분당선,압구정로데오,19647,22221,41868
2022-05-11,분당선,야탑,28969,30203,59172
2022-05-11,분당선,영통,9029,9225,18254
2022-05-11,분당선,오리,12685,10419,23104
2022-05-11,분당선,이매,6484,6114,12598
2022-05-11,분당선,정자,19308,20530,39838
2022-05-11,분당선,죽전,15581,17137,32718
2022-05-11,분당선,청명,4757,4700,9457
2022-05-11,분당선,태평,14432,13709,28141
2022-05-11,분당선,한티,15143,16256,31399
2022-05-11,수인선,고색,5462,5229,10691
2022-05-11,수인선,남동인더스파크,2468,2727,5195
2022-05-11,수인선,달월,116,90,206
2022-05-11,수인선,사리,5499,4878,10377
2022-05-11,수인선,소래포구,6645,6144,12789
2022-05-11,수인선,송도,2862,2631,5493
2022-05-11,수인선,숭의,4462,4176,8638
2022-05-11,수인선,신포,2024,2119,4143
2022-05-11,수인선,야목,458,306,764
2022-05-11,수인선,어천,849,872,1721
2022-05-11,수인선,연수,5028,5051,10079
2022-05-11,수인선,오목천,4538,4013,8551
2022-05-11,수인선,원인재,4807,4997,9804
2022-05-11,수인선,월곶,3244,2982,6226
2022-05-11,수인선,인천,1170,1915,3085
2022-05-11,수인선,인천논현,6145,6620,12765
2022-05-11,수인선,인하대,8380,7978,16358
2022-05-11,수인선,호구포,4588,4734,9322
2022-05-11,안산선,고잔,10012,9722,19734
2022-05-11,안산선,대야미,5658,5057,10715
2022-05-11,안산선,반월,4830,4648,9478
2022-05-11,안산선,산본,17454,18702,36156
2022-05-11,안산선,상록수,18136,18311,36447
2022-05-11,안산선,수리산,4772,3900,8672
2022-05-11,안산선,신길온천,2025,1856,3881
2022-05-11,안산선,안산,12384,11126,23510
2022-05-11,안산선,오이도,9396,9289,18685
2022-05-11,안산선,정왕,10884,11172,22056
2022-05-11,안산선,중앙,20180,20843,41023
2022-05-11,안산선,초지,5731,6182,11913
2022-05-11,안산선,한대앞,11314,11324,22638
2022-05-11,우이신설선,4.19민주묘지,4228,4116,8344
2022-05-11,우이신설선,가오리,4573,4464,9037
2022-05-11,우이신설선,보문,1671,1705,3376
2022-05-11,우이신설선,북한산보국문,6780,6309,13089
2022-05-11,우이신설선,북한산우이,2929,2712,5641
2022-05-11,우이신설선,삼양,2170,2217,4387
2022-05-11,우이신설선,삼양사거리,2653,2658,5311
2022-05-11,우이신설선,성신여대입구,3630,4048,7678
2022-05-11,우이신설선,솔밭공원,2752,2542,5294
2022-05-11,우이신설선,솔샘,6502,5973,12475
2022-05-11,우이신설선,신설동,2380,2295,4675
2022-05-11,우이신설선,정릉,5427,4750,10177
2022-05-11,우이신설선,화계,3685,3386,7071
2022-05-11,일산선,대곡,2428,2014,4442
2022-05-11,일산선,대화,14460,11422,25882
2022-05-11,일산선,마두,8366,8397,16763
2022-05-11,일산선,백석,10545,10377,20922
2022-05-11,일산선,삼송,21577,20839,42416
2022-05-11,일산선,원당,12648,11856,24504
2022-05-11,일산선,원흥,12241,11573,23814
2022-05-11,일산선,정발산,7807,7876,15683
2022-05-11,일산선,주엽,10081,10053,20134
2022-05-11,일산선,화정,18522,18932,37454
2022-05-11,장항선,배방,1310,1189,2499
2022-05-11,장항선,봉명,1385,1390,2775
2022-05-11,장항선,신창,2810,2886,5696
2022-05-11,장항선,쌍용,3329,2980,6309
2022-05-11,장항선,아산,4096,3561,7657
2022-05-11,장항선,온양온천,4026,4221,8247
2022-05-11,장항선,탕정,958,795,1753
2022-05-11,중앙선,구리,14659,14825,29484
2022-05-11,중앙선,국수,848,818,1666
2022-05-11,중앙선,덕소,6111,6127,12238
2022-05-11,중앙선,도농,12103,10803,22906
2022-05-11,중앙선,도심,2734,2157,4891
2022-05-11,중앙선,망우,8345,8344,16689
2022-05-11,중앙선,상봉,6270,6213,12483
2022-05-11,중앙선,신원,278,258,536
2022-05-11,중앙선,아신,633,590,1223
2022-05-11,중앙선,양수,2231,2338,4569
2022-05-11,중앙선,양원,3454,3256,6710
2022-05-11,중앙선,양정,823,694,1517
2022-05-11,중앙선,양평,3002,3045,6047
2022-05-11,중앙선,오빈,329,330,659
2022-05-11,중앙선,용문,2025,1992,4017
2022-05-11,중앙선,운길산,989,919,1908
2022-05-11,중앙선,원덕,458,407,865
2022-05-11,중앙선,중랑,6264,5737,12001
2022-05-11,중앙선,지평,81,93,174
2022-05-11,중앙선,팔당,883,885,1768
2022-05-11,중앙선,회기,28182,27359,55541
2022-05-12,1호선,동대문,11576,10958,22534
2022-05-12,1호선,동묘앞,8626,9052,17678
2022-05-12,1호선,서울역,49050,47408,96458
2022-05-12,1호선,시청,25542,26184,51726
2022-05-12,1호선,신설동,14884,14541,29425
2022-05-12,1호선,제기동,18312,18663,36975
2022-05-12,1호선,종각,38943,38342,77285
2022-05-12,1호선,종로3가,28000,25395,53395
2022-05-12,1호선,종로5가,24924,25101,50025
2022-05-12,1호선,청량리,21545,21314,42859
2022-05-12,2호선,강남,88571,88898,177469
2022-05-12,2호선,강변,33278,30577,63855
2022-05-12,2호선,건대입구,38835,41431,80266
2022-05-12,2호선,교대,37567,42778,80345
2022-05-12,2호선,구로디지털단지,63751,63712,127463
2022-05-12,2호선,구의,25201,24464,49665
2022-05-12,2호선,낙성대,29741,28865,58606
2022-05-12,2호선,당산,20740,24036,44776
2022-05-12,2호선,대림,25717,26180,51897
2022-05-12,2호선,도림천,1493,1563,3056
2022-05-12,2호선,동대문역사문화공원,12539,14482,27021
2022-05-12,2호선,뚝섬,24006,26104,50110
2022-05-12,2호선,문래,23654,24361,48015
2022-05-12,2호선,방배,21315,22150,43465
2022-05-12,2호선,봉천,25547,23256,48803
2022-05-12,2호선,사당,40758,45877,86635
2022-05-12,2호선,삼성,58680,60525,119205
2022-05-12,2호선,상왕십리,15481,14774,30255
2022-05-12,2호선,서울대입구,51296,50907,102203
2022-05-12,2호선,서초,23450,22802,46252
2022-05-12,2호선,선릉,61530,54859,116389
2022-05-12,2호선,성수,39710,44159,83869
2022-05-12,2호선,시청,26000,25499,51499
2022-05-12,2호선,신답,1873,2052,3925
2022-05-12,2호선,신당,14923,15284,30207
2022-05-12,2호선,신대방,28851,27533,56384
2022-05-12,2호선,신도림,51844,51460,103304
2022-05-12,2호선,신림,67276,64523,131799
2022-05-12,2호선,신설동,3377,2257,5634
2022-05-12,2호선,신정네거리,11112,11286,22398
2022-05-12,2호선,신촌,36380,37037,73417
2022-05-12,2호선,아현,11840,11200,23040
2022-05-12,2호선,양천구청,7465,7629,15094
2022-05-12,2호선,역삼,55081,64145,119226
2022-05-12,2호선,영등포구청,24001,24865,48866
2022-05-12,2호선,왕십리,18427,14620,33047
2022-05-12,2호선,용답,3409,3514,6923
2022-05-12,2호선,용두,2485,2484,4969
2022-05-12,2호선,을지로3가,24533,25054,49587
2022-05-12,2호선,을지로4가,13839,13993,27832
2022-05-12,2호선,을지로입구,42058,44434,86492
2022-05-12,2호선,이대,15179,16080,31259
2022-05-12,2호선,잠실,73355,73150,146505
2022-05-12,2호선,잠실나루,16306,15779,32085
2022-05-12,2호선,잠실새내,22816,22787,45603
2022-05-12,2호선,종합운동장,11888,13284,25172
2022-05-12,2호선,충정로,10813,11527,22340
2022-05-12,2호선,한양대,15386,17109,32495
2022-05-12,2호선,합정,33116,35533,68649
2022-05-12,2호선,홍대입구,57925,62274,120199
2022-05-12,3호선,가락시장,9870,9774,19644
2022-05-12,3호선,경복궁,31008,33018,64026
2022-05-12,3호선,경찰병원,7785,7829,15614
2022-05-12,3호선,고속터미널,43918,41867,85785
2022-05-12,3호선,교대,16564,10800,27364
2022-05-12,3호선,구파발,22769,21811,44580
2022-05-12,3호선,금호,8540,7794,16334
2022-05-12,3호선,남부터미널,31547,32014,63561
2022-05-12,3호선,녹번,17420,15510,32930
2022-05-12,3호선,대청,11395,10303,21698
2022-05-12,3호선,대치,11810,11958,23768
2022-05-12,3호선,도곡,5977,6241,12218
2022-05-12,3호선,독립문,7940,8335,16275
2022-05-12,3호선,동대입구,9603,10676,20279
2022-05-12,3호선,매봉,13917,13391,27308
2022-05-12,3호선,무악재,4325,4364,8689
2022-05-12,3호선,불광,17450,18607,36057
2022-05-12,3호선,수서,18533,18912,37445
2022-05-12,3호선,신사,32028,34159,66187
2022-05-12,3호선,안국,26487,26641,53128
2022-05-12,3호선,압구정,32841,35456,68297
2022-05-12,3호선,약수,14113,13622,27735
2022-05-12,3호선,양재,42445,46897,89342
2022-05-12,3호선,연신내,39009,36953,75962
2022-05-12,3호선,오금,6854,6216,13070
2022-05-12,3호선,옥수,10033,10217,20250
2022-05-12,3호선,을지로3가,11478,11820,23298
2022-05-12,3호선,일원,11881,11434,23315
2022-05-12,3호선,잠원,5406,5244,10650
2022-05-12,3호선,종로3가,10711,12364,23075
2022-05-12,3호선,지축,5604,5120,10724
2022-05-12,3호선,충무로,3,0,3
2022-05-12,3호선,학여울,2180,2226,4406
2022-05-12,3호선,홍제,19587,18426,38013
2022-05-12,4호선,길음,24340,23990,48330
2022-05-12,4호선,남태령,1464,1218,2682
2022-05-12,4호선,노원,20279,22989,43268
2022-05-12,4호선,당고개,9686,8633,18319
2022-05-12,4호선,동대문,21656,22131,43787
2022-05-12,4호선,동대문역사문화공원,15376,14217,29593
2022-05-12,4호선,동작,1849,2088,3937
2022-05-12,4호선,명동,21931,22864,44795
2022-05-12,4호선,미아,16337,15815,32152
2022-05-12,4호선,미아사거리,29241,28435,57676
2022-05-12,4호선,사당,29445,24442,53887
2022-05-12,4호선,삼각지,5635,6277,11912
2022-05-12,4호선,상계,21165,19460,40625
2022-05-12,4호선,서울역,12783,19266,32049
2022-05-12,4호선,성신여대입구,23165,21746,44911
2022-05-12,4호선,수유,36249,36241,72490
2022-05-12,4호선,숙대입구,15860,15245,31105
2022-05-12,4호선,신용산,18553,19709,38262
2022-05-12,4호선,쌍문,31348,28733,60081
2022-05-12,4호선,이촌,9616,10437,20053
2022-05-12,4호선,창동,27402,29100,56502
2022-05-12,4호선,총신대입구,20713,22458,43171
2022-05-12,4호선,충무로,31365,32526,63891
2022-05-12,4호선,한성대입구,16096,15709,31805
2022-05-12,4호선,혜화,40359,41807,82166
2022-05-12,4호선,회현,27675,29526,57201
2022-05-12,5호선,강동,20191,19489,39680
2022-05-12,5호선,강일,4793,4471,9264
2022-05-12,5호선,개롱,7048,7298,14346
2022-05-12,5호선,개화산,6163,5838,12001
2022-05-12,5호선,거여,11414,10663,22077
2022-05-12,5호선,고덕,10657,10497,21154
2022-05-12,5호선,공덕,15681,16854,32535
2022-05-12,5호선,광나루,15688,14261,29949
2022-05-12,5호선,광화문,34312,36870,71182
2022-05-12,5호선,군자,12163,13471,25634
2022-05-12,5호선,굽은다리,10299,9656,19955
2022-05-12,5호선,길동,8516,8614,17130
2022-05-12,5호선,김포공항,7946,7660,15606
2022-05-12,5호선,까치산,30769,28787,59556
2022-05-12,5호선,답십리,17136,15352,32488
2022-05-12,5호선,동대문역사문화공원,2968,3532,6500
2022-05-12,5호선,둔촌동,8915,8802,17717
2022-05-12,5호선,마곡,11510,11691,23201
2022-05-12,5호선,마장,6420,6048,12468
2022-05-12,5호선,마천,7951,7502,15453
2022-05-12,5호선,마포,15793,16055,31848
2022-05-12,5호선,명일,9491,9760,19251
2022-05-12,5호선,목동,18166,19535,37701
2022-05-12,5호선,미사,17419,17326,34745
2022-05-12,5호선,발산,22322,23160,45482
2022-05-12,5호선,방이,7624,7955,15579
2022-05-12,5호선,방화,7310,6945,14255
2022-05-12,5호선,상일동,16340,15010,31350
2022-05-12,5호선,서대문,22320,22752,45072
2022-05-12,5호선,송정,7054,6563,13617
2022-05-12,5호선,신금호,7008,7150,14158
2022-05-12,5호선,신길,4531,4644,9175
2022-05-12,5호선,신정,15096,12040,27136
2022-05-12,5호선,아차산,16745,15925,32670
2022-05-12,5호선,애오개,7349,7435,14784
2022-05-12,5호선,양평,8013,7826,15839
2022-05-12,5호선,여의나루,14600,16135,30735
2022-05-12,5호선,여의도,30420,33152,63572
2022-05-12,5호선,영등포구청,4408,4546,8954
2022-05-12,5호선,영등포시장,10643,11025,21668
2022-05-12,5호선,오금,4085,4089,8174
2022-05-12,5호선,오목교,22837,24459,47296
2022-05-12,5호선,올림픽공원,5319,4649,9968
2022-05-12,5호선,왕십리,4803,5680,10483
2022-05-12,5호선,우장산,16112,15707,31819
2022-05-12,5호선,을지로4가,6803,6902,13705
2022-05-12,5호선,장한평,19970,19365,39335
2022-05-12,5호선,종로3가,14061,13967,28028
2022-05-12,5호선,천호,19421,19341,38762
2022-05-12,5호선,청구,4327,3821,8148
2022-05-12,5호선,충정로,5118,5287,10405
2022-05-12,5호선,하남검단산,6289,5886,12175
2022-05-12,5호선,하남시청,7445,7142,14587
2022-05-12,5호선,하남풍산,4699,4566,9265
2022-05-12,5호선,행당,9107,7780,16887
2022-05-12,5호선,화곡,30548,28221,58769
2022-05-12,6호선,고려대,10045,9664,19709
2022-05-12,6호선,공덕,20482,19931,40413
2022-05-12,6호선,광흥창,10157,9803,19960
2022-05-12,6호선,구산,8413,5958,14371
2022-05-12,6호선,녹사평,5351,5263,10614
2022-05-12,6호선,대흥,9481,9620,19101
2022-05-12,6호선,독바위,2901,3050,5951
2022-05-12,6호선,돌곶이,10514,9444,19958
2022-05-12,6호선,동묘앞,8231,8490,16721
2022-05-12,6호선,디지털미디어시티,15358,17042,32400
2022-05-12,6호선,마포구청,15374,13618,28992
2022-05-12,6호선,망원,14307,15275,29582
2022-05-12,6호선,버티고개,2431,2373,4804
2022-05-12,6호선,보문,8084,7356,15440
2022-05-12,6호선,봉화산,9847,9212,19059
2022-05-12,6호선,불광,4576,4505,9081
2022-05-12,6호선,삼각지,7807,6753,14560
2022-05-12,6호선,상수,9522,11038,20560
2022-05-12,6호선,상월곡,7103,6522,13625
2022-05-12,6호선,새절,14366,13181,27547
2022-05-12,6호선,석계,13683,14193,27876
2022-05-12,6호선,신내,1,0,1
2022-05-12,6호선,신당,8915,9435,18350
2022-05-12,6호선,안암,15136,14966,30102
2022-05-12,6호선,약수,3838,3924,7762
2022-05-12,6호선,역촌,3961,4604,8565
2022-05-12,6호선,월곡,13235,12737,25972
2022-05-12,6호선,월드컵경기장,4847,5175,10022
2022-05-12,6호선,응암,18765,18399,37164
2022-05-12,6호선,이태원,10854,11769,22623
2022-05-12,6호선,증산,10878,10677,21555
2022-05-12,6호선,창신,3971,3328,7299
2022-05-12,6호선,청구,4002,4190,8192
2022-05-12,6호선,태릉입구,6370,7157,13527
2022-05-12,6호선,한강진,8896,10392,19288
2022-05-12,6호선,합정,14177,13787,27964
2022-05-12,6호선,화랑대,13917,10799,24716
2022-05-12,6호선,효창공원앞,8139,7416,15555
2022-05-12,7호선,가산디지털단지,48152,48705,96857
2022-05-12,7호선,강남구청,17306,19639,36945
2022-05-12,7호선,건대입구,14222,15193,29415
2022-05-12,7호선,고속터미널,16655,14337,30992
2022-05-12,7호선,공릉,14159,13727,27886
2022-05-12,7호선,광명사거리,23189,22668,45857
2022-05-12,7호선,군자,16047,12487,28534
2022-05-12,7호선,남구로,16382,17447,33829
2022-05-12,7호선,남성,12566,11381,23947
2022-05-12,7호선,내방,15828,16269,32097
2022-05-12,7호선,노원,20391,21895,42286
2022-05-12,7호선,논현,22002,24042,46044
2022-05-12,7호선,대림,8068,8134,16202
2022-05-12,7호선,도봉산,10648,12042,22690
2022-05-12,7호선,뚝섬유원지,11829,11371,23200
2022-05-12,7호선,마들,14047,13060,27107
2022-05-12,7호선,먹골,10930,10479,21409
2022-05-12,7호선,면목,17516,16887,34403
2022-05-12,7호선,반포,6356,6200,12556
2022-05-12,7호선,보라매,11215,11349,22564
2022-05-12,7호선,사가정,17667,17679,35346
2022-05-12,7호선,상도,12451,11979,24430
2022-05-12,7호선,상봉,17972,16888,34860
2022-05-12,7호선,수락산,13714,13298,27012
2022-05-12,7호선,숭실대입구,16165,16145,32310
2022-05-12,7호선,신대방삼거리,18195,17203,35398
2022-05-12,7호선,신풍,12497,11813,24310
2022-05-12,7호선,어린이대공원,17624,18299,35923
2022-05-12,7호선,온수,11815,11222,23037
2022-05-12,7호선,용마산,6598,6220,12818
2022-05-12,7호선,이수,17038,16551,33589
2022-05-12,7호선,장승배기,9555,9209,18764
2022-05-12,7호선,장암,2539,906,3445
2022-05-12,7호선,중계,16995,15201,32196
2022-05-12,7호선,중곡,12040,11051,23091
2022-05-12,7호선,중화,11782,11177,22959
2022-05-12,7호선,천왕,12628,11820,24448
2022-05-12,7호선,철산,22949,23416,46365
2022-05-12,7호선,청담,21182,23913,45095
2022-05-12,7호선,태릉입구,10494,9840,20334
2022-05-12,7호선,하계,19862,18485,38347
2022-05-12,7호선,학동,25864,27782,53646
2022-05-12,8호선,가락시장,8331,9239,17570
2022-05-12,8호선,강동구청,11360,11561,22921
2022-05-12,8호선,남위례,5655,5852,11507
2022-05-12,8호선,남한산성입구,16340,15066,31406
2022-05-12,8호선,단대오거리,11862,11289,23151
2022-05-12,8호선,모란,4801,3667,8468
2022-05-12,8호선,몽촌토성,6678,6888,13566
2022-05-12,8호선,문정,23645,25120,48765
2022-05-12,8호선,복정,11087,9367,20454
2022-05-12,8호선,산성,6041,6019,12060
2022-05-12,8호선,석촌,8105,9412,17517
2022-05-12,8호선,송파,8994,8702,17696
2022-05-12,8호선,수진,5654,5189,10843
2022-05-12,8호선,신흥,4407,4670,9077
2022-05-12,8호선,암사,20383,17610,37993
2022-05-12,8호선,잠실,14261,17235,31496
2022-05-12,8호선,장지,18448,17613,36061
2022-05-12,8호선,천호,15502,17914,33416
2022-05-12,9호선,가양,22857,21822,44679
2022-05-12,9호선,개화,2814,1956,4770
2022-05-12,9호선,고속터미널,14036,16923,30959
2022-05-12,9호선,공항시장,3251,3348,6599
2022-05-12,9호선,구반포,1383,1421,2804
2022-05-12,9호선,국회의사당,16773,17844,34617
2022-05-12,9호선,김포공항,7476,12130,19606
2022-05-12,9호선,노들,5006,4203,9209
2022-05-12,9호선,노량진,28713,27614,56327
2022-05-12,9호선,당산,20124,20181,40305
2022-05-12,9호선,동작,2233,2055,4288
2022-05-12,9호선,등촌,12201,11648,23849
2022-05-12,9호선,마곡나루,13492,13560,27052
2022-05-12,9호선,사평,3929,3732,7661
2022-05-12,9호선,샛강,6690,7075,13765
2022-05-12,9호선,선유도,9376,9038,18414
2022-05-12,9호선,신논현,33928,33794,67722
2022-05-12,9호선,신목동,4676,4026,8702
2022-05-12,9호선,신반포,3959,3905,7864
2022-05-12,9호선,신방화,7435,7003,14438
2022-05-12,9호선,양천향교,10567,10699,21266
2022-05-12,9호선,여의도,30272,30175,60447
2022-05-12,9호선,염창,18934,18075,37009
2022-05-12,9호선,증미,7757,7637,15394
2022-05-12,9호선,흑석,10161,10192,20353
2022-05-12,9호선2~3단계,둔촌오륜,1316,1142,2458
2022-05-12,9호선2~3단계,봉은사,19489,20266,39755
2022-05-12,9호선2~3단계,삼성중앙,7603,7966,15569
2022-05-12,9호선2~3단계,삼전,7341,6968,14309
2022-05-12,9호선2~3단계,석촌,9250,7987,17237
2022-05-12,9호선2~3단계,석촌고분,6447,6318,12765
2022-05-12,9호선2~3단계,선정릉,10681,11833,22514
2022-05-12,9호선2~3단계,송파나루,5238,5601,10839
2022-05-12,9호선2~3단계,언주,11179,11556,22735
2022-05-12,9호선2~3단계,올림픽공원,6598,6780,13378
2022-05-12,9호선2~3단계,종합운동장,4558,4691,9249
2022-05-12,9호선2~3단계,중앙보훈병원,11993,10541,22534
2022-05-12,9호선2~3단계,한성백제,2769,2528,5297
2022-05-12,경강선,경기광주,8615,8027,16642
2022-05-12,경강선,곤지암,2532,2466,4998
2022-05-12,경강선,부발,2338,2237,4575
2022-05-12,경강선,삼동,2639,2362,5001
2022-05-12,경강선,세종대왕릉,327,370,697
2022-05-12,경강선,신둔도예촌,1814,1639,3453
2022-05-12,경강선,여주,2940,2717,5657
2022-05-12,경강선,이매,1211,1085,2296
2022-05-12,경강선,이천,2799,2835,5634
2022-05-12,경강선,초월,3457,3296,6753
2022-05-12,경강선,판교,5405,5408,10813
2022-05-12,경부선,가산디지털단지,19999,23258,43257
2022-05-12,경부선,관악,8319,7704,16023
2022-05-12,경부선,광명,3669,3129,6798
2022-05-12,경부선,구로,19774,20624,40398
2022-05-12,경부선,군포,8238,8185,16423
2022-05-12,경부선,금정,29417,29521,58938
2022-05-12,경부선,금천구청,13126,12978,26104
2022-05-12,경부선,남영,10429,11142,21571
2022-05-12,경부선,노량진,9256,9373,18629
2022-05-12,경부선,당정,7913,7514,15427
2022-05-12,경부선,대방,14155,14680,28835
2022-05-12,경부선,독산,20542,21068,41610
2022-05-12,경부선,두정,8554,8918,17472
2022-05-12,경부선,명학,11303,11292,22595
2022-05-12,경부선,병점,18094,18088,36182
2022-05-12,경부선,서동탄,1538,1419,2957
2022-05-12,경부선,서울역,6964,2194,9158
2022-05-12,경부선,서정리,8388,7737,16125
2022-05-12,경부선,석수,10848,9670,20518
2022-05-12,경부선,성균관대,17140,16637,33777
2022-05-12,경부선,성환,7579,6866,14445
2022-05-12,경부선,세류,3452,3148,6600
2022-05-12,경부선,세마,3233,3116,6349
2022-05-12,경부선,송탄,4823,4531,9354
2022-05-12,경부선,수원,39271,41719,80990
2022-05-12,경부선,신길,10114,8725,18839
2022-05-12,경부선,신도림,4559,4858,9417
2022-05-12,경부선,안양,29341,28670,58011
2022-05-12,경부선,영등포,39902,41062,80964
2022-05-12,경부선,오산,11023,10977,22000
2022-05-12,경부선,오산대,4627,4337,8964
2022-05-12,경부선,용산,36528,37588,74116
2022-05-12,경부선,의왕,10643,10478,21121
2022-05-12,경부선,직산,921,980,1901
2022-05-12,경부선,진위,1915,1688,3603
2022-05-12,경부선,천안,7718,6795,14513
2022-05-12,경부선,평택,13720,13881,27601
2022-05-12,경부선,평택지제,3792,3814,7606
2022-05-12,경부선,화서,9278,8907,18185
2022-05-12,경원선,가능,7739,7469,15208
2022-05-12,경원선,광운대,9825,9555,19380
2022-05-12,경원선,녹양,5240,4878,10118
2022-05-12,경원선,녹천,5171,4284,9455
2022-05-12,경원선,덕계,3880,3398,7278
2022-05-12,경원선,덕정,7146,6759,13905
2022-05-12,경원선,도봉,6700,6342,13042
2022-05-12,경원선,도봉산,8889,6002,14891
2022-05-12,경원선,동두천,3070,3325,6395
2022-05-12,경원선,동두천중앙,3423,3366,6789
2022-05-12,경원선,망월사,10481,10656,21137
2022-05-12,경원선,방학,10835,10408,21243
2022-05-12,경원선,보산,1702,1601,3303
2022-05-12,경원선,서빙고,2334,2220,4554
2022-05-12,경원선,석계,9180,10320,19500
2022-05-12,경원선,소요산,3104,2736,5840
2022-05-12,경원선,신이문,9131,8358,17489
2022-05-12,경원선,양주,8805,8171,16976
2022-05-12,경원선,옥수,66,49,115
2022-05-12,경원선,왕십리,15912,17364,33276
2022-05-12,경원선,외대앞,9330,9356,18686
2022-05-12,경원선,월계,9162,8407,17569
2022-05-12,경원선,응봉,2152,1858,4010
2022-05-12,경원선,의정부,19976,20614,40590
2022-05-12,경원선,이촌,4215,3164,7379
2022-05-12,경원선,지행,7458,7688,15146
2022-05-12,경원선,창동,1,0,1
2022-05-12,경원선,청량리,16568,17042,33610
2022-05-12,경원선,한남,4483,4402,8885
2022-05-12,경원선,회룡,14041,14000,28041
2022-05-12,경의선,가좌,6390,5928,12318
2022-05-12,경의선,강매,3716,3198,6914
2022-05-12,경의선,곡산,738,790,1528
2022-05-12,경의선,공덕,3814,3475,7289
2022-05-12,경의선,금릉,5558,5342,10900
2022-05-12,경의선,금촌,7191,7032,14223
2022-05-12,경의선,능곡,4306,4089,8395
2022-05-12,경의선,디지털미디어시티,2941,2767,5708
2022-05-12,경의선,문산,5495,5532,11027
2022-05-12,경의선,백마,7882,7622,15504
2022-05-12,경의선,서강대,2404,2427,4831
2022-05-12,경의선,서울역,5103,6563,11666
2022-05-12,경의선,수색,3117,3320,6437
2022-05-12,경의선,신촌,991,1300,2291
2022-05-12,경의선,야당,8591,8593,17184
2022-05-12,경의선,운정,7916,7353,15269
2022-05-12,경의선,월롱,3282,2998,6280
2022-05-12,경의선,일산,10880,10580,21460
2022-05-12,경의선,임진강,16,22,38
2022-05-12,경의선,탄현,8755,8341,17096
2022-05-12,경의선,파주,1712,1250,2962
2022-05-12,경의선,풍산,6356,5944,12300
2022-05-12,경의선,행신,8943,8923,17866
2022-05-12,경의선,홍대입구,1884,2314,4198
2022-05-12,경의선,화전,3844,3633,7477
2022-05-12,경의선,효창공원앞,3486,3711,7197
2022-05-12,경인선,간석,6556,6148,12704
2022-05-12,경인선,개봉,23544,23159,46703
2022-05-12,경인선,구일,9364,9348,18712
2022-05-12,경인선,도원,3791,3749,7540
2022-05-12,경인선,도화,4735,4243,8978
2022-05-12,경인선,동암,16007,15955,31962
2022-05-12,경인선,동인천,15517,14659,30176
2022-05-12,경인선,백운,7674,7542,15216
2022-05-12,경인선,부개,9484,8817,18301
2022-05-12,경인선,부천,35240,35287,70527
2022-05-12,경인선,부평,30999,33319,64318
2022-05-12,경인선,소사,10065,9525,19590
2022-05-12,경인선,송내,30363,30438,60801
2022-05-12,경인선,역곡,32005,31221,63226
2022-05-12,경인선,오류동,13162,12052,25214
2022-05-12,경인선,온수,8081,7452,15533
2022-05-12,경인선,인천,4199,3374,7573
2022-05-12,경인선,제물포,12425,11739,24164
2022-05-12,경인선,주안,21562,19672,41234
2022-05-12,경인선,중동,10498,9786,20284
2022-05-12,경춘선,가평,1850,1877,3727
2022-05-12,경춘선,갈매,3364,2929,6293
2022-05-12,경춘선,강촌,608,588,1196
2022-05-12,경춘선,굴봉산,181,160,341
2022-05-12,경춘선,금곡,1769,1720,3489
2022-05-12,경춘선,김유정,419,460,879
2022-05-12,경춘선,남춘천,3879,3506,7385
2022-05-12,경춘선,대성리,673,637,1310
2022-05-12,경춘선,마석,4593,4578,9171
2022-05-12,경춘선,백양리,172,185,357
2022-05-12,경춘선,별내,3549,3346,6895
2022-05-12,경춘선,사릉,2884,2720,5604
2022-05-12,경춘선,상천,352,359,711
2022-05-12,경춘선,신내,2523,2343,4866
2022-05-12,경춘선,천마산,2002,1854,3856
2022-05-12,경춘선,청평,1851,1859,3710
2022-05-12,경춘선,춘천,2035,1601,3636
2022-05-12,경춘선,퇴계원,3955,3650,7605
2022-05-12,경춘선,평내호평,7209,7021,14230
2022-05-12,공항철도,검암,7237,7159,14396
2022-05-12,공항철도,계양,11873,11152,23025
2022-05-12,공항철도,공덕,2531,3297,5828
2022-05-12,공항철도,공항화물청사,2379,2613,4992
2022-05-12,공항철도,김포공항,12138,6817,18955
2022-05-12,공항철도,디지털미디어시티,15844,14655,30499
2022-05-12,공항철도,마곡나루,10663,10485,21148
2022-05-12,공항철도,서울역,9019,8129,17148
2022-05-12,공항철도,영종,3441,3490,6931
2022-05-12,공항철도,운서,7577,7664,15241
2022-05-12,공항철도,인천공항1터미널,5981,5422,11403
2022-05-12,공항철도,인천공항2터미널,3393,2911,6304
2022-05-12,공항철도,청라국제도시,7858,7493,15351
2022-05-12,공항철도,홍대입구,10490,10697,21187
2022-05-12,과천선,경마공원,1468,1406,2874
2022-05-12,과천선,과천,7057,6511,13568
2022-05-12,과천선,대공원,5155,5254,10409
2022-05-12,과천선,범계,28603,28396,56999
2022-05-12,과천선,선바위,9674,8367,18041
2022-05-12,과천선,인덕원,26749,27441,54190
2022-05-12,과천선,정부과천청사,11682,11655,23337
2022-05-12,과천선,평촌,19609,19317,38926
2022-05-12,분당선,가천대,13863,14592,28455
2022-05-12,분당선,강남구청,10995,12960,23955
2022-05-12,분당선,개포동,4290,4388,8678
2022-05-12,분당선,구룡,2688,2535,5223
2022-05-12,분당선,구성,5616,5751,11367
2022-05-12,분당선,기흥,11488,10773,22261
2022-05-12,분당선,대모산입구,5190,4668,9858
2022-05-12,분당선,도곡,7942,7626,15568
2022-05-12,분당선,망포,16072,15179,31251
2022-05-12,분당선,매교,3494,3431,6925
2022-05-12,분당선,매탄권선,5849,5601,11450
2022-05-12,분당선,모란,21421,21714,43135
2022-05-12,분당선,미금,16792,17746,34538
2022-05-12,분당선,보정,2921,2568,5489
2022-05-12,분당선,복정,1,0,1
2022-05-12,분당선,상갈,6085,5897,11982
2022-05-12,분당선,서울숲,13120,13619,26739
2022-05-12,분당선,서현,25917,26648,52565
2022-05-12,분당선,선릉,14415,22495,36910
2022-05-12,분당선,선정릉,8756,9629,18385
2022-05-12,분당선,수내,14706,14880,29586
2022-05-12,분당선,수서,14915,15307,30222
2022-05-12,분당선,수원,9082,7794,16876
2022-05-12,분당선,수원시청,13612,14576,28188
2022-05-12,분당선,신갈,4960,4893,9853
2022-05-12,분당선,압구정로데오,20026,22723,42749
2022-05-12,분당선,야탑,28577,29632,58209
2022-05-12,분당선,영통,9034,9308,18342
2022-05-12,분당선,오리,12640,10401,23041
2022-05-12,분당선,이매,6444,5815,12259
2022-05-12,분당선,정자,19091,20180,39271
2022-05-12,분당선,죽전,15964,17340,33304
2022-05-12,분당선,청명,4813,4701,9514
2022-05-12,분당선,태평,14306,13783,28089
2022-05-12,분당선,한티,15329,16504,31833
2022-05-12,수인선,고색,5446,5274,10720
2022-05-12,수인선,남동인더스파크,2428,2689,5117
2022-05-12,수인선,달월,123,85,208
2022-05-12,수인선,사리,5437,4824,10261
2022-05-12,수인선,소래포구,7067,6730,13797
2022-05-12,수인선,송도,2797,2583,5380
2022-05-12,수인선,숭의,4436,4148,8584
2022-05-12,수인선,신포,2066,2090,4156
2022-05-12,수인선,야목,471,339,810
2022-05-12,수인선,어천,875,946,1821
2022-05-12,수인선,연수,5027,5007,10034
2022-05-12,수인선,오목천,4463,3917,8380
2022-05-12,수인선,원인재,4774,5018,9792
2022-05-12,수인선,월곶,3279,2973,6252
2022-05-12,수인선,인천,1125,1926,3051
2022-05-12,수인선,인천논현,6014,6422,12436
2022-05-12,수인선,인하대,8345,7863,16208
2022-05-12,수인선,호구포,4506,4672,9178
2022-05-12,안산선,고잔,10081,9650,19731
2022-05-12,안산선,대야미,5763,5226,10989
2022-05-12,안산선,반월,4827,4625,9452
2022-05-12,안산선,산본,17354,18458,35812
2022-05-12,안산선,상록수,17436,17491,34927
2022-05-12,안산선,수리산,4747,4009,8756
2022-05-12,안산선,신길온천,2042,1876,3918
2022-05-12,안산선,안산,12243,11264,23507
2022-05-12,안산선,오이도,9527,9449,18976
2022-05-12,안산선,정왕,11161,11214,22375
2022-05-12,안산선,중앙,20262,21080,41342
2022-05-12,안산선,초지,5647,5896,11543
2022-05-12,안산선,한대앞,11487,11582,23069
2022-05-12,우이신설선,4.19민주묘지,3617,3386,7003
2022-05-12,우이신설선,가오리,4592,4416,9008
2022-05-12,우이신설선,보문,1728,1661,3389
2022-05-12,우이신설선,북한산보국문,6725,6279,13004
2022-05-12,우이신설선,북한산우이,3001,2702,5703
2022-05-12,우이신설선,삼양,2138,2180,4318
2022-05-12,우이신설선,삼양사거리,2699,2645,5344
2022-05-12,우이신설선,성신여대입구,3506,3921,7427
2022-05-12,우이신설선,솔밭공원,2769,2611,5380
2022-05-12,우이신설선,솔샘,6470,5889,12359
2022-05-12,우이신설선,신설동,2355,2296,4651
2022-05-12,우이신설선,정릉,5239,4717,9956
2022-05-12,우이신설선,화계,3639,3313,6952
2022-05-12,일산선,대곡,2573,1987,4560
2022-05-12,일산선,대화,15601,12722,28323
2022-05-12,일산선,마두,8189,8459,16648
2022-05-12,일산선,백석,10755,10622,21377
2022-05-12,일산선,삼송,22290,21300,43590
2022-05-12,일산선,원당,12458,11544,24002
2022-05-12,일산선,원흥,12314,11578,23892
2022-05-12,일산선,정발산,7854,7950,15804
2022-05-12,일산선,주엽,10182,9998,20180
2022-05-12,일산선,지축,1,0,1
2022-05-12,일산선,화정,18745,18954,37699
2022-05-12,장항선,배방,1274,1253,2527
2022-05-12,장항선,봉명,1443,1358,2801
2022-05-12,장항선,신창,3150,2573,5723
2022-05-12,장항선,쌍용,3297,2878,6175
2022-05-12,장항선,아산,4068,3813,7881
2022-05-12,장항선,온양온천,4075,4204,8279
2022-05-12,장항선,탕정,1012,838,1850
2022-05-12,중앙선,구리,14617,14692,29309
2022-05-12,중앙선,국수,882,848,1730
2022-05-12,중앙선,덕소,6203,6185,12388
2022-05-12,중앙선,도농,12212,11064,23276
2022-05-12,중앙선,도심,2788,2173,4961
2022-05-12,중앙선,망우,8425,8493,16918
2022-05-12,중앙선,상봉,6378,6303,12681
2022-05-12,중앙선,신원,266,224,490
2022-05-12,중앙선,아신,580,608,1188
2022-05-12,중앙선,양수,2199,2226,4425
2022-05-12,중앙선,양원,3404,3175,6579
2022-05-12,중앙선,양정,857,699,1556
2022-05-12,중앙선,양평,2993,2991,5984
2022-05-12,중앙선,오빈,348,355,703
2022-05-12,중앙선,용문,2137,2181,4318
2022-05-12,중앙선,운길산,956,950,1906
2022-05-12,중앙선,원덕,466,434,900
2022-05-12,중앙선,중랑,6209,5790,11999
2022-05-12,중앙선,지평,53,60,113
2022-05-12,중앙선,팔당,948,1071,2019
2022-05-12,중앙선,회기,28326,27242,55568
2022-05-13,1호선,동대문,12014,10699,22713
2022-05-13,1호선,동묘앞,8837,9277,18114
2022-05-13,1호선,서울역,54795,54091,108886
2022-05-13,1호선,시청,25954,27062,53016
2022-05-13,1호선,신설동,15322,14968,30290
2022-05-13,1호선,제기동,18225,18535,36760
2022-05-13,1호선,종각,40065,39947,80012
2022-05-13,1호선,종로3가,29662,27432,57094
2022-05-13,1호선,종로5가,25201,25790,50991
2022-05-13,1호선,청량리,22199,21980,44179
2022-05-13,2호선,강남,95342,98137,193479
2022-05-13,2호선,강변,37597,35305,72902
2022-05-13,2호선,건대입구,41856,47090,88946
2022-05-13,2호선,교대,38102,43987,82089
2022-05-13,2호선,구로디지털단지,64918,64005,128923
2022-05-13,2호선,구의,25970,25117,51087
2022-05-13,2호선,낙성대,31145,29082,60227
2022-05-13,2호선,당산,21281,24482,45763
2022-05-13,2호선,대림,26186,26657,52843
2022-05-13,2호선,도림천,1463,1481,2944
2022-05-13,2호선,동대문역사문화공원,13938,15387,29325
2022-05-13,2호선,뚝섬,25097,26830,51927
2022-05-13,2호선,문래,24027,25822,49849
2022-05-13,2호선,방배,20874,21235,42109
2022-05-13,2호선,봉천,26092,23213,49305
2022-05-13,2호선,사당,44928,50867,95795
2022-05-13,2호선,삼성,59384,60224,119608
2022-05-13,2호선,상왕십리,15973,15180,31153
2022-05-13,2호선,서울대입구,54803,52401,107204
2022-05-13,2호선,서초,23850,23722,47572
2022-05-13,2호선,선릉,61482,54954,116436
2022-05-13,2호선,성수,41019,45844,86863
2022-05-13,2호선,시청,27046,25981,53027
2022-05-13,2호선,신답,1939,2008,3947
2022-05-13,2호선,신당,15591,15883,31474
2022-05-13,2호선,신대방,29194,27714,56908
2022-05-13,2호선,신도림,53426,55066,108492
2022-05-13,2호선,신림,71101,68299,139400
2022-05-13,2호선,신설동,3915,1990,5905
2022-05-13,2호선,신정네거리,11559,11677,23236
2022-05-13,2호선,신촌,38629,40075,78704
2022-05-13,2호선,아현,12059,11240,23299
2022-05-13,2호선,양천구청,7612,7751,15363
2022-05-13,2호선,역삼,54545,62526,117071
2022-05-13,2호선,영등포구청,24175,25252,49427
2022-05-13,2호선,왕십리,19548,16537,36085
2022-05-13,2호선,용답,3324,3266,6590
2022-05-13,2호선,용두,2632,2610,5242
2022-05-13,2호선,을지로3가,25884,27323,53207
2022-05-13,2호선,을지로4가,14148,14309,28457
2022-05-13,2호선,을지로입구,43396,44888,88284
2022-05-13,2호선,이대,16153,16120,32273
2022-05-13,2호선,잠실,81273,80248,161521
2022-05-13,2호선,잠실나루,16391,15591,31982
2022-05-13,2호선,잠실새내,24937,25804,50741
2022-05-13,2호선,종합운동장,18024,20555,38579
2022-05-13,2호선,충정로,10900,12081,22981
2022-05-13,2호선,한양대,13649,14756,28405
2022-05-13,2호선,합정,35962,40115,76077
2022-05-13,2호선,홍대입구,65087,74675,139762
2022-05-13,3호선,가락시장,10265,10191,20456
2022-05-13,3호선,경복궁,31414,34131,65545
2022-05-13,3호선,경찰병원,8156,7966,16122
2022-05-13,3호선,고속터미널,53290,53660,106950
2022-05-13,3호선,교대,16901,10805,27706
2022-05-13,3호선,구파발,22664,21720,44384
2022-05-13,3호선,금호,9039,8067,17106
2022-05-13,3호선,남부터미널,34731,34269,69000
2022-05-13,3호선,녹번,17456,14849,32305
2022-05-13,3호선,대청,11669,10606,22275
2022-05-13,3호선,대치,12318,12324,24642
2022-05-13,3호선,도곡,6133,6270,12403
2022-05-13,3호선,독립문,8285,8634,16919
2022-05-13,3호선,동대입구,9092,9719,18811
2022-05-13,3호선,매봉,13863,13251,27114
2022-05-13,3호선,무악재,4385,4366,8751
2022-05-13,3호선,불광,17967,19162,37129
2022-05-13,3호선,수서,20589,20734,41323
2022-05-13,3호선,신사,35406,38548,73954
2022-05-13,3호선,안국,28746,29169,57915
2022-05-13,3호선,압구정,35434,38981,74415
2022-05-13,3호선,약수,14603,14158,28761
2022-05-13,3호선,양재,44199,47314,91513
2022-05-13,3호선,연신내,40008,37813,77821
2022-05-13,3호선,오금,7004,6405,13409
2022-05-13,3호선,옥수,10291,10398,20689
2022-05-13,3호선,을지로3가,12022,12952,24974
2022-05-13,3호선,일원,11731,10849,22580
2022-05-13,3호선,잠원,5727,5380,11107
2022-05-13,3호선,종로3가,11140,13747,24887
2022-05-13,3호선,지축,5809,5179,10988
2022-05-13,3호선,충무로,1,0,1
2022-05-13,3호선,학여울,2106,2167,4273
2022-05-13,3호선,홍제,19724,18243,37967
2022-05-13,4호선,길음,24406,23343,47749
2022-05-13,4호선,남태령,1456,1140,2596
2022-05-13,4호선,노원,22065,25389,47454
2022-05-13,4호선,당고개,10139,9045,19184
2022-05-13,4호선,동대문,21771,21779,43550
2022-05-13,4호선,동대문역사문화공원,16424,14681,31105
2022-05-13,4호선,동작,2136,2285,4421
2022-05-13,4호선,명동,22736,24487,47223
2022-05-13,4호선,미아,16936,16035,32971
2022-05-13,4호선,미아사거리,30503,29499,60002
2022-05-13,4호선,사당,31678,27837,59515
2022-05-13,4호선,삼각지,6104,7163,13267
2022-05-13,4호선,상계,21629,19574,41203
2022-05-13,4호선,서울역,12854,22527,35381
2022-05-13,4호선,성신여대입구,23689,22653,46342
2022-05-13,4호선,수유,37936,38133,76069
2022-05-13,4호선,숙대입구,15907,15706,31613
2022-05-13,4호선,신용산,19227,20792,40019
2022-05-13,4호선,쌍문,32817,29696,62513
2022-05-13,4호선,이촌,10067,10973,21040
2022-05-13,4호선,창동,29064,30916,59980
2022-05-13,4호선,총신대입구,22176,24096,46272
2022-05-13,4호선,충무로,29987,32094,62081
2022-05-13,4호선,한성대입구,16752,16329,33081
2022-05-13,4호선,혜화,47438,50126,97564
2022-05-13,4호선,회현,28100,29809,57909
2022-05-13,5호선,강동,20485,19210,39695
2022-05-13,5호선,강일,4828,4366,9194
2022-05-13,5호선,개롱,7365,7381,14746
2022-05-13,5호선,개화산,6336,5820,12156
2022-05-13,5호선,거여,11808,10919,22727
2022-05-13,5호선,고덕,11272,10854,22126
2022-05-13,5호선,공덕,15768,17028,32796
2022-05-13,5호선,광나루,15637,13909,29546
2022-05-13,5호선,광화문,33600,35891,69491
2022-05-13,5호선,군자,12620,14098,26718
2022-05-13,5호선,굽은다리,10636,10015,20651
2022-05-13,5호선,길동,9034,9372,18406
2022-05-13,5호선,김포공항,8699,8463,17162
2022-05-13,5호선,까치산,31575,29450,61025
2022-05-13,5호선,답십리,17403,15470,32873
2022-05-13,5호선,동대문역사문화공원,2906,3675,6581
2022-05-13,5호선,둔촌동,9094,9055,18149
2022-05-13,5호선,마곡,11643,11706,23349
2022-05-13,5호선,마장,6286,5927,12213
2022-05-13,5호선,마천,8207,7642,15849
2022-05-13,5호선,마포,15653,16165,31818
2022-05-13,5호선,명일,9833,9977,19810
2022-05-13,5호선,목동,18941,19786,38727
2022-05-13,5호선,미사,17950,18230,36180
2022-05-13,5호선,발산,22117,23426,45543
2022-05-13,5호선,방이,7871,8045,15916
2022-05-13,5호선,방화,7363,6851,14214
2022-05-13,5호선,상일동,16760,15147,31907
2022-05-13,5호선,서대문,21126,21243,42369
2022-05-13,5호선,송정,7227,6735,13962
2022-05-13,5호선,신금호,7428,7376,14804
2022-05-13,5호선,신길,4508,4591,9099
2022-05-13,5호선,신정,15402,11907,27309
2022-05-13,5호선,아차산,18228,17017,35245
2022-05-13,5호선,애오개,7384,7326,14710
2022-05-13,5호선,양평,8095,7705,15800
2022-05-13,5호선,여의나루,19567,20791,40358
2022-05-13,5호선,여의도,30825,33643,64468
2022-05-13,5호선,영등포구청,4407,4484,8891
2022-05-13,5호선,영등포시장,11311,11480,22791
2022-05-13,5호선,오금,4028,4168,8196
2022-05-13,5호선,오목교,24026,25588,49614
2022-05-13,5호선,올림픽공원,5777,5389,11166
2022-05-13,5호선,왕십리,5115,6233,11348
2022-05-13,5호선,우장산,16524,15662,32186
2022-05-13,5호선,을지로4가,6868,7163,14031
2022-05-13,5호선,장한평,20125,19562,39687
2022-05-13,5호선,종로3가,15568,16297,31865
2022-05-13,5호선,천호,20726,20927,41653
2022-05-13,5호선,청구,4419,4040,8459
2022-05-13,5호선,충정로,5117,5102,10219
2022-05-13,5호선,하남검단산,6792,6275,13067
2022-05-13,5호선,하남시청,7965,7487,15452
2022-05-13,5호선,하남풍산,4894,4637,9531
2022-05-13,5호선,행당,9262,7805,17067
2022-05-13,5호선,화곡,31521,28528,60049
2022-05-13,6호선,고려대,9422,8828,18250
2022-05-13,6호선,공덕,20849,20271,41120
2022-05-13,6호선,광흥창,9918,9535,19453
2022-05-13,6호선,구산,8601,6042,14643
2022-05-13,6호선,녹사평,5953,6506,12459
2022-05-13,6호선,대흥,9763,9788,19551
2022-05-13,6호선,독바위,2934,2959,5893
2022-05-13,6호선,돌곶이,10631,9551,20182
2022-05-13,6호선,동묘앞,8637,8418,17055
2022-05-13,6호선,디지털미디어시티,15445,16547,31992
2022-05-13,6호선,마포구청,15426,13331,28757
2022-05-13,6호선,망원,15664,17042,32706
2022-05-13,6호선,버티고개,2466,2345,4811
2022-05-13,6호선,보문,8395,7494,15889
2022-05-13,6호선,봉화산,9865,9224,19089
2022-05-13,6호선,불광,4662,4665,9327
2022-05-13,6호선,삼각지,8471,7087,15558
2022-05-13,6호선,상수,10658,12731,23389
2022-05-13,6호선,상월곡,7122,6213,13335
2022-05-13,6호선,새절,14338,12880,27218
2022-05-13,6호선,석계,13541,13922,27463
2022-05-13,6호선,신당,9093,8700,17793
2022-05-13,6호선,안암,14185,13334,27519
2022-05-13,6호선,약수,4004,4103,8107
2022-05-13,6호선,역촌,3992,4562,8554
2022-05-13,6호선,연신내,1,0,1
2022-05-13,6호선,월곡,13022,12531,25553
2022-05-13,6호선,월드컵경기장,5511,5661,11172
2022-05-13,6호선,응암,19177,18396,37573
2022-05-13,6호선,이태원,13204,18488,31692
2022-05-13,6호선,증산,11118,10761,21879
2022-05-13,6호선,창신,4068,3191,7259
2022-05-13,6호선,청구,3994,4210,8204
2022-05-13,6호선,태릉입구,6742,7500,14242
2022-05-13,6호선,한강진,10297,12462,22759
2022-05-13,6호선,합정,15334,15527,30861
2022-05-13,6호선,화랑대,14092,10597,24689
2022-05-13,6호선,효창공원앞,8232,7352,15584
2022-05-13,7호선,가산디지털단지,47798,47469,95267
2022-05-13,7호선,강남구청,17513,19934,37447
2022-05-13,7호선,건대입구,14325,15970,30295
2022-05-13,7호선,고속터미널,19407,15581,34988
2022-05-13,7호선,공릉,14568,13858,28426
2022-05-13,7호선,광명사거리,24313,23463,47776
2022-05-13,7호선,군자,16453,12795,29248
2022-05-13,7호선,남구로,16164,17424,33588
2022-05-13,7호선,남성,12345,10840,23185
2022-05-13,7호선,내방,16052,16469,32521
2022-05-13,7호선,노원,21724,24176,45900
2022-05-13,7호선,논현,22371,25091,47462
2022-05-13,7호선,대림,8327,8449,16776
2022-05-13,7호선,도봉산,10859,11884,22743
2022-05-13,7호선,뚝섬유원지,14523,14103,28626
2022-05-13,7호선,마들,14460,13054,27514
2022-05-13,7호선,먹골,11249,10526,21775
2022-05-13,7호선,면목,17594,16625,34219
2022-05-13,7호선,반포,7400,6825,14225
2022-05-13,7호선,보라매,11454,11101,22555
2022-05-13,7호선,사가정,17978,17394,35372
2022-05-13,7호선,상도,12720,11952,24672
2022-05-13,7호선,상봉,19011,18145,37156
2022-05-13,7호선,수락산,14042,13517,27559
2022-05-13,7호선,숭실대입구,15824,15320,31144
2022-05-13,7호선,신대방삼거리,18546,17126,35672
2022-05-13,7호선,신풍,12725,12050,24775
2022-05-13,7호선,어린이대공원,20246,20196,40442
2022-05-13,7호선,온수,11943,11254,23197
2022-05-13,7호선,용마산,6507,6080,12587
2022-05-13,7호선,이수,18124,17615,35739
2022-05-13,7호선,장승배기,9854,9474,19328
2022-05-13,7호선,장암,2493,997,3490
2022-05-13,7호선,중계,16936,14909,31845
2022-05-13,7호선,중곡,12247,11058,23305
2022-05-13,7호선,중화,11949,11421,23370
2022-05-13,7호선,천왕,12646,11693,24339
2022-05-13,7호선,철산,24262,24892,49154
2022-05-13,7호선,청담,20999,23993,44992
2022-05-13,7호선,태릉입구,10728,10406,21134
2022-05-13,7호선,하계,20002,18260,38262
2022-05-13,7호선,학동,25430,27455,52885
2022-05-13,8호선,가락시장,8402,9785,18187
2022-05-13,8호선,강동구청,11273,11347,22620
2022-05-13,8호선,남위례,5843,6049,11892
2022-05-13,8호선,남한산성입구,16334,14346,30680
2022-05-13,8호선,단대오거리,12098,11280,23378
2022-05-13,8호선,모란,5032,4134,9166
2022-05-13,8호선,몽촌토성,9100,9394,18494
2022-05-13,8호선,문정,23727,24888,48615
2022-05-13,8호선,복정,11216,9175,20391
2022-05-13,8호선,산성,6260,6179,12439
2022-05-13,8호선,석촌,8394,9976,18370
2022-05-13,8호선,송파,9141,8818,17959
2022-05-13,8호선,수진,5931,5284,11215
2022-05-13,8호선,신흥,4812,4890,9702
2022-05-13,8호선,암사,20712,17830,38542
2022-05-13,8호선,잠실,15566,19779,35345
2022-05-13,8호선,장지,19109,17664,36773
2022-05-13,8호선,천호,16355,19200,35555
2022-05-13,9호선,가양,23231,22076,45307
2022-05-13,9호선,개화,2819,2020,4839
2022-05-13,9호선,고속터미널,16942,21915,38857
2022-05-13,9호선,공항시장,3319,3397,6716
2022-05-13,9호선,구반포,1436,1543,2979
2022-05-13,9호선,국회의사당,17384,17750,35134
2022-05-13,9호선,김포공항,8963,14154,23117
2022-05-13,9호선,노들,5110,4208,9318
2022-05-13,9호선,노량진,30236,28991,59227
2022-05-13,9호선,당산,20803,20666,41469
2022-05-13,9호선,동작,2452,1955,4407
2022-05-13,9호선,등촌,12544,11727,24271
2022-05-13,9호선,마곡나루,13814,13748,27562
2022-05-13,9호선,사평,4256,3903,8159
2022-05-13,9호선,샛강,6606,6913,13519
2022-05-13,9호선,선유도,9548,8884,18432
2022-05-13,9호선,신논현,37366,38660,76026
2022-05-13,9호선,신목동,4756,3956,8712
2022-05-13,9호선,신반포,4354,4355,8709
2022-05-13,9호선,신방화,7415,6969,14384
2022-05-13,9호선,양천향교,10865,10605,21470
2022-05-13,9호선,여의도,31300,30546,61846
2022-05-13,9호선,염창,19518,18101,37619
2022-05-13,9호선,증미,8011,7658,15669
2022-05-13,9호선,흑석,10418,10338,20756
2022-05-13,9호선2~3단계,둔촌오륜,1352,1196,2548
2022-05-13,9호선2~3단계,봉은사,20043,20623,40666
2022-05-13,9호선2~3단계,삼성중앙,7894,8280,16174
2022-05-13,9호선2~3단계,삼전,7704,7243,14947
2022-05-13,9호선2~3단계,석촌,9580,8299,17879
2022-05-13,9호선2~3단계,석촌고분,6941,6479,13420
2022-05-13,9호선2~3단계,선정릉,10743,12138,22881
2022-05-13,9호선2~3단계,송파나루,5582,6100,11682
2022-05-13,9호선2~3단계,언주,11570,11735,23305
2022-05-13,9호선2~3단계,올림픽공원,9793,9256,19049
2022-05-13,9호선2~3단계,종합운동장,4836,4882,9718
2022-05-13,9호선2~3단계,중앙보훈병원,11746,10034,21780
2022-05-13,9호선2~3단계,한성백제,3349,3051,6400
2022-05-13,경강선,경기광주,9147,8507,17654
2022-05-13,경강선,곤지암,2605,2484,5089
2022-05-13,경강선,부발,3036,2310,5346
2022-05-13,경강선,삼동,2746,2349,5095
2022-05-13,경강선,세종대왕릉,402,386,788
2022-05-13,경강선,신둔도예촌,1930,1654,3584
2022-05-13,경강선,여주,2850,2958,5808
2022-05-13,경강선,이매,1252,1061,2313
2022-05-13,경강선,이천,3164,3266,6430
2022-05-13,경강선,초월,3841,3387,7228
2022-05-13,경강선,판교,5262,5547,10809
2022-05-13,경부선,가산디지털단지,19956,22988,42944
2022-05-13,경부선,관악,8343,7633,15976
2022-05-13,경부선,광명,4312,3899,8211
2022-05-13,경부선,구로,20128,21231,41359
2022-05-13,경부선,군포,8432,8168,16600
2022-05-13,경부선,금정,30967,30986,61953
2022-05-13,경부선,금천구청,13576,13340,26916
2022-05-13,경부선,남영,10507,11278,21785
2022-05-13,경부선,노량진,10114,9927,20041
2022-05-13,경부선,당정,7793,7242,15035
2022-05-13,경부선,대방,14655,14650,29305
2022-05-13,경부선,독산,20635,20805,41440
2022-05-13,경부선,두정,8711,7922,16633
2022-05-13,경부선,명학,10370,10004,20374
2022-05-13,경부선,병점,18323,18144,36467
2022-05-13,경부선,서동탄,1733,1624,3357
2022-05-13,경부선,서울역,9942,3122,13064
2022-05-13,경부선,서정리,9560,7649,17209
2022-05-13,경부선,석수,11070,9686,20756
2022-05-13,경부선,성균관대,17935,17055,34990
2022-05-13,경부선,성환,5539,4659,10198
2022-05-13,경부선,세류,3545,3273,6818
2022-05-13,경부선,세마,3312,3185,6497
2022-05-13,경부선,송탄,5543,4830,10373
2022-05-13,경부선,수원,42306,46558,88864
2022-05-13,경부선,신길,10182,8712,18894
2022-05-13,경부선,신도림,4526,4779,9305
2022-05-13,경부선,안양,29079,29004,58083
2022-05-13,경부선,영등포,44374,47503,91877
2022-05-13,경부선,오산,12072,12009,24081
2022-05-13,경부선,오산대,4693,4286,8979
2022-05-13,경부선,용산,43916,46024,89940
2022-05-13,경부선,의왕,11250,10918,22168
2022-05-13,경부선,직산,1052,959,2011
2022-05-13,경부선,진위,2056,1692,3748
2022-05-13,경부선,천안,7964,7553,15517
2022-05-13,경부선,평택,15790,15266,31056
2022-05-13,경부선,평택지제,4566,4222,8788
2022-05-13,경부선,화서,9238,8919,18157
2022-05-13,경원선,가능,7676,7185,14861
2022-05-13,경원선,광운대,9622,9040,18662
2022-05-13,경원선,녹양,5342,4942,10284
2022-05-13,경원선,녹천,5224,4301,9525
2022-05-13,경원선,덕계,3830,3340,7170
2022-05-13,경원선,덕정,7018,6433,13451
2022-05-13,경원선,도봉,6657,6253,12910
2022-05-13,경원선,도봉산,8987,6120,15107
2022-05-13,경원선,동두천,2618,2941,5559
2022-05-13,경원선,동두천중앙,3664,3424,7088
2022-05-13,경원선,망월사,9509,9359,18868
2022-05-13,경원선,방학,10868,10612,21480
2022-05-13,경원선,보산,2177,1799,3976
2022-05-13,경원선,서빙고,2375,2115,4490
2022-05-13,경원선,석계,9450,10373,19823
2022-05-13,경원선,소요산,3067,2703,5770
2022-05-13,경원선,신이문,9273,8354,17627
2022-05-13,경원선,양주,9260,8538,17798
2022-05-13,경원선,옥수,86,31,117
2022-05-13,경원선,왕십리,17098,18665,35763
2022-05-13,경원선,외대앞,10015,9499,19514
2022-05-13,경원선,월계,8771,7956,16727
2022-05-13,경원선,응봉,2203,1789,3992
2022-05-13,경원선,의정부,20875,22596,43471
2022-05-13,경원선,이촌,4444,3322,7766
2022-05-13,경원선,지행,8042,7819,15861
2022-05-13,경원선,창동,1,0,1
2022-05-13,경원선,청량리,19006,19541,38547
2022-05-13,경원선,한남,4625,4574,9199
2022-05-13,경원선,회룡,14481,14251,28732
2022-05-13,경의선,가좌,6348,6040,12388
2022-05-13,경의선,강매,3682,3176,6858
2022-05-13,경의선,곡산,723,727,1450
2022-05-13,경의선,공덕,4126,3745,7871
2022-05-13,경의선,금릉,5787,5710,11497
2022-05-13,경의선,금촌,7387,7079,14466
2022-05-13,경의선,능곡,4423,4127,8550
2022-05-13,경의선,디지털미디어시티,3061,2766,5827
2022-05-13,경의선,문산,6157,5871,12028
2022-05-13,경의선,백마,8256,7886,16142
2022-05-13,경의선,서강대,2489,2473,4962
2022-05-13,경의선,서울역,5068,6887,11955
2022-05-13,경의선,수색,3099,3202,6301
2022-05-13,경의선,신촌,1007,1338,2345
2022-05-13,경의선,야당,9089,9498,18587
2022-05-13,경의선,운정,8229,7627,15856
2022-05-13,경의선,월롱,3386,2596,5982
2022-05-13,경의선,일산,12082,12001,24083
2022-05-13,경의선,임진강,20,7,27
2022-05-13,경의선,탄현,9169,8592,17761
2022-05-13,경의선,파주,1569,958,2527
2022-05-13,경의선,풍산,6620,6156,12776
2022-05-13,경의선,행신,9305,9445,18750
2022-05-13,경의선,홍대입구,2211,2737,4948
2022-05-13,경의선,화전,3190,2877,6067
2022-05-13,경의선,효창공원앞,3427,3801,7228
2022-05-13,경인선,간석,6776,6300,13076
2022-05-13,경인선,개봉,23865,22893,46758
2022-05-13,경인선,구일,8011,7535,15546
2022-05-13,경인선,도원,3849,3707,7556
2022-05-13,경인선,도화,4728,4242,8970
2022-05-13,경인선,동암,16526,16637,33163
2022-05-13,경인선,동인천,15605,14924,30529
2022-05-13,경인선,백운,7973,7652,15625
2022-05-13,경인선,부개,9738,8822,18560
2022-05-13,경인선,부천,36785,37575,74360
2022-05-13,경인선,부평,32566,37199,69765
2022-05-13,경인선,소사,10016,9426,19442
2022-05-13,경인선,송내,30731,30548,61279
2022-05-13,경인선,역곡,33379,32137,65516
2022-05-13,경인선,오류동,13118,11617,24735
2022-05-13,경인선,온수,8051,7479,15530
2022-05-13,경인선,인천,4700,3648,8348
2022-05-13,경인선,제물포,12847,11656,24503
2022-05-13,경인선,주안,22374,20161,42535
2022-05-13,경인선,중동,10522,9601,20123
2022-05-13,경춘선,가평,2027,2689,4716
2022-05-13,경춘선,갈매,3532,3027,6559
2022-05-13,경춘선,강촌,574,783,1357
2022-05-13,경춘선,굴봉산,164,260,424
2022-05-13,경춘선,금곡,1752,1701,3453
2022-05-13,경춘선,김유정,514,625,1139
2022-05-13,경춘선,남춘천,3847,3100,6947
2022-05-13,경춘선,대성리,732,3146,3878
2022-05-13,경춘선,마석,5036,5053,10089
2022-05-13,경춘선,백양리,115,138,253
2022-05-13,경춘선,별내,3687,3435,7122
2022-05-13,경춘선,사릉,2819,2729,5548
2022-05-13,경춘선,상천,380,522,902
2022-05-13,경춘선,신내,2574,2403,4977
2022-05-13,경춘선,천마산,1956,1778,3734
2022-05-13,경춘선,청평,1898,2517,4415
2022-05-13,경춘선,춘천,2359,1654,4013
2022-05-13,경춘선,퇴계원,4284,4007,8291
2022-05-13,경춘선,평내호평,7848,7813,15661
2022-05-13,공항철도,검암,7571,7507,15078
2022-05-13,공항철도,계양,12054,11283,23337
2022-05-13,공항철도,공덕,2628,3584,6212
2022-05-13,공항철도,공항화물청사,2458,2554,5012
2022-05-13,공항철도,김포공항,15178,7617,22795
2022-05-13,공항철도,디지털미디어시티,15454,14136,29590
2022-05-13,공항철도,마곡나루,10532,10019,20551
2022-05-13,공항철도,서울역,11207,10559,21766
2022-05-13,공항철도,영종,3625,3917,7542
2022-05-13,공항철도,운서,8081,8052,16133
2022-05-13,공항철도,인천공항1터미널,6430,6282,12712
2022-05-13,공항철도,인천공항2터미널,3106,2862,5968
2022-05-13,공항철도,청라국제도시,8136,7677,15813
2022-05-13,공항철도,홍대입구,12234,13005,25239
2022-05-13,과천선,경마공원,7428,7653,15081
2022-05-13,과천선,과천,7456,6570,14026
2022-05-13,과천선,대공원,11926,11731,23657
2022-05-13,과천선,범계,30560,31133,61693
2022-05-13,과천선,선바위,9951,8373,18324
2022-05-13,과천선,인덕원,28372,28510,56882
2022-05-13,과천선,정부과천청사,12315,12021,24336
2022-05-13,과천선,평촌,20205,19242,39447
2022-05-13,분당선,가천대,12450,12624,25074
2022-05-13,분당선,강남구청,11572,13299,24871
2022-05-13,분당선,개포동,4509,4527,9036
2022-05-13,분당선,구룡,2856,2582,5438
2022-05-13,분당선,구성,5807,5955,11762
2022-05-13,분당선,기흥,11585,10848,22433
2022-05-13,분당선,대모산입구,5163,4609,9772
2022-05-13,분당선,도곡,8144,7740,15884
2022-05-13,분당선,망포,17210,15853,33063
2022-05-13,분당선,매교,3619,3512,7131
2022-05-13,분당선,매탄권선,6016,5723,11739
2022-05-13,분당선,모란,22170,22596,44766
2022-05-13,분당선,미금,17289,18553,35842
2022-05-13,분당선,보정,3135,2682,5817
2022-05-13,분당선,상갈,6249,6134,12383
2022-05-13,분당선,서울숲,15024,15563,30587
2022-05-13,분당선,서현,28922,29336,58258
2022-05-13,분당선,선릉,14386,22597,36983
2022-05-13,분당선,선정릉,8701,9243,17944
2022-05-13,분당선,수내,15122,15020,30142
2022-05-13,분당선,수서,16068,16853,32921
2022-05-13,분당선,수원,9723,8343,18066
2022-05-13,분당선,수원시청,14418,17142,31560
2022-05-13,분당선,신갈,5114,5006,10120
2022-05-13,분당선,압구정로데오,22466,26594,49060
2022-05-13,분당선,야탑,29839,31300,61139
2022-05-13,분당선,영통,9887,9964,19851
2022-05-13,분당선,오리,12960,10350,23310
2022-05-13,분당선,이매,6765,6291,13056
2022-05-13,분당선,정자,19987,21159,41146
2022-05-13,분당선,죽전,16162,17477,33639
2022-05-13,분당선,청명,5165,4763,9928
2022-05-13,분당선,태평,14850,14079,28929
2022-05-13,분당선,한티,16710,17534,34244
2022-05-13,수인선,고색,5558,5180,10738
2022-05-13,수인선,남동인더스파크,2408,2642,5050
2022-05-13,수인선,달월,130,86,216
2022-05-13,수인선,사리,5719,4958,10677
2022-05-13,수인선,소래포구,6907,6772,13679
2022-05-13,수인선,송도,2900,2698,5598
2022-05-13,수인선,숭의,4514,4260,8774
2022-05-13,수인선,신포,2077,2119,4196
2022-05-13,수인선,야목,487,363,850
2022-05-13,수인선,어천,969,919,1888
2022-05-13,수인선,연수,5571,5651,11222
2022-05-13,수인선,오목천,4477,3797,8274
2022-05-13,수인선,원인재,5102,5262,10364
2022-05-13,수인선,월곶,3134,2856,5990
2022-05-13,수인선,인천,1216,1990,3206
2022-05-13,수인선,인천논현,6473,6993,13466
2022-05-13,수인선,인하대,8027,7359,15386
2022-05-13,수인선,호구포,4619,4684,9303
2022-05-13,안산선,고잔,10208,9756,19964
2022-05-13,안산선,대야미,5892,5024,10916
2022-05-13,안산선,반월,4914,4646,9560
2022-05-13,안산선,산본,18705,20355,39060
2022-05-13,안산선,상록수,18448,18237,36685
2022-05-13,안산선,수리산,4714,3740,8454
2022-05-13,안산선,신길온천,2091,1924,4015
2022-05-13,안산선,안산,12774,11843,24617
2022-05-13,안산선,오이도,9952,10278,20230
2022-05-13,안산선,정왕,11784,11169,22953
2022-05-13,안산선,중앙,21503,23287,44790
2022-05-13,안산선,초지,5678,5800,11478
2022-05-13,안산선,한대앞,11972,11620,23592
2022-05-13,우이신설선,4.19민주묘지,4153,3932,8085
2022-05-13,우이신설선,가오리,4591,4379,8970
2022-05-13,우이신설선,보문,1727,1691,3418
2022-05-13,우이신설선,북한산보국문,7085,6290,13375
2022-05-13,우이신설선,북한산우이,3133,3120,6253
2022-05-13,우이신설선,삼양,2185,2177,4362
2022-05-13,우이신설선,삼양사거리,2808,2703,5511
2022-05-13,우이신설선,성신여대입구,3838,4379,8217
2022-05-13,우이신설선,솔밭공원,2804,2504,5308
2022-05-13,우이신설선,솔샘,6552,5865,12417
2022-05-13,우이신설선,신설동,2362,2285,4647
2022-05-13,우이신설선,정릉,5589,4774,10363
2022-05-13,우이신설선,화계,3787,3339,7126
2022-05-13,일산선,대곡,2603,1999,4602
2022-05-13,일산선,대화,16744,13400,30144
2022-05-13,일산선,마두,8681,9048,17729
2022-05-13,일산선,백석,11241,11104,22345
2022-05-13,일산선,삼송,22219,21213,43432
2022-05-13,일산선,원당,13178,12053,25231
2022-05-13,일산선,원흥,12636,11634,24270
2022-05-13,일산선,정발산,8920,9259,18179
2022-05-13,일산선,주엽,10963,10804,21767
2022-05-13,일산선,화정,19685,20046,39731
2022-05-13,장항선,배방,1453,1313,2766
2022-05-13,장항선,봉명,1450,1354,2804
2022-05-13,장항선,신창,3527,2099,5626
2022-05-13,장항선,쌍용,3066,2564,5630
2022-05-13,장항선,아산,5040,4803,9843
2022-05-13,장항선,온양온천,4340,4662,9002
2022-05-13,장항선,탕정,1088,891,1979
2022-05-13,중앙선,구리,15534,15745,31279
2022-05-13,중앙선,국수,950,923,1873
2022-05-13,중앙선,덕소,6438,6295,12733
2022-05-13,중앙선,도농,12771,11458,24229
2022-05-13,중앙선,도심,2805,2234,5039
2022-05-13,중앙선,망우,9104,8667,17771
2022-05-13,중앙선,상봉,6854,6694,13548
2022-05-13,중앙선,신원,266,284,550
2022-05-13,중앙선,아신,683,679,1362
2022-05-13,중앙선,양수,2251,2326,4577
2022-05-13,중앙선,양원,3503,3260,6763
2022-05-13,중앙선,양정,812,717,1529
2022-05-13,중앙선,양평,4647,4792,9439
2022-05-13,중앙선,오빈,340,370,710
2022-05-13,중앙선,용문,2147,2308,4455
2022-05-13,중앙선,운길산,1053,1051,2104
2022-05-13,중앙선,원덕,458,447,905
2022-05-13,중앙선,중랑,6426,5931,12357
2022-05-13,중앙선,지평,68,84,152
2022-05-13,중앙선,팔당,1010,1117,2127
2022-05-13,중앙선,회기,29602,27536,57138
2022-05-16,1호선,동대문,11664,11157,22821
2022-05-16,1호선,동묘앞,8064,8422,16486
2022-05-16,1호선,서울역,48277,46482,94759
2022-05-16,1호선,시청,24430,24510,48940
2022-05-16,1호선,신설동,14290,13926,28216
2022-05-16,1호선,제기동,17923,18458,36381
2022-05-16,1호선,종각,37722,36969,74691
2022-05-16,1호선,종로3가,27333,24377,51710
2022-05-16,1호선,종로5가,23979,23062,47041
2022-05-16,1호선,청량리,20996,20905,41901
2022-05-16,2호선,강남,85811,85928,171739
2022-05-16,2호선,강변,32687,31152,63839
2022-05-16,2호선,건대입구,36835,39187,76022
2022-05-16,2호선,교대,36056,41345,77401
2022-05-16,2호선,구로디지털단지,62615,62738,125353
2022-05-16,2호선,구의,24551,24053,48604
2022-05-16,2호선,낙성대,28764,28588,57352
2022-05-16,2호선,당산,19873,23325,43198
2022-05-16,2호선,대림,25963,26259,52222
2022-05-16,2호선,도림천,1438,1527,2965
2022-05-16,2호선,동대문역사문화공원,12350,13995,26345
2022-05-16,2호선,뚝섬,22884,24701,47585
2022-05-16,2호선,문래,23452,23974,47426
2022-05-16,2호선,방배,20390,21239,41629
2022-05-16,2호선,봉천,24949,22916,47865
2022-05-16,2호선,사당,39592,43532,83124
2022-05-16,2호선,삼성,52762,54096,106858
2022-05-16,2호선,상왕십리,15066,14759,29825
2022-05-16,2호선,서울대입구,50426,49815,100241
2022-05-16,2호선,서초,22481,21939,44420
2022-05-16,2호선,선릉,60858,54254,115112
2022-05-16,2호선,성수,38964,42873,81837
2022-05-16,2호선,시청,24753,24080,48833
2022-05-16,2호선,신답,1776,1963,3739
2022-05-16,2호선,신당,14417,14775,29192
2022-05-16,2호선,신대방,28004,27230,55234
2022-05-16,2호선,신도림,49682,49341,99023
2022-05-16,2호선,신림,66090,63775,129865
2022-05-16,2호선,신설동,3428,3464,6892
2022-05-16,2호선,신정네거리,11205,11343,22548
2022-05-16,2호선,신촌,35140,35909,71049
2022-05-16,2호선,아현,11005,10375,21380
2022-05-16,2호선,양천구청,7348,7496,14844
2022-05-16,2호선,역삼,55827,63862,119689
2022-05-16,2호선,영등포구청,23599,24398,47997
2022-05-16,2호선,왕십리,17587,13962,31549
2022-05-16,2호선,용답,3364,3482,6846
2022-05-16,2호선,용두,2489,2516,5005
2022-05-16,2호선,을지로3가,23834,24159,47993
2022-05-16,2호선,을지로4가,13481,13458,26939
2022-05-16,2호선,을지로입구,41411,43101,84512
2022-05-16,2호선,이대,14817,16241,31058
2022-05-16,2호선,잠실,69088,69289,138377
2022-05-16,2호선,잠실나루,16226,15748,31974
2022-05-16,2호선,잠실새내,22088,22010,44098
2022-05-16,2호선,종합운동장,7501,8644,16145
2022-05-16,2호선,충정로,10553,11157,21710
2022-05-16,2호선,한양대,15034,16968,32002
2022-05-16,2호선,합정,30700,32391,63091
2022-05-16,2호선,홍대입구,55746,57996,113742
2022-05-16,3호선,가락시장,9526,9314,18840
2022-05-16,3호선,경복궁,28281,30579,58860
2022-05-16,3호선,경찰병원,7870,7910,15780
2022-05-16,3호선,고속터미널,36967,35862,72829
2022-05-16,3호선,교대,15811,10302,26113
2022-05-16,3호선,구파발,22553,21741,44294
2022-05-16,3호선,금호,8472,7906,16378
2022-05-16,3호선,남부터미널,30212,31375,61587
2022-05-16,3호선,녹번,16883,15242,32125
2022-05-16,3호선,대청,11071,10077,21148
2022-05-16,3호선,대치,11650,11759,23409
2022-05-16,3호선,도곡,5957,6172,12129
2022-05-16,3호선,독립문,7535,7883,15418
2022-05-16,3호선,동대입구,9681,10644,20325
2022-05-16,3호선,매봉,13358,12812,26170
2022-05-16,3호선,무악재,4258,4320,8578
2022-05-16,3호선,불광,17331,18383,35714
2022-05-16,3호선,수서,18247,18769,37016
2022-05-16,3호선,신사,31973,33318,65291
2022-05-16,3호선,안국,24159,24150,48309
2022-05-16,3호선,압구정,32828,35367,68195
2022-05-16,3호선,약수,13981,13458,27439
2022-05-16,3호선,양재,40364,44720,85084
2022-05-16,3호선,연신내,38604,36100,74704
2022-05-16,3호선,오금,6915,6102,13017
2022-05-16,3호선,옥수,9843,10027,19870
2022-05-16,3호선,을지로3가,11120,11529,22649
2022-05-16,3호선,일원,11334,10981,22315
2022-05-16,3호선,잠원,5265,5190,10455
2022-05-16,3호선,종로3가,10409,11931,22340
2022-05-16,3호선,지축,5474,5101,10575
2022-05-16,3호선,충무로,2,0,2
2022-05-16,3호선,학여울,2046,2025,4071
2022-05-16,3호선,홍제,19193,18464,37657
2022-05-16,4호선,길음,23538,23461,46999
2022-05-16,4호선,남태령,1347,1251,2598
2022-05-16,4호선,노원,19678,22208,41886
2022-05-16,4호선,당고개,9734,8489,18223
2022-05-16,4호선,동대문,21454,21952,43406
2022-05-16,4호선,동대문역사문화공원,15462,14079,29541
2022-05-16,4호선,동작,1896,2154,4050
2022-05-16,4호선,명동,22039,22383,44422
2022-05-16,4호선,미아,16480,15970,32450
2022-05-16,4호선,미아사거리,28836,27795,56631
2022-05-16,4호선,사당,27265,23146,50411
2022-05-16,4호선,삼각지,5401,6227,11628
2022-05-16,4호선,상계,20614,18962,39576
2022-05-16,4호선,서울역,12254,18202,30456
2022-05-16,4호선,성신여대입구,21999,20868,42867
2022-05-16,4호선,수유,35434,35394,70828
2022-05-16,4호선,숙대입구,15098,14599,29697
2022-05-16,4호선,신용산,17943,18898,36841
2022-05-16,4호선,쌍문,30904,28368,59272
2022-05-16,4호선,이촌,8623,9722,18345
2022-05-16,4호선,창동,26627,28040,54667
2022-05-16,4호선,총신대입구,20470,22205,42675
2022-05-16,4호선,충무로,30169,31675,61844
2022-05-16,4호선,한성대입구,15036,14619,29655
2022-05-16,4호선,혜화,33750,33665,67415
2022-05-16,4호선,회현,27360,28722,56082
2022-05-16,5호선,강동,19557,18802,38359
2022-05-16,5호선,강일,4720,4482,9202
2022-05-16,5호선,개롱,7024,7305,14329
2022-05-16,5호선,개화산,6009,5696,11705
2022-05-16,5호선,거여,11399,10888,22287
2022-05-16,5호선,고덕,10089,10057,20146
2022-05-16,5호선,공덕,15064,15868,30932
2022-05-16,5호선,광나루,15082,13655,28737
2022-05-16,5호선,광화문,31947,33637,65584
2022-05-16,5호선,군자,11671,12944,24615
2022-05-16,5호선,굽은다리,10058,9499,19557
2022-05-16,5호선,길동,8396,8701,17097
2022-05-16,5호선,김포공항,7477,7320,14797
2022-05-16,5호선,까치산,30320,28789,59109
2022-05-16,5호선,답십리,16821,15283,32104
2022-05-16,5호선,동대문역사문화공원,3015,3635,6650
2022-05-16,5호선,둔촌동,8565,8514,17079
2022-05-16,5호선,마곡,11453,11427,22880
2022-05-16,5호선,마장,6055,5633,11688
2022-05-16,5호선,마천,8042,7560,15602
2022-05-16,5호선,마포,15246,15494,30740
2022-05-16,5호선,명일,9253,9534,18787
2022-05-16,5호선,목동,17963,19221,37184
2022-05-16,5호선,미사,17187,17179,34366
2022-05-16,5호선,발산,21653,22478,44131
2022-05-16,5호선,방이,7447,7631,15078
2022-05-16,5호선,방화,7179,6775,13954
2022-05-16,5호선,상일동,16360,15051,31411
2022-05-16,5호선,서대문,21319,21805,43124
2022-05-16,5호선,송정,6906,6525,13431
2022-05-16,5호선,신금호,7024,7397,14421
2022-05-16,5호선,신길,4445,4743,9188
2022-05-16,5호선,신정,14922,12013,26935
2022-05-16,5호선,아차산,16070,15465,31535
2022-05-16,5호선,애오개,7187,7175,14362
2022-05-16,5호선,양평,7951,7854,15805
2022-05-16,5호선,여의나루,12688,13642,26330
2022-05-16,5호선,여의도,29251,31710,60961
2022-05-16,5호선,영등포구청,4331,4467,8798
2022-05-16,5호선,영등포시장,10299,10663,20962
2022-05-16,5호선,오금,4121,4162,8283
2022-05-16,5호선,오목교,21215,22575,43790
2022-05-16,5호선,올림픽공원,5168,4520,9688
2022-05-16,5호선,왕십리,4665,5407,10072
2022-05-16,5호선,우장산,16025,15616,31641
2022-05-16,5호선,을지로4가,6677,6647,13324
2022-05-16,5호선,장한평,19186,18872,38058
2022-05-16,5호선,종로3가,13182,13032,26214
2022-05-16,5호선,천호,18727,18775,37502
2022-05-16,5호선,청구,4254,3816,8070
2022-05-16,5호선,충정로,4998,5147,10145
2022-05-16,5호선,하남검단산,6082,5770,11852
2022-05-16,5호선,하남시청,7520,7145,14665
2022-05-16,5호선,하남풍산,4610,4404,9014
2022-05-16,5호선,행당,8562,7667,16229
2022-05-16,5호선,화곡,30008,28050,58058
2022-05-16,6호선,고려대,9238,8966,18204
2022-05-16,6호선,공덕,19816,19268,39084
2022-05-16,6호선,광흥창,9798,9459,19257
2022-05-16,6호선,구산,8250,5960,14210
2022-05-16,6호선,녹사평,4765,4735,9500
2022-05-16,6호선,대흥,9201,9614,18815
2022-05-16,6호선,독바위,2859,3003,5862
2022-05-16,6호선,돌곶이,9887,9215,19102
2022-05-16,6호선,동묘앞,8188,8482,16670
2022-05-16,6호선,디지털미디어시티,15416,16723,32139
2022-05-16,6호선,마포구청,15286,13547,28833
2022-05-16,6호선,망원,13835,14615,28450
2022-05-16,6호선,버티고개,2366,2319,4685
2022-05-16,6호선,보문,7783,7181,14964
2022-05-16,6호선,봉화산,9527,8814,18341
2022-05-16,6호선,불광,4346,4360,8706
2022-05-16,6호선,삼각지,7265,6326,13591
2022-05-16,6호선,상수,8897,10282,19179
2022-05-16,6호선,상월곡,6926,6388,13314
2022-05-16,6호선,새절,14158,13061,27219
2022-05-16,6호선,석계,13466,14102,27568
2022-05-16,6호선,신내,2,0,2
2022-05-16,6호선,신당,7955,8438,16393
2022-05-16,6호선,안암,14780,15499,30279
2022-05-16,6호선,약수,3869,3923,7792
2022-05-16,6호선,역촌,3989,4574,8563
2022-05-16,6호선,월곡,13691,13189,26880
2022-05-16,6호선,월드컵경기장,4405,4734,9139
2022-05-16,6호선,응암,18423,18043,36466
2022-05-16,6호선,이태원,10195,10426,20621
2022-05-16,6호선,증산,10747,10705,21452
2022-05-16,6호선,창신,3986,3305,7291
2022-05-16,6호선,청구,3737,4013,7750
2022-05-16,6호선,태릉입구,7181,8256,15437
2022-05-16,6호선,한강진,7500,8603,16103
2022-05-16,6호선,합정,13346,13071,26417
2022-05-16,6호선,화랑대,13219,10244,23463
2022-05-16,6호선,효창공원앞,7900,7366,15266
2022-05-16,7호선,가산디지털단지,48386,48602,96988
2022-05-16,7호선,강남구청,16759,18466,35225
2022-05-16,7호선,건대입구,13632,14204,27836
2022-05-16,7호선,고속터미널,17118,14008,31126
2022-05-16,7호선,공릉,13579,13382,26961
2022-05-16,7호선,광명사거리,23108,22723,45831
2022-05-16,7호선,군자,15436,12313,27749
2022-05-16,7호선,남구로,17040,17675,34715
2022-05-16,7호선,남성,12054,11124,23178
2022-05-16,7호선,내방,15499,15967,31466
2022-05-16,7호선,노원,20256,21458,41714
2022-05-16,7호선,논현,21623,23354,44977
2022-05-16,7호선,대림,8300,8174,16474
2022-05-16,7호선,도봉산,10397,11783,22180
2022-05-16,7호선,뚝섬유원지,10452,10179,20631
2022-05-16,7호선,마들,13751,12896,26647
2022-05-16,7호선,먹골,10877,10443,21320
2022-05-16,7호선,면목,17241,16566,33807
2022-05-16,7호선,반포,6238,6203,12441
2022-05-16,7호선,보라매,11239,11150,22389
2022-05-16,7호선,사가정,16999,17129,34128
2022-05-16,7호선,상도,12304,12120,24424
2022-05-16,7호선,상봉,17479,16291,33770
2022-05-16,7호선,수락산,13371,13159,26530
2022-05-16,7호선,숭실대입구,16324,16789,33113
2022-05-16,7호선,신대방삼거리,17921,17068,34989
2022-05-16,7호선,신풍,12497,11952,24449
2022-05-16,7호선,어린이대공원,17020,17610,34630
2022-05-16,7호선,온수,11820,11196,23016
2022-05-16,7호선,용마산,6485,6107,12592
2022-05-16,7호선,이수,16525,15973,32498
2022-05-16,7호선,장승배기,9647,9501,19148
2022-05-16,7호선,장암,2415,865,3280
2022-05-16,7호선,중계,15838,14587,30425
2022-05-16,7호선,중곡,11807,10989,22796
2022-05-16,7호선,중화,11713,11304,23017
2022-05-16,7호선,천왕,12363,11762,24125
2022-05-16,7호선,철산,22440,22717,45157
2022-05-16,7호선,청담,20716,23364,44080
2022-05-16,7호선,태릉입구,11145,10898,22043
2022-05-16,7호선,하계,18981,17757,36738
2022-05-16,7호선,학동,25824,27378,53202
2022-05-16,8호선,가락시장,7999,8992,16991
2022-05-16,8호선,강동구청,11069,11374,22443
2022-05-16,8호선,남위례,5555,5737,11292
2022-05-16,8호선,남한산성입구,16430,15346,31776
2022-05-16,8호선,단대오거리,12019,11410,23429
2022-05-16,8호선,모란,4618,3691,8309
2022-05-16,8호선,몽촌토성,6678,6818,13496
2022-05-16,8호선,문정,23298,24732,48030
2022-05-16,8호선,복정,10314,8888,19202
2022-05-16,8호선,산성,5775,5925,11700
2022-05-16,8호선,석촌,7960,8936,16896
2022-05-16,8호선,송파,8808,8589,17397
2022-05-16,8호선,수진,5600,5264,10864
2022-05-16,8호선,신흥,4413,4709,9122
2022-05-16,8호선,암사,20056,17403,37459
2022-05-16,8호선,잠실,13965,16717,30682
2022-05-16,8호선,장지,17686,16889,34575
2022-05-16,8호선,천호,15031,17462,32493
2022-05-16,9호선,가양,22377,21554,43931
2022-05-16,9호선,개화,2827,1927,4754
2022-05-16,9호선,고속터미널,13135,16151,29286
2022-05-16,9호선,공항시장,3156,3427,6583
2022-05-16,9호선,구반포,1353,1461,2814
2022-05-16,9호선,국회의사당,16669,17509,34178
2022-05-16,9호선,김포공항,7531,11047,18578
2022-05-16,9호선,노들,4673,3810,8483
2022-05-16,9호선,노량진,27728,27181,54909
2022-05-16,9호선,당산,19283,19510,38793
2022-05-16,9호선,동작,2152,1795,3947
2022-05-16,9호선,등촌,12158,11632,23790
2022-05-16,9호선,마곡나루,12634,12732,25366
2022-05-16,9호선,사평,3844,3746,7590
2022-05-16,9호선,샛강,6309,6719,13028
2022-05-16,9호선,선유도,9353,8972,18325
2022-05-16,9호선,신논현,33388,32755,66143
2022-05-16,9호선,신목동,4670,4077,8747
2022-05-16,9호선,신반포,3894,3878,7772
2022-05-16,9호선,신방화,7160,6851,14011
2022-05-16,9호선,양천향교,10513,10701,21214
2022-05-16,9호선,여의도,28282,28451,56733
2022-05-16,9호선,염창,18561,17856,36417
2022-05-16,9호선,증미,7807,7724,15531
2022-05-16,9호선,흑석,10096,10124,20220
2022-05-16,9호선2~3단계,둔촌오륜,1249,1135,2384
2022-05-16,9호선2~3단계,봉은사,16641,17095,33736
2022-05-16,9호선2~3단계,삼성중앙,7669,8173,15842
2022-05-16,9호선2~3단계,삼전,7338,6922,14260
2022-05-16,9호선2~3단계,석촌,8993,7825,16818
2022-05-16,9호선2~3단계,석촌고분,6330,6093,12423
2022-05-16,9호선2~3단계,선정릉,10494,11546,22040
2022-05-16,9호선2~3단계,송파나루,5088,5348,10436
2022-05-16,9호선2~3단계,언주,10849,11358,22207
2022-05-16,9호선2~3단계,올림픽공원,6756,6747,13503
2022-05-16,9호선2~3단계,종합운동장,4446,4494,8940
2022-05-16,9호선2~3단계,중앙보훈병원,12147,10656,22803
2022-05-16,9호선2~3단계,한성백제,2684,2433,5117
2022-05-16,경강선,경기광주,8603,7949,16552
2022-05-16,경강선,곤지암,2454,2446,4900
2022-05-16,경강선,부발,2216,2387,4603
2022-05-16,경강선,삼동,2684,2446,5130
2022-05-16,경강선,세종대왕릉,359,336,695
2022-05-16,경강선,신둔도예촌,1742,1596,3338
2022-05-16,경강선,여주,2732,2752,5484
2022-05-16,경강선,이매,1231,1072,2303
2022-05-16,경강선,이천,2796,2896,5692
2022-05-16,경강선,초월,3513,3382,6895
2022-05-16,경강선,판교,5388,5255,10643
2022-05-16,경부선,가산디지털단지,20172,23159,43331
2022-05-16,경부선,관악,8015,7554,15569
2022-05-16,경부선,광명,3737,3133,6870
2022-05-16,경부선,구로,19915,20121,40036
2022-05-16,경부선,군포,8285,8142,16427
2022-05-16,경부선,금정,29069,29425,58494
2022-05-16,경부선,금천구청,12820,12656,25476
2022-05-16,경부선,남영,10076,10933,21009
2022-05-16,경부선,노량진,8754,9045,17799
2022-05-16,경부선,당정,7887,7449,15336
2022-05-16,경부선,대방,14259,14770,29029
2022-05-16,경부선,독산,20166,20749,40915
2022-05-16,경부선,두정,8098,9449,17547
2022-05-16,경부선,명학,10977,10753,21730
2022-05-16,경부선,병점,18005,18039,36044
2022-05-16,경부선,서동탄,1620,1314,2934
2022-05-16,경부선,서울역,7539,2297,9836
2022-05-16,경부선,서정리,8349,8094,16443
2022-05-16,경부선,석수,10419,9398,19817
2022-05-16,경부선,성균관대,16588,16894,33482
2022-05-16,경부선,성환,7382,7364,14746
2022-05-16,경부선,세류,3451,2955,6406
2022-05-16,경부선,세마,3260,2948,6208
2022-05-16,경부선,송탄,4797,4602,9399
2022-05-16,경부선,수원,38684,40978,79662
2022-05-16,경부선,신길,10023,8683,18706
2022-05-16,경부선,신도림,4276,4507,8783
2022-05-16,경부선,안양,28735,28246,56981
2022-05-16,경부선,영등포,36771,38189,74960
2022-05-16,경부선,오산,11070,11174,22244
2022-05-16,경부선,오산대,4454,4192,8646
2022-05-16,경부선,용산,35696,37243,72939
2022-05-16,경부선,의왕,10504,10468,20972
2022-05-16,경부선,직산,891,866,1757
2022-05-16,경부선,진위,2032,1753,3785
2022-05-16,경부선,천안,7498,7314,14812
2022-05-16,경부선,평택,14074,14479,28553
2022-05-16,경부선,평택지제,4076,3988,8064
2022-05-16,경부선,화서,9077,8770,17847
2022-05-16,경원선,가능,7446,7022,14468
2022-05-16,경원선,광운대,9979,9936,19915
2022-05-16,경원선,녹양,4971,4721,9692
2022-05-16,경원선,녹천,5125,4257,9382
2022-05-16,경원선,덕계,3753,3394,7147
2022-05-16,경원선,덕정,6823,6582,13405
2022-05-16,경원선,도봉,6494,6112,12606
2022-05-16,경원선,도봉산,8306,5532,13838
2022-05-16,경원선,동두천,2871,3241,6112
2022-05-16,경원선,동두천중앙,3504,3231,6735
2022-05-16,경원선,망월사,10414,10486,20900
2022-05-16,경원선,방학,10576,10348,20924
2022-05-16,경원선,보산,1687,1410,3097
2022-05-16,경원선,서빙고,2218,2018,4236
2022-05-16,경원선,석계,9006,10207,19213
2022-05-16,경원선,소요산,3036,2462,5498
2022-05-16,경원선,신이문,8972,8166,17138
2022-05-16,경원선,양주,8852,8146,16998
2022-05-16,경원선,옥수,59,52,111
2022-05-16,경원선,왕십리,15397,16717,32114
2022-05-16,경원선,외대앞,9027,9280,18307
2022-05-16,경원선,월계,8771,8158,16929
2022-05-16,경원선,응봉,2133,1772,3905
2022-05-16,경원선,의정부,18529,19214,37743
2022-05-16,경원선,이촌,4216,3140,7356
2022-05-16,경원선,지행,7240,7268,14508
2022-05-16,경원선,청량리,16209,17424,33633
2022-05-16,경원선,한남,4434,4252,8686
2022-05-16,경원선,회룡,13805,13643,27448
2022-05-16,경의선,가좌,6264,5947,12211
2022-05-16,경의선,강매,3807,3262,7069
2022-05-16,경의선,곡산,737,770,1507
2022-05-16,경의선,공덕,3728,3463,7191
2022-05-16,경의선,금릉,5503,5228,10731
2022-05-16,경의선,금촌,7345,7269,14614
2022-05-16,경의선,능곡,4324,3833,8157
2022-05-16,경의선,디지털미디어시티,2881,2623,5504
2022-05-16,경의선,문산,5688,5514,11202
2022-05-16,경의선,백마,7866,7548,15414
2022-05-16,경의선,서강대,2418,2331,4749
2022-05-16,경의선,서울역,4979,6558,11537
2022-05-16,경의선,수색,3211,3364,6575
2022-05-16,경의선,신촌,985,1330,2315
2022-05-16,경의선,야당,8380,8215,16595
2022-05-16,경의선,운정,7971,7259,15230
2022-05-16,경의선,월롱,3309,3311,6620
2022-05-16,경의선,일산,10737,10397,21134
2022-05-16,경의선,임진강,15,6,21
2022-05-16,경의선,탄현,8734,8164,16898
2022-05-16,경의선,파주,1797,1305,3102
2022-05-16,경의선,풍산,6306,5747,12053
2022-05-16,경의선,행신,8916,8990,17906
2022-05-16,경의선,홍대입구,1758,2081,3839
2022-05-16,경의선,화전,3950,3738,7688
2022-05-16,경의선,효창공원앞,3463,3674,7137
2022-05-16,경인선,간석,6453,6098,12551
2022-05-16,경인선,개봉,23282,22534,45816
2022-05-16,경인선,구일,8028,7873,15901
2022-05-16,경인선,도원,3703,3673,7376
2022-05-16,경인선,도화,4600,4213,8813
2022-05-16,경인선,동암,15701,15545,31246
2022-05-16,경인선,동인천,14565,14013,28578
2022-05-16,경인선,백운,7792,7661,15453
2022-05-16,경인선,부개,9476,8717,18193
2022-05-16,경인선,부천,35008,34661,69669
2022-05-16,경인선,부평,30351,31793,62144
2022-05-16,경인선,소사,9997,9570,19567
2022-05-16,경인선,송내,29825,29740,59565
2022-05-16,경인선,역곡,31229,30622,61851
2022-05-16,경인선,오류동,12757,11875,24632
2022-05-16,경인선,온수,7795,7471,15266
2022-05-16,경인선,인천,4077,3102,7179
2022-05-16,경인선,제물포,12324,11699,24023
2022-05-16,경인선,주안,21375,19452,40827
2022-05-16,경인선,중동,10268,9706,19974
2022-05-16,경춘선,가평,1899,1784,3683
2022-05-16,경춘선,갈매,3351,2937,6288
2022-05-16,경춘선,강촌,443,457,900
2022-05-16,경춘선,굴봉산,182,159,341
2022-05-16,경춘선,금곡,1770,1630,3400
2022-05-16,경춘선,김유정,374,356,730
2022-05-16,경춘선,남춘천,2704,3083,5787
2022-05-16,경춘선,대성리,652,556,1208
2022-05-16,경춘선,마석,4500,4302,8802
2022-05-16,경춘선,백양리,85,84,169
2022-05-16,경춘선,별내,3558,3275,6833
2022-05-16,경춘선,사릉,2874,2751,5625
2022-05-16,경춘선,상천,342,314,656
2022-05-16,경춘선,신내,2578,2361,4939
2022-05-16,경춘선,천마산,1951,1779,3730
2022-05-16,경춘선,청평,1894,1723,3617
2022-05-16,경춘선,춘천,1760,1892,3652
2022-05-16,경춘선,퇴계원,3985,3582,7567
2022-05-16,경춘선,평내호평,7284,6882,14166
2022-05-16,공항철도,검암,7132,7119,14251
2022-05-16,공항철도,계양,11659,10898,22557
2022-05-16,공항철도,공덕,2414,3178,5592
2022-05-16,공항철도,공항화물청사,2368,2550,4918
2022-05-16,공항철도,김포공항,12802,7275,20077
2022-05-16,공항철도,디지털미디어시티,15410,14528,29938
2022-05-16,공항철도,마곡나루,10459,10189,20648
2022-05-16,공항철도,서울역,8737,8234,16971
2022-05-16,공항철도,영종,3533,3428,6961
2022-05-16,공항철도,운서,7437,7445,14882
2022-05-16,공항철도,인천공항1터미널,5746,5470,11216
2022-05-16,공항철도,인천공항2터미널,3313,2823,6136
2022-05-16,공항철도,청라국제도시,7810,7278,15088
2022-05-16,공항철도,홍대입구,10068,10247,20315
2022-05-16,과천선,경마공원,1006,976,1982
2022-05-16,과천선,과천,6890,6300,13190
2022-05-16,과천선,대공원,4526,4665,9191
2022-05-16,과천선,범계,27827,27837,55664
2022-05-16,과천선,선바위,9196,8150,17346
2022-05-16,과천선,인덕원,26219,27072,53291
2022-05-16,과천선,정부과천청사,11630,11471,23101
2022-05-16,과천선,평촌,19399,19024,38423
2022-05-16,분당선,가천대,13682,14823,28505
2022-05-16,분당선,강남구청,10782,12491,23273
2022-05-16,분당선,개포동,4265,4370,8635
2022-05-16,분당선,구룡,2674,2463,5137
2022-05-16,분당선,구성,5730,5787,11517
2022-05-16,분당선,기흥,11336,10657,21993
2022-05-16,분당선,대모산입구,5036,4651,9687
2022-05-16,분당선,도곡,7712,7669,15381
2022-05-16,분당선,망포,15804,14937,30741
2022-05-16,분당선,매교,3470,3448,6918
2022-05-16,분당선,매탄권선,5673,5489,11162
2022-05-16,분당선,모란,21033,21291,42324
2022-05-16,분당선,미금,16776,17708,34484
2022-05-16,분당선,보정,2864,2523,5387
2022-05-16,분당선,복정,1,0,1
2022-05-16,분당선,상갈,6016,5736,11752
2022-05-16,분당선,서울숲,12129,12278,24407
2022-05-16,분당선,서현,25596,26046,51642
2022-05-16,분당선,선릉,14383,22413,36796
2022-05-16,분당선,선정릉,8709,9321,18030
2022-05-16,분당선,수내,14228,14134,28362
2022-05-16,분당선,수서,14811,14948,29759
2022-05-16,분당선,수원,8868,7446,16314
2022-05-16,분당선,수원시청,13435,14192,27627
2022-05-16,분당선,신갈,4941,4899,9840
2022-05-16,분당선,압구정로데오,18293,20255,38548
2022-05-16,분당선,야탑,27610,28954,56564
2022-05-16,분당선,영통,8576,8866,17442
2022-05-16,분당선,오리,12317,10073,22390
2022-05-16,분당선,이매,6313,5799,12112
2022-05-16,분당선,정자,18865,19885,38750
2022-05-16,분당선,죽전,14166,15822,29988
2022-05-16,분당선,청명,4702,4530,9232
2022-05-16,분당선,태평,14119,13512,27631
2022-05-16,분당선,한티,14844,16119,30963
2022-05-16,수인선,고색,5220,5142,10362
2022-05-16,수인선,남동인더스파크,2316,2595,4911
2022-05-16,수인선,달월,142,107,249
2022-05-16,수인선,사리,5587,4879,10466
2022-05-16,수인선,소래포구,7643,7153,14796
2022-05-16,수인선,송도,2811,2559,5370
2022-05-16,수인선,숭의,4456,4144,8600
2022-05-16,수인선,신포,2103,2069,4172
2022-05-16,수인선,야목,430,305,735
2022-05-16,수인선,어천,866,921,1787
2022-05-16,수인선,연수,5014,4843,9857
2022-05-16,수인선,오목천,4283,3897,8180
2022-05-16,수인선,원인재,4853,5074,9927
2022-05-16,수인선,월곶,2980,2713,5693
2022-05-16,수인선,인천,1130,1772,2902
2022-05-16,수인선,인천논현,5944,6323,12267
2022-05-16,수인선,인하대,8126,7836,15962
2022-05-16,수인선,호구포,4386,4645,9031
2022-05-16,안산선,고잔,9927,9427,19354
2022-05-16,안산선,대야미,5450,4933,10383
2022-05-16,안산선,반월,4731,4629,9360
2022-05-16,안산선,산본,17063,18363,35426
2022-05-16,안산선,상록수,17796,18007,35803
2022-05-16,안산선,수리산,4707,3857,8564
2022-05-16,안산선,신길온천,2039,1825,3864
2022-05-16,안산선,안산,12600,11294,23894
2022-05-16,안산선,오이도,9520,9121,18641
2022-05-16,안산선,정왕,10772,11667,22439
2022-05-16,안산선,중앙,19966,20550,40516
2022-05-16,안산선,초지,5752,6133,11885
2022-05-16,안산선,한대앞,11136,11300,22436
2022-05-16,우이신설선,4.19민주묘지,4097,4052,8149
2022-05-16,우이신설선,가오리,4573,4447,9020
2022-05-16,우이신설선,보문,1628,1660,3288
2022-05-16,우이신설선,북한산보국문,6481,6270,12751
2022-05-16,우이신설선,북한산우이,2848,2645,5493
2022-05-16,우이신설선,삼양,2128,2278,4406
2022-05-16,우이신설선,삼양사거리,2661,2611,5272
2022-05-16,우이신설선,성신여대입구,3475,3938,7413
2022-05-16,우이신설선,솔밭공원,2683,2571,5254
2022-05-16,우이신설선,솔샘,6423,5919,12342
2022-05-16,우이신설선,신설동,2253,2184,4437
2022-05-16,우이신설선,정릉,5184,4629,9813
2022-05-16,우이신설선,화계,3654,3323,6977
2022-05-16,일산선,대곡,2495,1986,4481
2022-05-16,일산선,대화,14079,10885,24964
2022-05-16,일산선,마두,8208,8390,16598
2022-05-16,일산선,백석,10486,10447,20933
2022-05-16,일산선,삼송,21299,20486,41785
2022-05-16,일산선,원당,12311,11438,23749
2022-05-16,일산선,원흥,12027,11392,23419
2022-05-16,일산선,정발산,7466,7525,14991
2022-05-16,일산선,주엽,10399,10152,20551
2022-05-16,일산선,화정,18493,18771,37264
2022-05-16,장항선,배방,1298,1223,2521
2022-05-16,장항선,봉명,1427,1400,2827
2022-05-16,장항선,신창,3028,3689,6717
2022-05-16,장항선,쌍용,3264,3323,6587
2022-05-16,장항선,아산,4395,3747,8142
2022-05-16,장항선,온양온천,4308,4297,8605
2022-05-16,장항선,탕정,940,867,1807
2022-05-16,중앙선,구리,14591,14576,29167
2022-05-16,중앙선,국수,900,879,1779
2022-05-16,중앙선,덕소,6128,6147,12275
2022-05-16,중앙선,도농,12277,10895,23172
2022-05-16,중앙선,도심,2795,2112,4907
2022-05-16,중앙선,망우,8296,8129,16425
2022-05-16,중앙선,상봉,6136,6133,12269
2022-05-16,중앙선,신원,241,221,462
2022-05-16,중앙선,아신,600,580,1180
2022-05-16,중앙선,양수,2305,2297,4602
2022-05-16,중앙선,양원,3258,3220,6478
2022-05-16,중앙선,양정,823,718,1541
2022-05-16,중앙선,양평,3126,3133,6259
2022-05-16,중앙선,오빈,347,314,661
2022-05-16,중앙선,용문,2104,2064,4168
2022-05-16,중앙선,운길산,1016,934,1950
2022-05-16,중앙선,원덕,446,400,846
2022-05-16,중앙선,중랑,6200,5955,12155
2022-05-16,중앙선,지평,85,95,180
2022-05-16,중앙선,팔당,865,914,1779
2022-05-16,중앙선,회기,27620,27291,54911
2022-05-17,1호선,동대문,11548,11101,22649
2022-05-17,1호선,동묘앞,8443,8820,17263
2022-05-17,1호선,서울역,47179,45823,93002
2022-05-17,1호선,시청,25334,25398,50732
2022-05-17,1호선,신설동,14433,14243,28676
2022-05-17,1호선,제기동,18480,18859,37339
2022-05-17,1호선,종각,37766,37016,74782
2022-05-17,1호선,종로3가,27499,24737,52236
2022-05-17,1호선,종로5가,24796,23392,48188
2022-05-17,1호선,청량리,21477,21220,42697
2022-05-17,2호선,강남,88303,88202,176505
2022-05-17,2호선,강변,31770,29726,61496
2022-05-17,2호선,건대입구,36941,39868,76809
2022-05-17,2호선,교대,37527,42918,80445
2022-05-17,2호선,구로디지털단지,63928,64152,128080
2022-05-17,2호선,구의,25138,24420,49558
2022-05-17,2호선,낙성대,29476,28761,58237
2022-05-17,2호선,당산,20921,24226,45147
2022-05-17,2호선,대림,25438,25957,51395
2022-05-17,2호선,도림천,1452,1534,2986
2022-05-17,2호선,동대문역사문화공원,12533,14147,26680
2022-05-17,2호선,뚝섬,23651,25753,49404
2022-05-17,2호선,문래,23790,24466,48256
2022-05-17,2호선,방배,21276,22300,43576
2022-05-17,2호선,봉천,25541,23310,48851
2022-05-17,2호선,사당,41212,45344,86556
2022-05-17,2호선,삼성,54511,56179,110690
2022-05-17,2호선,상왕십리,15490,14913,30403
2022-05-17,2호선,서울대입구,51305,50530,101835
2022-05-17,2호선,서초,23361,22830,46191
2022-05-17,2호선,선릉,62343,55604,117947
2022-05-17,2호선,성수,39352,43320,82672
2022-05-17,2호선,시청,25769,25387,51156
2022-05-17,2호선,신답,1787,2003,3790
2022-05-17,2호선,신당,14969,15313,30282
2022-05-17,2호선,신대방,28615,27785,56400
2022-05-17,2호선,신도림,51125,50617,101742
2022-05-17,2호선,신림,66735,64527,131262
2022-05-17,2호선,신설동,3336,3321,6657
2022-05-17,2호선,신정네거리,11284,11500,22784
2022-05-17,2호선,신촌,35480,36585,72065
2022-05-17,2호선,아현,11634,10961,22595
2022-05-17,2호선,양천구청,7509,7707,15216
2022-05-17,2호선,역삼,57142,65674,122816
2022-05-17,2호선,영등포구청,23888,24819,48707
2022-05-17,2호선,왕십리,18323,14655,32978
2022-05-17,2호선,용답,3351,3406,6757
2022-05-17,2호선,용두,2550,2533,5083
2022-05-17,2호선,을지로3가,24596,24910,49506
2022-05-17,2호선,을지로4가,14206,14285,28491
2022-05-17,2호선,을지로입구,42004,44231,86235
2022-05-17,2호선,이대,15370,16452,31822
2022-05-17,2호선,잠실,71882,71635,143517
2022-05-17,2호선,잠실나루,16423,16044,32467
2022-05-17,2호선,잠실새내,22665,22453,45118
2022-05-17,2호선,종합운동장,11446,12961,24407
2022-05-17,2호선,충정로,10878,11462,22340
2022-05-17,2호선,한양대,15877,17610,33487
2022-05-17,2호선,합정,31635,33583,65218
2022-05-17,2호선,홍대입구,55921,58779,114700
2022-05-17,3호선,가락시장,9760,9520,19280
2022-05-17,3호선,경복궁,28914,31104,60018
2022-05-17,3호선,경찰병원,7945,7877,15822
2022-05-17,3호선,고속터미널,42076,40063,82139
2022-05-17,3호선,교대,16375,10693,27068
2022-05-17,3호선,구파발,23154,21998,45152
2022-05-17,3호선,금호,8490,7788,16278
2022-05-17,3호선,남부터미널,30779,31598,62377
2022-05-17,3호선,녹번,17119,15415,32534
2022-05-17,3호선,대청,11202,10271,21473
2022-05-17,3호선,대치,12184,12167,24351
2022-05-17,3호선,도곡,6058,6045,12103
2022-05-17,3호선,독립문,7898,8291,16189
2022-05-17,3호선,동대입구,10262,11089,21351
2022-05-17,3호선,매봉,13805,13304,27109
2022-05-17,3호선,무악재,4343,4452,8795
2022-05-17,3호선,불광,17538,18773,36311
2022-05-17,3호선,수서,18164,18433,36597
2022-05-17,3호선,신사,32430,34237,66667
2022-05-17,3호선,안국,25366,26048,51414
2022-05-17,3호선,압구정,34221,36857,71078
2022-05-17,3호선,약수,14153,13697,27850
2022-05-17,3호선,양재,42210,46570,88780
2022-05-17,3호선,연신내,38768,36369,75137
2022-05-17,3호선,오금,7006,6363,13369
2022-05-17,3호선,옥수,9776,10116,19892
2022-05-17,3호선,을지로3가,11401,11812,23213
2022-05-17,3호선,일원,11784,11383,23167
2022-05-17,3호선,잠원,5347,5240,10587
2022-05-17,3호선,종로3가,10596,12232,22828
2022-05-17,3호선,지축,5493,5221,10714
2022-05-17,3호선,충무로,1,0,1
2022-05-17,3호선,학여울,2061,2060,4121
2022-05-17,3호선,홍제,19426,18159,37585
2022-05-17,4호선,길음,24087,24009,48096
2022-05-17,4호선,남태령,1395,1228,2623
2022-05-17,4호선,노원,20101,22759,42860
2022-05-17,4호선,당고개,9788,8661,18449
2022-05-17,4호선,동대문,21410,21984,43394
2022-05-17,4호선,동대문역사문화공원,15453,13966,29419
2022-05-17,4호선,동작,1931,2147,4078
2022-05-17,4호선,명동,21895,22694,44589
2022-05-17,4호선,미아,16610,15856,32466
2022-05-17,4호선,미아사거리,29048,28170,57218
2022-05-17,4호선,사당,28085,24152,52237
2022-05-17,4호선,삼각지,5631,6294,11925
2022-05-17,4호선,상계,20914,19121,40035
2022-05-17,4호선,서울역,12671,18282,30953
2022-05-17,4호선,성신여대입구,22276,21055,43331
2022-05-17,4호선,수유,35861,35827,71688
2022-05-17,4호선,숙대입구,15503,15234,30737
2022-05-17,4호선,신용산,18118,19460,37578
2022-05-17,4호선,쌍문,31428,28746,60174
2022-05-17,4호선,이촌,9256,10176,19432
2022-05-17,4호선,창동,27425,28960,56385
2022-05-17,4호선,총신대입구,20582,22028,42610
2022-05-17,4호선,충무로,30321,31873,62194
2022-05-17,4호선,한성대입구,16000,15444,31444
2022-05-17,4호선,혜화,35717,35847,71564
2022-05-17,4호선,회현,27847,29638,57485
2022-05-17,5호선,강동,20000,19260,39260
2022-05-17,5호선,강일,4990,4500,9490
2022-05-17,5호선,개롱,7164,7362,14526
2022-05-17,5호선,개화산,6157,5824,11981
2022-05-17,5호선,거여,11652,11072,22724
2022-05-17,5호선,고덕,10704,10638,21342
2022-05-17,5호선,공덕,15755,16511,32266
2022-05-17,5호선,광나루,15059,13578,28637
2022-05-17,5호선,광화문,32746,34867,67613
2022-05-17,5호선,군자,12049,13255,25304
2022-05-17,5호선,굽은다리,10324,9752,20076
2022-05-17,5호선,길동,8647,8870,17517
2022-05-17,5호선,김포공항,7298,7006,14304
2022-05-17,5호선,까치산,31053,29582,60635
2022-05-17,5호선,답십리,16901,15426,32327
2022-05-17,5호선,동대문역사문화공원,3111,3567,6678
2022-05-17,5호선,둔촌동,8904,8896,17800
2022-05-17,5호선,마곡,11546,11659,23205
2022-05-17,5호선,마장,6311,5959,12270
2022-05-17,5호선,마천,8012,7565,15577
2022-05-17,5호선,마포,15596,16081,31677
2022-05-17,5호선,명일,9493,9848,19341
2022-05-17,5호선,목동,18242,19409,37651
2022-05-17,5호선,미사,17341,17210,34551
2022-05-17,5호선,발산,22347,22994,45341
2022-05-17,5호선,방이,7720,7893,15613
2022-05-17,5호선,방화,7370,7008,14378
2022-05-17,5호선,상일동,16474,15292,31766
2022-05-17,5호선,서대문,22223,22769,44992
2022-05-17,5호선,송정,7071,6655,13726
2022-05-17,5호선,신금호,7177,7407,14584
2022-05-17,5호선,신길,4511,4747,9258
2022-05-17,5호선,신정,15048,11998,27046
2022-05-17,5호선,아차산,16636,15918,32554
2022-05-17,5호선,애오개,7440,7433,14873
2022-05-17,5호선,양평,8030,7845,15875
2022-05-17,5호선,여의나루,14373,15589,29962
2022-05-17,5호선,여의도,30415,33094,63509
2022-05-17,5호선,영등포구청,4315,4493,8808
2022-05-17,5호선,영등포시장,10601,10808,21409
2022-05-17,5호선,오금,4210,4196,8406
2022-05-17,5호선,오목교,23001,24803,47804
2022-05-17,5호선,올림픽공원,5215,4632,9847
2022-05-17,5호선,왕십리,4710,5646,10356
2022-05-17,5호선,우장산,16145,15801,31946
2022-05-17,5호선,을지로4가,6663,6773,13436
2022-05-17,5호선,장한평,19434,19080,38514
2022-05-17,5호선,종로3가,13581,13546,27127
2022-05-17,5호선,천호,19302,19454,38756
2022-05-17,5호선,청구,4470,4006,8476
2022-05-17,5호선,충정로,5214,5273,10487
2022-05-17,5호선,하남검단산,6232,5865,12097
2022-05-17,5호선,하남시청,7521,7314,14835
2022-05-17,5호선,하남풍산,4645,4507,9152
2022-05-17,5호선,행당,8997,7871,16868
2022-05-17,5호선,화곡,30670,28331,59001
2022-05-17,6호선,고려대,9779,9464,19243
2022-05-17,6호선,공덕,20490,19817,40307
2022-05-17,6호선,광흥창,10064,9532,19596
2022-05-17,6호선,구산,8299,6031,14330
2022-05-17,6호선,녹사평,5173,5177,10350
2022-05-17,6호선,대흥,9393,9779,19172
2022-05-17,6호선,독바위,2997,3185,6182
2022-05-17,6호선,돌곶이,10203,9453,19656
2022-05-17,6호선,동묘앞,8284,8542,16826
2022-05-17,6호선,디지털미디어시티,15560,17107,32667
2022-05-17,6호선,마포구청,15502,13648,29150
2022-05-17,6호선,망원,14582,15566,30148
2022-05-17,6호선,버티고개,2398,2443,4841
2022-05-17,6호선,보문,8057,7330,15387
2022-05-17,6호선,봉화산,9802,9147,18949
2022-05-17,6호선,불광,4470,4552,9022
2022-05-17,6호선,삼각지,8305,7274,15579
2022-05-17,6호선,상수,9363,10758,20121
2022-05-17,6호선,상월곡,7049,6499,13548
2022-05-17,6호선,새절,14406,13237,27643
2022-05-17,6호선,석계,13722,14276,27998
2022-05-17,6호선,신당,8811,9488,18299
2022-05-17,6호선,안암,15368,15522,30890
2022-05-17,6호선,약수,3953,3880,7833
2022-05-17,6호선,역촌,4036,4578,8614
2022-05-17,6호선,연신내,1,0,1
2022-05-17,6호선,월곡,13595,13218,26813
2022-05-17,6호선,월드컵경기장,4619,4978,9597
2022-05-17,6호선,응암,18907,18403,37310
2022-05-17,6호선,이태원,10309,10893,21202
2022-05-17,6호선,증산,10834,10756,21590
2022-05-17,6호선,창신,4037,3372,7409
2022-05-17,6호선,청구,3969,4118,8087
2022-05-17,6호선,태릉입구,7394,8664,16058
2022-05-17,6호선,한강진,9011,10445,19456
2022-05-17,6호선,합정,13568,13417,26985
2022-05-17,6호선,화랑대,14141,11040,25181
2022-05-17,6호선,효창공원앞,8155,7442,15597
2022-05-17,7호선,가산디지털단지,48454,48795,97249
2022-05-17,7호선,강남구청,17530,19433,36963
2022-05-17,7호선,건대입구,13579,14125,27704
2022-05-17,7호선,고속터미널,16278,14250,30528
2022-05-17,7호선,공릉,13833,13580,27413
2022-05-17,7호선,광명사거리,23665,23114,46779
2022-05-17,7호선,군자,16040,12699,28739
2022-05-17,7호선,남구로,16824,17698,34522
2022-05-17,7호선,남성,12438,11420,23858
2022-05-17,7호선,내방,15991,16433,32424
2022-05-17,7호선,노원,20481,21604,42085
2022-05-17,7호선,논현,22252,24195,46447
2022-05-17,7호선,대림,8189,8184,16373
2022-05-17,7호선,도봉산,10709,12145,22854
2022-05-17,7호선,뚝섬유원지,11263,10788,22051
2022-05-17,7호선,마들,14147,13270,27417
2022-05-17,7호선,먹골,11230,10717,21947
2022-05-17,7호선,면목,17857,17130,34987
2022-05-17,7호선,반포,6337,6039,12376
2022-05-17,7호선,보라매,11313,11401,22714
2022-05-17,7호선,사가정,17482,17378,34860
2022-05-17,7호선,상도,12565,12253,24818
2022-05-17,7호선,상봉,17884,16633,34517
2022-05-17,7호선,수락산,13777,13402,27179
2022-05-17,7호선,숭실대입구,16851,17460,34311
2022-05-17,7호선,신대방삼거리,18237,17342,35579
2022-05-17,7호선,신풍,12565,11901,24466
2022-05-17,7호선,어린이대공원,17269,17702,34971
2022-05-17,7호선,온수,12008,11289,23297
2022-05-17,7호선,용마산,6613,6260,12873
2022-05-17,7호선,이수,17019,16536,33555
2022-05-17,7호선,장승배기,9800,9475,19275
2022-05-17,7호선,장암,2521,959,3480
2022-05-17,7호선,중계,16211,14770,30981
2022-05-17,7호선,중곡,11856,10951,22807
2022-05-17,7호선,중화,12241,11692,23933
2022-05-17,7호선,천왕,12595,12060,24655
2022-05-17,7호선,철산,23148,23636,46784
2022-05-17,7호선,청담,21338,24033,45371
2022-05-17,7호선,태릉입구,11742,11493,23235
2022-05-17,7호선,하계,19273,18070,37343
2022-05-17,7호선,학동,26503,28213,54716
2022-05-17,8호선,가락시장,8029,9039,17068
2022-05-17,8호선,강동구청,11209,11501,22710
2022-05-17,8호선,남위례,5851,6117,11968
2022-05-17,8호선,남한산성입구,17124,15853,32977
2022-05-17,8호선,단대오거리,12151,11480,23631
2022-05-17,8호선,모란,4652,3780,8432
2022-05-17,8호선,몽촌토성,7256,7240,14496
2022-05-17,8호선,문정,23323,24829,48152
2022-05-17,8호선,복정,11101,9429,20530
2022-05-17,8호선,산성,5896,5958,11854
2022-05-17,8호선,석촌,8233,9370,17603
2022-05-17,8호선,송파,9018,8850,17868
2022-05-17,8호선,수진,5646,5131,10777
2022-05-17,8호선,신흥,4426,4660,9086
2022-05-17,8호선,암사,20467,17781,38248
2022-05-17,8호선,잠실,13791,17011,30802
2022-05-17,8호선,장지,18352,17470,35822
2022-05-17,8호선,천호,15584,17790,33374
2022-05-17,9호선,가양,22768,21965,44733
2022-05-17,9호선,개화,2974,2112,5086
2022-05-17,9호선,고속터미널,13707,16566,30273
2022-05-17,9호선,공항시장,3181,3356,6537
2022-05-17,9호선,구반포,1356,1444,2800
2022-05-17,9호선,국회의사당,17213,18101,35314
2022-05-17,9호선,김포공항,7422,11126,18548
2022-05-17,9호선,노들,4855,4090,8945
2022-05-17,9호선,노량진,28186,27268,55454
2022-05-17,9호선,당산,20020,20279,40299
2022-05-17,9호선,동작,2308,1861,4169
2022-05-17,9호선,등촌,12198,11608,23806
2022-05-17,9호선,마곡나루,13291,13201,26492
2022-05-17,9호선,사평,3993,3754,7747
2022-05-17,9호선,샛강,6614,6923,13537
2022-05-17,9호선,선유도,9618,9106,18724
2022-05-17,9호선,신논현,34075,34014,68089
2022-05-17,9호선,신목동,4650,4010,8660
2022-05-17,9호선,신반포,4070,3996,8066
2022-05-17,9호선,신방화,7323,6931,14254
2022-05-17,9호선,양천향교,10749,10836,21585
2022-05-17,9호선,여의도,30043,29970,60013
2022-05-17,9호선,염창,19012,18216,37228
2022-05-17,9호선,증미,7976,7695,15671
2022-05-17,9호선,흑석,9933,10122,20055
2022-05-17,9호선2~3단계,둔촌오륜,1292,1118,2410
2022-05-17,9호선2~3단계,봉은사,17523,17883,35406
2022-05-17,9호선2~3단계,삼성중앙,7745,8145,15890
2022-05-17,9호선2~3단계,삼전,7371,7064,14435
2022-05-17,9호선2~3단계,석촌,9337,8033,17370
2022-05-17,9호선2~3단계,석촌고분,6599,6227,12826
2022-05-17,9호선2~3단계,선정릉,10769,11978,22747
2022-05-17,9호선2~3단계,송파나루,5253,5555,10808
2022-05-17,9호선2~3단계,언주,11394,11717,23111
2022-05-17,9호선2~3단계,올림픽공원,6939,7071,14010
2022-05-17,9호선2~3단계,종합운동장,4497,4581,9078
2022-05-17,9호선2~3단계,중앙보훈병원,12130,10763,22893
2022-05-17,9호선2~3단계,한성백제,2850,2521,5371
2022-05-17,경강선,경기광주,8717,8191,16908
2022-05-17,경강선,곤지암,2524,2477,5001
2022-05-17,경강선,부발,2302,2307,4609
2022-05-17,경강선,삼동,2768,2436,5204
2022-05-17,경강선,세종대왕릉,352,374,726
2022-05-17,경강선,신둔도예촌,1800,1633,3433
2022-05-17,경강선,여주,2823,2657,5480
2022-05-17,경강선,이매,1290,1125,2415
2022-05-17,경강선,이천,2845,2950,5795
2022-05-17,경강선,초월,3538,3354,6892
2022-05-17,경강선,판교,5418,5343,10761
2022-05-17,경부선,가산디지털단지,20184,23278,43462
2022-05-17,경부선,관악,8275,7700,15975
2022-05-17,경부선,광명,3641,3113,6754
2022-05-17,경부선,구로,19633,20358,39991
2022-05-17,경부선,군포,8391,8243,16634
2022-05-17,경부선,금정,29689,29975,59664
2022-05-17,경부선,금천구청,12848,12886,25734
2022-05-17,경부선,남영,10329,10801,21130
2022-05-17,경부선,노량진,8935,9064,17999
2022-05-17,경부선,당정,7888,7607,15495
2022-05-17,경부선,대방,14392,14895,29287
2022-05-17,경부선,독산,20425,20955,41380
2022-05-17,경부선,두정,8299,9024,17323
2022-05-17,경부선,명학,11570,11572,23142
2022-05-17,경부선,병점,17934,17781,35715
2022-05-17,경부선,서동탄,1601,1403,3004
2022-05-17,경부선,서울역,6363,2065,8428
2022-05-17,경부선,서정리,8429,7992,16421
2022-05-17,경부선,석수,10730,9703,20433
2022-05-17,경부선,성균관대,16836,16709,33545
2022-05-17,경부선,성환,6856,6729,13585
2022-05-17,경부선,세류,3391,3188,6579
2022-05-17,경부선,세마,3184,2982,6166
2022-05-17,경부선,송탄,4622,4434,9056
2022-05-17,경부선,수원,38728,41192,79920
2022-05-17,경부선,신길,10063,8674,18737
2022-05-17,경부선,신도림,4322,4672,8994
2022-05-17,경부선,안양,28869,28404,57273
2022-05-17,경부선,영등포,38929,39878,78807
2022-05-17,경부선,오산,11185,10980,22165
2022-05-17,경부선,오산대,4827,4544,9371
2022-05-17,경부선,용산,35224,36056,71280
2022-05-17,경부선,의왕,10811,10624,21435
2022-05-17,경부선,직산,923,907,1830
2022-05-17,경부선,진위,1991,1844,3835
2022-05-17,경부선,천안,7191,7006,14197
2022-05-17,경부선,평택,13752,13875,27627
2022-05-17,경부선,평택지제,3934,3906,7840
2022-05-17,경부선,화서,9715,9182,18897
2022-05-17,경원선,가능,7656,7292,14948
2022-05-17,경원선,광운대,9718,9527,19245
2022-05-17,경원선,녹양,5076,4742,9818
2022-05-17,경원선,녹천,5211,4376,9587
2022-05-17,경원선,덕계,3826,3442,7268
2022-05-17,경원선,덕정,6900,6729,13629
2022-05-17,경원선,도봉,6653,6350,13003
2022-05-17,경원선,도봉산,8638,5875,14513
2022-05-17,경원선,동두천,2539,2921,5460
2022-05-17,경원선,동두천중앙,3515,3356,6871
2022-05-17,경원선,망월사,10401,10507,20908
2022-05-17,경원선,방학,10726,10556,21282
2022-05-17,경원선,보산,1631,1497,3128
2022-05-17,경원선,서빙고,2278,2132,4410
2022-05-17,경원선,석계,9195,10119,19314
2022-05-17,경원선,소요산,2976,2574,5550
2022-05-17,경원선,신이문,9053,8323,17376
2022-05-17,경원선,양주,8829,8215,17044
2022-05-17,경원선,옥수,54,54,108
2022-05-17,경원선,왕십리,15581,16811,32392
2022-05-17,경원선,외대앞,9124,9134,18258
2022-05-17,경원선,월계,9125,8420,17545
2022-05-17,경원선,응봉,2142,1837,3979
2022-05-17,경원선,의정부,19641,20149,39790
2022-05-17,경원선,이촌,4125,3155,7280
2022-05-17,경원선,지행,7498,7607,15105
2022-05-17,경원선,청량리,15775,16772,32547
2022-05-17,경원선,한남,4550,4270,8820
2022-05-17,경원선,회룡,14058,13830,27888
2022-05-17,경의선,가좌,6376,5973,12349
2022-05-17,경의선,강매,3751,3274,7025
2022-05-17,경의선,계양,1,0,1
2022-05-17,경의선,곡산,723,762,1485
2022-05-17,경의선,공덕,3789,3513,7302
2022-05-17,경의선,금릉,5448,5320,10768
2022-05-17,경의선,금촌,7101,6784,13885
2022-05-17,경의선,능곡,4383,3942,8325
2022-05-17,경의선,디지털미디어시티,3008,2735,5743
2022-05-17,경의선,문산,5593,5420,11013
2022-05-17,경의선,백마,7982,7701,15683
2022-05-17,경의선,서강대,2418,2433,4851
2022-05-17,경의선,서울역,4958,6668,11626
2022-05-17,경의선,수색,3211,3462,6673
2022-05-17,경의선,신촌,990,1347,2337
2022-05-17,경의선,야당,8606,8518,17124
2022-05-17,경의선,운정,7902,7261,15163
2022-05-17,경의선,월롱,3453,3209,6662
2022-05-17,경의선,일산,10726,10453,21179
2022-05-17,경의선,임진강,63,60,123
2022-05-17,경의선,탄현,8851,8322,17173
2022-05-17,경의선,파주,1771,1305,3076
2022-05-17,경의선,풍산,6385,5883,12268
2022-05-17,경의선,행신,9013,9078,18091
2022-05-17,경의선,홍대입구,1838,2101,3939
2022-05-17,경의선,화전,3901,3643,7544
2022-05-17,경의선,효창공원앞,3476,3865,7341
2022-05-17,경인선,간석,6523,6161,12684
2022-05-17,경인선,개봉,23502,23225,46727
2022-05-17,경인선,구일,8261,8084,16345
2022-05-17,경인선,도원,4592,4641,9233
2022-05-17,경인선,도화,4643,4288,8931
2022-05-17,경인선,동암,16296,16262,32558
2022-05-17,경인선,동인천,14728,14260,28988
2022-05-17,경인선,백운,7768,7566,15334
2022-05-17,경인선,부개,9606,8825,18431
2022-05-17,경인선,부천,34526,34445,68971
2022-05-17,경인선,부평,30499,32515,63014
2022-05-17,경인선,소사,9817,9667,19484
2022-05-17,경인선,송내,30736,30622,61358
2022-05-17,경인선,역곡,31816,31069,62885
2022-05-17,경인선,오류동,13083,12008,25091
2022-05-17,경인선,온수,8073,7617,15690
2022-05-17,경인선,인천,4674,3499,8173
2022-05-17,경인선,제물포,12634,12136,24770
2022-05-17,경인선,주안,21361,19515,40876
2022-05-17,경인선,중동,10419,9729,20148
2022-05-17,경춘선,가평,1991,1984,3975
2022-05-17,경춘선,갈매,3406,2953,6359
2022-05-17,경춘선,강촌,548,521,1069
2022-05-17,경춘선,굴봉산,168,147,315
2022-05-17,경춘선,금곡,1838,1760,3598
2022-05-17,경춘선,김유정,438,491,929
2022-05-17,경춘선,남춘천,3499,3463,6962
2022-05-17,경춘선,대성리,696,584,1280
2022-05-17,경춘선,마석,4679,4495,9174
2022-05-17,경춘선,백양리,83,78,161
2022-05-17,경춘선,별내,3593,3265,6858
2022-05-17,경춘선,사릉,2943,2801,5744
2022-05-17,경춘선,상천,399,356,755
2022-05-17,경춘선,신내,2552,2387,4939
2022-05-17,경춘선,천마산,1978,1804,3782
2022-05-17,경춘선,청평,1783,1774,3557
2022-05-17,경춘선,춘천,2001,1879,3880
2022-05-17,경춘선,퇴계원,4012,3550,7562
2022-05-17,경춘선,평내호평,7242,7050,14292
2022-05-17,공항철도,검암,7231,7260,14491
2022-05-17,공항철도,계양,11974,11179,23153
2022-05-17,공항철도,공덕,2447,3157,5604
2022-05-17,공항철도,공항화물청사,2466,2589,5055
2022-05-17,공항철도,김포공항,12187,7050,19237
2022-05-17,공항철도,디지털미디어시티,15635,14653,30288
2022-05-17,공항철도,마곡나루,11080,10647,21727
2022-05-17,공항철도,서울역,8466,7674,16140
2022-05-17,공항철도,영종,3400,3498,6898
2022-05-17,공항철도,운서,7663,7723,15386
2022-05-17,공항철도,인천공항1터미널,5400,5552,10952
2022-05-17,공항철도,인천공항2터미널,2878,2699,5577
2022-05-17,공항철도,청라국제도시,7905,7587,15492
2022-05-17,공항철도,홍대입구,10126,10137,20263
2022-05-17,과천선,경마공원,1935,1771,3706
2022-05-17,과천선,과천,7068,6574,13642
2022-05-17,과천선,대공원,4894,5128,10022
2022-05-17,과천선,범계,28279,28110,56389
2022-05-17,과천선,선바위,9389,8330,17719
2022-05-17,과천선,인덕원,27093,27772,54865
2022-05-17,과천선,정부과천청사,11899,11774,23673
2022-05-17,과천선,평촌,19875,19405,39280
2022-05-17,분당선,가천대,14128,15077,29205
2022-05-17,분당선,강남구청,11112,12937,24049
2022-05-17,분당선,개포동,4417,4497,8914
2022-05-17,분당선,구룡,2718,2541,5259
2022-05-17,분당선,구성,5793,5920,11713
2022-05-17,분당선,기흥,11355,10722,22077
2022-05-17,분당선,대모산입구,5144,4631,9775
2022-05-17,분당선,도곡,7745,7678,15423
2022-05-17,분당선,망포,16042,15200,31242
2022-05-17,분당선,매교,3497,3539,7036
2022-05-17,분당선,매탄권선,5864,5532,11396
2022-05-17,분당선,모란,21746,21903,43649
2022-05-17,분당선,미금,16896,18210,35106
2022-05-17,분당선,보정,2953,2549,5502
2022-05-17,분당선,복정,1,0,1
2022-05-17,분당선,상갈,6139,5885,12024
2022-05-17,분당선,서울숲,12614,12921,25535
2022-05-17,분당선,서현,25803,26682,52485
2022-05-17,분당선,선릉,14616,22844,37460
2022-05-17,분당선,선정릉,8942,9615,18557
2022-05-17,분당선,수내,14543,14598,29141
2022-05-17,분당선,수서,14819,15067,29886
2022-05-17,분당선,수원,8965,7653,16618
2022-05-17,분당선,수원시청,13617,14749,28366
2022-05-17,분당선,신갈,5014,4960,9974
2022-05-17,분당선,압구정로데오,19955,22196,42151
2022-05-17,분당선,야탑,28168,29506,57674
2022-05-17,분당선,영통,9015,9133,18148
2022-05-17,분당선,오리,12700,10247,22947
2022-05-17,분당선,이매,6472,5919,12391
2022-05-17,분당선,정자,19355,20484,39839
2022-05-17,분당선,죽전,15838,17419,33257
2022-05-17,분당선,청명,4825,4691,9516
2022-05-17,분당선,태평,14446,13865,28311
2022-05-17,분당선,한티,15356,16201,31557
2022-05-17,수인선,고색,5455,5143,10598
2022-05-17,수인선,남동인더스파크,2410,2684,5094
2022-05-17,수인선,달월,127,86,213
2022-05-17,수인선,사리,5507,4848,10355
2022-05-17,수인선,소래포구,7634,7240,14874
2022-05-17,수인선,송도,2755,2563,5318
2022-05-17,수인선,숭의,4600,4292,8892
2022-05-17,수인선,신포,2064,2065,4129
2022-05-17,수인선,야목,456,330,786
2022-05-17,수인선,어천,803,872,1675
2022-05-17,수인선,연수,4934,4903,9837
2022-05-17,수인선,오목천,4452,4050,8502
2022-05-17,수인선,원인재,4762,5077,9839
2022-05-17,수인선,월곶,3094,2827,5921
2022-05-17,수인선,인천,1096,1851,2947
2022-05-17,수인선,인천논현,6102,6613,12715
2022-05-17,수인선,인하대,8283,7919,16202
2022-05-17,수인선,호구포,4542,4781,9323
2022-05-17,안산선,고잔,9985,9410,19395
2022-05-17,안산선,대야미,5658,5087,10745
2022-05-17,안산선,반월,4735,4547,9282
2022-05-17,안산선,산본,17564,18791,36355
2022-05-17,안산선,상록수,17994,18303,36297
2022-05-17,안산선,수리산,4728,3984,8712
2022-05-17,안산선,신길온천,1999,1884,3883
2022-05-17,안산선,안산,12388,11178,23566
2022-05-17,안산선,오이도,9636,9217,18853
2022-05-17,안산선,정왕,11257,11462,22719
2022-05-17,안산선,중앙,20024,20952,40976
2022-05-17,안산선,초지,5815,6169,11984
2022-05-17,안산선,한대앞,11643,11653,23296
2022-05-17,우이신설선,4.19민주묘지,3729,3577,7306
2022-05-17,우이신설선,가오리,4477,4369,8846
2022-05-17,우이신설선,보문,1647,1647,3294
2022-05-17,우이신설선,북한산보국문,6686,6197,12883
2022-05-17,우이신설선,북한산우이,3068,2766,5834
2022-05-17,우이신설선,삼양,2039,2212,4251
2022-05-17,우이신설선,삼양사거리,2624,2579,5203
2022-05-17,우이신설선,성신여대입구,3558,4017,7575
2022-05-17,우이신설선,솔밭공원,2701,2496,5197
2022-05-17,우이신설선,솔샘,6379,5970,12349
2022-05-17,우이신설선,신설동,2340,2319,4659
2022-05-17,우이신설선,정릉,5474,4790,10264
2022-05-17,우이신설선,화계,3746,3353,7099
2022-05-17,일산선,대곡,2580,1959,4539
2022-05-17,일산선,대화,14231,11146,25377
2022-05-17,일산선,마두,8403,8505,16908
2022-05-17,일산선,백석,10702,10508,21210
2022-05-17,일산선,삼송,21605,20783,42388
2022-05-17,일산선,원당,12454,11750,24204
2022-05-17,일산선,원흥,12201,11384,23585
2022-05-17,일산선,정발산,7611,7794,15405
2022-05-17,일산선,주엽,10326,10080,20406
2022-05-17,일산선,화정,18451,19004,37455
2022-05-17,장항선,배방,1273,1208,2481
2022-05-17,장항선,봉명,1453,1468,2921
2022-05-17,장항선,신창,3095,3069,6164
2022-05-17,장항선,쌍용,3338,3089,6427
2022-05-17,장항선,아산,4192,3484,7676
2022-05-17,장항선,온양온천,4165,4318,8483
2022-05-17,장항선,탕정,986,865,1851
2022-05-17,중앙선,구리,14776,14936,29712
2022-05-17,중앙선,국수,844,829,1673
2022-05-17,중앙선,덕소,6207,6231,12438
2022-05-17,중앙선,도농,12474,11137,23611
2022-05-17,중앙선,도심,2778,2173,4951
2022-05-17,중앙선,망우,8465,8310,16775
2022-05-17,중앙선,상봉,6283,6276,12559
2022-05-17,중앙선,신원,276,225,501
2022-05-17,중앙선,아신,580,611,1191
2022-05-17,중앙선,양수,2159,2224,4383
2022-05-17,중앙선,양원,3525,3285,6810
2022-05-17,중앙선,양정,845,719,1564
2022-05-17,중앙선,양평,3026,3057,6083
2022-05-17,중앙선,오빈,360,350,710
2022-05-17,중앙선,용문,2181,2185,4366
2022-05-17,중앙선,운길산,1014,943,1957
2022-05-17,중앙선,원덕,425,396,821
2022-05-17,중앙선,중랑,6318,5872,12190
2022-05-17,중앙선,지평,75,88,163
2022-05-17,중앙선,팔당,992,997,1989
2022-05-17,중앙선,회기,27917,26962,54879
2022-05-18,1호선,동대문,11225,10706,21931
2022-05-18,1호선,동묘앞,7790,7914,15704
2022-05-18,1호선,서울역,47049,45696,92745
2022-05-18,1호선,시청,25853,26322,52175
2022-05-18,1호선,신설동,14552,14221,28773
2022-05-18,1호선,제기동,17117,17314,34431
2022-05-18,1호선,종각,38526,38018,76544
2022-05-18,1호선,종로3가,26949,24083,51032
2022-05-18,1호선,종로5가,23904,23240,47144
2022-05-18,1호선,청량리,20626,20375,41001
2022-05-18,2호선,강남,87386,87842,175228
2022-05-18,2호선,강변,31329,29655,60984
2022-05-18,2호선,건대입구,37452,40207,77659
2022-05-18,2호선,교대,37060,42559,79619
2022-05-18,2호선,구로디지털단지,63303,63270,126573
2022-05-18,2호선,구의,25107,24294,49401
2022-05-18,2호선,낙성대,28989,28356,57345
2022-05-18,2호선,당산,20373,23685,44058
2022-05-18,2호선,대림,25095,25537,50632
2022-05-18,2호선,도림천,1532,1527,3059
2022-05-18,2호선,동대문역사문화공원,12524,14190,26714
2022-05-18,2호선,뚝섬,23603,25601,49204
2022-05-18,2호선,문래,23769,24259,48028
2022-05-18,2호선,방배,20742,21696,42438
2022-05-18,2호선,봉천,25341,22943,48284
2022-05-18,2호선,사당,40948,45794,86742
2022-05-18,2호선,삼성,56509,58189,114698
2022-05-18,2호선,상왕십리,15355,14881,30236
2022-05-18,2호선,서울대입구,50945,49870,100815
2022-05-18,2호선,서초,23627,23125,46752
2022-05-18,2호선,선릉,61677,54670,116347
2022-05-18,2호선,성수,39498,43790,83288
2022-05-18,2호선,시청,26370,25765,52135
2022-05-18,2호선,신답,1839,1983,3822
2022-05-18,2호선,신당,14816,15294,30110
2022-05-18,2호선,신대방,28746,27739,56485
2022-05-18,2호선,신도림,51137,51391,102528
2022-05-18,2호선,신림,68145,65335,133480
2022-05-18,2호선,신설동,3532,3619,7151
2022-05-18,2호선,신정네거리,11100,11362,22462
2022-05-18,2호선,신촌,35324,36249,71573
2022-05-18,2호선,아현,11399,10538,21937
2022-05-18,2호선,양천구청,7435,7569,15004
2022-05-18,2호선,역삼,56090,64760,120850
2022-05-18,2호선,영등포구청,23761,25019,48780
2022-05-18,2호선,왕십리,18008,14465,32473
2022-05-18,2호선,용답,3391,3368,6759
2022-05-18,2호선,용두,2540,2488,5028
2022-05-18,2호선,을지로3가,24756,25128,49884
2022-05-18,2호선,을지로4가,13746,13798,27544
2022-05-18,2호선,을지로입구,41662,44185,85847
2022-05-18,2호선,이대,15330,16295,31625
2022-05-18,2호선,잠실,70347,70359,140706
2022-05-18,2호선,잠실나루,16346,15861,32207
2022-05-18,2호선,잠실새내,22422,22205,44627
2022-05-18,2호선,종합운동장,11211,12506,23717
2022-05-18,2호선,충정로,10958,11587,22545
2022-05-18,2호선,한양대,15001,16732,31733
2022-05-18,2호선,합정,31663,33706,65369
2022-05-18,2호선,홍대입구,56039,59495,115534
2022-05-18,3호선,가락시장,9685,9388,19073
2022-05-18,3호선,경복궁,30217,32602,62819
2022-05-18,3호선,경찰병원,7941,8039,15980
2022-05-18,3호선,고속터미널,41451,39466,80917
2022-05-18,3호선,교대,16279,10498,26777
2022-05-18,3호선,구파발,22952,22001,44953
2022-05-18,3호선,금호,8481,7804,16285
2022-05-18,3호선,남부터미널,30543,31054,61597
2022-05-18,3호선,녹번,17043,15112,32155
2022-05-18,3호선,대청,11087,10127,21214
2022-05-18,3호선,대치,11548,11796,23344
2022-05-18,3호선,도곡,6059,6182,12241
2022-05-18,3호선,독립문,7933,8158,16091
2022-05-18,3호선,동대입구,9479,10451,19930
2022-05-18,3호선,매봉,13827,13405,27232
2022-05-18,3호선,무악재,4271,4279,8550
2022-05-18,3호선,불광,17438,18640,36078
2022-05-18,3호선,수서,18425,18555,36980
2022-05-18,3호선,신사,31694,33670,65364
2022-05-18,3호선,안국,25770,26044,51814
2022-05-18,3호선,압구정,32808,35229,68037
2022-05-18,3호선,약수,14254,13770,28024
2022-05-18,3호선,양재,42218,46590,88808
2022-05-18,3호선,연신내,38704,36481,75185
2022-05-18,3호선,오금,6896,6231,13127
2022-05-18,3호선,옥수,9529,9841,19370
2022-05-18,3호선,을지로3가,11550,11870,23420
2022-05-18,3호선,일원,11576,11089,22665
2022-05-18,3호선,잠원,5509,5187,10696
2022-05-18,3호선,종로3가,10733,12551,23284
2022-05-18,3호선,지축,5527,5110,10637
2022-05-18,3호선,충무로,1,0,1
2022-05-18,3호선,학여울,3065,3082,6147
2022-05-18,3호선,홍제,19261,18150,37411
2022-05-18,4호선,길음,24050,23563,47613
2022-05-18,4호선,남태령,1413,1212,2625
2022-05-18,4호선,노원,19998,22749,42747
2022-05-18,4호선,당고개,9594,8600,18194
2022-05-18,4호선,동대문,20585,21256,41841
2022-05-18,4호선,동대문역사문화공원,15204,14072,29276
2022-05-18,4호선,동작,2334,2358,4692
2022-05-18,4호선,명동,21914,22674,44588
2022-05-18,4호선,미아,16158,15570,31728
2022-05-18,4호선,미아사거리,29088,28039,57127
2022-05-18,4호선,사당,28030,23899,51929
2022-05-18,4호선,삼각지,5767,6465,12232
2022-05-18,4호선,상계,20915,19225,40140
2022-05-18,4호선,서울역,12727,18384,31111
2022-05-18,4호선,성신여대입구,22581,21435,44016
2022-05-18,4호선,수유,35763,35984,71747
2022-05-18,4호선,숙대입구,15638,15122,30760
2022-05-18,4호선,신용산,17994,19173,37167
2022-05-18,4호선,쌍문,31197,28488,59685
2022-05-18,4호선,이촌,9398,10347,19745
2022-05-18,4호선,창동,27283,28787,56070
2022-05-18,4호선,총신대입구,20570,22443,43013
2022-05-18,4호선,충무로,29945,30994,60939
2022-05-18,4호선,한성대입구,15878,15459,31337
2022-05-18,4호선,혜화,36353,36891,73244
2022-05-18,4호선,회현,26550,28025,54575
2022-05-18,5호선,강동,19843,19008,38851
2022-05-18,5호선,강일,4765,4424,9189
2022-05-18,5호선,개롱,7184,7334,14518
2022-05-18,5호선,개화산,6117,5775,11892
2022-05-18,5호선,거여,11468,10815,22283
2022-05-18,5호선,고덕,10411,10415,20826
2022-05-18,5호선,공덕,15427,16442,31869
2022-05-18,5호선,광나루,15522,13935,29457
2022-05-18,5호선,광화문,33893,35678,69571
2022-05-18,5호선,군자,11934,13366,25300
2022-05-18,5호선,굽은다리,10325,9940,20265
2022-05-18,5호선,길동,8353,8642,16995
2022-05-18,5호선,김포공항,7316,7242,14558
2022-05-18,5호선,까치산,30797,29012,59809
2022-05-18,5호선,답십리,17010,15397,32407
2022-05-18,5호선,동대문역사문화공원,3066,3619,6685
2022-05-18,5호선,둔촌동,8582,8532,17114
2022-05-18,5호선,마곡,11510,11732,23242
2022-05-18,5호선,마장,6289,5875,12164
2022-05-18,5호선,마천,8030,7431,15461
2022-05-18,5호선,마포,15618,16132,31750
2022-05-18,5호선,명일,9565,9786,19351
2022-05-18,5호선,목동,18102,19467,37569
2022-05-18,5호선,미사,17454,17233,34687
2022-05-18,5호선,발산,22286,23222,45508
2022-05-18,5호선,방이,7755,8008,15763
2022-05-18,5호선,방화,7247,6818,14065
2022-05-18,5호선,상일동,16403,15064,31467
2022-05-18,5호선,서대문,21729,22343,44072
2022-05-18,5호선,송정,7061,6536,13597
2022-05-18,5호선,신금호,7162,7324,14486
2022-05-18,5호선,신길,4557,4646,9203
2022-05-18,5호선,신정,15127,12048,27175
2022-05-18,5호선,아차산,15944,15006,30950
2022-05-18,5호선,애오개,7333,7249,14582
2022-05-18,5호선,양평,8087,7898,15985
2022-05-18,5호선,여의나루,13191,14249,27440
2022-05-18,5호선,여의도,30536,33333,63869
2022-05-18,5호선,영등포구청,4314,4429,8743
2022-05-18,5호선,영등포시장,10629,10884,21513
2022-05-18,5호선,오금,4062,4141,8203
2022-05-18,5호선,오목교,22894,24672,47566
2022-05-18,5호선,올림픽공원,4810,4097,8907
2022-05-18,5호선,왕십리,4821,5660,10481
2022-05-18,5호선,우장산,16362,15578,31940
2022-05-18,5호선,을지로4가,6694,6882,13576
2022-05-18,5호선,장한평,20149,19665,39814
2022-05-18,5호선,종로3가,13960,13747,27707
2022-05-18,5호선,천호,19105,19094,38199
2022-05-18,5호선,청구,4404,3926,8330
2022-05-18,5호선,충정로,5150,5291,10441
2022-05-18,5호선,하남검단산,6198,5896,12094
2022-05-18,5호선,하남시청,7423,7121,14544
2022-05-18,5호선,하남풍산,4588,4434,9022
2022-05-18,5호선,행당,8834,7616,16450
2022-05-18,5호선,화곡,30423,28087,58510
2022-05-18,6호선,고려대,9451,9176,18627
2022-05-18,6호선,공덕,20000,19536,39536
2022-05-18,6호선,광흥창,10167,9600,19767
2022-05-18,6호선,구산,8278,5926,14204
2022-05-18,6호선,녹사평,5054,5127,10181
2022-05-18,6호선,대흥,9482,9864,19346
2022-05-18,6호선,독바위,2928,3004,5932
2022-05-18,6호선,돌곶이,10277,9489,19766
2022-05-18,6호선,동묘앞,8123,8408,16531
2022-05-18,6호선,디지털미디어시티,15531,16764,32295
2022-05-18,6호선,마포구청,15417,13802,29219
2022-05-18,6호선,망원,14246,15094,29340
2022-05-18,6호선,버티고개,2395,2249,4644
2022-05-18,6호선,보문,8110,7253,15363
2022-05-18,6호선,봉화산,9615,8868,18483
2022-05-18,6호선,불광,4730,4669,9399
2022-05-18,6호선,삼각지,7962,6986,14948
2022-05-18,6호선,상수,9363,10949,20312
2022-05-18,6호선,상월곡,7038,6612,13650
2022-05-18,6호선,새절,13999,13073,27072
2022-05-18,6호선,석계,13641,14130,27771
2022-05-18,6호선,신당,9412,9776,19188
2022-05-18,6호선,안암,15439,15656,31095
2022-05-18,6호선,약수,3768,3851,7619
2022-05-18,6호선,역촌,3920,4603,8523
2022-05-18,6호선,월곡,13577,12895,26472
2022-05-18,6호선,월드컵경기장,4438,4885,9323
2022-05-18,6호선,응암,18892,18121,37013
2022-05-18,6호선,이태원,10562,11298,21860
2022-05-18,6호선,증산,10937,10704,21641
2022-05-18,6호선,창신,4093,3358,7451
2022-05-18,6호선,청구,3950,4161,8111
2022-05-18,6호선,태릉입구,7097,8323,15420
2022-05-18,6호선,한강진,8616,10019,18635
2022-05-18,6호선,합정,13780,13752,27532
2022-05-18,6호선,화랑대,13886,10736,24622
2022-05-18,6호선,효창공원앞,8029,7367,15396
2022-05-18,7호선,가산디지털단지,48001,48770,96771
2022-05-18,7호선,강남구청,17301,19395,36696
2022-05-18,7호선,건대입구,13683,14259,27942
2022-05-18,7호선,고속터미널,16065,14136,30201
2022-05-18,7호선,공릉,13637,13167,26804
2022-05-18,7호선,광명사거리,23197,22739,45936
2022-05-18,7호선,군자,15946,12611,28557
2022-05-18,7호선,남구로,16654,17739,34393
2022-05-18,7호선,남성,12155,11014,23169
2022-05-18,7호선,내방,15689,16159,31848
2022-05-18,7호선,노원,19875,21364,41239
2022-05-18,7호선,논현,21807,23838,45645
2022-05-18,7호선,대림,7973,8045,16018
2022-05-18,7호선,도봉산,10345,11594,21939
2022-05-18,7호선,뚝섬유원지,10323,9827,20150
2022-05-18,7호선,마들,14104,13025,27129
2022-05-18,7호선,먹골,11167,10696,21863
2022-05-18,7호선,면목,17339,16724,34063
2022-05-18,7호선,반포,6585,6251,12836
2022-05-18,7호선,보라매,11157,11177,22334
2022-05-18,7호선,사가정,17000,17049,34049
2022-05-18,7호선,상도,12460,12130,24590
2022-05-18,7호선,상봉,17907,16467,34374
2022-05-18,7호선,수락산,13375,13059,26434
2022-05-18,7호선,숭실대입구,15883,15887,31770
2022-05-18,7호선,신대방삼거리,17932,16987,34919
2022-05-18,7호선,신풍,12769,12087,24856
2022-05-18,7호선,어린이대공원,17261,17620,34881
2022-05-18,7호선,온수,11820,11099,22919
2022-05-18,7호선,용마산,6613,6233,12846
2022-05-18,7호선,이수,17238,16574,33812
2022-05-18,7호선,장승배기,9581,9235,18816
2022-05-18,7호선,장암,2479,943,3422
2022-05-18,7호선,중계,16251,14690,30941
2022-05-18,7호선,중곡,12038,11006,23044
2022-05-18,7호선,중화,11874,11256,23130
2022-05-18,7호선,천왕,12315,11765,24080
2022-05-18,7호선,철산,22600,22780,45380
2022-05-18,7호선,청담,20883,23734,44617
2022-05-18,7호선,태릉입구,11574,11282,22856
2022-05-18,7호선,하계,19563,18293,37856
2022-05-18,7호선,학동,26070,28160,54230
2022-05-18,8호선,가락시장,8140,9009,17149
2022-05-18,8호선,강동구청,11233,11528,22761
2022-05-18,8호선,남위례,5690,5994,11684
2022-05-18,8호선,남한산성입구,16663,15238,31901
2022-05-18,8호선,단대오거리,12107,11531,23638
2022-05-18,8호선,모란,4616,3624,8240
2022-05-18,8호선,몽촌토성,6741,6747,13488
2022-05-18,8호선,문정,23406,24815,48221
2022-05-18,8호선,복정,10952,9184,20136
2022-05-18,8호선,산성,5949,5810,11759
2022-05-18,8호선,석촌,8279,9409,17688
2022-05-18,8호선,송파,9217,8836,18053
2022-05-18,8호선,수진,5727,5220,10947
2022-05-18,8호선,신흥,4432,4804,9236
2022-05-18,8호선,암사,20418,17650,38068
2022-05-18,8호선,잠실,13974,16956,30930
2022-05-18,8호선,장지,18452,17718,36170
2022-05-18,8호선,천호,15352,17682,33034
2022-05-18,9호선,가양,22562,22159,44721
2022-05-18,9호선,개화,2817,1957,4774
2022-05-18,9호선,고속터미널,13293,16391,29684
2022-05-18,9호선,공항시장,3208,3357,6565
2022-05-18,9호선,구반포,1318,1477,2795
2022-05-18,9호선,국회의사당,16549,17717,34266
2022-05-18,9호선,김포공항,7154,11558,18712
2022-05-18,9호선,노들,4929,4115,9044
2022-05-18,9호선,노량진,28510,27556,56066
2022-05-18,9호선,당산,20110,20020,40130
2022-05-18,9호선,동작,2345,1913,4258
2022-05-18,9호선,등촌,11936,11263,23199
2022-05-18,9호선,마곡나루,13302,13284,26586
2022-05-18,9호선,사평,3908,3668,7576
2022-05-18,9호선,샛강,6590,6945,13535
2022-05-18,9호선,선유도,9423,9092,18515
2022-05-18,9호선,신논현,33738,33404,67142
2022-05-18,9호선,신목동,4707,4009,8716
2022-05-18,9호선,신반포,3973,3858,7831
2022-05-18,9호선,신방화,7461,7073,14534
2022-05-18,9호선,양천향교,10602,10690,21292
2022-05-18,9호선,여의도,30040,29867,59907
2022-05-18,9호선,염창,18455,17737,36192
2022-05-18,9호선,증미,7807,7481,15288
2022-05-18,9호선,흑석,10051,10106,20157
2022-05-18,9호선2~3단계,둔촌오륜,1285,1140,2425
2022-05-18,9호선2~3단계,봉은사,18242,18805,37047
2022-05-18,9호선2~3단계,삼성중앙,7589,8048,15637
2022-05-18,9호선2~3단계,삼전,7394,6987,14381
2022-05-18,9호선2~3단계,석촌,9363,8057,17420
2022-05-18,9호선2~3단계,석촌고분,6531,6183,12714
2022-05-18,9호선2~3단계,선정릉,10535,11527,22062
2022-05-18,9호선2~3단계,송파나루,5237,5636,10873
2022-05-18,9호선2~3단계,언주,11217,11439,22656
2022-05-18,9호선2~3단계,올림픽공원,6483,6513,12996
2022-05-18,9호선2~3단계,종합운동장,4493,4694,9187
2022-05-18,9호선2~3단계,중앙보훈병원,11857,10326,22183
2022-05-18,9호선2~3단계,한성백제,2854,2515,5369
2022-05-18,경강선,경기광주,8466,7904,16370
2022-05-18,경강선,곤지암,2465,2476,4941
2022-05-18,경강선,부발,2288,2212,4500
2022-05-18,경강선,삼동,2671,2368,5039
2022-05-18,경강선,세종대왕릉,357,338,695
2022-05-18,경강선,신둔도예촌,1782,1542,3324
2022-05-18,경강선,여주,2321,2376,4697
2022-05-18,경강선,이매,1205,1122,2327
2022-05-18,경강선,이천,2724,2852,5576
2022-05-18,경강선,초월,3536,3304,6840
2022-05-18,경강선,판교,5376,5336,10712
2022-05-18,경부선,가산디지털단지,20122,22668,42790
2022-05-18,경부선,관악,8091,7684,15775
2022-05-18,경부선,광명,3503,3077,6580
2022-05-18,경부선,구로,19894,20713,40607
2022-05-18,경부선,군포,8366,8257,16623
2022-05-18,경부선,금정,29349,29590,58939
2022-05-18,경부선,금천구청,12840,12721,25561
2022-05-18,경부선,남영,10476,11253,21729
2022-05-18,경부선,노량진,8997,9134,18131
2022-05-18,경부선,당정,7918,7295,15213
2022-05-18,경부선,대방,14383,14796,29179
2022-05-18,경부선,독산,20184,20874,41058
2022-05-18,경부선,두정,8300,9583,17883
2022-05-18,경부선,명학,11483,11258,22741
2022-05-18,경부선,병점,17939,17937,35876
2022-05-18,경부선,서동탄,1594,1395,2989
2022-05-18,경부선,서울역,6331,2177,8508
2022-05-18,경부선,서정리,8322,7634,15956
2022-05-18,경부선,석수,10534,9396,19930
2022-05-18,경부선,성균관대,16919,16516,33435
2022-05-18,경부선,성환,7279,6921,14200
2022-05-18,경부선,세류,3415,3058,6473
2022-05-18,경부선,세마,3266,3031,6297
2022-05-18,경부선,송탄,4749,4550,9299
2022-05-18,경부선,수원,38464,40905,79369
2022-05-18,경부선,신길,9936,8596,18532
2022-05-18,경부선,신도림,4395,4552,8947
2022-05-18,경부선,안양,28928,28640,57568
2022-05-18,경부선,영등포,38289,39983,78272
2022-05-18,경부선,오산,11283,11357,22640
2022-05-18,경부선,오산대,4622,4126,8748
2022-05-18,경부선,용산,35059,35769,70828
2022-05-18,경부선,의왕,10592,10447,21039
2022-05-18,경부선,직산,949,961,1910
2022-05-18,경부선,진위,1979,1776,3755
2022-05-18,경부선,천안,7507,6831,14338
2022-05-18,경부선,평택,13585,13785,27370
2022-05-18,경부선,평택지제,3817,3785,7602
2022-05-18,경부선,화서,9250,8829,18079
2022-05-18,경원선,가능,7388,7009,14397
2022-05-18,경원선,광운대,9958,9698,19656
2022-05-18,경원선,녹양,5129,4800,9929
2022-05-18,경원선,녹천,5045,4226,9271
2022-05-18,경원선,덕계,3662,3345,7007
2022-05-18,경원선,덕정,6691,6422,13113
2022-05-18,경원선,도봉,6508,6216,12724
2022-05-18,경원선,도봉산,7739,5150,12889
2022-05-18,경원선,동두천,2429,2691,5120
2022-05-18,경원선,동두천중앙,3297,3178,6475
2022-05-18,경원선,망월사,10512,10654,21166
2022-05-18,경원선,방학,10387,10265,20652
2022-05-18,경원선,보산,1569,1412,2981
2022-05-18,경원선,서빙고,2211,2059,4270
2022-05-18,경원선,석계,8860,9913,18773
2022-05-18,경원선,소요산,2351,1952,4303
2022-05-18,경원선,신이문,8978,8278,17256
2022-05-18,경원선,양주,8639,7939,16578
2022-05-18,경원선,옥수,49,44,93
2022-05-18,경원선,왕십리,15709,16999,32708
2022-05-18,경원선,외대앞,8941,8933,17874
2022-05-18,경원선,월계,8935,8241,17176
2022-05-18,경원선,응봉,2117,1758,3875
2022-05-18,경원선,의정부,19426,20185,39611
2022-05-18,경원선,이촌,4203,3030,7233
2022-05-18,경원선,지행,7228,7172,14400
2022-05-18,경원선,창동,1,0,1
2022-05-18,경원선,청량리,15775,16459,32234
2022-05-18,경원선,한남,4485,4235,8720
2022-05-18,경원선,회룡,13672,13559,27231
2022-05-18,경의선,가좌,6173,5790,11963
2022-05-18,경의선,강매,3620,3165,6785
2022-05-18,경의선,곡산,753,792,1545
2022-05-18,경의선,공덕,3896,3430,7326
2022-05-18,경의선,금릉,5523,5397,10920
2022-05-18,경의선,금촌,6908,6773,13681
2022-05-18,경의선,능곡,4329,3909,8238
2022-05-18,경의선,디지털미디어시티,2830,2645,5475
2022-05-18,경의선,문산,5424,5369,10793
2022-05-18,경의선,백마,7889,7565,15454
2022-05-18,경의선,서강대,2380,2311,4691
2022-05-18,경의선,서울역,4942,6523,11465
2022-05-18,경의선,수색,3085,3225,6310
2022-05-18,경의선,신촌,957,1284,2241
2022-05-18,경의선,야당,8527,8563,17090
2022-05-18,경의선,운정,7728,7133,14861
2022-05-18,경의선,월롱,3527,3276,6803
2022-05-18,경의선,일산,11473,11275,22748
2022-05-18,경의선,임진강,11,14,25
2022-05-18,경의선,탄현,8688,8128,16816
2022-05-18,경의선,파주,1629,1209,2838
2022-05-18,경의선,풍산,6269,5775,12044
2022-05-18,경의선,행신,8629,8769,17398
2022-05-18,경의선,홍대입구,1909,2164,4073
2022-05-18,경의선,화전,3964,3715,7679
2022-05-18,경의선,효창공원앞,3438,3723,7161
2022-05-18,경인선,간석,6563,6125,12688
2022-05-18,경인선,개봉,23594,22666,46260
2022-05-18,경인선,구일,8207,7969,16176
2022-05-18,경인선,도원,3701,3687,7388
2022-05-18,경인선,도화,4601,4296,8897
2022-05-18,경인선,동암,15862,15952,31814
2022-05-18,경인선,동인천,15260,14299,29559
2022-05-18,경인선,백운,7572,7399,14971
2022-05-18,경인선,부개,9537,8717,18254
2022-05-18,경인선,부천,34852,34928,69780
2022-05-18,경인선,부평,30123,32367,62490
2022-05-18,경인선,소사,9728,9518,19246
2022-05-18,경인선,송내,30139,30156,60295
2022-05-18,경인선,역곡,31537,30805,62342
2022-05-18,경인선,오류동,12823,11848,24671
2022-05-18,경인선,온수,7873,7379,15252
2022-05-18,경인선,인천,3828,2874,6702
2022-05-18,경인선,제물포,12352,11709,24061
2022-05-18,경인선,주안,21573,19553,41126
2022-05-18,경인선,중동,10198,9582,19780
2022-05-18,경춘선,가평,1662,1671,3333
2022-05-18,경춘선,갈매,3389,2917,6306
2022-05-18,경춘선,강촌,579,469,1048
2022-05-18,경춘선,굴봉산,149,134,283
2022-05-18,경춘선,금곡,1756,1683,3439
2022-05-18,경춘선,김유정,374,510,884
2022-05-18,경춘선,남춘천,2626,2661,5287
2022-05-18,경춘선,대성리,588,586,1174
2022-05-18,경춘선,마석,4696,4578,9274
2022-05-18,경춘선,백양리,89,102,191
2022-05-18,경춘선,별내,3552,3328,6880
2022-05-18,경춘선,사릉,2815,2722,5537
2022-05-18,경춘선,상천,314,298,612
2022-05-18,경춘선,신내,2452,2298,4750
2022-05-18,경춘선,천마산,1948,1808,3756
2022-05-18,경춘선,청평,1658,1650,3308
2022-05-18,경춘선,춘천,1828,1556,3384
2022-05-18,경춘선,퇴계원,3831,3522,7353
2022-05-18,경춘선,평내호평,7162,6896,14058
2022-05-18,공항철도,검암,7148,7169,14317
2022-05-18,공항철도,계양,11685,10782,22467
2022-05-18,공항철도,공덕,2495,3316,5811
2022-05-18,공항철도,공항화물청사,2445,2582,5027
2022-05-18,공항철도,김포공항,11870,6965,18835
2022-05-18,공항철도,디지털미디어시티,15451,14358,29809
2022-05-18,공항철도,마곡나루,10829,10417,21246
2022-05-18,공항철도,서울역,8515,7828,16343
2022-05-18,공항철도,영종,3410,3421,6831
2022-05-18,공항철도,운서,7553,7524,15077
2022-05-18,공항철도,인천공항1터미널,5668,5589,11257
2022-05-18,공항철도,인천공항2터미널,2991,2807,5798
2022-05-18,공항철도,청라국제도시,7859,7467,15326
2022-05-18,공항철도,홍대입구,10209,10323,20532
2022-05-18,과천선,경마공원,1713,1754,3467
2022-05-18,과천선,과천,7085,6413,13498
2022-05-18,과천선,대공원,4496,4891,9387
2022-05-18,과천선,범계,29028,29258,58286
2022-05-18,과천선,선바위,9191,8185,17376
2022-05-18,과천선,인덕원,26945,27590,54535
2022-05-18,과천선,정부과천청사,11742,11728,23470
2022-05-18,과천선,평촌,19790,19266,39056
2022-05-18,분당선,가천대,13287,14247,27534
2022-05-18,분당선,강남구청,11063,12750,23813
2022-05-18,분당선,개포동,4515,4611,9126
2022-05-18,분당선,구룡,2705,2507,5212
2022-05-18,분당선,구성,5717,6138,11855
2022-05-18,분당선,기흥,11540,10795,22335
2022-05-18,분당선,대모산입구,5116,4593,9709
2022-05-18,분당선,도곡,7661,7445,15106
2022-05-18,분당선,망포,15927,15268,31195
2022-05-18,분당선,매교,3386,3420,6806
2022-05-18,분당선,매탄권선,5705,5401,11106
2022-05-18,분당선,모란,21175,18884,40059
2022-05-18,분당선,미금,17106,18183,35289
2022-05-18,분당선,보정,3039,2641,5680
2022-05-18,분당선,상갈,6244,6005,12249
2022-05-18,분당선,서울숲,12765,13149,25914
2022-05-18,분당선,서현,25893,26287,52180
2022-05-18,분당선,선릉,14677,22962,37639
2022-05-18,분당선,선정릉,8705,9474,18179
2022-05-18,분당선,수내,14730,14906,29636
2022-05-18,분당선,수서,14618,14913,29531
2022-05-18,분당선,수원,8860,7392,16252
2022-05-18,분당선,수원시청,13718,14544,28262
2022-05-18,분당선,신갈,4993,4944,9937
2022-05-18,분당선,압구정로데오,19940,22269,42209
2022-05-18,분당선,야탑,28914,30422,59336
2022-05-18,분당선,영통,8877,9227,18104
2022-05-18,분당선,오리,12743,10354,23097
2022-05-18,분당선,이매,6409,5979,12388
2022-05-18,분당선,정자,19510,20690,40200
2022-05-18,분당선,죽전,15494,17047,32541
2022-05-18,분당선,청명,4795,4576,9371
2022-05-18,분당선,태평,14222,13699,27921
2022-05-18,분당선,한티,15615,16659,32274
2022-05-18,수인선,고색,5418,5194,10612
2022-05-18,수인선,남동인더스파크,2405,2746,5151
2022-05-18,수인선,달월,139,88,227
2022-05-18,수인선,사리,5492,4807,10299
2022-05-18,수인선,소래포구,6581,6283,12864
2022-05-18,수인선,송도,2709,2533,5242
2022-05-18,수인선,숭의,4398,3998,8396
2022-05-18,수인선,신포,2084,2042,4126
2022-05-18,수인선,야목,450,324,774
2022-05-18,수인선,어천,808,872,1680
2022-05-18,수인선,연수,5045,5043,10088
2022-05-18,수인선,오목천,4476,4167,8643
2022-05-18,수인선,원인재,4906,4976,9882
2022-05-18,수인선,월곶,3171,2879,6050
2022-05-18,수인선,인천,1072,1841,2913
2022-05-18,수인선,인천논현,6003,6444,12447
2022-05-18,수인선,인하대,8087,7697,15784
2022-05-18,수인선,호구포,4597,4713,9310
2022-05-18,안산선,고잔,10020,9539,19559
2022-05-18,안산선,대야미,5585,4918,10503
2022-05-18,안산선,반월,4793,4589,9382
2022-05-18,안산선,산본,17220,18499,35719
2022-05-18,안산선,상록수,17797,17880,35677
2022-05-18,안산선,수리산,4596,3760,8356
2022-05-18,안산선,신길온천,1968,1785,3753
2022-05-18,안산선,안산,12404,11263,23667
2022-05-18,안산선,오이도,9398,9194,18592
2022-05-18,안산선,정왕,10817,11123,21940
2022-05-18,안산선,중앙,19817,20854,40671
2022-05-18,안산선,초지,5756,6165,11921
2022-05-18,안산선,한대앞,11074,11151,22225
2022-05-18,우이신설선,4.19민주묘지,4315,4467,8782
2022-05-18,우이신설선,가오리,4499,4371,8870
2022-05-18,우이신설선,보문,1657,1691,3348
2022-05-18,우이신설선,북한산보국문,6758,6283,13041
2022-05-18,우이신설선,북한산우이,2928,2687,5615
2022-05-18,우이신설선,삼양,2123,2162,4285
2022-05-18,우이신설선,삼양사거리,2565,2555,5120
2022-05-18,우이신설선,성신여대입구,3634,4049,7683
2022-05-18,우이신설선,솔밭공원,2654,2469,5123
2022-05-18,우이신설선,솔샘,6484,5986,12470
2022-05-18,우이신설선,신설동,2362,2302,4664
2022-05-18,우이신설선,정릉,5231,4622,9853
2022-05-18,우이신설선,화계,3729,3418,7147
2022-05-18,일산선,대곡,2410,1916,4326
2022-05-18,일산선,대화,13731,10700,24431
2022-05-18,일산선,마두,8173,8335,16508
2022-05-18,일산선,백석,10398,10277,20675
2022-05-18,일산선,삼송,21339,20652,41991
2022-05-18,일산선,원당,12450,11534,23984
2022-05-18,일산선,원흥,12030,11403,23433
2022-05-18,일산선,정발산,7365,7641,15006
2022-05-18,일산선,주엽,9957,9886,19843
2022-05-18,일산선,화정,18129,18395,36524
2022-05-18,장항선,배방,1267,1240,2507
2022-05-18,장항선,봉명,1438,1393,2831
2022-05-18,장항선,신창,2974,2930,5904
2022-05-18,장항선,쌍용,3247,2986,6233
2022-05-18,장항선,아산,4244,3622,7866
2022-05-18,장항선,온양온천,4021,4148,8169
2022-05-18,장항선,탕정,1002,878,1880
2022-05-18,중앙선,구리,14629,14710,29339
2022-05-18,중앙선,국수,776,788,1564
2022-05-18,중앙선,덕소,6024,6016,12040
2022-05-18,중앙선,도농,12017,10683,22700
2022-05-18,중앙선,도심,2814,2180,4994
2022-05-18,중앙선,망우,8409,8256,16665
2022-05-18,중앙선,상봉,6092,6234,12326
2022-05-18,중앙선,신원,272,218,490
2022-05-18,중앙선,아신,633,634,1267
2022-05-18,중앙선,양수,2057,2031,4088
2022-05-18,중앙선,양원,3486,3285,6771
2022-05-18,중앙선,양정,770,696,1466
2022-05-18,중앙선,양평,3897,3975,7872
2022-05-18,중앙선,오빈,390,358,748
2022-05-18,중앙선,용문,1871,1893,3764
2022-05-18,중앙선,운길산,834,837,1671
2022-05-18,중앙선,원덕,405,368,773
2022-05-18,중앙선,중랑,6282,5828,12110
2022-05-18,중앙선,지평,59,82,141
2022-05-18,중앙선,팔당,1045,1085,2130
2022-05-18,중앙선,회기,26954,26385,53339
2022-05-19,1호선,동대문,11449,10871,22320
2022-05-19,1호선,동묘앞,8468,8818,17286
2022-05-19,1호선,서울역,49283,48314,97597
2022-05-19,1호선,시청,25640,25755,51395
2022-05-19,1호선,신설동,14698,14332,29030
2022-05-19,1호선,제기동,18547,18759,37306
2022-05-19,1호선,종각,39084,38652,77736
2022-05-19,1호선,종로3가,28272,25236,53508
2022-05-19,1호선,종로5가,24507,24409,48916
2022-05-19,1호선,청량리,21753,21702,43455
2022-05-19,2호선,강남,88291,88726,177017
2022-05-19,2호선,강변,33067,30379,63446
2022-05-19,2호선,건대입구,38309,41396,79705
2022-05-19,2호선,교대,37483,42992,80475
2022-05-19,2호선,구로디지털단지,63666,63502,127168
2022-05-19,2호선,구의,25123,24301,49424
2022-05-19,2호선,낙성대,29788,28749,58537
2022-05-19,2호선,당산,21009,24573,45582
2022-05-19,2호선,대림,25892,26345,52237
2022-05-19,2호선,도림천,1455,1542,2997
2022-05-19,2호선,동대문역사문화공원,12726,14677,27403
2022-05-19,2호선,뚝섬,24201,26395,50596
2022-05-19,2호선,문래,23730,24377,48107
2022-05-19,2호선,방배,21254,22068,43322
2022-05-19,2호선,봉천,25721,23375,49096
2022-05-19,2호선,사당,42834,47396,90230
2022-05-19,2호선,삼성,57412,59554,116966
2022-05-19,2호선,상왕십리,15503,14721,30224
2022-05-19,2호선,서울대입구,51822,50716,102538
2022-05-19,2호선,서초,23311,22749,46060
2022-05-19,2호선,선릉,62852,55892,118744
2022-05-19,2호선,성수,40035,43918,83953
2022-05-19,2호선,시청,25946,25863,51809
2022-05-19,2호선,신답,1796,1998,3794
2022-05-19,2호선,신당,14912,15323,30235
2022-05-19,2호선,신대방,29135,28096,57231
2022-05-19,2호선,신도림,51688,52004,103692
2022-05-19,2호선,신림,68188,65433,133621
2022-05-19,2호선,신설동,3403,3421,6824
2022-05-19,2호선,신정네거리,11302,11411,22713
2022-05-19,2호선,신촌,36163,37390,73553
2022-05-19,2호선,아현,11686,10965,22651
2022-05-19,2호선,양천구청,7555,7743,15298
2022-05-19,2호선,역삼,55128,63790,118918
2022-05-19,2호선,영등포구청,24149,25137,49286
2022-05-19,2호선,왕십리,18427,14493,32920
2022-05-19,2호선,용답,3278,3445,6723
2022-05-19,2호선,용두,2520,2543,5063
2022-05-19,2호선,을지로3가,24309,24560,48869
2022-05-19,2호선,을지로4가,14001,14092,28093
2022-05-19,2호선,을지로입구,42764,44996,87760
2022-05-19,2호선,이대,15279,15943,31222
2022-05-19,2호선,잠실,72667,73015,145682
2022-05-19,2호선,잠실나루,16365,16027,32392
2022-05-19,2호선,잠실새내,23228,23145,46373
2022-05-19,2호선,종합운동장,12352,13315,25667
2022-05-19,2호선,충정로,10748,11648,22396
2022-05-19,2호선,한양대,14756,16612,31368
2022-05-19,2호선,합정,32982,35142,68124
2022-05-19,2호선,홍대입구,57447,61992,119439
2022-05-19,3호선,가락시장,9601,9453,19054
2022-05-19,3호선,경복궁,31498,33745,65243
2022-05-19,3호선,경찰병원,7954,7902,15856
2022-05-19,3호선,고속터미널,43155,41202,84357
2022-05-19,3호선,교대,16722,10816,27538
2022-05-19,3호선,구파발,23372,22434,45806
2022-05-19,3호선,금호,8624,7949,16573
2022-05-19,3호선,남부터미널,30985,31254,62239
2022-05-19,3호선,녹번,17478,15398,32876
2022-05-19,3호선,대청,11169,10406,21575
2022-05-19,3호선,대치,11926,12071,23997
2022-05-19,3호선,도곡,5899,6223,12122
2022-05-19,3호선,독립문,8021,8340,16361
2022-05-19,3호선,동대입구,10921,12004,22925
2022-05-19,3호선,매봉,13857,13441,27298
2022-05-19,3호선,무악재,4298,4370,8668
2022-05-19,3호선,불광,17729,18826,36555
2022-05-19,3호선,수서,18689,18782,37471
2022-05-19,3호선,신사,32222,34066,66288
2022-05-19,3호선,안국,25941,26582,52523
2022-05-19,3호선,압구정,33489,36094,69583
2022-05-19,3호선,약수,14432,13949,28381
2022-05-19,3호선,양재,42975,47402,90377
2022-05-19,3호선,연신내,39393,37287,76680
2022-05-19,3호선,오금,6867,6318,13185
2022-05-19,3호선,옥수,9997,10056,20053
2022-05-19,3호선,을지로3가,11337,11726,23063
2022-05-19,3호선,일원,11777,11255,23032
2022-05-19,3호선,잠원,5401,5226,10627
2022-05-19,3호선,종로3가,10857,12532,23389
2022-05-19,3호선,지축,5535,5103,10638
2022-05-19,3호선,충무로,2,0,2
2022-05-19,3호선,학여울,3225,3240,6465
2022-05-19,3호선,홍제,19613,18341,37954
2022-05-19,4호선,길음,24681,24340,49021
2022-05-19,4호선,남태령,1449,1223,2672
2022-05-19,4호선,노원,20302,23097,43399
2022-05-19,4호선,당고개,9825,8599,18424
2022-05-19,4호선,동대문,21325,22026,43351
2022-05-19,4호선,동대문역사문화공원,15774,14471,30245
2022-05-19,4호선,동작,1814,2075,3889
2022-05-19,4호선,명동,21768,23027,44795
2022-05-19,4호선,미아,17318,16788,34106
2022-05-19,4호선,미아사거리,29397,28464,57861
2022-05-19,4호선,사당,28442,24894,53336
2022-05-19,4호선,삼각지,5902,6684,12586
2022-05-19,4호선,상계,21121,19366,40487
2022-05-19,4호선,서울역,12855,19041,31896
2022-05-19,4호선,성신여대입구,22804,21879,44683
2022-05-19,4호선,수유,36591,36361,72952
2022-05-19,4호선,숙대입구,15645,15035,30680
2022-05-19,4호선,신용산,18658,19632,38290
2022-05-19,4호선,쌍문,31428,28923,60351
2022-05-19,4호선,이촌,9538,10348,19886
2022-05-19,4호선,창동,28146,29709,57855
2022-05-19,4호선,총신대입구,20857,22563,43420
2022-05-19,4호선,충무로,31127,32229,63356
2022-05-19,4호선,한성대입구,15964,15346,31310
2022-05-19,4호선,혜화,36750,37159,73909
2022-05-19,4호선,회현,27362,29332,56694
2022-05-19,5호선,강동,20006,19126,39132
2022-05-19,5호선,강일,4956,4632,9588
2022-05-19,5호선,개롱,7093,7251,14344
2022-05-19,5호선,개화산,6214,5775,11989
2022-05-19,5호선,거여,11546,10886,22432
2022-05-19,5호선,고덕,10561,10439,21000
2022-05-19,5호선,공덕,15742,16670,32412
2022-05-19,5호선,광나루,15850,14332,30182
2022-05-19,5호선,광화문,34831,37221,72052
2022-05-19,5호선,군자,11982,13125,25107
2022-05-19,5호선,굽은다리,10291,9833,20124
2022-05-19,5호선,길동,8511,8740,17251
2022-05-19,5호선,김포공항,7658,7597,15255
2022-05-19,5호선,까치산,31098,29317,60415
2022-05-19,5호선,답십리,17236,15467,32703
2022-05-19,5호선,동대문역사문화공원,3028,3646,6674
2022-05-19,5호선,둔촌동,9020,8818,17838
2022-05-19,5호선,마곡,11588,11737,23325
2022-05-19,5호선,마장,6459,6056,12515
2022-05-19,5호선,마천,7986,7661,15647
2022-05-19,5호선,마포,15715,16143,31858
2022-05-19,5호선,명일,9660,9748,19408
2022-05-19,5호선,목동,18709,19594,38303
2022-05-19,5호선,미사,17731,17389,35120
2022-05-19,5호선,발산,22416,23367,45783
2022-05-19,5호선,방이,7843,7967,15810
2022-05-19,5호선,방화,7404,7088,14492
2022-05-19,5호선,상일동,16524,15207,31731
2022-05-19,5호선,서대문,22342,23065,45407
2022-05-19,5호선,송정,7041,6480,13521
2022-05-19,5호선,신금호,7262,7357,14619
2022-05-19,5호선,신길,4518,4703,9221
2022-05-19,5호선,신정,15200,12068,27268
2022-05-19,5호선,아차산,16560,15577,32137
2022-05-19,5호선,애오개,7509,7440,14949
2022-05-19,5호선,양평,8024,7748,15772
2022-05-19,5호선,여의나루,13702,15096,28798
2022-05-19,5호선,여의도,30441,33149,63590
2022-05-19,5호선,영등포구청,4414,4579,8993
2022-05-19,5호선,영등포시장,10750,11123,21873
2022-05-19,5호선,오금,4098,4192,8290
2022-05-19,5호선,오목교,23270,24686,47956
2022-05-19,5호선,올림픽공원,5260,4512,9772
2022-05-19,5호선,왕십리,4773,5700,10473
2022-05-19,5호선,우장산,15959,15534,31493
2022-05-19,5호선,을지로4가,6565,6835,13400
2022-05-19,5호선,장한평,19892,19497,39389
2022-05-19,5호선,종로3가,14346,14473,28819
2022-05-19,5호선,천호,19388,19422,38810
2022-05-19,5호선,청구,4454,3868,8322
2022-05-19,5호선,충정로,5091,5289,10380
2022-05-19,5호선,하남검단산,6484,6139,12623
2022-05-19,5호선,하남시청,7746,7517,15263
2022-05-19,5호선,하남풍산,4592,4460,9052
2022-05-19,5호선,행당,8837,7591,16428
2022-05-19,5호선,화곡,30789,28420,59209
2022-05-19,6호선,고려대,10037,9625,19662
2022-05-19,6호선,공덕,20335,19820,40155
2022-05-19,6호선,광흥창,10243,9737,19980
2022-05-19,6호선,구산,8352,6019,14371
2022-05-19,6호선,녹사평,5339,5368,10707
2022-05-19,6호선,대흥,9752,10172,19924
2022-05-19,6호선,독바위,2924,3087,6011
2022-05-19,6호선,돌곶이,11408,10556,21964
2022-05-19,6호선,동묘앞,8222,8555,16777
2022-05-19,6호선,디지털미디어시티,15633,17064,32697
2022-05-19,6호선,마포구청,15358,13639,28997
2022-05-19,6호선,망원,14695,15637,30332
2022-05-19,6호선,버티고개,2453,2327,4780
2022-05-19,6호선,보문,8070,7186,15256
2022-05-19,6호선,봉화산,9828,9078,18906
2022-05-19,6호선,불광,4484,4545,9029
2022-05-19,6호선,삼각지,8067,7046,15113
2022-05-19,6호선,상수,9504,10958,20462
2022-05-19,6호선,상월곡,7038,6368,13406
2022-05-19,6호선,새절,14464,13270,27734
2022-05-19,6호선,석계,13838,14192,28030
2022-05-19,6호선,신당,8748,9332,18080
2022-05-19,6호선,안암,15447,15388,30835
2022-05-19,6호선,약수,3931,3992,7923
2022-05-19,6호선,역촌,4049,4607,8656
2022-05-19,6호선,연신내,1,0,1
2022-05-19,6호선,월곡,13379,12917,26296
2022-05-19,6호선,월드컵경기장,5328,5730,11058
2022-05-19,6호선,응암,19110,18387,37497
2022-05-19,6호선,이태원,10883,11954,22837
2022-05-19,6호선,증산,10926,10918,21844
2022-05-19,6호선,창신,4035,3365,7400
2022-05-19,6호선,청구,3808,4173,7981
2022-05-19,6호선,태릉입구,7760,9175,16935
2022-05-19,6호선,한강진,8759,10306,19065
2022-05-19,6호선,합정,14214,14125,28339
2022-05-19,6호선,화랑대,14021,10924,24945
2022-05-19,6호선,효창공원앞,8201,7498,15699
2022-05-19,7호선,가산디지털단지,47718,48310,96028
2022-05-19,7호선,강남구청,17358,19534,36892
2022-05-19,7호선,건대입구,13629,14562,28191
2022-05-19,7호선,고속터미널,16527,14039,30566
2022-05-19,7호선,공릉,14010,13493,27503
2022-05-19,7호선,광명사거리,23396,22898,46294
2022-05-19,7호선,군자,16069,12563,28632
2022-05-19,7호선,남구로,16472,17864,34336
2022-05-19,7호선,남성,12423,11293,23716
2022-05-19,7호선,내방,15795,16280,32075
2022-05-19,7호선,노원,20629,22082,42711
2022-05-19,7호선,논현,21859,23890,45749
2022-05-19,7호선,대림,7857,7795,15652
2022-05-19,7호선,도봉산,10444,12090,22534
2022-05-19,7호선,뚝섬유원지,11193,10736,21929
2022-05-19,7호선,마들,14328,13376,27704
2022-05-19,7호선,먹골,11238,10678,21916
2022-05-19,7호선,면목,17566,16800,34366
2022-05-19,7호선,반포,6446,6194,12640
2022-05-19,7호선,보라매,11393,11252,22645
2022-05-19,7호선,사가정,17510,17410,34920
2022-05-19,7호선,상도,12677,12179,24856
2022-05-19,7호선,상봉,18265,17064,35329
2022-05-19,7호선,수락산,14065,13591,27656
2022-05-19,7호선,숭실대입구,16084,16149,32233
2022-05-19,7호선,신대방삼거리,18041,17154,35195
2022-05-19,7호선,신풍,12687,12072,24759
2022-05-19,7호선,어린이대공원,17675,17989,35664
2022-05-19,7호선,온수,12054,11354,23408
2022-05-19,7호선,용마산,6810,6437,13247
2022-05-19,7호선,이수,17092,16710,33802
2022-05-19,7호선,장승배기,9882,9326,19208
2022-05-19,7호선,장암,2491,940,3431
2022-05-19,7호선,중계,16221,14787,31008
2022-05-19,7호선,중곡,11855,10967,22822
2022-05-19,7호선,중화,12019,11388,23407
2022-05-19,7호선,천왕,12697,11997,24694
2022-05-19,7호선,철산,22770,23103,45873
2022-05-19,7호선,청담,21130,23990,45120
2022-05-19,7호선,태릉입구,12428,12380,24808
2022-05-19,7호선,하계,19872,18423,38295
2022-05-19,7호선,학동,26080,28132,54212
2022-05-19,8호선,가락시장,8169,9260,17429
2022-05-19,8호선,강동구청,11570,11704,23274
2022-05-19,8호선,남위례,6010,6120,12130
2022-05-19,8호선,남한산성입구,17223,15805,33028
2022-05-19,8호선,단대오거리,12525,11788,24313
2022-05-19,8호선,모란,6862,5383,12245
2022-05-19,8호선,몽촌토성,8091,8042,16133
2022-05-19,8호선,문정,23342,24845,48187
2022-05-19,8호선,복정,11148,9391,20539
2022-05-19,8호선,산성,6124,6160,12284
2022-05-19,8호선,석촌,8441,9549,17990
2022-05-19,8호선,송파,9140,8870,18010
2022-05-19,8호선,수진,5833,5388,11221
2022-05-19,8호선,신흥,4442,4702,9144
2022-05-19,8호선,암사,20716,17872,38588
2022-05-19,8호선,잠실,14574,17558,32132
2022-05-19,8호선,장지,18868,18047,36915
2022-05-19,8호선,천호,15642,17924,33566
2022-05-19,9호선,가양,22764,21884,44648
2022-05-19,9호선,개화,2886,1928,4814
2022-05-19,9호선,고속터미널,14192,17073,31265
2022-05-19,9호선,공항시장,3246,3388,6634
2022-05-19,9호선,구반포,1325,1442,2767
2022-05-19,9호선,국회의사당,16737,17733,34470
2022-05-19,9호선,김포공항,7745,12576,20321
2022-05-19,9호선,노들,4915,4069,8984
2022-05-19,9호선,노량진,28859,27488,56347
2022-05-19,9호선,당산,20266,20293,40559
2022-05-19,9호선,동작,2212,1773,3985
2022-05-19,9호선,등촌,12243,11493,23736
2022-05-19,9호선,마곡나루,13474,13267,26741
2022-05-19,9호선,사평,3926,3752,7678
2022-05-19,9호선,샛강,6443,6871,13314
2022-05-19,9호선,선유도,9739,9194,18933
2022-05-19,9호선,신논현,33904,34087,67991
2022-05-19,9호선,신목동,4800,4107,8907
2022-05-19,9호선,신반포,4137,4054,8191
2022-05-19,9호선,신방화,7292,7049,14341
2022-05-19,9호선,양천향교,10790,10933,21723
2022-05-19,9호선,여의도,30112,29959,60071
2022-05-19,9호선,염창,19053,18350,37403
2022-05-19,9호선,증미,7872,7599,15471
2022-05-19,9호선,흑석,10108,10174,20282
2022-05-19,9호선2~3단계,둔촌오륜,1265,1097,2362
2022-05-19,9호선2~3단계,봉은사,18418,19268,37686
2022-05-19,9호선2~3단계,삼성중앙,7532,8097,15629
2022-05-19,9호선2~3단계,삼전,7328,7031,14359
2022-05-19,9호선2~3단계,석촌,9182,8147,17329
2022-05-19,9호선2~3단계,석촌고분,6529,6247,12776
2022-05-19,9호선2~3단계,선정릉,10811,11974,22785
2022-05-19,9호선2~3단계,송파나루,5313,5571,10884
2022-05-19,9호선2~3단계,언주,10844,11352,22196
2022-05-19,9호선2~3단계,올림픽공원,6974,7048,14022
2022-05-19,9호선2~3단계,종합운동장,4585,4653,9238
2022-05-19,9호선2~3단계,중앙보훈병원,12042,10520,22562
2022-05-19,9호선2~3단계,한성백제,2805,2504,5309
2022-05-19,경강선,경기광주,8774,8161,16935
2022-05-19,경강선,곤지암,2568,2574,5142
2022-05-19,경강선,부발,2467,2225,4692
2022-05-19,경강선,삼동,2697,2392,5089
2022-05-19,경강선,세종대왕릉,389,370,759
2022-05-19,경강선,신둔도예촌,1833,1640,3473
2022-05-19,경강선,여주,2415,2406,4821
2022-05-19,경강선,이매,1271,1065,2336
2022-05-19,경강선,이천,2854,2891,5745
2022-05-19,경강선,초월,3517,3347,6864
2022-05-19,경강선,판교,5402,5420,10822
2022-05-19,경부선,가산디지털단지,20155,23499,43654
2022-05-19,경부선,관악,8366,7576,15942
2022-05-19,경부선,광명,3682,3249,6931
2022-05-19,경부선,구로,20019,20799,40818
2022-05-19,경부선,군포,8341,8163,16504
2022-05-19,경부선,금정,30086,30262,60348
2022-05-19,경부선,금천구청,13164,13120,26284
2022-05-19,경부선,남영,10609,11239,21848
2022-05-19,경부선,노량진,9321,9388,18709
2022-05-19,경부선,당정,8018,7510,15528
2022-05-19,경부선,대방,14392,14822,29214
2022-05-19,경부선,독산,20412,21099,41511
2022-05-19,경부선,두정,8438,11291,19729
2022-05-19,경부선,명학,11607,11299,22906
2022-05-19,경부선,병점,18377,18207,36584
2022-05-19,경부선,서동탄,1579,1367,2946
2022-05-19,경부선,서울역,7114,2214,9328
2022-05-19,경부선,서정리,9108,7434,16542
2022-05-19,경부선,석수,10993,9744,20737
2022-05-19,경부선,성균관대,17151,16652,33803
2022-05-19,경부선,성환,7805,7013,14818
2022-05-19,경부선,세류,3415,3089,6504
2022-05-19,경부선,세마,3152,2978,6130
2022-05-19,경부선,송탄,5007,4552,9559
2022-05-19,경부선,수원,40431,42925,83356
2022-05-19,경부선,신길,10110,8709,18819
2022-05-19,경부선,신도림,4638,4773,9411
2022-05-19,경부선,안양,29347,29124,58471
2022-05-19,경부선,영등포,39453,41182,80635
2022-05-19,경부선,오산,11363,11197,22560
2022-05-19,경부선,오산대,4715,4321,9036
2022-05-19,경부선,용산,36910,37482,74392
2022-05-19,경부선,의왕,10760,10647,21407
2022-05-19,경부선,직산,950,952,1902
2022-05-19,경부선,진위,1912,1733,3645
2022-05-19,경부선,천안,7706,7558,15264
2022-05-19,경부선,평택,14481,14074,28555
2022-05-19,경부선,평택지제,4219,4023,8242
2022-05-19,경부선,화서,9523,9080,18603
2022-05-19,경원선,가능,7724,7348,15072
2022-05-19,경원선,광운대,9885,9720,19605
2022-05-19,경원선,녹양,5413,4997,10410
2022-05-19,경원선,녹천,5237,4271,9508
2022-05-19,경원선,덕계,3926,3434,7360
2022-05-19,경원선,덕정,7340,6911,14251
2022-05-19,경원선,도봉,6723,6355,13078
2022-05-19,경원선,도봉산,8921,6052,14973
2022-05-19,경원선,동두천,3043,3187,6230
2022-05-19,경원선,동두천중앙,3458,3385,6843
2022-05-19,경원선,망월사,10689,10670,21359
2022-05-19,경원선,방학,10742,10533,21275
2022-05-19,경원선,보산,1622,1525,3147
2022-05-19,경원선,서빙고,2310,2095,4405
2022-05-19,경원선,석계,9433,10373,19806
2022-05-19,경원선,소요산,2966,2532,5498
2022-05-19,경원선,신이문,9216,8339,17555
2022-05-19,경원선,양주,8872,8380,17252
2022-05-19,경원선,옥수,62,49,111
2022-05-19,경원선,왕십리,15663,17202,32865
2022-05-19,경원선,외대앞,9266,9281,18547
2022-05-19,경원선,월계,9022,8332,17354
2022-05-19,경원선,응봉,2281,1893,4174
2022-05-19,경원선,의정부,20080,21195,41275
2022-05-19,경원선,이촌,4207,3220,7427
2022-05-19,경원선,지행,7408,7523,14931
2022-05-19,경원선,청량리,16863,17190,34053
2022-05-19,경원선,한남,4576,4401,8977
2022-05-19,경원선,회룡,14148,14074,28222
2022-05-19,경의선,가좌,6306,5936,12242
2022-05-19,경의선,강매,3741,3200,6941
2022-05-19,경의선,곡산,718,760,1478
2022-05-19,경의선,공덕,3858,3635,7493
2022-05-19,경의선,금릉,5469,5387,10856
2022-05-19,경의선,금촌,7021,7025,14046
2022-05-19,경의선,능곡,4279,3975,8254
2022-05-19,경의선,디지털미디어시티,2924,2689,5613
2022-05-19,경의선,문산,5839,5901,11740
2022-05-19,경의선,백마,7962,7657,15619
2022-05-19,경의선,서강대,2456,2462,4918
2022-05-19,경의선,서울역,5179,6690,11869
2022-05-19,경의선,수색,3186,3381,6567
2022-05-19,경의선,신촌,977,1322,2299
2022-05-19,경의선,야당,8763,8708,17471
2022-05-19,경의선,운정,7860,7399,15259
2022-05-19,경의선,월롱,3340,3041,6381
2022-05-19,경의선,일산,10840,10621,21461
2022-05-19,경의선,임진강,23,11,34
2022-05-19,경의선,탄현,8794,8301,17095
2022-05-19,경의선,파주,1726,1302,3028
2022-05-19,경의선,풍산,6412,6043,12455
2022-05-19,경의선,행신,9017,9017,18034
2022-05-19,경의선,홍대입구,1906,2280,4186
2022-05-19,경의선,화전,3875,3721,7596
2022-05-19,경의선,효창공원앞,3493,3763,7256
2022-05-19,경인선,간석,6587,6186,12773
2022-05-19,경인선,개봉,23628,22910,46538
2022-05-19,경인선,구일,8299,7919,16218
2022-05-19,경인선,도원,3809,3758,7567
2022-05-19,경인선,도화,4631,4279,8910
2022-05-19,경인선,동암,15920,15876,31796
2022-05-19,경인선,동인천,15218,14541,29759
2022-05-19,경인선,백운,7578,7545,15123
2022-05-19,경인선,부개,9557,8857,18414
2022-05-19,경인선,부천,35133,35258,70391
2022-05-19,경인선,부평,30719,33148,63867
2022-05-19,경인선,소사,9893,9474,19367
2022-05-19,경인선,송내,30514,30490,61004
2022-05-19,경인선,역곡,32114,31320,63434
2022-05-19,경인선,오류동,13056,11863,24919
2022-05-19,경인선,온수,8081,7601,15682
2022-05-19,경인선,인천,4115,3241,7356
2022-05-19,경인선,제물포,12442,11702,24144
2022-05-19,경인선,주안,21663,19792,41455
2022-05-19,경인선,중동,10492,9670,20162
2022-05-19,경춘선,가평,1956,2049,4005
2022-05-19,경춘선,갈매,3410,2932,6342
2022-05-19,경춘선,강촌,453,484,937
2022-05-19,경춘선,굴봉산,194,188,382
2022-05-19,경춘선,금곡,1821,1771,3592
2022-05-19,경춘선,김유정,411,449,860
2022-05-19,경춘선,남춘천,3245,2864,6109
2022-05-19,경춘선,대성리,658,694,1352
2022-05-19,경춘선,마석,4420,4394,8814
2022-05-19,경춘선,백양리,104,108,212
2022-05-19,경춘선,별내,3542,3369,6911
2022-05-19,경춘선,사릉,2790,2772,5562
2022-05-19,경춘선,상천,335,299,634
2022-05-19,경춘선,신내,2508,2417,4925
2022-05-19,경춘선,천마산,1948,1778,3726
2022-05-19,경춘선,청평,1793,1760,3553
2022-05-19,경춘선,춘천,2134,1667,3801
2022-05-19,경춘선,퇴계원,3990,3570,7560
2022-05-19,경춘선,평내호평,7226,7053,14279
2022-05-19,공항철도,검암,7457,7422,14879
2022-05-19,공항철도,계양,12171,11301,23472
2022-05-19,공항철도,공덕,2592,3313,5905
2022-05-19,공항철도,공항화물청사,2452,2668,5120
2022-05-19,공항철도,김포공항,12744,6630,19374
2022-05-19,공항철도,디지털미디어시티,15486,14572,30058
2022-05-19,공항철도,마곡나루,11147,10962,22109
2022-05-19,공항철도,서울역,9292,8427,17719
2022-05-19,공항철도,영종,3443,3540,6983
2022-05-19,공항철도,운서,7717,7745,15462
2022-05-19,공항철도,인천공항1터미널,6290,5523,11813
2022-05-19,공항철도,인천공항2터미널,3447,3007,6454
2022-05-19,공항철도,청라국제도시,7902,7593,15495
2022-05-19,공항철도,홍대입구,10718,10808,21526
2022-05-19,과천선,경마공원,1537,1526,3063
2022-05-19,과천선,과천,7017,6424,13441
2022-05-19,과천선,대공원,7358,7334,14692
2022-05-19,과천선,범계,28550,28470,57020
2022-05-19,과천선,선바위,9358,8302,17660
2022-05-19,과천선,인덕원,27241,27848,55089
2022-05-19,과천선,정부과천청사,11974,11742,23716
2022-05-19,과천선,평촌,19784,19485,39269
2022-05-19,분당선,가천대,13730,14457,28187
2022-05-19,분당선,강남구청,10956,12821,23777
2022-05-19,분당선,개포동,4571,4555,9126
2022-05-19,분당선,구룡,2687,2512,5199
2022-05-19,분당선,구성,6025,6222,12247
2022-05-19,분당선,기흥,11769,10885,22654
2022-05-19,분당선,대모산입구,5123,4698,9821
2022-05-19,분당선,도곡,7794,7465,15259
2022-05-19,분당선,망포,16218,15314,31532
2022-05-19,분당선,매교,3630,3555,7185
2022-05-19,분당선,매탄권선,6145,5767,11912
2022-05-19,분당선,모란,28869,27449,56318
2022-05-19,분당선,미금,17183,18213,35396
2022-05-19,분당선,보정,3054,2650,5704
2022-05-19,분당선,상갈,6388,6092,12480
2022-05-19,분당선,서울숲,12940,13532,26472
2022-05-19,분당선,서현,26099,26964,53063
2022-05-19,분당선,선릉,14703,22886,37589
2022-05-19,분당선,선정릉,8798,9588,18386
2022-05-19,분당선,수내,14794,14962,29756
2022-05-19,분당선,수서,15227,15955,31182
2022-05-19,분당선,수원,9197,7728,16925
2022-05-19,분당선,수원시청,13495,14774,28269
2022-05-19,분당선,신갈,5098,4980,10078
2022-05-19,분당선,압구정로데오,20353,22964,43317
2022-05-19,분당선,야탑,29239,30413,59652
2022-05-19,분당선,영통,9287,9382,18669
2022-05-19,분당선,오리,13115,10673,23788
2022-05-19,분당선,이매,6608,6141,12749
2022-05-19,분당선,정자,19516,20949,40465
2022-05-19,분당선,죽전,16212,17583,33795
2022-05-19,분당선,청명,4869,4751,9620
2022-05-19,분당선,태평,14708,13943,28651
2022-05-19,분당선,한티,16041,16957,32998
2022-05-19,수인선,고색,5479,5295,10774
2022-05-19,수인선,남동인더스파크,2315,2674,4989
2022-05-19,수인선,달월,131,102,233
2022-05-19,수인선,사리,5673,5092,10765
2022-05-19,수인선,소래포구,7234,6819,14053
2022-05-19,수인선,송도,2749,2649,5398
2022-05-19,수인선,숭의,4504,4111,8615
2022-05-19,수인선,신포,2143,2165,4308
2022-05-19,수인선,야목,497,324,821
2022-05-19,수인선,어천,849,917,1766
2022-05-19,수인선,연수,5115,4985,10100
2022-05-19,수인선,오목천,4576,4053,8629
2022-05-19,수인선,원인재,4902,5059,9961
2022-05-19,수인선,월곶,3251,3007,6258
2022-05-19,수인선,인천,1161,1858,3019
2022-05-19,수인선,인천논현,6201,6525,12726
2022-05-19,수인선,인하대,8350,7912,16262
2022-05-19,수인선,호구포,4665,4858,9523
2022-05-19,안산선,고잔,10215,9610,19825
2022-05-19,안산선,대야미,5672,5059,10731
2022-05-19,안산선,반월,4763,4656,9419
2022-05-19,안산선,산본,17397,18717,36114
2022-05-19,안산선,상록수,18181,18213,36394
2022-05-19,안산선,수리산,4679,3866,8545
2022-05-19,안산선,신길온천,1971,1839,3810
2022-05-19,안산선,안산,12480,11027,23507
2022-05-19,안산선,오이도,9624,9470,19094
2022-05-19,안산선,정왕,11095,11269,22364
2022-05-19,안산선,중앙,20259,21187,41446
2022-05-19,안산선,초지,5692,6165,11857
2022-05-19,안산선,한대앞,11395,11524,22919
2022-05-19,우이신설선,4.19민주묘지,3984,3838,7822
2022-05-19,우이신설선,가오리,4519,4383,8902
2022-05-19,우이신설선,보문,1704,1684,3388
2022-05-19,우이신설선,북한산보국문,6867,6399,13266
2022-05-19,우이신설선,북한산우이,3076,2806,5882
2022-05-19,우이신설선,삼양,2124,2225,4349
2022-05-19,우이신설선,삼양사거리,2665,2636,5301
2022-05-19,우이신설선,성신여대입구,3592,3975,7567
2022-05-19,우이신설선,솔밭공원,2718,2518,5236
2022-05-19,우이신설선,솔샘,6484,5884,12368
2022-05-19,우이신설선,신설동,2353,2253,4606
2022-05-19,우이신설선,정릉,5506,4849,10355
2022-05-19,우이신설선,화계,3762,3474,7236
2022-05-19,일산선,대곡,2562,1985,4547
2022-05-19,일산선,대화,14068,11006,25074
2022-05-19,일산선,마두,8302,8331,16633
2022-05-19,일산선,백석,10733,10671,21404
2022-05-19,일산선,삼송,21711,20898,42609
2022-05-19,일산선,원당,12533,11757,24290
2022-05-19,일산선,원흥,12185,11334,23519
2022-05-19,일산선,정발산,7966,8142,16108
2022-05-19,일산선,주엽,10309,10237,20546
2022-05-19,일산선,지축,1,0,1
2022-05-19,일산선,화정,18786,19080,37866
2022-05-19,장항선,배방,1391,1310,2701
2022-05-19,장항선,봉명,1431,1372,2803
2022-05-19,장항선,신창,3286,2740,6026
2022-05-19,장항선,쌍용,3544,3142,6686
2022-05-19,장항선,아산,4376,3874,8250
2022-05-19,장항선,온양온천,5493,5592,11085
2022-05-19,장항선,탕정,1067,908,1975
2022-05-19,중앙선,구리,15110,15336,30446
2022-05-19,중앙선,국수,908,870,1778
2022-05-19,중앙선,덕소,6316,6336,12652
2022-05-19,중앙선,도농,12219,11031,23250
2022-05-19,중앙선,도심,2832,2241,5073
2022-05-19,중앙선,망우,8564,8439,17003
2022-05-19,중앙선,상봉,6310,6317,12627
2022-05-19,중앙선,신원,285,271,556
2022-05-19,중앙선,아신,625,654,1279
2022-05-19,중앙선,양수,2265,2284,4549
2022-05-19,중앙선,양원,3490,3340,6830
2022-05-19,중앙선,양정,794,682,1476
2022-05-19,중앙선,양평,2936,3043,5979
2022-05-19,중앙선,오빈,354,340,694
2022-05-19,중앙선,용문,2066,2041,4107
2022-05-19,중앙선,운길산,975,997,1972
2022-05-19,중앙선,원덕,438,410,848
2022-05-19,중앙선,중랑,6289,5954,12243
2022-05-19,중앙선,지평,78,89,167
2022-05-19,중앙선,팔당,1024,1062,2086
2022-05-19,중앙선,회기,28651,27824,56475
2022-05-20,1호선,동대문,12014,10815,22829
2022-05-20,1호선,동묘앞,8980,9466,18446
2022-05-20,1호선,서울역,55250,54967,110217
2022-05-20,1호선,시청,26169,26690,52859
2022-05-20,1호선,신설동,15355,15034,30389
2022-05-20,1호선,제기동,18477,18514,36991
2022-05-20,1호선,종각,39714,39777,79491
2022-05-20,1호선,종로3가,29985,27749,57734
2022-05-20,1호선,종로5가,25717,25831,51548
2022-05-20,1호선,청량리,22742,22841,45583
2022-05-20,2호선,강남,95179,98286,193465
2022-05-20,2호선,강변,38110,36005,74115
2022-05-20,2호선,건대입구,42121,47136,89257
2022-05-20,2호선,교대,38187,44108,82295
2022-05-20,2호선,구로디지털단지,64353,63778,128131
2022-05-20,2호선,구의,25716,24565,50281
2022-05-20,2호선,낙성대,31226,28591,59817
2022-05-20,2호선,당산,21624,25065,46689
2022-05-20,2호선,대림,26276,26381,52657
2022-05-20,2호선,도림천,1474,1454,2928
2022-05-20,2호선,동대문역사문화공원,13571,14964,28535
2022-05-20,2호선,뚝섬,25259,26771,52030
2022-05-20,2호선,문래,23971,24822,48793
2022-05-20,2호선,방배,20599,21237,41836
2022-05-20,2호선,봉천,26225,23094,49319
2022-05-20,2호선,사당,45373,50762,96135
2022-05-20,2호선,삼성,57712,59082,116794
2022-05-20,2호선,상왕십리,15740,15026,30766
2022-05-20,2호선,서울대입구,53678,51824,105502
2022-05-20,2호선,서초,23488,22364,45852
2022-05-20,2호선,선릉,61514,55016,116530
2022-05-20,2호선,성수,40866,46264,87130
2022-05-20,2호선,시청,26216,25782,51998
2022-05-20,2호선,신답,1947,2018,3965
2022-05-20,2호선,신당,15589,15854,31443
2022-05-20,2호선,신대방,29648,27923,57571
2022-05-20,2호선,신도림,53246,54864,108110
2022-05-20,2호선,신림,70661,67353,138014
2022-05-20,2호선,신설동,4006,3786,7792
2022-05-20,2호선,신정네거리,11712,11792,23504
2022-05-20,2호선,신촌,39652,41028,80680
2022-05-20,2호선,아현,12246,11170,23416
2022-05-20,2호선,양천구청,7909,7858,15767
2022-05-20,2호선,역삼,53502,61697,115199
2022-05-20,2호선,영등포구청,24301,25509,49810
2022-05-20,2호선,왕십리,19536,16360,35896
2022-05-20,2호선,용답,3367,3234,6601
2022-05-20,2호선,용두,2638,2530,5168
2022-05-20,2호선,을지로3가,25622,26942,52564
2022-05-20,2호선,을지로4가,14222,14742,28964
2022-05-20,2호선,을지로입구,42873,45106,87979
2022-05-20,2호선,이대,16173,16320,32493
2022-05-20,2호선,잠실,83341,83730,167071
2022-05-20,2호선,잠실나루,16505,15762,32267
2022-05-20,2호선,잠실새내,24601,25576,50177
2022-05-20,2호선,종합운동장,18410,21922,40332
2022-05-20,2호선,충정로,10616,11288,21904
2022-05-20,2호선,한양대,13228,14135,27363
2022-05-20,2호선,합정,35154,39700,74854
2022-05-20,2호선,홍대입구,64144,74950,139094
2022-05-20,3호선,가락시장,10362,10199,20561
2022-05-20,3호선,경복궁,32214,34693,66907
2022-05-20,3호선,경찰병원,8147,7954,16101
2022-05-20,3호선,고속터미널,54268,54292,108560
2022-05-20,3호선,교대,16931,11026,27957
2022-05-20,3호선,구파발,23028,22178,45206
2022-05-20,3호선,금호,8871,7998,16869
2022-05-20,3호선,남부터미널,34573,34537,69110
2022-05-20,3호선,녹번,17490,15102,32592
2022-05-20,3호선,대청,11019,10157,21176
2022-05-20,3호선,대치,12511,12338,24849
2022-05-20,3호선,도곡,6037,6351,12388
2022-05-20,3호선,독립문,8337,8706,17043
2022-05-20,3호선,동대입구,9323,11102,20425
2022-05-20,3호선,매봉,13998,13551,27549
2022-05-20,3호선,무악재,4468,4289,8757
2022-05-20,3호선,불광,17907,19070,36977
2022-05-20,3호선,수서,20604,20622,41226
2022-05-20,3호선,신사,35000,38374,73374
2022-05-20,3호선,안국,28133,28495,56628
2022-05-20,3호선,압구정,36288,39716,76004
2022-05-20,3호선,약수,14936,14225,29161
2022-05-20,3호선,양재,44690,47810,92500
2022-05-20,3호선,연신내,40492,38465,78957
2022-05-20,3호선,오금,7036,6303,13339
2022-05-20,3호선,옥수,10262,10337,20599
2022-05-20,3호선,을지로3가,12125,13004,25129
2022-05-20,3호선,일원,11595,10956,22551
2022-05-20,3호선,잠원,5725,5406,11131
2022-05-20,3호선,종로3가,11467,14162,25629
2022-05-20,3호선,지축,5789,5214,11003
2022-05-20,3호선,충무로,1,0,1
2022-05-20,3호선,학여울,3140,3144,6284
2022-05-20,3호선,홍제,19948,18523,38471
2022-05-20,4호선,길음,24573,23428,48001
2022-05-20,4호선,남태령,1482,1194,2676
2022-05-20,4호선,노원,21404,24823,46227
2022-05-20,4호선,당고개,10100,8775,18875
2022-05-20,4호선,동대문,21958,21983,43941
2022-05-20,4호선,동대문역사문화공원,16457,14568,31025
2022-05-20,4호선,동작,2027,2166,4193
2022-05-20,4호선,명동,23195,24162,47357
2022-05-20,4호선,미아,17392,16350,33742
2022-05-20,4호선,미아사거리,30372,29470,59842
2022-05-20,4호선,사당,30589,26588,57177
2022-05-20,4호선,삼각지,6244,7356,13600
2022-05-20,4호선,상계,21359,19525,40884
2022-05-20,4호선,서울역,12847,22516,35363
2022-05-20,4호선,성신여대입구,24143,23133,47276
2022-05-20,4호선,수유,38347,38006,76353
2022-05-20,4호선,숙대입구,15586,15342,30928
2022-05-20,4호선,신용산,19040,20591,39631
2022-05-20,4호선,쌍문,32203,28904,61107
2022-05-20,4호선,이촌,9710,10774,20484
2022-05-20,4호선,창동,28533,30261,58794
2022-05-20,4호선,총신대입구,21584,23664,45248
2022-05-20,4호선,충무로,30108,32408,62516
2022-05-20,4호선,한성대입구,16437,15643,32080
2022-05-20,4호선,혜화,39007,38732,77739
2022-05-20,4호선,회현,27883,29238,57121
2022-05-20,5호선,강동,20370,19044,39414
2022-05-20,5호선,강일,5042,4424,9466
2022-05-20,5호선,개롱,7370,7410,14780
2022-05-20,5호선,개화산,6221,5727,11948
2022-05-20,5호선,거여,11587,10750,22337
2022-05-20,5호선,고덕,11161,10805,21966
2022-05-20,5호선,공덕,15826,16993,32819
2022-05-20,5호선,광나루,15987,14096,30083
2022-05-20,5호선,광화문,33599,36328,69927
2022-05-20,5호선,군자,12397,13947,26344
2022-05-20,5호선,굽은다리,10501,9977,20478
2022-05-20,5호선,길동,9000,9318,18318
2022-05-20,5호선,김포공항,8651,8359,17010
2022-05-20,5호선,까치산,31857,29379,61236
2022-05-20,5호선,답십리,17591,15843,33434
2022-05-20,5호선,동대문역사문화공원,3001,3609,6610
2022-05-20,5호선,둔촌동,9023,8963,17986
2022-05-20,5호선,마곡,11890,11800,23690
2022-05-20,5호선,마장,6412,6055,12467
2022-05-20,5호선,마천,8152,7499,15651
2022-05-20,5호선,마포,15602,16108,31710
2022-05-20,5호선,명일,9906,10067,19973
2022-05-20,5호선,목동,19021,19906,38927
2022-05-20,5호선,미사,17794,17552,35346
2022-05-20,5호선,발산,21782,23559,45341
2022-05-20,5호선,방이,7786,7952,15738
2022-05-20,5호선,방화,7538,7110,14648
2022-05-20,5호선,상일동,16691,15262,31953
2022-05-20,5호선,서대문,21275,21549,42824
2022-05-20,5호선,송정,7073,6570,13643
2022-05-20,5호선,신금호,7375,7376,14751
2022-05-20,5호선,신길,4560,4638,9198
2022-05-20,5호선,신정,15538,11843,27381
2022-05-20,5호선,아차산,17312,16040,33352
2022-05-20,5호선,애오개,7608,7612,15220
2022-05-20,5호선,양평,8008,7628,15636
2022-05-20,5호선,여의나루,17490,18720,36210
2022-05-20,5호선,여의도,29811,32992,62803
2022-05-20,5호선,영등포구청,4269,4438,8707
2022-05-20,5호선,영등포시장,11513,11568,23081
2022-05-20,5호선,오금,4099,4164,8263
2022-05-20,5호선,오목교,24266,26092,50358
2022-05-20,5호선,올림픽공원,5185,4430,9615
2022-05-20,5호선,왕십리,4990,6378,11368
2022-05-20,5호선,우장산,16501,15634,32135
2022-05-20,5호선,을지로4가,6922,7144,14066
2022-05-20,5호선,장한평,20544,19916,40460
2022-05-20,5호선,종로3가,16018,16758,32776
2022-05-20,5호선,천호,20595,20927,41522
2022-05-20,5호선,청구,4351,4002,8353
2022-05-20,5호선,충정로,4981,5020,10001
2022-05-20,5호선,하남검단산,6616,6189,12805
2022-05-20,5호선,하남시청,7870,7401,15271
2022-05-20,5호선,하남풍산,4669,4577,9246
2022-05-20,5호선,행당,9079,7686,16765
2022-05-20,5호선,화곡,31787,28599,60386
2022-05-20,6호선,고려대,9812,9095,18907
2022-05-20,6호선,공덕,20870,20399,41269
2022-05-20,6호선,광흥창,10199,9607,19806
2022-05-20,6호선,구산,8459,5853,14312
2022-05-20,6호선,녹사평,6128,6567,12695
2022-05-20,6호선,대흥,9960,10178,20138
2022-05-20,6호선,독바위,3009,3026,6035
2022-05-20,6호선,돌곶이,10505,9410,19915
2022-05-20,6호선,동묘앞,8722,8424,17146
2022-05-20,6호선,디지털미디어시티,15338,16461,31799
2022-05-20,6호선,마포구청,15636,13535,29171
2022-05-20,6호선,망원,15622,16955,32577
2022-05-20,6호선,버티고개,2472,2309,4781
2022-05-20,6호선,보문,8416,7321,15737
2022-05-20,6호선,봉화산,9811,9297,19108
2022-05-20,6호선,불광,4752,4694,9446
2022-05-20,6호선,삼각지,8430,7105,15535
2022-05-20,6호선,상수,10138,12649,22787
2022-05-20,6호선,상월곡,6995,6149,13144
2022-05-20,6호선,새절,14240,13094,27334
2022-05-20,6호선,석계,14021,14053,28074
2022-05-20,6호선,신내,2,0,2
2022-05-20,6호선,신당,8617,8268,16885
2022-05-20,6호선,안암,14585,13740,28325
2022-05-20,6호선,약수,4002,4201,8203
2022-05-20,6호선,역촌,4095,4627,8722
2022-05-20,6호선,연신내,1,0,1
2022-05-20,6호선,월곡,13518,12654,26172
2022-05-20,6호선,월드컵경기장,5696,5989,11685
2022-05-20,6호선,응암,19317,18337,37654
2022-05-20,6호선,이태원,12770,17882,30652
2022-05-20,6호선,증산,11180,10720,21900
2022-05-20,6호선,창신,3979,3232,7211
2022-05-20,6호선,청구,4039,4170,8209
2022-05-20,6호선,태릉입구,8138,9497,17635
2022-05-20,6호선,한강진,9869,11696,21565
2022-05-20,6호선,합정,15014,15251,30265
2022-05-20,6호선,화랑대,14145,10591,24736
2022-05-20,6호선,효창공원앞,8278,7378,15656
2022-05-20,7호선,가산디지털단지,46932,47075,94007
2022-05-20,7호선,강남구청,17084,19720,36804
2022-05-20,7호선,건대입구,14094,15342,29436
2022-05-20,7호선,고속터미널,20110,16014,36124
2022-05-20,7호선,공릉,14404,13827,28231
2022-05-20,7호선,광명사거리,24140,23425,47565
2022-05-20,7호선,군자,16300,12630,28930
2022-05-20,7호선,남구로,16388,17549,33937
2022-05-20,7호선,남성,12340,10923,23263
2022-05-20,7호선,내방,16268,16595,32863
2022-05-20,7호선,노원,21708,23653,45361
2022-05-20,7호선,논현,22494,24843,47337
2022-05-20,7호선,대림,8123,8536,16659
2022-05-20,7호선,도봉산,10696,12091,22787
2022-05-20,7호선,뚝섬유원지,13277,12702,25979
2022-05-20,7호선,마들,14436,13157,27593
2022-05-20,7호선,먹골,11530,10871,22401
2022-05-20,7호선,면목,17913,16767,34680
2022-05-20,7호선,반포,6652,6260,12912
2022-05-20,7호선,보라매,11472,11157,22629
2022-05-20,7호선,부천시청,1,0,1
2022-05-20,7호선,사가정,18002,17651,35653
2022-05-20,7호선,상도,12898,11942,24840
2022-05-20,7호선,상봉,19119,18169,37288
2022-05-20,7호선,수락산,14074,13524,27598
2022-05-20,7호선,숭실대입구,16080,15536,31616
2022-05-20,7호선,신대방삼거리,18453,17145,35598
2022-05-20,7호선,신풍,13100,12356,25456
2022-05-20,7호선,어린이대공원,20457,20350,40807
2022-05-20,7호선,온수,11935,11179,23114
2022-05-20,7호선,용마산,6796,6376,13172
2022-05-20,7호선,이수,18221,17500,35721
2022-05-20,7호선,장승배기,9964,9509,19473
2022-05-20,7호선,장암,2471,1012,3483
2022-05-20,7호선,중계,16136,14162,30298
2022-05-20,7호선,중곡,11630,10589,22219
2022-05-20,7호선,중화,12405,11705,24110
2022-05-20,7호선,천왕,12725,11655,24380
2022-05-20,7호선,철산,23617,24228,47845
2022-05-20,7호선,청담,21388,24416,45804
2022-05-20,7호선,태릉입구,13091,12926,26017
2022-05-20,7호선,하계,20060,18128,38188
2022-05-20,7호선,학동,25328,27789,53117
2022-05-20,8호선,가락시장,8509,9732,18241
2022-05-20,8호선,강동구청,11625,11420,23045
2022-05-20,8호선,남위례,6055,6219,12274
2022-05-20,8호선,남한산성입구,16624,14626,31250
2022-05-20,8호선,단대오거리,12539,11400,23939
2022-05-20,8호선,모란,4988,4189,9177
2022-05-20,8호선,몽촌토성,8090,8267,16357
2022-05-20,8호선,문정,23384,24338,47722
2022-05-20,8호선,복정,11079,9260,20339
2022-05-20,8호선,산성,6147,5989,12136
2022-05-20,8호선,석촌,8411,9690,18101
2022-05-20,8호선,송파,9124,8827,17951
2022-05-20,8호선,수진,6301,5646,11947
2022-05-20,8호선,신흥,4947,5351,10298
2022-05-20,8호선,암사,20579,17595,38174
2022-05-20,8호선,잠실,15745,20197,35942
2022-05-20,8호선,장지,19443,17837,37280
2022-05-20,8호선,천호,16314,19361,35675
2022-05-20,9호선,가양,23369,22362,45731
2022-05-20,9호선,개화,2868,1978,4846
2022-05-20,9호선,고속터미널,16782,21832,38614
2022-05-20,9호선,공항시장,3304,3405,6709
2022-05-20,9호선,구반포,1450,1548,2998
2022-05-20,9호선,국회의사당,17002,17653,34655
2022-05-20,9호선,김포공항,8914,14631,23545
2022-05-20,9호선,노들,5200,4313,9513
2022-05-20,9호선,노량진,30397,28977,59374
2022-05-20,9호선,당산,20596,20824,41420
2022-05-20,9호선,동작,2637,2157,4794
2022-05-20,9호선,등촌,12571,11512,24083
2022-05-20,9호선,마곡나루,13721,13652,27373
2022-05-20,9호선,사평,4250,3843,8093
2022-05-20,9호선,샛강,6401,6823,13224
2022-05-20,9호선,선유도,9503,8922,18425
2022-05-20,9호선,신논현,37570,39157,76727
2022-05-20,9호선,신목동,5231,4271,9502
2022-05-20,9호선,신반포,4279,4279,8558
2022-05-20,9호선,신방화,7649,7024,14673
2022-05-20,9호선,양천향교,11135,10799,21934
2022-05-20,9호선,여의도,30423,29800,60223
2022-05-20,9호선,염창,19239,17819,37058
2022-05-20,9호선,증미,8047,7676,15723
2022-05-20,9호선,흑석,10133,10032,20165
2022-05-20,9호선2~3단계,둔촌오륜,1300,1111,2411
2022-05-20,9호선2~3단계,봉은사,18707,19360,38067
2022-05-20,9호선2~3단계,삼성중앙,7898,8367,16265
2022-05-20,9호선2~3단계,삼전,7598,7009,14607
2022-05-20,9호선2~3단계,석촌,9756,8253,18009
2022-05-20,9호선2~3단계,석촌고분,6779,6455,13234
2022-05-20,9호선2~3단계,선정릉,10844,11920,22764
2022-05-20,9호선2~3단계,송파나루,5737,6123,11860
2022-05-20,9호선2~3단계,언주,11317,11528,22845
2022-05-20,9호선2~3단계,올림픽공원,7536,7024,14560
2022-05-20,9호선2~3단계,종합운동장,5338,6143,11481
2022-05-20,9호선2~3단계,중앙보훈병원,11944,10375,22319
2022-05-20,9호선2~3단계,한성백제,3101,2644,5745
2022-05-20,경강선,경기광주,8843,8226,17069
2022-05-20,경강선,곤지암,2689,2660,5349
2022-05-20,경강선,부발,2909,2283,5192
2022-05-20,경강선,삼동,2822,2435,5257
2022-05-20,경강선,세종대왕릉,392,377,769
2022-05-20,경강선,신둔도예촌,1999,1684,3683
2022-05-20,경강선,여주,2760,2934,5694
2022-05-20,경강선,이매,1247,1081,2328
2022-05-20,경강선,이천,3134,3332,6466
2022-05-20,경강선,초월,3799,3349,7148
2022-05-20,경강선,판교,5443,5444,10887
2022-05-20,경부선,가산디지털단지,19947,22856,42803
2022-05-20,경부선,관악,8257,7668,15925
2022-05-20,경부선,광명,4263,3987,8250
2022-05-20,경부선,구로,20213,21489,41702
2022-05-20,경부선,군포,8551,8304,16855
2022-05-20,경부선,금정,30588,30570,61158
2022-05-20,경부선,금천구청,13281,13131,26412
2022-05-20,경부선,남영,10678,11299,21977
2022-05-20,경부선,노량진,9986,9873,19859
2022-05-20,경부선,당정,7908,7386,15294
2022-05-20,경부선,대방,14696,14760,29456
2022-05-20,경부선,독산,20436,20530,40966
2022-05-20,경부선,두정,10291,7650,17941
2022-05-20,경부선,명학,10390,10044,20434
2022-05-20,경부선,병점,18237,18332,36569
2022-05-20,경부선,서동탄,1713,1597,3310
2022-05-20,경부선,서울역,10230,3291,13521
2022-05-20,경부선,서정리,9361,8036,17397
2022-05-20,경부선,석수,10883,9539,20422
2022-05-20,경부선,성균관대,17944,17176,35120
2022-05-20,경부선,성환,5500,4695,10195
2022-05-20,경부선,세류,3638,3286,6924
2022-05-20,경부선,세마,3423,3135,6558
2022-05-20,경부선,송탄,5971,5113,11084
2022-05-20,경부선,수원,43604,48435,92039
2022-05-20,경부선,신길,10255,8814,19069
2022-05-20,경부선,신도림,4554,4772,9326
2022-05-20,경부선,안양,28790,28777,57567
2022-05-20,경부선,영등포,44737,47656,92393
2022-05-20,경부선,오산,11976,11601,23577
2022-05-20,경부선,오산대,4653,4312,8965
2022-05-20,경부선,용산,43464,45005,88469
2022-05-20,경부선,의왕,10961,10469,21430
2022-05-20,경부선,직산,1059,946,2005
2022-05-20,경부선,진위,2072,1744,3816
2022-05-20,경부선,천안,8546,7484,16030
2022-05-20,경부선,평택,16657,16238,32895
2022-05-20,경부선,평택지제,4295,3968,8263
2022-05-20,경부선,화서,9912,9351,19263
2022-05-20,경원선,가능,7515,7211,14726
2022-05-20,경원선,광운대,8671,8275,16946
2022-05-20,경원선,녹양,5833,5326,11159
2022-05-20,경원선,녹천,5179,4150,9329
2022-05-20,경원선,덕계,3803,3388,7191
2022-05-20,경원선,덕정,7141,6471,13612
2022-05-20,경원선,도봉,6710,6405,13115
2022-05-20,경원선,도봉산,8727,5768,14495
2022-05-20,경원선,동두천,2777,3047,5824
2022-05-20,경원선,동두천중앙,3792,3722,7514
2022-05-20,경원선,망월사,9983,9840,19823
2022-05-20,경원선,방학,11048,10531,21579
2022-05-20,경원선,보산,2157,1785,3942
2022-05-20,경원선,서빙고,2394,2193,4587
2022-05-20,경원선,석계,9697,10773,20470
2022-05-20,경원선,소요산,2979,2507,5486
2022-05-20,경원선,신이문,9342,8479,17821
2022-05-20,경원선,양주,9172,8579,17751
2022-05-20,경원선,옥수,65,30,95
2022-05-20,경원선,왕십리,16891,18661,35552
2022-05-20,경원선,외대앞,9828,9336,19164
2022-05-20,경원선,월계,8854,8038,16892
2022-05-20,경원선,응봉,2123,1808,3931
2022-05-20,경원선,의정부,21516,23154,44670
2022-05-20,경원선,이촌,4560,3281,7841
2022-05-20,경원선,지행,8042,7782,15824
2022-05-20,경원선,청량리,20013,20325,40338
2022-05-20,경원선,한남,4607,4481,9088
2022-05-20,경원선,회룡,14695,14333,29028
2022-05-20,경의선,가좌,6394,5940,12334
2022-05-20,경의선,강매,3769,3139,6908
2022-05-20,경의선,계양,1,0,1
2022-05-20,경의선,곡산,708,730,1438
2022-05-20,경의선,공덕,4046,3753,7799
2022-05-20,경의선,금릉,5936,5690,11626
2022-05-20,경의선,금촌,7654,7574,15228
2022-05-20,경의선,능곡,4288,3945,8233
2022-05-20,경의선,디지털미디어시티,3046,2786,5832
2022-05-20,경의선,문산,6027,5897,11924
2022-05-20,경의선,백마,8168,7720,15888
2022-05-20,경의선,서강대,2793,2744,5537
2022-05-20,경의선,서울역,5163,6796,11959
2022-05-20,경의선,수색,3135,3261,6396
2022-05-20,경의선,신촌,965,1273,2238
2022-05-20,경의선,야당,9455,9845,19300
2022-05-20,경의선,운정,8128,7479,15607
2022-05-20,경의선,월롱,3268,2598,5866
2022-05-20,경의선,일산,10890,10741,21631
2022-05-20,경의선,임진강,15,15,30
2022-05-20,경의선,탄현,8854,8383,17237
2022-05-20,경의선,파주,1478,948,2426
2022-05-20,경의선,풍산,6560,6031,12591
2022-05-20,경의선,행신,9318,9487,18805
2022-05-20,경의선,홍대입구,2244,2760,5004
2022-05-20,경의선,화전,3132,2853,5985
2022-05-20,경의선,효창공원앞,3335,3721,7056
2022-05-20,경인선,간석,6716,6342,13058
2022-05-20,경인선,개봉,24180,23025,47205
2022-05-20,경인선,구일,8507,8412,16919
2022-05-20,경인선,도원,3927,3967,7894
2022-05-20,경인선,도화,4791,4403,9194
2022-05-20,경인선,동암,16810,16792,33602
2022-05-20,경인선,동인천,16224,15591,31815
2022-05-20,경인선,백운,7857,7616,15473
2022-05-20,경인선,부개,9676,8955,18631
2022-05-20,경인선,부천,36889,37776,74665
2022-05-20,경인선,부평,32698,37262,69960
2022-05-20,경인선,소사,9994,9406,19400
2022-05-20,경인선,송내,30995,30677,61672
2022-05-20,경인선,역곡,32509,31536,64045
2022-05-20,경인선,오류동,13511,11954,25465
2022-05-20,경인선,온수,8271,7806,16077
2022-05-20,경인선,인천,4838,3583,8421
2022-05-20,경인선,제물포,12697,11571,24268
2022-05-20,경인선,주안,22668,20336,43004
2022-05-20,경인선,중동,10621,9803,20424
2022-05-20,경춘선,가평,2053,2616,4669
2022-05-20,경춘선,갈매,3446,3006,6452
2022-05-20,경춘선,강촌,464,827,1291
2022-05-20,경춘선,굴봉산,174,344,518
2022-05-20,경춘선,금곡,1796,1689,3485
2022-05-20,경춘선,김유정,439,529,968
2022-05-20,경춘선,남춘천,4083,3402,7485
2022-05-20,경춘선,대성리,922,3543,4465
2022-05-20,경춘선,마석,4672,4570,9242
2022-05-20,경춘선,백양리,97,103,200
2022-05-20,경춘선,별내,3734,3432,7166
2022-05-20,경춘선,사릉,2844,2750,5594
2022-05-20,경춘선,상천,322,513,835
2022-05-20,경춘선,신내,2578,2373,4951
2022-05-20,경춘선,천마산,1933,1764,3697
2022-05-20,경춘선,청평,1925,2565,4490
2022-05-20,경춘선,춘천,2318,1713,4031
2022-05-20,경춘선,퇴계원,4101,3758,7859
2022-05-20,경춘선,평내호평,7317,7258,14575
2022-05-20,공항철도,검암,7714,7613,15327
2022-05-20,공항철도,계양,12096,11216,23312
2022-05-20,공항철도,공덕,2642,3515,6157
2022-05-20,공항철도,공항화물청사,2433,2495,4928
2022-05-20,공항철도,김포공항,15385,7509,22894
2022-05-20,공항철도,디지털미디어시티,14981,13750,28731
2022-05-20,공항철도,마곡나루,10241,9704,19945
2022-05-20,공항철도,서울역,11465,10569,22034
2022-05-20,공항철도,영종,3587,3801,7388
2022-05-20,공항철도,운서,8038,8028,16066
2022-05-20,공항철도,인천공항1터미널,6427,6466,12893
2022-05-20,공항철도,인천공항2터미널,3094,2967,6061
2022-05-20,공항철도,청라국제도시,8280,7882,16162
2022-05-20,공항철도,홍대입구,12488,13107,25595
2022-05-20,과천선,경마공원,7617,7792,15409
2022-05-20,과천선,과천,7509,6734,14243
2022-05-20,과천선,대공원,10494,10204,20698
2022-05-20,과천선,범계,30497,30935,61432
2022-05-20,과천선,선바위,9963,8620,18583
2022-05-20,과천선,인덕원,28542,28713,57255
2022-05-20,과천선,정부과천청사,12301,11970,24271
2022-05-20,과천선,평촌,19855,19320,39175
2022-05-20,분당선,가천대,12365,12568,24933
2022-05-20,분당선,강남구청,11352,12949,24301
2022-05-20,분당선,개포동,4545,4636,9181
2022-05-20,분당선,구룡,2811,2511,5322
2022-05-20,분당선,구성,6148,6088,12236
2022-05-20,분당선,기흥,11720,10968,22688
2022-05-20,분당선,대모산입구,5324,4670,9994
2022-05-20,분당선,도곡,8212,7777,15989
2022-05-20,분당선,망포,17990,16517,34507
2022-05-20,분당선,매교,3660,3661,7321
2022-05-20,분당선,매탄권선,6420,5884,12304
2022-05-20,분당선,모란,22859,23207,46066
2022-05-20,분당선,미금,17486,18501,35987
2022-05-20,분당선,보정,3042,2611,5653
2022-05-20,분당선,상갈,6578,6353,12931
2022-05-20,분당선,서울숲,14935,15359,30294
2022-05-20,분당선,서현,28247,29107,57354
2022-05-20,분당선,선릉,14499,22559,37058
2022-05-20,분당선,선정릉,8809,9311,18120
2022-05-20,분당선,수내,14969,14940,29909
2022-05-20,분당선,수서,16406,17057,33463
2022-05-20,분당선,수원,10142,8665,18807
2022-05-20,분당선,수원시청,15248,18002,33250
2022-05-20,분당선,신갈,5190,4998,10188
2022-05-20,분당선,압구정로데오,22498,27116,49614
2022-05-20,분당선,야탑,30341,31443,61784
2022-05-20,분당선,영통,10301,10502,20803
2022-05-20,분당선,오리,13342,10509,23851
2022-05-20,분당선,이매,6830,6185,13015
2022-05-20,분당선,정자,19559,20869,40428
2022-05-20,분당선,죽전,16508,17748,34256
2022-05-20,분당선,청명,5217,4815,10032
2022-05-20,분당선,태평,15015,14210,29225
2022-05-20,분당선,한티,16495,17253,33748
2022-05-20,수인선,고색,5748,5324,11072
2022-05-20,수인선,남동인더스파크,2438,2732,5170
2022-05-20,수인선,달월,154,114,268
2022-05-20,수인선,사리,5794,4906,10700
2022-05-20,수인선,소래포구,7064,6828,13892
2022-05-20,수인선,송도,2895,2727,5622
2022-05-20,수인선,숭의,4641,4211,8852
2022-05-20,수인선,신포,2246,2291,4537
2022-05-20,수인선,야목,470,333,803
2022-05-20,수인선,어천,1036,1038,2074
2022-05-20,수인선,연수,5503,5411,10914
2022-05-20,수인선,오목천,4540,3825,8365
2022-05-20,수인선,원인재,5179,5487,10666
2022-05-20,수인선,월곶,3186,2860,6046
2022-05-20,수인선,인천,1275,2118,3393
2022-05-20,수인선,인천논현,6456,6944,13400
2022-05-20,수인선,인하대,8366,7737,16103
2022-05-20,수인선,호구포,4674,4795,9469
2022-05-20,안산선,고잔,10593,10097,20690
2022-05-20,안산선,대야미,6107,5209,11316
2022-05-20,안산선,반월,4979,4717,9696
2022-05-20,안산선,산본,19074,20800,39874
2022-05-20,안산선,상록수,18832,18634,37466
2022-05-20,안산선,수리산,4802,3777,8579
2022-05-20,안산선,신길온천,2109,1924,4033
2022-05-20,안산선,안산,13085,12006,25091
2022-05-20,안산선,오이도,9904,10234,20138
2022-05-20,안산선,정왕,11693,11091,22784
2022-05-20,안산선,중앙,21417,23376,44793
2022-05-20,안산선,초지,5674,6078,11752
2022-05-20,안산선,한대앞,11849,11506,23355
2022-05-20,우이신설선,4.19민주묘지,4365,4264,8629
2022-05-20,우이신설선,가오리,4689,4446,9135
2022-05-20,우이신설선,보문,1670,1635,3305
2022-05-20,우이신설선,북한산보국문,7132,6168,13300
2022-05-20,우이신설선,북한산우이,3158,3267,6425
2022-05-20,우이신설선,삼양,2192,2224,4416
2022-05-20,우이신설선,삼양사거리,2743,2574,5317
2022-05-20,우이신설선,성신여대입구,3765,4448,8213
2022-05-20,우이신설선,솔밭공원,2833,2547,5380
2022-05-20,우이신설선,솔샘,6599,5851,12450
2022-05-20,우이신설선,신설동,2315,2337,4652
2022-05-20,우이신설선,정릉,5478,4604,10082
2022-05-20,우이신설선,화계,3848,3425,7273
2022-05-20,일산선,대곡,2525,1979,4504
2022-05-20,일산선,대화,14727,11688,26415
2022-05-20,일산선,마두,8684,8905,17589
2022-05-20,일산선,백석,11209,11068,22277
2022-05-20,일산선,삼송,22313,21094,43407
2022-05-20,일산선,원당,12774,11701,24475
2022-05-20,일산선,원흥,12532,11558,24090
2022-05-20,일산선,정발산,8883,9313,18196
2022-05-20,일산선,주엽,10840,10634,21474
2022-05-20,일산선,지축,1,0,1
2022-05-20,일산선,화정,18997,19627,38624
2022-05-20,장항선,배방,1498,1397,2895
2022-05-20,장항선,봉명,1447,1313,2760
2022-05-20,장항선,신창,3518,2110,5628
2022-05-20,장항선,쌍용,3164,2692,5856
2022-05-20,장항선,아산,4994,4920,9914
2022-05-20,장항선,온양온천,4438,4816,9254
2022-05-20,장항선,탕정,1044,929,1973
2022-05-20,중앙선,구리,15477,15836,31313
2022-05-20,중앙선,국수,908,888,1796
2022-05-20,중앙선,덕소,6320,6316,12636
2022-05-20,중앙선,도농,12625,11389,24014
2022-05-20,중앙선,도심,2851,2203,5054
2022-05-20,중앙선,망우,9152,8737,17889
2022-05-20,중앙선,상봉,6913,6623,13536
2022-05-20,중앙선,신원,246,225,471
2022-05-20,중앙선,아신,672,644,1316
2022-05-20,중앙선,양수,2335,2357,4692
2022-05-20,중앙선,양원,3369,3089,6458
2022-05-20,중앙선,양정,808,732,1540
2022-05-20,중앙선,양평,3391,3804,7195
2022-05-20,중앙선,오빈,339,317,656
2022-05-20,중앙선,용문,3997,4318,8315
2022-05-20,중앙선,운길산,907,961,1868
2022-05-20,중앙선,원덕,452,447,899
2022-05-20,중앙선,중랑,6838,6270,13108
2022-05-20,중앙선,지평,88,106,194
2022-05-20,중앙선,팔당,1033,1097,2130
2022-05-20,중앙선,회기,30018,28649,58667
2022-05-23,1호선,동대문,11415,10895,22310
2022-05-23,1호선,동묘앞,7997,8353,16350
2022-05-23,1호선,서울역,47889,46597,94486
2022-05-23,1호선,시청,24186,24360,48546
2022-05-23,1호선,신설동,14394,14023,28417
2022-05-23,1호선,제기동,17468,17712,35180
2022-05-23,1호선,종각,37287,36422,73709
2022-05-23,1호선,종로3가,26042,23587,49629
2022-05-23,1호선,종로5가,23702,23562,47264
2022-05-23,1호선,청량리,20946,20629,41575
2022-05-23,2호선,강남,85230,84987,170217
2022-05-23,2호선,강변,31969,30774,62743
2022-05-23,2호선,건대입구,35363,38366,73729
2022-05-23,2호선,교대,35958,41124,77082
2022-05-23,2호선,구로디지털단지,61623,61844,123467
2022-05-23,2호선,구의,24221,23872,48093
2022-05-23,2호선,낙성대,28482,27878,56360
2022-05-23,2호선,당산,19554,23158,42712
2022-05-23,2호선,대림,25196,25364,50560
2022-05-23,2호선,도림천,1457,1524,2981
2022-05-23,2호선,동대문역사문화공원,12176,13669,25845
2022-05-23,2호선,뚝섬,22563,24546,47109
2022-05-23,2호선,문래,22904,23575,46479
2022-05-23,2호선,방배,20215,21136,41351
2022-05-23,2호선,봉천,24980,22980,47960
2022-05-23,2호선,사당,38492,42829,81321
2022-05-23,2호선,삼성,51711,53152,104863
2022-05-23,2호선,상왕십리,14757,14231,28988
2022-05-23,2호선,서울대입구,49457,49055,98512
2022-05-23,2호선,서초,23165,22704,45869
2022-05-23,2호선,선릉,60734,54179,114913
2022-05-23,2호선,성수,37860,41586,79446
2022-05-23,2호선,시청,24796,24378,49174
2022-05-23,2호선,신답,1809,1962,3771
2022-05-23,2호선,신당,14251,14335,28586
2022-05-23,2호선,신대방,27939,26915,54854
2022-05-23,2호선,신도림,48351,48097,96448
2022-05-23,2호선,신림,64971,62918,127889
2022-05-23,2호선,신설동,3328,3387,6715
2022-05-23,2호선,신정네거리,10858,11134,21992
2022-05-23,2호선,신촌,33219,33838,67057
2022-05-23,2호선,아현,10942,10568,21510
2022-05-23,2호선,양천구청,7346,7590,14936
2022-05-23,2호선,역삼,55250,63225,118475
2022-05-23,2호선,영등포구청,23334,24385,47719
2022-05-23,2호선,왕십리,17268,13684,30952
2022-05-23,2호선,용답,3327,3401,6728
2022-05-23,2호선,용두,2351,2452,4803
2022-05-23,2호선,을지로3가,23895,23712,47607
2022-05-23,2호선,을지로4가,13621,13459,27080
2022-05-23,2호선,을지로입구,38859,41384,80243
2022-05-23,2호선,이대,14870,16127,30997
2022-05-23,2호선,잠실,66255,66923,133178
2022-05-23,2호선,잠실나루,16059,15700,31759
2022-05-23,2호선,잠실새내,21851,21609,43460
2022-05-23,2호선,종합운동장,8464,9411,17875
2022-05-23,2호선,충정로,10571,11147,21718
2022-05-23,2호선,한양대,14898,16844,31742
2022-05-23,2호선,합정,30569,32259,62828
2022-05-23,2호선,홍대입구,53965,56363,110328
2022-05-23,3호선,가락시장,9628,9444,19072
2022-05-23,3호선,경복궁,27710,29220,56930
2022-05-23,3호선,경찰병원,7883,7932,15815
2022-05-23,3호선,고속터미널,41803,40538,82341
2022-05-23,3호선,교대,15808,10477,26285
2022-05-23,3호선,구파발,22313,21476,43789
2022-05-23,3호선,금호,8266,7745,16011
2022-05-23,3호선,남부터미널,29875,30873,60748
2022-05-23,3호선,녹번,16758,14961,31719
2022-05-23,3호선,대청,11410,10540,21950
2022-05-23,3호선,대치,11472,11787,23259
2022-05-23,3호선,도곡,5798,5972,11770
2022-05-23,3호선,독립문,7309,7548,14857
2022-05-23,3호선,동대입구,9349,10296,19645
2022-05-23,3호선,매봉,13635,12954,26589
2022-05-23,3호선,무악재,4214,4257,8471
2022-05-23,3호선,불광,17089,18234,35323
2022-05-23,3호선,수서,18003,18848,36851
2022-05-23,3호선,신사,31128,32600,63728
2022-05-23,3호선,안국,23544,23754,47298
2022-05-23,3호선,압구정,30308,32798,63106
2022-05-23,3호선,약수,13612,13181,26793
2022-05-23,3호선,양재,41064,45428,86492
2022-05-23,3호선,연신내,37945,35802,73747
2022-05-23,3호선,오금,6772,6064,12836
2022-05-23,3호선,옥수,9483,9662,19145
2022-05-23,3호선,을지로3가,11201,11394,22595
2022-05-23,3호선,일원,11376,10998,22374
2022-05-23,3호선,잠원,5244,5153,10397
2022-05-23,3호선,종로3가,10378,11928,22306
2022-05-23,3호선,지축,5529,5163,10692
2022-05-23,3호선,충무로,2,0,2
2022-05-23,3호선,학여울,1932,1899,3831
2022-05-23,3호선,홍제,19348,18245,37593
2022-05-23,4호선,길음,22964,23035,45999
2022-05-23,4호선,남태령,1294,1114,2408
2022-05-23,4호선,노원,19332,21648,40980
2022-05-23,4호선,당고개,9440,8364,17804
2022-05-23,4호선,동대문,20888,21426,42314
2022-05-23,4호선,동대문역사문화공원,14964,13639,28603
2022-05-23,4호선,동작,1820,1974,3794
2022-05-23,4호선,명동,21501,22036,43537
2022-05-23,4호선,미아,16134,15598,31732
2022-05-23,4호선,미아사거리,27619,26574,54193
2022-05-23,4호선,사당,26537,22516,49053
2022-05-23,4호선,삼각지,5378,5913,11291
2022-05-23,4호선,상계,20589,18824,39413
2022-05-23,4호선,서울역,12144,18085,30229
2022-05-23,4호선,성신여대입구,21215,20420,41635
2022-05-23,4호선,수유,34912,34909,69821
2022-05-23,4호선,숙대입구,14693,14385,29078
2022-05-23,4호선,신용산,17297,18464,35761
2022-05-23,4호선,쌍문,30581,28059,58640
2022-05-23,4호선,이촌,8675,9646,18321
2022-05-23,4호선,창동,27041,28153,55194
2022-05-23,4호선,총신대입구,19862,21515,41377
2022-05-23,4호선,충무로,29096,30364,59460
2022-05-23,4호선,한성대입구,14887,14405,29292
2022-05-23,4호선,혜화,31380,31939,63319
2022-05-23,4호선,회현,26916,28128,55044
2022-05-23,5호선,강동,19537,18776,38313
2022-05-23,5호선,강일,4624,4374,8998
2022-05-23,5호선,개롱,7108,7279,14387
2022-05-23,5호선,개화산,6110,5672,11782
2022-05-23,5호선,거여,11214,10685,21899
2022-05-23,5호선,고덕,10392,10199,20591
2022-05-23,5호선,공덕,14815,15843,30658
2022-05-23,5호선,광나루,14508,12994,27502
2022-05-23,5호선,광화문,31743,33803,65546
2022-05-23,5호선,군자,11425,12541,23966
2022-05-23,5호선,굽은다리,9978,9488,19466
2022-05-23,5호선,길동,8370,8626,16996
2022-05-23,5호선,김포공항,7285,7228,14513
2022-05-23,5호선,까치산,30420,28644,59064
2022-05-23,5호선,답십리,16633,15114,31747
2022-05-23,5호선,동대문역사문화공원,3112,3578,6690
2022-05-23,5호선,둔촌동,8647,8482,17129
2022-05-23,5호선,마곡,11419,11552,22971
2022-05-23,5호선,마장,6072,5712,11784
2022-05-23,5호선,마천,7899,7515,15414
2022-05-23,5호선,마포,14977,15354,30331
2022-05-23,5호선,명일,9290,9405,18695
2022-05-23,5호선,목동,17974,19058,37032
2022-05-23,5호선,미사,16952,16908,33860
2022-05-23,5호선,발산,22185,22866,45051
2022-05-23,5호선,방이,7330,7504,14834
2022-05-23,5호선,방화,7326,6985,14311
2022-05-23,5호선,상일동,16012,14680,30692
2022-05-23,5호선,서대문,21210,21837,43047
2022-05-23,5호선,송정,7017,6468,13485
2022-05-23,5호선,신금호,6986,7252,14238
2022-05-23,5호선,신길,4510,4718,9228
2022-05-23,5호선,신정,14796,11912,26708
2022-05-23,5호선,아차산,15708,15006,30714
2022-05-23,5호선,애오개,7183,6924,14107
2022-05-23,5호선,양평,7947,7878,15825
2022-05-23,5호선,여의나루,13088,14164,27252
2022-05-23,5호선,여의도,30185,32625,62810
2022-05-23,5호선,영등포구청,4376,4588,8964
2022-05-23,5호선,영등포시장,10276,10693,20969
2022-05-23,5호선,오금,3943,4062,8005
2022-05-23,5호선,오목교,22654,23870,46524
2022-05-23,5호선,올림픽공원,4756,4273,9029
2022-05-23,5호선,왕십리,4593,5403,9996
2022-05-23,5호선,우장산,15952,15626,31578
2022-05-23,5호선,을지로4가,6420,6635,13055
2022-05-23,5호선,장한평,18941,18633,37574
2022-05-23,5호선,종로3가,12768,12676,25444
2022-05-23,5호선,천호,16986,17653,34639
2022-05-23,5호선,청구,4219,3756,7975
2022-05-23,5호선,충정로,4918,4999,9917
2022-05-23,5호선,하남검단산,6204,5844,12048
2022-05-23,5호선,하남시청,7374,7063,14437
2022-05-23,5호선,하남풍산,4540,4324,8864
2022-05-23,5호선,행당,8531,7555,16086
2022-05-23,5호선,화곡,30041,28060,58101
2022-05-23,6호선,고려대,10010,9236,19246
2022-05-23,6호선,공덕,19774,19154,38928
2022-05-23,6호선,광흥창,9747,9439,19186
2022-05-23,6호선,구산,8141,5917,14058
2022-05-23,6호선,녹사평,4763,4717,9480
2022-05-23,6호선,대흥,9096,9436,18532
2022-05-23,6호선,독바위,2855,2991,5846
2022-05-23,6호선,돌곶이,10127,9306,19433
2022-05-23,6호선,동묘앞,8139,8330,16469
2022-05-23,6호선,디지털미디어시티,15388,16732,32120
2022-05-23,6호선,마포구청,15091,13396,28487
2022-05-23,6호선,망원,13763,14560,28323
2022-05-23,6호선,버티고개,2409,2297,4706
2022-05-23,6호선,보문,7807,7052,14859
2022-05-23,6호선,봉화산,9573,8867,18440
2022-05-23,6호선,불광,4587,4422,9009
2022-05-23,6호선,삼각지,7212,6192,13404
2022-05-23,6호선,상수,8724,9646,18370
2022-05-23,6호선,상월곡,7013,6606,13619
2022-05-23,6호선,새절,13893,12845,26738
2022-05-23,6호선,석계,13210,14032,27242
2022-05-23,6호선,신내,1,0,1
2022-05-23,6호선,신당,7758,8416,16174
2022-05-23,6호선,안암,15554,18246,33800
2022-05-23,6호선,약수,3893,3852,7745
2022-05-23,6호선,역촌,4036,4533,8569
2022-05-23,6호선,연신내,2,0,2
2022-05-23,6호선,월곡,13516,13056,26572
2022-05-23,6호선,월드컵경기장,4558,4912,9470
2022-05-23,6호선,응암,18373,18167,36540
2022-05-23,6호선,이태원,9903,10242,20145
2022-05-23,6호선,증산,10712,10538,21250
2022-05-23,6호선,창신,3912,3324,7236
2022-05-23,6호선,청구,3709,3979,7688
2022-05-23,6호선,태릉입구,7275,8186,15461
2022-05-23,6호선,한강진,7288,8299,15587
2022-05-23,6호선,합정,13138,12938,26076
2022-05-23,6호선,화랑대,13045,10147,23192
2022-05-23,6호선,효창공원앞,7662,7089,14751
2022-05-23,7호선,가산디지털단지,47890,48313,96203
2022-05-23,7호선,강남구청,16527,18433,34960
2022-05-23,7호선,건대입구,13123,13643,26766
2022-05-23,7호선,고속터미널,16628,13924,30552
2022-05-23,7호선,공릉,13377,12981,26358
2022-05-23,7호선,광명사거리,22750,22357,45107
2022-05-23,7호선,군자,15548,12237,27785
2022-05-23,7호선,남구로,16857,17728,34585
2022-05-23,7호선,남성,12088,11240,23328
2022-05-23,7호선,내방,15543,16014,31557
2022-05-23,7호선,노원,18954,20336,39290
2022-05-23,7호선,논현,21743,23607,45350
2022-05-23,7호선,대림,8300,8158,16458
2022-05-23,7호선,도봉산,10358,11341,21699
2022-05-23,7호선,뚝섬유원지,9824,9996,19820
2022-05-23,7호선,마들,13580,12714,26294
2022-05-23,7호선,먹골,10747,10365,21112
2022-05-23,7호선,면목,17266,16580,33846
2022-05-23,7호선,반포,6233,6064,12297
2022-05-23,7호선,보라매,11059,11213,22272
2022-05-23,7호선,사가정,17072,17100,34172
2022-05-23,7호선,상도,12095,11990,24085
2022-05-23,7호선,상봉,17477,16224,33701
2022-05-23,7호선,수락산,13364,12932,26296
2022-05-23,7호선,숭실대입구,16071,16421,32492
2022-05-23,7호선,신대방삼거리,17663,16940,34603
2022-05-23,7호선,신풍,12398,11774,24172
2022-05-23,7호선,어린이대공원,16356,16980,33336
2022-05-23,7호선,온수,11631,10825,22456
2022-05-23,7호선,용마산,6375,6072,12447
2022-05-23,7호선,이수,16218,15797,32015
2022-05-23,7호선,장승배기,9526,9176,18702
2022-05-23,7호선,장암,2471,873,3344
2022-05-23,7호선,중계,15801,14500,30301
2022-05-23,7호선,중곡,11497,10668,22165
2022-05-23,7호선,중화,11551,11185,22736
2022-05-23,7호선,천왕,12162,11577,23739
2022-05-23,7호선,철산,22249,22559,44808
2022-05-23,7호선,청담,20697,23125,43822
2022-05-23,7호선,태릉입구,10936,10842,21778
2022-05-23,7호선,하계,18692,17499,36191
2022-05-23,7호선,학동,25450,27043,52493
2022-05-23,8호선,가락시장,7787,8694,16481
2022-05-23,8호선,강동구청,11100,11278,22378
2022-05-23,8호선,남위례,5604,5829,11433
2022-05-23,8호선,남한산성입구,16558,15458,32016
2022-05-23,8호선,단대오거리,11944,11308,23252
2022-05-23,8호선,모란,4621,3588,8209
2022-05-23,8호선,몽촌토성,6728,6703,13431
2022-05-23,8호선,문정,23061,24532,47593
2022-05-23,8호선,복정,10280,8777,19057
2022-05-23,8호선,산성,5732,5801,11533
2022-05-23,8호선,석촌,8001,8879,16880
2022-05-23,8호선,송파,8815,8580,17395
2022-05-23,8호선,수진,5676,5239,10915
2022-05-23,8호선,신흥,4450,4789,9239
2022-05-23,8호선,암사,19818,17349,37167
2022-05-23,8호선,잠실,13591,16147,29738
2022-05-23,8호선,장지,17635,16979,34614
2022-05-23,8호선,천호,14718,16675,31393
2022-05-23,9호선,가양,22217,21611,43828
2022-05-23,9호선,개화,2954,2030,4984
2022-05-23,9호선,고속터미널,13324,16651,29975
2022-05-23,9호선,공항시장,3173,3384,6557
2022-05-23,9호선,구반포,1389,1464,2853
2022-05-23,9호선,국회의사당,16091,17085,33176
2022-05-23,9호선,김포공항,7464,10874,18338
2022-05-23,9호선,노들,4813,3932,8745
2022-05-23,9호선,노량진,27642,26738,54380
2022-05-23,9호선,당산,18974,19385,38359
2022-05-23,9호선,동작,2217,1808,4025
2022-05-23,9호선,등촌,11977,11566,23543
2022-05-23,9호선,마곡나루,12746,12956,25702
2022-05-23,9호선,사평,3853,3640,7493
2022-05-23,9호선,샛강,6512,6948,13460
2022-05-23,9호선,선유도,9129,8603,17732
2022-05-23,9호선,신논현,33047,32835,65882
2022-05-23,9호선,신목동,4839,4176,9015
2022-05-23,9호선,신반포,4362,3930,8292
2022-05-23,9호선,신방화,7239,6984,14223
2022-05-23,9호선,양천향교,10597,10737,21334
2022-05-23,9호선,여의도,29282,28892,58174
2022-05-23,9호선,염창,18419,17722,36141
2022-05-23,9호선,증미,7867,7677,15544
2022-05-23,9호선,흑석,9657,9953,19610
2022-05-23,9호선2~3단계,둔촌오륜,1203,1093,2296
2022-05-23,9호선2~3단계,봉은사,16342,16602,32944
2022-05-23,9호선2~3단계,삼성중앙,7554,8090,15644
2022-05-23,9호선2~3단계,삼전,7259,6885,14144
2022-05-23,9호선2~3단계,석촌,9091,7930,17021
2022-05-23,9호선2~3단계,석촌고분,6286,6008,12294
2022-05-23,9호선2~3단계,선정릉,10518,11375,21893
2022-05-23,9호선2~3단계,송파나루,5065,5385,10450
2022-05-23,9호선2~3단계,언주,10782,11337,22119
2022-05-23,9호선2~3단계,올림픽공원,6878,7058,13936
2022-05-23,9호선2~3단계,종합운동장,4391,4447,8838
2022-05-23,9호선2~3단계,중앙보훈병원,12052,10699,22751
2022-05-23,9호선2~3단계,한성백제,2660,2375,5035
2022-05-23,경강선,경기광주,8268,7871,16139
2022-05-23,경강선,곤지암,2423,2480,4903
2022-05-23,경강선,부발,2223,2343,4566
2022-05-23,경강선,삼동,2569,2298,4867
2022-05-23,경강선,세종대왕릉,360,335,695
2022-05-23,경강선,신둔도예촌,1769,1597,3366
2022-05-23,경강선,여주,2652,2655,5307
2022-05-23,경강선,이매,1286,986,2272
2022-05-23,경강선,이천,2695,2848,5543
2022-05-23,경강선,초월,3417,3272,6689
2022-05-23,경강선,판교,4748,4704,9452
2022-05-23,경부선,가산디지털단지,19940,22999,42939
2022-05-23,경부선,관악,8000,7405,15405
2022-05-23,경부선,광명,3772,3204,6976
2022-05-23,경부선,구로,19948,20313,40261
2022-05-23,경부선,군포,8124,8067,16191
2022-05-23,경부선,금정,28775,29024,57799
2022-05-23,경부선,금천구청,12816,12687,25503
2022-05-23,경부선,남영,10125,10954,21079
2022-05-23,경부선,노량진,8616,8769,17385
2022-05-23,경부선,당정,7877,7387,15264
2022-05-23,경부선,대방,14197,14729,28926
2022-05-23,경부선,독산,20108,20678,40786
2022-05-23,경부선,두정,7984,9418,17402
2022-05-23,경부선,명학,10989,10904,21893
2022-05-23,경부선,병점,17841,17665,35506
2022-05-23,경부선,서동탄,1591,1353,2944
2022-05-23,경부선,서울역,7772,2362,10134
2022-05-23,경부선,서정리,8139,7976,16115
2022-05-23,경부선,석수,10465,9396,19861
2022-05-23,경부선,성균관대,16448,16591,33039
2022-05-23,경부선,성환,7193,7311,14504
2022-05-23,경부선,세류,3423,3032,6455
2022-05-23,경부선,세마,3154,2945,6099
2022-05-23,경부선,송탄,4710,4610,9320
2022-05-23,경부선,수원,38334,40460,78794
2022-05-23,경부선,신길,10083,8721,18804
2022-05-23,경부선,신도림,4281,4431,8712
2022-05-23,경부선,안양,28459,28279,56738
2022-05-23,경부선,영등포,36844,38538,75382
2022-05-23,경부선,오산,11337,11494,22831
2022-05-23,경부선,오산대,4480,4140,8620
2022-05-23,경부선,용산,35306,36515,71821
2022-05-23,경부선,의왕,10459,10463,20922
2022-05-23,경부선,직산,891,890,1781
2022-05-23,경부선,진위,2010,1761,3771
2022-05-23,경부선,천안,7365,7075,14440
2022-05-23,경부선,평택,13978,14138,28116
2022-05-23,경부선,평택지제,4069,3890,7959
2022-05-23,경부선,화서,9068,8587,17655
2022-05-23,경원선,가능,7399,7216,14615
2022-05-23,경원선,광운대,9759,9689,19448
2022-05-23,경원선,녹양,4971,4626,9597
2022-05-23,경원선,녹천,5065,4156,9221
2022-05-23,경원선,덕계,3685,3279,6964
2022-05-23,경원선,덕정,7084,6883,13967
2022-05-23,경원선,도봉,6328,5974,12302
2022-05-23,경원선,도봉산,8129,5504,13633
2022-05-23,경원선,동두천,2913,3187,6100
2022-05-23,경원선,동두천중앙,3488,3327,6815
2022-05-23,경원선,망월사,10316,10483,20799
2022-05-23,경원선,방학,10556,10395,20951
2022-05-23,경원선,보산,1685,1436,3121
2022-05-23,경원선,서빙고,2092,1804,3896
2022-05-23,경원선,석계,8931,9984,18915
2022-05-23,경원선,소요산,2884,2332,5216
2022-05-23,경원선,신이문,8902,8087,16989
2022-05-23,경원선,양주,8618,8118,16736
2022-05-23,경원선,옥수,47,57,104
2022-05-23,경원선,왕십리,15192,16224,31416
2022-05-23,경원선,외대앞,8947,9053,18000
2022-05-23,경원선,월계,8903,8220,17123
2022-05-23,경원선,응봉,2078,1717,3795
2022-05-23,경원선,의정부,19094,19574,38668
2022-05-23,경원선,이촌,4078,3124,7202
2022-05-23,경원선,지행,7450,7486,14936
2022-05-23,경원선,창동,1,0,1
2022-05-23,경원선,청량리,15329,16320,31649
2022-05-23,경원선,한남,4386,4207,8593
2022-05-23,경원선,회룡,13541,13367,26908
2022-05-23,경의선,가좌,6238,5906,12144
2022-05-23,경의선,강매,3656,3152,6808
2022-05-23,경의선,계양,1,0,1
2022-05-23,경의선,곡산,669,698,1367
2022-05-23,경의선,공덕,3764,3403,7167
2022-05-23,경의선,금릉,5512,5282,10794
2022-05-23,경의선,금촌,6884,6775,13659
2022-05-23,경의선,능곡,4293,3942,8235
2022-05-23,경의선,디지털미디어시티,2896,2701,5597
2022-05-23,경의선,문산,5624,5478,11102
2022-05-23,경의선,백마,7821,7482,15303
2022-05-23,경의선,서강대,2259,2249,4508
2022-05-23,경의선,서울역,5088,6560,11648
2022-05-23,경의선,수색,3171,3322,6493
2022-05-23,경의선,신촌,979,1323,2302
2022-05-23,경의선,야당,8617,8386,17003
2022-05-23,경의선,운정,7925,7209,15134
2022-05-23,경의선,월롱,3245,3248,6493
2022-05-23,경의선,일산,11604,11284,22888
2022-05-23,경의선,임진강,10,11,21
2022-05-23,경의선,탄현,8700,8070,16770
2022-05-23,경의선,파주,1686,1320,3006
2022-05-23,경의선,풍산,6239,5705,11944
2022-05-23,경의선,행신,8882,9047,17929
2022-05-23,경의선,홍대입구,1749,2018,3767
2022-05-23,경의선,화전,3872,3700,7572
2022-05-23,경의선,효창공원앞,3425,3695,7120
2022-05-23,경인선,간석,6429,5992,12421
2022-05-23,경인선,개봉,22987,22324,45311
2022-05-23,경인선,구일,7902,7705,15607
2022-05-23,경인선,도원,3944,3849,7793
2022-05-23,경인선,도화,4529,4184,8713
2022-05-23,경인선,동암,15827,15692,31519
2022-05-23,경인선,동인천,14398,13574,27972
2022-05-23,경인선,백운,7634,7424,15058
2022-05-23,경인선,부개,9526,8628,18154
2022-05-23,경인선,부천,34692,34498,69190
2022-05-23,경인선,부평,30216,31878,62094
2022-05-23,경인선,소사,9857,9472,19329
2022-05-23,경인선,송내,29841,29772,59613
2022-05-23,경인선,역곡,31055,30412,61467
2022-05-23,경인선,오류동,12767,11884,24651
2022-05-23,경인선,온수,7612,7197,14809
2022-05-23,경인선,인천,3774,2857,6631
2022-05-23,경인선,제물포,12224,11758,23982
2022-05-23,경인선,주안,20942,19249,40191
2022-05-23,경인선,중동,10318,9543,19861
2022-05-23,경춘선,가평,1855,1763,3618
2022-05-23,경춘선,갈매,3347,2885,6232
2022-05-23,경춘선,강촌,427,453,880
2022-05-23,경춘선,굴봉산,150,132,282
2022-05-23,경춘선,금곡,1740,1669,3409
2022-05-23,경춘선,김유정,343,333,676
2022-05-23,경춘선,남춘천,2864,3257,6121
2022-05-23,경춘선,대성리,1022,507,1529
2022-05-23,경춘선,마석,4761,4630,9391
2022-05-23,경춘선,백양리,105,75,180
2022-05-23,경춘선,별내,3495,3213,6708
2022-05-23,경춘선,사릉,2808,2567,5375
2022-05-23,경춘선,상천,345,307,652
2022-05-23,경춘선,신내,2510,2309,4819
2022-05-23,경춘선,천마산,1970,1818,3788
2022-05-23,경춘선,청평,1871,1811,3682
2022-05-23,경춘선,춘천,1765,1786,3551
2022-05-23,경춘선,퇴계원,3948,3579,7527
2022-05-23,경춘선,평내호평,7230,6856,14086
2022-05-23,공항철도,검암,7089,7000,14089
2022-05-23,공항철도,계양,11808,10816,22624
2022-05-23,공항철도,공덕,2483,3167,5650
2022-05-23,공항철도,공항화물청사,2308,2560,4868
2022-05-23,공항철도,김포공항,12402,7240,19642
2022-05-23,공항철도,디지털미디어시티,15349,14393,29742
2022-05-23,공항철도,마곡나루,10492,10153,20645
2022-05-23,공항철도,서울역,8784,8623,17407
2022-05-23,공항철도,영종,3500,3431,6931
2022-05-23,공항철도,운서,7467,7413,14880
2022-05-23,공항철도,인천공항1터미널,5905,5468,11373
2022-05-23,공항철도,인천공항2터미널,3289,2752,6041
2022-05-23,공항철도,청라국제도시,7732,7157,14889
2022-05-23,공항철도,홍대입구,9860,9912,19772
2022-05-23,과천선,경마공원,994,1034,2028
2022-05-23,과천선,과천,6925,6198,13123
2022-05-23,과천선,대공원,4163,4128,8291
2022-05-23,과천선,범계,26930,26805,53735
2022-05-23,과천선,선바위,8865,7763,16628
2022-05-23,과천선,인덕원,26040,26974,53014
2022-05-23,과천선,정부과천청사,11411,11408,22819
2022-05-23,과천선,평촌,19175,18696,37871
2022-05-23,분당선,가천대,13445,14447,27892
2022-05-23,분당선,강남구청,10619,12123,22742
2022-05-23,분당선,개포동,4105,4314,8419
2022-05-23,분당선,구룡,2606,2524,5130
2022-05-23,분당선,구성,5583,5804,11387
2022-05-23,분당선,기흥,11343,10664,22007
2022-05-23,분당선,대모산입구,5019,4591,9610
2022-05-23,분당선,도곡,7652,7654,15306
2022-05-23,분당선,망포,15562,15065,30627
2022-05-23,분당선,매교,3506,3456,6962
2022-05-23,분당선,매탄권선,5671,5422,11093
2022-05-23,분당선,모란,20876,21117,41993
2022-05-23,분당선,미금,16438,17389,33827
2022-05-23,분당선,보정,2846,2460,5306
2022-05-23,분당선,상갈,5994,5683,11677
2022-05-23,분당선,서울숲,11924,11982,23906
2022-05-23,분당선,서현,25628,25889,51517
2022-05-23,분당선,선릉,14304,22187,36491
2022-05-23,분당선,선정릉,8521,9331,17852
2022-05-23,분당선,수내,13491,13361,26852
2022-05-23,분당선,수서,14825,15251,30076
2022-05-23,분당선,수원,8678,7250,15928
2022-05-23,분당선,수원시청,13340,14126,27466
2022-05-23,분당선,신갈,5020,4995,10015
2022-05-23,분당선,압구정로데오,18084,19633,37717
2022-05-23,분당선,야탑,27621,28930,56551
2022-05-23,분당선,영통,8583,8934,17517
2022-05-23,분당선,오리,12380,10152,22532
2022-05-23,분당선,이매,6304,5850,12154
2022-05-23,분당선,정자,18728,19768,38496
2022-05-23,분당선,죽전,14859,16509,31368
2022-05-23,분당선,청명,4663,4499,9162
2022-05-23,분당선,태평,13913,13438,27351
2022-05-23,분당선,한티,14211,15359,29570
2022-05-23,수인선,고색,5466,5070,10536
2022-05-23,수인선,남동인더스파크,2290,2637,4927
2022-05-23,수인선,달월,120,84,204
2022-05-23,수인선,사리,5384,4749,10133
2022-05-23,수인선,소래포구,6250,5674,11924
2022-05-23,수인선,송도,2770,2556,5326
2022-05-23,수인선,숭의,4428,4051,8479
2022-05-23,수인선,신포,1952,2001,3953
2022-05-23,수인선,야목,441,308,749
2022-05-23,수인선,어천,778,888,1666
2022-05-23,수인선,연수,4905,4769,9674
2022-05-23,수인선,오목천,4305,3977,8282
2022-05-23,수인선,원인재,4670,4889,9559
2022-05-23,수인선,월곶,3079,2825,5904
2022-05-23,수인선,인천,1196,1811,3007
2022-05-23,수인선,인천논현,5779,6313,12092
2022-05-23,수인선,인하대,7990,7759,15749
2022-05-23,수인선,호구포,4297,4472,8769
2022-05-23,안산선,고잔,9884,9277,19161
2022-05-23,안산선,대야미,5472,4875,10347
2022-05-23,안산선,반월,4767,4551,9318
2022-05-23,안산선,산본,16887,18299,35186
2022-05-23,안산선,상록수,17549,17894,35443
2022-05-23,안산선,수리산,4619,3778,8397
2022-05-23,안산선,신길온천,2031,1797,3828
2022-05-23,안산선,안산,12553,11258,23811
2022-05-23,안산선,오이도,9391,8903,18294
2022-05-23,안산선,정왕,10895,11459,22354
2022-05-23,안산선,중앙,19499,20218,39717
2022-05-23,안산선,초지,5726,6130,11856
2022-05-23,안산선,한대앞,10937,11285,22222
2022-05-23,우이신설선,4.19민주묘지,3887,3780,7667
2022-05-23,우이신설선,가오리,4485,4446,8931
2022-05-23,우이신설선,보문,1556,1658,3214
2022-05-23,우이신설선,북한산보국문,6567,6175,12742
2022-05-23,우이신설선,북한산우이,2819,2531,5350
2022-05-23,우이신설선,삼양,2111,2224,4335
2022-05-23,우이신설선,삼양사거리,2601,2609,5210
2022-05-23,우이신설선,성신여대입구,3431,3726,7157
2022-05-23,우이신설선,솔밭공원,2676,2474,5150
2022-05-23,우이신설선,솔샘,6322,5902,12224
2022-05-23,우이신설선,신설동,2295,2291,4586
2022-05-23,우이신설선,정릉,5124,4587,9711
2022-05-23,우이신설선,화계,3617,3355,6972
2022-05-23,일산선,대곡,2415,1913,4328
2022-05-23,일산선,대화,14610,11279,25889
2022-05-23,일산선,마두,8219,8309,16528
2022-05-23,일산선,백석,10349,10495,20844
2022-05-23,일산선,삼송,21180,20569,41749
2022-05-23,일산선,원당,12213,11474,23687
2022-05-23,일산선,원흥,12073,11419,23492
2022-05-23,일산선,정발산,7122,7153,14275
2022-05-23,일산선,주엽,10095,9699,19794
2022-05-23,일산선,화정,18122,18232,36354
2022-05-23,장항선,배방,1347,1292,2639
2022-05-23,장항선,봉명,1383,1451,2834
2022-05-23,장항선,신창,2917,3687,6604
2022-05-23,장항선,쌍용,3222,3267,6489
2022-05-23,장항선,아산,4625,3739,8364
2022-05-23,장항선,온양온천,4174,4280,8454
2022-05-23,장항선,탕정,968,856,1824
2022-05-23,중앙선,구리,14215,14278,28493
2022-05-23,중앙선,국수,854,877,1731
2022-05-23,중앙선,덕소,6185,5996,12181
2022-05-23,중앙선,도농,12081,10679,22760
2022-05-23,중앙선,도심,2839,2120,4959
2022-05-23,중앙선,망우,8186,8060,16246
2022-05-23,중앙선,상봉,6053,6181,12234
2022-05-23,중앙선,신원,261,199,460
2022-05-23,중앙선,아신,609,611,1220
2022-05-23,중앙선,양수,2099,2101,4200
2022-05-23,중앙선,양원,3006,2894,5900
2022-05-23,중앙선,양정,787,669,1456
2022-05-23,중앙선,양평,4247,4279,8526
2022-05-23,중앙선,오빈,353,351,704
2022-05-23,중앙선,용문,2107,2049,4156
2022-05-23,중앙선,운길산,886,875,1761
2022-05-23,중앙선,원덕,458,391,849
2022-05-23,중앙선,중랑,5991,5711,11702
2022-05-23,중앙선,지평,78,86,164
2022-05-23,중앙선,팔당,945,965,1910
2022-05-23,중앙선,회기,27089,26797,53886
2022-05-24,1호선,동대문,11327,10764,22091
2022-05-24,1호선,동묘앞,8329,8715,17044
2022-05-24,1호선,서울역,47761,45919,93680
2022-05-24,1호선,시청,25702,26158,51860
2022-05-24,1호선,신설동,14636,14239,28875
2022-05-24,1호선,제기동,17700,17913,35613
2022-05-24,1호선,종각,37742,37357,75099
2022-05-24,1호선,종로3가,26818,24481,51299
2022-05-24,1호선,종로5가,24565,24367,48932
2022-05-24,1호선,청량리,21197,20992,42189
2022-05-24,2호선,강남,89918,88877,178795
2022-05-24,2호선,강변,31262,29429,60691
2022-05-24,2호선,건대입구,36624,39147,75771
2022-05-24,2호선,교대,39186,44219,83405
2022-05-24,2호선,구로디지털단지,63395,63538,126933
2022-05-24,2호선,구의,24969,24215,49184
2022-05-24,2호선,낙성대,29163,28403,57566
2022-05-24,2호선,당산,20652,24139,44791
2022-05-24,2호선,대림,25598,25866,51464
2022-05-24,2호선,도림천,1501,1536,3037
2022-05-24,2호선,동대문역사문화공원,12387,13891,26278
2022-05-24,2호선,뚝섬,23142,25186,48328
2022-05-24,2호선,문래,23802,24507,48309
2022-05-24,2호선,방배,21419,22001,43420
2022-05-24,2호선,봉천,25560,23264,48824
2022-05-24,2호선,사당,41132,44853,85985
2022-05-24,2호선,삼성,55422,56850,112272
2022-05-24,2호선,상왕십리,15267,14630,29897
2022-05-24,2호선,서울대입구,51004,49884,100888
2022-05-24,2호선,서초,23794,23225,47019
2022-05-24,2호선,선릉,62527,55704,118231
2022-05-24,2호선,성수,38724,42731,81455
2022-05-24,2호선,시청,26145,25881,52026
2022-05-24,2호선,신답,1831,2049,3880
2022-05-24,2호선,신당,14606,14927,29533
2022-05-24,2호선,신대방,28518,27628,56146
2022-05-24,2호선,신도림,50417,50377,100794
2022-05-24,2호선,신림,67076,64397,131473
2022-05-24,2호선,신설동,3297,3349,6646
2022-05-24,2호선,신정네거리,11247,11482,22729
2022-05-24,2호선,신촌,35271,35938,71209
2022-05-24,2호선,아현,11570,10909,22479
2022-05-24,2호선,양천구청,7585,7702,15287
2022-05-24,2호선,역삼,57072,65083,122155
2022-05-24,2호선,영등포구청,23609,24742,48351
2022-05-24,2호선,왕십리,17686,14006,31692
2022-05-24,2호선,용답,3278,3414,6692
2022-05-24,2호선,용두,2415,2434,4849
2022-05-24,2호선,을지로3가,24343,24516,48859
2022-05-24,2호선,을지로4가,13923,13957,27880
2022-05-24,2호선,을지로입구,42259,44679,86938
2022-05-24,2호선,이대,15191,16276,31467
2022-05-24,2호선,잠실,70621,70909,141530
2022-05-24,2호선,잠실나루,16520,15971,32491
2022-05-24,2호선,잠실새내,22513,22148,44661
2022-05-24,2호선,종합운동장,10749,11966,22715
2022-05-24,2호선,충정로,10774,11416,22190
2022-05-24,2호선,한양대,15930,17706,33636
2022-05-24,2호선,합정,31789,33745,65534
2022-05-24,2호선,홍대입구,54959,58375,113334
2022-05-24,3호선,가락시장,9740,9728,19468
2022-05-24,3호선,경복궁,28502,29733,58235
2022-05-24,3호선,경찰병원,7793,7567,15360
2022-05-24,3호선,고속터미널,41685,40364,82049
2022-05-24,3호선,교대,16676,11725,28401
2022-05-24,3호선,구파발,22524,21268,43792
2022-05-24,3호선,금호,8505,7735,16240
2022-05-24,3호선,남부터미널,30788,33133,63921
2022-05-24,3호선,녹번,17073,14534,31607
2022-05-24,3호선,대청,10782,9543,20325
2022-05-24,3호선,대치,11711,11637,23348
2022-05-24,3호선,도곡,5901,6591,12492
2022-05-24,3호선,독립문,7635,8258,15893
2022-05-24,3호선,동대입구,9682,11125,20807
2022-05-24,3호선,매봉,11795,12582,24377
2022-05-24,3호선,무악재,4304,4350,8654
2022-05-24,3호선,불광,17668,18151,35819
2022-05-24,3호선,수서,17521,17455,34976
2022-05-24,3호선,신사,31721,34843,66564
2022-05-24,3호선,안국,24496,25460,49956
2022-05-24,3호선,압구정,33411,41963,75374
2022-05-24,3호선,약수,14017,13964,27981
2022-05-24,3호선,양재,38941,47834,86775
2022-05-24,3호선,연신내,38428,35786,74214
2022-05-24,3호선,오금,6902,6048,12950
2022-05-24,3호선,옥수,9920,9901,19821
2022-05-24,3호선,을지로3가,11288,12001,23289
2022-05-24,3호선,일원,11566,10772,22338
2022-05-24,3호선,잠원,5342,4829,10171
2022-05-24,3호선,종로3가,10422,12219,22641
2022-05-24,3호선,지축,5677,5273,10950
2022-05-24,3호선,학여울,2088,2102,4190
2022-05-24,3호선,홍제,19469,17781,37250
2022-05-24,4호선,길음,24288,23960,48248
2022-05-24,4호선,남태령,1466,1604,3070
2022-05-24,4호선,노원,19977,22448,42425
2022-05-24,4호선,당고개,9667,8593,18260
2022-05-24,4호선,동대문,21134,21505,42639
2022-05-24,4호선,동대문역사문화공원,15185,13845,29030
2022-05-24,4호선,동작,1861,2113,3974
2022-05-24,4호선,명동,22045,22835,44880
2022-05-24,4호선,미아,16368,15839,32207
2022-05-24,4호선,미아사거리,29153,28093,57246
2022-05-24,4호선,사당,27850,23695,51545
2022-05-24,4호선,삼각지,5764,6440,12204
2022-05-24,4호선,상계,20902,19024,39926
2022-05-24,4호선,서울역,12490,18228,30718
2022-05-24,4호선,성신여대입구,22264,21208,43472
2022-05-24,4호선,수유,35988,35628,71616
2022-05-24,4호선,숙대입구,15439,14925,30364
2022-05-24,4호선,신용산,17854,19021,36875
2022-05-24,4호선,쌍문,30881,28392,59273
2022-05-24,4호선,이촌,8999,9932,18931
2022-05-24,4호선,창동,27461,28881,56342
2022-05-24,4호선,총신대입구,20600,22192,42792
2022-05-24,4호선,충무로,30427,31659,62086
2022-05-24,4호선,한성대입구,16109,15570,31679
2022-05-24,4호선,혜화,34649,34973,69622
2022-05-24,4호선,회현,27576,29336,56912
2022-05-24,5호선,강동,19861,18867,38728
2022-05-24,5호선,강일,4810,4531,9341
2022-05-24,5호선,개롱,7011,7158,14169
2022-05-24,5호선,개화산,6055,5812,11867
2022-05-24,5호선,거여,11502,10824,22326
2022-05-24,5호선,고덕,10609,10477,21086
2022-05-24,5호선,공덕,15393,16331,31724
2022-05-24,5호선,광나루,15030,13696,28726
2022-05-24,5호선,광화문,33149,35305,68454
2022-05-24,5호선,군자,12053,13167,25220
2022-05-24,5호선,굽은다리,10211,9553,19764
2022-05-24,5호선,길동,8543,8892,17435
2022-05-24,5호선,김포공항,7442,7493,14935
2022-05-24,5호선,까치산,31287,29426,60713
2022-05-24,5호선,답십리,17115,15526,32641
2022-05-24,5호선,동대문역사문화공원,3178,3611,6789
2022-05-24,5호선,둔촌동,8870,8757,17627
2022-05-24,5호선,마곡,11644,11691,23335
2022-05-24,5호선,마장,6395,6037,12432
2022-05-24,5호선,마천,8045,7450,15495
2022-05-24,5호선,마포,15578,15873,31451
2022-05-24,5호선,명일,9526,9696,19222
2022-05-24,5호선,목동,18415,19366,37781
2022-05-24,5호선,미사,17287,17224,34511
2022-05-24,5호선,발산,22417,23120,45537
2022-05-24,5호선,방이,7701,7982,15683
2022-05-24,5호선,방화,7457,7041,14498
2022-05-24,5호선,상일동,16752,15498,32250
2022-05-24,5호선,서대문,22075,22658,44733
2022-05-24,5호선,송정,6867,6475,13342
2022-05-24,5호선,신금호,7306,7580,14886
2022-05-24,5호선,신길,4554,4728,9282
2022-05-24,5호선,신정,15144,12240,27384
2022-05-24,5호선,아차산,16158,15449,31607
2022-05-24,5호선,애오개,7418,7265,14683
2022-05-24,5호선,양평,7907,7894,15801
2022-05-24,5호선,여의나루,13055,14084,27139
2022-05-24,5호선,여의도,30442,33025,63467
2022-05-24,5호선,영등포구청,4366,4544,8910
2022-05-24,5호선,영등포시장,10859,11157,22016
2022-05-24,5호선,오금,4258,4338,8596
2022-05-24,5호선,오목교,23078,24542,47620
2022-05-24,5호선,올림픽공원,5109,4446,9555
2022-05-24,5호선,왕십리,4800,5648,10448
2022-05-24,5호선,우장산,16137,15608,31745
2022-05-24,5호선,을지로4가,6800,6843,13643
2022-05-24,5호선,장한평,19333,19048,38381
2022-05-24,5호선,종로3가,13421,13070,26491
2022-05-24,5호선,천호,19135,19128,38263
2022-05-24,5호선,청구,4531,3978,8509
2022-05-24,5호선,충정로,5209,5348,10557
2022-05-24,5호선,하남검단산,6312,5894,12206
2022-05-24,5호선,하남시청,7737,7465,15202
2022-05-24,5호선,하남풍산,4696,4506,9202
2022-05-24,5호선,행당,8824,7740,16564
2022-05-24,5호선,화곡,30587,28278,58865
2022-05-24,6호선,고려대,10210,10066,20276
2022-05-24,6호선,공덕,20381,19703,40084
2022-05-24,6호선,광흥창,10220,9618,19838
2022-05-24,6호선,구산,8407,5867,14274
2022-05-24,6호선,녹사평,5094,4942,10036
2022-05-24,6호선,대흥,9350,9374,18724
2022-05-24,6호선,독바위,2987,3093,6080
2022-05-24,6호선,돌곶이,10146,9308,19454
2022-05-24,6호선,동묘앞,8192,8483,16675
2022-05-24,6호선,디지털미디어시티,15580,17097,32677
2022-05-24,6호선,마포구청,15639,13772,29411
2022-05-24,6호선,망원,14258,15014,29272
2022-05-24,6호선,버티고개,2497,2349,4846
2022-05-24,6호선,보문,8047,7318,15365
2022-05-24,6호선,봉화산,9631,8883,18514
2022-05-24,6호선,불광,4522,4707,9229
2022-05-24,6호선,삼각지,8037,7039,15076
2022-05-24,6호선,상수,8966,10372,19338
2022-05-24,6호선,상월곡,7043,6545,13588
2022-05-24,6호선,새절,14467,13309,27776
2022-05-24,6호선,석계,13732,14121,27853
2022-05-24,6호선,신당,8821,9343,18164
2022-05-24,6호선,안암,16510,19473,35983
2022-05-24,6호선,약수,3943,3906,7849
2022-05-24,6호선,역촌,3923,4820,8743
2022-05-24,6호선,연신내,1,0,1
2022-05-24,6호선,월곡,13479,12895,26374
2022-05-24,6호선,월드컵경기장,4715,5024,9739
2022-05-24,6호선,응암,19075,18862,37937
2022-05-24,6호선,이태원,10395,10852,21247
2022-05-24,6호선,증산,10747,10722,21469
2022-05-24,6호선,창신,4123,3380,7503
2022-05-24,6호선,청구,3868,4130,7998
2022-05-24,6호선,태릉입구,7103,8308,15411
2022-05-24,6호선,한강진,8625,9957,18582
2022-05-24,6호선,합정,13517,13553,27070
2022-05-24,6호선,화랑대,13813,10443,24256
2022-05-24,6호선,효창공원앞,7949,7223,15172
2022-05-24,7호선,가산디지털단지,48266,48605,96871
2022-05-24,7호선,강남구청,17375,19386,36761
2022-05-24,7호선,건대입구,13583,14314,27897
2022-05-24,7호선,고속터미널,16253,14305,30558
2022-05-24,7호선,공릉,13347,13339,26686
2022-05-24,7호선,광명사거리,23495,22825,46320
2022-05-24,7호선,군자,15861,12723,28584
2022-05-24,7호선,까치울,1,0,1
2022-05-24,7호선,남구로,16942,18028,34970
2022-05-24,7호선,남성,12289,11261,23550
2022-05-24,7호선,내방,16257,16361,32618
2022-05-24,7호선,노원,20509,21880,42389
2022-05-24,7호선,논현,23435,24374,47809
2022-05-24,7호선,대림,8195,8254,16449
2022-05-24,7호선,도봉산,10693,12114,22807
2022-05-24,7호선,뚝섬유원지,10008,9732,19740
2022-05-24,7호선,마들,13965,13033,26998
2022-05-24,7호선,먹골,11001,10439,21440
2022-05-24,7호선,면목,17642,16945,34587
2022-05-24,7호선,반포,6679,6305,12984
2022-05-24,7호선,보라매,11265,11270,22535
2022-05-24,7호선,사가정,17302,17215,34517
2022-05-24,7호선,상도,12569,12186,24755
2022-05-24,7호선,상봉,17901,16591,34492
2022-05-24,7호선,수락산,13788,13465,27253
2022-05-24,7호선,숭실대입구,16751,16821,33572
2022-05-24,7호선,신대방삼거리,18264,17325,35589
2022-05-24,7호선,신풍,12463,11781,24244
2022-05-24,7호선,어린이대공원,18336,18627,36963
2022-05-24,7호선,온수,12045,11302,23347
2022-05-24,7호선,용마산,6578,6359,12937
2022-05-24,7호선,이수,16937,16198,33135
2022-05-24,7호선,장승배기,9667,9417,19084
2022-05-24,7호선,장암,2426,854,3280
2022-05-24,7호선,중계,15981,14505,30486
2022-05-24,7호선,중곡,11908,10993,22901
2022-05-24,7호선,중화,11981,11512,23493
2022-05-24,7호선,천왕,12508,11999,24507
2022-05-24,7호선,철산,22880,23124,46004
2022-05-24,7호선,청담,21498,23992,45490
2022-05-24,7호선,태릉입구,11343,10785,22128
2022-05-24,7호선,하계,19293,18099,37392
2022-05-24,7호선,학동,26662,27880,54542
2022-05-24,8호선,가락시장,8370,9293,17663
2022-05-24,8호선,강동구청,11251,11486,22737
2022-05-24,8호선,남위례,5769,5936,11705
2022-05-24,8호선,남한산성입구,16922,15638,32560
2022-05-24,8호선,단대오거리,12485,11693,24178
2022-05-24,8호선,모란,6588,5171,11759
2022-05-24,8호선,몽촌토성,6720,6859,13579
2022-05-24,8호선,문정,23448,25036,48484
2022-05-24,8호선,복정,11125,9288,20413
2022-05-24,8호선,산성,6021,6008,12029
2022-05-24,8호선,석촌,8138,9271,17409
2022-05-24,8호선,송파,9169,8852,18021
2022-05-24,8호선,수진,5774,5387,11161
2022-05-24,8호선,신흥,4480,4713,9193
2022-05-24,8호선,암사,20709,17837,38546
2022-05-24,8호선,잠실,14165,17079,31244
2022-05-24,8호선,장지,18591,17298,35889
2022-05-24,8호선,천호,15433,17907,33340
2022-05-24,9호선,가양,22868,21899,44767
2022-05-24,9호선,개화,2989,2072,5061
2022-05-24,9호선,고속터미널,13980,16568,30548
2022-05-24,9호선,공항시장,3182,3354,6536
2022-05-24,9호선,구반포,1452,1547,2999
2022-05-24,9호선,국회의사당,16786,17801,34587
2022-05-24,9호선,김포공항,7450,10540,17990
2022-05-24,9호선,노들,4886,4092,8978
2022-05-24,9호선,노량진,28064,26958,55022
2022-05-24,9호선,당산,19696,20186,39882
2022-05-24,9호선,동작,2317,1926,4243
2022-05-24,9호선,등촌,12253,11583,23836
2022-05-24,9호선,마곡나루,13217,13172,26389
2022-05-24,9호선,사평,4102,3849,7951
2022-05-24,9호선,샛강,6606,6925,13531
2022-05-24,9호선,선유도,9620,9081,18701
2022-05-24,9호선,신논현,34466,34385,68851
2022-05-24,9호선,신목동,4830,4196,9026
2022-05-24,9호선,신반포,3951,3896,7847
2022-05-24,9호선,신방화,7381,7125,14506
2022-05-24,9호선,양천향교,10643,10867,21510
2022-05-24,9호선,여의도,29897,29897,59794
2022-05-24,9호선,염창,18744,17916,36660
2022-05-24,9호선,증미,7993,7837,15830
2022-05-24,9호선,흑석,10027,10145,20172
2022-05-24,9호선2~3단계,둔촌오륜,1231,1164,2395
2022-05-24,9호선2~3단계,봉은사,17794,18204,35998
2022-05-24,9호선2~3단계,삼성중앙,7745,8300,16045
2022-05-24,9호선2~3단계,삼전,7506,7020,14526
2022-05-24,9호선2~3단계,석촌,9289,8096,17385
2022-05-24,9호선2~3단계,석촌고분,6532,6394,12926
2022-05-24,9호선2~3단계,선정릉,11026,11996,23022
2022-05-24,9호선2~3단계,송파나루,5204,5537,10741
2022-05-24,9호선2~3단계,언주,11176,11627,22803
2022-05-24,9호선2~3단계,올림픽공원,7204,7302,14506
2022-05-24,9호선2~3단계,종합운동장,4474,4503,8977
2022-05-24,9호선2~3단계,중앙보훈병원,12254,10881,23135
2022-05-24,9호선2~3단계,한성백제,2788,2453,5241
2022-05-24,경강선,경기광주,8745,8043,16788
2022-05-24,경강선,곤지암,2502,2527,5029
2022-05-24,경강선,부발,2251,2266,4517
2022-05-24,경강선,삼동,2739,2446,5185
2022-05-24,경강선,세종대왕릉,377,364,741
2022-05-24,경강선,신둔도예촌,1784,1613,3397
2022-05-24,경강선,여주,2712,2715,5427
2022-05-24,경강선,이매,1218,990,2208
2022-05-24,경강선,이천,2737,2883,5620
2022-05-24,경강선,초월,3565,3361,6926
2022-05-24,경강선,판교,5466,5437,10903
2022-05-24,경부선,가산디지털단지,19839,22989,42828
2022-05-24,경부선,관악,8234,7770,16004
2022-05-24,경부선,광명,3783,3168,6951
2022-05-24,경부선,구로,19828,20680,40508
2022-05-24,경부선,군포,8349,8189,16538
2022-05-24,경부선,금정,29412,30069,59481
2022-05-24,경부선,금천구청,13013,12983,25996
2022-05-24,경부선,남영,10475,11241,21716
2022-05-24,경부선,노량진,8881,9192,18073
2022-05-24,경부선,당정,7919,7571,15490
2022-05-24,경부선,대방,14447,14852,29299
2022-05-24,경부선,독산,20413,21223,41636
2022-05-24,경부선,두정,8258,9236,17494
2022-05-24,경부선,명학,11562,11378,22940
2022-05-24,경부선,병점,18013,18045,36058
2022-05-24,경부선,서동탄,1596,1425,3021
2022-05-24,경부선,서울역,6444,1997,8441
2022-05-24,경부선,서정리,8111,7691,15802
2022-05-24,경부선,석수,10737,9653,20390
2022-05-24,경부선,성균관대,16633,16497,33130
2022-05-24,경부선,성환,6874,6688,13562
2022-05-24,경부선,세류,3466,3079,6545
2022-05-24,경부선,세마,3187,2977,6164
2022-05-24,경부선,송탄,4604,4442,9046
2022-05-24,경부선,수원,38513,40949,79462
2022-05-24,경부선,신길,10563,9132,19695
2022-05-24,경부선,신도림,4558,4618,9176
2022-05-24,경부선,안양,28957,28543,57500
2022-05-24,경부선,영등포,39000,40325,79325
2022-05-24,경부선,오산,10947,10829,21776
2022-05-24,경부선,오산대,4687,4370,9057
2022-05-24,경부선,용산,34274,35313,69587
2022-05-24,경부선,의왕,10715,10520,21235
2022-05-24,경부선,직산,946,969,1915
2022-05-24,경부선,진위,2031,1778,3809
2022-05-24,경부선,천안,7587,7030,14617
2022-05-24,경부선,평택,13644,13860,27504
2022-05-24,경부선,평택지제,3872,3777,7649
2022-05-24,경부선,화서,9500,9026,18526
2022-05-24,경원선,가능,7532,7096,14628
2022-05-24,경원선,광운대,9618,9393,19011
2022-05-24,경원선,녹양,5113,4828,9941
2022-05-24,경원선,녹천,5074,4224,9298
2022-05-24,경원선,덕계,3746,3447,7193
2022-05-24,경원선,덕정,7130,6775,13905
2022-05-24,경원선,도봉,6663,6263,12926
2022-05-24,경원선,도봉산,8482,5640,14122
2022-05-24,경원선,동두천,2993,3206,6199
2022-05-24,경원선,동두천중앙,3435,3389,6824
2022-05-24,경원선,망월사,10285,10483,20768
2022-05-24,경원선,방학,10653,10446,21099
2022-05-24,경원선,보산,1731,1568,3299
2022-05-24,경원선,서빙고,2306,2065,4371
2022-05-24,경원선,석계,9301,10343,19644
2022-05-24,경원선,소요산,2940,2545,5485
2022-05-24,경원선,신이문,9125,8305,17430
2022-05-24,경원선,양주,8848,8255,17103
2022-05-24,경원선,옥수,61,49,110
2022-05-24,경원선,왕십리,15340,17098,32438
2022-05-24,경원선,외대앞,8924,9020,17944
2022-05-24,경원선,월계,9077,8333,17410
2022-05-24,경원선,응봉,2229,1803,4032
2022-05-24,경원선,의정부,19210,20047,39257
2022-05-24,경원선,이촌,4247,3184,7431
2022-05-24,경원선,지행,7540,7566,15106
2022-05-24,경원선,창동,2,0,2
2022-05-24,경원선,청량리,15911,16834,32745
2022-05-24,경원선,한남,4585,4248,8833
2022-05-24,경원선,회룡,13969,13788,27757
2022-05-24,경의선,가좌,6302,5891,12193
2022-05-24,경의선,강매,3752,3170,6922
2022-05-24,경의선,계양,1,0,1
2022-05-24,경의선,곡산,703,752,1455
2022-05-24,경의선,공덕,3818,3445,7263
2022-05-24,경의선,금릉,5481,5189,10670
2022-05-24,경의선,금촌,6906,6727,13633
2022-05-24,경의선,능곡,4386,3911,8297
2022-05-24,경의선,디지털미디어시티,3002,2778,5780
2022-05-24,경의선,문산,5905,5919,11824
2022-05-24,경의선,백마,7839,7563,15402
2022-05-24,경의선,서강대,2364,2372,4736
2022-05-24,경의선,서울역,5032,6617,11649
2022-05-24,경의선,수색,3131,3330,6461
2022-05-24,경의선,신촌,966,1306,2272
2022-05-24,경의선,야당,8505,8473,16978
2022-05-24,경의선,운정,7856,7133,14989
2022-05-24,경의선,월롱,3347,3219,6566
2022-05-24,경의선,일산,10729,10501,21230
2022-05-24,경의선,임진강,21,25,46
2022-05-24,경의선,탄현,8781,8297,17078
2022-05-24,경의선,파주,1755,1236,2991
2022-05-24,경의선,풍산,6146,5776,11922
2022-05-24,경의선,행신,8815,9058,17873
2022-05-24,경의선,홍대입구,1942,2039,3981
2022-05-24,경의선,화전,3908,3689,7597
2022-05-24,경의선,효창공원앞,3447,3802,7249
2022-05-24,경인선,간석,6533,6168,12701
2022-05-24,경인선,개봉,23461,22783,46244
2022-05-24,경인선,구일,8107,7814,15921
2022-05-24,경인선,도원,4050,3910,7960
2022-05-24,경인선,도화,4724,4275,8999
2022-05-24,경인선,동암,15900,15917,31817
2022-05-24,경인선,동인천,14695,13944,28639
2022-05-24,경인선,백운,7675,7544,15219
2022-05-24,경인선,부개,9753,8900,18653
2022-05-24,경인선,부천,34749,34602,69351
2022-05-24,경인선,부평,29750,31791,61541
2022-05-24,경인선,소사,10107,9753,19860
2022-05-24,경인선,송내,30634,30556,61190
2022-05-24,경인선,역곡,31522,30835,62357
2022-05-24,경인선,오류동,12883,11837,24720
2022-05-24,경인선,온수,7979,7608,15587
2022-05-24,경인선,인천,3939,3089,7028
2022-05-24,경인선,제물포,12385,11801,24186
2022-05-24,경인선,주안,21420,19533,40953
2022-05-24,경인선,중동,10605,9874,20479
2022-05-24,경춘선,가평,1721,1735,3456
2022-05-24,경춘선,갈매,3401,2884,6285
2022-05-24,경춘선,강촌,397,412,809
2022-05-24,경춘선,굴봉산,150,142,292
2022-05-24,경춘선,금곡,1747,1667,3414
2022-05-24,경춘선,김유정,401,402,803
2022-05-24,경춘선,남춘천,2698,2797,5495
2022-05-24,경춘선,대성리,589,573,1162
2022-05-24,경춘선,마석,4413,4342,8755
2022-05-24,경춘선,백양리,109,90,199
2022-05-24,경춘선,별내,3546,3323,6869
2022-05-24,경춘선,사릉,2793,2677,5470
2022-05-24,경춘선,상천,380,378,758
2022-05-24,경춘선,신내,2523,2347,4870
2022-05-24,경춘선,천마산,1996,1821,3817
2022-05-24,경춘선,청평,1804,1741,3545
2022-05-24,경춘선,춘천,1982,1806,3788
2022-05-24,경춘선,퇴계원,3941,3523,7464
2022-05-24,경춘선,평내호평,7111,7023,14134
2022-05-24,공항철도,검암,7403,7189,14592
2022-05-24,공항철도,계양,12081,11304,23385
2022-05-24,공항철도,공덕,2582,3297,5879
2022-05-24,공항철도,공항화물청사,2466,2724,5190
2022-05-24,공항철도,김포공항,12249,7390,19639
2022-05-24,공항철도,디지털미디어시티,15793,14852,30645
2022-05-24,공항철도,마곡나루,10916,10627,21543
2022-05-24,공항철도,서울역,8699,7895,16594
2022-05-24,공항철도,영종,3470,3465,6935
2022-05-24,공항철도,운서,7698,7703,15401
2022-05-24,공항철도,인천공항1터미널,5786,5725,11511
2022-05-24,공항철도,인천공항2터미널,2930,2846,5776
2022-05-24,공항철도,청라국제도시,7921,7408,15329
2022-05-24,공항철도,홍대입구,9951,10152,20103
2022-05-24,과천선,경마공원,1845,1751,3596
2022-05-24,과천선,과천,7127,6495,13622
2022-05-24,과천선,대공원,5872,5947,11819
2022-05-24,과천선,범계,28860,28500,57360
2022-05-24,과천선,선바위,9469,8818,18287
2022-05-24,과천선,인덕원,27163,27757,54920
2022-05-24,과천선,정부과천청사,11816,11709,23525
2022-05-24,과천선,평촌,19828,19449,39277
2022-05-24,분당선,가천대,14003,14930,28933
2022-05-24,분당선,강남구청,11360,13049,24409
2022-05-24,분당선,개포동,4423,4485,8908
2022-05-24,분당선,구룡,2984,2826,5810
2022-05-24,분당선,구성,5701,5964,11665
2022-05-24,분당선,기흥,11556,10939,22495
2022-05-24,분당선,대모산입구,5495,5188,10683
2022-05-24,분당선,도곡,8896,8081,16977
2022-05-24,분당선,망포,16091,15138,31229
2022-05-24,분당선,매교,3434,3495,6929
2022-05-24,분당선,매탄권선,5983,5673,11656
2022-05-24,분당선,모란,27545,28391,55936
2022-05-24,분당선,미금,17025,18382,35407
2022-05-24,분당선,보정,2950,2584,5534
2022-05-24,분당선,상갈,6262,5991,12253
2022-05-24,분당선,서울숲,12777,12950,25727
2022-05-24,분당선,서현,25796,26480,52276
2022-05-24,분당선,선릉,14956,23089,38045
2022-05-24,분당선,선정릉,8769,9550,18319
2022-05-24,분당선,수내,15165,15011,30176
2022-05-24,분당선,수서,15636,16277,31913
2022-05-24,분당선,수원,8716,7335,16051
2022-05-24,분당선,수원시청,13520,14526,28046
2022-05-24,분당선,신갈,5118,5145,10263
2022-05-24,분당선,압구정로데오,20459,22130,42589
2022-05-24,분당선,야탑,28536,29772,58308
2022-05-24,분당선,영통,9315,9911,19226
2022-05-24,분당선,오리,12943,10422,23365
2022-05-24,분당선,이매,6533,6065,12598
2022-05-24,분당선,정자,19495,20584,40079
2022-05-24,분당선,죽전,16014,17416,33430
2022-05-24,분당선,청명,4817,4706,9523
2022-05-24,분당선,태평,14727,14193,28920
2022-05-24,분당선,한티,15712,16687,32399
2022-05-24,수인선,고색,5465,5226,10691
2022-05-24,수인선,남동인더스파크,2435,2681,5116
2022-05-24,수인선,달월,127,85,212
2022-05-24,수인선,사리,5600,4981,10581
2022-05-24,수인선,소래포구,6794,6206,13000
2022-05-24,수인선,송도,2718,2530,5248
2022-05-24,수인선,숭의,4445,4129,8574
2022-05-24,수인선,신포,2058,2100,4158
2022-05-24,수인선,야목,453,304,757
2022-05-24,수인선,어천,828,863,1691
2022-05-24,수인선,연수,5073,4948,10021
2022-05-24,수인선,오목천,4674,4026,8700
2022-05-24,수인선,원인재,4869,5071,9940
2022-05-24,수인선,월곶,3139,2906,6045
2022-05-24,수인선,인천,1137,1836,2973
2022-05-24,수인선,인천논현,6030,6464,12494
2022-05-24,수인선,인하대,8271,7928,16199
2022-05-24,수인선,호구포,4449,4685,9134
2022-05-24,안산선,고잔,10146,9481,19627
2022-05-24,안산선,대야미,5626,5037,10663
2022-05-24,안산선,반월,4699,4579,9278
2022-05-24,안산선,산본,17417,18611,36028
2022-05-24,안산선,상록수,18255,18351,36606
2022-05-24,안산선,수리산,4627,3837,8464
2022-05-24,안산선,신길온천,2049,1898,3947
2022-05-24,안산선,안산,12495,11288,23783
2022-05-24,안산선,오이도,9619,9343,18962
2022-05-24,안산선,정왕,11230,11530,22760
2022-05-24,안산선,중앙,19862,20844,40706
2022-05-24,안산선,초지,5627,6092,11719
2022-05-24,안산선,한대앞,11469,11661,23130
2022-05-24,우이신설선,4.19민주묘지,3832,3545,7377
2022-05-24,우이신설선,가오리,4500,4366,8866
2022-05-24,우이신설선,보문,1627,1693,3320
2022-05-24,우이신설선,북한산보국문,6717,6261,12978
2022-05-24,우이신설선,북한산우이,3028,2697,5725
2022-05-24,우이신설선,삼양,2142,2248,4390
2022-05-24,우이신설선,삼양사거리,2676,2613,5289
2022-05-24,우이신설선,성신여대입구,3620,4104,7724
2022-05-24,우이신설선,솔밭공원,2766,2641,5407
2022-05-24,우이신설선,솔샘,6499,5965,12464
2022-05-24,우이신설선,신설동,2388,2257,4645
2022-05-24,우이신설선,정릉,5270,4690,9960
2022-05-24,우이신설선,화계,3773,3439,7212
2022-05-24,일산선,대곡,2605,2114,4719
2022-05-24,일산선,대화,14779,11051,25830
2022-05-24,일산선,마두,8091,7955,16046
2022-05-24,일산선,백석,10712,11386,22098
2022-05-24,일산선,삼송,21651,20775,42426
2022-05-24,일산선,원당,12395,11488,23883
2022-05-24,일산선,원흥,12245,11203,23448
2022-05-24,일산선,정발산,7631,7584,15215
2022-05-24,일산선,주엽,10109,9491,19600
2022-05-24,일산선,화정,18351,18593,36944
2022-05-24,장항선,배방,1356,1317,2673
2022-05-24,장항선,봉명,1457,1457,2914
2022-05-24,장항선,신창,3071,3007,6078
2022-05-24,장항선,쌍용,3519,3272,6791
2022-05-24,장항선,아산,4204,3508,7712
2022-05-24,장항선,온양온천,5253,5345,10598
2022-05-24,장항선,탕정,1013,889,1902
2022-05-24,중앙선,구리,14831,14764,29595
2022-05-24,중앙선,국수,865,851,1716
2022-05-24,중앙선,덕소,6103,6102,12205
2022-05-24,중앙선,도농,12308,11004,23312
2022-05-24,중앙선,도심,2782,2126,4908
2022-05-24,중앙선,망우,8218,8110,16328
2022-05-24,중앙선,상봉,6152,6284,12436
2022-05-24,중앙선,신원,260,202,462
2022-05-24,중앙선,아신,600,585,1185
2022-05-24,중앙선,양수,2198,2148,4346
2022-05-24,중앙선,양원,3376,3181,6557
2022-05-24,중앙선,양정,830,693,1523
2022-05-24,중앙선,양평,3016,3043,6059
2022-05-24,중앙선,오빈,353,375,728
2022-05-24,중앙선,용문,2080,2055,4135
2022-05-24,중앙선,운길산,955,910,1865
2022-05-24,중앙선,원덕,432,401,833
2022-05-24,중앙선,중랑,6264,5826,12090
2022-05-24,중앙선,지평,77,90,167
2022-05-24,중앙선,팔당,918,1013,1931
2022-05-24,중앙선,회기,28734,28902,57636
2022-05-25,1호선,동대문,11732,10994,22726
2022-05-25,1호선,동묘앞,8700,9036,17736
2022-05-25,1호선,서울역,48790,47082,95872
2022-05-25,1호선,시청,26242,26445,52687
2022-05-25,1호선,신설동,15024,14744,29768
2022-05-25,1호선,제기동,17983,18289,36272
2022-05-25,1호선,종각,40417,38603,79020
2022-05-25,1호선,종로3가,26899,24595,51494
2022-05-25,1호선,종로5가,25157,24807,49964
2022-05-25,1호선,청량리,21728,21521,43249
2022-05-25,2호선,강남,88971,88075,177046
2022-05-25,2호선,강변,32553,30362,62915
2022-05-25,2호선,건대입구,38648,41369,80017
2022-05-25,2호선,교대,37998,43213,81211
2022-05-25,2호선,구로디지털단지,63791,63206,126997
2022-05-25,2호선,구의,25535,24860,50395
2022-05-25,2호선,낙성대,29753,28692,58445
2022-05-25,2호선,당산,20618,24228,44846
2022-05-25,2호선,대림,25451,26075,51526
2022-05-25,2호선,도림천,1517,1577,3094
2022-05-25,2호선,동대문역사문화공원,12938,14684,27622
2022-05-25,2호선,뚝섬,24134,25959,50093
2022-05-25,2호선,문래,24174,24664,48838
2022-05-25,2호선,방배,21198,21889,43087
2022-05-25,2호선,봉천,25621,23576,49197
2022-05-25,2호선,사당,41492,45780,87272
2022-05-25,2호선,삼성,55534,56816,112350
2022-05-25,2호선,상왕십리,16006,15466,31472
2022-05-25,2호선,서울대입구,51341,50502,101843
2022-05-25,2호선,서초,24348,23555,47903
2022-05-25,2호선,선릉,62611,55464,118075
2022-05-25,2호선,성수,40468,44211,84679
2022-05-25,2호선,시청,26808,25649,52457
2022-05-25,2호선,신답,1831,2051,3882
2022-05-25,2호선,신당,15218,15964,31182
2022-05-25,2호선,신대방,29100,28339,57439
2022-05-25,2호선,신도림,51691,51549,103240
2022-05-25,2호선,신림,67827,65634,133461
2022-05-25,2호선,신설동,3518,3585,7103
2022-05-25,2호선,신정네거리,11425,11652,23077
2022-05-25,2호선,신촌,36528,37023,73551
2022-05-25,2호선,아현,11739,11032,22771
2022-05-25,2호선,양천구청,7585,7895,15480
2022-05-25,2호선,역삼,57690,65042,122732
2022-05-25,2호선,영등포구청,24451,25265,49716
2022-05-25,2호선,왕십리,20004,17494,37498
2022-05-25,2호선,용답,3182,3302,6484
2022-05-25,2호선,용두,2566,2607,5173
2022-05-25,2호선,을지로3가,25577,25153,50730
2022-05-25,2호선,을지로4가,14244,14201,28445
2022-05-25,2호선,을지로입구,43538,45417,88955
2022-05-25,2호선,이대,16005,17125,33130
2022-05-25,2호선,잠실,72268,71721,143989
2022-05-25,2호선,잠실나루,16332,16130,32462
2022-05-25,2호선,잠실새내,22712,22746,45458
2022-05-25,2호선,종합운동장,11547,12741,24288
2022-05-25,2호선,충정로,11072,11780,22852
2022-05-25,2호선,한양대,30105,39393,69498
2022-05-25,2호선,합정,32110,34319,66429
2022-05-25,2호선,홍대입구,56927,59744,116671
2022-05-25,3호선,가락시장,9952,9674,19626
2022-05-25,3호선,경복궁,30838,32466,63304
2022-05-25,3호선,경찰병원,8080,8138,16218
2022-05-25,3호선,고속터미널,42259,39811,82070
2022-05-25,3호선,교대,16661,10711,27372
2022-05-25,3호선,구파발,22745,21921,44666
2022-05-25,3호선,금호,8610,7967,16577
2022-05-25,3호선,남부터미널,31012,31485,62497
2022-05-25,3호선,녹번,17256,15582,32838
2022-05-25,3호선,대청,11510,10515,22025
2022-05-25,3호선,대치,11775,11977,23752
2022-05-25,3호선,도곡,5909,6181,12090
2022-05-25,3호선,독립문,7754,8180,15934
2022-05-25,3호선,동대입구,9583,10689,20272
2022-05-25,3호선,매봉,14068,13529,27597
2022-05-25,3호선,무악재,4280,4507,8787
2022-05-25,3호선,불광,18036,19284,37320
2022-05-25,3호선,수서,18456,18737,37193
2022-05-25,3호선,신사,32220,33181,65401
2022-05-25,3호선,안국,26582,26601,53183
2022-05-25,3호선,압구정,32997,35562,68559
2022-05-25,3호선,약수,14565,14151,28716
2022-05-25,3호선,양재,43408,47207,90615
2022-05-25,3호선,연신내,39047,37009,76056
2022-05-25,3호선,오금,6824,6144,12968
2022-05-25,3호선,옥수,9760,10018,19778
2022-05-25,3호선,을지로3가,11736,11706,23442
2022-05-25,3호선,일원,11547,11047,22594
2022-05-25,3호선,잠원,5521,5318,10839
2022-05-25,3호선,종로3가,10856,12344,23200
2022-05-25,3호선,지축,5687,5220,10907
2022-05-25,3호선,충무로,2,0,2
2022-05-25,3호선,학여울,2025,2039,4064
2022-05-25,3호선,홍제,19745,18842,38587
2022-05-25,4호선,길음,24363,24688,49051
2022-05-25,4호선,남태령,1407,1231,2638
2022-05-25,4호선,노원,20099,22794,42893
2022-05-25,4호선,당고개,9776,8686,18462
2022-05-25,4호선,동대문,21286,21792,43078
2022-05-25,4호선,동대문역사문화공원,15663,14250,29913
2022-05-25,4호선,동작,1678,1843,3521
2022-05-25,4호선,명동,22700,23341,46041
2022-05-25,4호선,미아,16594,16058,32652
2022-05-25,4호선,미아사거리,29551,28662,58213
2022-05-25,4호선,사당,28437,23767,52204
2022-05-25,4호선,삼각지,5986,6768,12754
2022-05-25,4호선,상계,20877,19435,40312
2022-05-25,4호선,서울역,12808,18745,31553
2022-05-25,4호선,성신여대입구,23088,21722,44810
2022-05-25,4호선,수유,36525,36297,72822
2022-05-25,4호선,숙대입구,16075,15456,31531
2022-05-25,4호선,신용산,18633,19359,37992
2022-05-25,4호선,쌍문,31657,29112,60769
2022-05-25,4호선,이촌,10004,10766,20770
2022-05-25,4호선,창동,27915,29291,57206
2022-05-25,4호선,총신대입구,21028,22679,43707
2022-05-25,4호선,충무로,30745,31461,62206
2022-05-25,4호선,한성대입구,16481,16246,32727
2022-05-25,4호선,혜화,37229,37338,74567
2022-05-25,4호선,회현,27403,28876,56279
2022-05-25,5호선,강동,19965,19421,39386
2022-05-25,5호선,강일,4793,4482,9275
2022-05-25,5호선,개롱,7309,7554,14863
2022-05-25,5호선,개화산,6268,5987,12255
2022-05-25,5호선,거여,11415,10876,22291
2022-05-25,5호선,고덕,10659,10685,21344
2022-05-25,5호선,공덕,15477,16663,32140
2022-05-25,5호선,광나루,15743,14378,30121
2022-05-25,5호선,광화문,34828,36195,71023
2022-05-25,5호선,군자,12223,13439,25662
2022-05-25,5호선,굽은다리,10462,10142,20604
2022-05-25,5호선,길동,8655,8925,17580
2022-05-25,5호선,김포공항,7920,7788,15708
2022-05-25,5호선,까치산,31342,29771,61113
2022-05-25,5호선,답십리,17322,15856,33178
2022-05-25,5호선,동대문역사문화공원,3190,3710,6900
2022-05-25,5호선,둔촌동,8921,8776,17697
2022-05-25,5호선,마곡,11910,11963,23873
2022-05-25,5호선,마장,6362,6175,12537
2022-05-25,5호선,마천,8144,7674,15818
2022-05-25,5호선,마포,16208,16260,32468
2022-05-25,5호선,명일,9734,9946,19680
2022-05-25,5호선,목동,19153,20047,39200
2022-05-25,5호선,미사,17624,17558,35182
2022-05-25,5호선,발산,22949,23365,46314
2022-05-25,5호선,방이,7875,8069,15944
2022-05-25,5호선,방화,7447,7215,14662
2022-05-25,5호선,상일동,16663,15501,32164
2022-05-25,5호선,서대문,22567,22892,45459
2022-05-25,5호선,송정,6971,6562,13533
2022-05-25,5호선,신금호,7109,7405,14514
2022-05-25,5호선,신길,4675,5044,9719
2022-05-25,5호선,신정,15375,12395,27770
2022-05-25,5호선,아차산,16382,15729,32111
2022-05-25,5호선,애오개,7681,7746,15427
2022-05-25,5호선,양평,8224,8181,16405
2022-05-25,5호선,여의나루,11436,13020,24456
2022-05-25,5호선,여의도,31947,33299,65246
2022-05-25,5호선,영등포구청,4356,4611,8967
2022-05-25,5호선,영등포시장,11072,11510,22582
2022-05-25,5호선,오금,4195,4328,8523
2022-05-25,5호선,오목교,24113,25625,49738
2022-05-25,5호선,올림픽공원,4963,4432,9395
2022-05-25,5호선,왕십리,4922,5925,10847
2022-05-25,5호선,우장산,16335,16093,32428
2022-05-25,5호선,을지로4가,6677,6731,13408
2022-05-25,5호선,장한평,20326,20053,40379
2022-05-25,5호선,종로3가,14469,13754,28223
2022-05-25,5호선,천호,19543,19552,39095
2022-05-25,5호선,청구,4490,3914,8404
2022-05-25,5호선,충정로,5253,5504,10757
2022-05-25,5호선,하남검단산,6288,5897,12185
2022-05-25,5호선,하남시청,7856,7376,15232
2022-05-25,5호선,하남풍산,4593,4467,9060
2022-05-25,5호선,행당,9096,7991,17087
2022-05-25,5호선,화곡,31036,29028,60064
2022-05-25,6호선,고려대,10433,9823,20256
2022-05-25,6호선,공덕,20436,20029,40465
2022-05-25,6호선,광흥창,10144,9848,19992
2022-05-25,6호선,구산,8442,6202,14644
2022-05-25,6호선,녹사평,5164,5185,10349
2022-05-25,6호선,대흥,9591,9803,19394
2022-05-25,6호선,독바위,2994,3192,6186
2022-05-25,6호선,돌곶이,10528,9805,20333
2022-05-25,6호선,동묘앞,8338,8601,16939
2022-05-25,6호선,디지털미디어시티,15746,17169,32915
2022-05-25,6호선,마포구청,15736,14188,29924
2022-05-25,6호선,망원,14662,15497,30159
2022-05-25,6호선,버티고개,2461,2346,4807
2022-05-25,6호선,보문,8180,7456,15636
2022-05-25,6호선,봉화산,9942,9272,19214
2022-05-25,6호선,불광,4895,4669,9564
2022-05-25,6호선,삼각지,8274,7345,15619
2022-05-25,6호선,상수,9661,10796,20457
2022-05-25,6호선,상월곡,7122,6733,13855
2022-05-25,6호선,새절,14315,13290,27605
2022-05-25,6호선,석계,13830,14462,28292
2022-05-25,6호선,신당,9792,9912,19704
2022-05-25,6호선,안암,16988,19701,36689
2022-05-25,6호선,약수,4034,4100,8134
2022-05-25,6호선,역촌,4032,4809,8841
2022-05-25,6호선,연신내,2,0,2
2022-05-25,6호선,월곡,13770,13241,27011
2022-05-25,6호선,월드컵경기장,5797,6137,11934
2022-05-25,6호선,응암,19112,18714,37826
2022-05-25,6호선,이태원,10672,11130,21802
2022-05-25,6호선,증산,10960,10944,21904
2022-05-25,6호선,창신,4231,3692,7923
2022-05-25,6호선,청구,3866,4259,8125
2022-05-25,6호선,태릉입구,7176,8280,15456
2022-05-25,6호선,한강진,8867,10056,18923
2022-05-25,6호선,합정,14241,14008,28249
2022-05-25,6호선,화랑대,13967,10560,24527
2022-05-25,6호선,효창공원앞,7947,7525,15472
2022-05-25,7호선,가산디지털단지,48759,48403,97162
2022-05-25,7호선,강남구청,17414,19491,36905
2022-05-25,7호선,건대입구,13697,14302,27999
2022-05-25,7호선,고속터미널,16313,14208,30521
2022-05-25,7호선,공릉,13721,13350,27071
2022-05-25,7호선,광명사거리,23586,23139,46725
2022-05-25,7호선,군자,16032,13078,29110
2022-05-25,7호선,까치울,1,0,1
2022-05-25,7호선,남구로,16947,17966,34913
2022-05-25,7호선,남성,12268,11306,23574
2022-05-25,7호선,내방,16023,16533,32556
2022-05-25,7호선,노원,20788,21877,42665
2022-05-25,7호선,논현,21599,23811,45410
2022-05-25,7호선,대림,8087,8121,16208
2022-05-25,7호선,도봉산,10462,11922,22384
2022-05-25,7호선,뚝섬유원지,9093,8859,17952
2022-05-25,7호선,마들,14386,13504,27890
2022-05-25,7호선,먹골,10902,10543,21445
2022-05-25,7호선,면목,17633,17098,34731
2022-05-25,7호선,반포,6519,6267,12786
2022-05-25,7호선,보라매,11336,11290,22626
2022-05-25,7호선,사가정,17552,17339,34891
2022-05-25,7호선,상도,12844,12496,25340
2022-05-25,7호선,상봉,17753,16664,34417
2022-05-25,7호선,수락산,14065,13648,27713
2022-05-25,7호선,숭실대입구,16211,16260,32471
2022-05-25,7호선,신대방삼거리,18252,17406,35658
2022-05-25,7호선,신중동,1,0,1
2022-05-25,7호선,신풍,12615,12149,24764
2022-05-25,7호선,어린이대공원,17159,17569,34728
2022-05-25,7호선,온수,11975,11206,23181
2022-05-25,7호선,용마산,6621,6425,13046
2022-05-25,7호선,이수,17169,16539,33708
2022-05-25,7호선,장승배기,9777,9545,19322
2022-05-25,7호선,장암,2392,906,3298
2022-05-25,7호선,중계,15998,14643,30641
2022-05-25,7호선,중곡,12087,10986,23073
2022-05-25,7호선,중화,11756,11437,23193
2022-05-25,7호선,천왕,12462,11910,24372
2022-05-25,7호선,철산,22779,23126,45905
2022-05-25,7호선,청담,21060,23791,44851
2022-05-25,7호선,태릉입구,11174,10650,21824
2022-05-25,7호선,하계,19964,18767,38731
2022-05-25,7호선,학동,26446,28122,54568
2022-05-25,8호선,가락시장,8324,9295,17619
2022-05-25,8호선,강동구청,11310,11799,23109
2022-05-25,8호선,남위례,5844,6035,11879
2022-05-25,8호선,남한산성입구,16778,15377,32155
2022-05-25,8호선,단대오거리,12264,11738,24002
2022-05-25,8호선,모란,4781,3700,8481
2022-05-25,8호선,몽촌토성,7276,7384,14660
2022-05-25,8호선,문정,24133,25248,49381
2022-05-25,8호선,복정,10988,9300,20288
2022-05-25,8호선,산성,6131,6162,12293
2022-05-25,8호선,석촌,8286,9508,17794
2022-05-25,8호선,송파,9303,9409,18712
2022-05-25,8호선,수진,5734,5433,11167
2022-05-25,8호선,신흥,4494,4762,9256
2022-05-25,8호선,암사,20694,18127,38821
2022-05-25,8호선,잠실,15060,17320,32380
2022-05-25,8호선,장지,18870,17949,36819
2022-05-25,8호선,천호,15736,17881,33617
2022-05-25,9호선,가양,23119,22398,45517
2022-05-25,9호선,개화,2985,2000,4985
2022-05-25,9호선,고속터미널,13254,16292,29546
2022-05-25,9호선,공항시장,3228,3558,6786
2022-05-25,9호선,구반포,1398,1490,2888
2022-05-25,9호선,국회의사당,18210,18515,36725
2022-05-25,9호선,김포공항,7389,11441,18830
2022-05-25,9호선,노들,4999,4263,9262
2022-05-25,9호선,노량진,28989,27582,56571
2022-05-25,9호선,당산,19932,20305,40237
2022-05-25,9호선,동작,2416,2013,4429
2022-05-25,9호선,등촌,12348,11934,24282
2022-05-25,9호선,마곡나루,13846,13314,27160
2022-05-25,9호선,사평,4067,4001,8068
2022-05-25,9호선,샛강,6937,7036,13973
2022-05-25,9호선,선유도,9940,9489,19429
2022-05-25,9호선,신논현,33927,33783,67710
2022-05-25,9호선,신목동,4843,4254,9097
2022-05-25,9호선,신반포,4084,3931,8015
2022-05-25,9호선,신방화,7611,7378,14989
2022-05-25,9호선,양천향교,10861,11099,21960
2022-05-25,9호선,여의도,30808,29985,60793
2022-05-25,9호선,염창,18839,18211,37050
2022-05-25,9호선,증미,8052,7819,15871
2022-05-25,9호선,흑석,10218,10486,20704
2022-05-25,9호선2~3단계,둔촌오륜,1295,1146,2441
2022-05-25,9호선2~3단계,봉은사,17862,17954,35816
2022-05-25,9호선2~3단계,삼성중앙,7740,8211,15951
2022-05-25,9호선2~3단계,삼전,7493,7142,14635
2022-05-25,9호선2~3단계,석촌,9215,8109,17324
2022-05-25,9호선2~3단계,석촌고분,6650,6494,13144
2022-05-25,9호선2~3단계,선정릉,10800,11978,22778
2022-05-25,9호선2~3단계,송파나루,5390,5774,11164
2022-05-25,9호선2~3단계,언주,11463,11688,23151
2022-05-25,9호선2~3단계,올림픽공원,7593,7581,15174
2022-05-25,9호선2~3단계,종합운동장,4585,4615,9200
2022-05-25,9호선2~3단계,중앙보훈병원,12133,10588,22721
2022-05-25,9호선2~3단계,한성백제,2948,2566,5514
2022-05-25,경강선,경기광주,8642,7955,16597
2022-05-25,경강선,곤지암,2569,2525,5094
2022-05-25,경강선,부발,2285,2242,4527
2022-05-25,경강선,삼동,2749,2423,5172
2022-05-25,경강선,세종대왕릉,371,338,709
2022-05-25,경강선,신둔도예촌,1797,1619,3416
2022-05-25,경강선,여주,2773,2814,5587
2022-05-25,경강선,이매,1279,1059,2338
2022-05-25,경강선,이천,2700,2797,5497
2022-05-25,경강선,초월,3479,3278,6757
2022-05-25,경강선,판교,5517,5498,11015
2022-05-25,경부선,가산디지털단지,20120,23408,43528
2022-05-25,경부선,관악,8276,7775,16051
2022-05-25,경부선,광명,3593,3089,6682
2022-05-25,경부선,구로,20084,20865,40949
2022-05-25,경부선,군포,8504,8331,16835
2022-05-25,경부선,금정,29750,29825,59575
2022-05-25,경부선,금천구청,13263,13046,26309
2022-05-25,경부선,남영,10508,11464,21972
2022-05-25,경부선,노량진,8966,9277,18243
2022-05-25,경부선,당정,7915,7555,15470
2022-05-25,경부선,대방,14660,15269,29929
2022-05-25,경부선,독산,20633,21204,41837
2022-05-25,경부선,두정,8410,9229,17639
2022-05-25,경부선,명학,11534,11438,22972
2022-05-25,경부선,병점,17927,17869,35796
2022-05-25,경부선,서동탄,1598,1388,2986
2022-05-25,경부선,서울역,6755,2158,8913
2022-05-25,경부선,서정리,8387,7736,16123
2022-05-25,경부선,석수,10748,9725,20473
2022-05-25,경부선,성균관대,16715,16509,33224
2022-05-25,경부선,성환,7388,7067,14455
2022-05-25,경부선,세류,3260,3033,6293
2022-05-25,경부선,세마,3176,3024,6200
2022-05-25,경부선,송탄,4790,4630,9420
2022-05-25,경부선,수원,38919,41304,80223
2022-05-25,경부선,신길,10397,9226,19623
2022-05-25,경부선,신도림,4491,4835,9326
2022-05-25,경부선,안양,28714,28671,57385
2022-05-25,경부선,영등포,40017,41220,81237
2022-05-25,경부선,오산,10897,10874,21771
2022-05-25,경부선,오산대,4616,4222,8838
2022-05-25,경부선,용산,35516,35725,71241
2022-05-25,경부선,의왕,10327,10221,20548
2022-05-25,경부선,직산,958,932,1890
2022-05-25,경부선,진위,2043,1867,3910
2022-05-25,경부선,천안,7281,6654,13935
2022-05-25,경부선,평택,13556,13523,27079
2022-05-25,경부선,평택지제,3875,3825,7700
2022-05-25,경부선,화서,9294,8854,18148
2022-05-25,경원선,가능,7692,7407,15099
2022-05-25,경원선,광운대,10035,9872,19907
2022-05-25,경원선,녹양,5146,4701,9847
2022-05-25,경원선,녹천,5174,4296,9470
2022-05-25,경원선,덕계,3896,3415,7311
2022-05-25,경원선,덕정,6880,6657,13537
2022-05-25,경원선,도봉,6651,6375,13026
2022-05-25,경원선,도봉산,8467,5790,14257
2022-05-25,경원선,동두천,2966,3279,6245
2022-05-25,경원선,동두천중앙,3811,3680,7491
2022-05-25,경원선,망월사,11680,12130,23810
2022-05-25,경원선,방학,10874,10647,21521
2022-05-25,경원선,보산,1570,1483,3053
2022-05-25,경원선,서빙고,2244,2082,4326
2022-05-25,경원선,석계,9285,10244,19529
2022-05-25,경원선,소요산,2819,2363,5182
2022-05-25,경원선,신이문,9301,8523,17824
2022-05-25,경원선,양주,8772,8213,16985
2022-05-25,경원선,옥수,53,38,91
2022-05-25,경원선,왕십리,17825,19353,37178
2022-05-25,경원선,외대앞,9196,9232,18428
2022-05-25,경원선,월계,9167,8452,17619
2022-05-25,경원선,응봉,2052,1773,3825
2022-05-25,경원선,의정부,19939,20662,40601
2022-05-25,경원선,이촌,4206,3275,7481
2022-05-25,경원선,지행,7401,7426,14827
2022-05-25,경원선,청량리,16089,17086,33175
2022-05-25,경원선,한남,4466,4274,8740
2022-05-25,경원선,회룡,14109,13906,28015
2022-05-25,경의선,가좌,6258,6009,12267
2022-05-25,경의선,강매,3766,3209,6975
2022-05-25,경의선,곡산,706,708,1414
2022-05-25,경의선,공덕,4165,3639,7804
2022-05-25,경의선,금릉,5541,5361,10902
2022-05-25,경의선,금촌,7082,6964,14046
2022-05-25,경의선,능곡,4267,3943,8210
2022-05-25,경의선,디지털미디어시티,2946,2724,5670
2022-05-25,경의선,문산,5441,5317,10758
2022-05-25,경의선,백마,7805,7544,15349
2022-05-25,경의선,서강대,2366,2335,4701
2022-05-25,경의선,서울역,5012,6659,11671
2022-05-25,경의선,수색,3116,3437,6553
2022-05-25,경의선,신촌,1049,1278,2327
2022-05-25,경의선,야당,8688,8459,17147
2022-05-25,경의선,운정,7771,7212,14983
2022-05-25,경의선,월롱,3479,3221,6700
2022-05-25,경의선,일산,10713,10445,21158
2022-05-25,경의선,임진강,14,7,21
2022-05-25,경의선,탄현,8773,8227,17000
2022-05-25,경의선,파주,1638,1258,2896
2022-05-25,경의선,풍산,6100,5500,11600
2022-05-25,경의선,행신,9030,9106,18136
2022-05-25,경의선,홍대입구,1876,2247,4123
2022-05-25,경의선,화전,3965,3729,7694
2022-05-25,경의선,효창공원앞,3463,3793,7256
2022-05-25,경인선,간석,6523,6212,12735
2022-05-25,경인선,개봉,23691,23271,46962
2022-05-25,경인선,구일,8122,7912,16034
2022-05-25,경인선,도원,3871,3838,7709
2022-05-25,경인선,도화,4814,4468,9282
2022-05-25,경인선,동암,16641,16620,33261
2022-05-25,경인선,동인천,15891,14792,30683
2022-05-25,경인선,백운,7739,7603,15342
2022-05-25,경인선,부개,9845,9073,18918
2022-05-25,경인선,부천,35430,35383,70813
2022-05-25,경인선,부평,30736,32799,63535
2022-05-25,경인선,소사,10141,9799,19940
2022-05-25,경인선,송내,30703,30675,61378
2022-05-25,경인선,역곡,31918,31256,63174
2022-05-25,경인선,오류동,13231,12284,25515
2022-05-25,경인선,온수,8082,7781,15863
2022-05-25,경인선,인천,4030,3210,7240
2022-05-25,경인선,제물포,12657,12083,24740
2022-05-25,경인선,주안,21808,19856,41664
2022-05-25,경인선,중동,10680,10043,20723
2022-05-25,경춘선,가평,1779,1813,3592
2022-05-25,경춘선,갈매,3395,2874,6269
2022-05-25,경춘선,강촌,447,502,949
2022-05-25,경춘선,굴봉산,149,163,312
2022-05-25,경춘선,금곡,1760,1672,3432
2022-05-25,경춘선,김유정,322,369,691
2022-05-25,경춘선,남춘천,2703,2642,5345
2022-05-25,경춘선,대성리,656,575,1231
2022-05-25,경춘선,마석,4488,4389,8877
2022-05-25,경춘선,백양리,82,74,156
2022-05-25,경춘선,별내,3466,3176,6642
2022-05-25,경춘선,사릉,2836,2724,5560
2022-05-25,경춘선,상천,376,351,727
2022-05-25,경춘선,신내,2548,2381,4929
2022-05-25,경춘선,천마산,1928,1764,3692
2022-05-25,경춘선,청평,1744,1663,3407
2022-05-25,경춘선,춘천,1802,1534,3336
2022-05-25,경춘선,퇴계원,3920,3763,7683
2022-05-25,경춘선,평내호평,7077,6818,13895
2022-05-25,공항철도,검암,7294,7113,14407
2022-05-25,공항철도,계양,11971,11241,23212
2022-05-25,공항철도,공덕,2498,3342,5840
2022-05-25,공항철도,공항화물청사,2417,2637,5054
2022-05-25,공항철도,김포공항,12090,7006,19096
2022-05-25,공항철도,디지털미디어시티,16137,14996,31133
2022-05-25,공항철도,마곡나루,10462,10192,20654
2022-05-25,공항철도,서울역,8729,7870,16599
2022-05-25,공항철도,영종,3415,3367,6782
2022-05-25,공항철도,운서,7630,7718,15348
2022-05-25,공항철도,인천공항1터미널,6395,6516,12911
2022-05-25,공항철도,인천공항2터미널,3023,2793,5816
2022-05-25,공항철도,청라국제도시,7866,7541,15407
2022-05-25,공항철도,홍대입구,10206,10516,20722
2022-05-25,과천선,경마공원,2062,1979,4041
2022-05-25,과천선,과천,7356,6772,14128
2022-05-25,과천선,대공원,4991,5119,10110
2022-05-25,과천선,범계,29238,28835,58073
2022-05-25,과천선,선바위,9363,8281,17644
2022-05-25,과천선,인덕원,27262,28191,55453
2022-05-25,과천선,정부과천청사,12059,11804,23863
2022-05-25,과천선,평촌,19944,19295,39239
2022-05-25,분당선,가천대,13333,14063,27396
2022-05-25,분당선,강남구청,11524,13036,24560
2022-05-25,분당선,개포동,4518,4212,8730
2022-05-25,분당선,구룡,2831,2581,5412
2022-05-25,분당선,구성,5684,5918,11602
2022-05-25,분당선,기흥,11648,10886,22534
2022-05-25,분당선,대모산입구,5112,4786,9898
2022-05-25,분당선,도곡,7931,7748,15679
2022-05-25,분당선,망포,16196,15265,31461
2022-05-25,분당선,매교,3467,3503,6970
2022-05-25,분당선,매탄권선,5871,5725,11596
2022-05-25,분당선,모란,21712,21934,43646
2022-05-25,분당선,미금,17337,18477,35814
2022-05-25,분당선,보정,3000,2619,5619
2022-05-25,분당선,상갈,6293,5984,12277
2022-05-25,분당선,서울숲,12997,13503,26500
2022-05-25,분당선,서현,25946,26505,52451
2022-05-25,분당선,선릉,14856,22836,37692
2022-05-25,분당선,선정릉,9028,9642,18670
2022-05-25,분당선,수내,14817,14960,29777
2022-05-25,분당선,수서,14770,15067,29837
2022-05-25,분당선,수원,8938,7460,16398
2022-05-25,분당선,수원시청,13967,14869,28836
2022-05-25,분당선,신갈,5043,4989,10032
2022-05-25,분당선,압구정로데오,19864,21873,41737
2022-05-25,분당선,야탑,29022,30377,59399
2022-05-25,분당선,영통,9379,9818,19197
2022-05-25,분당선,오리,13056,10742,23798
2022-05-25,분당선,이매,6446,6144,12590
2022-05-25,분당선,정자,19453,20485,39938
2022-05-25,분당선,죽전,15705,17265,32970
2022-05-25,분당선,청명,4843,4717,9560
2022-05-25,분당선,태평,14448,13776,28224
2022-05-25,분당선,한티,15971,17025,32996
2022-05-25,수인선,고색,5478,5250,10728
2022-05-25,수인선,남동인더스파크,2376,2706,5082
2022-05-25,수인선,달월,114,75,189
2022-05-25,수인선,사리,5605,4863,10468
2022-05-25,수인선,소래포구,6554,6046,12600
2022-05-25,수인선,송도,2768,2621,5389
2022-05-25,수인선,숭의,4482,4149,8631
2022-05-25,수인선,신포,2112,2141,4253
2022-05-25,수인선,야목,463,348,811
2022-05-25,수인선,어천,849,921,1770
2022-05-25,수인선,연수,5119,5079,10198
2022-05-25,수인선,오목천,4670,4165,8835
2022-05-25,수인선,원인재,4896,5097,9993
2022-05-25,수인선,월곶,3368,3157,6525
2022-05-25,수인선,인천,1144,1850,2994
2022-05-25,수인선,인천논현,6192,6685,12877
2022-05-25,수인선,인하대,8342,7837,16179
2022-05-25,수인선,호구포,4484,4704,9188
2022-05-25,안산선,고잔,9964,9463,19427
2022-05-25,안산선,대야미,5621,5091,10712
2022-05-25,안산선,반월,4912,4720,9632
2022-05-25,안산선,산본,17538,18832,36370
2022-05-25,안산선,상록수,18479,18887,37366
2022-05-25,안산선,수리산,4676,3908,8584
2022-05-25,안산선,신길온천,2024,1798,3822
2022-05-25,안산선,안산,12311,11102,23413
2022-05-25,안산선,오이도,9377,9168,18545
2022-05-25,안산선,정왕,10839,11219,22058
2022-05-25,안산선,중앙,20321,21202,41523
2022-05-25,안산선,초지,5925,6294,12219
2022-05-25,안산선,한대앞,10897,12326,23223
2022-05-25,우이신설선,4.19민주묘지,4219,4016,8235
2022-05-25,우이신설선,가오리,4670,4605,9275
2022-05-25,우이신설선,보문,1724,1757,3481
2022-05-25,우이신설선,북한산보국문,6785,6445,13230
2022-05-25,우이신설선,북한산우이,3016,2718,5734
2022-05-25,우이신설선,삼양,2106,2196,4302
2022-05-25,우이신설선,삼양사거리,2699,2717,5416
2022-05-25,우이신설선,성신여대입구,3788,3949,7737
2022-05-25,우이신설선,솔밭공원,2695,2584,5279
2022-05-25,우이신설선,솔샘,6489,5993,12482
2022-05-25,우이신설선,신설동,2337,2312,4649
2022-05-25,우이신설선,정릉,5452,4905,10357
2022-05-25,우이신설선,화계,3731,3407,7138
2022-05-25,일산선,대곡,2511,1996,4507
2022-05-25,일산선,대화,14766,11655,26421
2022-05-25,일산선,마두,8419,8592,17011
2022-05-25,일산선,백석,10773,10675,21448
2022-05-25,일산선,삼송,21744,20897,42641
2022-05-25,일산선,원당,12517,11725,24242
2022-05-25,일산선,원흥,12394,11679,24073
2022-05-25,일산선,정발산,7883,8000,15883
2022-05-25,일산선,주엽,10229,10133,20362
2022-05-25,일산선,화정,18546,18955,37501
2022-05-25,장항선,배방,1332,1267,2599
2022-05-25,장항선,봉명,1472,1462,2934
2022-05-25,장항선,신창,3229,3060,6289
2022-05-25,장항선,쌍용,3288,3039,6327
2022-05-25,장항선,아산,4153,3684,7837
2022-05-25,장항선,온양온천,4033,4178,8211
2022-05-25,장항선,탕정,1015,877,1892
2022-05-25,중앙선,구리,14771,15006,29777
2022-05-25,중앙선,국수,879,853,1732
2022-05-25,중앙선,덕소,6233,6225,12458
2022-05-25,중앙선,도농,12367,11085,23452
2022-05-25,중앙선,도심,2867,2205,5072
2022-05-25,중앙선,망우,8390,8369,16759
2022-05-25,중앙선,상봉,6109,6174,12283
2022-05-25,중앙선,신원,229,227,456
2022-05-25,중앙선,아신,637,619,1256
2022-05-25,중앙선,양수,2157,2155,4312
2022-05-25,중앙선,양원,3470,3328,6798
2022-05-25,중앙선,양정,820,708,1528
2022-05-25,중앙선,양평,3039,3065,6104
2022-05-25,중앙선,오빈,346,311,657
2022-05-25,중앙선,용문,3669,3618,7287
2022-05-25,중앙선,운길산,845,863,1708
2022-05-25,중앙선,원덕,434,420,854
2022-05-25,중앙선,중랑,6242,5807,12049
2022-05-25,중앙선,지평,80,98,178
2022-05-25,중앙선,팔당,990,988,1978
2022-05-25,중앙선,회기,28827,28053,56880
2022-05-26,1호선,동대문,11920,11150,23070
2022-05-26,1호선,동묘앞,8963,9317,18280
2022-05-26,1호선,서울역,50053,48046,98099
2022-05-26,1호선,시청,25925,26529,52454
2022-05-26,1호선,신설동,15108,14738,29846
2022-05-26,1호선,제기동,18660,18610,37270
2022-05-26,1호선,종각,39347,38453,77800
2022-05-26,1호선,종로3가,28206,25240,53446
2022-05-26,1호선,종로5가,25284,25128,50412
2022-05-26,1호선,청량리,21604,21629,43233
2022-05-26,2호선,강남,88506,89312,177818
2022-05-26,2호선,강변,33843,31125,64968
2022-05-26,2호선,건대입구,39676,42635,82311
2022-05-26,2호선,교대,38050,43631,81681
2022-05-26,2호선,구로디지털단지,63590,63592,127182
2022-05-26,2호선,구의,25497,24706,50203
2022-05-26,2호선,낙성대,29844,28388,58232
2022-05-26,2호선,당산,20971,24373,45344
2022-05-26,2호선,대림,25544,25936,51480
2022-05-26,2호선,도림천,1457,1502,2959
2022-05-26,2호선,동대문역사문화공원,13133,14760,27893
2022-05-26,2호선,뚝섬,24058,26105,50163
2022-05-26,2호선,문래,24406,24985,49391
2022-05-26,2호선,방배,21290,22071,43361
2022-05-26,2호선,봉천,25551,23361,48912
2022-05-26,2호선,사당,41839,46457,88296
2022-05-26,2호선,삼성,57796,59671,117467
2022-05-26,2호선,상왕십리,15971,15245,31216
2022-05-26,2호선,서울대입구,51616,50089,101705
2022-05-26,2호선,서초,23695,22942,46637
2022-05-26,2호선,선릉,62900,56441,119341
2022-05-26,2호선,성수,40025,44437,84462
2022-05-26,2호선,시청,26331,26032,52363
2022-05-26,2호선,신답,1904,2004,3908
2022-05-26,2호선,신당,15346,15767,31113
2022-05-26,2호선,신대방,28783,27526,56309
2022-05-26,2호선,신도림,52292,52994,105286
2022-05-26,2호선,신림,67577,65272,132849
2022-05-26,2호선,신설동,3499,3513,7012
2022-05-26,2호선,신정네거리,11270,11270,22540
2022-05-26,2호선,신촌,37137,37997,75134
2022-05-26,2호선,아현,11661,10965,22626
2022-05-26,2호선,양천구청,7634,7797,15431
2022-05-26,2호선,역삼,55995,64503,120498
2022-05-26,2호선,영등포구청,24214,25086,49300
2022-05-26,2호선,왕십리,20545,17163,37708
2022-05-26,2호선,용답,3256,3293,6549
2022-05-26,2호선,용두,2548,2583,5131
2022-05-26,2호선,을지로3가,25169,25529,50698
2022-05-26,2호선,을지로4가,14088,14154,28242
2022-05-26,2호선,을지로입구,43118,45389,88507
2022-05-26,2호선,이대,16012,16906,32918
2022-05-26,2호선,잠실,72430,72623,145053
2022-05-26,2호선,잠실나루,16260,16028,32288
2022-05-26,2호선,잠실새내,23059,22815,45874
2022-05-26,2호선,종합운동장,10893,12115,23008
2022-05-26,2호선,충정로,10936,11654,22590
2022-05-26,2호선,한양대,30766,38609,69375
2022-05-26,2호선,합정,32707,35073,67780
2022-05-26,2호선,홍대입구,57768,62125,119893
2022-05-26,3호선,가락시장,9949,9851,19800
2022-05-26,3호선,경복궁,30176,31967,62143
2022-05-26,3호선,경찰병원,7816,7856,15672
2022-05-26,3호선,고속터미널,43961,41317,85278
2022-05-26,3호선,교대,17155,11081,28236
2022-05-26,3호선,구파발,22583,21635,44218
2022-05-26,3호선,금호,8560,7814,16374
2022-05-26,3호선,남부터미널,31661,31767,63428
2022-05-26,3호선,녹번,17325,15296,32621
2022-05-26,3호선,대청,11467,10506,21973
2022-05-26,3호선,대치,11888,12100,23988
2022-05-26,3호선,도곡,6038,6175,12213
2022-05-26,3호선,독립문,7763,8150,15913
2022-05-26,3호선,동대입구,9787,10823,20610
2022-05-26,3호선,매봉,13762,13549,27311
2022-05-26,3호선,무악재,4295,4343,8638
2022-05-26,3호선,불광,17912,19251,37163
2022-05-26,3호선,수서,18359,18797,37156
2022-05-26,3호선,신사,32163,33942,66105
2022-05-26,3호선,안국,25571,26319,51890
2022-05-26,3호선,압구정,33118,35854,68972
2022-05-26,3호선,약수,14264,13835,28099
2022-05-26,3호선,양재,43099,47617,90716
2022-05-26,3호선,연신내,39038,36474,75512
2022-05-26,3호선,오금,6954,6220,13174
2022-05-26,3호선,옥수,9907,10073,19980
2022-05-26,3호선,을지로3가,11599,11938,23537
2022-05-26,3호선,일원,12163,11549,23712
2022-05-26,3호선,잠원,5524,5296,10820
2022-05-26,3호선,종로3가,10615,12453,23068
2022-05-26,3호선,지축,5711,5224,10935
2022-05-26,3호선,학여울,2591,2706,5297
2022-05-26,3호선,홍제,19656,18474,38130
2022-05-26,4호선,길음,24502,24088,48590
2022-05-26,4호선,남태령,1509,1272,2781
2022-05-26,4호선,노원,20457,23237,43694
2022-05-26,4호선,당고개,10029,8855,18884
2022-05-26,4호선,동대문,21496,22210,43706
2022-05-26,4호선,동대문역사문화공원,15446,14305,29751
2022-05-26,4호선,동작,1853,2073,3926
2022-05-26,4호선,명동,22243,23283,45526
2022-05-26,4호선,미아,16425,15711,32136
2022-05-26,4호선,미아사거리,29471,28268,57739
2022-05-26,4호선,사당,28597,24311,52908
2022-05-26,4호선,삼각지,6034,7021,13055
2022-05-26,4호선,상계,21498,19652,41150
2022-05-26,4호선,서울역,12811,19295,32106
2022-05-26,4호선,성신여대입구,22634,21423,44057
2022-05-26,4호선,수유,36445,36038,72483
2022-05-26,4호선,숙대입구,15559,15160,30719
2022-05-26,4호선,신용산,18493,19576,38069
2022-05-26,4호선,쌍문,31662,29025,60687
2022-05-26,4호선,이촌,9434,10496,19930
2022-05-26,4호선,창동,27996,29524,57520
2022-05-26,4호선,총신대입구,20895,22752,43647
2022-05-26,4호선,충무로,31404,32584,63988
2022-05-26,4호선,한성대입구,16221,15686,31907
2022-05-26,4호선,혜화,36713,37291,74004
2022-05-26,4호선,회현,27707,29518,57225
2022-05-26,5호선,강동,20139,19195,39334
2022-05-26,5호선,강일,4938,4585,9523
2022-05-26,5호선,개롱,7312,7448,14760
2022-05-26,5호선,개화산,6204,5800,12004
2022-05-26,5호선,거여,11614,11005,22619
2022-05-26,5호선,고덕,10590,10382,20972
2022-05-26,5호선,공덕,15651,16774,32425
2022-05-26,5호선,광나루,15746,14294,30040
2022-05-26,5호선,광화문,34766,37217,71983
2022-05-26,5호선,군자,12404,13352,25756
2022-05-26,5호선,굽은다리,10230,9705,19935
2022-05-26,5호선,길동,8487,8786,17273
2022-05-26,5호선,김포공항,7700,7760,15460
2022-05-26,5호선,까치산,31384,29254,60638
2022-05-26,5호선,답십리,17337,15546,32883
2022-05-26,5호선,동대문역사문화공원,3013,3600,6613
2022-05-26,5호선,둔촌동,8919,8896,17815
2022-05-26,5호선,마곡,11516,11481,22997
2022-05-26,5호선,마장,6205,5975,12180
2022-05-26,5호선,마천,8181,7565,15746
2022-05-26,5호선,마포,15825,16176,32001
2022-05-26,5호선,명일,9494,9628,19122
2022-05-26,5호선,목동,18735,19707,38442
2022-05-26,5호선,미사,17754,17788,35542
2022-05-26,5호선,발산,22543,23353,45896
2022-05-26,5호선,방이,7734,7978,15712
2022-05-26,5호선,방화,7433,7062,14495
2022-05-26,5호선,상일동,16532,15069,31601
2022-05-26,5호선,서대문,22246,22764,45010
2022-05-26,5호선,송정,7166,6611,13777
2022-05-26,5호선,신금호,7190,7187,14377
2022-05-26,5호선,신길,4602,4790,9392
2022-05-26,5호선,신정,15275,12140,27415
2022-05-26,5호선,아차산,16357,15641,31998
2022-05-26,5호선,애오개,7451,7336,14787
2022-05-26,5호선,양평,8074,7929,16003
2022-05-26,5호선,여의나루,12916,14394,27310
2022-05-26,5호선,여의도,30428,33503,63931
2022-05-26,5호선,영등포구청,4421,4641,9062
2022-05-26,5호선,영등포시장,11043,11141,22184
2022-05-26,5호선,오금,4165,4260,8425
2022-05-26,5호선,오목교,23473,25041,48514
2022-05-26,5호선,올림픽공원,5055,4601,9656
2022-05-26,5호선,왕십리,4960,5797,10757
2022-05-26,5호선,우장산,16230,15786,32016
2022-05-26,5호선,을지로4가,6807,7006,13813
2022-05-26,5호선,장한평,20023,19578,39601
2022-05-26,5호선,종로3가,14191,13981,28172
2022-05-26,5호선,천호,19483,19708,39191
2022-05-26,5호선,청구,4445,3913,8358
2022-05-26,5호선,충정로,5101,5332,10433
2022-05-26,5호선,하남검단산,6337,5974,12311
2022-05-26,5호선,하남시청,7747,7336,15083
2022-05-26,5호선,하남풍산,4614,4553,9167
2022-05-26,5호선,행당,9062,7864,16926
2022-05-26,5호선,화곡,31108,28604,59712
2022-05-26,6호선,고려대,14191,12611,26802
2022-05-26,6호선,공덕,20582,20137,40719
2022-05-26,6호선,광흥창,10207,9898,20105
2022-05-26,6호선,구산,8406,5852,14258
2022-05-26,6호선,녹사평,5310,5306,10616
2022-05-26,6호선,대흥,9828,10073,19901
2022-05-26,6호선,독바위,2926,3047,5973
2022-05-26,6호선,돌곶이,10488,9413,19901
2022-05-26,6호선,동묘앞,8606,8925,17531
2022-05-26,6호선,디지털미디어시티,15779,17279,33058
2022-05-26,6호선,마포구청,15487,13604,29091
2022-05-26,6호선,망원,14477,15409,29886
2022-05-26,6호선,버티고개,2539,2338,4877
2022-05-26,6호선,보문,8312,7372,15684
2022-05-26,6호선,봉화산,9922,9182,19104
2022-05-26,6호선,불광,4617,4566,9183
2022-05-26,6호선,삼각지,8874,7520,16394
2022-05-26,6호선,상수,9670,10995,20665
2022-05-26,6호선,상월곡,7732,7195,14927
2022-05-26,6호선,새절,14478,13333,27811
2022-05-26,6호선,석계,13941,14596,28537
2022-05-26,6호선,신내,1,0,1
2022-05-26,6호선,신당,9018,9470,18488
2022-05-26,6호선,안암,22768,29758,52526
2022-05-26,6호선,약수,3957,4007,7964
2022-05-26,6호선,역촌,3969,4626,8595
2022-05-26,6호선,월곡,13637,13051,26688
2022-05-26,6호선,월드컵경기장,5198,5531,10729
2022-05-26,6호선,응암,19037,18423,37460
2022-05-26,6호선,이태원,11235,12413,23648
2022-05-26,6호선,증산,11031,10817,21848
2022-05-26,6호선,창신,4071,3399,7470
2022-05-26,6호선,청구,3844,4184,8028
2022-05-26,6호선,태릉입구,6892,8015,14907
2022-05-26,6호선,한강진,8795,10317,19112
2022-05-26,6호선,합정,14126,14117,28243
2022-05-26,6호선,화랑대,14369,10881,25250
2022-05-26,6호선,효창공원앞,8131,7399,15530
2022-05-26,7호선,가산디지털단지,47544,48424,95968
2022-05-26,7호선,강남구청,17253,19361,36614
2022-05-26,7호선,건대입구,13747,14610,28357
2022-05-26,7호선,고속터미널,16682,14156,30838
2022-05-26,7호선,공릉,13758,13444,27202
2022-05-26,7호선,광명사거리,23276,22739,46015
2022-05-26,7호선,군자,15911,12614,28525
2022-05-26,7호선,남구로,16461,17824,34285
2022-05-26,7호선,남성,12306,11311,23617
2022-05-26,7호선,내방,15897,16373,32270
2022-05-26,7호선,노원,20451,21953,42404
2022-05-26,7호선,논현,21976,24175,46151
2022-05-26,7호선,대림,8088,8086,16174
2022-05-26,7호선,도봉산,10403,11944,22347
2022-05-26,7호선,뚝섬유원지,10016,9677,19693
2022-05-26,7호선,마들,14159,13190,27349
2022-05-26,7호선,먹골,11015,10485,21500
2022-05-26,7호선,면목,17553,16960,34513
2022-05-26,7호선,반포,6380,6182,12562
2022-05-26,7호선,보라매,11335,11392,22727
2022-05-26,7호선,사가정,17586,17287,34873
2022-05-26,7호선,상도,12836,12380,25216
2022-05-26,7호선,상봉,17996,17016,35012
2022-05-26,7호선,수락산,14079,13389,27468
2022-05-26,7호선,숭실대입구,16261,16201,32462
2022-05-26,7호선,신대방삼거리,18161,17179,35340
2022-05-26,7호선,신풍,12669,11968,24637
2022-05-26,7호선,어린이대공원,17797,18189,35986
2022-05-26,7호선,온수,11952,11405,23357
2022-05-26,7호선,용마산,6471,6226,12697
2022-05-26,7호선,이수,17174,16446,33620
2022-05-26,7호선,장승배기,9673,9383,19056
2022-05-26,7호선,장암,2529,992,3521
2022-05-26,7호선,중계,16312,14718,31030
2022-05-26,7호선,중곡,12008,11008,23016
2022-05-26,7호선,중화,11781,11370,23151
2022-05-26,7호선,천왕,12555,11799,24354
2022-05-26,7호선,철산,22703,22946,45649
2022-05-26,7호선,청담,21136,23934,45070
2022-05-26,7호선,태릉입구,10821,10466,21287
2022-05-26,7호선,하계,19597,18268,37865
2022-05-26,7호선,학동,25954,28147,54101
2022-05-26,8호선,가락시장,8259,9263,17522
2022-05-26,8호선,강동구청,11275,11587,22862
2022-05-26,8호선,남위례,5877,6013,11890
2022-05-26,8호선,남한산성입구,16888,15460,32348
2022-05-26,8호선,단대오거리,12267,11397,23664
2022-05-26,8호선,모란,4854,3816,8670
2022-05-26,8호선,몽촌토성,6942,7029,13971
2022-05-26,8호선,문정,23589,25028,48617
2022-05-26,8호선,복정,11032,9172,20204
2022-05-26,8호선,산성,5896,5969,11865
2022-05-26,8호선,석촌,8268,9497,17765
2022-05-26,8호선,송파,9196,8816,18012
2022-05-26,8호선,수진,5760,5309,11069
2022-05-26,8호선,신흥,4396,4850,9246
2022-05-26,8호선,암사,20802,17897,38699
2022-05-26,8호선,잠실,14452,17125,31577
2022-05-26,8호선,장지,18862,17478,36340
2022-05-26,8호선,천호,15726,18225,33951
2022-05-26,9호선,가양,23052,22185,45237
2022-05-26,9호선,개화,2922,2007,4929
2022-05-26,9호선,고속터미널,14020,17044,31064
2022-05-26,9호선,공항시장,3110,3376,6486
2022-05-26,9호선,구반포,1335,1366,2701
2022-05-26,9호선,국회의사당,17166,18092,35258
2022-05-26,9호선,김포공항,7965,11933,19898
2022-05-26,9호선,노들,4901,4014,8915
2022-05-26,9호선,노량진,28817,27448,56265
2022-05-26,9호선,당산,20029,20220,40249
2022-05-26,9호선,동작,2220,1887,4107
2022-05-26,9호선,등촌,12284,11572,23856
2022-05-26,9호선,마곡나루,13795,13746,27541
2022-05-26,9호선,사평,3994,3735,7729
2022-05-26,9호선,샛강,6756,7114,13870
2022-05-26,9호선,선유도,9526,9157,18683
2022-05-26,9호선,신논현,34074,33888,67962
2022-05-26,9호선,신목동,4810,4127,8937
2022-05-26,9호선,신반포,3960,3878,7838
2022-05-26,9호선,신방화,7438,7162,14600
2022-05-26,9호선,양천향교,10652,10933,21585
2022-05-26,9호선,여의도,30070,29970,60040
2022-05-26,9호선,염창,19078,18229,37307
2022-05-26,9호선,증미,8016,7714,15730
2022-05-26,9호선,흑석,10223,10267,20490
2022-05-26,9호선2~3단계,둔촌오륜,1258,1115,2373
2022-05-26,9호선2~3단계,봉은사,18697,19313,38010
2022-05-26,9호선2~3단계,삼성중앙,7767,8198,15965
2022-05-26,9호선2~3단계,삼전,7314,6941,14255
2022-05-26,9호선2~3단계,석촌,9254,8188,17442
2022-05-26,9호선2~3단계,석촌고분,6461,6309,12770
2022-05-26,9호선2~3단계,선정릉,10733,11938,22671
2022-05-26,9호선2~3단계,송파나루,5305,5589,10894
2022-05-26,9호선2~3단계,언주,11022,11718,22740
2022-05-26,9호선2~3단계,올림픽공원,7831,7555,15386
2022-05-26,9호선2~3단계,종합운동장,4541,4614,9155
2022-05-26,9호선2~3단계,중앙보훈병원,12002,10484,22486
2022-05-26,9호선2~3단계,한성백제,2811,2569,5380
2022-05-26,경강선,경기광주,8670,7933,16603
2022-05-26,경강선,곤지암,2460,2457,4917
2022-05-26,경강선,부발,2295,2182,4477
2022-05-26,경강선,삼동,2621,2377,4998
2022-05-26,경강선,세종대왕릉,329,332,661
2022-05-26,경강선,신둔도예촌,1814,1612,3426
2022-05-26,경강선,여주,2914,2714,5628
2022-05-26,경강선,이매,1214,971,2185
2022-05-26,경강선,이천,2626,2783,5409
2022-05-26,경강선,초월,3504,3259,6763
2022-05-26,경강선,판교,5316,5441,10757
2022-05-26,경부선,가산디지털단지,19940,22934,42874
2022-05-26,경부선,관악,8288,7622,15910
2022-05-26,경부선,광명,3631,3205,6836
2022-05-26,경부선,구로,19847,20848,40695
2022-05-26,경부선,군포,8191,8068,16259
2022-05-26,경부선,금정,29720,29996,59716
2022-05-26,경부선,금천구청,13063,12945,26008
2022-05-26,경부선,남영,10533,11324,21857
2022-05-26,경부선,노량진,9028,9231,18259
2022-05-26,경부선,당정,8033,7563,15596
2022-05-26,경부선,대방,14625,15029,29654
2022-05-26,경부선,독산,20258,21006,41264
2022-05-26,경부선,두정,8755,8819,17574
2022-05-26,경부선,명학,11237,11226,22463
2022-05-26,경부선,병점,17852,17889,35741
2022-05-26,경부선,서동탄,1572,1467,3039
2022-05-26,경부선,서울역,7350,2228,9578
2022-05-26,경부선,서정리,8086,7564,15650
2022-05-26,경부선,석수,10740,9599,20339
2022-05-26,경부선,성균관대,16786,16493,33279
2022-05-26,경부선,성환,7710,6998,14708
2022-05-26,경부선,세류,3384,3119,6503
2022-05-26,경부선,세마,3186,3044,6230
2022-05-26,경부선,송탄,4837,4578,9415
2022-05-26,경부선,수원,40059,42537,82596
2022-05-26,경부선,신길,10137,8816,18953
2022-05-26,경부선,신도림,4668,4822,9490
2022-05-26,경부선,안양,29001,28559,57560
2022-05-26,경부선,영등포,39872,41227,81099
2022-05-26,경부선,오산,11020,11012,22032
2022-05-26,경부선,오산대,4891,4436,9327
2022-05-26,경부선,용산,37412,37381,74793
2022-05-26,경부선,의왕,10471,10322,20793
2022-05-26,경부선,직산,899,914,1813
2022-05-26,경부선,진위,1897,1697,3594
2022-05-26,경부선,천안,7718,6897,14615
2022-05-26,경부선,평택,14424,14297,28721
2022-05-26,경부선,평택지제,4045,3971,8016
2022-05-26,경부선,화서,9324,8898,18222
2022-05-26,경원선,가능,7678,7364,15042
2022-05-26,경원선,광운대,9944,9771,19715
2022-05-26,경원선,녹양,5175,4918,10093
2022-05-26,경원선,녹천,5232,4328,9560
2022-05-26,경원선,덕계,3850,3372,7222
2022-05-26,경원선,덕정,7165,6829,13994
2022-05-26,경원선,도봉,6608,6312,12920
2022-05-26,경원선,도봉산,8620,5964,14584
2022-05-26,경원선,동두천,2994,3194,6188
2022-05-26,경원선,동두천중앙,3451,3355,6806
2022-05-26,경원선,망월사,12051,12518,24569
2022-05-26,경원선,방학,10884,10616,21500
2022-05-26,경원선,보산,1965,1609,3574
2022-05-26,경원선,서빙고,2208,1997,4205
2022-05-26,경원선,석계,9118,10043,19161
2022-05-26,경원선,소요산,2781,2448,5229
2022-05-26,경원선,신이문,9146,8198,17344
2022-05-26,경원선,양주,8733,8140,16873
2022-05-26,경원선,옥수,67,43,110
2022-05-26,경원선,왕십리,18080,18803,36883
2022-05-26,경원선,외대앞,9819,9937,19756
2022-05-26,경원선,월계,8977,8140,17117
2022-05-26,경원선,응봉,2193,1807,4000
2022-05-26,경원선,의정부,20012,20703,40715
2022-05-26,경원선,이촌,4318,3201,7519
2022-05-26,경원선,지행,7495,7513,15008
2022-05-26,경원선,창동,1,0,1
2022-05-26,경원선,청량리,16814,17034,33848
2022-05-26,경원선,한남,4540,4400,8940
2022-05-26,경원선,회룡,14163,13918,28081
2022-05-26,경의선,가좌,6264,5929,12193
2022-05-26,경의선,강매,3740,3276,7016
2022-05-26,경의선,곡산,724,751,1475
2022-05-26,경의선,공덕,3892,3602,7494
2022-05-26,경의선,금릉,5565,5417,10982
2022-05-26,경의선,금촌,7561,7570,15131
2022-05-26,경의선,능곡,4319,3983,8302
2022-05-26,경의선,디지털미디어시티,3027,2836,5863
2022-05-26,경의선,문산,5605,5610,11215
2022-05-26,경의선,백마,7908,7619,15527
2022-05-26,경의선,서강대,2359,2338,4697
2022-05-26,경의선,서울역,5107,6622,11729
2022-05-26,경의선,수색,3192,3437,6629
2022-05-26,경의선,신촌,933,1367,2300
2022-05-26,경의선,야당,8741,8729,17470
2022-05-26,경의선,운정,8050,7363,15413
2022-05-26,경의선,월롱,3547,2941,6488
2022-05-26,경의선,일산,10847,10547,21394
2022-05-26,경의선,임진강,15,7,22
2022-05-26,경의선,탄현,8742,8220,16962
2022-05-26,경의선,파주,1690,1276,2966
2022-05-26,경의선,풍산,6348,5880,12228
2022-05-26,경의선,행신,8955,9040,17995
2022-05-26,경의선,홍대입구,1911,2234,4145
2022-05-26,경의선,화전,3869,4067,7936
2022-05-26,경의선,효창공원앞,3588,3783,7371
2022-05-26,경인선,간석,6642,6237,12879
2022-05-26,경인선,개봉,23647,22743,46390
2022-05-26,경인선,구일,8084,7882,15966
2022-05-26,경인선,도원,3765,3838,7603
2022-05-26,경인선,도화,4687,4261,8948
2022-05-26,경인선,동암,16387,16468,32855
2022-05-26,경인선,동인천,15671,14614,30285
2022-05-26,경인선,백운,7831,7609,15440
2022-05-26,경인선,부개,9830,9000,18830
2022-05-26,경인선,부천,35703,35791,71494
2022-05-26,경인선,부평,31007,33346,64353
2022-05-26,경인선,소사,9660,9559,19219
2022-05-26,경인선,송내,30612,30498,61110
2022-05-26,경인선,역곡,31886,31052,62938
2022-05-26,경인선,오류동,13115,11958,25073
2022-05-26,경인선,온수,8132,7548,15680
2022-05-26,경인선,인천,4161,3298,7459
2022-05-26,경인선,제물포,12389,11842,24231
2022-05-26,경인선,주안,22118,19760,41878
2022-05-26,경인선,중동,10607,9820,20427
2022-05-26,경춘선,가평,1759,1817,3576
2022-05-26,경춘선,갈매,3318,2880,6198
2022-05-26,경춘선,강촌,535,555,1090
2022-05-26,경춘선,굴봉산,179,159,338
2022-05-26,경춘선,금곡,1772,1703,3475
2022-05-26,경춘선,김유정,352,386,738
2022-05-26,경춘선,남춘천,3255,2907,6162
2022-05-26,경춘선,대성리,547,658,1205
2022-05-26,경춘선,마석,4477,4218,8695
2022-05-26,경춘선,백양리,86,113,199
2022-05-26,경춘선,별내,3563,3410,6973
2022-05-26,경춘선,사릉,2735,2710,5445
2022-05-26,경춘선,상천,276,280,556
2022-05-26,경춘선,신내,2605,2457,5062
2022-05-26,경춘선,천마산,1946,1836,3782
2022-05-26,경춘선,청평,1773,1818,3591
2022-05-26,경춘선,춘천,2040,1522,3562
2022-05-26,경춘선,퇴계원,4005,3614,7619
2022-05-26,경춘선,평내호평,7111,6905,14016
2022-05-26,공항철도,검암,7505,7446,14951
2022-05-26,공항철도,계양,12218,11284,23502
2022-05-26,공항철도,공덕,2556,3325,5881
2022-05-26,공항철도,공항화물청사,2441,2586,5027
2022-05-26,공항철도,김포공항,12781,7211,19992
2022-05-26,공항철도,디지털미디어시티,15968,15022,30990
2022-05-26,공항철도,마곡나루,10796,10664,21460
2022-05-26,공항철도,서울역,9553,8637,18190
2022-05-26,공항철도,영종,3502,3581,7083
2022-05-26,공항철도,운서,7665,7860,15525
2022-05-26,공항철도,인천공항1터미널,6804,6025,12829
2022-05-26,공항철도,인천공항2터미널,3532,2898,6430
2022-05-26,공항철도,청라국제도시,7942,7587,15529
2022-05-26,공항철도,홍대입구,10523,10706,21229
2022-05-26,과천선,경마공원,1511,1454,2965
2022-05-26,과천선,과천,7088,6432,13520
2022-05-26,과천선,대공원,5367,5513,10880
2022-05-26,과천선,범계,28836,27824,56660
2022-05-26,과천선,선바위,9469,8249,17718
2022-05-26,과천선,인덕원,27210,27531,54741
2022-05-26,과천선,정부과천청사,11788,11792,23580
2022-05-26,과천선,평촌,19865,19397,39262
2022-05-26,분당선,가천대,13659,14367,28026
2022-05-26,분당선,강남구청,10964,12732,23696
2022-05-26,분당선,개포동,4432,4600,9032
2022-05-26,분당선,구룡,2655,2469,5124
2022-05-26,분당선,구성,5768,5980,11748
2022-05-26,분당선,기흥,11666,10871,22537
2022-05-26,분당선,대모산입구,5225,4816,10041
2022-05-26,분당선,도곡,7894,7668,15562
2022-05-26,분당선,망포,16223,15389,31612
2022-05-26,분당선,매교,3535,3629,7164
2022-05-26,분당선,매탄권선,5949,5701,11650
2022-05-26,분당선,모란,22130,22220,44350
2022-05-26,분당선,미금,17081,18227,35308
2022-05-26,분당선,보정,2946,2597,5543
2022-05-26,분당선,복정,1,0,1
2022-05-26,분당선,상갈,6272,6069,12341
2022-05-26,분당선,서울숲,12905,13249,26154
2022-05-26,분당선,서현,26054,26711,52765
2022-05-26,분당선,선릉,15099,22943,38042
2022-05-26,분당선,선정릉,8766,9457,18223
2022-05-26,분당선,수내,14724,14726,29450
2022-05-26,분당선,수서,14927,15403,30330
2022-05-26,분당선,수원,9209,7458,16667
2022-05-26,분당선,수원시청,13672,14782,28454
2022-05-26,분당선,신갈,5090,4937,10027
2022-05-26,분당선,압구정로데오,20049,22851,42900
2022-05-26,분당선,야탑,28924,30206,59130
2022-05-26,분당선,영통,10372,11049,21421
2022-05-26,분당선,오리,13093,10636,23729
2022-05-26,분당선,이매,6689,6416,13105
2022-05-26,분당선,정자,19585,20692,40277
2022-05-26,분당선,죽전,15950,17501,33451
2022-05-26,분당선,청명,4765,4786,9551
2022-05-26,분당선,태평,14403,13689,28092
2022-05-26,분당선,한티,16080,16995,33075
2022-05-26,수인선,고색,5578,5226,10804
2022-05-26,수인선,남동인더스파크,2398,2704,5102
2022-05-26,수인선,달월,120,76,196
2022-05-26,수인선,사리,5548,4835,10383
2022-05-26,수인선,소래포구,6984,6484,13468
2022-05-26,수인선,송도,2800,2599,5399
2022-05-26,수인선,숭의,4404,4158,8562
2022-05-26,수인선,신포,2077,2106,4183
2022-05-26,수인선,야목,503,349,852
2022-05-26,수인선,어천,825,895,1720
2022-05-26,수인선,연수,5041,5053,10094
2022-05-26,수인선,오목천,4519,4160,8679
2022-05-26,수인선,원인재,4891,5161,10052
2022-05-26,수인선,월곶,3317,3089,6406
2022-05-26,수인선,인천,1143,1881,3024
2022-05-26,수인선,인천논현,6169,6607,12776
2022-05-26,수인선,인하대,8324,7724,16048
2022-05-26,수인선,호구포,4518,4698,9216
2022-05-26,안산선,고잔,10092,9655,19747
2022-05-26,안산선,대야미,5637,5057,10694
2022-05-26,안산선,반월,4780,4612,9392
2022-05-26,안산선,산본,17592,18797,36389
2022-05-26,안산선,상록수,18126,18193,36319
2022-05-26,안산선,수리산,4661,3885,8546
2022-05-26,안산선,신길온천,2043,1833,3876
2022-05-26,안산선,안산,12178,11040,23218
2022-05-26,안산선,오이도,9483,9344,18827
2022-05-26,안산선,정왕,10893,11120,22013
2022-05-26,안산선,중앙,20373,20966,41339
2022-05-26,안산선,초지,5675,6062,11737
2022-05-26,안산선,한대앞,11505,11695,23200
2022-05-26,우이신설선,4.19민주묘지,3694,3476,7170
2022-05-26,우이신설선,가오리,4630,4523,9153
2022-05-26,우이신설선,보문,1666,1675,3341
2022-05-26,우이신설선,북한산보국문,6792,6274,13066
2022-05-26,우이신설선,북한산우이,3005,2748,5753
2022-05-26,우이신설선,삼양,2230,2238,4468
2022-05-26,우이신설선,삼양사거리,2671,2686,5357
2022-05-26,우이신설선,성신여대입구,3629,4057,7686
2022-05-26,우이신설선,솔밭공원,2840,2626,5466
2022-05-26,우이신설선,솔샘,6408,5898,12306
2022-05-26,우이신설선,신설동,2331,2290,4621
2022-05-26,우이신설선,정릉,5230,4697,9927
2022-05-26,우이신설선,화계,3841,3480,7321
2022-05-26,일산선,대곡,2448,1938,4386
2022-05-26,일산선,대화,14810,11523,26333
2022-05-26,일산선,마두,8360,8410,16770
2022-05-26,일산선,백석,10804,10708,21512
2022-05-26,일산선,삼송,21836,20815,42651
2022-05-26,일산선,원당,12467,11604,24071
2022-05-26,일산선,원흥,12457,11620,24077
2022-05-26,일산선,정발산,7561,7760,15321
2022-05-26,일산선,주엽,10171,10097,20268
2022-05-26,일산선,화정,18572,19017,37589
2022-05-26,장항선,배방,1312,1289,2601
2022-05-26,장항선,봉명,1417,1398,2815
2022-05-26,장항선,신창,3513,2866,6379
2022-05-26,장항선,쌍용,3311,2898,6209
2022-05-26,장항선,아산,4227,3868,8095
2022-05-26,장항선,온양온천,3992,4155,8147
2022-05-26,장항선,탕정,981,817,1798
2022-05-26,중앙선,구리,14707,14877,29584
2022-05-26,중앙선,국수,823,837,1660
2022-05-26,중앙선,덕소,6205,6248,12453
2022-05-26,중앙선,도농,12375,11021,23396
2022-05-26,중앙선,도심,2750,2133,4883
2022-05-26,중앙선,망우,8603,8359,16962
2022-05-26,중앙선,상봉,6279,6180,12459
2022-05-26,중앙선,신원,263,196,459
2022-05-26,중앙선,아신,555,577,1132
2022-05-26,중앙선,양수,2249,2257,4506
2022-05-26,중앙선,양원,3485,3255,6740
2022-05-26,중앙선,양정,800,682,1482
2022-05-26,중앙선,양평,3045,3031,6076
2022-05-26,중앙선,오빈,320,336,656
2022-05-26,중앙선,용문,2023,2046,4069
2022-05-26,중앙선,운길산,978,973,1951
2022-05-26,중앙선,원덕,396,399,795
2022-05-26,중앙선,중랑,6275,5775,12050
2022-05-26,중앙선,지평,72,110,182
2022-05-26,중앙선,팔당,930,978,1908
2022-05-26,중앙선,회기,28351,27404,55755
2022-05-27,1호선,동대문,12180,10821,23001
2022-05-27,1호선,동묘앞,8992,9482,18474
2022-05-27,1호선,서울역,57079,55250,112329
2022-05-27,1호선,시청,25949,26749,52698
2022-05-27,1호선,신설동,15431,15057,30488
2022-05-27,1호선,제기동,18277,18660,36937
2022-05-27,1호선,종각,39943,39535,79478
2022-05-27,1호선,종로3가,29898,27274,57172
2022-05-27,1호선,종로5가,25760,26091,51851
2022-05-27,1호선,청량리,22410,22420,44830
2022-05-27,2호선,강남,94765,97836,192601
2022-05-27,2호선,강변,38267,36097,74364
2022-05-27,2호선,건대입구,41693,46508,88201
2022-05-27,2호선,교대,38738,44664,83402
2022-05-27,2호선,구로디지털단지,64279,63294,127573
2022-05-27,2호선,구의,26369,25253,51622
2022-05-27,2호선,낙성대,31305,28610,59915
2022-05-27,2호선,당산,21171,24740,45911
2022-05-27,2호선,대림,25794,26299,52093
2022-05-27,2호선,도림천,1418,1483,2901
2022-05-27,2호선,동대문역사문화공원,14032,15056,29088
2022-05-27,2호선,뚝섬,24630,26584,51214
2022-05-27,2호선,문래,24509,25690,50199
2022-05-27,2호선,방배,20658,21041,41699
2022-05-27,2호선,봉천,26181,23305,49486
2022-05-27,2호선,사당,44941,51050,95991
2022-05-27,2호선,삼성,59668,60578,120246
2022-05-27,2호선,상왕십리,16030,14828,30858
2022-05-27,2호선,서울대입구,53398,51475,104873
2022-05-27,2호선,서초,23776,22632,46408
2022-05-27,2호선,선릉,61926,55187,117113
2022-05-27,2호선,성수,40731,45976,86707
2022-05-27,2호선,시청,26509,25810,52319
2022-05-27,2호선,신답,1893,2047,3940
2022-05-27,2호선,신당,15904,16339,32243
2022-05-27,2호선,신대방,29219,27763,56982
2022-05-27,2호선,신도림,53566,54928,108494
2022-05-27,2호선,신림,70257,66880,137137
2022-05-27,2호선,신설동,4117,3878,7995
2022-05-27,2호선,신정네거리,11424,11563,22987
2022-05-27,2호선,신촌,38459,39718,78177
2022-05-27,2호선,아현,12039,10960,22999
2022-05-27,2호선,양천구청,7689,7725,15414
2022-05-27,2호선,역삼,53845,62043,115888
2022-05-27,2호선,영등포구청,23948,24978,48926
2022-05-27,2호선,왕십리,20351,17370,37721
2022-05-27,2호선,용답,3242,3231,6473
2022-05-27,2호선,용두,2521,2522,5043
2022-05-27,2호선,을지로3가,25799,27083,52882
2022-05-27,2호선,을지로4가,14427,14574,29001
2022-05-27,2호선,을지로입구,43794,46021,89815
2022-05-27,2호선,이대,16544,16838,33382
2022-05-27,2호선,잠실,81962,81233,163195
2022-05-27,2호선,잠실나루,16946,16061,33007
2022-05-27,2호선,잠실새내,24896,25659,50555
2022-05-27,2호선,종합운동장,20157,22749,42906
2022-05-27,2호선,충정로,10696,11564,22260
2022-05-27,2호선,한양대,23336,30151,53487
2022-05-27,2호선,합정,35604,40060,75664
2022-05-27,2호선,홍대입구,62353,71942,134295
2022-05-27,3호선,가락시장,10275,10016,20291
2022-05-27,3호선,경복궁,31098,33081,64179
2022-05-27,3호선,경찰병원,8070,7822,15892
2022-05-27,3호선,고속터미널,53135,53586,106721
2022-05-27,3호선,교대,17250,11095,28345
2022-05-27,3호선,구파발,23144,22266,45410
2022-05-27,3호선,금호,8755,7839,16594
2022-05-27,3호선,남부터미널,34934,34936,69870
2022-05-27,3호선,녹번,17577,15168,32745
2022-05-27,3호선,대청,11608,10537,22145
2022-05-27,3호선,대치,12615,12496,25111
2022-05-27,3호선,도곡,6197,6473,12670
2022-05-27,3호선,독립문,8318,8524,16842
2022-05-27,3호선,동대입구,9284,10223,19507
2022-05-27,3호선,매봉,14142,13706,27848
2022-05-27,3호선,무악재,4431,4383,8814
2022-05-27,3호선,불광,18009,19389,37398
2022-05-27,3호선,수서,20533,20114,40647
2022-05-27,3호선,신사,35050,38577,73627
2022-05-27,3호선,안국,27077,27948,55025
2022-05-27,3호선,압구정,35813,39032,74845
2022-05-27,3호선,약수,14597,14175,28772
2022-05-27,3호선,양재,44637,47881,92518
2022-05-27,3호선,연신내,40294,38285,78579
2022-05-27,3호선,오금,6991,6213,13204
2022-05-27,3호선,옥수,10171,10201,20372
2022-05-27,3호선,을지로3가,12102,13034,25136
2022-05-27,3호선,일원,11790,10923,22713
2022-05-27,3호선,잠원,5842,5439,11281
2022-05-27,3호선,종로3가,11251,13738,24989
2022-05-27,3호선,지축,5753,5333,11086
2022-05-27,3호선,충무로,4,0,4
2022-05-27,3호선,학여울,2496,2446,4942
2022-05-27,3호선,홍제,19934,18520,38454
2022-05-27,4호선,길음,24765,23403,48168
2022-05-27,4호선,남태령,1615,1272,2887
2022-05-27,4호선,노원,21227,24527,45754
2022-05-27,4호선,당고개,9937,8750,18687
2022-05-27,4호선,동대문,21749,21783,43532
2022-05-27,4호선,동대문역사문화공원,16212,14205,30417
2022-05-27,4호선,동작,2063,2327,4390
2022-05-27,4호선,명동,23361,24654,48015
2022-05-27,4호선,미아,16589,15656,32245
2022-05-27,4호선,미아사거리,30545,29537,60082
2022-05-27,4호선,사당,30705,27025,57730
2022-05-27,4호선,삼각지,6538,7769,14307
2022-05-27,4호선,상계,21425,19569,40994
2022-05-27,4호선,서울역,13111,22601,35712
2022-05-27,4호선,성신여대입구,23677,22415,46092
2022-05-27,4호선,수유,37898,37541,75439
2022-05-27,4호선,숙대입구,15571,15354,30925
2022-05-27,4호선,신용산,19488,20423,39911
2022-05-27,4호선,쌍문,32326,28922,61248
2022-05-27,4호선,이촌,10310,11266,21576
2022-05-27,4호선,창동,29016,30376,59392
2022-05-27,4호선,총신대입구,21659,23487,45146
2022-05-27,4호선,충무로,29856,31948,61804
2022-05-27,4호선,한성대입구,16416,15744,32160
2022-05-27,4호선,혜화,37455,37973,75428
2022-05-27,4호선,회현,27835,29766,57601
2022-05-27,5호선,강동,20199,19090,39289
2022-05-27,5호선,강일,4913,4483,9396
2022-05-27,5호선,개롱,7338,7314,14652
2022-05-27,5호선,개화산,6266,5806,12072
2022-05-27,5호선,거여,11619,10918,22537
2022-05-27,5호선,고덕,11460,11184,22644
2022-05-27,5호선,공덕,15783,17017,32800
2022-05-27,5호선,광나루,16097,14253,30350
2022-05-27,5호선,광화문,34046,36344,70390
2022-05-27,5호선,군자,12710,14061,26771
2022-05-27,5호선,굽은다리,10590,10092,20682
2022-05-27,5호선,길동,9127,9494,18621
2022-05-27,5호선,김포공항,8616,8601,17217
2022-05-27,5호선,까치산,32045,29602,61647
2022-05-27,5호선,답십리,17763,15753,33516
2022-05-27,5호선,동대문역사문화공원,2963,3681,6644
2022-05-27,5호선,둔촌동,9345,9219,18564
2022-05-27,5호선,마곡,11312,11516,22828
2022-05-27,5호선,마장,6344,5920,12264
2022-05-27,5호선,마천,8207,7594,15801
2022-05-27,5호선,마포,15687,16317,32004
2022-05-27,5호선,명일,9882,10025,19907
2022-05-27,5호선,목동,19026,19799,38825
2022-05-27,5호선,미사,18943,18648,37591
2022-05-27,5호선,발산,22173,23454,45627
2022-05-27,5호선,방이,7913,8053,15966
2022-05-27,5호선,방화,7641,7049,14690
2022-05-27,5호선,상일동,16640,15095,31735
2022-05-27,5호선,서대문,21927,21885,43812
2022-05-27,5호선,송정,7404,6715,14119
2022-05-27,5호선,신금호,7434,7437,14871
2022-05-27,5호선,신길,4650,4643,9293
2022-05-27,5호선,신정,15338,11916,27254
2022-05-27,5호선,아차산,18462,17259,35721
2022-05-27,5호선,애오개,7523,7469,14992
2022-05-27,5호선,양평,8259,7816,16075
2022-05-27,5호선,여의나루,16029,17301,33330
2022-05-27,5호선,여의도,30234,33530,63764
2022-05-27,5호선,영등포구청,4374,4574,8948
2022-05-27,5호선,영등포시장,11421,11374,22795
2022-05-27,5호선,오금,4289,4375,8664
2022-05-27,5호선,오목교,24316,26017,50333
2022-05-27,5호선,올림픽공원,6740,6431,13171
2022-05-27,5호선,왕십리,4975,6217,11192
2022-05-27,5호선,우장산,16521,15694,32215
2022-05-27,5호선,을지로4가,6780,7084,13864
2022-05-27,5호선,장한평,20188,19635,39823
2022-05-27,5호선,종로3가,15574,15972,31546
2022-05-27,5호선,천호,20973,21205,42178
2022-05-27,5호선,청구,4431,3981,8412
2022-05-27,5호선,충정로,5038,5081,10119
2022-05-27,5호선,하남검단산,6518,6050,12568
2022-05-27,5호선,하남시청,8071,7622,15693
2022-05-27,5호선,하남풍산,4865,4774,9639
2022-05-27,5호선,행당,9047,7711,16758
2022-05-27,5호선,화곡,31811,28619,60430
2022-05-27,6호선,고려대,8873,9264,18137
2022-05-27,6호선,공덕,21404,20772,42176
2022-05-27,6호선,광흥창,10298,9748,20046
2022-05-27,6호선,구산,8618,5942,14560
2022-05-27,6호선,녹사평,5950,6350,12300
2022-05-27,6호선,대흥,9579,9503,19082
2022-05-27,6호선,독바위,2953,3019,5972
2022-05-27,6호선,돌곶이,10728,9622,20350
2022-05-27,6호선,동묘앞,9237,9101,18338
2022-05-27,6호선,디지털미디어시티,16076,16709,32785
2022-05-27,6호선,마포구청,15606,13429,29035
2022-05-27,6호선,망원,15460,16651,32111
2022-05-27,6호선,버티고개,2549,2344,4893
2022-05-27,6호선,보문,8405,7450,15855
2022-05-27,6호선,봉화산,9876,9252,19128
2022-05-27,6호선,불광,4741,4622,9363
2022-05-27,6호선,삼각지,8940,7593,16533
2022-05-27,6호선,상수,10107,12020,22127
2022-05-27,6호선,상월곡,6995,6285,13280
2022-05-27,6호선,새절,14104,12804,26908
2022-05-27,6호선,석계,14058,14410,28468
2022-05-27,6호선,신당,9289,8811,18100
2022-05-27,6호선,안암,16360,21447,37807
2022-05-27,6호선,약수,4120,4085,8205
2022-05-27,6호선,역촌,4064,4645,8709
2022-05-27,6호선,월곡,13161,12309,25470
2022-05-27,6호선,월드컵경기장,5246,5630,10876
2022-05-27,6호선,응암,19247,18507,37754
2022-05-27,6호선,이태원,13213,18302,31515
2022-05-27,6호선,증산,11052,10611,21663
2022-05-27,6호선,창신,3829,3139,6968
2022-05-27,6호선,청구,3999,4179,8178
2022-05-27,6호선,태릉입구,6992,7789,14781
2022-05-27,6호선,한강진,9364,11504,20868
2022-05-27,6호선,합정,15186,15561,30747
2022-05-27,6호선,화랑대,14621,10562,25183
2022-05-27,6호선,효창공원앞,8223,7338,15561
2022-05-27,7호선,가산디지털단지,47185,47215,94400
2022-05-27,7호선,강남구청,17386,19653,37039
2022-05-27,7호선,건대입구,14112,15296,29408
2022-05-27,7호선,고속터미널,20013,15972,35985
2022-05-27,7호선,공릉,14034,13491,27525
2022-05-27,7호선,광명사거리,24231,23665,47896
2022-05-27,7호선,군자,16447,12941,29388
2022-05-27,7호선,남구로,16502,17447,33949
2022-05-27,7호선,남성,12460,10925,23385
2022-05-27,7호선,내방,16253,16583,32836
2022-05-27,7호선,노원,21381,23648,45029
2022-05-27,7호선,논현,22283,25224,47507
2022-05-27,7호선,대림,8262,8553,16815
2022-05-27,7호선,도봉산,10449,11718,22167
2022-05-27,7호선,뚝섬유원지,12213,11783,23996
2022-05-27,7호선,마들,14561,13315,27876
2022-05-27,7호선,먹골,11180,10624,21804
2022-05-27,7호선,면목,17646,16814,34460
2022-05-27,7호선,반포,6714,6480,13194
2022-05-27,7호선,보라매,11586,11372,22958
2022-05-27,7호선,부천시청,1,0,1
2022-05-27,7호선,사가정,18012,17611,35623
2022-05-27,7호선,상도,12758,12315,25073
2022-05-27,7호선,상봉,18670,17676,36346
2022-05-27,7호선,수락산,14242,13697,27939
2022-05-27,7호선,숭실대입구,15709,15366,31075
2022-05-27,7호선,신대방삼거리,18461,16955,35416
2022-05-27,7호선,신풍,12696,12058,24754
2022-05-27,7호선,어린이대공원,18963,18689,37652
2022-05-27,7호선,온수,11959,11141,23100
2022-05-27,7호선,용마산,6661,6108,12769
2022-05-27,7호선,이수,18064,17623,35687
2022-05-27,7호선,장승배기,9836,9438,19274
2022-05-27,7호선,장암,2478,992,3470
2022-05-27,7호선,중계,16291,14193,30484
2022-05-27,7호선,중곡,12304,10984,23288
2022-05-27,7호선,중화,12098,11693,23791
2022-05-27,7호선,천왕,12652,11712,24364
2022-05-27,7호선,철산,23965,24402,48367
2022-05-27,7호선,청담,21104,24046,45150
2022-05-27,7호선,태릉입구,10956,10371,21327
2022-05-27,7호선,하계,19807,18137,37944
2022-05-27,7호선,학동,25400,27419,52819
2022-05-27,8호선,가락시장,8533,9688,18221
2022-05-27,8호선,강동구청,11447,11478,22925
2022-05-27,8호선,남위례,5964,6208,12172
2022-05-27,8호선,남한산성입구,16659,14727,31386
2022-05-27,8호선,단대오거리,12508,11654,24162
2022-05-27,8호선,모란,5012,4039,9051
2022-05-27,8호선,몽촌토성,8829,9196,18025
2022-05-27,8호선,문정,23089,24354,47443
2022-05-27,8호선,복정,11170,9300,20470
2022-05-27,8호선,산성,6034,5941,11975
2022-05-27,8호선,석촌,8571,9995,18566
2022-05-27,8호선,송파,9473,9083,18556
2022-05-27,8호선,수진,6092,5345,11437
2022-05-27,8호선,신흥,4748,4986,9734
2022-05-27,8호선,암사,21422,18351,39773
2022-05-27,8호선,잠실,15403,19215,34618
2022-05-27,8호선,장지,19070,17692,36762
2022-05-27,8호선,천호,16209,19592,35801
2022-05-27,9호선,가양,23473,22348,45821
2022-05-27,9호선,개화,2922,2023,4945
2022-05-27,9호선,고속터미널,16689,21852,38541
2022-05-27,9호선,공항시장,3308,3464,6772
2022-05-27,9호선,구반포,1576,1597,3173
2022-05-27,9호선,국회의사당,16349,17171,33520
2022-05-27,9호선,김포공항,9222,14526,23748
2022-05-27,9호선,노들,5214,4272,9486
2022-05-27,9호선,노량진,30319,29094,59413
2022-05-27,9호선,당산,20665,21043,41708
2022-05-27,9호선,동작,2499,2068,4567
2022-05-27,9호선,등촌,12617,11654,24271
2022-05-27,9호선,마곡나루,13869,13795,27664
2022-05-27,9호선,사평,4173,3871,8044
2022-05-27,9호선,샛강,7638,7643,15281
2022-05-27,9호선,선유도,9917,9066,18983
2022-05-27,9호선,신논현,37982,39832,77814
2022-05-27,9호선,신목동,4972,4126,9098
2022-05-27,9호선,신반포,4255,4200,8455
2022-05-27,9호선,신방화,7631,7146,14777
2022-05-27,9호선,양천향교,11065,10700,21765
2022-05-27,9호선,여의도,30855,29840,60695
2022-05-27,9호선,염창,19518,18385,37903
2022-05-27,9호선,증미,8154,7689,15843
2022-05-27,9호선,흑석,11276,11317,22593
2022-05-27,9호선2~3단계,둔촌오륜,1291,1113,2404
2022-05-27,9호선2~3단계,봉은사,20047,20738,40785
2022-05-27,9호선2~3단계,삼성중앙,7748,8157,15905
2022-05-27,9호선2~3단계,삼전,7726,7292,15018
2022-05-27,9호선2~3단계,석촌,9869,8675,18544
2022-05-27,9호선2~3단계,석촌고분,6843,6460,13303
2022-05-27,9호선2~3단계,선정릉,10940,11845,22785
2022-05-27,9호선2~3단계,송파나루,5545,5879,11424
2022-05-27,9호선2~3단계,언주,11247,11400,22647
2022-05-27,9호선2~3단계,올림픽공원,12968,12125,25093
2022-05-27,9호선2~3단계,종합운동장,4963,5489,10452
2022-05-27,9호선2~3단계,중앙보훈병원,12045,10464,22509
2022-05-27,9호선2~3단계,한성백제,3067,2872,5939
2022-05-27,경강선,경기광주,8914,8188,17102
2022-05-27,경강선,곤지암,2559,2448,5007
2022-05-27,경강선,부발,2997,2420,5417
2022-05-27,경강선,삼동,2758,2301,5059
2022-05-27,경강선,세종대왕릉,411,385,796
2022-05-27,경강선,신둔도예촌,1953,1701,3654
2022-05-27,경강선,여주,2752,2892,5644
2022-05-27,경강선,이매,1331,1051,2382
2022-05-27,경강선,이천,3155,3325,6480
2022-05-27,경강선,초월,3735,3386,7121
2022-05-27,경강선,판교,5506,5477,10983
2022-05-27,경부선,가산디지털단지,20061,22874,42935
2022-05-27,경부선,관악,8466,7743,16209
2022-05-27,경부선,광명,4521,4080,8601
2022-05-27,경부선,구로,20105,21608,41713
2022-05-27,경부선,군포,8478,8358,16836
2022-05-27,경부선,금정,30418,30506,60924
2022-05-27,경부선,금천구청,13159,13037,26196
2022-05-27,경부선,남영,10503,11068,21571
2022-05-27,경부선,노량진,10061,9903,19964
2022-05-27,경부선,당정,7913,7347,15260
2022-05-27,경부선,대방,14777,15155,29932
2022-05-27,경부선,독산,20193,20495,40688
2022-05-27,경부선,두정,8612,7779,16391
2022-05-27,경부선,명학,10448,10002,20450
2022-05-27,경부선,병점,17849,17543,35392
2022-05-27,경부선,서동탄,1632,1531,3163
2022-05-27,경부선,서울역,10435,3104,13539
2022-05-27,경부선,서정리,9880,8020,17900
2022-05-27,경부선,석수,10773,9464,20237
2022-05-27,경부선,성균관대,17493,16898,34391
2022-05-27,경부선,성환,5548,4642,10190
2022-05-27,경부선,세류,3647,3295,6942
2022-05-27,경부선,세마,3332,3151,6483
2022-05-27,경부선,송탄,6017,5127,11144
2022-05-27,경부선,수원,42991,46632,89623
2022-05-27,경부선,신길,10137,8691,18828
2022-05-27,경부선,신도림,4668,4824,9492
2022-05-27,경부선,안양,28627,28811,57438
2022-05-27,경부선,영등포,44400,47076,91476
2022-05-27,경부선,오산,11691,11385,23076
2022-05-27,경부선,오산대,4326,4056,8382
2022-05-27,경부선,용산,43809,45222,89031
2022-05-27,경부선,의왕,10458,10312,20770
2022-05-27,경부선,직산,1095,1001,2096
2022-05-27,경부선,진위,2141,1776,3917
2022-05-27,경부선,천안,7894,7523,15417
2022-05-27,경부선,평택,15658,15484,31142
2022-05-27,경부선,평택지제,4704,4461,9165
2022-05-27,경부선,화서,9359,8893,18252
2022-05-27,경원선,가능,7580,7155,14735
2022-05-27,경원선,광운대,9410,8931,18341
2022-05-27,경원선,녹양,5291,4981,10272
2022-05-27,경원선,녹천,5270,4202,9472
2022-05-27,경원선,덕계,3832,3342,7174
2022-05-27,경원선,덕정,6978,6565,13543
2022-05-27,경원선,도봉,6763,6429,13192
2022-05-27,경원선,도봉산,8904,5892,14796
2022-05-27,경원선,동두천,2785,3012,5797
2022-05-27,경원선,동두천중앙,3584,3499,7083
2022-05-27,경원선,망월사,9433,9223,18656
2022-05-27,경원선,방학,11048,10893,21941
2022-05-27,경원선,보산,2420,1884,4304
2022-05-27,경원선,서빙고,2397,2191,4588
2022-05-27,경원선,석계,9427,10288,19715
2022-05-27,경원선,소요산,3024,2620,5644
2022-05-27,경원선,신이문,9384,8530,17914
2022-05-27,경원선,양주,9382,8654,18036
2022-05-27,경원선,옥수,83,50,133
2022-05-27,경원선,왕십리,17973,19331,37304
2022-05-27,경원선,외대앞,11169,11305,22474
2022-05-27,경원선,월계,8811,7996,16807
2022-05-27,경원선,응봉,2378,1951,4329
2022-05-27,경원선,의정부,20936,22204,43140
2022-05-27,경원선,이촌,4653,3347,8000
2022-05-27,경원선,지행,8091,7925,16016
2022-05-27,경원선,창동,1,0,1
2022-05-27,경원선,청량리,19098,19552,38650
2022-05-27,경원선,한남,4683,4574,9257
2022-05-27,경원선,회룡,14146,14043,28189
2022-05-27,경의선,가좌,6308,6022,12330
2022-05-27,경의선,강매,3733,3162,6895
2022-05-27,경의선,곡산,689,744,1433
2022-05-27,경의선,공덕,4035,3736,7771
2022-05-27,경의선,금릉,5701,5467,11168
2022-05-27,경의선,금촌,7480,7253,14733
2022-05-27,경의선,능곡,4428,4031,8459
2022-05-27,경의선,디지털미디어시티,3043,2826,5869
2022-05-27,경의선,문산,6210,5824,12034
2022-05-27,경의선,백마,8048,7563,15611
2022-05-27,경의선,서강대,2552,2472,5024
2022-05-27,경의선,서울역,5171,6949,12120
2022-05-27,경의선,수색,3226,3338,6564
2022-05-27,경의선,신촌,990,1334,2324
2022-05-27,경의선,야당,9094,9239,18333
2022-05-27,경의선,운정,8020,7215,15235
2022-05-27,경의선,월롱,2896,2451,5347
2022-05-27,경의선,일산,10786,10493,21279
2022-05-27,경의선,임진강,17,25,42
2022-05-27,경의선,탄현,8962,8502,17464
2022-05-27,경의선,파주,1490,934,2424
2022-05-27,경의선,풍산,6461,5970,12431
2022-05-27,경의선,행신,9373,9446,18819
2022-05-27,경의선,홍대입구,2002,2650,4652
2022-05-27,경의선,화전,3059,2723,5782
2022-05-27,경의선,효창공원앞,3348,3683,7031
2022-05-27,경인선,간석,6944,6497,13441
2022-05-27,경인선,개봉,23801,22924,46725
2022-05-27,경인선,구일,8276,7751,16027
2022-05-27,경인선,도원,3902,3981,7883
2022-05-27,경인선,도화,4830,4431,9261
2022-05-27,경인선,동암,17055,17028,34083
2022-05-27,경인선,동인천,16262,15201,31463
2022-05-27,경인선,백운,7904,7638,15542
2022-05-27,경인선,부개,9881,9003,18884
2022-05-27,경인선,부천,36609,37702,74311
2022-05-27,경인선,부평,32520,36826,69346
2022-05-27,경인선,소사,9748,9212,18960
2022-05-27,경인선,송내,31225,30736,61961
2022-05-27,경인선,역곡,32360,31083,63443
2022-05-27,경인선,오류동,13356,11889,25245
2022-05-27,경인선,온수,8268,7616,15884
2022-05-27,경인선,인천,4719,3655,8374
2022-05-27,경인선,제물포,12570,11590,24160
2022-05-27,경인선,주안,22445,20232,42677
2022-05-27,경인선,중동,10612,9856,20468
2022-05-27,경춘선,가평,2148,2634,4782
2022-05-27,경춘선,갈매,3414,2925,6339
2022-05-27,경춘선,강촌,586,691,1277
2022-05-27,경춘선,굴봉산,182,167,349
2022-05-27,경춘선,금곡,1785,1785,3570
2022-05-27,경춘선,김유정,394,587,981
2022-05-27,경춘선,남춘천,4750,3881,8631
2022-05-27,경춘선,대성리,752,2855,3607
2022-05-27,경춘선,마석,4628,4526,9154
2022-05-27,경춘선,백양리,106,123,229
2022-05-27,경춘선,별내,3752,3421,7173
2022-05-27,경춘선,사릉,2796,2710,5506
2022-05-27,경춘선,상천,369,509,878
2022-05-27,경춘선,신내,2645,2402,5047
2022-05-27,경춘선,천마산,1930,1764,3694
2022-05-27,경춘선,청평,1941,2372,4313
2022-05-27,경춘선,춘천,2319,1680,3999
2022-05-27,경춘선,퇴계원,3963,3607,7570
2022-05-27,경춘선,평내호평,7216,7098,14314
2022-05-27,공항철도,검암,7845,7766,15611
2022-05-27,공항철도,계양,12281,11267,23548
2022-05-27,공항철도,공덕,2622,3641,6263
2022-05-27,공항철도,공항화물청사,2388,2533,4921
2022-05-27,공항철도,김포공항,15145,7304,22449
2022-05-27,공항철도,디지털미디어시티,15389,14181,29570
2022-05-27,공항철도,마곡나루,10291,10026,20317
2022-05-27,공항철도,서울역,11364,10697,22061
2022-05-27,공항철도,영종,3776,3978,7754
2022-05-27,공항철도,운서,8159,8106,16265
2022-05-27,공항철도,인천공항1터미널,6680,6523,13203
2022-05-27,공항철도,인천공항2터미널,3291,3040,6331
2022-05-27,공항철도,청라국제도시,8233,7810,16043
2022-05-27,공항철도,홍대입구,11941,12628,24569
2022-05-27,과천선,경마공원,8082,8139,16221
2022-05-27,과천선,과천,7457,6704,14161
2022-05-27,과천선,대공원,8868,8885,17753
2022-05-27,과천선,범계,30315,30799,61114
2022-05-27,과천선,선바위,9925,8473,18398
2022-05-27,과천선,인덕원,28460,28530,56990
2022-05-27,과천선,정부과천청사,12441,11905,24346
2022-05-27,과천선,평촌,19962,19390,39352
2022-05-27,분당선,가천대,12300,12389,24689
2022-05-27,분당선,강남구청,11478,13267,24745
2022-05-27,분당선,개포동,4509,4515,9024
2022-05-27,분당선,구룡,2800,2464,5264
2022-05-27,분당선,구성,5851,5929,11780
2022-05-27,분당선,기흥,11575,10850,22425
2022-05-27,분당선,대모산입구,5165,4603,9768
2022-05-27,분당선,도곡,8372,7823,16195
2022-05-27,분당선,망포,17316,15842,33158
2022-05-27,분당선,매교,3644,3541,7185
2022-05-27,분당선,매탄권선,6153,5683,11836
2022-05-27,분당선,모란,22513,22938,45451
2022-05-27,분당선,미금,17624,18568,36192
2022-05-27,분당선,보정,2853,2454,5307
2022-05-27,분당선,상갈,6223,5956,12179
2022-05-27,분당선,서울숲,14062,14634,28696
2022-05-27,분당선,서현,28270,28897,57167
2022-05-27,분당선,선릉,14604,22637,37241
2022-05-27,분당선,선정릉,8836,9383,18219
2022-05-27,분당선,수내,15050,15064,30114
2022-05-27,분당선,수서,16233,16925,33158
2022-05-27,분당선,수원,9808,8427,18235
2022-05-27,분당선,수원시청,14616,17169,31785
2022-05-27,분당선,신갈,5102,5011,10113
2022-05-27,분당선,압구정로데오,21949,26042,47991
2022-05-27,분당선,야탑,30609,31749,62358
2022-05-27,분당선,영통,10410,10118,20528
2022-05-27,분당선,오리,13062,10531,23593
2022-05-27,분당선,이매,6632,6275,12907
2022-05-27,분당선,정자,20003,21166,41169
2022-05-27,분당선,죽전,16485,17570,34055
2022-05-27,분당선,청명,5174,4733,9907
2022-05-27,분당선,태평,15208,14310,29518
2022-05-27,분당선,한티,16497,17369,33866
2022-05-27,수인선,고색,5650,5144,10794
2022-05-27,수인선,남동인더스파크,2362,2610,4972
2022-05-27,수인선,달월,134,89,223
2022-05-27,수인선,사리,5658,4882,10540
2022-05-27,수인선,소래포구,7350,6989,14339
2022-05-27,수인선,송도,2886,2673,5559
2022-05-27,수인선,숭의,4530,4151,8681
2022-05-27,수인선,신포,2231,2234,4465
2022-05-27,수인선,야목,517,356,873
2022-05-27,수인선,어천,942,938,1880
2022-05-27,수인선,연수,5385,5322,10707
2022-05-27,수인선,오목천,4438,3803,8241
2022-05-27,수인선,원인재,5133,5185,10318
2022-05-27,수인선,월곶,3265,2974,6239
2022-05-27,수인선,인천,1277,2041,3318
2022-05-27,수인선,인천논현,6367,6873,13240
2022-05-27,수인선,인하대,8029,7353,15382
2022-05-27,수인선,호구포,4626,4701,9327
2022-05-27,안산선,고잔,10188,9688,19876
2022-05-27,안산선,대야미,5945,5144,11089
2022-05-27,안산선,반월,5056,4772,9828
2022-05-27,안산선,산본,18430,19836,38266
2022-05-27,안산선,상록수,18712,18557,37269
2022-05-27,안산선,수리산,4707,3798,8505
2022-05-27,안산선,신길온천,2110,1918,4028
2022-05-27,안산선,안산,12813,11835,24648
2022-05-27,안산선,오이도,10046,10156,20202
2022-05-27,안산선,정왕,11902,11253,23155
2022-05-27,안산선,중앙,21352,23247,44599
2022-05-27,안산선,초지,5720,6017,11737
2022-05-27,안산선,한대앞,11686,12428,24114
2022-05-27,우이신설선,4.19민주묘지,4118,3886,8004
2022-05-27,우이신설선,가오리,4627,4416,9043
2022-05-27,우이신설선,보문,1735,1757,3492
2022-05-27,우이신설선,북한산보국문,7146,6162,13308
2022-05-27,우이신설선,북한산우이,3163,3052,6215
2022-05-27,우이신설선,삼양,2181,2266,4447
2022-05-27,우이신설선,삼양사거리,2814,2776,5590
2022-05-27,우이신설선,성신여대입구,3706,4172,7878
2022-05-27,우이신설선,솔밭공원,2783,2554,5337
2022-05-27,우이신설선,솔샘,6417,5667,12084
2022-05-27,우이신설선,신설동,2406,2343,4749
2022-05-27,우이신설선,정릉,5498,4703,10201
2022-05-27,우이신설선,화계,3889,3498,7387
2022-05-27,일산선,대곡,2497,1927,4424
2022-05-27,일산선,대화,14796,11463,26259
2022-05-27,일산선,마두,8422,8599,17021
2022-05-27,일산선,백석,11001,10964,21965
2022-05-27,일산선,삼송,22280,21147,43427
2022-05-27,일산선,원당,12817,11741,24558
2022-05-27,일산선,원흥,12706,11594,24300
2022-05-27,일산선,정발산,8344,9002,17346
2022-05-27,일산선,주엽,10522,10332,20854
2022-05-27,일산선,화정,19048,19321,38369
2022-05-27,장항선,배방,1519,1401,2920
2022-05-27,장항선,봉명,1381,1336,2717
2022-05-27,장항선,신창,3558,2209,5767
2022-05-27,장항선,쌍용,3159,2672,5831
2022-05-27,장항선,아산,4905,4816,9721
2022-05-27,장항선,온양온천,4415,4735,9150
2022-05-27,장항선,탕정,1106,904,2010
2022-05-27,중앙선,구리,15121,15586,30707
2022-05-27,중앙선,국수,884,880,1764
2022-05-27,중앙선,덕소,6383,6301,12684
2022-05-27,중앙선,도농,12444,11177,23621
2022-05-27,중앙선,도심,2828,2227,5055
2022-05-27,중앙선,망우,9043,8650,17693
2022-05-27,중앙선,상봉,6530,6369,12899
2022-05-27,중앙선,신원,283,238,521
2022-05-27,중앙선,아신,633,651,1284
2022-05-27,중앙선,양수,2331,2463,4794
2022-05-27,중앙선,양원,3452,3213,6665
2022-05-27,중앙선,양정,796,687,1483
2022-05-27,중앙선,양평,3249,3549,6798
2022-05-27,중앙선,오빈,320,353,673
2022-05-27,중앙선,용문,2059,2247,4306
2022-05-27,중앙선,운길산,976,913,1889
2022-05-27,중앙선,원덕,428,407,835
2022-05-27,중앙선,중랑,6446,5849,12295
2022-05-27,중앙선,지평,78,97,175
2022-05-27,중앙선,팔당,1018,1142,2160
2022-05-27,중앙선,회기,29363,27348,56711
2022-05-30,1호선,동대문,11246,10806,22052
2022-05-30,1호선,동묘앞,7746,7902,15648
2022-05-30,1호선,서울역,48112,46166,94278
2022-05-30,1호선,시청,21280,24142,45422
2022-05-30,1호선,신설동,14231,13815,28046
2022-05-30,1호선,제기동,17241,17582,34823
2022-05-30,1호선,종각,38213,37520,75733
2022-05-30,1호선,종로3가,25502,22892,48394
2022-05-30,1호선,종로5가,23335,23485,46820
2022-05-30,1호선,청량리,20091,20203,40294
2022-05-30,2호선,강남,81745,81075,162820
2022-05-30,2호선,강변,31649,30297,61946
2022-05-30,2호선,건대입구,34257,36545,70802
2022-05-30,2호선,교대,35423,40061,75484
2022-05-30,2호선,구로디지털단지,61793,62098,123891
2022-05-30,2호선,구의,24282,23952,48234
2022-05-30,2호선,낙성대,27767,27734,55501
2022-05-30,2호선,당산,19495,22838,42333
2022-05-30,2호선,대림,25328,25534,50862
2022-05-30,2호선,도림천,1371,1467,2838
2022-05-30,2호선,동대문역사문화공원,11837,13389,25226
2022-05-30,2호선,뚝섬,21896,23677,45573
2022-05-30,2호선,문래,23045,23634,46679
2022-05-30,2호선,방배,19859,20794,40653
2022-05-30,2호선,봉천,24888,22873,47761
2022-05-30,2호선,사당,38431,42400,80831
2022-05-30,2호선,삼성,50764,52402,103166
2022-05-30,2호선,상왕십리,14862,14372,29234
2022-05-30,2호선,서울대입구,48220,47765,95985
2022-05-30,2호선,서초,22115,21825,43940
2022-05-30,2호선,선릉,60747,54349,115096
2022-05-30,2호선,성수,37455,41216,78671
2022-05-30,2호선,시청,24355,24289,48644
2022-05-30,2호선,신답,1736,1940,3676
2022-05-30,2호선,신당,14095,14560,28655
2022-05-30,2호선,신대방,26887,26024,52911
2022-05-30,2호선,신도림,48635,48449,97084
2022-05-30,2호선,신림,61563,58270,119833
2022-05-30,2호선,신설동,3332,3318,6650
2022-05-30,2호선,신정네거리,11074,11277,22351
2022-05-30,2호선,신촌,33437,34429,67866
2022-05-30,2호선,아현,10776,10189,20965
2022-05-30,2호선,양천구청,7446,7543,14989
2022-05-30,2호선,역삼,55022,62500,117522
2022-05-30,2호선,영등포구청,23177,24059,47236
2022-05-30,2호선,왕십리,16811,13321,30132
2022-05-30,2호선,용답,3265,3312,6577
2022-05-30,2호선,용두,2385,2381,4766
2022-05-30,2호선,을지로3가,23497,23720,47217
2022-05-30,2호선,을지로4가,13444,13412,26856
2022-05-30,2호선,을지로입구,40759,42538,83297
2022-05-30,2호선,이대,14520,15562,30082
2022-05-30,2호선,잠실,66283,66612,132895
2022-05-30,2호선,잠실나루,15907,15605,31512
2022-05-30,2호선,잠실새내,21671,21395,43066
2022-05-30,2호선,종합운동장,7401,8352,15753
2022-05-30,2호선,충정로,10596,11331,21927
2022-05-30,2호선,한양대,14478,16513,30991
2022-05-30,2호선,합정,29993,31702,61695
2022-05-30,2호선,홍대입구,52407,55030,107437
2022-05-30,3호선,가락시장,9471,9239,18710
2022-05-30,3호선,경복궁,27384,29125,56509
2022-05-30,3호선,경찰병원,7836,7879,15715
2022-05-30,3호선,고속터미널,39870,38862,78732
2022-05-30,3호선,교대,15493,10382,25875
2022-05-30,3호선,구파발,22182,21189,43371
2022-05-30,3호선,금호,8286,7671,15957
2022-05-30,3호선,남부터미널,29776,30852,60628
2022-05-30,3호선,녹번,16735,14979,31714
2022-05-30,3호선,대청,11223,10293,21516
2022-05-30,3호선,대치,11647,12056,23703
2022-05-30,3호선,도곡,5878,5840,11718
2022-05-30,3호선,독립문,7302,7554,14856
2022-05-30,3호선,동대입구,9451,10395,19846
2022-05-30,3호선,매봉,13263,12774,26037
2022-05-30,3호선,무악재,4096,4304,8400
2022-05-30,3호선,불광,17101,17968,35069
2022-05-30,3호선,수서,17984,18876,36860
2022-05-30,3호선,신사,29046,30524,59570
2022-05-30,3호선,안국,23617,23801,47418
2022-05-30,3호선,압구정,32221,34601,66822
2022-05-30,3호선,약수,13829,13432,27261
2022-05-30,3호선,양재,39707,43686,83393
2022-05-30,3호선,연신내,37741,35478,73219
2022-05-30,3호선,오금,6675,5899,12574
2022-05-30,3호선,옥수,12604,9677,22281
2022-05-30,3호선,을지로3가,11135,11245,22380
2022-05-30,3호선,일원,11639,11194,22833
2022-05-30,3호선,잠원,5125,4950,10075
2022-05-30,3호선,종로3가,10242,11640,21882
2022-05-30,3호선,지축,5479,4999,10478
2022-05-30,3호선,학여울,1994,1992,3986
2022-05-30,3호선,홍제,19233,18377,37610
2022-05-30,4호선,길음,23045,23170,46215
2022-05-30,4호선,남태령,1315,1196,2511
2022-05-30,4호선,노원,19166,21566,40732
2022-05-30,4호선,당고개,9774,8539,18313
2022-05-30,4호선,동대문,20721,21031,41752
2022-05-30,4호선,동대문역사문화공원,14763,13273,28036
2022-05-30,4호선,동작,1590,1751,3341
2022-05-30,4호선,명동,21417,22018,43435
2022-05-30,4호선,미아,15927,15505,31432
2022-05-30,4호선,미아사거리,28082,27267,55349
2022-05-30,4호선,사당,26449,22342,48791
2022-05-30,4호선,삼각지,5406,5931,11337
2022-05-30,4호선,상계,20332,18537,38869
2022-05-30,4호선,서울역,12235,18053,30288
2022-05-30,4호선,성신여대입구,21448,20583,42031
2022-05-30,4호선,수유,35147,34854,70001
2022-05-30,4호선,숙대입구,14708,14422,29130
2022-05-30,4호선,신용산,17226,18564,35790
2022-05-30,4호선,쌍문,30548,27996,58544
2022-05-30,4호선,이촌,8725,9695,18420
2022-05-30,4호선,창동,26547,27860,54407
2022-05-30,4호선,총신대입구,19506,21215,40721
2022-05-30,4호선,충무로,29663,30743,60406
2022-05-30,4호선,한성대입구,14712,14432,29144
2022-05-30,4호선,혜화,31424,31765,63189
2022-05-30,4호선,회현,26252,28125,54377
2022-05-30,5호선,강동,19559,18704,38263
2022-05-30,5호선,강일,4704,4435,9139
2022-05-30,5호선,개롱,6898,7036,13934
2022-05-30,5호선,개화산,6009,5761,11770
2022-05-30,5호선,거여,11145,10686,21831
2022-05-30,5호선,고덕,10063,10056,20119
2022-05-30,5호선,공덕,15082,15908,30990
2022-05-30,5호선,광나루,14143,12878,27021
2022-05-30,5호선,광화문,31771,33778,65549
2022-05-30,5호선,군자,11500,12547,24047
2022-05-30,5호선,굽은다리,9791,9235,19026
2022-05-30,5호선,길동,8247,8556,16803
2022-05-30,5호선,김포공항,7385,7229,14614
2022-05-30,5호선,까치산,30241,28681,58922
2022-05-30,5호선,답십리,16449,15006,31455
2022-05-30,5호선,동대문역사문화공원,3023,3513,6536
2022-05-30,5호선,둔촌동,8493,8317,16810
2022-05-30,5호선,마곡,11327,11416,22743
2022-05-30,5호선,마장,6024,5640,11664
2022-05-30,5호선,마천,7802,7380,15182
2022-05-30,5호선,마포,15286,15539,30825
2022-05-30,5호선,명일,9234,9349,18583
2022-05-30,5호선,목동,18062,19052,37114
2022-05-30,5호선,미사,16767,16735,33502
2022-05-30,5호선,발산,21533,22064,43597
2022-05-30,5호선,방이,7371,7699,15070
2022-05-30,5호선,방화,7105,6757,13862
2022-05-30,5호선,상일동,15700,14592,30292
2022-05-30,5호선,서대문,21638,22355,43993
2022-05-30,5호선,송정,6918,6389,13307
2022-05-30,5호선,신금호,6821,7066,13887
2022-05-30,5호선,신길,4423,4683,9106
2022-05-30,5호선,신정,15066,11997,27063
2022-05-30,5호선,아차산,15231,14637,29868
2022-05-30,5호선,애오개,7009,7041,14050
2022-05-30,5호선,양평,7905,7951,15856
2022-05-30,5호선,여의나루,10843,12249,23092
2022-05-30,5호선,여의도,29830,32204,62034
2022-05-30,5호선,영등포구청,4356,4650,9006
2022-05-30,5호선,영등포시장,10377,10828,21205
2022-05-30,5호선,오금,3999,4142,8141
2022-05-30,5호선,오목교,22442,24013,46455
2022-05-30,5호선,올림픽공원,4644,4007,8651
2022-05-30,5호선,왕십리,4625,5296,9921
2022-05-30,5호선,우장산,15825,15447,31272
2022-05-30,5호선,을지로4가,6357,6450,12807
2022-05-30,5호선,장한평,18898,18669,37567
2022-05-30,5호선,종로3가,12345,12251,24596
2022-05-30,5호선,천호,17859,18061,35920
2022-05-30,5호선,청구,4280,3745,8025
2022-05-30,5호선,충정로,4914,5031,9945
2022-05-30,5호선,하남검단산,5944,5711,11655
2022-05-30,5호선,하남시청,7378,7034,14412
2022-05-30,5호선,하남풍산,4539,4359,8898
2022-05-30,5호선,행당,8595,7561,16156
2022-05-30,5호선,화곡,30032,27632,57664
2022-05-30,6호선,고려대,8824,8478,17302
2022-05-30,6호선,공덕,19609,18848,38457
2022-05-30,6호선,광흥창,9830,9433,19263
2022-05-30,6호선,구산,8265,5984,14249
2022-05-30,6호선,녹사평,4667,4603,9270
2022-05-30,6호선,대흥,8902,9275,18177
2022-05-30,6호선,독바위,2855,2958,5813
2022-05-30,6호선,돌곶이,9981,9489,19470
2022-05-30,6호선,동묘앞,7752,8131,15883
2022-05-30,6호선,디지털미디어시티,15521,16960,32481
2022-05-30,6호선,마포구청,15147,13361,28508
2022-05-30,6호선,망원,13452,14214,27666
2022-05-30,6호선,버티고개,2333,2273,4606
2022-05-30,6호선,보문,7899,7210,15109
2022-05-30,6호선,봉화산,9537,8950,18487
2022-05-30,6호선,불광,4271,4225,8496
2022-05-30,6호선,삼각지,6838,6077,12915
2022-05-30,6호선,상수,8528,9659,18187
2022-05-30,6호선,상월곡,6868,6400,13268
2022-05-30,6호선,새절,13953,12958,26911
2022-05-30,6호선,석계,13155,13988,27143
2022-05-30,6호선,신당,7849,8480,16329
2022-05-30,6호선,안암,14087,14873,28960
2022-05-30,6호선,약수,3855,3932,7787
2022-05-30,6호선,역촌,3758,4557,8315
2022-05-30,6호선,연신내,1,0,1
2022-05-30,6호선,월곡,13279,12684,25963
2022-05-30,6호선,월드컵경기장,4336,4545,8881
2022-05-30,6호선,응암,18418,17886,36304
2022-05-30,6호선,이태원,9869,10050,19919
2022-05-30,6호선,증산,10628,10558,21186
2022-05-30,6호선,창신,3894,3204,7098
2022-05-30,6호선,청구,3747,3970,7717
2022-05-30,6호선,태릉입구,6067,6900,12967
2022-05-30,6호선,한강진,6828,7920,14748
2022-05-30,6호선,합정,13029,12831,25860
2022-05-30,6호선,화랑대,12885,9939,22824
2022-05-30,6호선,효창공원앞,7876,7112,14988
2022-05-30,7호선,가산디지털단지,48126,48335,96461
2022-05-30,7호선,강남구청,16613,18574,35187
2022-05-30,7호선,건대입구,13121,13730,26851
2022-05-30,7호선,고속터미널,16958,14147,31105
2022-05-30,7호선,공릉,12973,12997,25970
2022-05-30,7호선,광명사거리,22803,22313,45116
2022-05-30,7호선,군자,15304,12299,27603
2022-05-30,7호선,남구로,16854,17785,34639
2022-05-30,7호선,남성,11944,11173,23117
2022-05-30,7호선,내방,15592,16008,31600
2022-05-30,7호선,노원,19777,20682,40459
2022-05-30,7호선,논현,20374,21915,42289
2022-05-30,7호선,대림,8301,8365,16666
2022-05-30,7호선,도봉산,10132,11044,21176
2022-05-30,7호선,뚝섬유원지,8663,8304,16967
2022-05-30,7호선,마들,13622,12827,26449
2022-05-30,7호선,먹골,10382,10204,20586
2022-05-30,7호선,면목,17100,16621,33721
2022-05-30,7호선,반포,6081,6102,12183
2022-05-30,7호선,보라매,9722,9969,19691
2022-05-30,7호선,사가정,16979,16680,33659
2022-05-30,7호선,상도,12050,11947,23997
2022-05-30,7호선,상봉,17168,15907,33075
2022-05-30,7호선,수락산,12984,12784,25768
2022-05-30,7호선,숭실대입구,15699,16047,31746
2022-05-30,7호선,신대방삼거리,16817,16055,32872
2022-05-30,7호선,신풍,12533,11908,24441
2022-05-30,7호선,어린이대공원,16313,17174,33487
2022-05-30,7호선,온수,11756,11117,22873
2022-05-30,7호선,용마산,6267,5985,12252
2022-05-30,7호선,이수,16317,15952,32269
2022-05-30,7호선,장승배기,9580,9347,18927
2022-05-30,7호선,장암,2424,878,3302
2022-05-30,7호선,중계,15695,14502,30197
2022-05-30,7호선,중곡,11611,10770,22381
2022-05-30,7호선,중화,11201,10958,22159
2022-05-30,7호선,천왕,12411,11731,24142
2022-05-30,7호선,철산,22343,22686,45029
2022-05-30,7호선,청담,20935,23307,44242
2022-05-30,7호선,태릉입구,9508,9184,18692
2022-05-30,7호선,하계,18706,17232,35938
2022-05-30,7호선,학동,25659,27236,52895
2022-05-30,8호선,가락시장,7911,8679,16590
2022-05-30,8호선,강동구청,10791,11164,21955
2022-05-30,8호선,남위례,5508,5666,11174
2022-05-30,8호선,남한산성입구,16503,15122,31625
2022-05-30,8호선,단대오거리,11611,11059,22670
2022-05-30,8호선,모란,4429,3589,8018
2022-05-30,8호선,몽촌토성,6384,6471,12855
2022-05-30,8호선,문정,22982,24457,47439
2022-05-30,8호선,복정,10247,8611,18858
2022-05-30,8호선,산성,5728,5829,11557
2022-05-30,8호선,석촌,7810,8870,16680
2022-05-30,8호선,송파,8856,8692,17548
2022-05-30,8호선,수진,5584,5203,10787
2022-05-30,8호선,신흥,4222,4644,8866
2022-05-30,8호선,암사,19784,17339,37123
2022-05-30,8호선,잠실,13553,16164,29717
2022-05-30,8호선,장지,17288,16662,33950
2022-05-30,8호선,천호,14684,16784,31468
2022-05-30,9호선,가양,22073,21597,43670
2022-05-30,9호선,개화,3022,2043,5065
2022-05-30,9호선,고속터미널,12991,16340,29331
2022-05-30,9호선,공항시장,3029,3301,6330
2022-05-30,9호선,구반포,1334,1388,2722
2022-05-30,9호선,국회의사당,16105,16942,33047
2022-05-30,9호선,김포공항,7474,11357,18831
2022-05-30,9호선,노들,4725,3917,8642
2022-05-30,9호선,노량진,26874,26543,53417
2022-05-30,9호선,당산,18794,19481,38275
2022-05-30,9호선,동작,2057,1719,3776
2022-05-30,9호선,등촌,12025,11511,23536
2022-05-30,9호선,마곡나루,12833,12996,25829
2022-05-30,9호선,사평,3928,3806,7734
2022-05-30,9호선,샛강,7055,6776,13831
2022-05-30,9호선,선유도,9354,8999,18353
2022-05-30,9호선,신논현,31579,31308,62887
2022-05-30,9호선,신목동,4840,4199,9039
2022-05-30,9호선,신반포,3842,3783,7625
2022-05-30,9호선,신방화,7189,6862,14051
2022-05-30,9호선,양천향교,10738,10986,21724
2022-05-30,9호선,여의도,30049,29669,59718
2022-05-30,9호선,염창,18281,17720,36001
2022-05-30,9호선,증미,7778,7621,15399
2022-05-30,9호선,흑석,9612,9971,19583
2022-05-30,9호선2~3단계,둔촌오륜,1211,1154,2365
2022-05-30,9호선2~3단계,봉은사,17414,17670,35084
2022-05-30,9호선2~3단계,삼성중앙,7608,8170,15778
2022-05-30,9호선2~3단계,삼전,7261,6857,14118
2022-05-30,9호선2~3단계,석촌,9015,8038,17053
2022-05-30,9호선2~3단계,석촌고분,6285,6190,12475
2022-05-30,9호선2~3단계,선정릉,10619,11733,22352
2022-05-30,9호선2~3단계,송파나루,5092,5245,10337
2022-05-30,9호선2~3단계,언주,10945,11493,22438
2022-05-30,9호선2~3단계,올림픽공원,6636,6678,13314
2022-05-30,9호선2~3단계,종합운동장,4399,4465,8864
2022-05-30,9호선2~3단계,중앙보훈병원,12155,10676,22831
2022-05-30,9호선2~3단계,한성백제,2650,2368,5018
2022-05-30,경강선,경기광주,8450,7987,16437
2022-05-30,경강선,곤지암,2363,2379,4742
2022-05-30,경강선,부발,2231,2344,4575
2022-05-30,경강선,삼동,2655,2390,5045
2022-05-30,경강선,세종대왕릉,341,345,686
2022-05-30,경강선,신둔도예촌,1774,1652,3426
2022-05-30,경강선,여주,2708,2766,5474
2022-05-30,경강선,이매,1298,1010,2308
2022-05-30,경강선,이천,2698,2885,5583
2022-05-30,경강선,초월,3503,3357,6860
2022-05-30,경강선,판교,5302,5171,10473
2022-05-30,경부선,가산디지털단지,19805,22854,42659
2022-05-30,경부선,관악,8234,7731,15965
2022-05-30,경부선,광명,3691,3127,6818
2022-05-30,경부선,구로,19720,20078,39798
2022-05-30,경부선,군포,8322,8197,16519
2022-05-30,경부선,금정,29002,29135,58137
2022-05-30,경부선,금천구청,12907,12822,25729
2022-05-30,경부선,남영,10097,10978,21075
2022-05-30,경부선,노량진,8357,8366,16723
2022-05-30,경부선,당정,7785,7428,15213
2022-05-30,경부선,대방,12825,13635,26460
2022-05-30,경부선,독산,20043,20680,40723
2022-05-30,경부선,두정,7807,9229,17036
2022-05-30,경부선,명학,11113,11064,22177
2022-05-30,경부선,병점,17650,17588,35238
2022-05-30,경부선,서동탄,1560,1330,2890
2022-05-30,경부선,서울역,7501,2385,9886
2022-05-30,경부선,서정리,8168,7953,16121
2022-05-30,경부선,석수,10396,9437,19833
2022-05-30,경부선,성균관대,16315,16230,32545
2022-05-30,경부선,성환,7147,7254,14401
2022-05-30,경부선,세류,3287,3003,6290
2022-05-30,경부선,세마,3076,2912,5988
2022-05-30,경부선,송탄,4826,4852,9678
2022-05-30,경부선,수원,37158,39167,76325
2022-05-30,경부선,신길,9884,8539,18423
2022-05-30,경부선,신도림,4437,4664,9101
2022-05-30,경부선,안양,28381,27902,56283
2022-05-30,경부선,영등포,37236,39073,76309
2022-05-30,경부선,오산,11001,11090,22091
2022-05-30,경부선,오산대,4316,4032,8348
2022-05-30,경부선,용산,34678,35318,69996
2022-05-30,경부선,의왕,10137,10106,20243
2022-05-30,경부선,직산,901,870,1771
2022-05-30,경부선,진위,1951,1738,3689
2022-05-30,경부선,천안,7099,7023,14122
2022-05-30,경부선,평택,13908,14528,28436
2022-05-30,경부선,평택지제,4179,3887,8066
2022-05-30,경부선,화서,8957,8588,17545
2022-05-30,경원선,가능,7357,7062,14419
2022-05-30,경원선,광운대,9526,9552,19078
2022-05-30,경원선,녹양,4981,4588,9569
2022-05-30,경원선,녹천,5097,4189,9286
2022-05-30,경원선,덕계,3705,3422,7127
2022-05-30,경원선,덕정,7055,6788,13843
2022-05-30,경원선,도봉,6288,6056,12344
2022-05-30,경원선,도봉산,7429,5053,12482
2022-05-30,경원선,동두천,2783,3128,5911
2022-05-30,경원선,동두천중앙,3551,3458,7009
2022-05-30,경원선,망월사,9949,10150,20099
2022-05-30,경원선,방학,10360,10082,20442
2022-05-30,경원선,보산,1813,1931,3744
2022-05-30,경원선,서빙고,2194,1979,4173
2022-05-30,경원선,석계,8810,9874,18684
2022-05-30,경원선,소요산,2467,2119,4586
2022-05-30,경원선,신이문,8971,8284,17255
2022-05-30,경원선,양주,8495,8032,16527
2022-05-30,경원선,옥수,58,40,98
2022-05-30,경원선,왕십리,14641,15832,30473
2022-05-30,경원선,외대앞,8750,8949,17699
2022-05-30,경원선,월계,8870,8079,16949
2022-05-30,경원선,응봉,1999,1730,3729
2022-05-30,경원선,의정부,18535,19288,37823
2022-05-30,경원선,이촌,3954,3015,6969
2022-05-30,경원선,지행,7421,7380,14801
2022-05-30,경원선,청량리,15644,16667,32311
2022-05-30,경원선,한남,4496,4291,8787
2022-05-30,경원선,회룡,13588,13170,26758
2022-05-30,경의선,가좌,6239,5773,12012
2022-05-30,경의선,강매,3660,3101,6761
2022-05-30,경의선,곡산,676,692,1368
2022-05-30,경의선,공덕,3727,3410,7137
2022-05-30,경의선,금릉,5417,5180,10597
2022-05-30,경의선,금촌,6797,6717,13514
2022-05-30,경의선,능곡,4178,3843,8021
2022-05-30,경의선,디지털미디어시티,2922,2661,5583
2022-05-30,경의선,문산,5342,5417,10759
2022-05-30,경의선,백마,7708,7289,14997
2022-05-30,경의선,서강대,2316,2267,4583
2022-05-30,경의선,서울역,5079,6643,11722
2022-05-30,경의선,수색,3232,3424,6656
2022-05-30,경의선,신촌,981,1257,2238
2022-05-30,경의선,야당,8214,7935,16149
2022-05-30,경의선,운정,7758,7015,14773
2022-05-30,경의선,월롱,3310,3175,6485
2022-05-30,경의선,일산,10523,10315,20838
2022-05-30,경의선,임진강,23,9,32
2022-05-30,경의선,탄현,8552,7975,16527
2022-05-30,경의선,파주,1676,1253,2929
2022-05-30,경의선,풍산,6122,5535,11657
2022-05-30,경의선,행신,8923,9026,17949
2022-05-30,경의선,홍대입구,1744,1985,3729
2022-05-30,경의선,화전,3719,3561,7280
2022-05-30,경의선,효창공원앞,3370,3765,7135
2022-05-30,경인선,간석,6553,6010,12563
2022-05-30,경인선,개봉,22890,22185,45075
2022-05-30,경인선,구일,7841,7602,15443
2022-05-30,경인선,도원,3793,3706,7499
2022-05-30,경인선,도화,4518,4162,8680
2022-05-30,경인선,동암,16024,15942,31966
2022-05-30,경인선,동인천,14338,13611,27949
2022-05-30,경인선,백운,7587,7357,14944
2022-05-30,경인선,부개,9547,8722,18269
2022-05-30,경인선,부천,34249,33986,68235
2022-05-30,경인선,부평,29452,31271,60723
2022-05-30,경인선,소사,9731,9393,19124
2022-05-30,경인선,송내,30001,29753,59754
2022-05-30,경인선,역곡,30757,30110,60867
2022-05-30,경인선,오류동,12725,11786,24511
2022-05-30,경인선,온수,7645,7358,15003
2022-05-30,경인선,인천,3614,2760,6374
2022-05-30,경인선,제물포,12031,11460,23491
2022-05-30,경인선,주안,21103,19350,40453
2022-05-30,경인선,중동,10418,9709,20127
2022-05-30,경춘선,가평,1774,1651,3425
2022-05-30,경춘선,갈매,3278,2880,6158
2022-05-30,경춘선,강촌,418,439,857
2022-05-30,경춘선,굴봉산,136,138,274
2022-05-30,경춘선,금곡,1760,1672,3432
2022-05-30,경춘선,김유정,294,297,591
2022-05-30,경춘선,남춘천,2610,2899,5509
2022-05-30,경춘선,대성리,685,492,1177
2022-05-30,경춘선,마석,4460,4226,8686
2022-05-30,경춘선,백양리,90,110,200
2022-05-30,경춘선,별내,3434,3190,6624
2022-05-30,경춘선,사릉,2793,2657,5450
2022-05-30,경춘선,상천,243,246,489
2022-05-30,경춘선,신내,2511,2355,4866
2022-05-30,경춘선,천마산,1899,1719,3618
2022-05-30,경춘선,청평,1742,1633,3375
2022-05-30,경춘선,춘천,1558,1669,3227
2022-05-30,경춘선,퇴계원,3916,3447,7363
2022-05-30,경춘선,평내호평,7053,6718,13771
2022-05-30,공항철도,검암,7193,7058,14251
2022-05-30,공항철도,계양,11853,10943,22796
2022-05-30,공항철도,공덕,2457,3212,5669
2022-05-30,공항철도,공항화물청사,2284,2585,4869
2022-05-30,공항철도,김포공항,12458,7475,19933
2022-05-30,공항철도,디지털미디어시티,15365,14528,29893
2022-05-30,공항철도,마곡나루,10423,9999,20422
2022-05-30,공항철도,서울역,8729,8244,16973
2022-05-30,공항철도,영종,3404,3335,6739
2022-05-30,공항철도,운서,7344,7165,14509
2022-05-30,공항철도,인천공항1터미널,5600,5444,11044
2022-05-30,공항철도,인천공항2터미널,3254,2849,6103
2022-05-30,공항철도,청라국제도시,7788,7231,15019
2022-05-30,공항철도,홍대입구,9876,9805,19681
2022-05-30,과천선,경마공원,998,950,1948
2022-05-30,과천선,과천,6840,6258,13098
2022-05-30,과천선,대공원,3436,3513,6949
2022-05-30,과천선,범계,27176,26936,54112
2022-05-30,과천선,선바위,8842,7719,16561
2022-05-30,과천선,인덕원,25906,27056,52962
2022-05-30,과천선,정부과천청사,11579,11335,22914
2022-05-30,과천선,평촌,19213,18802,38015
2022-05-30,분당선,가천대,13162,14243,27405
2022-05-30,분당선,강남구청,10223,11736,21959
2022-05-30,분당선,개포동,4035,4275,8310
2022-05-30,분당선,구룡,2567,2479,5046
2022-05-30,분당선,구성,5592,5748,11340
2022-05-30,분당선,기흥,11221,10544,21765
2022-05-30,분당선,대모산입구,4890,4422,9312
2022-05-30,분당선,도곡,7630,7619,15249
2022-05-30,분당선,망포,15510,14687,30197
2022-05-30,분당선,매교,3382,3338,6720
2022-05-30,분당선,매탄권선,5639,5377,11016
2022-05-30,분당선,모란,20858,20790,41648
2022-05-30,분당선,미금,16040,17081,33121
2022-05-30,분당선,보정,2858,2491,5349
2022-05-30,분당선,상갈,5879,5641,11520
2022-05-30,분당선,서울숲,11182,11299,22481
2022-05-30,분당선,서현,25139,25529,50668
2022-05-30,분당선,선릉,14473,22252,36725
2022-05-30,분당선,선정릉,8381,9009,17390
2022-05-30,분당선,수내,13642,13728,27370
2022-05-30,분당선,수서,14514,14812,29326
2022-05-30,분당선,수원,8450,7151,15601
2022-05-30,분당선,수원시청,13156,13739,26895
2022-05-30,분당선,신갈,4890,4805,9695
2022-05-30,분당선,압구정로데오,17364,19232,36596
2022-05-30,분당선,야탑,27072,28362,55434
2022-05-30,분당선,영통,8461,8953,17414
2022-05-30,분당선,오리,12179,10057,22236
2022-05-30,분당선,이매,6179,5770,11949
2022-05-30,분당선,정자,18769,19861,38630
2022-05-30,분당선,죽전,14850,16163,31013
2022-05-30,분당선,청명,4641,4487,9128
2022-05-30,분당선,태평,14045,13483,27528
2022-05-30,분당선,한티,14739,15978,30717
2022-05-30,수인선,고색,5336,5143,10479
2022-05-30,수인선,남동인더스파크,2284,2573,4857
2022-05-30,수인선,달월,118,76,194
2022-05-30,수인선,사리,5388,4744,10132
2022-05-30,수인선,소래포구,7131,6666,13797
2022-05-30,수인선,송도,2731,2430,5161
2022-05-30,수인선,숭의,4406,3984,8390
2022-05-30,수인선,신포,2005,1975,3980
2022-05-30,수인선,야목,438,303,741
2022-05-30,수인선,어천,775,869,1644
2022-05-30,수인선,연수,4819,4651,9470
2022-05-30,수인선,오목천,4292,4182,8474
2022-05-30,수인선,원인재,4747,4940,9687
2022-05-30,수인선,월곶,2978,2807,5785
2022-05-30,수인선,인천,1135,1813,2948
2022-05-30,수인선,인천논현,5921,6305,12226
2022-05-30,수인선,인하대,7839,7566,15405
2022-05-30,수인선,호구포,4325,4511,8836
2022-05-30,신림선,관악산,3908,3842,7750
2022-05-30,신림선,당곡,2914,2963,5877
2022-05-30,신림선,대방,1662,1087,2749
2022-05-30,신림선,보라매,2640,2193,4833
2022-05-30,신림선,보라매공원,1582,1877,3459
2022-05-30,신림선,보라매병원,5586,4893,10479
2022-05-30,신림선,샛강,2382,3083,5465
2022-05-30,신림선,서울대벤처타운,5503,5970,11473
2022-05-30,신림선,서울지방병무청,2053,2308,4361
2022-05-30,신림선,서원,2343,2358,4701
2022-05-30,신림선,신림,1724,1980,3704
2022-05-30,안산선,고잔,9801,9169,18970
2022-05-30,안산선,대야미,5380,4791,10171
2022-05-30,안산선,반월,4773,4540,9313
2022-05-30,안산선,산본,16844,17982,34826
2022-05-30,안산선,상록수,17627,17735,35362
2022-05-30,안산선,수리산,4534,3741,8275
2022-05-30,안산선,신길온천,1995,1763,3758
2022-05-30,안산선,안산,12477,11274,23751
2022-05-30,안산선,오이도,9209,8723,17932
2022-05-30,안산선,정왕,10587,11500,22087
2022-05-30,안산선,중앙,19300,20033,39333
2022-05-30,안산선,초지,5762,6035,11797
2022-05-30,안산선,한대앞,10972,11094,22066
2022-05-30,우이신설선,4.19민주묘지,3924,3814,7738
2022-05-30,우이신설선,가오리,4519,4412,8931
2022-05-30,우이신설선,보문,1672,1648,3320
2022-05-30,우이신설선,북한산보국문,6340,6133,12473
2022-05-30,우이신설선,북한산우이,3242,2966,6208
2022-05-30,우이신설선,삼양,2080,2160,4240
2022-05-30,우이신설선,삼양사거리,2589,2530,5119
2022-05-30,우이신설선,성신여대입구,3449,3841,7290
2022-05-30,우이신설선,솔밭공원,2651,2468,5119
2022-05-30,우이신설선,솔샘,6219,5713,11932
2022-05-30,우이신설선,신설동,2298,2274,4572
2022-05-30,우이신설선,정릉,5070,4568,9638
2022-05-30,우이신설선,화계,3727,3541,7268
2022-05-30,일산선,대곡,2430,1948,4378
2022-05-30,일산선,대화,14033,10759,24792
2022-05-30,일산선,마두,8042,8291,16333
2022-05-30,일산선,백석,10328,10242,20570
2022-05-30,일산선,삼송,21056,20323,41379
2022-05-30,일산선,원당,11972,11211,23183
2022-05-30,일산선,원흥,11680,11107,22787
2022-05-30,일산선,정발산,7103,6988,14091
2022-05-30,일산선,주엽,9869,9768,19637
2022-05-30,일산선,화정,17967,18058,36025
2022-05-30,장항선,배방,1251,1252,2503
2022-05-30,장항선,봉명,1432,1352,2784
2022-05-30,장항선,신창,2866,3433,6299
2022-05-30,장항선,쌍용,3175,3186,6361
2022-05-30,장항선,아산,4361,3596,7957
2022-05-30,장항선,온양온천,4141,4128,8269
2022-05-30,장항선,탕정,957,841,1798
2022-05-30,중앙선,구리,14504,14358,28862
2022-05-30,중앙선,국수,873,879,1752
2022-05-30,중앙선,덕소,6026,6046,12072
2022-05-30,중앙선,도농,12220,10911,23131
2022-05-30,중앙선,도심,2823,2114,4937
2022-05-30,중앙선,망우,8179,7803,15982
2022-05-30,중앙선,상봉,5990,6006,11996
2022-05-30,중앙선,신원,218,176,394
2022-05-30,중앙선,아신,561,554,1115
2022-05-30,중앙선,양수,2021,2037,4058
2022-05-30,중앙선,양원,3261,3144,6405
2022-05-30,중앙선,양정,808,653,1461
2022-05-30,중앙선,양평,3176,3119,6295
2022-05-30,중앙선,오빈,375,377,752
2022-05-30,중앙선,용문,3359,3306,6665
2022-05-30,중앙선,운길산,866,843,1709
2022-05-30,중앙선,원덕,445,403,848
2022-05-30,중앙선,중랑,5986,5643,11629
2022-05-30,중앙선,지평,94,102,196
2022-05-30,중앙선,팔당,909,944,1853
2022-05-30,중앙선,회기,26777,26328,53105
2022-05-31,1호선,동대문,12020,11398,23418
2022-05-31,1호선,동묘앞,8770,9175,17945
2022-05-31,1호선,서울역,49864,48244,98108
2022-05-31,1호선,시청,26014,26307,52321
2022-05-31,1호선,신설동,14745,14437,29182
2022-05-31,1호선,제기동,18554,18894,37448
2022-05-31,1호선,종각,40117,40193,80310
2022-05-31,1호선,종로3가,28428,25876,54304
2022-05-31,1호선,종로5가,26035,26143,52178
2022-05-31,1호선,청량리,22705,22452,45157
2022-05-31,2호선,강남,87761,89575,177336
2022-05-31,2호선,강변,33644,31423,65067
2022-05-31,2호선,건대입구,37932,42180,80112
2022-05-31,2호선,교대,37357,42858,80215
2022-05-31,2호선,구로디지털단지,65726,65734,131460
2022-05-31,2호선,구의,26019,24742,50761
2022-05-31,2호선,낙성대,29989,28182,58171
2022-05-31,2호선,당산,21173,24784,45957
2022-05-31,2호선,대림,26097,26440,52537
2022-05-31,2호선,도림천,1389,1474,2863
2022-05-31,2호선,동대문역사문화공원,13122,15008,28130
2022-05-31,2호선,뚝섬,24045,25807,49852
2022-05-31,2호선,문래,24311,25321,49632
2022-05-31,2호선,방배,21250,22195,43445
2022-05-31,2호선,봉천,26544,23574,50118
2022-05-31,2호선,사당,43427,48238,91665
2022-05-31,2호선,삼성,55058,57457,112515
2022-05-31,2호선,상왕십리,15515,14652,30167
2022-05-31,2호선,서울대입구,51861,50160,102021
2022-05-31,2호선,서초,23722,23390,47112
2022-05-31,2호선,선릉,63117,56809,119926
2022-05-31,2호선,성수,39230,44276,83506
2022-05-31,2호선,시청,25636,25403,51039
2022-05-31,2호선,신답,1829,2010,3839
2022-05-31,2호선,신당,15442,16024,31466
2022-05-31,2호선,신대방,28344,26849,55193
2022-05-31,2호선,신도림,53459,54011,107470
2022-05-31,2호선,신림,65330,62047,127377
2022-05-31,2호선,신설동,3423,3338,6761
2022-05-31,2호선,신정네거리,11652,11648,23300
2022-05-31,2호선,신촌,35962,37522,73484
2022-05-31,2호선,아현,11769,10985,22754
2022-05-31,2호선,양천구청,7752,7828,15580
2022-05-31,2호선,역삼,55731,64693,120424
2022-05-31,2호선,영등포구청,24202,25531,49733
2022-05-31,2호선,왕십리,18290,15071,33361
2022-05-31,2호선,용답,3370,3375,6745
2022-05-31,2호선,용두,2520,2499,5019
2022-05-31,2호선,을지로3가,25046,26167,51213
2022-05-31,2호선,을지로4가,14067,14567,28634
2022-05-31,2호선,을지로입구,43067,45556,88623
2022-05-31,2호선,이대,14388,14925,29313
2022-05-31,2호선,잠실,76926,76647,153573
2022-05-31,2호선,잠실나루,16757,15979,32736
2022-05-31,2호선,잠실새내,24530,25057,49587
2022-05-31,2호선,종합운동장,17485,20082,37567
2022-05-31,2호선,충정로,11068,11641,22709
2022-05-31,2호선,한양대,15542,17122,32664
2022-05-31,2호선,합정,32996,37425,70421
2022-05-31,2호선,홍대입구,57653,65304,122957
2022-05-31,3호선,가락시장,10029,10028,20057
2022-05-31,3호선,경복궁,29681,31277,60958
2022-05-31,3호선,경찰병원,7948,7880,15828
2022-05-31,3호선,고속터미널,44361,43326,87687
2022-05-31,3호선,교대,16536,10917,27453
2022-05-31,3호선,구파발,23215,22099,45314
2022-05-31,3호선,금호,8860,7986,16846
2022-05-31,3호선,남부터미널,31447,31983,63430
2022-05-31,3호선,녹번,17729,15136,32865
2022-05-31,3호선,대청,11391,10339,21730
2022-05-31,3호선,대치,12347,12361,24708
2022-05-31,3호선,도곡,5877,5948,11825
2022-05-31,3호선,독립문,8132,8216,16348
2022-05-31,3호선,동대입구,9747,10696,20443
2022-05-31,3호선,매봉,13975,13474,27449
2022-05-31,3호선,무악재,4358,4328,8686
2022-05-31,3호선,불광,18220,19376,37596
2022-05-31,3호선,수서,19071,19118,38189
2022-05-31,3호선,신사,30528,33468,63996
2022-05-31,3호선,안국,26286,26931,53217
2022-05-31,3호선,압구정,33936,37242,71178
2022-05-31,3호선,약수,14475,14042,28517
2022-05-31,3호선,양재,41805,45658,87463
2022-05-31,3호선,연신내,39926,37617,77543
2022-05-31,3호선,오금,7022,6028,13050
2022-05-31,3호선,옥수,10218,10295,20513
2022-05-31,3호선,을지로3가,11781,12869,24650
2022-05-31,3호선,일원,12018,11163,23181
2022-05-31,3호선,잠원,5468,5185,10653
2022-05-31,3호선,종로3가,10990,13380,24370
2022-05-31,3호선,지축,6066,5525,11591
2022-05-31,3호선,충무로,3,0,3
2022-05-31,3호선,학여울,1975,2016,3991
2022-05-31,3호선,홍제,19941,18403,38344
2022-05-31,4호선,길음,24637,23886,48523
2022-05-31,4호선,남태령,1489,1268,2757
2022-05-31,4호선,노원,20408,23669,44077
2022-05-31,4호선,당고개,9954,8716,18670
2022-05-31,4호선,동대문,22377,23138,45515
2022-05-31,4호선,동대문역사문화공원,15698,14733,30431
2022-05-31,4호선,동작,1808,1995,3803
2022-05-31,4호선,명동,22798,24093,46891
2022-05-31,4호선,미아,16578,15806,32384
2022-05-31,4호선,미아사거리,29841,28561,58402
2022-05-31,4호선,사당,29204,25557,54761
2022-05-31,4호선,삼각지,6159,6977,13136
2022-05-31,4호선,상계,21599,19504,41103
2022-05-31,4호선,서울역,12837,19617,32454
2022-05-31,4호선,성신여대입구,22994,21921,44915
2022-05-31,4호선,수유,37243,37120,74363
2022-05-31,4호선,숙대입구,15862,15361,31223
2022-05-31,4호선,신용산,18783,20189,38972
2022-05-31,4호선,쌍문,31674,28630,60304
2022-05-31,4호선,이촌,10447,11684,22131
2022-05-31,4호선,창동,28162,29652,57814
2022-05-31,4호선,총신대입구,20990,23122,44112
2022-05-31,4호선,충무로,30677,32692,63369
2022-05-31,4호선,한성대입구,16444,15763,32207
2022-05-31,4호선,혜화,36392,36456,72848
2022-05-31,4호선,회현,28487,30445,58932
2022-05-31,5호선,강동,20174,18967,39141
2022-05-31,5호선,강일,5019,4521,9540
2022-05-31,5호선,개롱,7178,7240,14418
2022-05-31,5호선,개화산,6198,5886,12084
2022-05-31,5호선,거여,11856,10825,22681
2022-05-31,5호선,고덕,10645,10405,21050
2022-05-31,5호선,공덕,15984,17188,33172
2022-05-31,5호선,광나루,15403,13837,29240
2022-05-31,5호선,광화문,33834,36894,70728
2022-05-31,5호선,군자,12283,13704,25987
2022-05-31,5호선,굽은다리,10392,9639,20031
2022-05-31,5호선,길동,8820,8978,17798
2022-05-31,5호선,김포공항,7704,7439,15143
2022-05-31,5호선,까치산,32255,29448,61703
2022-05-31,5호선,답십리,17266,15394,32660
2022-05-31,5호선,동대문역사문화공원,3063,3754,6817
2022-05-31,5호선,둔촌동,9098,8919,18017
2022-05-31,5호선,마곡,11770,11935,23705
2022-05-31,5호선,마장,6440,6003,12443
2022-05-31,5호선,마천,8196,7555,15751
2022-05-31,5호선,마포,15896,16438,32334
2022-05-31,5호선,명일,9649,9756,19405
2022-05-31,5호선,목동,18880,19726,38606
2022-05-31,5호선,미사,18334,17972,36306
2022-05-31,5호선,발산,23020,24367,47387
2022-05-31,5호선,방이,7497,7856,15353
2022-05-31,5호선,방화,7333,6905,14238
2022-05-31,5호선,상일동,16788,15110,31898
2022-05-31,5호선,서대문,22342,23154,45496
2022-05-31,5호선,송정,7242,6660,13902
2022-05-31,5호선,신금호,7317,7293,14610
2022-05-31,5호선,신길,4606,4642,9248
2022-05-31,5호선,신정,15571,11952,27523
2022-05-31,5호선,아차산,16523,15639,32162
2022-05-31,5호선,애오개,7525,7465,14990
2022-05-31,5호선,양평,8153,7833,15986
2022-05-31,5호선,여의나루,14526,15802,30328
2022-05-31,5호선,여의도,30393,33980,64373
2022-05-31,5호선,영등포구청,4507,4686,9193
2022-05-31,5호선,영등포시장,10897,11390,22287
2022-05-31,5호선,오금,4140,4342,8482
2022-05-31,5호선,오목교,24413,26089,50502
2022-05-31,5호선,올림픽공원,5206,4333,9539
2022-05-31,5호선,왕십리,4858,5891,10749
2022-05-31,5호선,우장산,16421,15828,32249
2022-05-31,5호선,을지로4가,6792,6989,13781
2022-05-31,5호선,장한평,19743,19232,38975
2022-05-31,5호선,종로3가,14463,14968,29431
2022-05-31,5호선,천호,19807,20075,39882
2022-05-31,5호선,청구,4314,3956,8270
2022-05-31,5호선,충정로,5287,5348,10635
2022-05-31,5호선,하남검단산,6499,6014,12513
2022-05-31,5호선,하남시청,7731,7239,14970
2022-05-31,5호선,하남풍산,4723,4586,9309
2022-05-31,5호선,행당,9020,7752,16772
2022-05-31,5호선,화곡,31557,28362,59919
2022-05-31,6호선,고려대,9566,9109,18675
2022-05-31,6호선,공덕,20468,20342,40810
2022-05-31,6호선,광흥창,10029,9545,19574
2022-05-31,6호선,구산,8584,6018,14602
2022-05-31,6호선,녹사평,5259,5567,10826
2022-05-31,6호선,대흥,9595,9802,19397
2022-05-31,6호선,독바위,3019,3005,6024
2022-05-31,6호선,돌곶이,10251,9159,19410
2022-05-31,6호선,동묘앞,8633,8933,17566
2022-05-31,6호선,디지털미디어시티,16118,17145,33263
2022-05-31,6호선,마포구청,15647,13680,29327
2022-05-31,6호선,망원,14870,15967,30837
2022-05-31,6호선,버티고개,2416,2260,4676
2022-05-31,6호선,보문,8395,7324,15719
2022-05-31,6호선,봉화산,9888,8980,18868
2022-05-31,6호선,불광,4655,4583,9238
2022-05-31,6호선,삼각지,8306,7131,15437
2022-05-31,6호선,상수,9548,11550,21098
2022-05-31,6호선,상월곡,7190,6444,13634
2022-05-31,6호선,새절,14690,13231,27921
2022-05-31,6호선,석계,13906,14150,28056
2022-05-31,6호선,신당,9188,9649,18837
2022-05-31,6호선,안암,15229,15149,30378
2022-05-31,6호선,약수,3956,3955,7911
2022-05-31,6호선,역촌,4068,4677,8745
2022-05-31,6호선,연신내,1,0,1
2022-05-31,6호선,월곡,13796,13103,26899
2022-05-31,6호선,월드컵경기장,5171,5522,10693
2022-05-31,6호선,응암,19180,18329,37509
2022-05-31,6호선,이태원,11076,14696,25772
2022-05-31,6호선,증산,11197,10740,21937
2022-05-31,6호선,창신,4148,3394,7542
2022-05-31,6호선,청구,3896,4191,8087
2022-05-31,6호선,태릉입구,6450,7322,13772
2022-05-31,6호선,한강진,8498,10339,18837
2022-05-31,6호선,합정,14646,14906,29552
2022-05-31,6호선,화랑대,13985,10390,24375
2022-05-31,6호선,효창공원앞,8216,7218,15434
2022-05-31,7호선,가산디지털단지,48446,49475,97921
2022-05-31,7호선,강남구청,17589,20120,37709
2022-05-31,7호선,건대입구,14187,15381,29568
2022-05-31,7호선,고속터미널,17174,14707,31881
2022-05-31,7호선,공릉,13959,13555,27514
2022-05-31,7호선,광명사거리,24204,23473,47677
2022-05-31,7호선,군자,16230,12733,28963
2022-05-31,7호선,남구로,16731,18032,34763
2022-05-31,7호선,남성,12589,11191,23780
2022-05-31,7호선,내방,16119,16722,32841
2022-05-31,7호선,노원,20615,22522,43137
2022-05-31,7호선,논현,20799,23217,44016
2022-05-31,7호선,대림,8587,8814,17401
2022-05-31,7호선,도봉산,10902,12086,22988
2022-05-31,7호선,뚝섬유원지,11369,11012,22381
2022-05-31,7호선,마들,14398,12940,27338
2022-05-31,7호선,먹골,10969,10469,21438
2022-05-31,7호선,면목,18104,17200,35304
2022-05-31,7호선,반포,6603,6275,12878
2022-05-31,7호선,보라매,9939,9846,19785
2022-05-31,7호선,사가정,17789,17370,35159
2022-05-31,7호선,상도,12755,12047,24802
2022-05-31,7호선,상봉,18399,17364,35763
2022-05-31,7호선,수락산,14203,13527,27730
2022-05-31,7호선,숭실대입구,16435,16465,32900
2022-05-31,7호선,신대방삼거리,17407,16267,33674
2022-05-31,7호선,신풍,12958,12140,25098
2022-05-31,7호선,어린이대공원,19108,19604,38712
2022-05-31,7호선,온수,12502,11628,24130
2022-05-31,7호선,용마산,6632,6123,12755
2022-05-31,7호선,이수,17571,17261,34832
2022-05-31,7호선,장승배기,9969,9388,19357
2022-05-31,7호선,장암,2467,951,3418
2022-05-31,7호선,중계,16277,14548,30825
2022-05-31,7호선,중곡,12062,10778,22840
2022-05-31,7호선,중화,11892,11247,23139
2022-05-31,7호선,천왕,12975,11902,24877
2022-05-31,7호선,철산,23721,24114,47835
2022-05-31,7호선,청담,21103,24259,45362
2022-05-31,7호선,태릉입구,10352,9777,20129
2022-05-31,7호선,하계,19862,17860,37722
2022-05-31,7호선,학동,25465,28182,53647
2022-05-31,8호선,가락시장,8357,9586,17943
2022-05-31,8호선,강동구청,11282,11315,22597
2022-05-31,8호선,남위례,5912,6171,12083
2022-05-31,8호선,남한산성입구,17468,15511,32979
2022-05-31,8호선,단대오거리,12492,11503,23995
2022-05-31,8호선,모란,4870,4053,8923
2022-05-31,8호선,몽촌토성,7140,7477,14617
2022-05-31,8호선,문정,23406,24982,48388
2022-05-31,8호선,복정,11254,9248,20502
2022-05-31,8호선,산성,6114,6035,12149
2022-05-31,8호선,석촌,8203,9522,17725
2022-05-31,8호선,송파,9200,8801,18001
2022-05-31,8호선,수진,5920,5234,11154
2022-05-31,8호선,신흥,4564,5003,9567
2022-05-31,8호선,암사,20996,17770,38766
2022-05-31,8호선,잠실,14883,18226,33109
2022-05-31,8호선,장지,18746,17111,35857
2022-05-31,8호선,천호,15996,18620,34616
2022-05-31,9호선,가양,23218,22376,45594
2022-05-31,9호선,개화,2981,2009,4990
2022-05-31,9호선,고속터미널,14682,18028,32710
2022-05-31,9호선,공항시장,3286,3427,6713
2022-05-31,9호선,구반포,1874,1934,3808
2022-05-31,9호선,국회의사당,16309,17469,33778
2022-05-31,9호선,김포공항,8169,11591,19760
2022-05-31,9호선,노들,5264,4389,9653
2022-05-31,9호선,노량진,28781,28433,57214
2022-05-31,9호선,당산,20521,20954,41475
2022-05-31,9호선,동작,2373,1963,4336
2022-05-31,9호선,등촌,12428,11569,23997
2022-05-31,9호선,마곡나루,13994,13930,27924
2022-05-31,9호선,사평,4167,3933,8100
2022-05-31,9호선,샛강,7725,7389,15114
2022-05-31,9호선,선유도,9832,9375,19207
2022-05-31,9호선,신논현,34326,35414,69740
2022-05-31,9호선,신목동,4972,4171,9143
2022-05-31,9호선,신반포,4174,3963,8137
2022-05-31,9호선,신방화,7527,7199,14726
2022-05-31,9호선,양천향교,11191,11181,22372
2022-05-31,9호선,여의도,30999,30843,61842
2022-05-31,9호선,염창,19415,18223,37638
2022-05-31,9호선,증미,8061,7715,15776
2022-05-31,9호선,흑석,10253,10483,20736
2022-05-31,9호선2~3단계,둔촌오륜,1301,1135,2436
2022-05-31,9호선2~3단계,봉은사,18027,18410,36437
2022-05-31,9호선2~3단계,삼성중앙,8043,8465,16508
2022-05-31,9호선2~3단계,삼전,7571,7030,14601
2022-05-31,9호선2~3단계,석촌,9691,8614,18305
2022-05-31,9호선2~3단계,석촌고분,6652,6389,13041
2022-05-31,9호선2~3단계,선정릉,10987,12349,23336
2022-05-31,9호선2~3단계,송파나루,5417,5857,11274
2022-05-31,9호선2~3단계,언주,11262,11883,23145
2022-05-31,9호선2~3단계,올림픽공원,7445,7454,14899
2022-05-31,9호선2~3단계,종합운동장,4773,4930,9703
2022-05-31,9호선2~3단계,중앙보훈병원,12462,10826,23288
2022-05-31,9호선2~3단계,한성백제,3045,2572,5617
2022-05-31,경강선,경기광주,8902,8196,17098
2022-05-31,경강선,곤지암,2732,2609,5341
2022-05-31,경강선,부발,2695,2358,5053
2022-05-31,경강선,삼동,2804,2427,5231
2022-05-31,경강선,세종대왕릉,372,383,755
2022-05-31,경강선,신둔도예촌,1991,1722,3713
2022-05-31,경강선,여주,3187,2957,6144
2022-05-31,경강선,이매,1367,1059,2426
2022-05-31,경강선,이천,2907,3040,5947
2022-05-31,경강선,초월,3890,3555,7445
2022-05-31,경강선,판교,5433,5548,10981
2022-05-31,경부선,가산디지털단지,20785,23623,44408
2022-05-31,경부선,관악,8690,7769,16459
2022-05-31,경부선,광명,3800,3268,7068
2022-05-31,경부선,구로,20169,21512,41681
2022-05-31,경부선,군포,8602,8337,16939
2022-05-31,경부선,금정,30837,30896,61733
2022-05-31,경부선,금천구청,13317,13195,26512
2022-05-31,경부선,남영,11022,11720,22742
2022-05-31,경부선,노량진,9364,9354,18718
2022-05-31,경부선,당정,8140,7548,15688
2022-05-31,경부선,대방,12851,13739,26590
2022-05-31,경부선,독산,20784,21282,42066
2022-05-31,경부선,두정,9093,9767,18860
2022-05-31,경부선,명학,11860,11712,23572
2022-05-31,경부선,병점,19137,19285,38422
2022-05-31,경부선,서동탄,1703,1481,3184
2022-05-31,경부선,서울역,7311,2374,9685
2022-05-31,경부선,서정리,9759,8180,17939
2022-05-31,경부선,석수,11214,9833,21047
2022-05-31,경부선,성균관대,17611,17081,34692
2022-05-31,경부선,성환,7455,7004,14459
2022-05-31,경부선,세류,3619,3260,6879
2022-05-31,경부선,세마,3353,3179,6532
2022-05-31,경부선,송탄,5247,4688,9935
2022-05-31,경부선,수원,41392,44552,85944
2022-05-31,경부선,신길,10077,8741,18818
2022-05-31,경부선,신도림,4790,5048,9838
2022-05-31,경부선,안양,30392,29995,60387
2022-05-31,경부선,영등포,40612,43520,84132
2022-05-31,경부선,오산,11796,11591,23387
2022-05-31,경부선,오산대,5039,4652,9691
2022-05-31,경부선,용산,37848,39141,76989
2022-05-31,경부선,의왕,10501,10378,20879
2022-05-31,경부선,직산,1040,969,2009
2022-05-31,경부선,진위,2152,1916,4068
2022-05-31,경부선,천안,8244,7377,15621
2022-05-31,경부선,평택,15209,15241,30450
2022-05-31,경부선,평택지제,4494,4139,8633
2022-05-31,경부선,화서,9730,9111,18841
2022-05-31,경원선,가능,7862,7446,15308
2022-05-31,경원선,광운대,9889,9546,19435
2022-05-31,경원선,녹양,5388,5109,10497
2022-05-31,경원선,녹천,5265,4138,9403
2022-05-31,경원선,덕계,3996,3544,7540
2022-05-31,경원선,덕정,7856,7282,15138
2022-05-31,경원선,도봉,6770,6407,13177
2022-05-31,경원선,도봉산,9028,5953,14981
2022-05-31,경원선,동두천,3058,3308,6366
2022-05-31,경원선,동두천중앙,3522,3469,6991
2022-05-31,경원선,망월사,10655,10535,21190
2022-05-31,경원선,방학,10948,10617,21565
2022-05-31,경원선,보산,1762,1536,3298
2022-05-31,경원선,서빙고,2417,2203,4620
2022-05-31,경원선,석계,9462,10601,20063
2022-05-31,경원선,소요산,3071,2739,5810
2022-05-31,경원선,신이문,9305,8273,17578
2022-05-31,경원선,양주,9461,8545,18006
2022-05-31,경원선,옥수,66,57,123
2022-05-31,경원선,왕십리,15875,17462,33337
2022-05-31,경원선,외대앞,9385,9172,18557
2022-05-31,경원선,월계,9419,8516,17935
2022-05-31,경원선,응봉,2247,1861,4108
2022-05-31,경원선,의정부,20167,21493,41660
2022-05-31,경원선,이촌,4425,3276,7701
2022-05-31,경원선,지행,8094,8029,16123
2022-05-31,경원선,청량리,17081,17822,34903
2022-05-31,경원선,한남,4617,4422,9039
2022-05-31,경원선,회룡,14383,13923,28306
2022-05-31,경의선,가좌,6405,5991,12396
2022-05-31,경의선,강매,3815,3165,6980
2022-05-31,경의선,곡산,692,742,1434
2022-05-31,경의선,공덕,3930,3628,7558
2022-05-31,경의선,금릉,5681,5532,11213
2022-05-31,경의선,금촌,7285,7127,14412
2022-05-31,경의선,능곡,4295,3937,8232
2022-05-31,경의선,디지털미디어시티,3028,2798,5826
2022-05-31,경의선,문산,5848,5761,11609
2022-05-31,경의선,백마,8222,7804,16026
2022-05-31,경의선,서강대,2357,2334,4691
2022-05-31,경의선,서울역,5229,6885,12114
2022-05-31,경의선,수색,3194,3345,6539
2022-05-31,경의선,신촌,931,1229,2160
2022-05-31,경의선,야당,9034,9169,18203
2022-05-31,경의선,운정,7965,7206,15171
2022-05-31,경의선,월롱,3816,3182,6998
2022-05-31,경의선,일산,10857,10519,21376
2022-05-31,경의선,임진강,28,19,47
2022-05-31,경의선,탄현,8786,8301,17087
2022-05-31,경의선,파주,1803,1250,3053
2022-05-31,경의선,풍산,6613,5976,12589
2022-05-31,경의선,행신,9258,9217,18475
2022-05-31,경의선,홍대입구,1945,2410,4355
2022-05-31,경의선,화전,3988,3690,7678
2022-05-31,경의선,효창공원앞,3431,3754,7185
2022-05-31,경인선,간석,6804,6218,13022
2022-05-31,경인선,개봉,24298,23354,47652
2022-05-31,경인선,구일,10059,10126,20185
2022-05-31,경인선,도원,3868,3744,7612
2022-05-31,경인선,도화,4954,4444,9398
2022-05-31,경인선,동암,17061,16936,33997
2022-05-31,경인선,동인천,15490,14515,30005
2022-05-31,경인선,백운,7871,7615,15486
2022-05-31,경인선,부개,9904,8872,18776
2022-05-31,경인선,부천,36283,36860,73143
2022-05-31,경인선,부평,31022,34682,65704
2022-05-31,경인선,소사,10259,9958,20217
2022-05-31,경인선,송내,31661,31075,62736
2022-05-31,경인선,역곡,32836,31733,64569
2022-05-31,경인선,오류동,13329,11983,25312
2022-05-31,경인선,온수,8235,7521,15756
2022-05-31,경인선,인천,5263,4106,9369
2022-05-31,경인선,제물포,12965,12167,25132
2022-05-31,경인선,주안,22113,19925,42038
2022-05-31,경인선,중동,10911,9838,20749
2022-05-31,경춘선,가평,2345,2349,4694
2022-05-31,경춘선,갈매,3448,2980,6428
2022-05-31,경춘선,강촌,653,694,1347
2022-05-31,경춘선,굴봉산,167,146,313
2022-05-31,경춘선,금곡,1775,1729,3504
2022-05-31,경춘선,김유정,528,591,1119
2022-05-31,경춘선,남춘천,3292,3014,6306
2022-05-31,경춘선,대성리,736,837,1573
2022-05-31,경춘선,마석,5304,5017,10321
2022-05-31,경춘선,백양리,110,100,210
2022-05-31,경춘선,별내,3615,3297,6912
2022-05-31,경춘선,사릉,2853,2803,5656
2022-05-31,경춘선,상천,356,377,733
2022-05-31,경춘선,신내,2631,2384,5015
2022-05-31,경춘선,천마산,2412,2077,4489
2022-05-31,경춘선,청평,1856,1949,3805
2022-05-31,경춘선,춘천,2163,1887,4050
2022-05-31,경춘선,퇴계원,4024,3548,7572
2022-05-31,경춘선,평내호평,7229,7225,14454
2022-05-31,공항철도,검암,7547,7487,15034
2022-05-31,공항철도,계양,12401,11480,23881
2022-05-31,공항철도,공덕,2566,3474,6040
2022-05-31,공항철도,공항화물청사,2397,2599,4996
2022-05-31,공항철도,김포공항,12559,7178,19737
2022-05-31,공항철도,디지털미디어시티,15877,14957,30834
2022-05-31,공항철도,마곡나루,11144,10779,21923
2022-05-31,공항철도,서울역,9283,8481,17764
2022-05-31,공항철도,영종,3577,3738,7315
2022-05-31,공항철도,운서,8057,8061,16118
2022-05-31,공항철도,인천공항1터미널,5682,5784,11466
2022-05-31,공항철도,인천공항2터미널,2813,2873,5686
2022-05-31,공항철도,청라국제도시,8240,7709,15949
2022-05-31,공항철도,홍대입구,10677,11267,21944
2022-05-31,과천선,경마공원,1918,1831,3749
2022-05-31,과천선,과천,7350,6586,13936
2022-05-31,과천선,대공원,8687,8700,17387
2022-05-31,과천선,범계,29904,30179,60083
2022-05-31,과천선,선바위,9484,8203,17687
2022-05-31,과천선,인덕원,27818,28059,55877
2022-05-31,과천선,정부과천청사,12150,12001,24151
2022-05-31,과천선,평촌,20020,19569,39589
2022-05-31,분당선,가천대,13857,14483,28340
2022-05-31,분당선,강남구청,10568,12383,22951
2022-05-31,분당선,개포동,4437,4446,8883
2022-05-31,분당선,구룡,2808,2541,5349
2022-05-31,분당선,구성,5795,5914,11709
2022-05-31,분당선,기흥,11908,11113,23021
2022-05-31,분당선,대모산입구,5064,4641,9705
2022-05-31,분당선,도곡,7863,7616,15479
2022-05-31,분당선,망포,17214,15732,32946
2022-05-31,분당선,매교,3536,3494,7030
2022-05-31,분당선,매탄권선,6123,5765,11888
2022-05-31,분당선,모란,22400,22719,45119
2022-05-31,분당선,미금,16990,17972,34962
2022-05-31,분당선,보정,3028,2588,5616
2022-05-31,분당선,상갈,6368,6064,12432
2022-05-31,분당선,서울숲,12798,13382,26180
2022-05-31,분당선,서현,26703,27465,54168
2022-05-31,분당선,선릉,15144,23301,38445
2022-05-31,분당선,선정릉,8397,9288,17685
2022-05-31,분당선,수내,14793,14840,29633
2022-05-31,분당선,수서,15065,15411,30476
2022-05-31,분당선,수원,9584,8104,17688
2022-05-31,분당선,수원시청,14179,16601,30780
2022-05-31,분당선,신갈,5146,4943,10089
2022-05-31,분당선,압구정로데오,19885,23568,43453
2022-05-31,분당선,야탑,28911,30176,59087
2022-05-31,분당선,영통,9586,9916,19502
2022-05-31,분당선,오리,12897,10660,23557
2022-05-31,분당선,이매,6277,5948,12225
2022-05-31,분당선,정자,20313,21800,42113
2022-05-31,분당선,죽전,16316,17560,33876
2022-05-31,분당선,청명,5200,4708,9908
2022-05-31,분당선,태평,14659,13780,28439
2022-05-31,분당선,한티,15741,16745,32486
2022-05-31,수인선,고색,5603,5356,10959
2022-05-31,수인선,남동인더스파크,2334,2672,5006
2022-05-31,수인선,달월,117,82,199
2022-05-31,수인선,사리,6004,5037,11041
2022-05-31,수인선,소래포구,8684,8174,16858
2022-05-31,수인선,송도,2848,2661,5509
2022-05-31,수인선,숭의,4610,4218,8828
2022-05-31,수인선,신포,2081,2182,4263
2022-05-31,수인선,야목,521,377,898
2022-05-31,수인선,어천,873,893,1766
2022-05-31,수인선,연수,5258,5195,10453
2022-05-31,수인선,오목천,4818,4357,9175
2022-05-31,수인선,원인재,5105,5242,10347
2022-05-31,수인선,월곶,3307,3005,6312
2022-05-31,수인선,인천,1424,2328,3752
2022-05-31,수인선,인천논현,6301,6836,13137
2022-05-31,수인선,인하대,8334,7863,16197
2022-05-31,수인선,호구포,4623,4843,9466
2022-05-31,신림선,관악산,4590,4378,8968
2022-05-31,신림선,당곡,3387,3113,6500
2022-05-31,신림선,대방,1779,1155,2934
2022-05-31,신림선,보라매,2742,2278,5020
2022-05-31,신림선,보라매공원,1864,2100,3964
2022-05-31,신림선,보라매병원,5879,5643,11522
2022-05-31,신림선,샛강,2654,3540,6194
2022-05-31,신림선,서울대벤처타운,6361,6263,12624
2022-05-31,신림선,서울지방병무청,2104,2273,4377
2022-05-31,신림선,서원,2571,2371,4942
2022-05-31,신림선,신림,1960,2432,4392
2022-05-31,안산선,고잔,10524,10038,20562
2022-05-31,안산선,대야미,5889,5012,10901
2022-05-31,안산선,반월,4962,4611,9573
2022-05-31,안산선,산본,18230,19422,37652
2022-05-31,안산선,상록수,18771,18686,37457
2022-05-31,안산선,수리산,4807,3877,8684
2022-05-31,안산선,신길온천,2047,1867,3914
2022-05-31,안산선,안산,12993,11590,24583
2022-05-31,안산선,오이도,10253,10208,20461
2022-05-31,안산선,정왕,11807,11904,23711
2022-05-31,안산선,중앙,20853,22586,43439
2022-05-31,안산선,초지,5967,6231,12198
2022-05-31,안산선,한대앞,11707,11856,23563
2022-05-31,우이신설선,4.19민주묘지,3878,3598,7476
2022-05-31,우이신설선,가오리,4630,4501,9131
2022-05-31,우이신설선,보문,1702,1772,3474
2022-05-31,우이신설선,북한산보국문,6915,6184,13099
2022-05-31,우이신설선,북한산우이,3070,2802,5872
2022-05-31,우이신설선,삼양,2183,2205,4388
2022-05-31,우이신설선,삼양사거리,2720,2697,5417
2022-05-31,우이신설선,성신여대입구,3695,4041,7736
2022-05-31,우이신설선,솔밭공원,2724,2532,5256
2022-05-31,우이신설선,솔샘,6459,5848,12307
2022-05-31,우이신설선,신설동,2380,2331,4711
2022-05-31,우이신설선,정릉,5398,4742,10140
2022-05-31,우이신설선,화계,3769,3462,7231
2022-05-31,일산선,대곡,2478,1927,4405
2022-05-31,일산선,대화,14376,11000,25376
2022-05-31,일산선,마두,8396,8655,17051
2022-05-31,일산선,백석,10884,10871,21755
2022-05-31,일산선,삼송,22952,21576,44528
2022-05-31,일산선,원당,12749,11581,24330
2022-05-31,일산선,원흥,12836,11816,24652
2022-05-31,일산선,정발산,7983,8366,16349
2022-05-31,일산선,주엽,10412,10262,20674
2022-05-31,일산선,화정,18719,19060,37779
2022-05-31,장항선,배방,1430,1382,2812
2022-05-31,장항선,봉명,1422,1410,2832
2022-05-31,장항선,신창,3307,2905,6212
2022-05-31,장항선,쌍용,3526,3218,6744
2022-05-31,장항선,아산,4597,3967,8564
2022-05-31,장항선,온양온천,4218,4426,8644
2022-05-31,장항선,탕정,1084,889,1973
2022-05-31,중앙선,구리,14961,15153,30114
2022-05-31,중앙선,국수,870,895,1765
2022-05-31,중앙선,덕소,6229,6172,12401
2022-05-31,중앙선,도농,12591,11157,23748
2022-05-31,중앙선,도심,2844,2175,5019
2022-05-31,중앙선,망우,8659,8396,17055
2022-05-31,중앙선,상봉,6352,6395,12747
2022-05-31,중앙선,신원,273,229,502
2022-05-31,중앙선,아신,627,607,1234
2022-05-31,중앙선,양수,2245,2273,4518
2022-05-31,중앙선,양원,3389,3164,6553
2022-05-31,중앙선,양정,833,700,1533
2022-05-31,중앙선,양평,3208,3322,6530
2022-05-31,중앙선,오빈,351,354,705
2022-05-31,중앙선,용문,2183,2227,4410
2022-05-31,중앙선,운길산,1067,1075,2142
2022-05-31,중앙선,원덕,472,438,910
2022-05-31,중앙선,중랑,6407,5981,12388
2022-05-31,중앙선,지평,87,100,187
2022-05-31,중앙선,팔당,1033,1080,2113
2022-05-31,중앙선,회기,28496,27282,55778
