사용일자,호선명,지하철역,승차총승객수,하차총승객수,승하차총승객수
20210101,경의선,서울,370,408,778
20210101,경의선,신촌,97,85,182
20210101,경의선,효창공원앞,647,686,1333
20210101,경의선,공덕,821,659,1480
20210101,경의선,서강대,548,495,1043
20210101,경의선,홍대입구,546,577,1123
20210101,경의선,가좌,1296,1238,2534
20210101,경의선,디지털미디어시티,652,554,1206
20210101,경의선,수색,431,434,865
20210101,경의선,화전,312,309,621
20210101,경의선,강매,641,640,1281
20210101,경의선,행신,1693,1782,3475
20210101,경의선,능곡,1025,1033,2058
20210101,경의선,곡산,113,117,230
20210101,경의선,백마,1430,1404,2834
20210101,경의선,풍산,1537,1460,2997
20210101,경의선,일산,2003,2087,4090
20210101,경의선,탄현,1906,1838,3744
20210101,경의선,야당,1730,1651,3381
20210101,경의선,운정,1439,1471,2910
20210101,경의선,금릉,1189,1243,2432
20210101,경의선,금촌,2149,2215,4364
20210101,경의선,월롱,546,491,1037
20210101,경의선,파주,301,283,584
20210101,경의선,문산,1617,1698,3315
20210101,경의선,임진강,25,13,38
20210104,경의선,서울,3370,4096,7466
20210104,경의선,신촌,627,784,1411
20210104,경의선,효창공원앞,2378,2744,5122
20210104,경의선,공덕,2819,2406,5225
20210104,경의선,서강대,1552,1470,3022
20210104,경의선,홍대입구,1120,1212,2332
20210104,경의선,가좌,4199,3966,8165
20210104,경의선,디지털미디어시티,1882,1880,3762
20210104,경의선,수색,2068,2101,4169
20210104,경의선,화전,1076,968,2044
20210104,경의선,강매,2578,2301,4879
20210104,경의선,행신,6072,6213,12285
20210104,경의선,능곡,2948,2654,5602
20210104,경의선,곡산,399,426,825
20210104,경의선,백마,5377,5242,10619
20210104,경의선,풍산,4060,3805,7865
20210104,경의선,일산,7257,7303,14560
20210104,경의선,탄현,5855,5785,11640
20210104,경의선,야당,4608,4360,8968
20210104,경의선,운정,4887,4573,9460
20210104,경의선,금릉,3475,3290,6765
20210104,경의선,금촌,4863,4853,9716
20210104,경의선,월롱,1589,1576,3165
20210104,경의선,파주,747,537,1284
20210104,경의선,문산,3719,3664,7383
20210104,경의선,임진강,6,3,9
20210105,경의선,임진강,7,4,11
20210105,경의선,문산,3661,3609,7270
20210105,경의선,파주,749,559,1308
20210105,경의선,월롱,1573,1461,3034
20210105,경의선,금촌,4683,4668,9351
20210105,경의선,금릉,3415,3256,6671
20210105,경의선,운정,4723,4561,9284
20210105,경의선,야당,4571,4412,8983
20210105,경의선,탄현,5796,5751,11547
20210105,경의선,일산,7133,7201,14334
20210105,경의선,풍산,4081,3899,7980
20210105,경의선,백마,5273,5086,10359
20210105,경의선,곡산,398,428,826
20210105,경의선,능곡,2863,2602,5465
20210105,경의선,행신,6038,5957,11995
20210105,경의선,강매,2571,2262,4833
20210105,경의선,화전,1124,1057,2181
20210105,경의선,수색,2092,2407,4499
20210105,경의선,디지털미디어시티,1966,1866,3832
20210105,경의선,가좌,4295,4251,8546
20210105,경의선,홍대입구,1109,1221,2330
20210105,경의선,서강대,1502,1486,2988
20210105,경의선,공덕,2932,2448,5380
20210105,경의선,효창공원앞,2381,2729,5110
20210105,경의선,신촌,634,729,1363
20210105,경의선,서울,3141,3989,7130
20210106,경의선,임진강,5,2,7
20210106,경의선,문산,3416,3455,6871
20210106,경의선,파주,718,519,1237
20210106,경의선,월롱,1654,1459,3113
20210106,경의선,금촌,4707,4663,9370
20210106,경의선,금릉,3317,3275,6592
20210106,경의선,운정,4689,4733,9422
20210106,경의선,야당,4459,4474,8933
20210106,경의선,탄현,5704,5916,11620
20210106,경의선,일산,6898,7298,14196
20210106,경의선,풍산,4029,4011,8040
20210106,경의선,백마,5191,5319,10510
20210106,경의선,곡산,418,399,817
20210106,경의선,능곡,2850,2749,5599
20210106,경의선,행신,5935,6276,12211
20210106,경의선,강매,2495,2336,4831
20210106,경의선,화전,1095,1052,2147
20210106,경의선,수색,2069,2095,4164
20210106,경의선,디지털미디어시티,1950,2003,3953
20210106,경의선,가좌,4119,4264,8383
20210106,경의선,홍대입구,1130,1201,2331
20210106,경의선,서강대,1520,1481,3001
20210106,경의선,공덕,2969,2546,5515
20210106,경의선,효창공원앞,2449,2943,5392
20210106,경의선,신촌,657,713,1370
20210106,경의선,서울,3197,3772,6969
20210107,경의선,임진강,2,3,5
20210107,경의선,문산,3467,3500,6967
20210107,경의선,파주,652,511,1163
20210107,경의선,월롱,1674,1497,3171
20210107,경의선,금촌,4402,4488,8890
20210107,경의선,금릉,3304,3204,6508
20210107,경의선,운정,4727,4551,9278
20210107,경의선,야당,4564,4423,8987
20210107,경의선,탄현,5807,5804,11611
20210107,경의선,일산,6914,7075,13989
20210107,경의선,풍산,4080,3935,8015
20210107,경의선,백마,5371,5223,10594
20210107,경의선,곡산,410,428,838
20210107,경의선,능곡,2831,2575,5406
20210107,경의선,행신,6177,6280,12457
20210107,경의선,강매,2490,2225,4715
20210107,경의선,화전,1122,1054,2176
20210107,경의선,수색,2028,2123,4151
20210107,경의선,디지털미디어시티,1840,1813,3653
20210107,경의선,가좌,4280,4064,8344
20210107,경의선,홍대입구,1071,1169,2240
20210107,경의선,서강대,1552,1396,2948
20210107,경의선,공덕,2998,2389,5387
20210107,경의선,효창공원앞,2564,2910,5474
20210107,경의선,신촌,593,724,1317
20210107,경의선,서울,3175,3953,7128
20210108,경의선,서울,2975,3686,6661
20210108,경의선,신촌,602,655,1257
20210108,경의선,효창공원앞,2330,2649,4979
20210108,경의선,공덕,2828,2328,5156
20210108,경의선,서강대,1394,1348,2742
20210108,경의선,홍대입구,1096,1155,2251
20210108,경의선,가좌,3852,3647,7499
20210108,경의선,디지털미디어시티,1743,1860,3603
20210108,경의선,수색,1876,1929,3805
20210108,경의선,화전,1009,948,1957
20210108,경의선,강매,2298,2023,4321
20210108,경의선,행신,5862,5951,11813
20210108,경의선,능곡,2576,2367,4943
20210108,경의선,곡산,383,378,761
20210108,경의선,백마,4870,4905,9775
20210108,경의선,풍산,3753,3595,7348
20210108,경의선,일산,6458,6698,13156
20210108,경의선,탄현,5508,5493,11001
20210108,경의선,야당,4208,4163,8371
20210108,경의선,운정,4415,4300,8715
20210108,경의선,금릉,3149,3044,6193
20210108,경의선,금촌,4334,4400,8734
20210108,경의선,월롱,1796,1363,3159
20210108,경의선,파주,674,488,1162
20210108,경의선,문산,3355,3351,6706
20210108,경의선,임진강,3,1,4
20210108,경의선,계양,1,0,1
20210111,경의선,서울,2235,3708,5943
20210111,경의선,신촌,652,750,1402
20210111,경의선,효창공원앞,2445,2772,5217
20210111,경의선,공덕,2834,2445,5279
20210111,경의선,서강대,1560,1504,3064
20210111,경의선,홍대입구,1091,1206,2297
20210111,경의선,가좌,4230,4004,8234
20210111,경의선,디지털미디어시티,1851,1847,3698
20210111,경의선,수색,2047,2071,4118
20210111,경의선,화전,1135,1065,2200
20210111,경의선,강매,2541,2257,4798
20210111,경의선,행신,6028,6096,12124
20210111,경의선,능곡,2872,2671,5543
20210111,경의선,곡산,390,392,782
20210111,경의선,백마,5295,5152,10447
20210111,경의선,풍산,4127,3847,7974
20210111,경의선,일산,7158,7187,14345
20210111,경의선,탄현,5884,5765,11649
20210111,경의선,야당,4750,4516,9266
20210111,경의선,운정,4869,4589,9458
20210111,경의선,금릉,3541,3364,6905
20210111,경의선,금촌,4856,4883,9739
20210111,경의선,월롱,1639,1535,3174
20210111,경의선,파주,746,541,1287
20210111,경의선,문산,3656,3642,7298
20210111,경의선,임진강,8,3,11
20210111,경의선,서울,1048,210,1258
20210112,경의선,계양,1,0,1
20210112,경의선,임진강,10,3,13
20210112,경의선,문산,3795,3808,7603
20210112,경의선,파주,716,562,1278
20210112,경의선,월롱,1909,1523,3432
20210112,경의선,금촌,4894,4964,9858
20210112,경의선,금릉,3556,3470,7026
20210112,경의선,운정,4997,5158,10155
20210112,경의선,야당,4802,4930,9732
20210112,경의선,탄현,6113,6411,12524
20210112,경의선,일산,7425,7951,15376
20210112,경의선,풍산,4374,4386,8760
20210112,경의선,백마,5465,5724,11189
20210112,경의선,곡산,445,450,895
20210112,경의선,능곡,3044,2968,6012
20210112,경의선,행신,6283,6883,13166
20210112,경의선,강매,2525,2384,4909
20210112,경의선,화전,1218,1131,2349
20210112,경의선,수색,2249,2206,4455
20210112,경의선,디지털미디어시티,1983,2038,4021
20210112,경의선,가좌,4498,4749,9247
20210112,경의선,홍대입구,1199,1288,2487
20210112,경의선,서강대,1580,1563,3143
20210112,경의선,공덕,3060,2586,5646
20210112,경의선,효창공원앞,2607,3081,5688
20210112,경의선,신촌,759,769,1528
20210112,경의선,서울,3616,4077,7693
20210113,경의선,가좌,4476,4167,8643
20210113,경의선,화전,1275,1184,2459
20210113,경의선,강매,2643,2319,4962
20210113,경의선,행신,6360,6425,12785
20210113,경의선,능곡,3076,2796,5872
20210113,경의선,곡산,425,446,871
20210113,경의선,백마,5743,5504,11247
20210113,경의선,풍산,4346,4084,8430
20210113,경의선,일산,8012,7948,15960
20210113,경의선,탄현,6265,6100,12365
20210113,경의선,야당,5053,4921,9974
20210113,경의선,운정,5137,4793,9930
20210113,경의선,금릉,3636,3495,7131
20210113,경의선,금촌,4983,5000,9983
20210113,경의선,월롱,1779,1632,3411
20210113,경의선,파주,818,606,1424
20210113,경의선,문산,3866,3806,7672
20210113,경의선,임진강,5,7,12
20210113,경의선,디지털미디어시티,2020,1945,3965
20210113,경의선,홍대입구,1265,1385,2650
20210113,경의선,수색,2147,2199,4346
20210113,경의선,서강대,1599,1533,3132
20210113,경의선,공덕,3058,2632,5690
20210113,경의선,효창공원앞,2577,2937,5514
20210113,경의선,신촌,717,828,1545
20210113,경의선,서울,3486,4279,7765
20210114,경의선,서울,3402,4150,7552
20210114,경의선,신촌,696,787,1483
20210114,경의선,효창공원앞,2420,2881,5301
20210114,경의선,공덕,2969,2590,5559
20210114,경의선,서강대,1528,1480,3008
20210114,경의선,홍대입구,1251,1314,2565
20210114,경의선,가좌,4535,4244,8779
20210114,경의선,디지털미디어시티,2031,1870,3901
20210114,경의선,수색,2142,2167,4309
20210114,경의선,화전,1210,1193,2403
20210114,경의선,강매,2644,2334,4978
20210114,경의선,행신,6313,6271,12584
20210114,경의선,능곡,3024,2801,5825
20210114,경의선,곡산,465,484,949
20210114,경의선,백마,5487,5341,10828
20210114,경의선,풍산,4405,4245,8650
20210114,경의선,일산,7529,7634,15163
20210114,경의선,탄현,6235,6106,12341
20210114,경의선,야당,5058,4865,9923
20210114,경의선,운정,4990,4847,9837
20210114,경의선,금릉,3585,3491,7076
20210114,경의선,금촌,5039,4868,9907
20210114,경의선,월롱,1711,1526,3237
20210114,경의선,파주,776,602,1378
20210114,경의선,문산,4038,3990,8028
20210114,경의선,임진강,9,17,26
20210115,경의선,서울,3427,4211,7638
20210115,경의선,신촌,677,827,1504
20210115,경의선,효창공원앞,2535,2865,5400
20210115,경의선,공덕,2996,2680,5676
20210115,경의선,서강대,1584,1516,3100
20210115,경의선,홍대입구,1215,1408,2623
20210115,경의선,가좌,4686,4405,9091
20210115,경의선,디지털미디어시티,1991,1998,3989
20210115,경의선,수색,2050,2100,4150
20210115,경의선,화전,1156,1101,2257
20210115,경의선,강매,2639,2313,4952
20210115,경의선,행신,6509,6536,13045
20210115,경의선,능곡,3051,2771,5822
20210115,경의선,곡산,442,478,920
20210115,경의선,백마,5484,5300,10784
20210115,경의선,풍산,4384,4207,8591
20210115,경의선,일산,7450,7693,15143
20210115,경의선,탄현,6197,6184,12381
20210115,경의선,야당,5054,4820,9874
20210115,경의선,운정,4983,4795,9778
20210115,경의선,금릉,3638,3573,7211
20210115,경의선,금촌,5186,5283,10469
20210115,경의선,월롱,1984,1511,3495
20210115,경의선,파주,797,593,1390
20210115,경의선,문산,3983,3998,7981
20210115,경의선,임진강,9,1,10
20210118,경의선,임진강,8,6,14
20210118,경의선,문산,4188,4063,8251
20210118,경의선,파주,756,574,1330
20210118,경의선,월롱,1760,1671,3431
20210118,경의선,금촌,5360,5147,10507
20210118,경의선,금릉,3804,3680,7484
20210118,경의선,운정,5455,5118,10573
20210118,경의선,야당,5266,5047,10313
20210118,경의선,탄현,6639,6532,13171
20210118,경의선,일산,8220,8248,16468
20210118,경의선,풍산,4559,4252,8811
20210118,경의선,백마,5955,5791,11746
20210118,경의선,곡산,473,474,947
20210118,경의선,능곡,3162,2867,6029
20210118,경의선,행신,6756,6850,13606
20210118,경의선,강매,2717,2388,5105
20210118,경의선,화전,1259,1211,2470
20210118,경의선,수색,2296,2373,4669
20210118,경의선,디지털미디어시티,2144,2064,4208
20210118,경의선,가좌,4532,4394,8926
20210118,경의선,홍대입구,1187,1303,2490
20210118,경의선,서강대,1648,1553,3201
20210118,경의선,공덕,3068,2726,5794
20210118,경의선,효창공원앞,2659,3043,5702
20210118,경의선,신촌,740,882,1622
20210118,경의선,서울,3517,4529,8046
20210119,경의선,서울,3361,4145,7506
20210119,경의선,신촌,641,789,1430
20210119,경의선,효창공원앞,2511,2907,5418
20210119,경의선,공덕,3147,2563,5710
20210119,경의선,서강대,1629,1534,3163
20210119,경의선,홍대입구,1201,1284,2485
20210119,경의선,가좌,4444,4133,8577
20210119,경의선,디지털미디어시티,2004,1881,3885
20210119,경의선,수색,2158,2194,4352
20210119,경의선,화전,1221,1115,2336
20210119,경의선,강매,2599,2293,4892
20210119,경의선,행신,6428,6457,12885
20210119,경의선,능곡,3020,2738,5758
20210119,경의선,곡산,387,415,802
20210119,경의선,백마,5496,5412,10908
20210119,경의선,풍산,4310,4120,8430
20210119,경의선,일산,7277,7448,14725
20210119,경의선,탄현,6232,6049,12281
20210119,경의선,야당,4884,4742,9626
20210119,경의선,운정,5008,4734,9742
20210119,경의선,금릉,3658,3503,7161
20210119,경의선,금촌,4789,4800,9589
20210119,경의선,월롱,1652,1538,3190
20210119,경의선,파주,744,560,1304
20210119,경의선,문산,3896,3916,7812
20210119,경의선,임진강,12,5,17
20210120,경의선,임진강,13,9,22
20210120,경의선,문산,4116,4020,8136
20210120,경의선,파주,777,598,1375
20210120,경의선,월롱,1764,1572,3336
20210120,경의선,금촌,5207,5180,10387
20210120,경의선,금릉,3873,3722,7595
20210120,경의선,운정,5326,4972,10298
20210120,경의선,야당,5252,5116,10368
20210120,경의선,탄현,6486,6357,12843
20210120,경의선,일산,7922,8088,16010
20210120,경의선,풍산,4658,4367,9025
20210120,경의선,백마,5925,5809,11734
20210120,경의선,곡산,452,470,922
20210120,경의선,능곡,3149,2873,6022
20210120,경의선,행신,6615,6708,13323
20210120,경의선,강매,2757,2468,5225
20210120,경의선,화전,1365,1246,2611
20210120,경의선,수색,2303,2319,4622
20210120,경의선,디지털미디어시티,2124,2045,4169
20210120,경의선,가좌,4707,4406,9113
20210120,경의선,홍대입구,1341,1435,2776
20210120,경의선,서강대,1689,1627,3316
20210120,경의선,공덕,3112,2697,5809
20210120,경의선,효창공원앞,2555,3058,5613
20210120,경의선,신촌,760,890,1650
20210120,경의선,서울,3558,4255,7813
20210121,경의선,임진강,14,3,17
20210121,경의선,문산,3922,3897,7819
20210121,경의선,파주,767,618,1385
20210121,경의선,월롱,1688,1520,3208
20210121,경의선,금촌,5093,5161,10254
20210121,경의선,금릉,3631,3511,7142
20210121,경의선,운정,5157,4787,9944
20210121,경의선,야당,5015,4830,9845
20210121,경의선,탄현,6320,6180,12500
20210121,경의선,일산,7561,7622,15183
20210121,경의선,풍산,4515,4268,8783
20210121,경의선,백마,5642,5555,11197
20210121,경의선,곡산,444,463,907
20210121,경의선,능곡,3084,2781,5865
20210121,경의선,행신,6479,6543,13022
20210121,경의선,강매,2680,2317,4997
20210121,경의선,화전,1223,1151,2374
20210121,경의선,수색,2180,2249,4429
20210121,경의선,디지털미디어시티,2073,2046,4119
20210121,경의선,가좌,4611,4373,8984
20210121,경의선,홍대입구,1207,1346,2553
20210121,경의선,서강대,1578,1588,3166
20210121,경의선,공덕,3034,2611,5645
20210121,경의선,효창공원앞,2513,3027,5540
20210121,경의선,신촌,676,805,1481
20210121,경의선,서울,3304,4184,7488
20210122,경의선,서울,78,59,137
20210122,경의선,임진강,10,5,15
20210122,경의선,문산,4193,4206,8399
20210122,경의선,파주,911,677,1588
20210122,경의선,월롱,2007,1586,3593
20210122,경의선,금촌,5311,5234,10545
20210122,경의선,금릉,3867,3876,7743
20210122,경의선,운정,5272,4997,10269
20210122,경의선,야당,5188,5173,10361
20210122,경의선,탄현,6401,6329,12730
20210122,경의선,일산,7769,7988,15757
20210122,경의선,풍산,4684,4461,9145
20210122,경의선,백마,5895,5714,11609
20210122,경의선,곡산,453,453,906
20210122,경의선,능곡,3193,2938,6131
20210122,경의선,행신,6728,6891,13619
20210122,경의선,강매,2795,2394,5189
20210122,경의선,화전,1276,1180,2456
20210122,경의선,수색,2265,2273,4538
20210122,경의선,디지털미디어시티,2229,2018,4247
20210122,경의선,가좌,4724,4428,9152
20210122,경의선,홍대입구,1394,1509,2903
20210122,경의선,서강대,1706,1597,3303
20210122,경의선,공덕,3137,2735,5872
20210122,경의선,효창공원앞,2561,2996,5557
20210122,경의선,신촌,726,863,1589
20210122,경의선,서울,3473,4454,7927
20210125,경의선,서울,3622,4438,8060
20210125,경의선,신촌,754,828,1582
20210125,경의선,효창공원앞,2680,3069,5749
20210125,경의선,공덕,3151,2785,5936
20210125,경의선,서강대,1760,1682,3442
20210125,경의선,홍대입구,1342,1469,2811
20210125,경의선,가좌,4840,4631,9471
20210125,경의선,디지털미디어시티,2197,2049,4246
20210125,경의선,수색,2395,2464,4859
20210125,경의선,화전,1246,1164,2410
20210125,경의선,강매,2803,2518,5321
20210125,경의선,행신,6739,6885,13624
20210125,경의선,능곡,3264,2968,6232
20210125,경의선,곡산,467,511,978
20210125,경의선,백마,6073,5733,11806
20210125,경의선,풍산,4711,4480,9191
20210125,경의선,일산,8084,8113,16197
20210125,경의선,탄현,6758,6646,13404
20210125,경의선,야당,5314,5187,10501
20210125,경의선,운정,5457,5135,10592
20210125,경의선,금릉,3870,3723,7593
20210125,경의선,금촌,5395,5388,10783
20210125,경의선,월롱,1916,1726,3642
20210125,경의선,파주,839,632,1471
20210125,경의선,문산,4250,4193,8443
20210125,경의선,임진강,10,2,12
20210126,경의선,계양,1,0,1
20210126,경의선,서울,3530,4420,7950
20210126,경의선,신촌,708,857,1565
20210126,경의선,효창공원앞,2534,2969,5503
20210126,경의선,공덕,3155,2712,5867
20210126,경의선,서강대,1684,1645,3329
20210126,경의선,홍대입구,1310,1404,2714
20210126,경의선,가좌,4617,4443,9060
20210126,경의선,디지털미디어시티,2068,2013,4081
20210126,경의선,수색,2317,2332,4649
20210126,경의선,화전,1217,1123,2340
20210126,경의선,강매,2793,2435,5228
20210126,경의선,행신,6759,6805,13564
20210126,경의선,능곡,3211,2927,6138
20210126,경의선,곡산,456,473,929
20210126,경의선,백마,5880,5652,11532
20210126,경의선,풍산,4561,4398,8959
20210126,경의선,일산,7894,8056,15950
20210126,경의선,탄현,6541,6435,12976
20210126,경의선,야당,5262,5117,10379
20210126,경의선,운정,5346,5113,10459
20210126,경의선,금릉,3840,3654,7494
20210126,경의선,금촌,5327,5334,10661
20210126,경의선,월롱,1812,1616,3428
20210126,경의선,파주,769,598,1367
20210126,경의선,문산,4110,4071,8181
20210126,경의선,임진강,8,8,16
20210127,경의선,서울,3681,4531,8212
20210127,경의선,신촌,811,998,1809
20210127,경의선,효창공원앞,2665,3105,5770
20210127,경의선,공덕,3325,2890,6215
20210127,경의선,서강대,1725,1654,3379
20210127,경의선,홍대입구,1388,1542,2930
20210127,경의선,가좌,4837,4630,9467
20210127,경의선,디지털미디어시티,2143,2155,4298
20210127,경의선,수색,2301,2369,4670
20210127,경의선,화전,1255,1114,2369
20210127,경의선,강매,2861,2557,5418
20210127,경의선,행신,6835,6791,13626
20210127,경의선,능곡,3385,3073,6458
20210127,경의선,곡산,493,481,974
20210127,경의선,백마,6081,5868,11949
20210127,경의선,풍산,4680,4447,9127
20210127,경의선,일산,7974,8085,16059
20210127,경의선,탄현,6713,6582,13295
20210127,경의선,야당,5551,5429,10980
20210127,경의선,운정,5482,5298,10780
20210127,경의선,금릉,4042,3851,7893
20210127,경의선,금촌,5576,5540,11116
20210127,경의선,월롱,1899,1646,3545
20210127,경의선,파주,861,640,1501
20210127,경의선,문산,4264,4246,8510
20210127,경의선,임진강,8,8,16
20210128,경의선,행신,6799,6806,13605
20210128,경의선,서울,3614,4566,8180
20210128,경의선,신촌,754,958,1712
20210128,경의선,효창공원앞,2621,3012,5633
20210128,경의선,공덕,3197,2764,5961
20210128,경의선,서강대,1671,1621,3292
20210128,경의선,홍대입구,1259,1400,2659
20210128,경의선,가좌,4781,4443,9224
20210128,경의선,디지털미디어시티,2127,2037,4164
20210128,경의선,수색,2239,2374,4613
20210128,경의선,화전,1253,1167,2420
20210128,경의선,강매,2793,2386,5179
20210128,경의선,능곡,3096,2881,5977
20210128,경의선,곡산,482,476,958
20210128,경의선,백마,6015,5791,11806
20210128,경의선,풍산,4729,4502,9231
20210128,경의선,일산,8189,8291,16480
20210128,경의선,탄현,6643,6504,13147
20210128,경의선,야당,5429,5129,10558
20210128,경의선,운정,5474,5147,10621
20210128,경의선,금릉,3811,3612,7423
20210128,경의선,금촌,5069,5088,10157
20210128,경의선,월롱,1783,1586,3369
20210128,경의선,파주,769,574,1343
20210128,경의선,문산,4022,3975,7997
20210128,경의선,임진강,4,2,6
20210129,경의선,검암,1,0,1
20210129,경의선,서울,3363,4287,7650
20210129,경의선,신촌,677,840,1517
20210129,경의선,효창공원앞,2552,2990,5542
20210129,경의선,공덕,3236,2696,5932
20210129,경의선,서강대,1729,1611,3340
20210129,경의선,홍대입구,1269,1436,2705
20210129,경의선,가좌,4506,4258,8764
20210129,경의선,디지털미디어시티,2058,2012,4070
20210129,경의선,수색,2148,2176,4324
20210129,경의선,화전,1152,1109,2261
20210129,경의선,강매,2664,2340,5004
20210129,경의선,행신,6601,6690,13291
20210129,경의선,능곡,3059,2771,5830
20210129,경의선,곡산,444,406,850
20210129,경의선,백마,5669,5569,11238
20210129,경의선,풍산,4523,4275,8798
20210129,경의선,일산,7465,7539,15004
20210129,경의선,탄현,6347,6343,12690
20210129,경의선,야당,5181,5060,10241
20210129,경의선,운정,5036,4881,9917
20210129,경의선,금릉,3655,3613,7268
20210129,경의선,금촌,5188,5214,10402
20210129,경의선,월롱,1927,1492,3419
20210129,경의선,파주,813,613,1426
20210129,경의선,문산,4161,4066,8227
20210129,경의선,임진강,7,4,11
20210201,경의선,임진강,10,5,15
20210201,경의선,문산,4215,4244,8459
20210201,경의선,파주,869,643,1512
20210201,경의선,월롱,1817,1679,3496
20210201,경의선,금촌,5662,5663,11325
20210201,경의선,금릉,4016,3820,7836
20210201,경의선,운정,5525,5198,10723
20210201,경의선,야당,5483,5324,10807
20210201,경의선,탄현,6745,6581,13326
20210201,경의선,일산,8181,8227,16408
20210201,경의선,풍산,4839,4467,9306
20210201,경의선,백마,6154,5932,12086
20210201,경의선,곡산,468,485,953
20210201,경의선,능곡,3292,3036,6328
20210201,경의선,행신,6860,7017,13877
20210201,경의선,강매,2918,2571,5489
20210201,경의선,화전,1301,1195,2496
20210201,경의선,수색,2391,2406,4797
20210201,경의선,디지털미디어시티,2158,2133,4291
20210201,경의선,가좌,4959,4661,9620
20210201,경의선,홍대입구,1253,1409,2662
20210201,경의선,서강대,1779,1757,3536
20210201,경의선,공덕,3192,2910,6102
20210201,경의선,효창공원앞,2677,3032,5709
20210201,경의선,신촌,760,895,1655
20210201,경의선,서울,3704,4392,8096
20210202,경의선,계양,1,0,1
20210202,경의선,임진강,7,3,10
20210202,경의선,문산,4087,4061,8148
20210202,경의선,파주,776,575,1351
20210202,경의선,월롱,1798,1591,3389
20210202,경의선,금촌,5227,5261,10488
20210202,경의선,금릉,3887,3796,7683
20210202,경의선,운정,5309,5099,10408
20210202,경의선,야당,5400,5171,10571
20210202,경의선,탄현,6687,6642,13329
20210202,경의선,일산,7954,8025,15979
20210202,경의선,풍산,4725,4504,9229
20210202,경의선,백마,5963,5835,11798
20210202,경의선,곡산,471,469,940
20210202,경의선,능곡,3193,2933,6126
20210202,경의선,행신,6759,6849,13608
20210202,경의선,강매,2859,2516,5375
20210202,경의선,화전,1233,1175,2408
20210202,경의선,수색,2274,2376,4650
20210202,경의선,디지털미디어시티,2189,2103,4292
20210202,경의선,가좌,4812,4518,9330
20210202,경의선,홍대입구,1236,1344,2580
20210202,경의선,서강대,1734,1652,3386
20210202,경의선,공덕,3161,2756,5917
20210202,경의선,효창공원앞,2622,3066,5688
20210202,경의선,신촌,744,895,1639
20210202,경의선,서울,3627,4478,8105
20210203,경의선,서울,3752,4644,8396
20210203,경의선,신촌,808,916,1724
20210203,경의선,효창공원앞,2766,3175,5941
20210203,경의선,공덕,2716,2669,5385
20210203,경의선,서강대,1779,1749,3528
20210203,경의선,홍대입구,1397,1490,2887
20210203,경의선,가좌,4948,4841,9789
20210203,경의선,디지털미디어시티,2156,2179,4335
20210203,경의선,수색,2386,2491,4877
20210203,경의선,화전,1295,1171,2466
20210203,경의선,강매,2894,2585,5479
20210203,경의선,행신,7062,7324,14386
20210203,경의선,능곡,3491,3226,6717
20210203,경의선,곡산,516,492,1008
20210203,경의선,백마,6426,6425,12851
20210203,경의선,풍산,5040,4840,9880
20210203,경의선,일산,9089,9394,18483
20210203,경의선,탄현,6898,6950,13848
20210203,경의선,야당,5850,5734,11584
20210203,경의선,운정,5632,5496,11128
20210203,경의선,금릉,4076,3939,8015
20210203,경의선,금촌,5591,5460,11051
20210203,경의선,월롱,2024,1671,3695
20210203,경의선,파주,860,642,1502
20210203,경의선,문산,4184,4154,8338
20210203,경의선,임진강,7,4,11
20210203,경의선,공덕,673,202,875
20210203,경의선,계양,1,0,1
20210204,경의선,서울,3613,4533,8146
20210204,경의선,신촌,823,993,1816
20210204,경의선,효창공원앞,2735,3184,5919
20210204,경의선,공덕,3400,2884,6284
20210204,경의선,서강대,1782,1777,3559
20210204,경의선,홍대입구,1356,1504,2860
20210204,경의선,가좌,4941,4581,9522
20210204,경의선,디지털미디어시티,2266,2201,4467
20210204,경의선,수색,2336,2465,4801
20210204,경의선,화전,1276,1201,2477
20210204,경의선,강매,2927,2552,5479
20210204,경의선,행신,7153,7191,14344
20210204,경의선,능곡,3337,3064,6401
20210204,경의선,곡산,464,485,949
20210204,경의선,백마,6433,6167,12600
20210204,경의선,풍산,5083,4828,9911
20210204,경의선,일산,8274,8269,16543
20210204,경의선,탄현,7043,6859,13902
20210204,경의선,야당,5853,5595,11448
20210204,경의선,운정,5770,5360,11130
20210204,경의선,금릉,4085,3910,7995
20210204,경의선,금촌,5615,5377,10992
20210204,경의선,월롱,1958,1733,3691
20210204,경의선,파주,829,556,1385
20210204,경의선,문산,4346,4373,8719
20210204,경의선,임진강,11,5,16
20210205,경의선,임진강,8,3,11
20210205,경의선,문산,4534,4408,8942
20210205,경의선,파주,886,651,1537
20210205,경의선,월롱,2169,1581,3750
20210205,경의선,금촌,5715,5740,11455
20210205,경의선,금릉,4127,4006,8133
20210205,경의선,운정,5726,5368,11094
20210205,경의선,야당,5753,5735,11488
20210205,경의선,탄현,6909,6797,13706
20210205,경의선,일산,8292,8323,16615
20210205,경의선,풍산,5004,4842,9846
20210205,경의선,백마,6327,6070,12397
20210205,경의선,곡산,476,477,953
20210205,경의선,능곡,3471,3116,6587
20210205,경의선,행신,7054,7117,14171
20210205,경의선,강매,2983,2575,5558
20210205,경의선,화전,1313,1229,2542
20210205,경의선,수색,2324,2421,4745
20210205,경의선,디지털미디어시티,2362,2238,4600
20210205,경의선,가좌,5056,4725,9781
20210205,경의선,홍대입구,1497,1663,3160
20210205,경의선,서강대,1872,1791,3663
20210205,경의선,공덕,3349,2890,6239
20210205,경의선,효창공원앞,2686,3151,5837
20210205,경의선,신촌,784,911,1695
20210205,경의선,서울,3760,4607,8367
20210208,경의선,서울,3568,4610,8178
20210208,경의선,신촌,786,914,1700
20210208,경의선,효창공원앞,2727,3142,5869
20210208,경의선,공덕,3206,2873,6079
20210208,경의선,서강대,1909,1781,3690
20210208,경의선,홍대입구,1335,1451,2786
20210208,경의선,가좌,5079,4821,9900
20210208,경의선,디지털미디어시티,2154,2193,4347
20210208,경의선,수색,2405,2448,4853
20210208,경의선,화전,1373,1244,2617
20210208,경의선,강매,2939,2602,5541
20210208,경의선,행신,7099,7100,14199
20210208,경의선,능곡,3369,3034,6403
20210208,경의선,곡산,493,492,985
20210208,경의선,백마,6381,6150,12531
20210208,경의선,풍산,5038,4719,9757
20210208,경의선,일산,9408,9439,18847
20210208,경의선,탄현,6931,6732,13663
20210208,경의선,야당,5789,5500,11289
20210208,경의선,운정,5712,5348,11060
20210208,경의선,금릉,4118,3985,8103
20210208,경의선,금촌,5507,5457,10964
20210208,경의선,월롱,1925,1775,3700
20210208,경의선,파주,862,664,1526
20210208,경의선,문산,4367,4228,8595
20210208,경의선,임진강,6,4,10
20210209,경의선,임진강,10,4,14
20210209,경의선,문산,4523,4583,9106
20210209,경의선,파주,872,648,1520
20210209,경의선,월롱,2083,1655,3738
20210209,경의선,금촌,5638,5542,11180
20210209,경의선,금릉,4087,3996,8083
20210209,경의선,운정,5614,5304,10918
20210209,경의선,야당,5742,5566,11308
20210209,경의선,탄현,6893,6778,13671
20210209,경의선,일산,8320,8389,16709
20210209,경의선,풍산,5007,4759,9766
20210209,경의선,백마,6343,6174,12517
20210209,경의선,곡산,479,508,987
20210209,경의선,능곡,3510,3067,6577
20210209,경의선,행신,7079,7166,14245
20210209,경의선,강매,2955,2586,5541
20210209,경의선,화전,1336,1183,2519
20210209,경의선,수색,2458,2422,4880
20210209,경의선,디지털미디어시티,2285,2217,4502
20210209,경의선,가좌,5036,4800,9836
20210209,경의선,홍대입구,1448,1528,2976
20210209,경의선,서강대,1924,1783,3707
20210209,경의선,공덕,3310,2894,6204
20210209,경의선,효창공원앞,2707,3180,5887
20210209,경의선,신촌,771,893,1664
20210209,경의선,서울,3569,4537,8106
20210210,경의선,서울,3192,4176,7368
20210210,경의선,신촌,720,852,1572
20210210,경의선,효창공원앞,2436,2817,5253
20210210,경의선,공덕,3046,2709,5755
20210210,경의선,서강대,1838,1695,3533
20210210,경의선,홍대입구,1447,1547,2994
20210210,경의선,가좌,4825,4424,9249
20210210,경의선,디지털미디어시티,2158,2039,4197
20210210,경의선,수색,2192,2193,4385
20210210,경의선,화전,1244,1138,2382
20210210,경의선,강매,2764,2355,5119
20210210,경의선,행신,6718,6454,13172
20210210,경의선,능곡,3176,2847,6023
20210210,경의선,곡산,412,449,861
20210210,경의선,백마,5914,5729,11643
20210210,경의선,풍산,4688,4506,9194
20210210,경의선,일산,7825,7924,15749
20210210,경의선,탄현,6528,6546,13074
20210210,경의선,야당,5483,5446,10929
20210210,경의선,운정,5246,5018,10264
20210210,경의선,금릉,3935,3915,7850
20210210,경의선,금촌,5740,5780,11520
20210210,경의선,월롱,1946,1407,3353
20210210,경의선,파주,899,660,1559
20210210,경의선,문산,4300,4407,8707
20210210,경의선,임진강,4,6,10
20210211,경의선,임진강,24,19,43
20210211,경의선,문산,2346,2903,5249
20210211,경의선,파주,480,424,904
20210211,경의선,월롱,725,644,1369
20210211,경의선,금촌,3573,3791,7364
20210211,경의선,금릉,1914,2083,3997
20210211,경의선,운정,2297,2388,4685
20210211,경의선,야당,2602,2644,5246
20210211,경의선,탄현,2712,2883,5595
20210211,경의선,일산,3159,3454,6613
20210211,경의선,풍산,2239,2346,4585
20210211,경의선,백마,2113,2190,4303
20210211,경의선,곡산,178,164,342
20210211,경의선,능곡,1515,1536,3051
20210211,경의선,행신,2639,2667,5306
20210211,경의선,강매,1037,922,1959
20210211,경의선,화전,528,486,1014
20210211,경의선,수색,620,609,1229
20210211,경의선,디지털미디어시티,968,835,1803
20210211,경의선,가좌,2074,1781,3855
20210211,경의선,홍대입구,891,791,1682
20210211,경의선,서강대,921,702,1623
20210211,경의선,공덕,1076,871,1947
20210211,경의선,효창공원앞,954,931,1885
20210211,경의선,신촌,198,189,387
20210211,경의선,서울,648,653,1301
20210212,경의선,서울,568,531,1099
20210212,경의선,신촌,136,124,260
20210212,경의선,효창공원앞,706,799,1505
20210212,경의선,공덕,757,786,1543
20210212,경의선,서강대,560,570,1130
20210212,경의선,홍대입구,592,736,1328
20210212,경의선,가좌,1457,1403,2860
20210212,경의선,디지털미디어시티,774,692,1466
20210212,경의선,수색,468,518,986
20210212,경의선,화전,364,338,702
20210212,경의선,강매,762,736,1498
20210212,경의선,행신,2075,2132,4207
20210212,경의선,능곡,1227,1191,2418
20210212,경의선,곡산,165,119,284
20210212,경의선,백마,1543,1477,3020
20210212,경의선,풍산,1620,1584,3204
20210212,경의선,일산,2353,2298,4651
20210212,경의선,탄현,2176,2132,4308
20210212,경의선,야당,2049,2055,4104
20210212,경의선,운정,1843,1767,3610
20210212,경의선,금릉,1576,1482,3058
20210212,경의선,금촌,2935,2816,5751
20210212,경의선,월롱,518,545,1063
20210212,경의선,파주,438,351,789
20210212,경의선,문산,2368,2158,4526
20210212,경의선,임진강,47,47,94
20210215,경의선,임진강,8,2,10
20210215,경의선,문산,4331,4320,8651
20210215,경의선,파주,930,705,1635
20210215,경의선,월롱,1667,1716,3383
20210215,경의선,금촌,5541,5496,11037
20210215,경의선,금릉,4044,3861,7905
20210215,경의선,운정,5561,5188,10749
20210215,경의선,야당,5638,5415,11053
20210215,경의선,탄현,6904,6596,13500
20210215,경의선,일산,8150,8069,16219
20210215,경의선,풍산,4714,4356,9070
20210215,경의선,백마,6212,5915,12127
20210215,경의선,곡산,474,461,935
20210215,경의선,능곡,3264,2931,6195
20210215,경의선,행신,7016,7042,14058
20210215,경의선,강매,2828,2463,5291
20210215,경의선,화전,1255,1212,2467
20210215,경의선,수색,2264,2375,4639
20210215,경의선,디지털미디어시티,2089,2094,4183
20210215,경의선,가좌,4700,4593,9293
20210215,경의선,홍대입구,1280,1467,2747
20210215,경의선,서강대,1802,1817,3619
20210215,경의선,공덕,3097,2784,5881
20210215,경의선,효창공원앞,2654,3063,5717
20210215,경의선,신촌,803,923,1726
20210215,경의선,서울,3578,4516,8094
20210216,경의선,임진강,12,6,18
20210216,경의선,문산,4471,4382,8853
20210216,경의선,파주,887,678,1565
20210216,경의선,월롱,1935,1848,3783
20210216,경의선,금촌,5656,5562,11218
20210216,경의선,금릉,4068,3917,7985
20210216,경의선,운정,5635,5402,11037
20210216,경의선,야당,5698,5486,11184
20210216,경의선,탄현,6967,6792,13759
20210216,경의선,일산,8185,8385,16570
20210216,경의선,풍산,4845,4544,9389
20210216,경의선,백마,6340,6060,12400
20210216,경의선,곡산,475,471,946
20210216,경의선,능곡,3205,2936,6141
20210216,경의선,행신,7132,7115,14247
20210216,경의선,강매,2878,2494,5372
20210216,경의선,화전,1306,1194,2500
20210216,경의선,수색,2319,2402,4721
20210216,경의선,디지털미디어시티,2222,2147,4369
20210216,경의선,가좌,4846,4693,9539
20210216,경의선,홍대입구,1374,1531,2905
20210216,경의선,서강대,1790,1865,3655
20210216,경의선,공덕,3330,2865,6195
20210216,경의선,효창공원앞,2726,3109,5835
20210216,경의선,신촌,830,949,1779
20210216,경의선,서울,3878,4690,8568
20210216,경의선,계양,1,0,1
20210217,경의선,서울,3718,4653,8371
20210217,경의선,신촌,799,941,1740
20210217,경의선,효창공원앞,2691,3125,5816
20210217,경의선,공덕,3342,2816,6158
20210217,경의선,서강대,1759,1717,3476
20210217,경의선,홍대입구,1350,1480,2830
20210217,경의선,가좌,4679,4558,9237
20210217,경의선,디지털미디어시티,2167,2157,4324
20210217,경의선,수색,2244,2394,4638
20210217,경의선,화전,1263,1169,2432
20210217,경의선,강매,2834,2448,5282
20210217,경의선,행신,6893,7061,13954
20210217,경의선,능곡,3240,2859,6099
20210217,경의선,곡산,454,455,909
20210217,경의선,백마,6060,5920,11980
20210217,경의선,풍산,4699,4411,9110
20210217,경의선,일산,7968,8148,16116
20210217,경의선,탄현,6713,6441,13154
20210217,경의선,야당,5442,5344,10786
20210217,경의선,운정,5393,5049,10442
20210217,경의선,금릉,3932,3793,7725
20210217,경의선,금촌,5268,5109,10377
20210217,경의선,월롱,1884,1603,3487
20210217,경의선,파주,824,662,1486
20210217,경의선,문산,4187,4066,8253
20210217,경의선,임진강,11,8,19
20210217,경의선,김포공항,1,0,1
20210218,경의선,임진강,6,4,10
20210218,경의선,문산,4219,4224,8443
20210218,경의선,파주,866,645,1511
20210218,경의선,월롱,1885,1682,3567
20210218,경의선,금촌,5465,5422,10887
20210218,경의선,금릉,4091,3957,8048
20210218,경의선,운정,5550,5210,10760
20210218,경의선,야당,5760,5605,11365
20210218,경의선,탄현,6854,6698,13552
20210218,경의선,일산,8568,8474,17042
20210218,경의선,풍산,4989,4671,9660
20210218,경의선,백마,6240,5960,12200
20210218,경의선,곡산,480,490,970
20210218,경의선,능곡,3248,2952,6200
20210218,경의선,행신,6959,7001,13960
20210218,경의선,강매,2912,2502,5414
20210218,경의선,화전,1324,1291,2615
20210218,경의선,수색,2269,2435,4704
20210218,경의선,디지털미디어시티,2228,2142,4370
20210218,경의선,가좌,4830,4553,9383
20210218,경의선,홍대입구,1449,1596,3045
20210218,경의선,서강대,1804,1794,3598
20210218,경의선,공덕,3480,2931,6411
20210218,경의선,효창공원앞,2677,3050,5727
20210218,경의선,신촌,801,984,1785
20210218,경의선,서울,3731,4754,8485
20210219,경의선,서울,3896,4976,8872
20210219,경의선,신촌,803,1004,1807
20210219,경의선,효창공원앞,2744,3206,5950
20210219,경의선,공덕,3562,3043,6605
20210219,경의선,서강대,1970,1983,3953
20210219,경의선,홍대입구,1602,1866,3468
20210219,경의선,가좌,5285,4984,10269
20210219,경의선,디지털미디어시티,2353,2326,4679
20210219,경의선,수색,2329,2421,4750
20210219,경의선,화전,1628,1590,3218
20210219,경의선,강매,2962,2584,5546
20210219,경의선,행신,7519,7567,15086
20210219,경의선,능곡,3512,3112,6624
20210219,경의선,곡산,486,501,987
20210219,경의선,백마,6400,6152,12552
20210219,경의선,풍산,5029,4755,9784
20210219,경의선,일산,8394,8538,16932
20210219,경의선,탄현,7151,6921,14072
20210219,경의선,야당,6068,5931,11999
20210219,경의선,운정,5889,5494,11383
20210219,경의선,금릉,4305,4225,8530
20210219,경의선,금촌,5926,5858,11784
20210219,경의선,월롱,2204,1715,3919
20210219,경의선,파주,997,710,1707
20210219,경의선,문산,4934,4728,9662
20210219,경의선,임진강,9,2,11
20210222,경의선,서울,3862,5112,8974
20210222,경의선,신촌,808,991,1799
20210222,경의선,효창공원앞,2774,3144,5918
20210222,경의선,공덕,3353,3041,6394
20210222,경의선,서강대,1938,1817,3755
20210222,경의선,홍대입구,1472,1598,3070
20210222,경의선,가좌,5057,4841,9898
20210222,경의선,디지털미디어시티,2309,2263,4572
20210222,경의선,수색,2540,2615,5155
20210222,경의선,화전,1321,1210,2531
20210222,경의선,강매,3023,2661,5684
20210222,경의선,행신,7360,7416,14776
20210222,경의선,능곡,3637,3297,6934
20210222,경의선,곡산,477,506,983
20210222,경의선,백마,6530,6247,12777
20210222,경의선,풍산,5218,4878,10096
20210222,경의선,일산,8698,8757,17455
20210222,경의선,탄현,7295,7043,14338
20210222,경의선,야당,6081,5911,11992
20210222,경의선,운정,5979,5566,11545
20210222,경의선,금릉,4321,4118,8439
20210222,경의선,금촌,5943,5932,11875
20210222,경의선,월롱,1914,1806,3720
20210222,경의선,파주,969,762,1731
20210222,경의선,문산,4823,4620,9443
20210222,경의선,임진강,8,2,10
20210223,경의선,임진강,14,16,30
20210223,경의선,문산,4485,4500,8985
20210223,경의선,파주,908,695,1603
20210223,경의선,월롱,1955,1731,3686
20210223,경의선,금촌,5708,5652,11360
20210223,경의선,금릉,4335,4169,8504
20210223,경의선,운정,5921,5584,11505
20210223,경의선,야당,6143,5979,12122
20210223,경의선,탄현,7222,6954,14176
20210223,경의선,일산,9411,9532,18943
20210223,경의선,풍산,5229,4976,10205
20210223,경의선,백마,6621,6505,13126
20210223,경의선,곡산,487,526,1013
20210223,경의선,능곡,3422,3140,6562
20210223,경의선,행신,7440,7322,14762
20210223,경의선,강매,2997,2662,5659
20210223,경의선,화전,1328,1237,2565
20210223,경의선,수색,2519,2530,5049
20210223,경의선,디지털미디어시티,2285,2215,4500
20210223,경의선,가좌,5131,4831,9962
20210223,경의선,홍대입구,1406,1652,3058
20210223,경의선,서강대,1864,1851,3715
20210223,경의선,공덕,3479,3025,6504
20210223,경의선,효창공원앞,2786,3103,5889
20210223,경의선,신촌,799,967,1766
20210223,경의선,서울,3824,4855,8679
20210224,경의선,검암,1,0,1
20210224,경의선,임진강,11,4,15
20210224,경의선,문산,4853,4863,9716
20210224,경의선,파주,975,717,1692
20210224,경의선,월롱,2069,1785,3854
20210224,경의선,금촌,5903,6000,11903
20210224,경의선,금릉,4411,4224,8635
20210224,경의선,운정,5952,5617,11569
20210224,경의선,야당,6213,5913,12126
20210224,경의선,탄현,7270,6954,14224
20210224,경의선,일산,8642,8744,17386
20210224,경의선,풍산,5064,4795,9859
20210224,경의선,백마,6637,6392,13029
20210224,경의선,곡산,516,516,1032
20210224,경의선,능곡,3571,3212,6783
20210224,경의선,행신,7315,7369,14684
20210224,경의선,강매,3065,2740,5805
20210224,경의선,화전,1330,1235,2565
20210224,경의선,수색,2501,2618,5119
20210224,경의선,디지털미디어시티,2421,2328,4749
20210224,경의선,가좌,5140,4801,9941
20210224,경의선,홍대입구,1508,1627,3135
20210224,경의선,서강대,1943,1868,3811
20210224,경의선,공덕,3456,2926,6382
20210224,경의선,효창공원앞,2706,3126,5832
20210224,경의선,신촌,805,1030,1835
20210224,경의선,서울,4112,5052,9164
20210225,경의선,서울,4024,4925,8949
20210225,경의선,신촌,828,970,1798
20210225,경의선,효창공원앞,2800,3155,5955
20210225,경의선,공덕,3438,2960,6398
20210225,경의선,서강대,1888,1926,3814
20210225,경의선,홍대입구,1481,1717,3198
20210225,경의선,가좌,5067,4824,9891
20210225,경의선,디지털미디어시티,2365,2299,4664
20210225,경의선,수색,2576,2699,5275
20210225,경의선,화전,1298,1258,2556
20210225,경의선,강매,3011,2635,5646
20210225,경의선,행신,7386,7422,14808
20210225,경의선,능곡,3547,3164,6711
20210225,경의선,곡산,492,500,992
20210225,경의선,백마,6543,6340,12883
20210225,경의선,풍산,5217,4890,10107
20210225,경의선,일산,8712,8806,17518
20210225,경의선,탄현,7239,7132,14371
20210225,경의선,야당,6238,5931,12169
20210225,경의선,운정,6006,5649,11655
20210225,경의선,금릉,4294,4182,8476
20210225,경의선,금촌,5795,5721,11516
20210225,경의선,월롱,2052,1730,3782
20210225,경의선,파주,956,763,1719
20210225,경의선,문산,4549,4478,9027
20210225,경의선,임진강,21,3,24
20210226,경의선,서울,3989,5242,9231
20210226,경의선,신촌,781,1027,1808
20210226,경의선,효창공원앞,2805,3178,5983
20210226,경의선,공덕,3588,3159,6747
20210226,경의선,서강대,1992,2014,4006
20210226,경의선,홍대입구,1542,1800,3342
20210226,경의선,가좌,5452,5051,10503
20210226,경의선,디지털미디어시티,2531,2329,4860
20210226,경의선,수색,2594,2635,5229
20210226,경의선,화전,1432,1350,2782
20210226,경의선,강매,3069,2683,5752
20210226,경의선,행신,7830,7775,15605
20210226,경의선,능곡,3618,3246,6864
20210226,경의선,곡산,531,525,1056
20210226,경의선,백마,6733,6476,13209
20210226,경의선,풍산,5392,5031,10423
20210226,경의선,일산,9005,8964,17969
20210226,경의선,탄현,7561,7306,14867
20210226,경의선,야당,6405,6426,12831
20210226,경의선,운정,6171,5763,11934
20210226,경의선,금릉,4598,4511,9109
20210226,경의선,금촌,6524,6478,13002
20210226,경의선,월롱,2293,1812,4105
20210226,경의선,파주,1054,771,1825
20210226,경의선,문산,4921,4782,9703
20210226,경의선,임진강,17,14,31
20210226,경의선,서울,82,101,183
20210226,경의선,홍대입구,206,221,427
20210301,경의선,서울,822,720,1542
20210301,경의선,신촌,197,213,410
20210301,경의선,효창공원앞,943,1162,2105
20210301,경의선,공덕,1245,979,2224
20210301,경의선,서강대,855,864,1719
20210301,경의선,홍대입구,758,880,1638
20210301,경의선,가좌,1931,2051,3982
20210301,경의선,디지털미디어시티,1034,897,1931
20210301,경의선,수색,683,744,1427
20210301,경의선,화전,643,639,1282
20210301,경의선,강매,901,877,1778
20210301,경의선,행신,3174,3083,6257
20210301,경의선,능곡,1422,1405,2827
20210301,경의선,곡산,186,170,356
20210301,경의선,백마,2366,2249,4615
20210301,경의선,풍산,2303,2181,4484
20210301,경의선,일산,3228,3120,6348
20210301,경의선,탄현,3100,2876,5976
20210301,경의선,야당,2651,2520,5171
20210301,경의선,운정,2315,2249,4564
20210301,경의선,금릉,1809,1773,3582
20210301,경의선,금촌,2880,2931,5811
20210301,경의선,월롱,607,1080,1687
20210301,경의선,파주,418,344,762
20210301,경의선,문산,2228,2298,4526
20210301,경의선,임진강,9,11,20
20210302,경의선,임진강,9,5,14
20210302,경의선,문산,4801,4704,9505
20210302,경의선,파주,1619,1242,2861
20210302,경의선,월롱,2735,2609,5344
20210302,경의선,금촌,6062,6152,12214
20210302,경의선,금릉,4376,4235,8611
20210302,경의선,운정,6195,5847,12042
20210302,경의선,야당,6179,5963,12142
20210302,경의선,탄현,7400,7199,14599
20210302,경의선,일산,9200,9197,18397
20210302,경의선,풍산,5284,4879,10163
20210302,경의선,백마,6672,6337,13009
20210302,경의선,곡산,502,522,1024
20210302,경의선,능곡,3690,3320,7010
20210302,경의선,행신,7486,7622,15108
20210302,경의선,강매,3029,2668,5697
20210302,경의선,화전,1865,1719,3584
20210302,경의선,수색,2616,2659,5275
20210302,경의선,디지털미디어시티,2312,2253,4565
20210302,경의선,가좌,5093,4853,9946
20210302,경의선,홍대입구,1401,1473,2874
20210302,경의선,서강대,1845,1883,3728
20210302,경의선,공덕,3453,2995,6448
20210302,경의선,효창공원앞,2882,3259,6141
20210302,경의선,신촌,782,1032,1814
20210302,경의선,서울,4016,4995,9011
20210303,경의선,서울,4017,5103,9120
20210303,경의선,신촌,830,995,1825
20210303,경의선,효창공원앞,2915,3330,6245
20210303,경의선,공덕,3401,2980,6381
20210303,경의선,서강대,1916,1839,3755
20210303,경의선,홍대입구,1390,1541,2931
20210303,경의선,가좌,5364,5023,10387
20210303,경의선,디지털미디어시티,2391,2399,4790
20210303,경의선,수색,2632,2714,5346
20210303,경의선,화전,1958,1815,3773
20210303,경의선,강매,3138,2764,5902
20210303,경의선,행신,7593,7609,15202
20210303,경의선,능곡,3724,3315,7039
20210303,경의선,곡산,567,584,1151
20210303,경의선,백마,6913,6634,13547
20210303,경의선,풍산,5307,5078,10385
20210303,경의선,일산,9810,9791,19601
20210303,경의선,탄현,7427,7293,14720
20210303,경의선,야당,6264,6087,12351
20210303,경의선,운정,6232,5853,12085
20210303,경의선,금릉,4398,4283,8681
20210303,경의선,금촌,6001,5901,11902
20210303,경의선,월롱,2606,2322,4928
20210303,경의선,파주,1562,1192,2754
20210303,경의선,문산,4782,4677,9459
20210303,경의선,임진강,19,7,26
20210304,경의선,서울,3919,4977,8896
20210304,경의선,신촌,855,1037,1892
20210304,경의선,효창공원앞,2777,3264,6041
20210304,경의선,공덕,3392,3020,6412
20210304,경의선,서강대,1880,1861,3741
20210304,경의선,홍대입구,1428,1563,2991
20210304,경의선,가좌,5335,4963,10298
20210304,경의선,디지털미디어시티,2483,2367,4850
20210304,경의선,수색,2617,2807,5424
20210304,경의선,화전,1779,1627,3406
20210304,경의선,강매,3106,2699,5805
20210304,경의선,행신,7519,7607,15126
20210304,경의선,능곡,3707,3327,7034
20210304,경의선,곡산,565,596,1161
20210304,경의선,백마,6792,6504,13296
20210304,경의선,풍산,5390,5049,10439
20210304,경의선,일산,9083,9013,18096
20210304,경의선,탄현,7374,7193,14567
20210304,경의선,야당,6253,6163,12416
20210304,경의선,운정,6104,5810,11914
20210304,경의선,금릉,4379,4355,8734
20210304,경의선,금촌,5978,5934,11912
20210304,경의선,월롱,2819,2443,5262
20210304,경의선,파주,1509,1155,2664
20210304,경의선,문산,5093,5052,10145
20210304,경의선,임진강,10,8,18
20210304,경의선,계양,1,0,1
20210305,경의선,계양,1,0,1
20210305,경의선,임진강,12,5,17
20210305,경의선,문산,5138,5004,10142
20210305,경의선,파주,1311,924,2235
20210305,경의선,월롱,2466,1895,4361
20210305,경의선,금촌,6474,6276,12750
20210305,경의선,금릉,4566,4638,9204
20210305,경의선,운정,6367,6089,12456
20210305,경의선,야당,6534,6586,13120
20210305,경의선,탄현,7697,7533,15230
20210305,경의선,일산,9243,9427,18670
20210305,경의선,풍산,5511,5307,10818
20210305,경의선,백마,6991,6690,13681
20210305,경의선,곡산,574,602,1176
20210305,경의선,능곡,3831,3401,7232
20210305,경의선,행신,8108,8120,16228
20210305,경의선,강매,3189,2765,5954
20210305,경의선,화전,1878,1698,3576
20210305,경의선,수색,2686,2718,5404
20210305,경의선,디지털미디어시티,2505,2403,4908
20210305,경의선,가좌,5512,5159,10671
20210305,경의선,홍대입구,1657,1871,3528
20210305,경의선,서강대,2098,2065,4163
20210305,경의선,공덕,3614,3279,6893
20210305,경의선,효창공원앞,2968,3424,6392
20210305,경의선,신촌,903,1122,2025
20210305,경의선,서울,4195,5378,9573
20210308,경의선,서울,4254,5199,9453
20210308,경의선,신촌,837,1044,1881
20210308,경의선,효창공원앞,2922,3217,6139
20210308,경의선,공덕,3345,3054,6399
20210308,경의선,서강대,2017,1960,3977
20210308,경의선,홍대입구,1417,1589,3006
20210308,경의선,가좌,5358,4952,10310
20210308,경의선,디지털미디어시티,2398,2317,4715
20210308,경의선,수색,2708,2805,5513
20210308,경의선,화전,1801,1650,3451
20210308,경의선,강매,3188,2761,5949
20210308,경의선,행신,7551,7756,15307
20210308,경의선,능곡,3800,3486,7286
20210308,경의선,곡산,650,627,1277
20210308,경의선,백마,7014,6807,13821
20210308,경의선,풍산,5481,5062,10543
20210308,경의선,일산,10311,10349,20660
20210308,경의선,탄현,7530,7254,14784
20210308,경의선,야당,6414,6284,12698
20210308,경의선,운정,6326,6068,12394
20210308,경의선,금릉,4444,4257,8701
20210308,경의선,금촌,6202,6155,12357
20210308,경의선,월롱,2550,2495,5045
20210308,경의선,파주,1693,1312,3005
20210308,경의선,문산,4930,4789,9719
20210308,경의선,임진강,8,3,11
20210309,경의선,서울,4081,5367,9448
20210309,경의선,신촌,821,1051,1872
20210309,경의선,효창공원앞,2876,3262,6138
20210309,경의선,공덕,3542,3200,6742
20210309,경의선,서강대,2014,1959,3973
20210309,경의선,홍대입구,1478,1596,3074
20210309,경의선,가좌,5330,4878,10208
20210309,경의선,디지털미디어시티,2457,2317,4774
20210309,경의선,수색,2650,2767,5417
20210309,경의선,화전,2180,2004,4184
20210309,경의선,강매,3273,2850,6123
20210309,경의선,행신,7578,7663,15241
20210309,경의선,능곡,3760,3458,7218
20210309,경의선,곡산,609,621,1230
20210309,경의선,백마,6911,6685,13596
20210309,경의선,풍산,5391,5048,10439
20210309,경의선,일산,9310,9316,18626
20210309,경의선,탄현,7585,7344,14929
20210309,경의선,야당,6289,6148,12437
20210309,경의선,운정,6338,5985,12323
20210309,경의선,금릉,4393,4334,8727
20210309,경의선,금촌,6129,6068,12197
20210309,경의선,월롱,2703,2486,5189
20210309,경의선,파주,1737,1326,3063
20210309,경의선,문산,5311,5176,10487
20210309,경의선,임진강,11,12,23
20210310,경의선,서울,4150,5334,9484
20210310,경의선,신촌,838,1077,1915
20210310,경의선,효창공원앞,2928,3297,6225
20210310,경의선,공덕,3428,3114,6542
20210310,경의선,서강대,1947,1893,3840
20210310,경의선,홍대입구,1510,1700,3210
20210310,경의선,가좌,5256,4879,10135
20210310,경의선,디지털미디어시티,2484,2381,4865
20210310,경의선,수색,2640,2769,5409
20210310,경의선,화전,2006,1854,3860
20210310,경의선,강매,3234,2809,6043
20210310,경의선,행신,7688,7696,15384
20210310,경의선,능곡,3809,3332,7141
20210310,경의선,곡산,596,627,1223
20210310,경의선,백마,6994,6664,13658
20210310,경의선,풍산,5287,4997,10284
20210310,경의선,일산,9241,9320,18561
20210310,경의선,탄현,7544,7273,14817
20210310,경의선,야당,6486,6355,12841
20210310,경의선,운정,6252,5940,12192
20210310,경의선,금릉,4484,4406,8890
20210310,경의선,금촌,6095,6049,12144
20210310,경의선,월롱,2615,2309,4924
20210310,경의선,파주,1599,1221,2820
20210310,경의선,문산,4938,4808,9746
20210310,경의선,임진강,9,5,14
20210311,경의선,서울,4113,5326,9439
20210311,경의선,신촌,882,1099,1981
20210311,경의선,효창공원앞,2919,3273,6192
20210311,경의선,공덕,3375,3006,6381
20210311,경의선,서강대,1947,1959,3906
20210311,경의선,홍대입구,1447,1621,3068
20210311,경의선,가좌,5261,5008,10269
20210311,경의선,디지털미디어시티,2474,2366,4840
20210311,경의선,수색,2572,2726,5298
20210311,경의선,화전,2010,1891,3901
20210311,경의선,강매,3203,2745,5948
20210311,경의선,행신,7641,7594,15235
20210311,경의선,능곡,3733,3375,7108
20210311,경의선,곡산,595,626,1221
20210311,경의선,백마,6954,6596,13550
20210311,경의선,풍산,5397,5200,10597
20210311,경의선,일산,9410,9383,18793
20210311,경의선,탄현,7566,7312,14878
20210311,경의선,야당,6466,6499,12965
20210311,경의선,운정,6448,6033,12481
20210311,경의선,금릉,4388,4351,8739
20210311,경의선,금촌,6447,6452,12899
20210311,경의선,월롱,2733,2433,5166
20210311,경의선,파주,1528,1133,2661
20210311,경의선,문산,4931,4992,9923
20210311,경의선,임진강,12,9,21
20210311,경의선,계양,1,0,1
20210312,경의선,서울,4213,5406,9619
20210312,경의선,신촌,866,1100,1966
20210312,경의선,효창공원앞,2875,3330,6205
20210312,경의선,공덕,3568,3216,6784
20210312,경의선,서강대,2041,2029,4070
20210312,경의선,홍대입구,1665,1938,3603
20210312,경의선,가좌,5518,5204,10722
20210312,경의선,디지털미디어시티,2572,2511,5083
20210312,경의선,수색,2599,2675,5274
20210312,경의선,화전,1942,1689,3631
20210312,경의선,강매,3110,2753,5863
20210312,경의선,행신,7976,8059,16035
20210312,경의선,능곡,3769,3421,7190
20210312,경의선,곡산,581,600,1181
20210312,경의선,백마,7032,6787,13819
20210312,경의선,풍산,5575,5341,10916
20210312,경의선,일산,9360,9501,18861
20210312,경의선,탄현,7543,7462,15005
20210312,경의선,야당,6602,6481,13083
20210312,경의선,운정,6359,6240,12599
20210312,경의선,금릉,4663,4550,9213
20210312,경의선,금촌,6319,6082,12401
20210312,경의선,월롱,2445,1933,4378
20210312,경의선,파주,1334,899,2233
20210312,경의선,문산,5169,5034,10203
20210312,경의선,임진강,12,10,22
20210315,경의선,서울,4262,5387,9649
20210315,경의선,신촌,828,1053,1881
20210315,경의선,효창공원앞,2768,3256,6024
20210315,경의선,공덕,3399,3111,6510
20210315,경의선,서강대,1980,1914,3894
20210315,경의선,홍대입구,1438,1599,3037
20210315,경의선,가좌,5286,4905,10191
20210315,경의선,디지털미디어시티,2447,2320,4767
20210315,경의선,수색,2729,2772,5501
20210315,경의선,화전,1811,1695,3506
20210315,경의선,강매,3200,2789,5989
20210315,경의선,행신,7658,7715,15373
20210315,경의선,능곡,3774,3374,7148
20210315,경의선,곡산,634,631,1265
20210315,경의선,백마,6917,6614,13531
20210315,경의선,풍산,5379,5027,10406
20210315,경의선,일산,9310,9239,18549
20210315,경의선,탄현,7567,7198,14765
20210315,경의선,야당,6402,6219,12621
20210315,경의선,운정,6480,6060,12540
20210315,경의선,금릉,4418,4293,8711
20210315,경의선,금촌,6195,6080,12275
20210315,경의선,월롱,2554,2499,5053
20210315,경의선,파주,1656,1272,2928
20210315,경의선,문산,4896,4831,9727
20210315,경의선,임진강,22,7,29
20210316,경의선,서울,4145,5285,9430
20210316,경의선,신촌,861,1138,1999
20210316,경의선,효창공원앞,2864,3309,6173
20210316,경의선,공덕,3496,3030,6526
20210316,경의선,서강대,2009,1963,3972
20210316,경의선,홍대입구,1403,1612,3015
20210316,경의선,가좌,5283,4893,10176
20210316,경의선,디지털미디어시티,2408,2315,4723
20210316,경의선,수색,2749,2863,5612
20210316,경의선,화전,2128,1858,3986
20210316,경의선,강매,3263,2840,6103
20210316,경의선,행신,7595,7742,15337
20210316,경의선,능곡,3750,3372,7122
20210316,경의선,곡산,592,624,1216
20210316,경의선,백마,6937,6727,13664
20210316,경의선,풍산,5430,5092,10522
20210316,경의선,일산,9411,9307,18718
20210316,경의선,탄현,7564,7328,14892
20210316,경의선,야당,6425,6425,12850
20210316,경의선,운정,6477,6195,12672
20210316,경의선,금릉,4449,4325,8774
20210316,경의선,금촌,6409,6543,12952
20210316,경의선,월롱,2798,2459,5257
20210316,경의선,파주,1656,1258,2914
20210316,경의선,문산,4938,5004,9942
20210316,경의선,임진강,22,8,30
20210317,경의선,서울,4131,5383,9514
20210317,경의선,신촌,918,1133,2051
20210317,경의선,효창공원앞,2856,3317,6173
20210317,경의선,공덕,3552,3116,6668
20210317,경의선,서강대,2044,2044,4088
20210317,경의선,홍대입구,1594,1673,3267
20210317,경의선,일산,9474,9466,18940
20210317,경의선,탄현,7577,7264,14841
20210317,경의선,야당,6586,6470,13056
20210317,경의선,운정,6514,6088,12602
20210317,경의선,금릉,4523,4478,9001
20210317,경의선,금촌,6299,6010,12309
20210317,경의선,월롱,2638,2337,4975
20210317,경의선,파주,1541,1196,2737
20210317,경의선,문산,5034,4901,9935
20210317,경의선,임진강,14,7,21
20210317,경의선,풍산,5533,5177,10710
20210317,경의선,백마,7031,6815,13846
20210317,경의선,곡산,629,672,1301
20210317,경의선,능곡,3834,3509,7343
20210317,경의선,행신,7701,7709,15410
20210317,경의선,강매,3195,2851,6046
20210317,경의선,화전,1971,1858,3829
20210317,경의선,수색,2678,2844,5522
20210317,경의선,디지털미디어시티,2543,2382,4925
20210317,경의선,가좌,5416,5014,10430
20210318,경의선,계양,1,0,1
20210318,경의선,임진강,17,9,26
20210318,경의선,문산,4954,5174,10128
20210318,경의선,파주,1551,1172,2723
20210318,경의선,월롱,2665,2460,5125
20210318,경의선,금촌,6136,5952,12088
20210318,경의선,금릉,4495,4408,8903
20210318,경의선,운정,6522,6341,12863
20210318,경의선,야당,6732,6492,13224
20210318,경의선,탄현,7660,7424,15084
20210318,경의선,일산,10686,10699,21385
20210318,경의선,풍산,5563,5245,10808
20210318,경의선,백마,6989,6840,13829
20210318,경의선,곡산,616,670,1286
20210318,경의선,능곡,3930,3531,7461
20210318,경의선,행신,7810,7682,15492
20210318,경의선,강매,3160,2804,5964
20210318,경의선,화전,2083,1911,3994
20210318,경의선,수색,2809,2847,5656
20210318,경의선,디지털미디어시티,2525,2393,4918
20210318,경의선,가좌,5408,5073,10481
20210318,경의선,홍대입구,1506,1688,3194
20210318,경의선,서강대,2067,2021,4088
20210318,경의선,공덕,3528,3147,6675
20210318,경의선,효창공원앞,2839,3278,6117
20210318,경의선,신촌,815,1068,1883
20210318,경의선,서울,4319,5432,9751
20210319,경의선,서울,4261,5626,9887
20210319,경의선,신촌,903,1152,2055
20210319,경의선,효창공원앞,2995,3366,6361
20210319,경의선,공덕,3605,3266,6871
20210319,경의선,서강대,2175,2219,4394
20210319,경의선,홍대입구,1803,1949,3752
20210319,경의선,가좌,5624,5246,10870
20210319,경의선,디지털미디어시티,2604,2497,5101
20210319,경의선,수색,2661,2716,5377
20210319,경의선,화전,1859,1665,3524
20210319,경의선,강매,3291,2908,6199
20210319,경의선,행신,8145,8185,16330
20210319,경의선,능곡,3867,3579,7446
20210319,경의선,곡산,658,683,1341
20210319,경의선,백마,7213,7038,14251
20210319,경의선,풍산,5689,5317,11006
20210319,경의선,일산,9685,9761,19446
20210319,경의선,탄현,7887,7748,15635
20210319,경의선,야당,6866,6738,13604
20210319,경의선,운정,6649,6376,13025
20210319,경의선,금릉,4706,4647,9353
20210319,경의선,금촌,6712,6443,13155
20210319,경의선,월롱,2527,2028,4555
20210319,경의선,파주,1360,938,2298
20210319,경의선,문산,5908,5786,11694
20210319,경의선,임진강,14,6,20
20210322,경의선,서울,4174,5395,9569
20210322,경의선,신촌,802,1049,1851
20210322,경의선,효창공원앞,2864,3289,6153
20210322,경의선,공덕,3414,3075,6489
20210322,경의선,서강대,1992,1961,3953
20210322,경의선,홍대입구,1392,1562,2954
20210322,경의선,가좌,5294,4912,10206
20210322,경의선,디지털미디어시티,2362,2272,4634
20210322,경의선,수색,2726,2842,5568
20210322,경의선,화전,1830,1703,3533
20210322,경의선,강매,3152,2786,5938
20210322,경의선,행신,7752,7595,15347
20210322,경의선,능곡,3824,3478,7302
20210322,경의선,곡산,588,604,1192
20210322,경의선,백마,7059,6716,13775
20210322,경의선,풍산,5376,4932,10308
20210322,경의선,일산,9299,9340,18639
20210322,경의선,탄현,7632,7233,14865
20210322,경의선,야당,6537,6274,12811
20210322,경의선,운정,6463,6186,12649
20210322,경의선,금릉,4514,4464,8978
20210322,경의선,금촌,6175,6141,12316
20210322,경의선,월롱,2618,2457,5075
20210322,경의선,파주,1704,1309,3013
20210322,경의선,문산,4898,4756,9654
20210322,경의선,임진강,10,2,12
20210323,경의선,임진강,13,13,26
20210323,경의선,문산,5013,5084,10097
20210323,경의선,파주,1691,1275,2966
20210323,경의선,월롱,2660,2457,5117
20210323,경의선,금촌,6280,6360,12640
20210323,경의선,금릉,4565,4512,9077
20210323,경의선,운정,6559,6304,12863
20210323,경의선,야당,6802,6542,13344
20210323,경의선,탄현,7696,7411,15107
20210323,경의선,일산,10587,10518,21105
20210323,경의선,풍산,5629,5302,10931
20210323,경의선,백마,7229,7000,14229
20210323,경의선,곡산,600,664,1264
20210323,경의선,능곡,4004,3621,7625
20210323,경의선,행신,7899,7879,15778
20210323,경의선,강매,3344,2920,6264
20210323,경의선,화전,2255,2076,4331
20210323,경의선,수색,2794,2832,5626
20210323,경의선,디지털미디어시티,2425,2355,4780
20210323,경의선,가좌,5446,5070,10516
20210323,경의선,홍대입구,1515,1626,3141
20210323,경의선,서강대,2057,2024,4081
20210323,경의선,공덕,3512,3136,6648
20210323,경의선,효창공원앞,2961,3434,6395
20210323,경의선,신촌,835,1056,1891
20210323,경의선,서울,4189,5490,9679
20210324,경의선,임진강,20,9,29
20210324,경의선,문산,5336,5197,10533
20210324,경의선,파주,1614,1228,2842
20210324,경의선,월롱,2563,2365,4928
20210324,경의선,금촌,6359,6088,12447
20210324,경의선,금릉,4553,4426,8979
20210324,경의선,운정,6408,6108,12516
20210324,경의선,야당,6693,6460,13153
20210324,경의선,탄현,7529,7333,14862
20210324,경의선,일산,9428,9490,18918
20210324,경의선,풍산,5505,5095,10600
20210324,경의선,백마,7126,6813,13939
20210324,경의선,곡산,626,643,1269
20210324,경의선,능곡,3895,3428,7323
20210324,경의선,행신,7855,7854,15709
20210324,경의선,강매,3293,2907,6200
20210324,경의선,화전,2027,1903,3930
20210324,경의선,수색,2748,2857,5605
20210324,경의선,디지털미디어시티,2530,2360,4890
20210324,경의선,가좌,5396,5092,10488
20210324,경의선,홍대입구,1459,1674,3133
20210324,경의선,서강대,2009,2026,4035
20210324,경의선,공덕,3478,3141,6619
20210324,경의선,효창공원앞,2917,3381,6298
20210324,경의선,신촌,870,1099,1969
20210324,경의선,서울,4161,5476,9637
20210324,경의선,계양,1,0,1
20210325,경의선,임진강,15,7,22
20210325,경의선,문산,5130,5188,10318
20210325,경의선,파주,1570,1190,2760
20210325,경의선,월롱,2789,2405,5194
20210325,경의선,금촌,6235,6248,12483
20210325,경의선,금릉,4685,4456,9141
20210325,경의선,운정,6511,6020,12531
20210325,경의선,야당,6655,6380,13035
20210325,경의선,탄현,7717,7083,14800
20210325,경의선,일산,9646,9102,18748
20210325,경의선,풍산,5554,4945,10499
20210325,경의선,백마,7041,6435,13476
20210325,경의선,곡산,603,644,1247
20210325,경의선,능곡,3908,3424,7332
20210325,경의선,행신,7860,7618,15478
20210325,경의선,강매,3227,2721,5948
20210325,경의선,화전,2004,2821,4825
20210325,경의선,수색,2785,3788,6573
20210325,경의선,디지털미디어시티,2600,2994,5594
20210325,경의선,가좌,5462,5069,10531
20210325,경의선,홍대입구,1569,1821,3390
20210325,경의선,서강대,2018,1976,3994
20210325,경의선,공덕,3570,3250,6820
20210325,경의선,효창공원앞,2901,3417,6318
20210325,경의선,신촌,780,1094,1874
20210325,경의선,서울,4208,5402,9610
20210326,경의선,계양,1,0,1
20210326,경의선,임진강,32,19,51
20210326,경의선,문산,5263,5221,10484
20210326,경의선,파주,1406,969,2375
20210326,경의선,월롱,2518,2009,4527
20210326,경의선,금촌,7193,7033,14226
20210326,경의선,금릉,4819,4815,9634
20210326,경의선,운정,6724,6468,13192
20210326,경의선,야당,6850,6994,13844
20210326,경의선,탄현,7973,7705,15678
20210326,경의선,일산,9913,9824,19737
20210326,경의선,풍산,5836,5492,11328
20210326,경의선,백마,7224,6931,14155
20210326,경의선,곡산,620,663,1283
20210326,경의선,능곡,3912,3651,7563
20210326,경의선,행신,8269,8321,16590
20210326,경의선,강매,3314,2916,6230
20210326,경의선,화전,1882,1713,3595
20210326,경의선,수색,2790,2829,5619
20210326,경의선,디지털미디어시티,2585,2474,5059
20210326,경의선,가좌,5698,5246,10944
20210326,경의선,홍대입구,1875,2014,3889
20210326,경의선,서강대,2145,2017,4162
20210326,경의선,공덕,3726,3278,7004
20210326,경의선,효창공원앞,3043,3401,6444
20210326,경의선,신촌,878,1189,2067
20210326,경의선,서울,4392,5740,10132
20210329,경의선,임진강,8,3,11
20210329,경의선,문산,5143,5027,10170
20210329,경의선,파주,1692,1307,2999
20210329,경의선,월롱,2615,2407,5022
20210329,경의선,금촌,6155,6142,12297
20210329,경의선,금릉,4493,4413,8906
20210329,경의선,운정,6531,6102,12633
20210329,경의선,야당,6620,6222,12842
20210329,경의선,탄현,7535,7185,14720
20210329,경의선,일산,9338,9223,18561
20210329,경의선,풍산,5362,4992,10354
20210329,경의선,백마,6935,6681,13616
20210329,경의선,곡산,595,587,1182
20210329,경의선,능곡,3857,3474,7331
20210329,경의선,행신,7626,7704,15330
20210329,경의선,강매,3191,2813,6004
20210329,경의선,화전,1851,1740,3591
20210329,경의선,수색,2698,2803,5501
20210329,경의선,디지털미디어시티,2422,2339,4761
20210329,경의선,가좌,5394,5045,10439
20210329,경의선,홍대입구,1426,1641,3067
20210329,경의선,서강대,1863,1799,3662
20210329,경의선,공덕,3433,3126,6559
20210329,경의선,효창공원앞,2927,3251,6178
20210329,경의선,신촌,832,1136,1968
20210329,경의선,서울,4252,5325,9577
20210330,경의선,임진강,11,9,20
20210330,경의선,문산,4924,4989,9913
20210330,경의선,파주,1745,1378,3123
20210330,경의선,월롱,2720,2532,5252
20210330,경의선,금촌,6302,6370,12672
20210330,경의선,금릉,4519,4469,8988
20210330,경의선,운정,6513,6164,12677
20210330,경의선,야당,6697,6465,13162
20210330,경의선,탄현,7709,7371,15080
20210330,경의선,일산,9610,9570,19180
20210330,경의선,서울,4264,5355,9619
20210330,경의선,신촌,881,1045,1926
20210330,경의선,효창공원앞,2890,3369,6259
20210330,경의선,공덕,3586,3150,6736
20210330,경의선,서강대,1991,1894,3885
20210330,경의선,홍대입구,1586,1722,3308
20210330,경의선,가좌,5448,5174,10622
20210330,경의선,디지털미디어시티,2559,2386,4945
20210330,경의선,수색,2790,2905,5695
20210330,경의선,화전,2246,2024,4270
20210330,경의선,강매,3319,2922,6241
20210330,경의선,행신,7945,7822,15767
20210330,경의선,능곡,3963,3640,7603
20210330,경의선,곡산,612,649,1261
20210330,경의선,백마,7066,6853,13919
20210330,경의선,풍산,5592,5303,10895
20210331,경의선,계양,1,0,1
20210331,경의선,서울,4209,5383,9592
20210331,경의선,신촌,813,1041,1854
20210331,경의선,효창공원앞,2925,3402,6327
20210331,경의선,공덕,3581,3167,6748
20210331,경의선,서강대,2111,1957,4068
20210331,경의선,홍대입구,1566,1807,3373
20210331,경의선,가좌,5500,5099,10599
20210331,경의선,디지털미디어시티,2440,2408,4848
20210331,경의선,수색,2724,2795,5519
20210331,경의선,화전,1999,1886,3885
20210331,경의선,강매,3342,2927,6269
20210331,경의선,행신,7829,7820,15649
20210331,경의선,능곡,3920,3504,7424
20210331,경의선,곡산,699,720,1419
20210331,경의선,백마,7171,6856,14027
20210331,경의선,풍산,5627,5264,10891
20210331,경의선,일산,9608,9526,19134
20210331,경의선,탄현,7751,7303,15054
20210331,경의선,야당,6944,6691,13635
20210331,경의선,운정,6498,6300,12798
20210331,경의선,금릉,4699,4545,9244
20210331,경의선,금촌,6551,6244,12795
20210331,경의선,월롱,2654,2450,5104
20210331,경의선,파주,1584,1247,2831
20210331,경의선,문산,5029,5033,10062
20210331,경의선,임진강,31,13,44
20210401,경의선,계양,1,0,1
20210401,경의선,임진강,21,28,49
20210401,경의선,문산,5114,5044,10158
20210401,경의선,파주,1612,1184,2796
20210401,경의선,월롱,2871,2574,5445
20210401,경의선,금촌,6676,6759,13435
20210401,경의선,금릉,4569,4613,9182
20210401,경의선,운정,6668,6380,13048
20210401,경의선,야당,6934,6800,13734
20210401,경의선,탄현,7870,7489,15359
20210401,경의선,일산,9651,9591,19242
20210401,경의선,풍산,5801,5361,11162
20210401,경의선,백마,7117,6745,13862
20210401,경의선,곡산,687,675,1362
20210401,경의선,능곡,3882,3509,7391
20210401,경의선,행신,7807,7763,15570
20210401,경의선,강매,3320,2893,6213
20210401,경의선,화전,2187,2020,4207
20210401,경의선,수색,2797,2975,5772
20210401,경의선,디지털미디어시티,2574,2415,4989
20210401,경의선,가좌,5548,5146,10694
20210401,경의선,홍대입구,1637,1772,3409
20210401,경의선,서강대,2008,1962,3970
20210401,경의선,공덕,3518,3126,6644
20210401,경의선,효창공원앞,2921,3393,6314
20210401,경의선,신촌,848,1058,1906
20210401,경의선,서울,4182,5461,9643
20210402,경의선,임진강,21,10,31
20210402,경의선,문산,5353,5218,10571
20210402,경의선,파주,1329,943,2272
20210402,경의선,월롱,2542,2045,4587
20210402,경의선,금촌,6651,6559,13210
20210402,경의선,금릉,4825,4806,9631
20210402,경의선,운정,6712,6427,13139
20210402,경의선,야당,6969,6864,13833
20210402,경의선,탄현,7941,7789,15730
20210402,경의선,일산,9729,9927,19656
20210402,경의선,풍산,5855,5564,11419
20210402,경의선,백마,7229,7050,14279
20210402,경의선,곡산,655,661,1316
20210402,경의선,능곡,4072,3597,7669
20210402,경의선,행신,8290,8255,16545
20210402,경의선,강매,3359,2932,6291
20210402,경의선,화전,1898,1722,3620
20210402,경의선,수색,2707,2779,5486
20210402,경의선,디지털미디어시티,2627,2545,5172
20210402,경의선,가좌,5650,5299,10949
20210402,경의선,홍대입구,1760,1973,3733
20210402,경의선,서강대,2091,2043,4134
20210402,경의선,공덕,3675,3367,7042
20210402,경의선,효창공원앞,3005,3429,6434
20210402,경의선,신촌,863,1103,1966
20210402,경의선,서울,4552,5521,10073
20210402,경의선,계양,1,0,1
20210405,경의선,서울,4231,5427,9658
20210405,경의선,신촌,804,1045,1849
20210405,경의선,효창공원앞,2987,3378,6365
20210405,경의선,공덕,3485,3143,6628
20210405,경의선,서강대,1981,1872,3853
20210405,경의선,홍대입구,1471,1618,3089
20210405,경의선,가좌,5507,5073,10580
20210405,경의선,디지털미디어시티,2532,2386,4918
20210405,경의선,수색,2847,2907,5754
20210405,경의선,화전,1964,1813,3777
20210405,경의선,강매,3308,2888,6196
20210405,경의선,행신,7829,7809,15638
20210405,경의선,능곡,3877,3500,7377
20210405,경의선,곡산,679,676,1355
20210405,경의선,백마,7162,6933,14095
20210405,경의선,풍산,5598,5178,10776
20210405,경의선,일산,9555,9562,19117
20210405,경의선,탄현,7783,7278,15061
20210405,경의선,야당,6754,6435,13189
20210405,경의선,운정,6726,6371,13097
20210405,경의선,금릉,4676,4500,9176
20210405,경의선,금촌,6430,6349,12779
20210405,경의선,월롱,2862,2674,5536
20210405,경의선,파주,1760,1313,3073
20210405,경의선,문산,5238,5067,10305
20210405,경의선,임진강,13,10,23
20210405,경의선,검암,1,0,1
20210405,경의선,계양,2,0,2
20210406,경의선,임진강,24,12,36
20210406,경의선,문산,5044,5005,10049
20210406,경의선,파주,1639,1227,2866
20210406,경의선,월롱,2860,2637,5497
20210406,경의선,금촌,6686,6722,13408
20210406,경의선,금릉,4611,4441,9052
20210406,경의선,운정,6825,6415,13240
20210406,경의선,야당,6813,6698,13511
20210406,경의선,탄현,7823,7578,15401
20210406,경의선,일산,9693,9666,19359
20210406,경의선,풍산,5716,5336,11052
20210406,경의선,백마,7222,6915,14137
20210406,경의선,곡산,692,708,1400
20210406,경의선,능곡,3935,3546,7481
20210406,경의선,행신,7842,7895,15737
20210406,경의선,강매,3374,2961,6335
20210406,경의선,화전,2177,2024,4201
20210406,경의선,수색,2728,2928,5656
20210406,경의선,디지털미디어시티,2585,2392,4977
20210406,경의선,가좌,5533,5089,10622
20210406,경의선,홍대입구,1591,1680,3271
20210406,경의선,서강대,2081,2006,4087
20210406,경의선,공덕,3583,3220,6803
20210406,경의선,효창공원앞,2957,3398,6355
20210406,경의선,신촌,846,1074,1920
20210406,경의선,서울,4290,5361,9651
20210407,경의선,임진강,17,15,32
20210407,경의선,문산,4986,4938,9924
20210407,경의선,파주,1681,1318,2999
20210407,경의선,월롱,2706,2414,5120
20210407,경의선,금촌,6233,6176,12409
20210407,경의선,금릉,4651,4528,9179
20210407,경의선,운정,6638,6337,12975
20210407,경의선,야당,6732,6452,13184
20210407,경의선,탄현,7571,7383,14954
20210407,경의선,일산,9566,9417,18983
20210407,경의선,풍산,5576,5307,10883
20210407,경의선,백마,7125,6815,13940
20210407,경의선,곡산,618,622,1240
20210407,경의선,능곡,3905,3560,7465
20210407,경의선,행신,7747,7764,15511
20210407,경의선,강매,3315,2789,6104
20210407,경의선,화전,2126,1914,4040
20210407,경의선,수색,2735,2941,5676
20210407,경의선,디지털미디어시티,2367,2325,4692
20210407,경의선,가좌,5407,5055,10462
20210407,경의선,홍대입구,1579,1707,3286
20210407,경의선,서강대,1995,1955,3950
20210407,경의선,공덕,3539,3103,6642
20210407,경의선,효창공원앞,2937,3306,6243
20210407,경의선,신촌,827,1064,1891
20210407,경의선,서울,4326,5287,9613
20210408,경의선,서울,4208,5436,9644
20210408,경의선,신촌,782,1023,1805
20210408,경의선,효창공원앞,3012,3387,6399
20210408,경의선,공덕,3494,3150,6644
20210408,경의선,서강대,1977,1895,3872
20210408,경의선,홍대입구,1566,1758,3324
20210408,경의선,가좌,5535,5106,10641
20210408,경의선,디지털미디어시티,2513,2457,4970
20210408,경의선,수색,2721,2883,5604
20210408,경의선,화전,1938,1790,3728
20210408,경의선,강매,3324,2953,6277
20210408,경의선,행신,7940,7851,15791
20210408,경의선,능곡,3992,3615,7607
20210408,경의선,곡산,674,667,1341
20210408,경의선,백마,7228,6934,14162
20210408,경의선,풍산,5738,5427,11165
20210408,경의선,일산,10813,10874,21687
20210408,경의선,탄현,7808,7564,15372
20210408,경의선,야당,6932,6803,13735
20210408,경의선,운정,6803,6493,13296
20210408,경의선,금릉,4603,4542,9145
20210408,경의선,금촌,6138,6246,12384
20210408,경의선,월롱,2980,2568,5548
20210408,경의선,파주,1606,1155,2761
20210408,경의선,문산,5074,5195,10269
20210408,경의선,임진강,30,18,48
20210409,경의선,화전,1960,1774,3734
20210409,경의선,서울,4196,5494,9690
20210409,경의선,신촌,817,1085,1902
20210409,경의선,효창공원앞,3042,3373,6415
20210409,경의선,공덕,3461,3142,6603
20210409,경의선,서강대,2171,2066,4237
20210409,경의선,홍대입구,1769,2007,3776
20210409,경의선,가좌,5680,5233,10913
20210409,경의선,디지털미디어시티,2585,2454,5039
20210409,경의선,수색,2665,2719,5384
20210409,경의선,강매,3246,2921,6167
20210409,경의선,행신,8025,8190,16215
20210409,경의선,능곡,3979,3567,7546
20210409,경의선,곡산,641,649,1290
20210409,경의선,백마,7155,6855,14010
20210409,경의선,풍산,5708,5347,11055
20210409,경의선,일산,9616,9625,19241
20210409,경의선,탄현,7806,7578,15384
20210409,경의선,야당,7051,6896,13947
20210409,경의선,운정,6817,6424,13241
20210409,경의선,금릉,4783,4780,9563
20210409,경의선,금촌,6665,6396,13061
20210409,경의선,월롱,2036,1930,3966
20210409,경의선,파주,1349,898,2247
20210409,경의선,문산,5817,5708,11525
20210409,경의선,임진강,22,12,34
20210412,경의선,임진강,5,8,13
20210412,경의선,문산,4413,4295,8708
20210412,경의선,파주,1548,1211,2759
20210412,경의선,월롱,1798,1907,3705
20210412,경의선,금촌,5770,5656,11426
20210412,경의선,금릉,4281,4119,8400
20210412,경의선,운정,6257,5815,12072
20210412,경의선,야당,6127,5693,11820
20210412,경의선,탄현,7254,6976,14230
20210412,경의선,일산,8890,9043,17933
20210412,경의선,풍산,5120,4816,9936
20210412,경의선,백마,6642,6422,13064
20210412,경의선,곡산,564,498,1062
20210412,경의선,능곡,3505,3201,6706
20210412,경의선,행신,7305,7320,14625
20210412,경의선,강매,3095,2673,5768
20210412,경의선,화전,1719,1596,3315
20210412,경의선,수색,2697,2801,5498
20210412,경의선,디지털미디어시티,2305,2309,4614
20210412,경의선,가좌,5126,5053,10179
20210412,경의선,홍대입구,1244,1419,2663
20210412,경의선,서강대,1917,1876,3793
20210412,경의선,공덕,3329,2959,6288
20210412,경의선,효창공원앞,2775,3219,5994
20210412,경의선,신촌,770,1015,1785
20210412,경의선,서울,3986,5118,9104
20210413,경의선,서울,4087,5107,9194
20210413,경의선,신촌,863,1077,1940
20210413,경의선,효창공원앞,2942,3351,6293
20210413,경의선,공덕,3440,3060,6500
20210413,경의선,서강대,2010,1956,3966
20210413,경의선,홍대입구,1369,1447,2816
20210413,경의선,가좌,5358,5069,10427
20210413,경의선,디지털미디어시티,2476,2355,4831
20210413,경의선,수색,2743,2857,5600
20210413,경의선,화전,2060,1898,3958
20210413,경의선,강매,3260,2799,6059
20210413,경의선,행신,7747,7683,15430
20210413,경의선,능곡,3834,3440,7274
20210413,경의선,곡산,603,628,1231
20210413,경의선,백마,6858,6701,13559
20210413,경의선,풍산,5439,5232,10671
20210413,경의선,일산,10190,10191,20381
20210413,경의선,탄현,7510,7231,14741
20210413,경의선,야당,6649,6503,13152
20210413,경의선,운정,6482,6191,12673
20210413,경의선,금릉,4460,4465,8925
20210413,경의선,금촌,6019,6009,12028
20210413,경의선,월롱,2072,1962,4034
20210413,경의선,파주,1750,1373,3123
20210413,경의선,문산,4805,4861,9666
20210413,경의선,임진강,17,8,25
20210414,경의선,홍대입구,1531,1643,3174
20210414,경의선,가좌,5304,5049,10353
20210414,경의선,디지털미디어시티,2532,2354,4886
20210414,경의선,수색,2731,2936,5667
20210414,경의선,화전,1977,1828,3805
20210414,경의선,강매,3292,2857,6149
20210414,경의선,행신,7563,7573,15136
20210414,경의선,능곡,3825,3537,7362
20210414,경의선,곡산,643,666,1309
20210414,경의선,백마,6894,6694,13588
20210414,경의선,풍산,5409,5153,10562
20210414,경의선,일산,9408,9420,18828
20210414,경의선,탄현,7453,7183,14636
20210414,경의선,야당,6608,6451,13059
20210414,경의선,운정,6624,6310,12934
20210414,경의선,금릉,4628,4440,9068
20210414,경의선,금촌,6109,6002,12111
20210414,경의선,월롱,2216,2025,4241
20210414,경의선,파주,1743,1325,3068
20210414,경의선,문산,5295,5280,10575
20210414,경의선,임진강,15,10,25
20210414,경의선,서강대,2023,1945,3968
20210414,경의선,공덕,3490,3064,6554
20210414,경의선,효창공원앞,2914,3339,6253
20210414,경의선,신촌,860,1053,1913
20210414,경의선,서울,4141,5360,9501
20210415,경의선,백마,6816,6503,13319
20210415,경의선,풍산,5615,5276,10891
20210415,경의선,일산,9432,9374,18806
20210415,경의선,탄현,7586,7286,14872
20210415,경의선,야당,6701,6541,13242
20210415,경의선,운정,6682,6333,13015
20210415,경의선,금릉,4462,4511,8973
20210415,경의선,금촌,6064,5969,12033
20210415,경의선,월롱,2133,1986,4119
20210415,경의선,파주,1603,1250,2853
20210415,경의선,문산,5041,5172,10213
20210415,경의선,임진강,20,16,36
20210415,경의선,곡산,611,643,1254
20210415,경의선,능곡,3953,3588,7541
20210415,경의선,행신,7789,7746,15535
20210415,경의선,강매,3323,2843,6166
20210415,경의선,화전,1917,1712,3629
20210415,경의선,수색,2716,2860,5576
20210415,경의선,디지털미디어시티,2469,2314,4783
20210415,경의선,가좌,5510,5182,10692
20210415,경의선,홍대입구,1445,1639,3084
20210415,경의선,서강대,2101,1971,4072
20210415,경의선,공덕,3516,3131,6647
20210415,경의선,효창공원앞,2867,3344,6211
20210415,경의선,신촌,802,1035,1837
20210415,경의선,서울,4187,5423,9610
20210416,경의선,서울,4103,5241,9344
20210416,경의선,신촌,820,1051,1871
20210416,경의선,효창공원앞,2898,3262,6160
20210416,경의선,공덕,3566,3154,6720
20210416,경의선,서강대,2064,1971,4035
20210416,경의선,홍대입구,1559,1827,3386
20210416,경의선,가좌,5321,4872,10193
20210416,경의선,디지털미디어시티,2420,2359,4779
20210416,경의선,수색,2563,2680,5243
20210416,경의선,화전,1861,1678,3539
20210416,경의선,강매,3108,2684,5792
20210416,경의선,행신,7745,7798,15543
20210416,경의선,능곡,3639,3296,6935
20210416,경의선,곡산,532,563,1095
20210416,경의선,백마,6733,6453,13186
20210416,경의선,풍산,5350,5120,10470
20210416,경의선,일산,8976,9168,18144
20210416,경의선,탄현,7379,7113,14492
20210416,경의선,야당,6727,6732,13459
20210416,경의선,운정,6448,6239,12687
20210416,경의선,금릉,4420,4404,8824
20210416,경의선,금촌,6518,6315,12833
20210416,경의선,월롱,2413,1841,4254
20210416,경의선,파주,1226,844,2070
20210416,경의선,문산,4982,4696,9678
20210416,경의선,임진강,10,1,11
20210416,경의선,계양,1,0,1
20210419,경의선,김포공항,1,0,1
20210419,경의선,임진강,24,19,43
20210419,경의선,문산,5393,5202,10595
20210419,경의선,파주,1859,1419,3278
20210419,경의선,월롱,2058,2016,4074
20210419,경의선,금촌,6397,6291,12688
20210419,경의선,금릉,4688,4662,9350
20210419,경의선,운정,6693,6238,12931
20210419,경의선,야당,6572,6269,12841
20210419,경의선,탄현,7474,7130,14604
20210419,경의선,일산,9337,9382,18719
20210419,경의선,풍산,5441,5039,10480
20210419,경의선,백마,6860,6568,13428
20210419,경의선,곡산,619,643,1262
20210419,경의선,능곡,3928,3485,7413
20210419,경의선,행신,7560,7705,15265
20210419,경의선,강매,3221,2821,6042
20210419,경의선,화전,1724,1602,3326
20210419,경의선,수색,2785,2820,5605
20210419,경의선,디지털미디어시티,2398,2297,4695
20210419,경의선,가좌,5488,4994,10482
20210419,경의선,홍대입구,1356,1546,2902
20210419,경의선,서강대,1948,1885,3833
20210419,경의선,공덕,3410,3089,6499
20210419,경의선,효창공원앞,2889,3155,6044
20210419,경의선,신촌,856,1077,1933
20210419,경의선,서울,4263,5376,9639
20210420,경의선,디지털미디어시티,72,271,343
20210420,경의선,임진강,26,13,39
20210420,경의선,문산,4951,5036,9987
20210420,경의선,파주,1824,1352,3176
20210420,경의선,월롱,2043,1982,4025
20210420,경의선,금촌,6197,6249,12446
20210420,경의선,금릉,4583,4488,9071
20210420,경의선,운정,6700,6388,13088
20210420,경의선,야당,6500,6468,12968
20210420,경의선,탄현,7699,7341,15040
20210420,경의선,일산,9464,9432,18896
20210420,경의선,풍산,5562,5243,10805
20210420,경의선,백마,6913,6704,13617
20210420,경의선,곡산,606,659,1265
20210420,경의선,능곡,3948,3576,7524
20210420,경의선,행신,7699,7794,15493
20210420,경의선,강매,3332,2903,6235
20210420,경의선,화전,2098,1932,4030
20210420,경의선,수색,2771,2971,5742
20210420,경의선,디지털미디어시티,2453,2046,4499
20210420,경의선,가좌,5470,5026,10496
20210420,경의선,홍대입구,1477,1631,3108
20210420,경의선,서강대,1933,1854,3787
20210420,경의선,공덕,3473,3144,6617
20210420,경의선,효창공원앞,2995,3378,6373
20210420,경의선,신촌,819,1083,1902
20210420,경의선,서울,4140,5157,9297
20210421,경의선,임진강,29,22,51
20210421,경의선,문산,4946,4958,9904
20210421,경의선,파주,1829,1456,3285
20210421,경의선,월롱,2033,1953,3986
20210421,경의선,금촌,6767,6650,13417
20210421,경의선,금릉,4603,4449,9052
20210421,경의선,운정,6729,6385,13114
20210421,경의선,야당,6764,6541,13305
20210421,경의선,탄현,7642,7327,14969
20210421,경의선,일산,9407,9399,18806
20210421,경의선,풍산,5470,5180,10650
20210421,경의선,백마,7147,6799,13946
20210421,경의선,곡산,643,639,1282
20210421,경의선,능곡,3963,3601,7564
20210421,경의선,행신,7827,7794,15621
20210421,경의선,강매,3294,2927,6221
20210421,경의선,화전,1986,1836,3822
20210421,경의선,수색,2828,2958,5786
20210421,경의선,디지털미디어시티,2509,2372,4881
20210421,경의선,가좌,5485,5118,10603
20210421,경의선,홍대입구,1450,1625,3075
20210421,경의선,서강대,2020,1923,3943
20210421,경의선,공덕,3469,3222,6691
20210421,경의선,효창공원앞,2918,3338,6256
20210421,경의선,신촌,843,1061,1904
20210421,경의선,서울,4170,5342,9512
20210422,경의선,임진강,19,15,34
20210422,경의선,문산,4781,4879,9660
20210422,경의선,파주,1747,1302,3049
20210422,경의선,월롱,2051,1906,3957
20210422,경의선,금촌,5947,5983,11930
20210422,경의선,금릉,4554,4507,9061
20210422,경의선,운정,6582,6228,12810
20210422,경의선,야당,6789,6591,13380
20210422,경의선,탄현,7437,7267,14704
20210422,경의선,일산,9377,9251,18628
20210422,경의선,풍산,5474,5210,10684
20210422,경의선,백마,6953,6589,13542
20210422,경의선,곡산,644,645,1289
20210422,경의선,능곡,3865,3511,7376
20210422,경의선,행신,7784,7741,15525
20210422,경의선,강매,3238,2829,6067
20210422,경의선,화전,2166,1962,4128
20210422,경의선,수색,2801,2973,5774
20210422,경의선,디지털미디어시티,2484,2351,4835
20210422,경의선,가좌,5372,5035,10407
20210422,경의선,홍대입구,1502,1690,3192
20210422,경의선,서강대,1913,1848,3761
20210422,경의선,공덕,3475,3128,6603
20210422,경의선,효창공원앞,2914,3369,6283
20210422,경의선,신촌,839,1017,1856
20210422,경의선,서울,4205,5316,9521
20210423,경의선,서울,4345,5295,9640
20210423,경의선,신촌,880,1124,2004
20210423,경의선,효창공원앞,2909,3293,6202
20210423,경의선,공덕,3601,3242,6843
20210423,경의선,서강대,2162,2043,4205
20210423,경의선,홍대입구,1691,2016,3707
20210423,경의선,가좌,5545,5214,10759
20210423,경의선,디지털미디어시티,2639,2481,5120
20210423,경의선,수색,2895,2936,5831
20210423,경의선,화전,1903,1753,3656
20210423,경의선,강매,3251,2875,6126
20210423,경의선,행신,8030,8069,16099
20210423,경의선,능곡,3890,3536,7426
20210423,경의선,곡산,593,659,1252
20210423,경의선,백마,7058,6824,13882
20210423,경의선,풍산,5716,5458,11174
20210423,경의선,일산,10446,10529,20975
20210423,경의선,탄현,7661,7516,15177
20210423,경의선,야당,7052,7020,14072
20210423,경의선,운정,6723,6413,13136
20210423,경의선,금릉,4733,4677,9410
20210423,경의선,금촌,6633,6540,13173
20210423,경의선,월롱,2303,1968,4271
20210423,경의선,파주,1379,929,2308
20210423,경의선,문산,5263,5246,10509
20210423,경의선,임진강,31,17,48
20210426,경의선,임진강,10,6,16
20210426,경의선,문산,5048,4907,9955
20210426,경의선,파주,1854,1429,3283
20210426,경의선,월롱,2544,2526,5070
20210426,경의선,금촌,6817,6674,13491
20210426,경의선,금릉,4654,4530,9184
20210426,경의선,운정,6863,6389,13252
20210426,경의선,야당,6829,6605,13434
20210426,경의선,탄현,7640,7303,14943
20210426,경의선,일산,9664,9474,19138
20210426,경의선,풍산,5505,5097,10602
20210426,경의선,백마,7071,6785,13856
20210426,경의선,곡산,632,657,1289
20210426,경의선,능곡,3989,3631,7620
20210426,경의선,행신,7706,7824,15530
20210426,경의선,강매,3260,2838,6098
20210426,경의선,화전,1947,1814,3761
20210426,경의선,수색,2827,2953,5780
20210426,경의선,디지털미디어시티,2430,2324,4754
20210426,경의선,가좌,5535,5178,10713
20210426,경의선,홍대입구,1425,1603,3028
20210426,경의선,서강대,2088,1990,4078
20210426,경의선,공덕,3506,3098,6604
20210426,경의선,효창공원앞,2911,3303,6214
20210426,경의선,신촌,893,1103,1996
20210426,경의선,서울,4316,5444,9760
20210427,경의선,서울,4226,3895,8121
20210427,경의선,신촌,879,1125,2004
20210427,경의선,효창공원앞,2964,3365,6329
20210427,경의선,공덕,3482,3191,6673
20210427,경의선,서강대,2051,2065,4116
20210427,경의선,홍대입구,1384,1688,3072
20210427,경의선,가좌,5472,5149,10621
20210427,경의선,디지털미디어시티,2497,2409,4906
20210427,경의선,수색,2767,2924,5691
20210427,경의선,화전,2134,1947,4081
20210427,경의선,강매,3301,2841,6142
20210427,경의선,행신,7801,7813,15614
20210427,경의선,능곡,3939,3563,7502
20210427,경의선,곡산,652,626,1278
20210427,경의선,백마,6991,6763,13754
20210427,경의선,풍산,5482,5158,10640
20210427,경의선,일산,9413,9426,18839
20210427,경의선,탄현,7748,7501,15249
20210427,경의선,야당,6815,6563,13378
20210427,경의선,운정,6757,6416,13173
20210427,경의선,금릉,4577,4560,9137
20210427,경의선,금촌,6090,6087,12177
20210427,경의선,월롱,2540,2413,4953
20210427,경의선,파주,1655,1272,2927
20210427,경의선,문산,5030,5075,10105
20210427,경의선,임진강,33,14,47
20210427,경의선,서울,75,1505,1580
20210427,경의선,계양,1,0,1
20210428,경의선,임진강,17,15,32
20210428,경의선,문산,4959,4921,9880
20210428,경의선,파주,1665,1269,2934
20210428,경의선,월롱,2636,2539,5175
20210428,경의선,금촌,6297,6096,12393
20210428,경의선,금릉,4546,4471,9017
20210428,경의선,운정,6619,6532,13151
20210428,경의선,야당,6778,6706,13484
20210428,경의선,탄현,7754,7283,15037
20210428,경의선,일산,10448,10501,20949
20210428,경의선,풍산,5588,5227,10815
20210428,경의선,백마,7001,6825,13826
20210428,경의선,곡산,612,661,1273
20210428,경의선,능곡,3937,3581,7518
20210428,경의선,행신,7855,7923,15778
20210428,경의선,강매,3272,2815,6087
20210428,경의선,화전,1954,1847,3801
20210428,경의선,수색,2749,3020,5769
20210428,경의선,디지털미디어시티,2461,2317,4778
20210428,경의선,가좌,5419,5044,10463
20210428,경의선,홍대입구,1592,1749,3341
20210428,경의선,서강대,2127,2021,4148
20210428,경의선,공덕,3571,3226,6797
20210428,경의선,효창공원앞,2916,3373,6289
20210428,경의선,신촌,881,1073,1954
20210428,경의선,서울,4188,5333,9521
20210429,경의선,서울,4281,5408,9689
20210429,경의선,신촌,867,1069,1936
20210429,경의선,효창공원앞,2937,3364,6301
20210429,경의선,공덕,3483,3139,6622
20210429,경의선,서강대,2020,1952,3972
20210429,경의선,홍대입구,1566,1790,3356
20210429,경의선,가좌,5443,5045,10488
20210429,경의선,디지털미디어시티,2526,2432,4958
20210429,경의선,수색,2754,2906,5660
20210429,경의선,화전,2043,1901,3944
20210429,경의선,강매,3282,2890,6172
20210429,경의선,행신,7868,7791,15659
20210429,경의선,능곡,3872,3539,7411
20210429,경의선,곡산,638,665,1303
20210429,경의선,백마,7145,6826,13971
20210429,경의선,풍산,5695,5446,11141
20210429,경의선,일산,9604,9711,19315
20210429,경의선,탄현,7707,7395,15102
20210429,경의선,야당,6928,6769,13697
20210429,경의선,운정,6709,6468,13177
20210429,경의선,금릉,4623,4556,9179
20210429,경의선,금촌,6358,6305,12663
20210429,경의선,월롱,2501,2300,4801
20210429,경의선,파주,1660,1206,2866
20210429,경의선,문산,5317,5518,10835
20210429,경의선,임진강,17,15,32
20210430,경의선,서울,4429,5687,10116
20210430,경의선,신촌,862,1120,1982
20210430,경의선,효창공원앞,2913,3366,6279
20210430,경의선,공덕,3721,3296,7017
20210430,경의선,서강대,2162,2091,4253
20210430,경의선,홍대입구,1707,2083,3790
20210430,경의선,가좌,5700,5266,10966
20210430,경의선,디지털미디어시티,2635,2478,5113
20210430,경의선,수색,2697,2806,5503
20210430,경의선,화전,1937,1751,3688
20210430,경의선,강매,3265,2845,6110
20210430,경의선,행신,8358,8391,16749
20210430,경의선,능곡,3947,3555,7502
20210430,경의선,곡산,592,582,1174
20210430,경의선,백마,7060,6896,13956
20210430,경의선,풍산,5634,5390,11024
20210430,경의선,일산,9608,9652,19260
20210430,경의선,탄현,7761,7606,15367
20210430,경의선,야당,6946,6938,13884
20210430,경의선,운정,6699,6527,13226
20210430,경의선,금릉,4707,4559,9266
20210430,경의선,금촌,6681,6441,13122
20210430,경의선,월롱,2693,2089,4782
20210430,경의선,파주,1351,915,2266
20210430,경의선,문산,5285,5099,10384
20210430,경의선,임진강,14,5,19
20210503,경의선,임진강,14,11,25
20210503,경의선,문산,5308,5153,10461
20210503,경의선,파주,1792,1372,3164
20210503,경의선,월롱,2618,2525,5143
20210503,경의선,금촌,6414,6320,12734
20210503,경의선,금릉,4800,4606,9406
20210503,경의선,운정,7072,6576,13648
20210503,경의선,야당,6891,6731,13622
20210503,경의선,탄현,7840,7455,15295
20210503,경의선,일산,10697,10594,21291
20210503,경의선,풍산,5859,5430,11289
20210503,경의선,백마,7336,6943,14279
20210503,경의선,곡산,636,611,1247
20210503,경의선,능곡,3976,3617,7593
20210503,경의선,행신,7904,7974,15878
20210503,경의선,강매,3328,2888,6216
20210503,경의선,화전,1907,1844,3751
20210503,경의선,수색,2818,2888,5706
20210503,경의선,디지털미디어시티,2505,2407,4912
20210503,경의선,가좌,5558,5297,10855
20210503,경의선,홍대입구,1544,1832,3376
20210503,경의선,서강대,2051,2013,4064
20210503,경의선,공덕,3578,3131,6709
20210503,경의선,효창공원앞,2928,3384,6312
20210503,경의선,신촌,950,1170,2120
20210503,경의선,서울,4231,5498,9729
20210504,경의선,임진강,4,1,5
20210504,경의선,문산,4677,4660,9337
20210504,경의선,파주,1631,1183,2814
20210504,경의선,월롱,2389,2190,4579
20210504,경의선,금촌,5759,5772,11531
20210504,경의선,금릉,4293,4120,8413
20210504,경의선,운정,6243,5949,12192
20210504,경의선,야당,6283,6267,12550
20210504,경의선,탄현,7304,7166,14470
20210504,경의선,일산,8757,8816,17573
20210504,경의선,풍산,5145,4769,9914
20210504,경의선,백마,6528,6421,12949
20210504,경의선,곡산,474,526,1000
20210504,경의선,능곡,3635,3288,6923
20210504,경의선,행신,7687,7646,15333
20210504,경의선,강매,3102,2685,5787
20210504,경의선,화전,1972,1863,3835
20210504,경의선,수색,2630,2814,5444
20210504,경의선,디지털미디어시티,2448,2307,4755
20210504,경의선,가좌,5265,5051,10316
20210504,경의선,홍대입구,1465,1664,3129
20210504,경의선,서강대,1953,1967,3920
20210504,경의선,공덕,3712,3121,6833
20210504,경의선,효창공원앞,3030,3440,6470
20210504,경의선,신촌,883,1042,1925
20210504,경의선,서울,3989,5211,9200
20210505,경의선,서울,1172,1071,2243
20210505,경의선,신촌,317,298,615
20210505,경의선,효창공원앞,1496,1680,3176
20210505,경의선,공덕,1840,1557,3397
20210505,경의선,서강대,1414,1354,2768
20210505,경의선,홍대입구,1788,2185,3973
20210505,경의선,가좌,3237,3180,6417
20210505,경의선,디지털미디어시티,1604,1451,3055
20210505,경의선,수색,1150,1175,2325
20210505,경의선,화전,960,930,1890
20210505,경의선,강매,1621,1613,3234
20210505,경의선,행신,4355,4262,8617
20210505,경의선,능곡,2379,2348,4727
20210505,경의선,곡산,374,368,742
20210505,경의선,백마,3714,3520,7234
20210505,경의선,풍산,3530,3404,6934
20210505,경의선,일산,5132,4936,10068
20210505,경의선,탄현,4453,4333,8786
20210505,경의선,야당,4608,4409,9017
20210505,경의선,운정,3886,3828,7714
20210505,경의선,금릉,3097,3051,6148
20210505,경의선,금촌,4326,4431,8757
20210505,경의선,월롱,1127,1317,2444
20210505,경의선,파주,716,591,1307
20210505,경의선,문산,3843,3890,7733
20210505,경의선,임진강,128,121,249
20210506,경의선,서울,4295,5426,9721
20210506,경의선,신촌,891,1126,2017
20210506,경의선,효창공원앞,2920,3387,6307
20210506,경의선,공덕,3545,3141,6686
20210506,경의선,서강대,2128,2065,4193
20210506,경의선,홍대입구,1744,1988,3732
20210506,경의선,가좌,5591,5087,10678
20210506,경의선,디지털미디어시티,2599,2430,5029
20210506,경의선,수색,2786,2905,5691
20210506,경의선,화전,1699,1492,3191
20210506,경의선,강매,3348,2973,6321
20210506,경의선,행신,8011,8006,16017
20210506,경의선,능곡,3946,3612,7558
20210506,경의선,곡산,662,626,1288
20210506,경의선,백마,7193,6907,14100
20210506,경의선,풍산,5777,5377,11154
20210506,경의선,일산,9584,9473,19057
20210506,경의선,탄현,7916,7523,15439
20210506,경의선,야당,7014,6736,13750
20210506,경의선,운정,6858,6470,13328
20210506,경의선,금릉,4791,4722,9513
20210506,경의선,금촌,6894,6871,13765
20210506,경의선,월롱,2595,2398,4993
20210506,경의선,파주,1543,1124,2667
20210506,경의선,문산,5182,5331,10513
20210506,경의선,임진강,18,12,30
20210507,경의선,서울,4382,5447,9829
20210507,경의선,신촌,924,1169,2093
20210507,경의선,효창공원앞,2908,3265,6173
20210507,경의선,공덕,3535,2994,6529
20210507,경의선,서강대,2255,2100,4355
20210507,경의선,홍대입구,1793,2009,3802
20210507,경의선,가좌,5567,5228,10795
20210507,경의선,디지털미디어시티,2576,2497,5073
20210507,경의선,수색,2645,2713,5358
20210507,경의선,화전,1645,1451,3096
20210507,경의선,강매,3147,2712,5859
20210507,경의선,행신,7951,8076,16027
20210507,경의선,능곡,3715,3442,7157
20210507,경의선,곡산,576,567,1143
20210507,경의선,백마,6954,6814,13768
20210507,경의선,풍산,5584,5232,10816
20210507,경의선,일산,9228,9548,18776
20210507,경의선,탄현,7635,7582,15217
20210507,경의선,야당,6798,6924,13722
20210507,경의선,운정,6653,6400,13053
20210507,경의선,금릉,4669,4642,9311
20210507,경의선,금촌,6407,6444,12851
20210507,경의선,월롱,2438,2035,4473
20210507,경의선,파주,1372,887,2259
20210507,경의선,문산,5109,5239,10348
20210507,경의선,임진강,14,3,17
20210510,경의선,서울,4293,5317,9610
20210510,경의선,신촌,882,1146,2028
20210510,경의선,효창공원앞,2918,3343,6261
20210510,경의선,공덕,3390,3185,6575
20210510,경의선,서강대,2029,1940,3969
20210510,경의선,홍대입구,1472,1669,3141
20210510,경의선,가좌,5447,5011,10458
20210510,경의선,디지털미디어시티,2425,2392,4817
20210510,경의선,수색,2789,2824,5613
20210510,경의선,화전,1510,1434,2944
20210510,경의선,강매,3213,2819,6032
20210510,경의선,행신,7685,7701,15386
20210510,경의선,능곡,3796,3382,7178
20210510,경의선,곡산,607,604,1211
20210510,경의선,백마,7003,6770,13773
20210510,경의선,풍산,5622,5192,10814
20210510,경의선,일산,9316,9134,18450
20210510,경의선,탄현,7685,7264,14949
20210510,경의선,야당,6617,6329,12946
20210510,경의선,운정,6628,6067,12695
20210510,경의선,금릉,4670,4487,9157
20210510,경의선,금촌,6205,6191,12396
20210510,경의선,월롱,2486,2396,4882
20210510,경의선,파주,1582,1191,2773
20210510,경의선,문산,4975,4893,9868
20210510,경의선,임진강,13,11,24
20210511,경의선,서울,4342,5623,9965
20210511,경의선,신촌,939,1161,2100
20210511,경의선,효창공원앞,3015,3403,6418
20210511,경의선,공덕,3574,3196,6770
20210511,경의선,서강대,2046,2021,4067
20210511,경의선,홍대입구,1525,1790,3315
20210511,경의선,가좌,5502,5179,10681
20210511,경의선,디지털미디어시티,2585,2441,5026
20210511,경의선,수색,2864,2976,5840
20210511,경의선,화전,1740,1585,3325
20210511,경의선,강매,3415,2969,6384
20210511,경의선,행신,7934,8096,16030
20210511,경의선,능곡,3945,3539,7484
20210511,경의선,곡산,650,668,1318
20210511,경의선,백마,7194,6982,14176
20210511,경의선,풍산,5789,5408,11197
20210511,경의선,일산,9732,9594,19326
20210511,경의선,탄현,8047,7674,15721
20210511,경의선,야당,7012,6899,13911
20210511,경의선,운정,6932,6504,13436
20210511,경의선,금릉,4786,4637,9423
20210511,경의선,금촌,6804,6729,13533
20210511,경의선,월롱,2792,2551,5343
20210511,경의선,파주,1754,1323,3077
20210511,경의선,문산,5244,5066,10310
20210511,경의선,임진강,18,17,35
20210512,경의선,임진강,32,19,51
20210512,경의선,문산,5030,5074,10104
20210512,경의선,파주,1700,1280,2980
20210512,경의선,월롱,2516,2318,4834
20210512,경의선,금촌,6437,6333,12770
20210512,경의선,금릉,4725,4643,9368
20210512,경의선,운정,6730,6443,13173
20210512,경의선,야당,6992,6875,13867
20210512,경의선,탄현,7950,7618,15568
20210512,경의선,일산,9424,9446,18870
20210512,경의선,풍산,5571,5091,10662
20210512,경의선,백마,7193,6875,14068
20210512,경의선,곡산,676,687,1363
20210512,경의선,능곡,3954,3667,7621
20210512,경의선,행신,7991,7992,15983
20210512,경의선,강매,3403,2932,6335
20210512,경의선,화전,1645,1508,3153
20210512,경의선,수색,2858,3024,5882
20210512,경의선,디지털미디어시티,2530,2402,4932
20210512,경의선,가좌,5598,5224,10822
20210512,경의선,홍대입구,1677,1809,3486
20210512,경의선,서강대,2054,1995,4049
20210512,경의선,공덕,3668,3189,6857
20210512,경의선,효창공원앞,3008,3383,6391
20210512,경의선,신촌,913,1159,2072
20210512,경의선,서울,4365,5483,9848
20210512,경의선,검암,1,0,1
20210513,경의선,서울,4337,5364,9701
20210513,경의선,신촌,831,1102,1933
20210513,경의선,효창공원앞,3010,3359,6369
20210513,경의선,공덕,3576,3258,6834
20210513,경의선,서강대,2114,2003,4117
20210513,경의선,홍대입구,1540,1826,3366
20210513,경의선,가좌,5567,5203,10770
20210513,경의선,디지털미디어시티,2591,2499,5090
20210513,경의선,수색,2777,2952,5729
20210513,경의선,화전,1645,1534,3179
20210513,경의선,강매,3403,2969,6372
20210513,경의선,행신,7912,7951,15863
20210513,경의선,능곡,3955,3509,7464
20210513,경의선,곡산,677,678,1355
20210513,경의선,백마,7310,7037,14347
20210513,경의선,풍산,5869,5528,11397
20210513,경의선,일산,10545,10514,21059
20210513,경의선,탄현,8024,7657,15681
20210513,경의선,야당,7121,6886,14007
20210513,경의선,운정,6909,6610,13519
20210513,경의선,금릉,4790,4713,9503
20210513,경의선,금촌,6271,6341,12612
20210513,경의선,월롱,2744,2548,5292
20210513,경의선,파주,1563,1161,2724
20210513,경의선,문산,5174,5240,10414
20210513,경의선,임진강,16,15,31
20210513,경의선,홍대입구,145,110,255
20210514,경의선,서울,4457,5712,10169
20210514,경의선,신촌,922,1105,2027
20210514,경의선,효창공원앞,3091,3467,6558
20210514,경의선,공덕,3690,3379,7069
20210514,경의선,서강대,2293,2246,4539
20210514,경의선,홍대입구,1898,2180,4078
20210514,경의선,가좌,5931,5528,11459
20210514,경의선,디지털미디어시티,2763,2580,5343
20210514,경의선,수색,2794,2911,5705
20210514,경의선,화전,1715,1598,3313
20210514,경의선,강매,3400,2920,6320
20210514,경의선,행신,8315,8398,16713
20210514,경의선,능곡,3999,3632,7631
20210514,경의선,곡산,652,655,1307
20210514,경의선,백마,7349,7100,14449
20210514,경의선,풍산,6071,5687,11758
20210514,경의선,일산,9766,9753,19519
20210514,경의선,탄현,8017,7949,15966
20210514,경의선,야당,7284,7165,14449
20210514,경의선,운정,7093,6699,13792
20210514,경의선,금릉,4949,4935,9884
20210514,경의선,금촌,6720,6568,13288
20210514,경의선,월롱,2756,2158,4914
20210514,경의선,파주,1248,902,2150
20210514,경의선,문산,5871,5714,11585
20210514,경의선,임진강,22,15,37
20210517,경의선,임진강,7,9,16
20210517,경의선,문산,4861,4854,9715
20210517,경의선,파주,1554,1145,2699
20210517,경의선,월롱,2610,2471,5081
20210517,경의선,금촌,6081,6025,12106
20210517,경의선,금릉,4598,4464,9062
20210517,경의선,운정,6562,6167,12729
20210517,경의선,야당,6678,6496,13174
20210517,경의선,탄현,7681,7267,14948
20210517,경의선,일산,9128,9024,18152
20210517,경의선,풍산,5409,4990,10399
20210517,경의선,백마,6918,6544,13462
20210517,경의선,곡산,570,580,1150
20210517,경의선,능곡,3755,3422,7177
20210517,경의선,행신,7763,7792,15555
20210517,경의선,강매,3218,2781,5999
20210517,경의선,화전,1678,1578,3256
20210517,경의선,수색,2815,2865,5680
20210517,경의선,디지털미디어시티,2435,2284,4719
20210517,경의선,가좌,5322,4934,10256
20210517,경의선,홍대입구,1406,1566,2972
20210517,경의선,서강대,1978,1885,3863
20210517,경의선,공덕,3536,3121,6657
20210517,경의선,효창공원앞,2858,3201,6059
20210517,경의선,신촌,861,1099,1960
20210517,경의선,서울,4179,5214,9393
20210518,경의선,강매,3519,2957,6476
20210518,경의선,화전,2176,2040,4216
20210518,경의선,수색,2924,3073,5997
20210518,경의선,디지털미디어시티,2756,2587,5343
20210518,경의선,가좌,5781,5344,11125
20210518,경의선,홍대입구,1770,1946,3716
20210518,경의선,서강대,2151,2072,4223
20210518,경의선,공덕,3834,3402,7236
20210518,경의선,효창공원앞,3007,3379,6386
20210518,경의선,신촌,918,1137,2055
20210518,경의선,서울,4337,5752,10089
20210518,경의선,행신,8278,8250,16528
20210518,경의선,능곡,4015,3644,7659
20210518,경의선,곡산,663,651,1314
20210518,경의선,백마,7516,7090,14606
20210518,경의선,풍산,5989,5593,11582
20210518,경의선,일산,10705,10614,21319
20210518,경의선,탄현,8296,7787,16083
20210518,경의선,야당,7506,7350,14856
20210518,경의선,운정,7093,6731,13824
20210518,경의선,금릉,4988,4889,9877
20210518,경의선,금촌,6645,6616,13261
20210518,경의선,월롱,2851,2467,5318
20210518,경의선,파주,1721,1344,3065
20210518,경의선,문산,5272,5177,10449
20210518,경의선,임진강,5,8,13
20210519,경의선,임진강,99,83,182
20210519,경의선,문산,4452,4485,8937
20210519,경의선,파주,812,648,1460
20210519,경의선,월롱,1220,1452,2672
20210519,경의선,금촌,4635,4651,9286
20210519,경의선,금릉,3276,3178,6454
20210519,경의선,운정,4212,4044,8256
20210519,경의선,야당,4882,4650,9532
20210519,경의선,탄현,4639,4505,9144
20210519,경의선,일산,5364,5292,10656
20210519,경의선,풍산,3868,3784,7652
20210519,경의선,백마,3903,3805,7708
20210519,경의선,곡산,365,402,767
20210519,경의선,능곡,2504,2527,5031
20210519,경의선,행신,4564,4556,9120
20210519,경의선,강매,1920,1858,3778
20210519,경의선,화전,1209,1168,2377
20210519,경의선,수색,1194,1303,2497
20210519,경의선,디지털미디어시티,1635,1578,3213
20210519,경의선,가좌,3502,3493,6995
20210519,경의선,홍대입구,1843,2098,3941
20210519,경의선,서강대,1383,1333,2716
20210519,경의선,공덕,1951,1591,3542
20210519,경의선,효창공원앞,1593,1815,3408
20210519,경의선,신촌,366,326,692
20210519,경의선,서울,1224,1265,2489
20210520,경의선,서울,432,97,529
20210520,경의선,임진강,16,10,26
20210520,경의선,문산,4794,4888,9682
20210520,경의선,파주,1489,1114,2603
20210520,경의선,월롱,2393,2119,4512
20210520,경의선,금촌,6125,6176,12301
20210520,경의선,금릉,4528,4437,8965
20210520,경의선,운정,6539,6303,12842
20210520,경의선,야당,6863,6605,13468
20210520,경의선,탄현,7626,7297,14923
20210520,경의선,일산,9162,9346,18508
20210520,경의선,풍산,5481,5171,10652
20210520,경의선,백마,7000,6751,13751
20210520,경의선,곡산,583,582,1165
20210520,경의선,능곡,3788,3395,7183
20210520,경의선,행신,7614,7676,15290
20210520,경의선,강매,3309,2846,6155
20210520,경의선,화전,1889,1758,3647
20210520,경의선,수색,2826,2924,5750
20210520,경의선,디지털미디어시티,2564,2392,4956
20210520,경의선,가좌,5428,5095,10523
20210520,경의선,홍대입구,1497,1749,3246
20210520,경의선,서강대,2041,2041,4082
20210520,경의선,공덕,3490,3125,6615
20210520,경의선,효창공원앞,2815,3406,6221
20210520,경의선,신촌,842,1069,1911
20210520,경의선,서울,3776,5134,8910
20210521,경의선,임진강,11,7,18
20210521,경의선,문산,5186,5138,10324
20210521,경의선,파주,1326,856,2182
20210521,경의선,월롱,2204,1825,4029
20210521,경의선,금촌,6940,6932,13872
20210521,경의선,금릉,4717,4605,9322
20210521,경의선,운정,6723,6472,13195
20210521,경의선,야당,7043,6966,14009
20210521,경의선,탄현,7755,7513,15268
20210521,경의선,일산,9387,9432,18819
20210521,경의선,풍산,5657,5355,11012
20210521,경의선,백마,7142,6895,14037
20210521,경의선,곡산,620,602,1222
20210521,경의선,능곡,3871,3520,7391
20210521,경의선,행신,8172,8074,16246
20210521,경의선,강매,3275,2895,6170
20210521,경의선,화전,1893,1780,3673
20210521,경의선,수색,2747,2857,5604
20210521,경의선,디지털미디어시티,2576,2396,4972
20210521,경의선,가좌,5544,5167,10711
20210521,경의선,홍대입구,1780,2031,3811
20210521,경의선,서강대,2189,2022,4211
20210521,경의선,공덕,3700,3277,6977
20210521,경의선,효창공원앞,2956,3361,6317
20210521,경의선,신촌,891,1105,1996
20210521,경의선,서울,4207,5369,9576
20210524,경의선,서울,4348,5576,9924
20210524,경의선,신촌,852,1121,1973
20210524,경의선,효창공원앞,2940,3376,6316
20210524,경의선,공덕,3491,3189,6680
20210524,경의선,서강대,2105,2015,4120
20210524,경의선,홍대입구,1500,1779,3279
20210524,경의선,가좌,5582,5044,10626
20210524,경의선,디지털미디어시티,2527,2495,5022
20210524,경의선,수색,2901,2959,5860
20210524,경의선,화전,1827,1792,3619
20210524,경의선,강매,3297,2822,6119
20210524,경의선,행신,7842,8058,15900
20210524,경의선,능곡,3913,3498,7411
20210524,경의선,곡산,636,614,1250
20210524,경의선,백마,7147,6726,13873
20210524,경의선,풍산,5604,5176,10780
20210524,경의선,일산,9541,9354,18895
20210524,경의선,탄현,7801,7404,15205
20210524,경의선,야당,6904,6683,13587
20210524,경의선,운정,6818,6295,13113
20210524,경의선,금릉,4725,4538,9263
20210524,경의선,금촌,6452,6226,12678
20210524,경의선,월롱,2519,2485,5004
20210524,경의선,파주,1563,1232,2795
20210524,경의선,문산,5343,5287,10630
20210524,경의선,임진강,22,6,28
20210525,경의선,서울,4275,5332,9607
20210525,경의선,신촌,931,1109,2040
20210525,경의선,효창공원앞,2953,3300,6253
20210525,경의선,공덕,3473,3043,6516
20210525,경의선,서강대,1995,1957,3952
20210525,경의선,홍대입구,1554,1707,3261
20210525,경의선,가좌,5393,4959,10352
20210525,경의선,디지털미디어시티,2624,2478,5102
20210525,경의선,수색,2877,2969,5846
20210525,경의선,화전,2129,1927,4056
20210525,경의선,강매,3336,2854,6190
20210525,경의선,행신,7901,8033,15934
20210525,경의선,능곡,3941,3499,7440
20210525,경의선,곡산,597,595,1192
20210525,경의선,백마,6925,6742,13667
20210525,경의선,풍산,5573,5264,10837
20210525,경의선,일산,9286,9182,18468
20210525,경의선,탄현,7858,7518,15376
20210525,경의선,야당,6752,6536,13288
20210525,경의선,운정,6574,6312,12886
20210525,경의선,금릉,4435,4452,8887
20210525,경의선,금촌,6213,6157,12370
20210525,경의선,월롱,2639,2434,5073
20210525,경의선,파주,1645,1254,2899
20210525,경의선,문산,4810,4805,9615
20210525,경의선,임진강,16,10,26
20210526,경의선,서울,4348,5586,9934
20210526,경의선,신촌,932,1123,2055
20210526,경의선,효창공원앞,2978,3354,6332
20210526,경의선,공덕,3593,3227,6820
20210526,경의선,서강대,2078,2051,4129
20210526,경의선,홍대입구,1670,1807,3477
20210526,경의선,가좌,5656,5242,10898
20210526,경의선,디지털미디어시티,2510,2536,5046
20210526,경의선,수색,2877,3059,5936
20210526,경의선,화전,1983,1833,3816
20210526,경의선,강매,3394,2936,6330
20210526,경의선,행신,8101,7970,16071
20210526,경의선,능곡,3871,3558,7429
20210526,경의선,곡산,664,634,1298
20210526,경의선,백마,7233,6952,14185
20210526,경의선,풍산,5656,5219,10875
20210526,경의선,일산,9438,9397,18835
20210526,경의선,탄현,7750,7520,15270
20210526,경의선,야당,7049,6844,13893
20210526,경의선,운정,6863,6453,13316
20210526,경의선,금릉,4755,4576,9331
20210526,경의선,금촌,6735,6688,13423
20210526,경의선,월롱,2561,2390,4951
20210526,경의선,파주,1603,1208,2811
20210526,경의선,문산,5049,4969,10018
20210526,경의선,임진강,19,17,36
20210527,경의선,문산,4447,4561,9008
20210527,경의선,서울,4126,5143,9269
20210527,경의선,신촌,796,1036,1832
20210527,경의선,효창공원앞,2938,3299,6237
20210527,경의선,공덕,3486,3057,6543
20210527,경의선,서강대,2010,1908,3918
20210527,경의선,홍대입구,1559,1751,3310
20210527,경의선,가좌,5374,4911,10285
20210527,경의선,디지털미디어시티,2553,2453,5006
20210527,경의선,수색,2738,2944,5682
20210527,경의선,화전,1873,1691,3564
20210527,경의선,강매,3180,2795,5975
20210527,경의선,행신,7823,7817,15640
20210527,경의선,능곡,3751,3338,7089
20210527,경의선,곡산,552,557,1109
20210527,경의선,백마,6857,6571,13428
20210527,경의선,풍산,5428,5158,10586
20210527,경의선,일산,9072,9099,18171
20210527,경의선,탄현,7513,7165,14678
20210527,경의선,야당,6823,6581,13404
20210527,경의선,운정,6492,6127,12619
20210527,경의선,금릉,4508,4405,8913
20210527,경의선,금촌,5848,5866,11714
20210527,경의선,월롱,2679,2323,5002
20210527,경의선,파주,1471,1063,2534
20210527,경의선,임진강,5,2,7
20210528,경의선,임진강,7,8,15
20210528,경의선,문산,5133,5030,10163
20210528,경의선,파주,1251,802,2053
20210528,경의선,월롱,1915,1760,3675
20210528,경의선,금촌,6428,6218,12646
20210528,경의선,금릉,4763,4604,9367
20210528,경의선,운정,6644,6226,12870
20210528,경의선,야당,6873,6893,13766
20210528,경의선,탄현,7679,7395,15074
20210528,경의선,일산,9733,9727,19460
20210528,경의선,풍산,5475,5327,10802
20210528,경의선,백마,7013,6651,13664
20210528,경의선,곡산,609,576,1185
20210528,경의선,능곡,3758,3409,7167
20210528,경의선,행신,8012,8137,16149
20210528,경의선,강매,3256,2805,6061
20210528,경의선,화전,1883,1725,3608
20210528,경의선,수색,2676,2688,5364
20210528,경의선,디지털미디어시티,2555,2425,4980
20210528,경의선,가좌,5482,5006,10488
20210528,경의선,홍대입구,1780,1934,3714
20210528,경의선,서강대,2040,2042,4082
20210528,경의선,공덕,3616,3192,6808
20210528,경의선,효창공원앞,2956,3267,6223
20210528,경의선,신촌,794,962,1756
20210528,경의선,서울,4298,5403,9701
20210531,경의선,임진강,7,5,12
20210531,경의선,문산,4864,4776,9640
20210531,경의선,파주,1648,1262,2910
20210531,경의선,월롱,2627,2501,5128
20210531,경의선,금촌,6181,6187,12368
20210531,경의선,금릉,4558,4473,9031
20210531,경의선,운정,6660,6186,12846
20210531,경의선,야당,6602,6347,12949
20210531,경의선,탄현,7673,7249,14922
20210531,경의선,일산,9208,9043,18251
20210531,경의선,풍산,5462,5029,10491
20210531,경의선,백마,6938,6558,13496
20210531,경의선,곡산,564,563,1127
20210531,경의선,능곡,3747,3348,7095
20210531,경의선,행신,7745,7765,15510
20210531,경의선,강매,3223,2767,5990
20210531,경의선,화전,1678,1554,3232
20210531,경의선,수색,2959,3045,6004
20210531,경의선,디지털미디어시티,2482,2400,4882
20210531,경의선,가좌,5391,4973,10364
20210531,경의선,홍대입구,1402,1627,3029
20210531,경의선,서강대,1949,1854,3803
20210531,경의선,공덕,3461,3115,6576
20210531,경의선,효창공원앞,2903,3195,6098
20210531,경의선,신촌,802,977,1779
20210531,경의선,서울,4287,5389,9676
20210601,경의선,가좌,5351,4912,10263
20210601,경의선,디지털미디어시티,2605,2433,5038
20210601,경의선,수색,2901,3070,5971
20210601,경의선,화전,2108,1927,4035
20210601,경의선,강매,3310,2898,6208
20210601,경의선,행신,7761,7709,15470
20210601,경의선,능곡,3801,3491,7292
20210601,경의선,곡산,592,592,1184
20210601,경의선,백마,7045,6782,13827
20210601,경의선,풍산,5526,5162,10688
20210601,경의선,일산,9314,9271,18585
20210601,경의선,탄현,7730,7420,15150
20210601,경의선,야당,6697,6605,13302
20210601,경의선,운정,6756,6311,13067
20210601,경의선,금릉,4587,4438,9025
20210601,경의선,금촌,6353,6400,12753
20210601,경의선,월롱,2823,2674,5497
20210601,경의선,파주,1650,1211,2861
20210601,경의선,문산,4797,4728,9525
20210601,경의선,임진강,5,1,6
20210601,경의선,서울,4263,5355,9618
20210601,경의선,신촌,850,999,1849
20210601,경의선,효창공원앞,2916,3394,6310
20210601,경의선,공덕,3489,3164,6653
20210601,경의선,서강대,2050,1999,4049
20210601,경의선,홍대입구,1514,1702,3216
20210602,경의선,서울,4155,5340,9495
20210602,경의선,신촌,881,1088,1969
20210602,경의선,효창공원앞,2916,3416,6332
20210602,경의선,공덕,3552,3178,6730
20210602,경의선,서강대,2053,1960,4013
20210602,경의선,홍대입구,1540,1763,3303
20210602,경의선,가좌,5444,4989,10433
20210602,경의선,디지털미디어시티,2602,2416,5018
20210602,경의선,수색,2960,3130,6090
20210602,경의선,화전,1885,1706,3591
20210602,경의선,강매,3370,2917,6287
20210602,경의선,행신,7760,7713,15473
20210602,경의선,능곡,3824,3466,7290
20210602,경의선,곡산,621,650,1271
20210602,경의선,백마,7095,6803,13898
20210602,경의선,풍산,5616,5183,10799
20210602,경의선,일산,9370,9320,18690
20210602,경의선,탄현,7725,7345,15070
20210602,경의선,야당,6853,6662,13515
20210602,경의선,운정,6719,6364,13083
20210602,경의선,금릉,4627,4588,9215
20210602,경의선,금촌,6402,6245,12647
20210602,경의선,월롱,2732,2488,5220
20210602,경의선,파주,1611,1221,2832
20210602,경의선,문산,4862,4833,9695
20210602,경의선,임진강,4,11,15
20210603,경의선,서울,4054,5201,9255
20210603,경의선,신촌,789,1021,1810
20210603,경의선,효창공원앞,2809,3255,6064
20210603,경의선,공덕,3480,3127,6607
20210603,경의선,서강대,1932,1948,3880
20210603,경의선,홍대입구,1410,1670,3080
20210603,경의선,가좌,5213,4918,10131
20210603,경의선,디지털미디어시티,2515,2458,4973
20210603,경의선,수색,2736,2982,5718
20210603,경의선,화전,1864,1729,3593
20210603,경의선,강매,3173,2690,5863
20210603,경의선,행신,7640,7633,15273
20210603,경의선,능곡,3619,3307,6926
20210603,경의선,곡산,594,577,1171
20210603,경의선,백마,6769,6600,13369
20210603,경의선,풍산,5308,5067,10375
20210603,경의선,일산,9464,9612,19076
20210603,경의선,탄현,7546,7255,14801
20210603,경의선,야당,6571,6323,12894
20210603,경의선,운정,6520,6096,12616
20210603,경의선,금릉,4370,4297,8667
20210603,경의선,금촌,5839,5897,11736
20210603,경의선,월롱,2615,2410,5025
20210603,경의선,파주,1467,1117,2584
20210603,경의선,문산,4472,4629,9101
20210603,경의선,임진강,14,10,24
20210604,경의선,서울,4321,5590,9911
20210604,경의선,신촌,967,1139,2106
20210604,경의선,효창공원앞,3000,3404,6404
20210604,경의선,공덕,3600,3262,6862
20210604,경의선,서강대,2187,2077,4264
20210604,경의선,홍대입구,1846,2149,3995
20210604,경의선,가좌,5715,5238,10953
20210604,경의선,디지털미디어시티,2706,2610,5316
20210604,경의선,수색,2953,3062,6015
20210604,경의선,화전,1905,1779,3684
20210604,경의선,강매,3401,2898,6299
20210604,경의선,행신,8286,8298,16584
20210604,경의선,능곡,3988,3595,7583
20210604,경의선,곡산,650,662,1312
20210604,경의선,백마,7214,6844,14058
20210604,경의선,풍산,5799,5596,11395
20210604,경의선,일산,9484,9492,18976
20210604,경의선,탄현,7899,7655,15554
20210604,경의선,야당,7225,7312,14537
20210604,경의선,운정,7016,6543,13559
20210604,경의선,금릉,4767,4693,9460
20210604,경의선,금촌,6702,6607,13309
20210604,경의선,월롱,2698,2271,4969
20210604,경의선,파주,1254,850,2104
20210604,경의선,문산,5573,5647,11220
20210604,경의선,임진강,14,15,29
20210607,경의선,임진강,15,12,27
20210607,경의선,문산,4836,4779,9615
20210607,경의선,파주,1696,1307,3003
20210607,경의선,월롱,2520,2551,5071
20210607,경의선,금촌,6169,6021,12190
20210607,경의선,금릉,4607,4440,9047
20210607,경의선,운정,6602,6228,12830
20210607,경의선,야당,6720,6434,13154
20210607,경의선,탄현,7543,7237,14780
20210607,경의선,일산,9226,9051,18277
20210607,경의선,풍산,5482,5154,10636
20210607,경의선,백마,6994,6664,13658
20210607,경의선,곡산,602,603,1205
20210607,경의선,능곡,3792,3455,7247
20210607,경의선,행신,7635,7708,15343
20210607,경의선,강매,3272,2844,6116
20210607,경의선,화전,1759,1643,3402
20210607,경의선,수색,3009,3060,6069
20210607,경의선,디지털미디어시티,2487,2446,4933
20210607,경의선,가좌,5438,4964,10402
20210607,경의선,홍대입구,1470,1638,3108
20210607,경의선,서강대,2010,1909,3919
20210607,경의선,공덕,3390,3228,6618
20210607,경의선,효창공원앞,2740,3120,5860
20210607,경의선,신촌,874,1048,1922
20210607,경의선,서울,4312,5291,9603
20210608,경의선,서울,4306,5538,9844
20210608,경의선,신촌,839,1036,1875
20210608,경의선,효창공원앞,2865,3310,6175
20210608,경의선,공덕,3404,3101,6505
20210608,경의선,서강대,1996,1910,3906
20210608,경의선,홍대입구,1581,1756,3337
20210608,경의선,가좌,5423,4956,10379
20210608,경의선,디지털미디어시티,2526,2432,4958
20210608,경의선,수색,2990,3168,6158
20210608,경의선,화전,1870,1677,3547
20210608,경의선,강매,3246,2840,6086
20210608,경의선,행신,7920,7841,15761
20210608,경의선,능곡,3859,3431,7290
20210608,경의선,곡산,609,621,1230
20210608,경의선,백마,7165,6938,14103
20210608,경의선,풍산,5674,5331,11005
20210608,경의선,일산,10365,10316,20681
20210608,경의선,탄현,7879,7503,15382
20210608,경의선,야당,6888,6728,13616
20210608,경의선,운정,6851,6577,13428
20210608,경의선,금릉,4630,4467,9097
20210608,경의선,금촌,6150,6035,12185
20210608,경의선,월롱,2551,2372,4923
20210608,경의선,파주,1464,1146,2610
20210608,경의선,문산,4880,4866,9746
20210608,경의선,임진강,16,21,37
20210609,경의선,서울,4343,5443,9786
20210609,경의선,신촌,908,1107,2015
20210609,경의선,효창공원앞,2900,3359,6259
20210609,경의선,공덕,3514,3159,6673
20210609,경의선,서강대,1984,1972,3956
20210609,경의선,홍대입구,1623,1769,3392
20210609,경의선,가좌,5412,5013,10425
20210609,경의선,디지털미디어시티,2506,2527,5033
20210609,경의선,수색,2972,3008,5980
20210609,경의선,화전,1813,1682,3495
20210609,경의선,강매,3301,2898,6199
20210609,경의선,행신,7681,7815,15496
20210609,경의선,능곡,3809,3461,7270
20210609,경의선,곡산,578,626,1204
20210609,경의선,백마,6975,6762,13737
20210609,경의선,풍산,5488,5158,10646
20210609,경의선,일산,9297,9301,18598
20210609,경의선,탄현,7754,7465,15219
20210609,경의선,야당,6855,6661,13516
20210609,경의선,운정,6804,6380,13184
20210609,경의선,금릉,4733,4565,9298
20210609,경의선,금촌,6155,6103,12258
20210609,경의선,월롱,2701,2462,5163
20210609,경의선,파주,1555,1169,2724
20210609,경의선,문산,5319,5321,10640
20210609,경의선,임진강,28,7,35
20210610,경의선,임진강,10,10,20
20210610,경의선,문산,4703,4768,9471
20210610,경의선,파주,1736,1392,3128
20210610,경의선,월롱,2394,2258,4652
20210610,경의선,금촌,6050,6027,12077
20210610,경의선,금릉,4577,4529,9106
20210610,경의선,운정,6674,6262,12936
20210610,경의선,야당,6804,6504,13308
20210610,경의선,탄현,7637,7443,15080
20210610,경의선,일산,9313,9323,18636
20210610,경의선,풍산,5671,5245,10916
20210610,경의선,백마,6959,6786,13745
20210610,경의선,곡산,610,595,1205
20210610,경의선,능곡,3839,3437,7276
20210610,경의선,행신,7752,7833,15585
20210610,경의선,강매,3274,2799,6073
20210610,경의선,화전,1741,1566,3307
20210610,경의선,수색,2847,3054,5901
20210610,경의선,디지털미디어시티,2555,2480,5035
20210610,경의선,가좌,5419,5237,10656
20210610,경의선,홍대입구,1586,1791,3377
20210610,경의선,서강대,1922,1923,3845
20210610,경의선,공덕,3586,3186,6772
20210610,경의선,효창공원앞,2879,3328,6207
20210610,경의선,신촌,838,984,1822
20210610,경의선,서울,4285,5436,9721
20210611,경의선,임진강,19,16,35
20210611,경의선,문산,4967,4826,9793
20210611,경의선,파주,1363,912,2275
20210611,경의선,월롱,2499,2033,4532
20210611,경의선,금촌,6646,6592,13238
20210611,경의선,금릉,4672,4548,9220
20210611,경의선,운정,6680,6257,12937
20210611,경의선,야당,6802,6876,13678
20210611,경의선,탄현,7596,7426,15022
20210611,경의선,일산,8960,9057,18017
20210611,경의선,풍산,5537,5243,10780
20210611,경의선,백마,6769,6570,13339
20210611,경의선,곡산,574,602,1176
20210611,경의선,능곡,3758,3418,7176
20210611,경의선,행신,7706,7853,15559
20210611,경의선,강매,3177,2710,5887
20210611,경의선,화전,1696,1527,3223
20210611,경의선,수색,2711,2833,5544
20210611,경의선,디지털미디어시티,2483,2448,4931
20210611,경의선,가좌,5403,4934,10337
20210611,경의선,홍대입구,1747,1916,3663
20210611,경의선,서강대,2077,1962,4039
20210611,경의선,공덕,3550,3164,6714
20210611,경의선,효창공원앞,2847,3249,6096
20210611,경의선,신촌,872,1095,1967
20210611,경의선,서울,4324,5347,9671
20210614,경의선,능곡,3658,3385,7043
20210614,경의선,계양,1,0,1
20210614,경의선,임진강,16,21,37
20210614,경의선,문산,5327,5185,10512
20210614,경의선,파주,1817,1369,3186
20210614,경의선,월롱,2750,2717,5467
20210614,경의선,금촌,6211,6229,12440
20210614,경의선,금릉,4566,4466,9032
20210614,경의선,운정,6627,6227,12854
20210614,경의선,야당,6736,6555,13291
20210614,경의선,탄현,7730,7293,15023
20210614,경의선,일산,9347,9236,18583
20210614,경의선,풍산,5517,5137,10654
20210614,경의선,백마,6978,6631,13609
20210614,경의선,곡산,645,649,1294
20210614,경의선,행신,7720,7734,15454
20210614,경의선,강매,3252,2836,6088
20210614,경의선,화전,1562,1443,3005
20210614,경의선,수색,2925,3010,5935
20210614,경의선,디지털미디어시티,2537,2391,4928
20210614,경의선,가좌,5453,5075,10528
20210614,경의선,홍대입구,1527,1643,3170
20210614,경의선,서강대,1963,1840,3803
20210614,경의선,공덕,3442,3145,6587
20210614,경의선,효창공원앞,2794,3193,5987
20210614,경의선,신촌,862,1116,1978
20210614,경의선,서울,4238,5481,9719
20210615,경의선,임진강,15,10,25
20210615,경의선,문산,4730,4716,9446
20210615,경의선,파주,1896,1397,3293
20210615,경의선,월롱,2751,2592,5343
20210615,경의선,금촌,5953,5928,11881
20210615,경의선,금릉,4399,4374,8773
20210615,경의선,운정,6596,6160,12756
20210615,경의선,야당,6593,6561,13154
20210615,경의선,탄현,7545,7275,14820
20210615,경의선,일산,9246,9243,18489
20210615,경의선,풍산,5496,5155,10651
20210615,경의선,백마,6981,6808,13789
20210615,경의선,곡산,572,589,1161
20210615,경의선,능곡,3701,3351,7052
20210615,경의선,행신,7788,7702,15490
20210615,경의선,강매,3277,2853,6130
20210615,경의선,화전,2722,2543,5265
20210615,경의선,수색,2899,3038,5937
20210615,경의선,디지털미디어시티,2588,2363,4951
20210615,경의선,가좌,5419,5045,10464
20210615,경의선,홍대입구,1536,1643,3179
20210615,경의선,서강대,2021,1927,3948
20210615,경의선,공덕,3505,3114,6619
20210615,경의선,효창공원앞,2884,3270,6154
20210615,경의선,신촌,854,1065,1919
20210615,경의선,서울,4162,5116,9278
20210616,경의선,신촌,862,1084,1946
20210616,경의선,공덕,3538,3146,6684
20210616,경의선,서강대,2050,1922,3972
20210616,경의선,홍대입구,1664,1854,3518
20210616,경의선,가좌,5492,5051,10543
20210616,경의선,디지털미디어시티,2686,2508,5194
20210616,경의선,수색,2845,3024,5869
20210616,경의선,화전,1416,1276,2692
20210616,경의선,강매,3304,2826,6130
20210616,경의선,행신,7867,7803,15670
20210616,경의선,능곡,3804,3488,7292
20210616,경의선,곡산,563,611,1174
20210616,경의선,백마,7045,6672,13717
20210616,경의선,풍산,5675,5301,10976
20210616,경의선,일산,9352,9246,18598
20210616,경의선,탄현,7712,7447,15159
20210616,경의선,야당,6992,6920,13912
20210616,경의선,운정,6718,6356,13074
20210616,경의선,금릉,4779,4589,9368
20210616,경의선,금촌,6659,6605,13264
20210616,경의선,월롱,2953,2739,5692
20210616,경의선,파주,1702,1297,2999
20210616,경의선,문산,4947,5086,10033
20210616,경의선,임진강,12,11,23
20210616,경의선,서울,88,174,262
20210616,경의선,김포공항,1,0,1
20210616,경의선,서울,4243,5211,9454
20210616,경의선,효창공원앞,2996,3298,6294
20210617,경의선,임진강,18,25,43
20210617,경의선,문산,4941,5040,9981
20210617,경의선,파주,1308,873,2181
20210617,경의선,월롱,2698,2453,5151
20210617,경의선,금촌,6189,6198,12387
20210617,경의선,금릉,4530,4545,9075
20210617,경의선,운정,6735,6380,13115
20210617,경의선,야당,6981,6704,13685
20210617,경의선,탄현,7737,7512,15249
20210617,경의선,일산,9476,9359,18835
20210617,경의선,풍산,5699,5354,11053
20210617,경의선,백마,7159,6912,14071
20210617,경의선,곡산,607,652,1259
20210617,경의선,능곡,3821,3504,7325
20210617,경의선,행신,7885,8011,15896
20210617,경의선,강매,3306,2756,6062
20210617,경의선,화전,2778,2510,5288
20210617,경의선,수색,2952,3056,6008
20210617,경의선,디지털미디어시티,2632,2528,5160
20210617,경의선,가좌,5531,5165,10696
20210617,경의선,홍대입구,1594,1835,3429
20210617,경의선,서강대,2000,1965,3965
20210617,경의선,공덕,3575,3251,6826
20210617,경의선,효창공원앞,2919,3279,6198
20210617,경의선,신촌,866,1054,1920
20210617,경의선,서울,4347,5335,9682
20210618,경의선,서울,4189,5326,9515
20210618,경의선,신촌,849,1084,1933
20210618,경의선,효창공원앞,2833,3156,5989
20210618,경의선,공덕,3616,3174,6790
20210618,경의선,서강대,2113,2033,4146
20210618,경의선,홍대입구,1820,2008,3828
20210618,경의선,가좌,5534,5116,10650
20210618,경의선,디지털미디어시티,2638,2488,5126
20210618,경의선,수색,2818,2903,5721
20210618,경의선,화전,2553,2291,4844
20210618,경의선,강매,3206,2806,6012
20210618,경의선,행신,8232,8201,16433
20210618,경의선,능곡,3727,3457,7184
20210618,경의선,곡산,627,639,1266
20210618,경의선,백마,7021,6758,13779
20210618,경의선,풍산,5684,5350,11034
20210618,경의선,일산,9700,9702,19402
20210618,경의선,탄현,7754,7421,15175
20210618,경의선,야당,6811,6951,13762
20210618,경의선,운정,6734,6330,13064
20210618,경의선,금릉,4768,4663,9431
20210618,경의선,금촌,6356,6263,12619
20210618,경의선,월롱,2513,2023,4536
20210618,경의선,파주,1288,807,2095
20210618,경의선,문산,5081,5031,10112
20210618,경의선,임진강,8,6,14
20210618,경의선,서울,87,87,174
20210621,경의선,계양,1,0,1
20210621,경의선,임진강,16,15,31
20210621,경의선,문산,5121,5052,10173
20210621,경의선,파주,1283,830,2113
20210621,경의선,월롱,2177,2146,4323
20210621,경의선,금촌,6791,6632,13423
20210621,경의선,금릉,4853,4664,9517
20210621,경의선,운정,6814,6432,13246
20210621,경의선,야당,7000,6815,13815
20210621,경의선,서울,4437,5558,9995
20210621,경의선,신촌,866,1101,1967
20210621,경의선,효창공원앞,2897,3212,6109
20210621,경의선,공덕,3608,3305,6913
20210621,경의선,서강대,2168,2073,4241
20210621,경의선,홍대입구,1631,1716,3347
20210621,경의선,가좌,5446,5140,10586
20210621,경의선,디지털미디어시티,2567,2476,5043
20210621,경의선,수색,2885,3046,5931
20210621,경의선,화전,1527,1386,2913
20210621,경의선,강매,3375,2931,6306
20210621,경의선,행신,7959,8017,15976
20210621,경의선,능곡,3812,3620,7432
20210621,경의선,곡산,609,643,1252
20210621,경의선,백마,7204,6868,14072
20210621,경의선,풍산,5689,5382,11071
20210621,경의선,일산,9429,9238,18667
20210621,경의선,탄현,7851,7522,15373
20210622,경의선,서울,4263,5434,9697
20210622,경의선,신촌,915,1076,1991
20210622,경의선,효창공원앞,2960,3305,6265
20210622,경의선,공덕,3589,3269,6858
20210622,경의선,서강대,2172,2076,4248
20210622,경의선,홍대입구,1697,1847,3544
20210622,경의선,가좌,5487,5104,10591
20210622,경의선,디지털미디어시티,2615,2501,5116
20210622,경의선,수색,3047,3160,6207
20210622,경의선,화전,1555,1433,2988
20210622,경의선,강매,3371,2928,6299
20210622,경의선,행신,8001,7995,15996
20210622,경의선,능곡,3814,3538,7352
20210622,경의선,곡산,654,645,1299
20210622,경의선,백마,7267,6875,14142
20210622,경의선,풍산,5675,5333,11008
20210622,경의선,일산,9430,9373,18803
20210622,경의선,탄현,7684,7418,15102
20210622,경의선,야당,6885,6753,13638
20210622,경의선,운정,6819,6489,13308
20210622,경의선,금릉,4660,4591,9251
20210622,경의선,금촌,6208,6127,12335
20210622,경의선,월롱,2182,2081,4263
20210622,경의선,파주,1265,818,2083
20210622,경의선,문산,4962,5023,9985
20210622,경의선,임진강,12,9,21
20210623,경의선,서울,4348,5503,9851
20210623,경의선,신촌,863,1057,1920
20210623,경의선,효창공원앞,2871,3289,6160
20210623,경의선,공덕,3593,3305,6898
20210623,경의선,서강대,2096,2000,4096
20210623,경의선,홍대입구,1672,1969,3641
20210623,경의선,가좌,5409,5041,10450
20210623,경의선,디지털미디어시티,2585,2554,5139
20210623,경의선,수색,2977,3069,6046
20210623,경의선,화전,1587,1414,3001
20210623,경의선,강매,3400,2906,6306
20210623,경의선,행신,8088,7949,16037
20210623,경의선,능곡,3895,3586,7481
20210623,경의선,곡산,645,651,1296
20210623,경의선,백마,7149,6917,14066
20210623,경의선,풍산,5665,5286,10951
20210623,경의선,일산,10379,10362,20741
20210623,경의선,탄현,7782,7457,15239
20210623,경의선,야당,7057,6912,13969
20210623,경의선,운정,6804,6443,13247
20210623,경의선,금릉,4712,4597,9309
20210623,경의선,금촌,6332,6154,12486
20210623,경의선,월롱,2240,2001,4241
20210623,경의선,파주,1222,804,2026
20210623,경의선,문산,4968,4875,9843
20210623,경의선,임진강,22,27,49
20210624,경의선,서울,4393,5472,9865
20210624,경의선,신촌,886,1147,2033
20210624,경의선,효창공원앞,2971,3384,6355
20210624,경의선,공덕,3752,3389,7141
20210624,경의선,서강대,2120,2005,4125
20210624,경의선,홍대입구,1782,1947,3729
20210624,경의선,가좌,5559,5094,10653
20210624,경의선,디지털미디어시티,2607,2393,5000
20210624,경의선,수색,3006,3087,6093
20210624,경의선,화전,1735,1572,3307
20210624,경의선,강매,3360,2892,6252
20210624,경의선,행신,8053,7956,16009
20210624,경의선,능곡,3903,3597,7500
20210624,경의선,곡산,620,659,1279
20210624,경의선,백마,7215,6939,14154
20210624,경의선,풍산,5728,5339,11067
20210624,경의선,일산,9421,9251,18672
20210624,경의선,탄현,7836,7551,15387
20210624,경의선,야당,7040,7007,14047
20210624,경의선,운정,6761,6462,13223
20210624,경의선,금릉,4766,4669,9435
20210624,경의선,금촌,6465,6394,12859
20210624,경의선,월롱,2366,2042,4408
20210624,경의선,파주,1295,833,2128
20210624,경의선,문산,5400,5502,10902
20210624,경의선,임진강,34,20,54
20210624,경의선,검암,1,0,1
20210625,경의선,임진강,30,19,49
20210625,경의선,문산,5610,5501,11111
20210625,경의선,파주,1350,945,2295
20210625,경의선,월롱,2513,2011,4524
20210625,경의선,금촌,6861,6775,13636
20210625,경의선,금릉,5010,4804,9814
20210625,경의선,운정,6918,6657,13575
20210625,경의선,야당,7334,7307,14641
20210625,경의선,탄현,7968,7782,15750
20210625,경의선,일산,9675,9482,19157
20210625,경의선,풍산,5875,5647,11522
20210625,경의선,백마,7255,6953,14208
20210625,경의선,곡산,642,621,1263
20210625,경의선,능곡,3963,3561,7524
20210625,경의선,행신,8295,8363,16658
20210625,경의선,강매,3442,2947,6389
20210625,경의선,화전,1850,1607,3457
20210625,경의선,수색,2912,2969,5881
20210625,경의선,디지털미디어시티,2810,2674,5484
20210625,경의선,가좌,5660,5258,10918
20210625,경의선,홍대입구,1909,2202,4111
20210625,경의선,서강대,2306,2223,4529
20210625,경의선,공덕,3755,3365,7120
20210625,경의선,효창공원앞,2884,3373,6257
20210625,경의선,신촌,952,1108,2060
20210625,경의선,서울,4463,5552,10015
20210625,경의선,계양,1,0,1
20210628,경의선,임진강,18,9,27
20210628,경의선,문산,5056,4893,9949
20210628,경의선,파주,1213,790,2003
20210628,경의선,월롱,2178,2151,4329
20210628,경의선,금촌,6297,6220,12517
20210628,경의선,금릉,4623,4538,9161
20210628,경의선,운정,6759,6369,13128
20210628,경의선,야당,6918,6717,13635
20210628,경의선,탄현,7680,7356,15036
20210628,경의선,일산,10182,9903,20085
20210628,경의선,풍산,5519,5130,10649
20210628,경의선,백마,7037,6716,13753
20210628,경의선,곡산,570,595,1165
20210628,경의선,능곡,3716,3445,7161
20210628,경의선,행신,7793,7837,15630
20210628,경의선,강매,3221,2810,6031
20210628,경의선,화전,1624,1442,3066
20210628,경의선,수색,2911,3097,6008
20210628,경의선,디지털미디어시티,2471,2434,4905
20210628,경의선,가좌,5358,5056,10414
20210628,경의선,홍대입구,1510,1672,3182
20210628,경의선,서강대,2146,2019,4165
20210628,경의선,공덕,3485,3034,6519
20210628,경의선,효창공원앞,2804,3214,6018
20210628,경의선,신촌,814,1071,1885
20210628,경의선,서울,4273,5314,9587
20210629,경의선,임진강,30,22,52
20210629,경의선,문산,5401,5405,10806
20210629,경의선,파주,1241,815,2056
20210629,경의선,월롱,2271,2154,4425
20210629,경의선,금촌,6284,6208,12492
20210629,경의선,금릉,4677,4562,9239
20210629,경의선,운정,6785,6400,13185
20210629,경의선,야당,6868,6732,13600
20210629,경의선,탄현,7665,7323,14988
20210629,경의선,일산,9284,9234,18518
20210629,경의선,풍산,5535,5184,10719
20210629,경의선,백마,6988,6581,13569
20210629,경의선,곡산,567,604,1171
20210629,경의선,능곡,3641,3381,7022
20210629,경의선,행신,7992,7881,15873
20210629,경의선,강매,3319,2868,6187
20210629,경의선,화전,1510,1363,2873
20210629,경의선,수색,2894,3106,6000
20210629,경의선,디지털미디어시티,2602,2416,5018
20210629,경의선,가좌,5436,5048,10484
20210629,경의선,홍대입구,1583,1687,3270
20210629,경의선,서강대,2120,2026,4146
20210629,경의선,공덕,3524,3217,6741
20210629,경의선,효창공원앞,2954,3326,6280
20210629,경의선,신촌,880,1114,1994
20210629,경의선,서울,4331,5332,9663
20210630,경의선,서울,4304,5392,9696
20210630,경의선,신촌,837,1074,1911
20210630,경의선,효창공원앞,2916,3339,6255
20210630,경의선,공덕,3706,3268,6974
20210630,경의선,서강대,2161,2017,4178
20210630,경의선,홍대입구,1553,1776,3329
20210630,경의선,가좌,5441,5058,10499
20210630,경의선,디지털미디어시티,2558,2432,4990
20210630,경의선,수색,2943,3112,6055
20210630,경의선,화전,1572,1457,3029
20210630,경의선,강매,3251,2843,6094
20210630,경의선,행신,7924,7676,15600
20210630,경의선,능곡,3658,3332,6990
20210630,경의선,곡산,605,611,1216
20210630,경의선,백마,7027,6642,13669
20210630,경의선,풍산,5479,5117,10596
20210630,경의선,일산,9327,9134,18461
20210630,경의선,탄현,7680,7308,14988
20210630,경의선,야당,6848,6827,13675
20210630,경의선,운정,6686,6476,13162
20210630,경의선,금릉,4819,4616,9435
20210630,경의선,금촌,6191,6222,12413
20210630,경의선,월롱,2226,2069,4295
20210630,경의선,파주,1209,782,1991
20210630,경의선,문산,4889,4884,9773
20210630,경의선,임진강,15,4,19
20210701,경의선,임진강,18,10,28
20210701,경의선,문산,5181,5208,10389
20210701,경의선,파주,1235,868,2103
20210701,경의선,월롱,2218,2179,4397
20210701,경의선,금촌,6556,6629,13185
20210701,경의선,금릉,4841,4683,9524
20210701,경의선,운정,6823,6433,13256
20210701,경의선,야당,7165,6826,13991
20210701,경의선,탄현,7991,7650,15641
20210701,경의선,일산,9478,9323,18801
20210701,경의선,풍산,5661,5213,10874
20210701,경의선,백마,7125,6879,14004
20210701,경의선,곡산,605,615,1220
20210701,경의선,능곡,3749,3448,7197
20210701,경의선,행신,7886,7906,15792
20210701,경의선,강매,3375,2806,6181
20210701,경의선,화전,1633,1428,3061
20210701,경의선,수색,2801,2884,5685
20210701,경의선,디지털미디어시티,2577,2477,5054
20210701,경의선,가좌,5400,5026,10426
20210701,경의선,홍대입구,1619,1761,3380
20210701,경의선,서강대,2063,2003,4066
20210701,경의선,공덕,3607,3289,6896
20210701,경의선,효창공원앞,2875,3347,6222
20210701,경의선,신촌,831,1047,1878
20210701,경의선,서울,4317,5497,9814
20210702,경의선,임진강,23,14,37
20210702,경의선,문산,5295,5252,10547
20210702,경의선,파주,1354,830,2184
20210702,경의선,월롱,2606,2092,4698
20210702,경의선,금촌,6657,6568,13225
20210702,경의선,금릉,4871,4851,9722
20210702,경의선,운정,6932,6486,13418
20210702,경의선,야당,7237,7204,14441
20210702,경의선,탄현,7919,7633,15552
20210702,경의선,일산,9322,9276,18598
20210702,경의선,풍산,5759,5475,11234
20210702,경의선,백마,7104,6638,13742
20210702,경의선,곡산,610,612,1222
20210702,경의선,능곡,3804,3443,7247
20210702,경의선,행신,7940,8155,16095
20210702,경의선,강매,3380,2921,6301
20210702,경의선,화전,1674,1520,3194
20210702,경의선,수색,2827,2879,5706
20210702,경의선,디지털미디어시티,2663,2593,5256
20210702,경의선,가좌,5592,5200,10792
20210702,경의선,홍대입구,1638,1822,3460
20210702,경의선,서강대,2195,2111,4306
20210702,경의선,공덕,3698,3376,7074
20210702,경의선,효창공원앞,2928,3301,6229
20210702,경의선,신촌,870,1154,2024
20210702,경의선,서울,4146,5634,9780
20210705,경의선,임진강,15,6,21
20210705,경의선,문산,5011,4931,9942
20210705,경의선,파주,1312,803,2115
20210705,경의선,월롱,2097,2059,4156
20210705,경의선,금촌,6281,6303,12584
20210705,경의선,금릉,4658,4532,9190
20210705,경의선,운정,6754,6370,13124
20210705,경의선,야당,6946,6666,13612
20210705,경의선,탄현,7715,7373,15088
20210705,경의선,일산,9483,9242,18725
20210705,경의선,풍산,5542,5150,10692
20210705,경의선,백마,7093,6671,13764
20210705,경의선,곡산,613,593,1206
20210705,경의선,능곡,3821,3457,7278
20210705,경의선,행신,7794,7920,15714
20210705,경의선,강매,3324,2895,6219
20210705,경의선,화전,1606,1475,3081
20210705,경의선,수색,2851,3067,5918
20210705,경의선,디지털미디어시티,2525,2400,4925
20210705,경의선,가좌,5486,5123,10609
20210705,경의선,홍대입구,1466,1603,3069
20210705,경의선,서강대,2167,2026,4193
20210705,경의선,공덕,3523,3147,6670
20210705,경의선,효창공원앞,2853,3243,6096
20210705,경의선,신촌,863,1048,1911
20210705,경의선,서울,4385,5475,9860
20210706,경의선,임진강,14,8,22
20210706,경의선,문산,5172,5031,10203
20210706,경의선,파주,1271,788,2059
20210706,경의선,월롱,2155,2146,4301
20210706,경의선,금촌,6643,6631,13274
20210706,경의선,금릉,4783,4602,9385
20210706,경의선,운정,6871,6597,13468
20210706,경의선,야당,6974,6812,13786
20210706,경의선,탄현,7833,7478,15311
20210706,경의선,일산,9386,9333,18719
20210706,경의선,풍산,5688,5260,10948
20210706,경의선,백마,7144,6695,13839
20210706,경의선,곡산,621,643,1264
20210706,경의선,능곡,3795,3511,7306
20210706,경의선,행신,7966,7927,15893
20210706,경의선,강매,3285,2859,6144
20210706,경의선,화전,1573,1505,3078
20210706,경의선,수색,2989,3104,6093
20210706,경의선,디지털미디어시티,2560,2460,5020
20210706,경의선,가좌,5471,5110,10581
20210706,경의선,홍대입구,1503,1566,3069
20210706,경의선,서강대,2130,2049,4179
20210706,경의선,공덕,3644,3326,6970
20210706,경의선,효창공원앞,2921,3310,6231
20210706,경의선,신촌,905,1164,2069
20210706,경의선,서울,4299,5447,9746
20210707,경의선,풍산,5477,5112,10589
20210707,경의선,서울,4189,5264,9453
20210707,경의선,신촌,874,1006,1880
20210707,경의선,효창공원앞,2777,3309,6086
20210707,경의선,공덕,3555,3182,6737
20210707,경의선,서강대,2103,2042,4145
20210707,경의선,홍대입구,1389,1612,3001
20210707,경의선,가좌,5286,4996,10282
20210707,경의선,디지털미디어시티,2442,2360,4802
20210707,경의선,수색,2772,2945,5717
20210707,경의선,화전,1473,1387,2860
20210707,경의선,강매,3226,2753,5979
20210707,경의선,행신,7701,7685,15386
20210707,경의선,능곡,3676,3471,7147
20210707,경의선,곡산,608,628,1236
20210707,경의선,백마,6812,6606,13418
20210707,경의선,일산,9145,9060,18205
20210707,경의선,탄현,7435,7288,14723
20210707,경의선,야당,6735,6493,13228
20210707,경의선,운정,6559,6273,12832
20210707,경의선,금릉,4574,4552,9126
20210707,경의선,금촌,6161,6020,12181
20210707,경의선,월롱,2135,1992,4127
20210707,경의선,파주,1184,763,1947
20210707,경의선,문산,4866,4744,9610
20210707,경의선,임진강,7,3,10
20210708,경의선,서울,4102,5287,9389
20210708,경의선,신촌,820,996,1816
20210708,경의선,효창공원앞,2779,3218,5997
20210708,경의선,공덕,3327,3007,6334
20210708,경의선,서강대,2096,1913,4009
20210708,경의선,홍대입구,1390,1466,2856
20210708,경의선,가좌,5190,4901,10091
20210708,경의선,디지털미디어시티,2441,2266,4707
20210708,경의선,수색,2715,2856,5571
20210708,경의선,화전,1500,1352,2852
20210708,경의선,강매,3082,2668,5750
20210708,경의선,행신,7490,7517,15007
20210708,경의선,능곡,3556,3250,6806
20210708,경의선,곡산,555,572,1127
20210708,경의선,백마,6709,6440,13149
20210708,경의선,풍산,5387,5059,10446
20210708,경의선,일산,9528,9342,18870
20210708,경의선,탄현,7339,7058,14397
20210708,경의선,야당,6689,6510,13199
20210708,경의선,운정,6358,6079,12437
20210708,경의선,금릉,4419,4330,8749
20210708,경의선,금촌,5977,5815,11792
20210708,경의선,월롱,2082,1981,4063
20210708,경의선,파주,1154,744,1898
20210708,경의선,문산,4776,4677,9453
20210708,경의선,임진강,8,10,18
20210709,경의선,서울,4222,5226,9448
20210709,경의선,신촌,836,1047,1883
20210709,경의선,효창공원앞,2758,3187,5945
20210709,경의선,공덕,3381,3043,6424
20210709,경의선,서강대,2144,2033,4177
20210709,경의선,홍대입구,1364,1471,2835
20210709,경의선,가좌,5284,4894,10178
20210709,경의선,디지털미디어시티,2428,2260,4688
20210709,경의선,수색,2725,2716,5441
20210709,경의선,화전,1544,1418,2962
20210709,경의선,강매,2982,2595,5577
20210709,경의선,행신,7430,7690,15120
20210709,경의선,능곡,3555,3284,6839
20210709,경의선,곡산,577,591,1168
20210709,경의선,백마,6536,6378,12914
20210709,경의선,풍산,5294,5057,10351
20210709,경의선,일산,8772,8748,17520
20210709,경의선,탄현,7296,7096,14392
20210709,경의선,야당,6722,6622,13344
20210709,경의선,운정,6391,6103,12494
20210709,경의선,금릉,4645,4629,9274
20210709,경의선,금촌,6341,6253,12594
20210709,경의선,월롱,2402,1958,4360
20210709,경의선,파주,1236,807,2043
20210709,경의선,문산,5306,5137,10443
20210709,경의선,임진강,7,1,8
20210712,경의선,서울,3850,4651,8501
20210712,경의선,신촌,735,934,1669
20210712,경의선,효창공원앞,2570,3009,5579
20210712,경의선,공덕,2968,2790,5758
20210712,경의선,서강대,1908,1761,3669
20210712,경의선,홍대입구,1180,1341,2521
20210712,경의선,가좌,4800,4499,9299
20210712,경의선,디지털미디어시티,2109,2026,4135
20210712,경의선,수색,2464,2582,5046
20210712,경의선,화전,1242,1151,2393
20210712,경의선,강매,2860,2416,5276
20210712,경의선,행신,6728,6937,13665
20210712,경의선,능곡,3246,2959,6205
20210712,경의선,곡산,525,519,1044
20210712,경의선,백마,5999,5690,11689
20210712,경의선,풍산,4657,4451,9108
20210712,경의선,일산,7835,7841,15676
20210712,경의선,탄현,6766,6352,13118
20210712,경의선,야당,5782,5563,11345
20210712,경의선,운정,5816,5439,11255
20210712,경의선,금릉,4042,3920,7962
20210712,경의선,금촌,5514,5455,10969
20210712,경의선,월롱,1886,1972,3858
20210712,경의선,파주,983,745,1728
20210712,경의선,문산,4534,4514,9048
20210712,경의선,임진강,6,2,8
20210713,경의선,가좌,4627,4305,8932
20210713,경의선,홍대입구,1220,1353,2573
20210713,경의선,서강대,1846,1730,3576
20210713,경의선,공덕,2959,2714,5673
20210713,경의선,효창공원앞,2560,2957,5517
20210713,경의선,신촌,758,912,1670
20210713,경의선,서울,3675,4449,8124
20210713,경의선,계양,1,0,1
20210713,경의선,임진강,24,11,35
20210713,경의선,문산,4324,4390,8714
20210713,경의선,파주,952,699,1651
20210713,경의선,월롱,2029,1877,3906
20210713,경의선,금촌,5451,5359,10810
20210713,경의선,금릉,4006,3867,7873
20210713,경의선,운정,5701,5457,11158
20210713,경의선,야당,5701,5563,11264
20210713,경의선,탄현,6573,6359,12932
20210713,경의선,일산,8207,8367,16574
20210713,경의선,풍산,4822,4431,9253
20210713,경의선,백마,5889,5768,11657
20210713,경의선,곡산,519,492,1011
20210713,경의선,능곡,3210,2962,6172
20210713,경의선,행신,6643,6808,13451
20210713,경의선,강매,2846,2435,5281
20210713,경의선,화전,1245,1175,2420
20210713,경의선,수색,2367,2409,4776
20210713,경의선,디지털미디어시티,2168,2065,4233
20210714,경의선,임진강,10,7,17
20210714,경의선,문산,4565,4630,9195
20210714,경의선,파주,947,683,1630
20210714,경의선,월롱,1877,1862,3739
20210714,경의선,금촌,5343,5384,10727
20210714,경의선,금릉,4013,3872,7885
20210714,경의선,운정,5549,5311,10860
20210714,경의선,야당,5787,5537,11324
20210714,경의선,탄현,6401,6183,12584
20210714,경의선,일산,7657,7850,15507
20210714,경의선,풍산,4518,4237,8755
20210714,경의선,백마,5826,5654,11480
20210714,경의선,곡산,483,488,971
20210714,경의선,능곡,3215,2990,6205
20210714,경의선,행신,6548,6707,13255
20210714,경의선,강매,2681,2364,5045
20210714,경의선,화전,1258,1177,2435
20210714,경의선,수색,2387,2462,4849
20210714,경의선,디지털미디어시티,2180,2018,4198
20210714,경의선,가좌,4578,4292,8870
20210714,경의선,홍대입구,1211,1306,2517
20210714,경의선,서강대,1818,1701,3519
20210714,경의선,공덕,2862,2624,5486
20210714,경의선,효창공원앞,2501,2924,5425
20210714,경의선,신촌,771,918,1689
20210714,경의선,서울,3674,4433,8107
20210715,경의선,임진강,10,3,13
20210715,경의선,문산,4423,4497,8920
20210715,경의선,파주,902,649,1551
20210715,경의선,월롱,1940,1852,3792
20210715,경의선,금촌,5154,5218,10372
20210715,경의선,금릉,3898,3805,7703
20210715,경의선,운정,5600,5240,10840
20210715,경의선,야당,5584,5459,11043
20210715,경의선,탄현,6446,6178,12624
20210715,경의선,일산,7566,7655,15221
20210715,경의선,풍산,4505,4267,8772
20210715,경의선,백마,5804,5644,11448
20210715,경의선,곡산,469,478,947
20210715,경의선,능곡,3190,2869,6059
20210715,경의선,행신,6635,6738,13373
20210715,경의선,강매,2732,2393,5125
20210715,경의선,화전,1340,1207,2547
20210715,경의선,수색,2357,2392,4749
20210715,경의선,디지털미디어시티,2125,2044,4169
20210715,경의선,가좌,4421,4185,8606
20210715,경의선,홍대입구,1245,1368,2613
20210715,경의선,서강대,1798,1689,3487
20210715,경의선,공덕,2889,2641,5530
20210715,경의선,효창공원앞,2528,2882,5410
20210715,경의선,신촌,728,820,1548
20210715,경의선,서울,3697,4489,8186
20210716,경의선,임진강,9,7,16
20210716,경의선,문산,4544,4584,9128
20210716,경의선,파주,897,663,1560
20210716,경의선,월롱,2277,1806,4083
20210716,경의선,금촌,5671,5612,11283
20210716,경의선,금릉,4037,3883,7920
20210716,경의선,운정,5584,5339,10923
20210716,경의선,야당,5667,5543,11210
20210716,경의선,탄현,6459,6220,12679
20210716,경의선,일산,7538,7754,15292
20210716,경의선,풍산,4606,4406,9012
20210716,경의선,백마,5716,5532,11248
20210716,경의선,곡산,485,539,1024
20210716,경의선,능곡,3176,2931,6107
20210716,경의선,행신,6687,7002,13689
20210716,경의선,강매,2694,2301,4995
20210716,경의선,화전,1289,1247,2536
20210716,경의선,수색,2341,2355,4696
20210716,경의선,디지털미디어시티,2154,2063,4217
20210716,경의선,가좌,4544,4344,8888
20210716,경의선,홍대입구,1296,1446,2742
20210716,경의선,서강대,1890,1759,3649
20210716,경의선,공덕,3017,2678,5695
20210716,경의선,효창공원앞,2426,2895,5321
20210716,경의선,신촌,694,833,1527
20210716,경의선,서울,3706,4429,8135
20210719,경의선,서울,3575,4374,7949
20210719,경의선,신촌,716,922,1638
20210719,경의선,효창공원앞,2466,2872,5338
20210719,경의선,공덕,2917,2653,5570
20210719,경의선,서강대,1762,1729,3491
20210719,경의선,홍대입구,1271,1326,2597
20210719,경의선,가좌,4532,4366,8898
20210719,경의선,디지털미디어시티,2083,2016,4099
20210719,경의선,수색,2363,2476,4839
20210719,경의선,화전,1284,1209,2493
20210719,경의선,강매,2719,2365,5084
20210719,경의선,행신,6544,6572,13116
20210719,경의선,능곡,3111,2822,5933
20210719,경의선,곡산,481,487,968
20210719,경의선,백마,5633,5445,11078
20210719,경의선,풍산,4600,4306,8906
20210719,경의선,일산,7482,7641,15123
20210719,경의선,탄현,6490,6226,12716
20210719,경의선,야당,5650,5387,11037
20210719,경의선,운정,5647,5296,10943
20210719,경의선,금릉,4029,3786,7815
20210719,경의선,금촌,5300,5268,10568
20210719,경의선,월롱,1838,1911,3749
20210719,경의선,파주,925,711,1636
20210719,경의선,문산,4509,4474,8983
20210719,경의선,임진강,12,6,18
20210720,경의선,서울,3622,4370,7992
20210720,경의선,신촌,728,867,1595
20210720,경의선,효창공원앞,2548,2961,5509
20210720,경의선,공덕,2986,2670,5656
20210720,경의선,서강대,1782,1645,3427
20210720,경의선,홍대입구,1261,1402,2663
20210720,경의선,가좌,4640,4458,9098
20210720,경의선,디지털미디어시티,2106,2031,4137
20210720,경의선,수색,2329,2410,4739
20210720,경의선,화전,1277,1168,2445
20210720,경의선,강매,2801,2407,5208
20210720,경의선,행신,6532,6678,13210
20210720,경의선,능곡,3229,2898,6127
20210720,경의선,곡산,480,502,982
20210720,경의선,백마,5870,5717,11587
20210720,경의선,풍산,4625,4249,8874
20210720,경의선,일산,7526,7630,15156
20210720,경의선,탄현,6513,6267,12780
20210720,경의선,야당,5664,5423,11087
20210720,경의선,운정,5611,5391,11002
20210720,경의선,금릉,4089,3891,7980
20210720,경의선,금촌,5338,5457,10795
20210720,경의선,월롱,1909,1907,3816
20210720,경의선,파주,924,667,1591
20210720,경의선,문산,4511,4446,8957
20210720,경의선,임진강,8,5,13
20210721,경의선,임진강,11,8,19
20210721,경의선,김포공항,1,0,1
20210721,경의선,서울,3531,4251,7782
20210721,경의선,신촌,711,840,1551
20210721,경의선,효창공원앞,2525,2936,5461
20210721,경의선,공덕,2954,2678,5632
20210721,경의선,서강대,1779,1654,3433
20210721,경의선,홍대입구,1250,1334,2584
20210721,경의선,가좌,4426,4194,8620
20210721,경의선,디지털미디어시티,2039,1965,4004
20210721,경의선,수색,2358,2383,4741
20210721,경의선,화전,1292,1174,2466
20210721,경의선,강매,2694,2355,5049
20210721,경의선,행신,6585,6614,13199
20210721,경의선,능곡,3211,2958,6169
20210721,경의선,곡산,457,479,936
20210721,경의선,백마,5726,5612,11338
20210721,경의선,풍산,4566,4281,8847
20210721,경의선,일산,7469,7564,15033
20210721,경의선,탄현,6461,6301,12762
20210721,경의선,야당,5608,5415,11023
20210721,경의선,운정,5467,5212,10679
20210721,경의선,금릉,3932,3803,7735
20210721,경의선,금촌,5243,5210,10453
20210721,경의선,월롱,1879,1838,3717
20210721,경의선,파주,894,702,1596
20210721,경의선,문산,4481,4433,8914
20210722,경의선,임진강,10,8,18
20210722,경의선,문산,4348,4382,8730
20210722,경의선,파주,870,645,1515
20210722,경의선,월롱,1861,1801,3662
20210722,경의선,금촌,5069,5039,10108
20210722,경의선,금릉,3926,3713,7639
20210722,경의선,운정,5412,5139,10551
20210722,경의선,야당,5498,5368,10866
20210722,경의선,탄현,6235,6084,12319
20210722,경의선,일산,7349,7527,14876
20210722,경의선,풍산,4539,4271,8810
20210722,경의선,백마,5694,5547,11241
20210722,경의선,곡산,449,474,923
20210722,경의선,능곡,3145,2837,5982
20210722,경의선,행신,6399,6531,12930
20210722,경의선,강매,2703,2299,5002
20210722,경의선,화전,1265,1183,2448
20210722,경의선,수색,2277,2358,4635
20210722,경의선,디지털미디어시티,2077,1932,4009
20210722,경의선,가좌,4403,4324,8727
20210722,경의선,홍대입구,1276,1441,2717
20210722,경의선,서강대,1691,1595,3286
20210722,경의선,공덕,2883,2687,5570
20210722,경의선,효창공원앞,2572,2880,5452
20210722,경의선,신촌,725,892,1617
20210722,경의선,서울,3516,4209,7725
20210722,경의선,계양,1,0,1
20210723,경의선,서울,3535,4274,7809
20210723,경의선,신촌,739,805,1544
20210723,경의선,효창공원앞,2488,2870,5358
20210723,경의선,공덕,2989,2668,5657
20210723,경의선,서강대,1818,1689,3507
20210723,경의선,홍대입구,1372,1453,2825
20210723,경의선,가좌,4514,4337,8851
20210723,경의선,디지털미디어시티,2103,1946,4049
20210723,경의선,수색,2295,2317,4612
20210723,경의선,화전,1263,1180,2443
20210723,경의선,강매,2626,2258,4884
20210723,경의선,행신,6710,6818,13528
20210723,경의선,능곡,3182,2899,6081
20210723,경의선,곡산,492,500,992
20210723,경의선,백마,5640,5462,11102
20210723,경의선,풍산,4563,4403,8966
20210723,경의선,일산,7661,7884,15545
20210723,경의선,탄현,6424,6240,12664
20210723,경의선,야당,5631,5577,11208
20210723,경의선,운정,5587,5383,10970
20210723,경의선,금릉,3982,3912,7894
20210723,경의선,금촌,5427,5320,10747
20210723,경의선,월롱,2191,1819,4010
20210723,경의선,파주,923,665,1588
20210723,경의선,문산,4733,4636,9369
20210723,경의선,임진강,9,7,16
20210726,경의선,임진강,7,5,12
20210726,경의선,문산,4607,4584,9191
20210726,경의선,파주,926,707,1633
20210726,경의선,월롱,1773,1852,3625
20210726,경의선,금촌,5395,5414,10809
20210726,경의선,금릉,3929,3697,7626
20210726,경의선,운정,5601,5212,10813
20210726,경의선,야당,5605,5403,11008
20210726,경의선,탄현,6391,6093,12484
20210726,경의선,일산,7436,7421,14857
20210726,경의선,풍산,4496,4223,8719
20210726,경의선,백마,5709,5460,11169
20210726,경의선,곡산,432,447,879
20210726,경의선,능곡,3179,2880,6059
20210726,경의선,행신,6541,6750,13291
20210726,경의선,강매,2651,2252,4903
20210726,경의선,화전,1248,1161,2409
20210726,경의선,수색,2331,2304,4635
20210726,경의선,디지털미디어시티,2018,1947,3965
20210726,경의선,가좌,4583,4374,8957
20210726,경의선,홍대입구,1246,1391,2637
20210726,경의선,서강대,1810,1742,3552
20210726,경의선,공덕,2946,2656,5602
20210726,경의선,효창공원앞,2480,2780,5260
20210726,경의선,신촌,696,821,1517
20210726,경의선,서울,3596,4309,7905
20210727,경의선,임진강,11,10,21
20210727,경의선,문산,4504,4392,8896
20210727,경의선,파주,904,672,1576
20210727,경의선,월롱,1927,1866,3793
20210727,경의선,금촌,5142,5142,10284
20210727,경의선,금릉,3894,3780,7674
20210727,경의선,운정,5450,5178,10628
20210727,경의선,야당,5529,5366,10895
20210727,경의선,탄현,6288,6091,12379
20210727,경의선,일산,7329,7350,14679
20210727,경의선,풍산,4553,4217,8770
20210727,경의선,백마,5773,5669,11442
20210727,경의선,곡산,440,481,921
20210727,경의선,능곡,3192,2938,6130
20210727,경의선,행신,6379,6623,13002
20210727,경의선,강매,2588,2246,4834
20210727,경의선,화전,1311,1209,2520
20210727,경의선,수색,2252,2307,4559
20210727,경의선,디지털미디어시티,2066,1960,4026
20210727,경의선,가좌,4443,4291,8734
20210727,경의선,홍대입구,1250,1381,2631
20210727,경의선,서강대,1748,1601,3349
20210727,경의선,공덕,2937,2612,5549
20210727,경의선,효창공원앞,2544,2866,5410
20210727,경의선,신촌,757,869,1626
20210727,경의선,서울,3467,4224,7691
20210728,경의선,서울,3484,4186,7670
20210728,경의선,신촌,700,832,1532
20210728,경의선,효창공원앞,2470,2822,5292
20210728,경의선,공덕,2898,2641,5539
20210728,경의선,서강대,1755,1751,3506
20210728,경의선,홍대입구,1251,1336,2587
20210728,경의선,가좌,4387,4164,8551
20210728,경의선,디지털미디어시티,2114,1916,4030
20210728,경의선,수색,2258,2302,4560
20210728,경의선,화전,1224,1114,2338
20210728,경의선,강매,2604,2263,4867
20210728,경의선,행신,6397,6654,13051
20210728,경의선,능곡,3084,2853,5937
20210728,경의선,곡산,476,494,970
20210728,경의선,백마,5782,5666,11448
20210728,경의선,풍산,4391,4039,8430
20210728,경의선,일산,7614,7709,15323
20210728,경의선,탄현,6301,6115,12416
20210728,경의선,야당,5533,5353,10886
20210728,경의선,운정,5345,5081,10426
20210728,경의선,금릉,3831,3684,7515
20210728,경의선,금촌,5224,5163,10387
20210728,경의선,월롱,1977,1898,3875
20210728,경의선,파주,880,689,1569
20210728,경의선,문산,4519,4372,8891
20210728,경의선,임진강,17,17,34
20210729,경의선,서울,3416,4233,7649
20210729,경의선,신촌,703,844,1547
20210729,경의선,효창공원앞,2176,2636,4812
20210729,경의선,공덕,3052,2679,5731
20210729,경의선,서강대,1755,1675,3430
20210729,경의선,홍대입구,1272,1483,2755
20210729,경의선,가좌,4428,4266,8694
20210729,경의선,디지털미디어시티,2007,1926,3933
20210729,경의선,수색,2263,2296,4559
20210729,경의선,화전,1166,1142,2308
20210729,경의선,강매,2529,2206,4735
20210729,경의선,행신,6458,6607,13065
20210729,경의선,능곡,3064,2818,5882
20210729,경의선,곡산,487,472,959
20210729,경의선,백마,5689,5547,11236
20210729,경의선,풍산,4527,4252,8779
20210729,경의선,일산,7345,7434,14779
20210729,경의선,탄현,6190,6059,12249
20210729,경의선,야당,5516,5359,10875
20210729,경의선,운정,5385,5012,10397
20210729,경의선,금릉,3829,3643,7472
20210729,경의선,금촌,5114,5117,10231
20210729,경의선,월롱,1924,1803,3727
20210729,경의선,파주,924,677,1601
20210729,경의선,문산,4637,4519,9156
20210729,경의선,임진강,12,15,27
20210730,경의선,임진강,12,4,16
20210730,경의선,문산,4651,4621,9272
20210730,경의선,파주,926,696,1622
20210730,경의선,월롱,2347,1860,4207
20210730,경의선,금촌,5282,5290,10572
20210730,경의선,금릉,4009,3857,7866
20210730,경의선,운정,5471,5074,10545
20210730,경의선,야당,5656,5446,11102
20210730,경의선,탄현,6304,6167,12471
20210730,경의선,일산,7336,7449,14785
20210730,경의선,풍산,4523,4213,8736
20210730,경의선,백마,5678,5501,11179
20210730,경의선,곡산,463,467,930
20210730,경의선,능곡,3030,2859,5889
20210730,경의선,행신,6589,6725,13314
20210730,경의선,강매,2589,2259,4848
20210730,경의선,화전,1206,1101,2307
20210730,경의선,수색,2210,2227,4437
20210730,경의선,디지털미디어시티,2135,2007,4142
20210730,경의선,가좌,4562,4288,8850
20210730,경의선,홍대입구,1438,1529,2967
20210730,경의선,서강대,1793,1667,3460
20210730,경의선,공덕,3001,2694,5695
20210730,경의선,효창공원앞,2226,2568,4794
20210730,경의선,신촌,741,836,1577
20210730,경의선,서울,3525,4428,7953
20210802,경의선,계양,1,0,1
20210802,경의선,홍대입구,34,59,93
20210802,경의선,임진강,14,10,24
20210802,경의선,문산,4213,4169,8382
20210802,경의선,파주,912,700,1612
20210802,경의선,월롱,1815,1786,3601
20210802,경의선,금촌,5143,5169,10312
20210802,경의선,금릉,3707,3593,7300
20210802,경의선,운정,5194,4900,10094
20210802,경의선,야당,5388,5190,10578
20210802,경의선,탄현,6218,5851,12069
20210802,경의선,일산,7111,7118,14229
20210802,경의선,풍산,4275,4040,8315
20210802,경의선,백마,5592,5336,10928
20210802,경의선,곡산,465,496,961
20210802,경의선,능곡,2862,2693,5555
20210802,경의선,행신,6293,6359,12652
20210802,경의선,강매,2507,2195,4702
20210802,경의선,화전,1249,1126,2375
20210802,경의선,수색,2096,2114,4210
20210802,경의선,디지털미디어시티,1955,1901,3856
20210802,경의선,가좌,4236,4022,8258
20210802,경의선,홍대입구,1254,1448,2702
20210802,경의선,서강대,1744,1660,3404
20210802,경의선,공덕,2720,2490,5210
20210802,경의선,효창공원앞,2330,2685,5015
20210802,경의선,신촌,687,842,1529
20210802,경의선,서울,3426,4120,7546
20210803,경의선,검암,1,0,1
20210803,경의선,서울,3464,4094,7558
20210803,경의선,신촌,725,886,1611
20210803,경의선,효창공원앞,2431,2854,5285
20210803,경의선,공덕,2830,2574,5404
20210803,경의선,서강대,1742,1672,3414
20210803,경의선,홍대입구,1387,1519,2906
20210803,경의선,가좌,4326,4190,8516
20210803,경의선,디지털미디어시티,2017,1926,3943
20210803,경의선,수색,2088,2076,4164
20210803,경의선,화전,1240,1177,2417
20210803,경의선,강매,2562,2144,4706
20210803,경의선,행신,6346,6478,12824
20210803,경의선,능곡,2970,2699,5669
20210803,경의선,곡산,493,505,998
20210803,경의선,백마,5560,5387,10947
20210803,경의선,풍산,4552,4223,8775
20210803,경의선,일산,7523,7567,15090
20210803,경의선,탄현,6176,5935,12111
20210803,경의선,야당,5369,5301,10670
20210803,경의선,운정,5401,5087,10488
20210803,경의선,금릉,3872,3719,7591
20210803,경의선,금촌,5193,5318,10511
20210803,경의선,월롱,1761,1734,3495
20210803,경의선,파주,893,668,1561
20210803,경의선,문산,4354,4391,8745
20210803,경의선,임진강,11,7,18
20210804,경의선,서울,3487,4135,7622
20210804,경의선,신촌,718,862,1580
20210804,경의선,효창공원앞,2317,2743,5060
20210804,경의선,공덕,2878,2512,5390
20210804,경의선,서강대,1728,1643,3371
20210804,경의선,홍대입구,1283,1541,2824
20210804,경의선,가좌,4298,4125,8423
20210804,경의선,디지털미디어시티,2014,1898,3912
20210804,경의선,수색,2099,2117,4216
20210804,경의선,화전,1224,1118,2342
20210804,경의선,강매,2513,2207,4720
20210804,경의선,행신,6378,6487,12865
20210804,경의선,능곡,2974,2758,5732
20210804,경의선,곡산,475,509,984
20210804,경의선,백마,5733,5595,11328
20210804,경의선,풍산,4449,4218,8667
20210804,경의선,일산,7131,7266,14397
20210804,경의선,탄현,6105,6020,12125
20210804,경의선,야당,5354,5234,10588
20210804,경의선,운정,5385,5046,10431
20210804,경의선,금릉,3736,3629,7365
20210804,경의선,금촌,5152,5143,10295
20210804,경의선,월롱,1890,1767,3657
20210804,경의선,파주,869,667,1536
20210804,경의선,문산,4402,4351,8753
20210804,경의선,임진강,15,14,29
20210805,경의선,검암,1,0,1
20210805,경의선,계양,1,0,1
20210805,경의선,서울,3513,4332,7845
20210805,경의선,신촌,752,929,1681
20210805,경의선,효창공원앞,2446,2751,5197
20210805,경의선,공덕,2938,2612,5550
20210805,경의선,서강대,1783,1684,3467
20210805,경의선,홍대입구,1433,1570,3003
20210805,경의선,가좌,4409,4287,8696
20210805,경의선,디지털미디어시티,2069,1925,3994
20210805,경의선,수색,2126,2203,4329
20210805,경의선,화전,1253,1164,2417
20210805,경의선,강매,2561,2229,4790
20210805,경의선,행신,6584,6688,13272
20210805,경의선,능곡,3030,2851,5881
20210805,경의선,곡산,491,483,974
20210805,경의선,백마,5824,5668,11492
20210805,경의선,풍산,4597,4276,8873
20210805,경의선,일산,7323,7373,14696
20210805,경의선,탄현,6334,6187,12521
20210805,경의선,야당,5568,5409,10977
20210805,경의선,운정,5552,5190,10742
20210805,경의선,금릉,3874,3709,7583
20210805,경의선,금촌,5110,5125,10235
20210805,경의선,월롱,2034,1766,3800
20210805,경의선,파주,858,669,1527
20210805,경의선,문산,4349,4367,8716
20210805,경의선,임진강,20,10,30
20210806,경의선,임진강,19,7,26
20210806,경의선,문산,4535,4472,9007
20210806,경의선,파주,935,695,1630
20210806,경의선,월롱,2135,1781,3916
20210806,경의선,금촌,5571,5524,11095
20210806,경의선,금릉,3914,3840,7754
20210806,경의선,운정,5542,5154,10696
20210806,경의선,야당,5564,5524,11088
20210806,경의선,탄현,6193,6077,12270
20210806,경의선,일산,7309,7471,14780
20210806,경의선,풍산,4624,4407,9031
20210806,경의선,백마,5781,5618,11399
20210806,경의선,곡산,487,522,1009
20210806,경의선,능곡,3162,2842,6004
20210806,경의선,행신,6594,6746,13340
20210806,경의선,강매,2528,2204,4732
20210806,경의선,화전,1240,1186,2426
20210806,경의선,수색,2139,2043,4182
20210806,경의선,디지털미디어시티,2113,1963,4076
20210806,경의선,가좌,4486,4319,8805
20210806,경의선,홍대입구,1440,1588,3028
20210806,경의선,서강대,1853,1751,3604
20210806,경의선,공덕,2967,2698,5665
20210806,경의선,효창공원앞,2389,2783,5172
20210806,경의선,신촌,739,866,1605
20210806,경의선,서울,3580,4386,7966
20210809,경의선,임진강,12,7,19
20210809,경의선,문산,4787,4714,9501
20210809,경의선,파주,932,718,1650
20210809,경의선,월롱,1929,2005,3934
20210809,경의선,금촌,5542,5447,10989
20210809,경의선,금릉,4049,3891,7940
20210809,경의선,운정,5704,5483,11187
20210809,경의선,야당,5753,5591,11344
20210809,경의선,탄현,6620,6377,12997
20210809,경의선,일산,7791,7683,15474
20210809,경의선,풍산,4812,4463,9275
20210809,경의선,백마,6165,6000,12165
20210809,경의선,곡산,488,478,966
20210809,경의선,능곡,3231,3004,6235
20210809,경의선,행신,6726,7003,13729
20210809,경의선,강매,2850,2429,5279
20210809,경의선,화전,1333,1252,2585
20210809,경의선,수색,2350,2381,4731
20210809,경의선,디지털미디어시티,2063,2020,4083
20210809,경의선,가좌,4672,4473,9145
20210809,경의선,홍대입구,1384,1508,2892
20210809,경의선,서강대,1863,1748,3611
20210809,경의선,공덕,3064,2771,5835
20210809,경의선,효창공원앞,2512,2868,5380
20210809,경의선,신촌,718,845,1563
20210809,경의선,서울,3644,4433,8077
20210810,경의선,임진강,6,6,12
20210810,경의선,문산,4408,4497,8905
20210810,경의선,파주,928,705,1633
20210810,경의선,월롱,1921,1885,3806
20210810,경의선,금촌,5419,5411,10830
20210810,경의선,금릉,4092,3913,8005
20210810,경의선,운정,5708,5413,11121
20210810,경의선,야당,5840,5679,11519
20210810,경의선,탄현,6721,6502,13223
20210810,경의선,일산,7936,8029,15965
20210810,경의선,풍산,4974,4604,9578
20210810,경의선,백마,6256,6104,12360
20210810,경의선,곡산,510,531,1041
20210810,경의선,능곡,3317,3006,6323
20210810,경의선,행신,6662,6968,13630
20210810,경의선,강매,2792,2398,5190
20210810,경의선,화전,1294,1192,2486
20210810,경의선,수색,2426,2463,4889
20210810,경의선,디지털미디어시티,2133,2040,4173
20210810,경의선,가좌,4655,4542,9197
20210810,경의선,홍대입구,1409,1477,2886
20210810,경의선,서강대,1905,1731,3636
20210810,경의선,공덕,3033,2722,5755
20210810,경의선,효창공원앞,2538,3043,5581
20210810,경의선,신촌,745,885,1630
20210810,경의선,서울,3805,4585,8390
20210810,경의선,계양,1,0,1
20210811,경의선,서울,3597,4255,7852
20210811,경의선,신촌,736,906,1642
20210811,경의선,효창공원앞,2505,2901,5406
20210811,경의선,공덕,3010,2700,5710
20210811,경의선,서강대,1874,1802,3676
20210811,경의선,홍대입구,1474,1536,3010
20210811,경의선,가좌,4640,4390,9030
20210811,경의선,디지털미디어시티,2181,2077,4258
20210811,경의선,수색,2447,2411,4858
20210811,경의선,화전,1294,1209,2503
20210811,경의선,강매,2796,2459,5255
20210811,경의선,행신,6689,6803,13492
20210811,경의선,능곡,3264,2953,6217
20210811,경의선,곡산,503,523,1026
20210811,경의선,백마,6064,5929,11993
20210811,경의선,풍산,4755,4436,9191
20210811,경의선,일산,7694,7797,15491
20210811,경의선,탄현,6730,6430,13160
20210811,경의선,야당,5761,5624,11385
20210811,경의선,운정,5637,5362,10999
20210811,경의선,금릉,4155,3934,8089
20210811,경의선,금촌,5515,5463,10978
20210811,경의선,월롱,2065,1876,3941
20210811,경의선,파주,944,760,1704
20210811,경의선,문산,4531,4470,9001
20210811,경의선,임진강,9,11,20
20210812,경의선,임진강,26,12,38
20210812,경의선,문산,4462,4507,8969
20210812,경의선,파주,917,711,1628
20210812,경의선,월롱,2035,1832,3867
20210812,경의선,금촌,5360,5357,10717
20210812,경의선,금릉,4114,3929,8043
20210812,경의선,운정,5614,5264,10878
20210812,경의선,야당,5705,5690,11395
20210812,경의선,탄현,6588,6346,12934
20210812,경의선,일산,7716,7858,15574
20210812,경의선,풍산,4846,4478,9324
20210812,경의선,백마,6018,5896,11914
20210812,경의선,곡산,501,520,1021
20210812,경의선,능곡,3324,3047,6371
20210812,경의선,행신,6656,6758,13414
20210812,경의선,강매,2759,2347,5106
20210812,경의선,화전,1319,1239,2558
20210812,경의선,수색,2467,2481,4948
20210812,경의선,디지털미디어시티,2123,2015,4138
20210812,경의선,가좌,4653,4497,9150
20210812,경의선,홍대입구,1423,1662,3085
20210812,경의선,서강대,1847,1762,3609
20210812,경의선,공덕,3092,2803,5895
20210812,경의선,효창공원앞,2516,2940,5456
20210812,경의선,신촌,704,816,1520
20210812,경의선,서울,3603,4380,7983
20210813,경의선,서울,3550,4573,8123
20210813,경의선,신촌,753,856,1609
20210813,경의선,효창공원앞,2530,2943,5473
20210813,경의선,공덕,3055,2807,5862
20210813,경의선,서강대,1964,1795,3759
20210813,경의선,홍대입구,1527,1640,3167
20210813,경의선,가좌,4778,4563,9341
20210813,경의선,디지털미디어시티,2185,2020,4205
20210813,경의선,수색,2314,2315,4629
20210813,경의선,화전,1283,1165,2448
20210813,경의선,강매,2750,2481,5231
20210813,경의선,행신,6812,6993,13805
20210813,경의선,능곡,3350,3016,6366
20210813,경의선,곡산,521,538,1059
20210813,경의선,백마,6039,5824,11863
20210813,경의선,풍산,4906,4610,9516
20210813,경의선,일산,8231,8363,16594
20210813,경의선,탄현,6650,6475,13125
20210813,경의선,야당,5938,5873,11811
20210813,경의선,운정,5762,5464,11226
20210813,경의선,금릉,4211,3996,8207
20210813,경의선,금촌,5841,5605,11446
20210813,경의선,월롱,2367,1805,4172
20210813,경의선,파주,957,685,1642
20210813,경의선,문산,4725,4617,9342
20210813,경의선,임진강,25,16,41
20210816,경의선,서울,1294,1981,3275
20210816,경의선,신촌,395,537,932
20210816,경의선,효창공원앞,1313,1518,2831
20210816,경의선,공덕,1561,1425,2986
20210816,경의선,서강대,1322,1229,2551
20210816,경의선,홍대입구,1077,1234,2311
20210816,경의선,가좌,2870,2944,5814
20210816,경의선,디지털미디어시티,1302,1233,2535
20210816,경의선,수색,1088,1115,2203
20210816,경의선,화전,743,744,1487
20210816,경의선,강매,1424,1254,2678
20210816,경의선,행신,4060,3856,7916
20210816,경의선,능곡,2214,2153,4367
20210816,경의선,곡산,320,313,633
20210816,경의선,백마,3306,3289,6595
20210816,경의선,풍산,3068,2936,6004
20210816,경의선,일산,4517,4511,9028
20210816,경의선,탄현,3982,3720,7702
20210816,경의선,야당,4166,3966,8132
20210816,경의선,운정,3520,3386,6906
20210816,경의선,금릉,2788,2643,5431
20210816,경의선,금촌,4178,4313,8491
20210816,경의선,월롱,966,1622,2588
20210816,경의선,파주,653,549,1202
20210816,경의선,문산,3656,3520,7176
20210816,경의선,임진강,18,16,34
20210817,경의선,능곡,3426,3134,6560
20210817,경의선,서울,3654,4556,8210
20210817,경의선,신촌,747,871,1618
20210817,경의선,효창공원앞,2646,3071,5717
20210817,경의선,공덕,3158,2867,6025
20210817,경의선,서강대,1841,1932,3773
20210817,경의선,홍대입구,1272,1437,2709
20210817,경의선,가좌,4673,4633,9306
20210817,경의선,디지털미디어시티,2178,2026,4204
20210817,경의선,수색,2423,2511,4934
20210817,경의선,화전,1299,1185,2484
20210817,경의선,강매,2816,2450,5266
20210817,경의선,행신,6795,7048,13843
20210817,경의선,곡산,516,523,1039
20210817,경의선,백마,6113,5894,12007
20210817,경의선,풍산,4738,4538,9276
20210817,경의선,일산,7880,7905,15785
20210817,경의선,탄현,6634,6583,13217
20210817,경의선,야당,5771,5619,11390
20210817,경의선,운정,5774,5667,11441
20210817,경의선,금릉,4115,4037,8152
20210817,경의선,금촌,5529,5549,11078
20210817,경의선,월롱,1935,1967,3902
20210817,경의선,파주,1056,695,1751
20210817,경의선,문산,4537,4433,8970
20210817,경의선,임진강,14,8,22
20210817,경의선,서울,153,58,211
20210818,경의선,임진강,15,13,28
20210818,경의선,문산,4445,4343,8788
20210818,경의선,파주,1100,717,1817
20210818,경의선,월롱,1956,1911,3867
20210818,경의선,금촌,5547,5505,11052
20210818,경의선,금릉,4151,4043,8194
20210818,경의선,운정,5815,5571,11386
20210818,경의선,야당,5933,5795,11728
20210818,경의선,탄현,6732,6541,13273
20210818,경의선,일산,8254,8254,16508
20210818,경의선,풍산,4841,4611,9452
20210818,경의선,백마,6199,6107,12306
20210818,경의선,곡산,478,565,1043
20210818,경의선,능곡,3487,3122,6609
20210818,경의선,행신,6695,6899,13594
20210818,경의선,강매,2863,2531,5394
20210818,경의선,화전,1286,1175,2461
20210818,경의선,수색,2366,2359,4725
20210818,경의선,디지털미디어시티,2191,2019,4210
20210818,경의선,가좌,4627,4343,8970
20210818,경의선,홍대입구,1453,1566,3019
20210818,경의선,서강대,1908,1825,3733
20210818,경의선,공덕,3115,2757,5872
20210818,경의선,효창공원앞,2631,2985,5616
20210818,경의선,신촌,776,948,1724
20210818,경의선,서울,3619,4339,7958
20210818,경의선,계양,1,0,1
20210819,경의선,서울,3874,4625,8499
20210819,경의선,신촌,809,960,1769
20210819,경의선,효창공원앞,2701,3114,5815
20210819,경의선,공덕,3169,2787,5956
20210819,경의선,서강대,1933,1868,3801
20210819,경의선,홍대입구,1469,1532,3001
20210819,경의선,가좌,4768,4606,9374
20210819,경의선,디지털미디어시티,2168,2019,4187
20210819,경의선,수색,2445,2560,5005
20210819,경의선,화전,1301,1206,2507
20210819,경의선,강매,2914,2582,5496
20210819,경의선,행신,6876,6972,13848
20210819,경의선,능곡,3509,3154,6663
20210819,경의선,곡산,529,552,1081
20210819,경의선,백마,6288,6147,12435
20210819,경의선,풍산,5001,4656,9657
20210819,경의선,일산,8081,8034,16115
20210819,경의선,탄현,6880,6636,13516
20210819,경의선,야당,6067,5944,12011
20210819,경의선,운정,5788,5613,11401
20210819,경의선,금릉,4128,4027,8155
20210819,경의선,금촌,5698,5793,11491
20210819,경의선,월롱,1940,1870,3810
20210819,경의선,파주,1080,759,1839
20210819,경의선,문산,4780,4810,9590
20210819,경의선,임진강,21,6,27
20210820,경의선,서울,3928,4750,8678
20210820,경의선,신촌,783,938,1721
20210820,경의선,효창공원앞,2660,3024,5684
20210820,경의선,공덕,3109,2775,5884
20210820,경의선,서강대,1967,1846,3813
20210820,경의선,홍대입구,1493,1659,3152
20210820,경의선,가좌,4907,4650,9557
20210820,경의선,디지털미디어시티,2256,2104,4360
20210820,경의선,수색,2422,2457,4879
20210820,경의선,화전,1377,1229,2606
20210820,경의선,강매,2885,2508,5393
20210820,경의선,행신,7066,7128,14194
20210820,경의선,능곡,3479,3187,6666
20210820,경의선,곡산,534,565,1099
20210820,경의선,백마,6362,6221,12583
20210820,경의선,풍산,5047,4839,9886
20210820,경의선,일산,8121,8311,16432
20210820,경의선,탄현,6971,6798,13769
20210820,경의선,야당,6279,6256,12535
20210820,경의선,운정,6044,5841,11885
20210820,경의선,금릉,4427,4251,8678
20210820,경의선,금촌,5912,5733,11645
20210820,경의선,월롱,2369,1886,4255
20210820,경의선,파주,1134,736,1870
20210820,경의선,문산,4949,4837,9786
20210820,경의선,임진강,12,5,17
20210823,경의선,서울,3724,4563,8287
20210823,경의선,신촌,776,960,1736
20210823,경의선,효창공원앞,2605,3040,5645
20210823,경의선,공덕,3108,2782,5890
20210823,경의선,서강대,1908,1841,3749
20210823,경의선,홍대입구,1199,1423,2622
20210823,경의선,가좌,4700,4604,9304
20210823,경의선,디지털미디어시티,2106,2012,4118
20210823,경의선,수색,2452,2517,4969
20210823,경의선,화전,1250,1156,2406
20210823,경의선,강매,2848,2466,5314
20210823,경의선,행신,6812,7092,13904
20210823,경의선,능곡,3425,3161,6586
20210823,경의선,곡산,509,506,1015
20210823,경의선,백마,6298,6166,12464
20210823,경의선,풍산,4842,4601,9443
20210823,경의선,일산,8515,8394,16909
20210823,경의선,탄현,6793,6542,13335
20210823,경의선,야당,5993,5747,11740
20210823,경의선,운정,5951,5703,11654
20210823,경의선,금릉,4199,3973,8172
20210823,경의선,금촌,5556,5604,11160
20210823,경의선,월롱,1818,1912,3730
20210823,경의선,파주,1033,711,1744
20210823,경의선,문산,4458,4367,8825
20210823,경의선,임진강,10,3,13
20210824,경의선,임진강,7,4,11
20210824,경의선,문산,4312,4194,8506
20210824,경의선,파주,996,674,1670
20210824,경의선,월롱,1818,1789,3607
20210824,경의선,금촌,5418,5386,10804
20210824,경의선,금릉,4040,3921,7961
20210824,경의선,운정,5700,5550,11250
20210824,경의선,야당,5957,5673,11630
20210824,경의선,탄현,6732,6657,13389
20210824,경의선,일산,7986,8115,16101
20210824,경의선,풍산,4883,4597,9480
20210824,경의선,백마,6191,6079,12270
20210824,경의선,곡산,503,515,1018
20210824,경의선,능곡,3466,3133,6599
20210824,경의선,행신,6855,6979,13834
20210824,경의선,강매,2862,2553,5415
20210824,경의선,화전,1291,1175,2466
20210824,경의선,수색,2371,2333,4704
20210824,경의선,디지털미디어시티,2165,1993,4158
20210824,경의선,가좌,4574,4433,9007
20210824,경의선,홍대입구,1309,1388,2697
20210824,경의선,서강대,1860,1777,3637
20210824,경의선,공덕,3134,2771,5905
20210824,경의선,효창공원앞,2545,2969,5514
20210824,경의선,신촌,756,913,1669
20210824,경의선,서울,3747,4481,8228
20210825,경의선,서울,27,21,48
20210825,경의선,임진강,6,7,13
20210825,경의선,문산,4404,4471,8875
20210825,경의선,파주,1048,727,1775
20210825,경의선,월롱,1977,1851,3828
20210825,경의선,금촌,5819,5825,11644
20210825,경의선,금릉,4301,4196,8497
20210825,경의선,운정,6105,5922,12027
20210825,경의선,야당,6275,6174,12449
20210825,경의선,탄현,6927,6771,13698
20210825,경의선,일산,8517,8444,16961
20210825,경의선,풍산,5076,4622,9698
20210825,경의선,백마,6389,6271,12660
20210825,경의선,곡산,539,549,1088
20210825,경의선,능곡,3568,3265,6833
20210825,경의선,행신,7027,7166,14193
20210825,경의선,강매,2997,2600,5597
20210825,경의선,화전,1387,1289,2676
20210825,경의선,수색,2405,2491,4896
20210825,경의선,디지털미디어시티,2161,2015,4176
20210825,경의선,가좌,4943,4717,9660
20210825,경의선,홍대입구,1489,1644,3133
20210825,경의선,서강대,1982,1879,3861
20210825,경의선,공덕,3296,2887,6183
20210825,경의선,효창공원앞,2698,3099,5797
20210825,경의선,신촌,758,951,1709
20210825,경의선,서울,3830,4618,8448
20210825,경의선,계양,1,0,1
20210826,경의선,서울,3929,4730,8659
20210826,경의선,신촌,826,999,1825
20210826,경의선,효창공원앞,2704,3131,5835
20210826,경의선,공덕,3261,2943,6204
20210826,경의선,서강대,1921,1903,3824
20210826,경의선,홍대입구,1343,1561,2904
20210826,경의선,가좌,4992,4767,9759
20210826,경의선,디지털미디어시티,2206,2066,4272
20210826,경의선,수색,2522,2592,5114
20210826,경의선,화전,1342,1286,2628
20210826,경의선,강매,2896,2529,5425
20210826,경의선,행신,7126,7228,14354
20210826,경의선,능곡,3508,3228,6736
20210826,경의선,곡산,536,572,1108
20210826,경의선,백마,6504,6253,12757
20210826,경의선,풍산,5155,4833,9988
20210826,경의선,일산,8544,8582,17126
20210826,경의선,탄현,6937,6790,13727
20210826,경의선,야당,6330,6123,12453
20210826,경의선,운정,6176,5918,12094
20210826,경의선,금릉,4272,4180,8452
20210826,경의선,금촌,5946,6027,11973
20210826,경의선,월롱,1990,1904,3894
20210826,경의선,파주,1116,790,1906
20210826,경의선,문산,4680,4750,9430
20210826,경의선,임진강,16,17,33
20210826,경의선,홍대입구,113,30,143
20210827,경의선,서울,3836,4603,8439
20210827,경의선,신촌,814,968,1782
20210827,경의선,효창공원앞,2641,3029,5670
20210827,경의선,공덕,3177,2868,6045
20210827,경의선,서강대,1966,1943,3909
20210827,경의선,홍대입구,1479,1643,3122
20210827,경의선,가좌,4964,4771,9735
20210827,경의선,디지털미디어시티,2224,2051,4275
20210827,경의선,수색,2324,2412,4736
20210827,경의선,화전,1382,1273,2655
20210827,경의선,강매,2847,2503,5350
20210827,경의선,행신,7222,7457,14679
20210827,경의선,능곡,3469,3173,6642
20210827,경의선,곡산,540,590,1130
20210827,경의선,백마,6281,6173,12454
20210827,경의선,풍산,5129,4879,10008
20210827,경의선,일산,8381,8540,16921
20210827,경의선,탄현,6840,6739,13579
20210827,경의선,야당,6258,6152,12410
20210827,경의선,운정,6160,5899,12059
20210827,경의선,금릉,4290,4251,8541
20210827,경의선,금촌,5922,5764,11686
20210827,경의선,월롱,2260,1868,4128
20210827,경의선,파주,1092,713,1805
20210827,경의선,문산,4659,4577,9236
20210827,경의선,임진강,10,6,16
20210827,경의선,검암,1,0,1
20210830,경의선,서울,3937,4793,8730
20210830,경의선,신촌,816,988,1804
20210830,경의선,효창공원앞,2588,3079,5667
20210830,경의선,공덕,3159,2973,6132
20210830,경의선,서강대,2021,1868,3889
20210830,경의선,홍대입구,1420,1529,2949
20210830,경의선,가좌,4990,4815,9805
20210830,경의선,디지털미디어시티,2147,1839,3986
20210830,경의선,수색,2641,2672,5313
20210830,경의선,화전,1438,1341,2779
20210830,경의선,강매,3026,2612,5638
20210830,경의선,행신,7188,7391,14579
20210830,경의선,능곡,3584,3292,6876
20210830,경의선,곡산,559,563,1122
20210830,경의선,백마,6469,6349,12818
20210830,경의선,풍산,5064,4765,9829
20210830,경의선,일산,8459,8524,16983
20210830,경의선,탄현,7080,6780,13860
20210830,경의선,야당,6433,6206,12639
20210830,경의선,운정,6370,5967,12337
20210830,경의선,금릉,4397,4265,8662
20210830,경의선,금촌,5901,5813,11714
20210830,경의선,월롱,2405,2450,4855
20210830,경의선,파주,1195,826,2021
20210830,경의선,문산,4813,4725,9538
20210830,경의선,임진강,21,16,37
20210830,경의선,디지털미디어시티,83,258,341
20210831,경의선,서울,3744,4633,8377
20210831,경의선,신촌,751,947,1698
20210831,경의선,효창공원앞,2614,3155,5769
20210831,경의선,공덕,3170,2798,5968
20210831,경의선,서강대,1878,1872,3750
20210831,경의선,홍대입구,1155,1416,2571
20210831,경의선,가좌,4634,4485,9119
20210831,경의선,디지털미디어시티,2287,2126,4413
20210831,경의선,수색,2420,2489,4909
20210831,경의선,화전,1321,1218,2539
20210831,경의선,강매,2871,2411,5282
20210831,경의선,행신,6778,7056,13834
20210831,경의선,능곡,3293,3046,6339
20210831,경의선,곡산,502,493,995
20210831,경의선,백마,6058,6021,12079
20210831,경의선,풍산,4793,4410,9203
20210831,경의선,일산,7991,8078,16069
20210831,경의선,탄현,6640,6404,13044
20210831,경의선,야당,5881,5625,11506
20210831,경의선,운정,5863,5757,11620
20210831,경의선,금릉,4076,3903,7979
20210831,경의선,금촌,5494,5419,10913
20210831,경의선,월롱,2366,2385,4751
20210831,경의선,파주,994,671,1665
20210831,경의선,문산,4355,4278,8633
20210831,경의선,임진강,16,2,18
20210901,경의선,서울,3837,4599,8436
20210901,경의선,신촌,807,981,1788
20210901,경의선,효창공원앞,2665,3074,5739
20210901,경의선,공덕,3151,2887,6038
20210901,경의선,서강대,1937,1778,3715
20210901,경의선,홍대입구,1395,1510,2905
20210901,경의선,가좌,4844,4717,9561
20210901,경의선,디지털미디어시티,2274,2158,4432
20210901,경의선,수색,2500,2537,5037
20210901,경의선,화전,1595,1480,3075
20210901,경의선,강매,3039,2641,5680
20210901,경의선,행신,7105,7257,14362
20210901,경의선,능곡,3549,3232,6781
20210901,경의선,곡산,530,571,1101
20210901,경의선,백마,6490,6263,12753
20210901,경의선,풍산,5093,4815,9908
20210901,경의선,일산,8551,8539,17090
20210901,경의선,탄현,6974,6764,13738
20210901,경의선,야당,6151,6058,12209
20210901,경의선,운정,6093,5873,11966
20210901,경의선,금릉,4279,4150,8429
20210901,경의선,금촌,5932,5867,11799
20210901,경의선,월롱,2498,2457,4955
20210901,경의선,파주,1113,766,1879
20210901,경의선,문산,4477,4498,8975
20210901,경의선,임진강,12,9,21
20210902,경의선,임진강,13,22,35
20210902,경의선,문산,4686,4585,9271
20210902,경의선,파주,1101,748,1849
20210902,경의선,월롱,2438,2320,4758
20210902,경의선,금촌,5834,5932,11766
20210902,경의선,금릉,4338,4267,8605
20210902,경의선,운정,6370,6020,12390
20210902,경의선,야당,6286,6062,12348
20210902,경의선,탄현,7096,6864,13960
20210902,경의선,일산,8711,8618,17329
20210902,경의선,풍산,5357,5004,10361
20210902,경의선,백마,6429,6272,12701
20210902,경의선,곡산,579,598,1177
20210902,경의선,능곡,3694,3346,7040
20210902,경의선,행신,7255,7360,14615
20210902,경의선,강매,3018,2598,5616
20210902,경의선,화전,1558,1410,2968
20210902,경의선,수색,2552,2668,5220
20210902,경의선,디지털미디어시티,2283,2109,4392
20210902,경의선,가좌,5029,4829,9858
20210902,경의선,홍대입구,1522,1664,3186
20210902,경의선,서강대,2023,1861,3884
20210902,경의선,공덕,3248,2932,6180
20210902,경의선,효창공원앞,2660,3170,5830
20210902,경의선,신촌,804,971,1775
20210902,경의선,서울,4012,4942,8954
20210903,경의선,임진강,17,12,29
20210903,경의선,문산,5044,4965,10009
20210903,경의선,파주,1187,776,1963
20210903,경의선,월롱,2488,1962,4450
20210903,경의선,금촌,6246,6159,12405
20210903,경의선,금릉,4590,4475,9065
20210903,경의선,운정,6498,6262,12760
20210903,경의선,야당,6677,6673,13350
20210903,경의선,탄현,7333,7172,14505
20210903,경의선,일산,9516,9702,19218
20210903,경의선,풍산,5571,5313,10884
20210903,경의선,백마,6721,6584,13305
20210903,경의선,곡산,601,595,1196
20210903,경의선,능곡,3769,3442,7211
20210903,경의선,행신,7640,7783,15423
20210903,경의선,강매,3002,2672,5674
20210903,경의선,화전,1717,1566,3283
20210903,경의선,수색,2447,2444,4891
20210903,경의선,디지털미디어시티,2393,2239,4632
20210903,경의선,가좌,5240,4946,10186
20210903,경의선,홍대입구,1646,1764,3410
20210903,경의선,서강대,2214,1971,4185
20210903,경의선,공덕,3308,3096,6404
20210903,경의선,효창공원앞,2761,3194,5955
20210903,경의선,신촌,839,1022,1861
20210903,경의선,서울,4052,4991,9043
20210906,경의선,서울,3934,4906,8840
20210906,경의선,신촌,809,1051,1860
20210906,경의선,효창공원앞,2710,3163,5873
20210906,경의선,공덕,3280,2902,6182
20210906,경의선,서강대,1931,1936,3867
20210906,경의선,홍대입구,1301,1414,2715
20210906,경의선,가좌,5064,4909,9973
20210906,경의선,디지털미디어시티,2225,2163,4388
20210906,경의선,수색,2562,2633,5195
20210906,경의선,화전,1562,1464,3026
20210906,경의선,강매,3078,2619,5697
20210906,경의선,행신,7250,7438,14688
20210906,경의선,능곡,3606,3336,6942
20210906,경의선,곡산,569,583,1152
20210906,경의선,백마,6640,6445,13085
20210906,경의선,풍산,5208,4818,10026
20210906,경의선,일산,8701,8735,17436
20210906,경의선,탄현,7275,6861,14136
20210906,경의선,야당,6418,6198,12616
20210906,경의선,운정,6459,6139,12598
20210906,경의선,금릉,4445,4312,8757
20210906,경의선,금촌,6065,6137,12202
20210906,경의선,월롱,2403,2409,4812
20210906,경의선,파주,1160,809,1969
20210906,경의선,문산,4843,4763,9606
20210906,경의선,임진강,4,6,10
20210907,경의선,서울,3726,4472,8198
20210907,경의선,신촌,781,928,1709
20210907,경의선,효창공원앞,2657,3084,5741
20210907,경의선,공덕,3115,2760,5875
20210907,경의선,서강대,1885,1820,3705
20210907,경의선,홍대입구,1254,1337,2591
20210907,경의선,가좌,4729,4558,9287
20210907,경의선,디지털미디어시티,2229,2001,4230
20210907,경의선,수색,2388,2380,4768
20210907,경의선,화전,1427,1298,2725
20210907,경의선,강매,2862,2481,5343
20210907,경의선,행신,6879,7007,13886
20210907,경의선,능곡,3380,3074,6454
20210907,경의선,곡산,531,529,1060
20210907,경의선,백마,6097,6050,12147
20210907,경의선,풍산,4846,4510,9356
20210907,경의선,일산,8199,8310,16509
20210907,경의선,탄현,6750,6547,13297
20210907,경의선,야당,5952,5694,11646
20210907,경의선,운정,5800,5715,11515
20210907,경의선,금릉,4109,3939,8048
20210907,경의선,금촌,5365,5326,10691
20210907,경의선,월롱,2377,2343,4720
20210907,경의선,파주,1046,676,1722
20210907,경의선,문산,4196,4201,8397
20210907,경의선,임진강,6,2,8
20210908,경의선,서울,3999,4954,8953
20210908,경의선,신촌,831,1043,1874
20210908,경의선,효창공원앞,2786,3207,5993
20210908,경의선,공덕,3340,3038,6378
20210908,경의선,서강대,2012,1949,3961
20210908,경의선,홍대입구,1519,1616,3135
20210908,경의선,가좌,5246,4868,10114
20210908,경의선,디지털미디어시티,2324,2261,4585
20210908,경의선,수색,2672,2761,5433
20210908,경의선,화전,1720,1573,3293
20210908,경의선,강매,3150,2755,5905
20210908,경의선,행신,7578,7567,15145
20210908,경의선,능곡,3810,3384,7194
20210908,경의선,곡산,587,635,1222
20210908,경의선,백마,6794,6571,13365
20210908,경의선,풍산,5204,4810,10014
20210908,경의선,일산,9719,9796,19515
20210908,경의선,탄현,7306,7036,14342
20210908,경의선,야당,6616,6544,13160
20210908,경의선,운정,6619,6255,12874
20210908,경의선,금릉,4578,4470,9048
20210908,경의선,금촌,6095,6114,12209
20210908,경의선,월롱,2567,2438,5005
20210908,경의선,파주,1146,809,1955
20210908,경의선,문산,4755,4778,9533
20210908,경의선,임진강,10,4,14
20210909,경의선,서울,4075,4981,9056
20210909,경의선,신촌,882,1036,1918
20210909,경의선,효창공원앞,2732,3167,5899
20210909,경의선,공덕,3367,3022,6389
20210909,경의선,서강대,2008,1904,3912
20210909,경의선,홍대입구,1482,1629,3111
20210909,경의선,가좌,5120,4776,9896
20210909,경의선,디지털미디어시티,2457,2179,4636
20210909,경의선,수색,2617,2600,5217
20210909,경의선,화전,1588,1493,3081
20210909,경의선,강매,3188,2740,5928
20210909,경의선,행신,7470,7609,15079
20210909,경의선,능곡,3741,3422,7163
20210909,경의선,곡산,598,611,1209
20210909,경의선,백마,6717,6545,13262
20210909,경의선,풍산,5308,5096,10404
20210909,경의선,일산,8939,9000,17939
20210909,경의선,탄현,7392,7164,14556
20210909,경의선,야당,6594,6507,13101
20210909,경의선,운정,6511,6241,12752
20210909,경의선,금릉,4437,4350,8787
20210909,경의선,금촌,6148,6018,12166
20210909,경의선,월롱,2454,2347,4801
20210909,경의선,파주,1126,797,1923
20210909,경의선,문산,5123,5193,10316
20210909,경의선,임진강,11,10,21
20210910,경의선,홍대입구,1624,1752,3376
20210910,경의선,서강대,2068,2004,4072
20210910,경의선,공덕,3354,3101,6455
20210910,경의선,효창공원앞,2728,3236,5964
20210910,경의선,신촌,892,1110,2002
20210910,경의선,서울,4097,5135,9232
20210910,경의선,임진강,13,4,17
20210910,경의선,문산,5164,5134,10298
20210910,경의선,파주,1207,813,2020
20210910,경의선,월롱,2561,1996,4557
20210910,경의선,금촌,6379,6336,12715
20210910,경의선,금릉,4750,4636,9386
20210910,경의선,운정,6667,6415,13082
20210910,경의선,야당,6674,6805,13479
20210910,경의선,탄현,7382,7081,14463
20210910,경의선,일산,8941,8914,17855
20210910,경의선,풍산,5382,5193,10575
20210910,경의선,백마,6771,6558,13329
20210910,경의선,곡산,613,640,1253
20210910,경의선,능곡,3742,3391,7133
20210910,경의선,행신,7689,7918,15607
20210910,경의선,강매,3039,2627,5666
20210910,경의선,화전,1744,1554,3298
20210910,경의선,수색,2571,2626,5197
20210910,경의선,디지털미디어시티,2414,2236,4650
20210910,경의선,가좌,5280,5060,10340
20210913,경의선,검암,1,0,1
20210913,경의선,임진강,12,7,19
20210913,경의선,문산,4797,4700,9497
20210913,경의선,파주,1218,777,1995
20210913,경의선,월롱,2425,2463,4888
20210913,경의선,금촌,6232,6079,12311
20210913,경의선,금릉,4598,4560,9158
20210913,경의선,운정,6600,6113,12713
20210913,경의선,야당,6666,6466,13132
20210913,경의선,탄현,7598,7062,14660
20210913,경의선,일산,9882,9919,19801
20210913,경의선,풍산,5459,5027,10486
20210913,경의선,백마,6937,6656,13593
20210913,경의선,곡산,575,586,1161
20210913,경의선,능곡,3740,3364,7104
20210913,경의선,행신,7423,7626,15049
20210913,경의선,강매,3104,2649,5753
20210913,경의선,화전,1580,1466,3046
20210913,경의선,수색,2631,2712,5343
20210913,경의선,디지털미디어시티,2377,2161,4538
20210913,경의선,가좌,5176,4928,10104
20210913,경의선,홍대입구,1435,1590,3025
20210913,경의선,서강대,1964,1868,3832
20210913,경의선,공덕,3290,3080,6370
20210913,경의선,효창공원앞,2828,3196,6024
20210913,경의선,신촌,831,1004,1835
20210913,경의선,서울,3978,5032,9010
20210914,경의선,임진강,13,11,24
20210914,경의선,문산,5122,5068,10190
20210914,경의선,파주,1098,761,1859
20210914,경의선,월롱,2627,2487,5114
20210914,경의선,금촌,6037,6000,12037
20210914,경의선,금릉,4532,4455,8987
20210914,경의선,운정,6365,6154,12519
20210914,경의선,야당,6511,6361,12872
20210914,경의선,탄현,7424,7048,14472
20210914,경의선,일산,8803,8842,17645
20210914,경의선,풍산,5391,4984,10375
20210914,경의선,백마,6719,6555,13274
20210914,경의선,곡산,573,601,1174
20210914,경의선,능곡,3773,3386,7159
20210914,경의선,행신,7413,7482,14895
20210914,경의선,강매,3126,2616,5742
20210914,경의선,화전,1763,1609,3372
20210914,경의선,수색,2663,2678,5341
20210914,경의선,디지털미디어시티,2399,2222,4621
20210914,경의선,가좌,5359,5047,10406
20210914,경의선,홍대입구,1521,1590,3111
20210914,경의선,서강대,2034,1929,3963
20210914,경의선,공덕,3182,2922,6104
20210914,경의선,효창공원앞,2862,3281,6143
20210914,경의선,신촌,846,1082,1928
20210914,경의선,서울,3988,4947,8935
20210915,경의선,서울,383,96,479
20210915,경의선,임진강,5,7,12
20210915,경의선,문산,4912,4896,9808
20210915,경의선,파주,1158,769,1927
20210915,경의선,월롱,2540,2427,4967
20210915,경의선,금촌,6123,6193,12316
20210915,경의선,금릉,4612,4462,9074
20210915,경의선,운정,6486,6161,12647
20210915,경의선,야당,6715,6586,13301
20210915,경의선,탄현,7482,7061,14543
20210915,경의선,일산,9102,8975,18077
20210915,경의선,풍산,5364,5075,10439
20210915,경의선,백마,6904,6737,13641
20210915,경의선,곡산,605,643,1248
20210915,경의선,능곡,3813,3485,7298
20210915,경의선,행신,7484,7654,15138
20210915,경의선,강매,3146,2711,5857
20210915,경의선,화전,1728,1599,3327
20210915,경의선,수색,2709,2717,5426
20210915,경의선,디지털미디어시티,2410,2254,4664
20210915,경의선,가좌,5419,5048,10467
20210915,경의선,홍대입구,1541,1612,3153
20210915,경의선,서강대,2203,1968,4171
20210915,경의선,공덕,3468,3169,6637
20210915,경의선,효창공원앞,2842,3269,6111
20210915,경의선,신촌,854,1059,1913
20210915,경의선,서울,3746,5118,8864
20210916,경의선,강매,3166,2721,5887
20210916,경의선,임진강,12,6,18
20210916,경의선,문산,4886,4941,9827
20210916,경의선,파주,1161,843,2004
20210916,경의선,월롱,2605,2334,4939
20210916,경의선,금촌,6548,6459,13007
20210916,경의선,금릉,4551,4551,9102
20210916,경의선,운정,6672,6250,12922
20210916,경의선,야당,6818,6548,13366
20210916,경의선,탄현,7440,7131,14571
20210916,경의선,일산,8985,8938,17923
20210916,경의선,풍산,5520,5149,10669
20210916,경의선,백마,6890,6604,13494
20210916,경의선,곡산,609,637,1246
20210916,경의선,능곡,3745,3361,7106
20210916,경의선,행신,7497,7703,15200
20210916,경의선,서울,4121,5245,9366
20210916,경의선,신촌,895,1120,2015
20210916,경의선,효창공원앞,2752,3176,5928
20210916,경의선,공덕,3471,3095,6566
20210916,경의선,서강대,2120,2057,4177
20210916,경의선,홍대입구,1634,1698,3332
20210916,경의선,가좌,5534,5101,10635
20210916,경의선,디지털미디어시티,2454,2261,4715
20210916,경의선,수색,2635,2701,5336
20210916,경의선,화전,1703,1511,3214
20210917,경의선,서울,3756,4974,8730
20210917,경의선,신촌,884,1010,1894
20210917,경의선,효창공원앞,2735,3121,5856
20210917,경의선,공덕,3339,3052,6391
20210917,경의선,서강대,2219,2036,4255
20210917,경의선,홍대입구,1712,1895,3607
20210917,경의선,가좌,5284,5005,10289
20210917,경의선,디지털미디어시티,2386,2197,4583
20210917,경의선,수색,2465,2508,4973
20210917,경의선,화전,1678,1530,3208
20210917,경의선,강매,3063,2703,5766
20210917,경의선,행신,7386,7362,14748
20210917,경의선,능곡,3775,3523,7298
20210917,경의선,곡산,558,594,1152
20210917,경의선,백마,6771,6509,13280
20210917,경의선,풍산,5484,5216,10700
20210917,경의선,일산,8800,8909,17709
20210917,경의선,탄현,7273,7053,14326
20210917,경의선,야당,6874,7002,13876
20210917,경의선,운정,6545,6356,12901
20210917,경의선,금릉,4650,4584,9234
20210917,경의선,금촌,6713,6461,13174
20210917,경의선,월롱,2801,1943,4744
20210917,경의선,파주,1197,771,1968
20210917,경의선,문산,5143,5046,10189
20210917,경의선,임진강,9,11,20
20210920,경의선,서울,848,726,1574
20210920,경의선,신촌,194,189,383
20210920,경의선,효창공원앞,787,881,1668
20210920,경의선,공덕,1160,991,2151
20210920,경의선,서강대,938,787,1725
20210920,경의선,홍대입구,876,995,1871
20210920,경의선,가좌,2090,2007,4097
20210920,경의선,디지털미디어시티,1069,893,1962
20210920,경의선,수색,683,641,1324
20210920,경의선,화전,501,458,959
20210920,경의선,강매,1093,996,2089
20210920,경의선,행신,2780,2836,5616
20210920,경의선,능곡,1591,1633,3224
20210920,경의선,곡산,221,216,437
20210920,경의선,백마,2379,2294,4673
20210920,경의선,풍산,2428,2411,4839
20210920,경의선,일산,3491,3472,6963
20210920,경의선,탄현,2801,2715,5516
20210920,경의선,야당,3206,3323,6529
20210920,경의선,운정,2699,2569,5268
20210920,경의선,금릉,2184,2202,4386
20210920,경의선,금촌,3819,4120,7939
20210920,경의선,월롱,760,767,1527
20210920,경의선,파주,532,490,1022
20210920,경의선,문산,3091,3374,6465
20210920,경의선,임진강,81,75,156
20210920,경의선,계양,1,0,1
20210921,경의선,곡산,175,198,373
20210921,경의선,백마,1824,1774,3598
20210921,경의선,풍산,1800,1753,3553
20210921,경의선,일산,2764,2791,5555
20210921,경의선,탄현,2497,2451,4948
20210921,경의선,야당,2535,2437,4972
20210921,경의선,운정,2213,2096,4309
20210921,경의선,금릉,1780,1658,3438
20210921,경의선,금촌,3090,3108,6198
20210921,경의선,월롱,577,699,1276
20210921,경의선,파주,569,415,984
20210921,경의선,문산,2826,2631,5457
20210921,경의선,임진강,90,66,156
20210921,경의선,서울,706,625,1331
20210921,경의선,신촌,146,135,281
20210921,경의선,효창공원앞,743,884,1627
20210921,경의선,공덕,925,929,1854
20210921,경의선,서강대,741,829,1570
20210921,경의선,홍대입구,569,754,1323
20210921,경의선,가좌,1545,1689,3234
20210921,경의선,디지털미디어시티,929,820,1749
20210921,경의선,수색,542,573,1115
20210921,경의선,화전,414,382,796
20210921,경의선,강매,877,861,1738
20210921,경의선,행신,2402,2523,4925
20210921,경의선,능곡,1342,1302,2644
20210922,경의선,서울,874,824,1698
20210922,경의선,신촌,187,181,368
20210922,경의선,효창공원앞,940,1276,2216
20210922,경의선,공덕,1209,1210,2419
20210922,경의선,서강대,1064,1085,2149
20210922,경의선,홍대입구,1179,1472,2651
20210922,경의선,가좌,2346,2407,4753
20210922,경의선,디지털미디어시티,1168,1096,2264
20210922,경의선,수색,716,782,1498
20210922,경의선,화전,601,647,1248
20210922,경의선,강매,1323,1224,2547
20210922,경의선,행신,3306,3342,6648
20210922,경의선,능곡,1872,1813,3685
20210922,경의선,곡산,301,292,593
20210922,경의선,백마,2743,2507,5250
20210922,경의선,풍산,2830,2565,5395
20210922,경의선,일산,4063,3609,7672
20210922,경의선,탄현,3650,3216,6866
20210922,경의선,야당,3815,3702,7517
20210922,경의선,운정,3126,2883,6009
20210922,경의선,금릉,2557,2409,4966
20210922,경의선,금촌,3874,3957,7831
20210922,경의선,월롱,694,984,1678
20210922,경의선,파주,639,518,1157
20210922,경의선,문산,3740,3321,7061
20210922,경의선,임진강,102,89,191
20210923,경의선,서울,3990,4653,8643
20210923,경의선,신촌,808,1046,1854
20210923,경의선,효창공원앞,2588,3026,5614
20210923,경의선,공덕,3144,2914,6058
20210923,경의선,서강대,1871,1905,3776
20210923,경의선,홍대입구,1618,1691,3309
20210923,경의선,가좌,4798,4813,9611
20210923,경의선,디지털미디어시티,2179,2018,4197
20210923,경의선,수색,2433,2538,4971
20210923,경의선,화전,1429,1380,2809
20210923,경의선,강매,2907,2508,5415
20210923,경의선,행신,7285,7097,14382
20210923,경의선,능곡,3612,3234,6846
20210923,경의선,곡산,553,572,1125
20210923,경의선,백마,6352,6202,12554
20210923,경의선,풍산,5163,4807,9970
20210923,경의선,일산,8594,8497,17091
20210923,경의선,탄현,6953,6648,13601
20210923,경의선,야당,6386,6148,12534
20210923,경의선,운정,6205,5722,11927
20210923,경의선,금릉,4431,4297,8728
20210923,경의선,금촌,6269,6136,12405
20210923,경의선,월롱,1627,2105,3732
20210923,경의선,파주,1148,794,1942
20210923,경의선,문산,5015,4929,9944
20210923,경의선,임진강,6,19,25
20210923,경의선,계양,1,0,1
20210924,경의선,서울,3862,4962,8824
20210924,경의선,신촌,844,1101,1945
20210924,경의선,효창공원앞,2802,3246,6048
20210924,경의선,공덕,3183,2991,6174
20210924,경의선,서강대,2072,2064,4136
20210924,경의선,홍대입구,1676,1822,3498
20210924,경의선,가좌,5116,4917,10033
20210924,경의선,디지털미디어시티,2396,2121,4517
20210924,경의선,수색,2531,2569,5100
20210924,경의선,화전,1612,1512,3124
20210924,경의선,강매,3096,2687,5783
20210924,경의선,행신,7362,7465,14827
20210924,경의선,능곡,3652,3401,7053
20210924,경의선,곡산,592,593,1185
20210924,경의선,백마,6738,6462,13200
20210924,경의선,풍산,5443,5049,10492
20210924,경의선,일산,8630,8538,17168
20210924,경의선,탄현,7270,6951,14221
20210924,경의선,야당,6776,6713,13489
20210924,경의선,운정,6656,6256,12912
20210924,경의선,금릉,4667,4571,9238
20210924,경의선,금촌,6532,6307,12839
20210924,경의선,월롱,1954,1854,3808
20210924,경의선,파주,1174,795,1969
20210924,경의선,문산,5284,5321,10605
20210924,경의선,임진강,21,15,36
20210927,경의선,임진강,8,5,13
20210927,경의선,문산,4878,4845,9723
20210927,경의선,파주,1527,1138,2665
20210927,경의선,월롱,2456,2465,4921
20210927,경의선,금촌,6314,6202,12516
20210927,경의선,금릉,4588,4449,9037
20210927,경의선,운정,6697,6311,13008
20210927,경의선,야당,6675,6345,13020
20210927,경의선,탄현,7401,6999,14400
20210927,경의선,일산,8896,8809,17705
20210927,경의선,풍산,5264,4882,10146
20210927,경의선,백마,6809,6614,13423
20210927,경의선,곡산,595,591,1186
20210927,경의선,능곡,3703,3291,6994
20210927,경의선,행신,7310,7514,14824
20210927,경의선,강매,3169,2716,5885
20210927,경의선,화전,1642,1549,3191
20210927,경의선,수색,2736,2829,5565
20210927,경의선,디지털미디어시티,2310,2136,4446
20210927,경의선,가좌,5250,4930,10180
20210927,경의선,홍대입구,1339,1534,2873
20210927,경의선,서강대,2034,1907,3941
20210927,경의선,공덕,3293,3025,6318
20210927,경의선,효창공원앞,2803,3263,6066
20210927,경의선,신촌,822,1053,1875
20210927,경의선,서울,4011,5086,9097
20210928,경의선,서울,4058,4950,9008
20210928,경의선,신촌,839,1059,1898
20210928,경의선,효창공원앞,2781,3241,6022
20210928,경의선,공덕,3404,3050,6454
20210928,경의선,서강대,1934,1945,3879
20210928,경의선,홍대입구,1440,1643,3083
20210928,경의선,가좌,5065,4873,9938
20210928,경의선,디지털미디어시티,2400,2204,4604
20210928,경의선,수색,2679,2765,5444
20210928,경의선,화전,1640,1571,3211
20210928,경의선,강매,3173,2716,5889
20210928,경의선,행신,7433,7498,14931
20210928,경의선,능곡,3712,3348,7060
20210928,경의선,곡산,590,594,1184
20210928,경의선,백마,6795,6562,13357
20210928,경의선,풍산,5358,5044,10402
20210928,경의선,일산,9438,9392,18830
20210928,경의선,탄현,7407,7033,14440
20210928,경의선,야당,6768,6532,13300
20210928,경의선,운정,6574,6229,12803
20210928,경의선,금릉,4611,4532,9143
20210928,경의선,금촌,6041,6047,12088
20210928,경의선,월롱,2481,2431,4912
20210928,경의선,파주,1432,1074,2506
20210928,경의선,문산,4872,4994,9866
20210928,경의선,임진강,15,8,23
20210929,경의선,검암,1,0,1
20210929,경의선,야당,6299,6182,12481
20210929,경의선,운정,6189,5835,12024
20210929,경의선,금릉,4372,4209,8581
20210929,경의선,금촌,5564,5474,11038
20210929,경의선,월롱,2383,2314,4697
20210929,경의선,파주,1221,857,2078
20210929,경의선,문산,4513,4437,8950
20210929,경의선,임진강,7,3,10
20210929,경의선,탄현,6985,6786,13771
20210929,경의선,일산,8376,8390,16766
20210929,경의선,풍산,4977,4686,9663
20210929,경의선,백마,6529,6376,12905
20210929,경의선,곡산,561,575,1136
20210929,경의선,능곡,3481,3183,6664
20210929,경의선,행신,7067,7189,14256
20210929,경의선,강매,2999,2641,5640
20210929,경의선,화전,1600,1454,3054
20210929,경의선,수색,2532,2541,5073
20210929,경의선,디지털미디어시티,2271,2066,4337
20210929,경의선,가좌,4902,4654,9556
20210929,경의선,홍대입구,1366,1532,2898
20210929,경의선,서강대,1925,1787,3712
20210929,경의선,공덕,3179,2950,6129
20210929,경의선,효창공원앞,2733,3125,5858
20210929,경의선,신촌,791,944,1735
20210929,경의선,서울,3800,4796,8596
20210930,경의선,서울,4117,5225,9342
20210930,경의선,신촌,833,1029,1862
20210930,경의선,효창공원앞,2752,3189,5941
20210930,경의선,공덕,3292,3126,6418
20210930,경의선,서강대,2018,1917,3935
20210930,경의선,홍대입구,1478,1605,3083
20210930,경의선,가좌,5283,5019,10302
20210930,경의선,디지털미디어시티,2417,2290,4707
20210930,경의선,수색,2629,2750,5379
20210930,경의선,화전,1714,1558,3272
20210930,경의선,강매,3243,2727,5970
20210930,경의선,행신,7602,7679,15281
20210930,경의선,능곡,3750,3426,7176
20210930,경의선,곡산,620,641,1261
20210930,경의선,백마,6793,6632,13425
20210930,경의선,풍산,5438,5175,10613
20210930,경의선,일산,8969,8911,17880
20210930,경의선,탄현,7550,7265,14815
20210930,경의선,야당,6870,6710,13580
20210930,경의선,운정,6711,6340,13051
20210930,경의선,금릉,4694,4554,9248
20210930,경의선,금촌,6222,6410,12632
20210930,경의선,월롱,2464,2385,4849
20210930,경의선,파주,1527,1145,2672
20210930,경의선,문산,5157,5178,10335
20210930,경의선,임진강,25,17,42
20211001,경의선,서울,73,1176,1249
20211001,경의선,임진강,25,13,38
20211001,경의선,문산,5376,5205,10581
20211001,경의선,파주,1351,898,2249
20211001,경의선,월롱,2620,2092,4712
20211001,경의선,금촌,6805,6650,13455
20211001,경의선,금릉,4769,4578,9347
20211001,경의선,운정,6705,6499,13204
20211001,경의선,야당,6987,6921,13908
20211001,경의선,탄현,7444,7299,14743
20211001,경의선,일산,8941,9094,18035
20211001,경의선,풍산,5608,5236,10844
20211001,경의선,백마,6847,6654,13501
20211001,경의선,곡산,613,678,1291
20211001,경의선,능곡,3777,3527,7304
20211001,경의선,행신,7736,7916,15652
20211001,경의선,강매,3118,2695,5813
20211001,경의선,화전,1813,1655,3468
20211001,경의선,수색,2493,2602,5095
20211001,경의선,디지털미디어시티,2507,2338,4845
20211001,경의선,가좌,5247,5115,10362
20211001,경의선,홍대입구,1639,1920,3559
20211001,경의선,서강대,2162,2021,4183
20211001,경의선,공덕,3539,3235,6774
20211001,경의선,효창공원앞,2830,3217,6047
20211001,경의선,신촌,811,995,1806
20211001,경의선,서울,4073,4111,8184
20211004,경의선,서울,1210,1114,2324
20211004,경의선,신촌,363,378,741
20211004,경의선,효창공원앞,1465,1634,3099
20211004,경의선,공덕,1640,1419,3059
20211004,경의선,서강대,1388,1389,2777
20211004,경의선,홍대입구,1198,1405,2603
20211004,경의선,가좌,2933,3120,6053
20211004,경의선,디지털미디어시티,1401,1313,2714
20211004,경의선,수색,1211,1210,2421
20211004,경의선,화전,905,943,1848
20211004,경의선,강매,1593,1436,3029
20211004,경의선,행신,4333,4210,8543
20211004,경의선,능곡,2280,2161,4441
20211004,경의선,곡산,309,303,612
20211004,경의선,백마,3576,3343,6919
20211004,경의선,풍산,3283,3112,6395
20211004,경의선,일산,4809,4637,9446
20211004,경의선,탄현,4229,3885,8114
20211004,경의선,야당,4452,4146,8598
20211004,경의선,운정,3780,3542,7322
20211004,경의선,금릉,2770,2710,5480
20211004,경의선,금촌,4115,4168,8283
20211004,경의선,월롱,1061,1741,2802
20211004,경의선,파주,671,576,1247
20211004,경의선,문산,3825,3775,7600
20211004,경의선,임진강,24,27,51
20211005,경의선,계양,1,0,1
20211005,경의선,임진강,26,17,43
20211005,경의선,문산,4862,4775,9637
20211005,경의선,파주,1423,1050,2473
20211005,경의선,월롱,2634,2596,5230
20211005,경의선,금촌,6012,5979,11991
20211005,경의선,금릉,4632,4537,9169
20211005,경의선,운정,6593,6236,12829
20211005,경의선,야당,6649,6408,13057
20211005,경의선,탄현,7491,7085,14576
20211005,경의선,일산,9119,8967,18086
20211005,경의선,풍산,5556,5099,10655
20211005,경의선,백마,6885,6533,13418
20211005,경의선,곡산,561,601,1162
20211005,경의선,능곡,3726,3387,7113
20211005,경의선,행신,7522,7726,15248
20211005,경의선,강매,3163,2705,5868
20211005,경의선,화전,1719,1602,3321
20211005,경의선,수색,2666,2718,5384
20211005,경의선,디지털미디어시티,2394,2172,4566
20211005,경의선,가좌,5121,4875,9996
20211005,경의선,홍대입구,1407,1526,2933
20211005,경의선,서강대,2033,1898,3931
20211005,경의선,공덕,3390,3135,6525
20211005,경의선,효창공원앞,2842,3249,6091
20211005,경의선,신촌,832,1046,1878
20211005,경의선,서울,4103,5159,9262
20211006,경의선,서울,4093,4923,9016
20211006,경의선,신촌,794,1017,1811
20211006,경의선,효창공원앞,2862,3195,6057
20211006,경의선,공덕,3314,3083,6397
20211006,경의선,서강대,2046,1914,3960
20211006,경의선,홍대입구,1424,1535,2959
20211006,경의선,가좌,5108,4761,9869
20211006,경의선,디지털미디어시티,2381,2233,4614
20211006,경의선,수색,2602,2699,5301
20211006,경의선,화전,1712,1493,3205
20211006,경의선,강매,3144,2715,5859
20211006,경의선,행신,7552,7631,15183
20211006,경의선,능곡,3656,3354,7010
20211006,경의선,곡산,573,621,1194
20211006,경의선,백마,6792,6431,13223
20211006,경의선,풍산,5305,5018,10323
20211006,경의선,일산,8919,8875,17794
20211006,경의선,탄현,7249,6980,14229
20211006,경의선,야당,6601,6514,13115
20211006,경의선,운정,6496,6177,12673
20211006,경의선,금릉,4545,4353,8898
20211006,경의선,금촌,6053,6110,12163
20211006,경의선,월롱,2552,2390,4942
20211006,경의선,파주,1218,875,2093
20211006,경의선,문산,4811,4717,9528
20211006,경의선,임진강,3,10,13
20211007,경의선,계양,1,0,1
20211007,경의선,임진강,8,8,16
20211007,경의선,문산,4842,4870,9712
20211007,경의선,파주,1095,781,1876
20211007,경의선,월롱,2618,2406,5024
20211007,경의선,금촌,6101,6054,12155
20211007,경의선,금릉,4567,4464,9031
20211007,경의선,운정,6691,6421,13112
20211007,경의선,야당,6781,6540,13321
20211007,경의선,탄현,7466,7207,14673
20211007,경의선,일산,9128,8946,18074
20211007,경의선,풍산,5493,5247,10740
20211007,경의선,백마,6889,6559,13448
20211007,경의선,곡산,646,664,1310
20211007,경의선,능곡,3725,3438,7163
20211007,경의선,행신,7547,7518,15065
20211007,경의선,강매,3225,2719,5944
20211007,경의선,화전,1616,1522,3138
20211007,경의선,수색,2672,2821,5493
20211007,경의선,디지털미디어시티,2461,2242,4703
20211007,경의선,가좌,5134,4819,9953
20211007,경의선,홍대입구,1438,1585,3023
20211007,경의선,서강대,2049,1913,3962
20211007,경의선,공덕,3370,3144,6514
20211007,경의선,효창공원앞,2774,3283,6057
20211007,경의선,신촌,826,1047,1873
20211007,경의선,서울,4214,5113,9327
20211008,경의선,김포공항,1,0,1
20211008,경의선,임진강,8,12,20
20211008,경의선,문산,5286,5196,10482
20211008,경의선,파주,1148,756,1904
20211008,경의선,월롱,2695,2155,4850
20211008,경의선,금촌,6353,6355,12708
20211008,경의선,금릉,4836,4771,9607
20211008,경의선,운정,6841,6566,13407
20211008,경의선,야당,7201,7171,14372
20211008,경의선,탄현,7553,7274,14827
20211008,경의선,일산,9766,9679,19445
20211008,경의선,풍산,5633,5301,10934
20211008,경의선,백마,6899,6851,13750
20211008,경의선,곡산,607,638,1245
20211008,경의선,능곡,3835,3466,7301
20211008,경의선,행신,7866,8007,15873
20211008,경의선,강매,3183,2732,5915
20211008,경의선,화전,1648,1575,3223
20211008,경의선,수색,2621,2710,5331
20211008,경의선,디지털미디어시티,2568,2290,4858
20211008,경의선,가좌,5280,5077,10357
20211008,경의선,홍대입구,1674,1836,3510
20211008,경의선,서강대,2090,2033,4123
20211008,경의선,공덕,3383,3067,6450
20211008,경의선,효창공원앞,2828,3274,6102
20211008,경의선,신촌,820,1040,1860
20211008,경의선,서울,4152,5277,9429
20211011,경의선,서울,1299,1223,2522
20211011,경의선,신촌,274,314,588
20211011,경의선,효창공원앞,1462,1688,3150
20211011,경의선,공덕,1774,1572,3346
20211011,경의선,서강대,1431,1404,2835
20211011,경의선,홍대입구,1380,1604,2984
20211011,경의선,가좌,3155,3255,6410
20211011,경의선,디지털미디어시티,1500,1474,2974
20211011,경의선,수색,1356,1357,2713
20211011,경의선,화전,971,981,1952
20211011,경의선,강매,1625,1523,3148
20211011,경의선,행신,4715,4520,9235
20211011,경의선,능곡,2477,2402,4879
20211011,경의선,곡산,385,359,744
20211011,경의선,백마,3898,3704,7602
20211011,경의선,풍산,3638,3470,7108
20211011,경의선,일산,5342,5017,10359
20211011,경의선,탄현,4671,4453,9124
20211011,경의선,야당,4953,4762,9715
20211011,경의선,운정,4205,3975,8180
20211011,경의선,금릉,3174,3070,6244
20211011,경의선,금촌,5073,5141,10214
20211011,경의선,월롱,1200,1976,3176
20211011,경의선,파주,805,700,1505
20211011,경의선,문산,3975,3961,7936
20211011,경의선,임진강,63,61,124
20211012,경의선,서울,4337,5400,9737
20211012,경의선,신촌,867,1057,1924
20211012,경의선,효창공원앞,2876,3358,6234
20211012,경의선,공덕,3489,3204,6693
20211012,경의선,서강대,2041,1927,3968
20211012,경의선,홍대입구,1435,1599,3034
20211012,경의선,가좌,5296,5008,10304
20211012,경의선,디지털미디어시티,2410,2268,4678
20211012,경의선,수색,2854,2904,5758
20211012,경의선,화전,1804,1680,3484
20211012,경의선,강매,3321,2846,6167
20211012,경의선,행신,7849,8052,15901
20211012,경의선,능곡,3871,3580,7451
20211012,경의선,곡산,614,623,1237
20211012,경의선,백마,7030,6728,13758
20211012,경의선,풍산,5651,5218,10869
20211012,경의선,일산,9319,9134,18453
20211012,경의선,탄현,7660,7372,15032
20211012,경의선,야당,6893,6676,13569
20211012,경의선,운정,6943,6591,13534
20211012,경의선,금릉,4800,4769,9569
20211012,경의선,금촌,6349,6210,12559
20211012,경의선,월롱,2754,2702,5456
20211012,경의선,파주,1188,794,1982
20211012,경의선,문산,5135,5175,10310
20211012,경의선,임진강,21,5,26
20211012,경의선,계양,1,0,1
20211013,경의선,임진강,7,6,13
20211013,경의선,문산,5009,4992,10001
20211013,경의선,파주,1462,1033,2495
20211013,경의선,월롱,2668,2515,5183
20211013,경의선,금촌,6475,6440,12915
20211013,경의선,금릉,4794,4698,9492
20211013,경의선,운정,7082,6727,13809
20211013,경의선,야당,7186,6970,14156
20211013,경의선,탄현,7760,7398,15158
20211013,경의선,일산,10259,10263,20522
20211013,경의선,풍산,5592,5268,10860
20211013,경의선,백마,7143,7008,14151
20211013,경의선,곡산,595,636,1231
20211013,경의선,능곡,3923,3609,7532
20211013,경의선,행신,7854,7953,15807
20211013,경의선,강매,3285,2800,6085
20211013,경의선,화전,1806,1644,3450
20211013,경의선,수색,2799,2819,5618
20211013,경의선,디지털미디어시티,2481,2265,4746
20211013,경의선,가좌,5408,5102,10510
20211013,경의선,홍대입구,1692,1858,3550
20211013,경의선,서강대,2123,1957,4080
20211013,경의선,공덕,3428,3154,6582
20211013,경의선,효창공원앞,2942,3359,6301
20211013,경의선,신촌,845,1055,1900
20211013,경의선,서울,4285,5383,9668
20211014,경의선,임진강,16,8,24
20211014,경의선,문산,5392,5520,10912
20211014,경의선,파주,1549,1125,2674
20211014,경의선,월롱,2762,2580,5342
20211014,경의선,금촌,6302,6402,12704
20211014,경의선,금릉,4904,4798,9702
20211014,경의선,운정,6995,6520,13515
20211014,경의선,야당,7139,6952,14091
20211014,경의선,탄현,7781,7433,15214
20211014,경의선,일산,9286,9230,18516
20211014,경의선,풍산,5580,5381,10961
20211014,경의선,백마,6982,6792,13774
20211014,경의선,곡산,599,659,1258
20211014,경의선,능곡,3848,3546,7394
20211014,경의선,행신,7787,7798,15585
20211014,경의선,강매,3253,2793,6046
20211014,경의선,화전,1769,1676,3445
20211014,경의선,수색,2713,2844,5557
20211014,경의선,디지털미디어시티,2407,2276,4683
20211014,경의선,가좌,5304,4995,10299
20211014,경의선,홍대입구,1432,1559,2991
20211014,경의선,서강대,2060,1960,4020
20211014,경의선,공덕,3428,3233,6661
20211014,경의선,효창공원앞,3013,3408,6421
20211014,경의선,신촌,823,1048,1871
20211014,경의선,서울,4334,5429,9763
20211015,경의선,서울,4231,5414,9645
20211015,경의선,신촌,832,1046,1878
20211015,경의선,효창공원앞,2922,3321,6243
20211015,경의선,공덕,3292,3161,6453
20211015,경의선,서강대,2127,1998,4125
20211015,경의선,홍대입구,1671,1901,3572
20211015,경의선,가좌,5383,5161,10544
20211015,경의선,디지털미디어시티,2531,2379,4910
20211015,경의선,수색,2655,2712,5367
20211015,경의선,화전,1780,1605,3385
20211015,경의선,강매,3228,2736,5964
20211015,경의선,행신,8056,8183,16239
20211015,경의선,능곡,3827,3474,7301
20211015,경의선,곡산,614,645,1259
20211015,경의선,백마,7139,6826,13965
20211015,경의선,풍산,5612,5350,10962
20211015,경의선,일산,9098,9270,18368
20211015,경의선,탄현,7737,7390,15127
20211015,경의선,야당,7196,7198,14394
20211015,경의선,운정,6971,6750,13721
20211015,경의선,금릉,4875,4751,9626
20211015,경의선,금촌,6582,6502,13084
20211015,경의선,월롱,2815,2233,5048
20211015,경의선,파주,1383,835,2218
20211015,경의선,문산,5355,5205,10560
20211015,경의선,임진강,24,22,46
20211018,경의선,서울,3584,5160,8744
20211018,경의선,신촌,795,1021,1816
20211018,경의선,효창공원앞,2822,3163,5985
20211018,경의선,공덕,3485,3080,6565
20211018,경의선,서강대,1874,1859,3733
20211018,경의선,홍대입구,1325,1526,2851
20211018,경의선,가좌,5092,4942,10034
20211018,경의선,디지털미디어시티,2399,2247,4646
20211018,경의선,수색,2725,2795,5520
20211018,경의선,화전,1613,1503,3116
20211018,경의선,강매,3117,2735,5852
20211018,경의선,행신,7625,7729,15354
20211018,경의선,능곡,3714,3418,7132
20211018,경의선,곡산,650,649,1299
20211018,경의선,백마,6854,6657,13511
20211018,경의선,풍산,5513,5090,10603
20211018,경의선,일산,9721,9625,19346
20211018,경의선,탄현,7624,7103,14727
20211018,경의선,야당,6827,6468,13295
20211018,경의선,운정,6792,6450,13242
20211018,경의선,금릉,4544,4380,8924
20211018,경의선,금촌,6056,6140,12196
20211018,경의선,월롱,2608,2674,5282
20211018,경의선,파주,1670,1215,2885
20211018,경의선,문산,4683,4698,9381
20211018,경의선,임진강,14,6,20
20211018,경의선,서울,536,106,642
20211019,경의선,서울,4120,5244,9364
20211019,경의선,신촌,827,1090,1917
20211019,경의선,효창공원앞,2875,3310,6185
20211019,경의선,공덕,3422,3200,6622
20211019,경의선,서강대,1899,1865,3764
20211019,경의선,홍대입구,1414,1673,3087
20211019,경의선,가좌,5119,4937,10056
20211019,경의선,디지털미디어시티,2444,2321,4765
20211019,경의선,수색,2702,2816,5518
20211019,경의선,화전,1706,1614,3320
20211019,경의선,강매,3277,2808,6085
20211019,경의선,행신,7624,7738,15362
20211019,경의선,능곡,3825,3556,7381
20211019,경의선,곡산,596,603,1199
20211019,경의선,백마,7032,6738,13770
20211019,경의선,풍산,5599,5170,10769
20211019,경의선,일산,9158,9137,18295
20211019,경의선,탄현,7573,7259,14832
20211019,경의선,야당,7094,6657,13751
20211019,경의선,운정,6825,6484,13309
20211019,경의선,금릉,4793,4602,9395
20211019,경의선,금촌,6141,6253,12394
20211019,경의선,월롱,2751,2742,5493
20211019,경의선,파주,1706,1226,2932
20211019,경의선,문산,5018,4945,9963
20211019,경의선,임진강,3,11,14
20211020,경의선,서울,4538,5386,9924
20211020,경의선,신촌,874,1046,1920
20211020,경의선,효창공원앞,2881,3390,6271
20211020,경의선,공덕,3501,3264,6765
20211020,경의선,서강대,2003,1900,3903
20211020,경의선,홍대입구,1489,1746,3235
20211020,경의선,가좌,5415,5109,10524
20211020,경의선,디지털미디어시티,2537,2398,4935
20211020,경의선,수색,2656,2869,5525
20211020,경의선,화전,1823,1691,3514
20211020,경의선,강매,3324,2845,6169
20211020,경의선,행신,7753,7936,15689
20211020,경의선,능곡,3865,3553,7418
20211020,경의선,곡산,610,658,1268
20211020,경의선,백마,6991,6845,13836
20211020,경의선,풍산,5619,5285,10904
20211020,경의선,일산,9288,9337,18625
20211020,경의선,탄현,7663,7457,15120
20211020,경의선,야당,7085,6955,14040
20211020,경의선,운정,6986,6650,13636
20211020,경의선,금릉,4792,4668,9460
20211020,경의선,금촌,6257,6384,12641
20211020,경의선,월롱,2877,2657,5534
20211020,경의선,파주,1654,1190,2844
20211020,경의선,문산,4927,5069,9996
20211020,경의선,임진강,9,11,20
20211021,경의선,서울,4188,5403,9591
20211021,경의선,신촌,838,1030,1868
20211021,경의선,효창공원앞,2857,3295,6152
20211021,경의선,공덕,3518,3263,6781
20211021,경의선,서강대,2025,1978,4003
20211021,경의선,홍대입구,1516,1776,3292
20211021,경의선,가좌,5410,5123,10533
20211021,경의선,디지털미디어시티,2462,2336,4798
20211021,경의선,수색,2811,2970,5781
20211021,경의선,화전,1823,1705,3528
20211021,경의선,강매,3278,2779,6057
20211021,경의선,행신,7716,7874,15590
20211021,경의선,능곡,3911,3589,7500
20211021,경의선,곡산,621,663,1284
20211021,경의선,백마,7147,6806,13953
20211021,경의선,풍산,5632,5263,10895
20211021,경의선,일산,9276,9315,18591
20211021,경의선,탄현,7898,7511,15409
20211021,경의선,야당,7287,6988,14275
20211021,경의선,운정,7106,6774,13880
20211021,경의선,금릉,4717,4593,9310
20211021,경의선,금촌,6592,6711,13303
20211021,경의선,월롱,2710,2589,5299
20211021,경의선,파주,1713,1248,2961
20211021,경의선,문산,4907,5042,9949
20211021,경의선,임진강,8,15,23
20211021,경의선,계양,1,0,1
20211022,경의선,임진강,18,11,29
20211022,경의선,문산,5271,5332,10603
20211022,경의선,파주,1521,1018,2539
20211022,경의선,월롱,2794,2251,5045
20211022,경의선,금촌,6722,6696,13418
20211022,경의선,금릉,4926,4814,9740
20211022,경의선,운정,7109,6859,13968
20211022,경의선,야당,7456,7336,14792
20211022,경의선,탄현,7803,7543,15346
20211022,경의선,일산,9291,9406,18697
20211022,경의선,풍산,5689,5329,11018
20211022,경의선,백마,7051,6784,13835
20211022,경의선,곡산,648,679,1327
20211022,경의선,능곡,3965,3631,7596
20211022,경의선,행신,8109,8215,16324
20211022,경의선,강매,3214,2790,6004
20211022,경의선,화전,1872,1696,3568
20211022,경의선,수색,2755,2758,5513
20211022,경의선,디지털미디어시티,2587,2398,4985
20211022,경의선,가좌,5537,5138,10675
20211022,경의선,홍대입구,1717,2131,3848
20211022,경의선,서강대,2061,2021,4082
20211022,경의선,공덕,3478,3355,6833
20211022,경의선,효창공원앞,2839,3244,6083
20211022,경의선,신촌,817,1013,1830
20211022,경의선,서울,4237,5607,9844
20211025,경의선,서울,4356,5405,9761
20211025,경의선,신촌,824,1035,1859
20211025,경의선,효창공원앞,2798,3240,6038
20211025,경의선,공덕,3499,3246,6745
20211025,경의선,서강대,2072,1954,4026
20211025,경의선,홍대입구,1488,1627,3115
20211025,경의선,가좌,5563,5117,10680
20211025,경의선,디지털미디어시티,2498,2299,4797
20211025,경의선,수색,2856,2911,5767
20211025,경의선,화전,1703,1600,3303
20211025,경의선,강매,3254,2792,6046
20211025,경의선,행신,7879,7975,15854
20211025,경의선,능곡,3868,3550,7418
20211025,경의선,곡산,613,597,1210
20211025,경의선,백마,7102,6792,13894
20211025,경의선,풍산,5589,5203,10792
20211025,경의선,일산,9404,9254,18658
20211025,경의선,탄현,7815,7522,15337
20211025,경의선,야당,7178,6782,13960
20211025,경의선,운정,7088,6627,13715
20211025,경의선,금릉,4837,4669,9506
20211025,경의선,금촌,6365,6342,12707
20211025,경의선,월롱,2608,2687,5295
20211025,경의선,파주,1719,1307,3026
20211025,경의선,문산,5102,4986,10088
20211025,경의선,임진강,11,9,20
20211025,경의선,계양,2,0,2
20211026,경의선,임진강,15,19,34
20211026,경의선,문산,5108,5132,10240
20211026,경의선,파주,1623,1190,2813
20211026,경의선,월롱,2799,2689,5488
20211026,경의선,금촌,6946,6926,13872
20211026,경의선,금릉,4710,4693,9403
20211026,경의선,운정,7228,6957,14185
20211026,경의선,야당,7207,6943,14150
20211026,경의선,탄현,8112,7593,15705
20211026,경의선,일산,9527,9441,18968
20211026,경의선,풍산,5823,5351,11174
20211026,경의선,백마,7310,6916,14226
20211026,경의선,곡산,635,645,1280
20211026,경의선,능곡,3861,3634,7495
20211026,경의선,행신,7888,7973,15861
20211026,경의선,강매,3262,2880,6142
20211026,경의선,화전,1872,1738,3610
20211026,경의선,수색,2852,2947,5799
20211026,경의선,디지털미디어시티,2495,2376,4871
20211026,경의선,가좌,5614,5270,10884
20211026,경의선,홍대입구,1504,1778,3282
20211026,경의선,서강대,2114,2010,4124
20211026,경의선,공덕,3464,3207,6671
20211026,경의선,효창공원앞,2880,3324,6204
20211026,경의선,신촌,818,1027,1845
20211026,경의선,서울,4396,5609,10005
20211027,경의선,임진강,5,8,13
20211027,경의선,문산,5045,4884,9929
20211027,경의선,파주,1543,1107,2650
20211027,경의선,월롱,2756,2616,5372
20211027,경의선,금촌,6306,6451,12757
20211027,경의선,금릉,4897,4707,9604
20211027,경의선,운정,7030,6652,13682
20211027,경의선,야당,7344,7102,14446
20211027,경의선,탄현,7963,7584,15547
20211027,경의선,일산,9523,9474,18997
20211027,경의선,풍산,5676,5332,11008
20211027,경의선,백마,7244,6865,14109
20211027,경의선,곡산,644,702,1346
20211027,경의선,능곡,3962,3648,7610
20211027,경의선,행신,7999,7983,15982
20211027,경의선,강매,3290,2866,6156
20211027,경의선,화전,1852,1734,3586
20211027,경의선,수색,2808,2928,5736
20211027,경의선,디지털미디어시티,2519,2301,4820
20211027,경의선,가좌,5401,5170,10571
20211027,경의선,홍대입구,1577,1805,3382
20211027,경의선,서강대,2136,1942,4078
20211027,경의선,공덕,3651,3324,6975
20211027,경의선,효창공원앞,2913,3388,6301
20211027,경의선,신촌,888,1102,1990
20211027,경의선,서울,4224,5517,9741
20211028,경의선,임진강,11,4,15
20211028,경의선,문산,4844,4926,9770
20211028,경의선,파주,1539,1145,2684
20211028,경의선,월롱,2733,2600,5333
20211028,경의선,금촌,6403,6360,12763
20211028,경의선,금릉,4823,4805,9628
20211028,경의선,운정,7002,6765,13767
20211028,경의선,야당,7411,7143,14554
20211028,경의선,탄현,7976,7558,15534
20211028,경의선,일산,10741,10724,21465
20211028,경의선,풍산,5861,5545,11406
20211028,경의선,백마,7192,7004,14196
20211028,경의선,곡산,651,700,1351
20211028,경의선,능곡,3928,3597,7525
20211028,경의선,행신,8132,8062,16194
20211028,경의선,강매,3299,2891,6190
20211028,경의선,화전,1824,1686,3510
20211028,경의선,수색,2827,2948,5775
20211028,경의선,디지털미디어시티,2501,2341,4842
20211028,경의선,가좌,5467,5250,10717
20211028,경의선,홍대입구,1642,1821,3463
20211028,경의선,서강대,2162,2034,4196
20211028,경의선,공덕,3604,3355,6959
20211028,경의선,효창공원앞,2979,3376,6355
20211028,경의선,신촌,865,1107,1972
20211028,경의선,서울,4297,5738,10035
20211028,경의선,계양,1,0,1
20211029,경의선,임진강,15,13,28
20211029,경의선,문산,5605,5638,11243
20211029,경의선,파주,1422,940,2362
20211029,경의선,월롱,2894,2266,5160
20211029,경의선,금촌,6705,6620,13325
20211029,경의선,금릉,5054,4931,9985
20211029,경의선,운정,7051,6822,13873
20211029,경의선,야당,7548,7472,15020
20211029,경의선,탄현,8053,7657,15710
20211029,경의선,일산,9518,9557,19075
20211029,경의선,풍산,5897,5596,11493
20211029,경의선,백마,7070,6876,13946
20211029,경의선,곡산,683,694,1377
20211029,경의선,능곡,3852,3577,7429
20211029,경의선,행신,8213,8356,16569
20211029,경의선,강매,3239,2828,6067
20211029,경의선,화전,1851,1626,3477
20211029,경의선,수색,2731,2775,5506
20211029,경의선,디지털미디어시티,2611,2453,5064
20211029,경의선,가좌,5606,5301,10907
20211029,경의선,홍대입구,1826,2110,3936
20211029,경의선,서강대,2268,2126,4394
20211029,경의선,공덕,3693,3364,7057
20211029,경의선,효창공원앞,2892,3466,6358
20211029,경의선,신촌,890,1138,2028
20211029,경의선,서울,4381,5720,10101
20211029,경의선,검암,1,0,1
20211101,경의선,계양,2,0,2
20211101,경의선,임진강,16,6,22
20211101,경의선,문산,5053,4955,10008
20211101,경의선,파주,1697,1194,2891
20211101,경의선,월롱,2676,2766,5442
20211101,경의선,금촌,6846,6856,13702
20211101,경의선,금릉,4780,4606,9386
20211101,경의선,운정,7254,6654,13908
20211101,경의선,야당,7165,6947,14112
20211101,경의선,탄현,7974,7420,15394
20211101,경의선,일산,9635,9293,18928
20211101,경의선,풍산,5621,5320,10941
20211101,경의선,백마,7200,6661,13861
20211101,경의선,곡산,628,659,1287
20211101,경의선,능곡,3894,3578,7472
20211101,경의선,행신,8100,8019,16119
20211101,경의선,강매,3315,2877,6192
20211101,경의선,화전,1906,1783,3689
20211101,경의선,수색,2874,2947,5821
20211101,경의선,디지털미디어시티,2546,2323,4869
20211101,경의선,가좌,5567,5195,10762
20211101,경의선,홍대입구,1477,1686,3163
20211101,경의선,서강대,2118,2004,4122
20211101,경의선,공덕,3447,3267,6714
20211101,경의선,효창공원앞,2894,3316,6210
20211101,경의선,신촌,874,1075,1949
20211101,경의선,서울,4438,5635,10073
20211102,경의선,임진강,21,19,40
20211102,경의선,문산,5071,4925,9996
20211102,경의선,파주,1643,1205,2848
20211102,경의선,월롱,2769,2677,5446
20211102,경의선,금촌,6481,6376,12857
20211102,경의선,금릉,4914,4616,9530
20211102,경의선,운정,7141,6843,13984
20211102,경의선,야당,7289,7076,14365
20211102,경의선,탄현,8018,7564,15582
20211102,경의선,일산,9754,9606,19360
20211102,경의선,풍산,5931,5433,11364
20211102,경의선,백마,7419,7102,14521
20211102,경의선,곡산,650,698,1348
20211102,경의선,능곡,3957,3676,7633
20211102,경의선,행신,8082,8170,16252
20211102,경의선,서울,4472,5791,10263
20211102,경의선,신촌,830,1112,1942
20211102,경의선,효창공원앞,2891,3346,6237
20211102,경의선,공덕,3582,3359,6941
20211102,경의선,서강대,2162,2108,4270
20211102,경의선,홍대입구,1573,1789,3362
20211102,경의선,가좌,5545,5180,10725
20211102,경의선,디지털미디어시티,2614,2340,4954
20211102,경의선,수색,2875,3013,5888
20211102,경의선,화전,1978,1842,3820
20211102,경의선,강매,3384,2932,6316
20211103,경의선,신촌,881,1131,2012
20211103,경의선,서울,4486,5640,10126
20211103,경의선,임진강,11,11,22
20211103,경의선,문산,5022,4847,9869
20211103,경의선,파주,1524,1070,2594
20211103,경의선,월롱,2782,2643,5425
20211103,경의선,금촌,6373,6385,12758
20211103,경의선,금릉,4986,4819,9805
20211103,경의선,운정,7289,6817,14106
20211103,경의선,야당,7546,7339,14885
20211103,경의선,탄현,8112,7698,15810
20211103,경의선,일산,10854,10656,21510
20211103,경의선,풍산,5838,5439,11277
20211103,경의선,백마,7373,6966,14339
20211103,경의선,곡산,659,649,1308
20211103,경의선,능곡,4045,3717,7762
20211103,경의선,행신,8092,8120,16212
20211103,경의선,강매,3460,2958,6418
20211103,경의선,화전,1949,1818,3767
20211103,경의선,수색,2891,2930,5821
20211103,경의선,디지털미디어시티,2688,2461,5149
20211103,경의선,가좌,5629,5347,10976
20211103,경의선,홍대입구,1623,1929,3552
20211103,경의선,서강대,2135,2144,4279
20211103,경의선,공덕,3526,3382,6908
20211103,경의선,효창공원앞,2995,3355,6350
20211104,경의선,임진강,10,8,18
20211104,경의선,문산,5484,5529,11013
20211104,경의선,파주,1614,1174,2788
20211104,경의선,월롱,2744,2547,5291
20211104,경의선,금촌,6456,6303,12759
20211104,경의선,금릉,4944,4816,9760
20211104,경의선,운정,7026,6639,13665
20211104,경의선,야당,7426,7258,14684
20211104,경의선,탄현,8052,7536,15588
20211104,경의선,일산,9591,9441,19032
20211104,경의선,풍산,5935,5446,11381
20211104,경의선,백마,7321,6994,14315
20211104,경의선,곡산,660,684,1344
20211104,경의선,능곡,3897,3556,7453
20211104,경의선,행신,8154,8097,16251
20211104,경의선,강매,3441,2939,6380
20211104,경의선,화전,1871,1752,3623
20211104,경의선,수색,2893,2992,5885
20211104,경의선,디지털미디어시티,2558,2404,4962
20211104,경의선,가좌,5484,5246,10730
20211104,경의선,홍대입구,1578,1864,3442
20211104,경의선,서강대,2176,2156,4332
20211104,경의선,공덕,3650,3372,7022
20211104,경의선,효창공원앞,2999,3341,6340
20211104,경의선,신촌,876,1086,1962
20211104,경의선,서울,4531,5842,10373
20211105,경의선,강매,3408,2906,6314
20211105,경의선,화전,2060,1800,3860
20211105,경의선,수색,2837,2851,5688
20211105,경의선,디지털미디어시티,2734,2495,5229
20211105,경의선,가좌,5641,5286,10927
20211105,경의선,홍대입구,1816,2241,4057
20211105,경의선,서강대,2275,2184,4459
20211105,경의선,공덕,3725,3331,7056
20211105,경의선,효창공원앞,2968,3455,6423
20211105,경의선,신촌,890,1135,2025
20211105,경의선,서울,4588,5960,10548
20211105,경의선,야당,7602,7652,15254
20211105,경의선,탄현,8240,7799,16039
20211105,경의선,일산,9804,9721,19525
20211105,경의선,풍산,6039,5699,11738
20211105,경의선,백마,7499,7036,14535
20211105,경의선,곡산,684,698,1382
20211105,경의선,능곡,4075,3739,7814
20211105,경의선,행신,8475,8458,16933
20211105,경의선,운정,7329,6848,14177
20211105,경의선,임진강,22,17,39
20211105,경의선,문산,5331,5281,10612
20211105,경의선,파주,1446,988,2434
20211105,경의선,월롱,2925,2194,5119
20211105,경의선,금촌,6911,6826,13737
20211105,경의선,금릉,5028,4877,9905
20211108,경의선,서울,4202,5280,9482
20211108,경의선,신촌,820,1037,1857
20211108,경의선,효창공원앞,2842,3240,6082
20211108,경의선,공덕,3397,3025,6422
20211108,경의선,서강대,2073,1980,4053
20211108,경의선,홍대입구,1279,1483,2762
20211108,경의선,가좌,5129,4841,9970
20211108,경의선,디지털미디어시티,2371,2175,4546
20211108,경의선,수색,2750,2849,5599
20211108,경의선,화전,1677,1563,3240
20211108,경의선,강매,3064,2616,5680
20211108,경의선,행신,7616,7732,15348
20211108,경의선,능곡,3592,3290,6882
20211108,경의선,곡산,536,561,1097
20211108,경의선,백마,6819,6426,13245
20211108,경의선,풍산,5360,4994,10354
20211108,경의선,일산,9203,9062,18265
20211108,경의선,탄현,7533,7090,14623
20211108,경의선,야당,6511,6246,12757
20211108,경의선,운정,6575,6174,12749
20211108,경의선,금릉,4331,4177,8508
20211108,경의선,금촌,5767,5607,11374
20211108,경의선,월롱,2557,2562,5119
20211108,경의선,파주,1479,1092,2571
20211108,경의선,문산,4510,4319,8829
20211108,경의선,임진강,2,1,3
20211109,경의선,서울,4346,5475,9821
20211109,경의선,신촌,859,1149,2008
20211109,경의선,효창공원앞,2958,3428,6386
20211109,경의선,공덕,3568,3260,6828
20211109,경의선,서강대,2101,2055,4156
20211109,경의선,홍대입구,1420,1645,3065
20211109,경의선,가좌,5349,4960,10309
20211109,경의선,디지털미디어시티,2509,2242,4751
20211109,경의선,수색,2778,3003,5781
20211109,경의선,화전,1861,1755,3616
20211109,경의선,강매,3288,2819,6107
20211109,경의선,행신,7846,7840,15686
20211109,경의선,능곡,3726,3412,7138
20211109,경의선,곡산,634,628,1262
20211109,경의선,백마,7077,6741,13818
20211109,경의선,풍산,5645,5186,10831
20211109,경의선,일산,9149,8890,18039
20211109,경의선,탄현,7834,7443,15277
20211109,경의선,야당,6913,6665,13578
20211109,경의선,운정,6861,6375,13236
20211109,경의선,금릉,4665,4483,9148
20211109,경의선,금촌,6068,6201,12269
20211109,경의선,월롱,2724,2629,5353
20211109,경의선,파주,1562,1172,2734
20211109,경의선,문산,4932,5044,9976
20211109,경의선,임진강,7,2,9
20211110,경의선,서울,4405,5499,9904
20211110,경의선,신촌,851,1070,1921
20211110,경의선,효창공원앞,3009,3446,6455
20211110,경의선,공덕,3642,3299,6941
20211110,경의선,서강대,2150,2052,4202
20211110,경의선,홍대입구,1577,1814,3391
20211110,경의선,가좌,5587,5260,10847
20211110,경의선,디지털미디어시티,2628,2443,5071
20211110,경의선,수색,2853,2983,5836
20211110,경의선,화전,1977,1785,3762
20211110,경의선,강매,3309,2883,6192
20211110,경의선,행신,8106,8168,16274
20211110,경의선,능곡,3965,3596,7561
20211110,경의선,곡산,593,641,1234
20211110,경의선,백마,7197,6899,14096
20211110,경의선,풍산,5540,5197,10737
20211110,경의선,일산,9461,9371,18832
20211110,경의선,탄현,7949,7551,15500
20211110,경의선,야당,7227,7054,14281
20211110,경의선,운정,7110,6691,13801
20211110,경의선,금릉,4813,4657,9470
20211110,경의선,금촌,6208,6305,12513
20211110,경의선,월롱,2842,2571,5413
20211110,경의선,파주,1533,1136,2669
20211110,경의선,문산,4939,4753,9692
20211110,경의선,임진강,7,2,9
20211111,경의선,서울,4636,5816,10452
20211111,경의선,신촌,885,1096,1981
20211111,경의선,효창공원앞,2981,3392,6373
20211111,경의선,공덕,3781,3399,7180
20211111,경의선,서강대,2160,2133,4293
20211111,경의선,홍대입구,1587,1862,3449
20211111,경의선,가좌,5605,5356,10961
20211111,경의선,디지털미디어시티,2690,2466,5156
20211111,경의선,수색,2975,3128,6103
20211111,경의선,화전,1970,1875,3845
20211111,경의선,강매,3322,2842,6164
20211111,경의선,행신,8196,8088,16284
20211111,경의선,능곡,3890,3491,7381
20211111,경의선,곡산,612,677,1289
20211111,경의선,백마,7243,6864,14107
20211111,경의선,풍산,5891,5470,11361
20211111,경의선,일산,9294,9185,18479
20211111,경의선,탄현,8049,7619,15668
20211111,경의선,야당,7257,7021,14278
20211111,경의선,운정,7117,6568,13685
20211111,경의선,금릉,4768,4588,9356
20211111,경의선,금촌,6652,6665,13317
20211111,경의선,월롱,2814,2558,5372
20211111,경의선,파주,1403,1115,2518
20211111,경의선,문산,5001,5153,10154
20211111,경의선,임진강,9,22,31
20211112,경의선,서울,3245,5702,8947
20211112,경의선,신촌,891,1148,2039
20211112,경의선,효창공원앞,3033,3369,6402
20211112,경의선,공덕,3763,3317,7080
20211112,경의선,서강대,2216,2172,4388
20211112,경의선,홍대입구,1801,2199,4000
20211112,경의선,가좌,5651,5297,10948
20211112,경의선,디지털미디어시티,2745,2432,5177
20211112,경의선,수색,2795,2923,5718
20211112,경의선,화전,2075,1856,3931
20211112,경의선,강매,3310,2833,6143
20211112,경의선,행신,8506,8590,17096
20211112,경의선,능곡,3920,3612,7532
20211112,경의선,곡산,629,654,1283
20211112,경의선,백마,7459,6814,14273
20211112,경의선,풍산,5745,5556,11301
20211112,경의선,일산,9414,9305,18719
20211112,경의선,탄현,8097,7670,15767
20211112,경의선,야당,7482,7541,15023
20211112,경의선,운정,7046,6673,13719
20211112,경의선,금릉,4888,4727,9615
20211112,경의선,금촌,6603,6441,13044
20211112,경의선,월롱,2888,2126,5014
20211112,경의선,파주,1146,840,1986
20211112,경의선,문산,5308,5108,10416
20211112,경의선,임진강,5,8,13
20211112,경의선,서울,1195,296,1491
20211115,경의선,수색,2947,3100,6047
20211115,경의선,서울,4473,5594,10067
20211115,경의선,신촌,853,1061,1914
20211115,경의선,효창공원앞,2977,3306,6283
20211115,경의선,공덕,3495,3208,6703
20211115,경의선,서강대,2129,2124,4253
20211115,경의선,홍대입구,1505,1700,3205
20211115,경의선,가좌,5387,5164,10551
20211115,경의선,디지털미디어시티,2500,2356,4856
20211115,경의선,화전,1880,1745,3625
20211115,경의선,강매,3289,2820,6109
20211115,경의선,행신,8109,8147,16256
20211115,경의선,능곡,3801,3454,7255
20211115,경의선,곡산,610,621,1231
20211115,경의선,백마,7190,6769,13959
20211115,경의선,풍산,5734,5183,10917
20211115,경의선,일산,9340,9129,18469
20211115,경의선,탄현,7893,7376,15269
20211115,경의선,야당,6988,6679,13667
20211115,경의선,운정,7194,6571,13765
20211115,경의선,금릉,4774,4549,9323
20211115,경의선,금촌,6401,6232,12633
20211115,경의선,월롱,2678,2592,5270
20211115,경의선,파주,1402,1176,2578
20211115,경의선,문산,4965,4773,9738
20211115,경의선,임진강,10,8,18
20211116,경의선,서울,4514,5677,10191
20211116,경의선,신촌,894,1106,2000
20211116,경의선,효창공원앞,2934,3377,6311
20211116,경의선,공덕,3659,3295,6954
20211116,경의선,서강대,2122,2101,4223
20211116,경의선,홍대입구,1481,1772,3253
20211116,경의선,가좌,5393,5138,10531
20211116,경의선,디지털미디어시티,2610,2414,5024
20211116,경의선,수색,3008,3153,6161
20211116,경의선,화전,2032,1820,3852
20211116,경의선,강매,3455,3002,6457
20211116,경의선,행신,8130,8014,16144
20211116,경의선,능곡,3853,3677,7530
20211116,경의선,곡산,635,654,1289
20211116,경의선,백마,7134,6900,14034
20211116,경의선,풍산,5738,5350,11088
20211116,경의선,일산,9454,9299,18753
20211116,경의선,탄현,8125,7522,15647
20211116,경의선,야당,7281,6940,14221
20211116,경의선,운정,7300,6757,14057
20211116,경의선,금릉,4868,4635,9503
20211116,경의선,금촌,6761,6661,13422
20211116,경의선,월롱,2791,2743,5534
20211116,경의선,파주,1411,1115,2526
20211116,경의선,문산,5049,5053,10102
20211116,경의선,임진강,17,16,33
20211117,경의선,김포공항,1,0,1
20211117,경의선,임진강,19,3,22
20211117,경의선,문산,5087,4920,10007
20211117,경의선,파주,1426,1064,2490
20211117,경의선,월롱,2865,2637,5502
20211117,경의선,금촌,6539,6397,12936
20211117,경의선,금릉,4958,4714,9672
20211117,경의선,운정,7202,6697,13899
20211117,경의선,야당,7530,7271,14801
20211117,경의선,탄현,8102,7667,15769
20211117,경의선,일산,9386,9279,18665
20211117,경의선,풍산,5845,5431,11276
20211117,경의선,백마,7270,6915,14185
20211117,경의선,곡산,636,678,1314
20211117,경의선,능곡,4006,3617,7623
20211117,경의선,행신,8233,8097,16330
20211117,경의선,서울,4397,5827,10224
20211117,경의선,신촌,910,1159,2069
20211117,경의선,효창공원앞,2968,3373,6341
20211117,경의선,공덕,3826,3393,7219
20211117,경의선,서강대,2106,2119,4225
20211117,경의선,홍대입구,1539,1812,3351
20211117,경의선,가좌,5416,5143,10559
20211117,경의선,디지털미디어시티,2602,2374,4976
20211117,경의선,수색,2979,3081,6060
20211117,경의선,화전,1942,1758,3700
20211117,경의선,강매,3360,2888,6248
20211118,경의선,임진강,15,7,22
20211118,경의선,문산,4944,5051,9995
20211118,경의선,파주,1363,1118,2481
20211118,경의선,월롱,2763,2470,5233
20211118,경의선,금촌,6250,6167,12417
20211118,경의선,금릉,4999,4832,9831
20211118,경의선,운정,7140,6624,13764
20211118,경의선,야당,7394,7175,14569
20211118,경의선,탄현,8104,7749,15853
20211118,경의선,일산,10182,10076,20258
20211118,경의선,풍산,5936,5468,11404
20211118,경의선,백마,7215,6926,14141
20211118,경의선,곡산,634,679,1313
20211118,경의선,능곡,3785,3486,7271
20211118,경의선,행신,8074,8110,16184
20211118,경의선,강매,3370,2870,6240
20211118,경의선,화전,1867,1710,3577
20211118,경의선,수색,2890,2981,5871
20211118,경의선,디지털미디어시티,2612,2384,4996
20211118,경의선,가좌,5457,5127,10584
20211118,경의선,홍대입구,1677,1947,3624
20211118,경의선,서강대,2107,2077,4184
20211118,경의선,공덕,3548,3277,6825
20211118,경의선,효창공원앞,2976,3348,6324
20211118,경의선,신촌,933,1111,2044
20211118,경의선,서울,4483,5745,10228
20211118,경의선,검암,1,0,1
20211119,경의선,서울,4607,5926,10533
20211119,경의선,신촌,960,1143,2103
20211119,경의선,효창공원앞,2892,3290,6182
20211119,경의선,공덕,3814,3469,7283
20211119,경의선,서강대,2237,2311,4548
20211119,경의선,홍대입구,1910,2238,4148
20211119,경의선,가좌,5588,5350,10938
20211119,경의선,디지털미디어시티,2778,2528,5306
20211119,경의선,수색,2837,2901,5738
20211119,경의선,화전,1977,1750,3727
20211119,경의선,강매,3271,2784,6055
20211119,경의선,행신,8639,8687,17326
20211119,경의선,능곡,3940,3616,7556
20211119,경의선,곡산,647,688,1335
20211119,경의선,백마,7435,6934,14369
20211119,경의선,풍산,5803,5499,11302
20211119,경의선,일산,9614,9381,18995
20211119,경의선,탄현,8171,7662,15833
20211119,경의선,야당,7530,7612,15142
20211119,경의선,운정,7396,6809,14205
20211119,경의선,금릉,5067,4851,9918
20211119,경의선,금촌,6870,6741,13611
20211119,경의선,월롱,2979,2255,5234
20211119,경의선,파주,1360,897,2257
20211119,경의선,문산,5851,5641,11492
20211119,경의선,임진강,20,53,73
20211122,경의선,서울,4392,5518,9910
20211122,경의선,신촌,855,1091,1946
20211122,경의선,효창공원앞,2956,3323,6279
20211122,경의선,공덕,3680,3221,6901
20211122,경의선,서강대,2099,2076,4175
20211122,경의선,홍대입구,1488,1789,3277
20211122,경의선,가좌,5307,5070,10377
20211122,경의선,디지털미디어시티,2526,2243,4769
20211122,경의선,수색,2810,2947,5757
20211122,경의선,화전,1825,1719,3544
20211122,경의선,강매,3210,2748,5958
20211122,경의선,행신,7852,8022,15874
20211122,경의선,능곡,3854,3523,7377
20211122,경의선,곡산,598,614,1212
20211122,경의선,백마,7073,6640,13713
20211122,경의선,풍산,5581,5084,10665
20211122,경의선,일산,9431,9197,18628
20211122,경의선,탄현,7889,7452,15341
20211122,경의선,야당,7184,6822,14006
20211122,경의선,운정,7105,6638,13743
20211122,경의선,금릉,4837,4539,9376
20211122,경의선,금촌,6299,6322,12621
20211122,경의선,월롱,2734,2743,5477
20211122,경의선,파주,1673,1150,2823
20211122,경의선,문산,4893,4877,9770
20211122,경의선,임진강,4,10,14
20211122,경의선,계양,1,0,1
20211123,경의선,임진강,11,8,19
20211123,경의선,문산,4805,4906,9711
20211123,경의선,파주,1624,1223,2847
20211123,경의선,월롱,2721,2701,5422
20211123,경의선,금촌,6234,6216,12450
20211123,경의선,금릉,4744,4578,9322
20211123,경의선,운정,7226,6781,14007
20211123,경의선,야당,7274,7013,14287
20211123,경의선,탄현,7966,7426,15392
20211123,경의선,일산,10086,10018,20104
20211123,경의선,풍산,5649,5274,10923
20211123,경의선,백마,7127,6916,14043
20211123,경의선,곡산,625,638,1263
20211123,경의선,능곡,3843,3475,7318
20211123,경의선,행신,7944,8136,16080
20211123,경의선,강매,3360,2845,6205
20211123,경의선,화전,1927,1763,3690
20211123,경의선,수색,2860,3004,5864
20211123,경의선,디지털미디어시티,2588,2412,5000
20211123,경의선,가좌,5424,5058,10482
20211123,경의선,홍대입구,1546,1827,3373
20211123,경의선,서강대,2092,2048,4140
20211123,경의선,공덕,3572,3193,6765
20211123,경의선,효창공원앞,2975,3524,6499
20211123,경의선,신촌,878,1157,2035
20211123,경의선,서울,4462,5569,10031
20211124,경의선,임진강,5,14,19
20211124,경의선,문산,5213,5139,10352
20211124,경의선,파주,1447,1007,2454
20211124,경의선,월롱,2817,2603,5420
20211124,경의선,금촌,6511,6350,12861
20211124,경의선,금릉,4832,4755,9587
20211124,경의선,야당,7374,7173,14547
20211124,경의선,탄현,7962,7476,15438
20211124,경의선,일산,9479,9317,18796
20211124,경의선,풍산,5635,5147,10782
20211124,경의선,백마,6943,6677,13620
20211124,경의선,곡산,620,677,1297
20211124,경의선,능곡,3920,3641,7561
20211124,경의선,행신,8194,8085,16279
20211124,경의선,강매,3295,2826,6121
20211124,경의선,화전,1907,1699,3606
20211124,경의선,수색,2828,2933,5761
20211124,경의선,디지털미디어시티,2521,2417,4938
20211124,경의선,가좌,5409,5164,10573
20211124,경의선,홍대입구,1610,1925,3535
20211124,경의선,서강대,2118,2058,4176
20211124,경의선,공덕,3631,3326,6957
20211124,경의선,효창공원앞,2948,3334,6282
20211124,경의선,신촌,924,1124,2048
20211124,경의선,서울,4399,5646,10045
20211124,경의선,운정,7188,6791,13979
20211125,경의선,서울,4518,5677,10195
20211125,경의선,신촌,906,1108,2014
20211125,경의선,효창공원앞,3046,3470,6516
20211125,경의선,공덕,3637,3254,6891
20211125,경의선,서강대,2117,2110,4227
20211125,경의선,홍대입구,1600,1970,3570
20211125,경의선,가좌,5509,5195,10704
20211125,경의선,디지털미디어시티,2610,2397,5007
20211125,경의선,수색,2817,3020,5837
20211125,경의선,화전,1781,1669,3450
20211125,경의선,강매,3328,2836,6164
20211125,경의선,행신,8162,8163,16325
20211125,경의선,능곡,3842,3556,7398
20211125,경의선,곡산,615,653,1268
20211125,경의선,백마,7159,6823,13982
20211125,경의선,풍산,5882,5327,11209
20211125,경의선,일산,9672,9454,19126
20211125,경의선,탄현,8098,7639,15737
20211125,경의선,야당,7480,7333,14813
20211125,경의선,운정,7255,6844,14099
20211125,경의선,금릉,4887,4868,9755
20211125,경의선,금촌,6481,6449,12930
20211125,경의선,월롱,2899,2660,5559
20211125,경의선,파주,1510,1069,2579
20211125,경의선,문산,4964,5038,10002
20211125,경의선,임진강,5,2,7
20211126,경의선,서울,4634,5990,10624
20211126,경의선,신촌,975,1143,2118
20211126,경의선,효창공원앞,3013,3449,6462
20211126,경의선,공덕,3747,3473,7220
20211126,경의선,서강대,2243,2213,4456
20211126,경의선,홍대입구,1747,2208,3955
20211126,경의선,가좌,5625,5237,10862
20211126,경의선,디지털미디어시티,2694,2497,5191
20211126,경의선,수색,2762,2834,5596
20211126,경의선,화전,1852,1643,3495
20211126,경의선,강매,3336,2776,6112
20211126,경의선,행신,8576,8503,17079
20211126,경의선,능곡,4045,3659,7704
20211126,경의선,곡산,611,619,1230
20211126,경의선,백마,7238,6883,14121
20211126,경의선,풍산,5838,5482,11320
20211126,경의선,일산,9636,9607,19243
20211126,경의선,탄현,8139,7553,15692
20211126,경의선,야당,7607,7740,15347
20211126,경의선,운정,7573,7136,14709
20211126,경의선,금릉,5196,4877,10073
20211126,경의선,금촌,7224,7069,14293
20211126,경의선,월롱,2854,2194,5048
20211126,경의선,파주,1374,901,2275
20211126,경의선,문산,6942,6720,13662
20211126,경의선,임진강,9,30,39
20211129,경의선,서울,4508,5673,10181
20211129,경의선,신촌,853,1051,1904
20211129,경의선,효창공원앞,2915,3306,6221
20211129,경의선,공덕,3543,3335,6878
20211129,경의선,서강대,2132,2041,4173
20211129,경의선,홍대입구,1467,1759,3226
20211129,경의선,가좌,5407,5017,10424
20211129,경의선,디지털미디어시티,2561,2318,4879
20211129,경의선,수색,2835,2999,5834
20211129,경의선,화전,1874,1699,3573
20211129,경의선,강매,3281,2853,6134
20211129,경의선,행신,8072,8097,16169
20211129,경의선,능곡,3831,3465,7296
20211129,경의선,곡산,607,592,1199
20211129,경의선,백마,7050,6732,13782
20211129,경의선,풍산,5560,5110,10670
20211129,경의선,일산,9537,9401,18938
20211129,경의선,탄현,7985,7462,15447
20211129,경의선,야당,7162,6896,14058
20211129,경의선,운정,7330,6780,14110
20211129,경의선,금릉,4930,4764,9694
20211129,경의선,금촌,6395,6314,12709
20211129,경의선,월롱,2705,2706,5411
20211129,경의선,파주,1662,1211,2873
20211129,경의선,문산,5322,5185,10507
20211129,경의선,임진강,9,7,16
20211130,경의선,서울,4123,5180,9303
20211130,경의선,신촌,831,1031,1862
20211130,경의선,효창공원앞,2851,3409,6260
20211130,경의선,공덕,3467,3013,6480
20211130,경의선,서강대,2050,1969,4019
20211130,경의선,홍대입구,1348,1617,2965
20211130,경의선,가좌,5065,4753,9818
20211130,경의선,디지털미디어시티,2435,2230,4665
20211130,경의선,수색,2646,2777,5423
20211130,경의선,화전,1674,1537,3211
20211130,경의선,강매,3131,2647,5778
20211130,경의선,행신,7572,7605,15177
20211130,경의선,능곡,3492,3214,6706
20211130,경의선,곡산,548,565,1113
20211130,경의선,백마,6613,6361,12974
20211130,경의선,풍산,5169,4823,9992
20211130,경의선,일산,8873,8706,17579
20211130,경의선,탄현,7530,7058,14588
20211130,경의선,야당,6691,6434,13125
20211130,경의선,운정,6648,6397,13045
20211130,경의선,금릉,4454,4237,8691
20211130,경의선,금촌,5742,5724,11466
20211130,경의선,월롱,2684,2577,5261
20211130,경의선,파주,1421,1032,2453
20211130,경의선,문산,4402,4339,8741
20211130,경의선,임진강,8,7,15
20211130,경의선,계양,1,0,1
20211201,경의선,임진강,4,3,7
20211201,경의선,문산,4734,4620,9354
20211201,경의선,파주,1417,957,2374
20211201,경의선,월롱,2925,2639,5564
20211201,경의선,금촌,6274,6357,12631
20211201,경의선,금릉,4722,4510,9232
20211201,경의선,운정,7015,6611,13626
20211201,경의선,야당,7115,6951,14066
20211201,경의선,탄현,7796,7394,15190
20211201,경의선,일산,9206,9187,18393
20211201,경의선,풍산,5603,5161,10764
20211201,경의선,백마,6835,6574,13409
20211201,경의선,곡산,547,582,1129
20211201,경의선,능곡,3803,3488,7291
20211201,경의선,행신,7750,7719,15469
20211201,경의선,강매,3244,2778,6022
20211201,경의선,화전,1848,1673,3521
20211201,경의선,수색,2818,2887,5705
20211201,경의선,디지털미디어시티,2474,2291,4765
20211201,경의선,가좌,5256,4998,10254
20211201,경의선,홍대입구,1452,1770,3222
20211201,경의선,서강대,2077,2076,4153
20211201,경의선,공덕,3535,3142,6677
20211201,경의선,효창공원앞,3035,3478,6513
20211201,경의선,신촌,859,1029,1888
20211201,경의선,서울,4254,5483,9737
20211201,경의선,계양,1,0,1
20211202,경의선,임진강,8,6,14
20211202,경의선,문산,4712,4796,9508
20211202,경의선,파주,1515,1080,2595
20211202,경의선,월롱,2798,2517,5315
20211202,경의선,금촌,6064,5947,12011
20211202,경의선,금릉,4757,4648,9405
20211202,경의선,운정,6972,6604,13576
20211202,경의선,야당,7042,6859,13901
20211202,경의선,탄현,7787,7392,15179
20211202,경의선,일산,9268,9214,18482
20211202,경의선,풍산,5477,5130,10607
20211202,경의선,백마,6907,6605,13512
20211202,경의선,곡산,567,589,1156
20211202,경의선,능곡,3703,3402,7105
20211202,경의선,행신,7794,7713,15507
20211202,경의선,강매,3291,2775,6066
20211202,경의선,화전,1676,1568,3244
20211202,경의선,수색,2801,2861,5662
20211202,경의선,디지털미디어시티,2480,2350,4830
20211202,경의선,가좌,5206,4928,10134
20211202,경의선,홍대입구,1511,1841,3352
20211202,경의선,서강대,2087,2031,4118
20211202,경의선,공덕,3565,3207,6772
20211202,경의선,효창공원앞,2894,3390,6284
20211202,경의선,신촌,875,1061,1936
20211202,경의선,서울,4434,5533,9967
20211203,경의선,서울,4367,5853,10220
20211203,경의선,신촌,825,1056,1881
20211203,경의선,효창공원앞,3025,3382,6407
20211203,경의선,공덕,3661,3396,7057
20211203,경의선,서강대,2206,2183,4389
20211203,경의선,홍대입구,1701,2190,3891
20211203,경의선,가좌,5417,5201,10618
20211203,경의선,디지털미디어시티,2533,2402,4935
20211203,경의선,수색,2786,2828,5614
20211203,경의선,화전,1816,1624,3440
20211203,경의선,강매,3183,2689,5872
20211203,경의선,행신,8158,8351,16509
20211203,경의선,능곡,3856,3495,7351
20211203,경의선,곡산,595,599,1194
20211203,경의선,백마,7134,6753,13887
20211203,경의선,풍산,5727,5344,11071
20211203,경의선,일산,10346,10121,20467
20211203,경의선,탄현,7924,7516,15440
20211203,경의선,야당,7333,7387,14720
20211203,경의선,운정,7280,6768,14048
20211203,경의선,금릉,4959,4832,9791
20211203,경의선,금촌,6504,6391,12895
20211203,경의선,월롱,2882,2174,5056
20211203,경의선,파주,1432,851,2283
20211203,경의선,문산,5142,4878,10020
20211203,경의선,임진강,11,5,16
20211203,경의선,계양,2,0,2
20211206,경의선,임진강,3,1,4
20211206,경의선,문산,4883,4845,9728
20211206,경의선,파주,1622,1154,2776
20211206,경의선,월롱,2515,2498,5013
20211206,경의선,금촌,6692,6698,13390
20211206,경의선,금릉,4696,4524,9220
20211206,경의선,운정,7128,6618,13746
20211206,경의선,야당,7027,6743,13770
20211206,경의선,탄현,7643,7210,14853
20211206,경의선,일산,9195,9135,18330
20211206,경의선,풍산,5357,5016,10373
20211206,경의선,백마,6830,6429,13259
20211206,경의선,곡산,601,604,1205
20211206,경의선,능곡,3768,3432,7200
20211206,경의선,행신,7644,7834,15478
20211206,경의선,강매,3183,2681,5864
20211206,경의선,화전,1682,1525,3207
20211206,경의선,수색,2950,2939,5889
20211206,경의선,디지털미디어시티,2387,2283,4670
20211206,경의선,가좌,5295,5005,10300
20211206,경의선,홍대입구,1408,1735,3143
20211206,경의선,서강대,2083,2055,4138
20211206,경의선,공덕,3494,3133,6627
20211206,경의선,효창공원앞,2902,3236,6138
20211206,경의선,신촌,824,1071,1895
20211206,경의선,서울,4429,5452,9881
20211207,경의선,서울,4274,5337,9611
20211207,경의선,신촌,883,1018,1901
20211207,경의선,효창공원앞,2973,3382,6355
20211207,경의선,공덕,3397,3176,6573
20211207,경의선,서강대,2113,2071,4184
20211207,경의선,홍대입구,1477,1751,3228
20211207,경의선,가좌,5131,4824,9955
20211207,경의선,디지털미디어시티,2378,2250,4628
20211207,경의선,수색,2885,2994,5879
20211207,경의선,화전,1629,1477,3106
20211207,경의선,강매,3266,2820,6086
20211207,경의선,행신,7715,7654,15369
20211207,경의선,능곡,3770,3399,7169
20211207,경의선,곡산,565,627,1192
20211207,경의선,백마,6855,6584,13439
20211207,경의선,풍산,5405,5013,10418
20211207,경의선,일산,9205,9119,18324
20211207,경의선,탄현,7615,7286,14901
20211207,경의선,야당,7020,6902,13922
20211207,경의선,운정,7101,6722,13823
20211207,경의선,금릉,4767,4622,9389
20211207,경의선,금촌,6211,6042,12253
20211207,경의선,월롱,2626,2424,5050
20211207,경의선,파주,1574,1094,2668
20211207,경의선,문산,4757,4851,9608
20211207,경의선,임진강,10,5,15
20211208,경의선,계양,2,0,2
20211208,경의선,임진강,21,6,27
20211208,경의선,문산,4850,4784,9634
20211208,경의선,파주,1576,1127,2703
20211208,경의선,월롱,2568,2447,5015
20211208,경의선,금촌,6182,6119,12301
20211208,경의선,금릉,4799,4621,9420
20211208,경의선,운정,7086,6661,13747
20211208,경의선,야당,7158,7071,14229
20211208,경의선,탄현,7758,7430,15188
20211208,경의선,일산,10269,10030,20299
20211208,경의선,풍산,5511,5148,10659
20211208,경의선,백마,7038,6670,13708
20211208,경의선,곡산,607,658,1265
20211208,경의선,능곡,3826,3591,7417
20211208,경의선,행신,7710,7701,15411
20211208,경의선,강매,3220,2746,5966
20211208,경의선,화전,1762,1606,3368
20211208,경의선,수색,2899,2917,5816
20211208,경의선,디지털미디어시티,2456,2319,4775
20211208,경의선,가좌,5307,4979,10286
20211208,경의선,홍대입구,1653,1861,3514
20211208,경의선,서강대,2040,1993,4033
20211208,경의선,공덕,3505,3168,6673
20211208,경의선,효창공원앞,3065,3361,6426
20211208,경의선,신촌,792,1007,1799
20211208,경의선,서울,4187,5349,9536
20211209,경의선,서울,4213,5366,9579
20211209,경의선,신촌,857,1017,1874
20211209,경의선,효창공원앞,2932,3366,6298
20211209,경의선,공덕,3499,3146,6645
20211209,경의선,서강대,2073,1993,4066
20211209,경의선,홍대입구,1697,1847,3544
20211209,경의선,가좌,5240,4894,10134
20211209,경의선,디지털미디어시티,2465,2267,4732
20211209,경의선,수색,2864,2937,5801
20211209,경의선,화전,1601,1498,3099
20211209,경의선,강매,3227,2814,6041
20211209,경의선,행신,7769,7753,15522
20211209,경의선,능곡,3668,3416,7084
20211209,경의선,곡산,575,630,1205
20211209,경의선,백마,6733,6441,13174
20211209,경의선,풍산,5540,5107,10647
20211209,경의선,일산,9350,9185,18535
20211209,경의선,탄현,7675,7279,14954
20211209,경의선,야당,7028,6872,13900
20211209,경의선,운정,7033,6709,13742
20211209,경의선,금릉,4736,4633,9369
20211209,경의선,금촌,6160,6231,12391
20211209,경의선,월롱,2479,2290,4769
20211209,경의선,파주,1385,967,2352
20211209,경의선,문산,5097,5100,10197
20211209,경의선,임진강,11,10,21
20211210,경의선,서울,4290,5525,9815
20211210,경의선,신촌,832,1074,1906
20211210,경의선,효창공원앞,2852,3321,6173
20211210,경의선,공덕,3418,3180,6598
20211210,경의선,서강대,2079,2020,4099
20211210,경의선,홍대입구,1767,2027,3794
20211210,경의선,가좌,5354,4954,10308
20211210,경의선,디지털미디어시티,2485,2338,4823
20211210,경의선,수색,2710,2775,5485
20211210,경의선,화전,1635,1487,3122
20211210,경의선,강매,3166,2678,5844
20211210,경의선,행신,7900,7951,15851
20211210,경의선,능곡,3759,3414,7173
20211210,경의선,곡산,543,631,1174
20211210,경의선,백마,6900,6401,13301
20211210,경의선,풍산,5375,5068,10443
20211210,경의선,일산,9139,9067,18206
20211210,경의선,탄현,7671,7218,14889
20211210,경의선,야당,7107,7190,14297
20211210,경의선,운정,6940,6661,13601
20211210,경의선,금릉,4921,4687,9608
20211210,경의선,금촌,6584,6368,12952
20211210,경의선,월롱,2826,2083,4909
20211210,경의선,파주,1529,940,2469
20211210,경의선,문산,4969,4780,9749
20211210,경의선,임진강,12,10,22
20211213,경의선,임진강,10,5,15
20211213,경의선,문산,4513,4473,8986
20211213,경의선,파주,1688,1176,2864
20211213,경의선,월롱,2617,2645,5262
20211213,경의선,금촌,5894,5843,11737
20211213,경의선,금릉,4544,4377,8921
20211213,경의선,운정,6674,6384,13058
20211213,경의선,야당,6724,6453,13177
20211213,경의선,탄현,7242,6803,14045
20211213,경의선,일산,9430,9300,18730
20211213,경의선,풍산,5192,4803,9995
20211213,경의선,백마,6537,6245,12782
20211213,경의선,곡산,504,553,1057
20211213,경의선,능곡,3660,3324,6984
20211213,경의선,행신,7378,7471,14849
20211213,경의선,강매,3105,2657,5762
20211213,경의선,화전,2204,2014,4218
20211213,경의선,수색,2703,2833,5536
20211213,경의선,디지털미디어시티,2247,2197,4444
20211213,경의선,가좌,4946,4766,9712
20211213,경의선,홍대입구,1492,1647,3139
20211213,경의선,서강대,1998,1882,3880
20211213,경의선,공덕,3281,2883,6164
20211213,경의선,효창공원앞,2810,3184,5994
20211213,경의선,신촌,758,941,1699
20211213,경의선,서울,4066,5038,9104
20211214,경의선,화전,2819,2508,5327
20211214,경의선,강매,3192,2702,5894
20211214,경의선,행신,7673,7742,15415
20211214,경의선,능곡,3724,3518,7242
20211214,경의선,곡산,548,574,1122
20211214,경의선,백마,6753,6536,13289
20211214,경의선,풍산,5350,4913,10263
20211214,경의선,일산,9011,8938,17949
20211214,경의선,탄현,7648,7225,14873
20211214,경의선,야당,6897,6704,13601
20211214,경의선,운정,6843,6507,13350
20211214,경의선,금릉,4660,4546,9206
20211214,경의선,금촌,6124,5974,12098
20211214,경의선,월롱,2815,2630,5445
20211214,경의선,파주,1601,1154,2755
20211214,경의선,문산,4995,4932,9927
20211214,경의선,임진강,3,12,15
20211214,경의선,공덕,3421,3209,6630
20211214,경의선,서강대,1970,2002,3972
20211214,경의선,홍대입구,1507,1762,3269
20211214,경의선,가좌,5135,4927,10062
20211214,경의선,디지털미디어시티,2395,2254,4649
20211214,경의선,수색,2767,2908,5675
20211214,경의선,효창공원앞,2831,3277,6108
20211214,경의선,신촌,789,1019,1808
20211214,경의선,서울,4137,5287,9424
20211215,경의선,서울,4153,5203,9356
20211215,경의선,신촌,775,1030,1805
20211215,경의선,효창공원앞,2911,3350,6261
20211215,경의선,공덕,3413,3131,6544
20211215,경의선,서강대,2129,1986,4115
20211215,경의선,홍대입구,1652,1974,3626
20211215,경의선,가좌,5239,4998,10237
20211215,경의선,디지털미디어시티,2476,2251,4727
20211215,경의선,수색,2741,2878,5619
20211215,경의선,화전,2469,2191,4660
20211215,경의선,강매,3211,2772,5983
20211215,경의선,행신,7727,7924,15651
20211215,경의선,능곡,3799,3474,7273
20211215,경의선,곡산,618,625,1243
20211215,경의선,백마,6803,6487,13290
20211215,경의선,풍산,5470,5023,10493
20211215,경의선,일산,9184,9015,18199
20211215,경의선,탄현,7555,7131,14686
20211215,경의선,야당,7201,7127,14328
20211215,경의선,운정,6896,6501,13397
20211215,경의선,금릉,4835,4706,9541
20211215,경의선,금촌,6274,6298,12572
20211215,경의선,월롱,2836,2642,5478
20211215,경의선,파주,1567,1088,2655
20211215,경의선,문산,4794,4796,9590
20211215,경의선,임진강,7,12,19
20211216,경의선,임진강,13,3,16
20211216,경의선,문산,4861,4880,9741
20211216,경의선,파주,1576,1103,2679
20211216,경의선,월롱,2880,2684,5564
20211216,경의선,금촌,6674,6584,13258
20211216,경의선,금릉,4761,4581,9342
20211216,경의선,운정,6917,6539,13456
20211216,경의선,야당,7157,7137,14294
20211216,경의선,탄현,7651,7196,14847
20211216,경의선,일산,9143,8927,18070
20211216,경의선,풍산,5478,5048,10526
20211216,경의선,백마,6765,6493,13258
20211216,경의선,곡산,590,590,1180
20211216,경의선,능곡,3841,3489,7330
20211216,경의선,행신,7867,7848,15715
20211216,경의선,강매,3137,2698,5835
20211216,경의선,화전,2284,2071,4355
20211216,경의선,수색,2724,2881,5605
20211216,경의선,디지털미디어시티,2458,2216,4674
20211216,경의선,가좌,5177,4810,9987
20211216,경의선,홍대입구,1615,2043,3658
20211216,경의선,서강대,2052,1988,4040
20211216,경의선,공덕,3405,3227,6632
20211216,경의선,효창공원앞,2882,3371,6253
20211216,경의선,신촌,774,1033,1807
20211216,경의선,서울,4146,5348,9494
20211217,경의선,검암,1,0,1
20211217,경의선,계양,2,0,2
20211217,경의선,임진강,6,12,18
20211217,경의선,문산,5017,4861,9878
20211217,경의선,파주,1319,791,2110
20211217,경의선,월롱,2939,2134,5073
20211217,경의선,금촌,6238,6091,12329
20211217,경의선,금릉,4739,4434,9173
20211217,경의선,운정,6719,6428,13147
20211217,경의선,야당,7201,7101,14302
20211217,경의선,탄현,7415,7066,14481
20211217,경의선,일산,8783,8683,17466
20211217,경의선,풍산,5303,4913,10216
20211217,경의선,백마,6554,6280,12834
20211217,경의선,곡산,540,555,1095
20211217,경의선,능곡,3623,3409,7032
20211217,경의선,행신,7910,7919,15829
20211217,경의선,강매,2969,2497,5466
20211217,경의선,화전,1591,1379,2970
20211217,경의선,수색,2533,2629,5162
20211217,경의선,디지털미디어시티,2513,2195,4708
20211217,경의선,가좌,5185,4896,10081
20211217,경의선,홍대입구,1580,2106,3686
20211217,경의선,서강대,2145,2107,4252
20211217,경의선,공덕,3546,3165,6711
20211217,경의선,효창공원앞,2931,3388,6319
20211217,경의선,신촌,765,982,1747
20211217,경의선,서울,3979,5281,9260
20211220,경의선,서울,4120,5095,9215
20211220,경의선,신촌,813,995,1808
20211220,경의선,효창공원앞,2786,3320,6106
20211220,경의선,공덕,3499,3258,6757
20211220,경의선,서강대,2132,1983,4115
20211220,경의선,홍대입구,1599,1806,3405
20211220,경의선,가좌,5090,4857,9947
20211220,경의선,디지털미디어시티,2347,2250,4597
20211220,경의선,수색,2685,2804,5489
20211220,경의선,화전,2025,1787,3812
20211220,경의선,강매,3105,2692,5797
20211220,경의선,행신,7519,7482,15001
20211220,경의선,능곡,3599,3336,6935
20211220,경의선,곡산,568,594,1162
20211220,경의선,백마,6638,6487,13125
20211220,경의선,풍산,5289,4883,10172
20211220,경의선,일산,8966,8809,17775
20211220,경의선,탄현,7484,7075,14559
20211220,경의선,야당,6969,6567,13536
20211220,경의선,운정,6789,6552,13341
20211220,경의선,금릉,4643,4503,9146
20211220,경의선,금촌,6082,6073,12155
20211220,경의선,월롱,2220,2263,4483
20211220,경의선,파주,1146,742,1888
20211220,경의선,문산,4784,4907,9691
20211220,경의선,임진강,4,4,8
20211221,경의선,서울,4170,5259,9429
20211221,경의선,신촌,862,1082,1944
20211221,경의선,효창공원앞,2942,3392,6334
20211221,경의선,공덕,3602,3208,6810
20211221,경의선,서강대,2078,2078,4156
20211221,경의선,홍대입구,1726,1885,3611
20211221,경의선,가좌,5210,5002,10212
20211221,경의선,디지털미디어시티,2393,2318,4711
20211221,경의선,수색,2755,2868,5623
20211221,경의선,화전,2056,1891,3947
20211221,경의선,강매,3226,2822,6048
20211221,경의선,행신,7661,7729,15390
20211221,경의선,능곡,3713,3429,7142
20211221,경의선,곡산,581,611,1192
20211221,경의선,백마,6831,6611,13442
20211221,경의선,풍산,5374,5070,10444
20211221,경의선,일산,9217,9234,18451
20211221,경의선,탄현,7620,7219,14839
20211221,경의선,야당,6976,6812,13788
20211221,경의선,운정,6974,6624,13598
20211221,경의선,금릉,4674,4570,9244
20211221,경의선,금촌,6262,6272,12534
20211221,경의선,월롱,2307,2196,4503
20211221,경의선,파주,1154,730,1884
20211221,경의선,문산,4947,4938,9885
20211221,경의선,임진강,11,10,21
20211222,경의선,서울,4224,5391,9615
20211222,경의선,신촌,895,1052,1947
20211222,경의선,효창공원앞,2904,3372,6276
20211222,경의선,공덕,3654,3234,6888
20211222,경의선,서강대,2155,2091,4246
20211222,경의선,홍대입구,1766,2137,3903
20211222,경의선,가좌,5300,5047,10347
20211222,경의선,디지털미디어시티,2462,2278,4740
20211222,경의선,수색,2776,2867,5643
20211222,경의선,화전,2152,1983,4135
20211222,경의선,강매,3190,2809,5999
20211222,경의선,행신,7726,7848,15574
20211222,경의선,능곡,3849,3472,7321
20211222,경의선,곡산,599,614,1213
20211222,경의선,백마,6912,6771,13683
20211222,경의선,풍산,5425,5195,10620
20211222,경의선,일산,9297,9276,18573
20211222,경의선,탄현,7709,7403,15112
20211222,경의선,야당,7154,6904,14058
20211222,경의선,운정,6932,6624,13556
20211222,경의선,금릉,4815,4664,9479
20211222,경의선,금촌,6038,6190,12228
20211222,경의선,월롱,2362,2117,4479
20211222,경의선,파주,1111,742,1853
20211222,경의선,문산,5083,5000,10083
20211222,경의선,임진강,6,8,14
20211223,경의선,임진강,5,8,13
20211223,경의선,문산,4943,4922,9865
20211223,경의선,파주,1161,796,1957
20211223,경의선,월롱,2381,2060,4441
20211223,경의선,금촌,6271,6201,12472
20211223,경의선,금릉,4782,4689,9471
20211223,경의선,운정,6868,6570,13438
20211223,경의선,야당,7356,7088,14444
20211223,경의선,탄현,7653,7368,15021
20211223,경의선,일산,10102,10112,20214
20211223,경의선,풍산,5661,5424,11085
20211223,경의선,백마,6976,6703,13679
20211223,경의선,곡산,578,626,1204
20211223,경의선,능곡,3724,3444,7168
20211223,경의선,행신,7788,7826,15614
20211223,경의선,강매,3195,2807,6002
20211223,경의선,화전,1831,1690,3521
20211223,경의선,수색,2686,2832,5518
20211223,경의선,디지털미디어시티,2428,2302,4730
20211223,경의선,가좌,5320,5115,10435
20211223,경의선,홍대입구,1792,2089,3881
20211223,경의선,서강대,2168,2094,4262
20211223,경의선,공덕,3637,3150,6787
20211223,경의선,효창공원앞,2966,3419,6385
20211223,경의선,신촌,793,1027,1820
20211223,경의선,서울,4272,5342,9614
20211224,경의선,계양,1,0,1
20211224,경의선,임진강,7,6,13
20211224,경의선,문산,5433,5140,10573
20211224,경의선,파주,1207,755,1962
20211224,경의선,월롱,2978,2006,4984
20211224,경의선,금촌,6496,6414,12910
20211224,경의선,금릉,4739,4623,9362
20211224,경의선,운정,6827,6816,13643
20211224,경의선,야당,7136,7156,14292
20211224,경의선,탄현,7528,7398,14926
20211224,경의선,일산,8750,8903,17653
20211224,경의선,풍산,5484,5273,10757
20211224,경의선,백마,6531,6371,12902
20211224,경의선,곡산,506,552,1058
20211224,경의선,능곡,3652,3344,6996
20211224,경의선,행신,7822,8078,15900
20211224,경의선,강매,2983,2593,5576
20211224,경의선,화전,1865,1617,3482
20211224,경의선,수색,2535,2517,5052
20211224,경의선,디지털미디어시티,2450,2288,4738
20211224,경의선,가좌,5269,5157,10426
20211224,경의선,홍대입구,1790,2294,4084
20211224,경의선,서강대,2098,2117,4215
20211224,경의선,공덕,3404,2974,6378
20211224,경의선,효창공원앞,2883,3339,6222
20211224,경의선,신촌,828,1049,1877
20211224,경의선,서울,4106,5338,9444
20211227,경의선,임진강,1,6,7
20211227,경의선,문산,4503,4393,8896
20211227,경의선,파주,994,614,1608
20211227,경의선,월롱,2036,2081,4117
20211227,경의선,금촌,5605,5666,11271
20211227,경의선,금릉,4294,4153,8447
20211227,경의선,운정,6208,5960,12168
20211227,경의선,야당,6543,6277,12820
20211227,경의선,탄현,6987,6793,13780
20211227,경의선,일산,8439,8112,16551
20211227,경의선,풍산,4742,4491,9233
20211227,경의선,백마,6310,5881,12191
20211227,경의선,곡산,423,465,888
20211227,경의선,능곡,3358,3089,6447
20211227,경의선,행신,7024,7093,14117
20211227,경의선,강매,2949,2546,5495
20211227,경의선,화전,1402,1251,2653
20211227,경의선,수색,2435,2550,4985
20211227,경의선,디지털미디어시티,2206,2076,4282
20211227,경의선,가좌,4670,4585,9255
20211227,경의선,홍대입구,1371,1520,2891
20211227,경의선,서강대,1925,1856,3781
20211227,경의선,공덕,3299,2904,6203
20211227,경의선,효창공원앞,2642,3096,5738
20211227,경의선,신촌,734,930,1664
20211227,경의선,서울,3890,4802,8692
20211228,경의선,임진강,30,7,37
20211228,경의선,문산,4743,4682,9425
20211228,경의선,파주,1057,681,1738
20211228,경의선,월롱,2181,2055,4236
20211228,경의선,금촌,5919,5925,11844
20211228,경의선,금릉,4545,4450,8995
20211228,경의선,운정,6623,6388,13011
20211228,경의선,야당,6944,6557,13501
20211228,경의선,탄현,7349,7186,14535
20211228,경의선,일산,9589,9641,19230
20211228,경의선,풍산,5202,4949,10151
20211228,경의선,백마,6581,6351,12932
20211228,경의선,곡산,517,539,1056
20211228,경의선,능곡,3557,3297,6854
20211228,경의선,행신,7437,7500,14937
20211228,경의선,강매,3017,2636,5653
20211228,경의선,화전,1492,1368,2860
20211228,경의선,수색,2621,2715,5336
20211228,경의선,디지털미디어시티,2340,2160,4500
20211228,경의선,가좌,4899,4587,9486
20211228,경의선,홍대입구,1630,1720,3350
20211228,경의선,서강대,1974,1892,3866
20211228,경의선,공덕,3347,3004,6351
20211228,경의선,효창공원앞,2787,3292,6079
20211228,경의선,신촌,818,943,1761
20211228,경의선,서울,4001,4937,8938
20211229,경의선,서울,4052,5130,9182
20211229,경의선,신촌,780,997,1777
20211229,경의선,효창공원앞,2830,3294,6124
20211229,경의선,공덕,3602,3116,6718
20211229,경의선,서강대,2003,1985,3988
20211229,경의선,홍대입구,1810,2082,3892
20211229,경의선,가좌,5116,4971,10087
20211229,경의선,디지털미디어시티,2427,2262,4689
20211229,경의선,수색,2596,2723,5319
20211229,경의선,화전,1506,1391,2897
20211229,경의선,강매,2978,2700,5678
20211229,경의선,행신,7609,7839,15448
20211229,경의선,능곡,3649,3374,7023
20211229,경의선,곡산,520,561,1081
20211229,경의선,백마,6611,6429,13040
20211229,경의선,풍산,5533,5053,10586
20211229,경의선,일산,9108,9076,18184
20211229,경의선,탄현,7688,7278,14966
20211229,경의선,야당,7191,6897,14088
20211229,경의선,운정,6867,6540,13407
20211229,경의선,금릉,4744,4615,9359
20211229,경의선,금촌,6142,6312,12454
20211229,경의선,월롱,2593,2131,4724
20211229,경의선,파주,1089,683,1772
20211229,경의선,문산,5102,4907,10009
20211229,경의선,임진강,7,15,22
20211230,경의선,수색,2470,2528,4998
20211230,경의선,화전,1418,1335,2753
20211230,경의선,강매,3003,2537,5540
20211230,경의선,행신,7388,7554,14942
20211230,경의선,능곡,3524,3267,6791
20211230,경의선,곡산,543,571,1114
20211230,경의선,백마,6545,6349,12894
20211230,경의선,풍산,5296,5020,10316
20211230,경의선,일산,8728,8728,17456
20211230,경의선,탄현,7329,6983,14312
20211230,경의선,야당,6945,6694,13639
20211230,경의선,운정,6537,6278,12815
20211230,경의선,금릉,4549,4405,8954
20211230,경의선,금촌,5962,6001,11963
20211230,경의선,월롱,2377,1853,4230
20211230,경의선,파주,1073,740,1813
20211230,경의선,문산,4641,4719,9360
20211230,경의선,임진강,9,7,16
20211230,경의선,디지털미디어시티,2327,2184,4511
20211230,경의선,가좌,4925,4690,9615
20211230,경의선,홍대입구,1693,2036,3729
20211230,경의선,서강대,2044,1958,4002
20211230,경의선,공덕,3533,3031,6564
20211230,경의선,효창공원앞,2787,3268,6055
20211230,경의선,신촌,758,869,1627
20211230,경의선,서울,3857,4838,8695
20211231,경의선,서울,3321,4497,7818
20211231,경의선,신촌,736,867,1603
20211231,경의선,효창공원앞,2521,3030,5551
20211231,경의선,공덕,3185,2681,5866
20211231,경의선,서강대,1945,1835,3780
20211231,경의선,홍대입구,1629,1827,3456
20211231,경의선,가좌,4639,4421,9060
20211231,경의선,디지털미디어시티,2316,2124,4440
20211231,경의선,수색,2102,2121,4223
20211231,경의선,화전,1250,1048,2298
20211231,경의선,강매,2565,2265,4830
20211231,경의선,행신,6884,7061,13945
20211231,경의선,능곡,3350,2989,6339
20211231,경의선,곡산,481,495,976
20211231,경의선,백마,5701,5690,11391
20211231,경의선,풍산,4852,4723,9575
20211231,경의선,일산,7796,8089,15885
20211231,경의선,탄현,6713,6645,13358
20211231,경의선,야당,6714,6679,13393
20211231,경의선,운정,6185,5923,12108
20211231,경의선,금릉,4440,4279,8719
20211231,경의선,금촌,6216,6283,12499
20211231,경의선,월롱,2452,1656,4108
20211231,경의선,파주,1058,674,1732
20211231,경의선,문산,4732,4830,9562
20211231,경의선,임진강,7,5,12
