사용월,호선명,지하철역,승차총승객수,하차총승객수,승하차총승객수
<class,9호선,노들,1719,1527,3246
<class,우이신설선,삼양사거리,1112,1102,2214
<class,우이신설선,삼양,917,1019,1936
<class,우이신설선,화계,1470,1315,2785
<class,우이신설선,가오리,1653,1625,3278
<class,우이신설선,4.19민주묘지,1299,1122,2421
<class,우이신설선,솔밭공원,1039,1024,2063
<class,우이신설선,북한산우이,2003,1969,3972
<class,안산선,수리산,1670,1570,3240
<class,중앙선,중랑,2505,2473,4978
<class,중앙선,회기,9073,9143,18216
<class,장항선,신창,425,447,872
<class,장항선,온양온천,2035,2011,4046
<class,장항선,배방,408,407,815
<class,장항선,아산,1344,1102,2446
<class,장항선,쌍용,773,703,1476
<class,장항선,봉명,411,375,786
<class,일산선,대화,4616,4245,8861
<class,일산선,주엽,3317,3324,6641
<class,일산선,정발산,3419,3487,6906
<class,일산선,마두,2883,2841,5724
<class,일산선,백석,4388,4521,8909
<class,일산선,대곡,644,478,1122
<class,일산선,화정,7146,7424,14570
<class,일산선,원당,4470,4325,8795
<class,일산선,삼송,7405,7365,14770
<class,일산선,원흥,3623,3453,7076
<class,우이신설선,신설동,854,844,1698
<class,우이신설선,보문,671,706,1377
<class,우이신설선,성신여대입구,1565,1789,3354
<class,우이신설선,정릉,1976,1701,3677
<class,우이신설선,북한산보국문,2442,2264,4706
<class,우이신설선,솔샘,2031,1881,3912
<class,경인선,인천,1879,1538,3417
<class,경인선,동인천,6559,6479,13038
<class,경인선,제물포,3870,3784,7654
<class,중앙선,지평,20,20,40
<class,중앙선,용문,963,922,1885
<class,중앙선,원덕,152,108,260
<class,중앙선,양평,1172,1117,2289
<class,중앙선,오빈,124,117,241
<class,중앙선,아신,249,236,485
<class,중앙선,국수,339,374,713
<class,중앙선,신원,154,137,291
<class,중앙선,양수,918,894,1812
<class,중앙선,운길산,628,577,1205
<class,중앙선,팔당,807,828,1635
<class,중앙선,도심,877,785,1662
<class,중앙선,덕소,2374,2411,4785
<class,중앙선,양정,290,245,535
<class,중앙선,도농,3341,3191,6532
<class,중앙선,구리,5370,5621,10991
<class,중앙선,양원,555,550,1105
<class,중앙선,망우,3348,3418,6766
<class,중앙선,상봉,2789,2620,5409
<class,안산선,오이도,4031,4040,8071
<class,안산선,정왕,3168,3394,6562
<class,안산선,신길온천,719,710,1429
<class,안산선,안산,6299,6274,12573
<class,안산선,초지,1548,1589,3137
<class,안산선,고잔,2905,2686,5591
<class,안산선,중앙,7328,7575,14903
<class,안산선,한대앞,3554,3474,7028
<class,안산선,상록수,6973,6779,13752
<class,안산선,반월,1901,1811,3712
<class,안산선,대야미,2139,1896,4035
<class,안산선,산본,6411,6840,13251
<class,수인선,인천,634,986,1620
<class,수인선,신포,797,823,1620
<class,수인선,숭의,1542,1442,2984
<class,수인선,인하대,2208,2125,4333
<class,수인선,송도,1187,1125,2312
<class,수인선,연수,2123,2095,4218
<class,수인선,원인재,2108,2232,4340
<class,수인선,남동인더스파크,507,508,1015
<class,수인선,호구포,1277,1341,2618
<class,수인선,인천논현,2535,2554,5089
<class,수인선,소래포구,2892,2907,5799
<class,수인선,월곶,1194,1130,2324
<class,수인선,달월,39,39,78
<class,수인선,사리,1559,1353,2912
<class,수인선,야목,80,82,162
<class,수인선,어천,254,254,508
<class,수인선,오목천,875,806,1681
<class,수인선,고색,1078,1109,2187
<class,분당선,매교,978,1008,1986
<class,분당선,수원시청,5164,5641,10805
<class,분당선,매탄권선,1732,1726,3458
<class,분당선,망포,4315,4211,8526
<class,분당선,영통,3215,3246,6461
<class,분당선,청명,1336,1300,2636
<class,분당선,상갈,2044,2044,4088
<class,분당선,기흥,3519,3313,6832
<class,분당선,신갈,1379,1417,2796
<class,분당선,구성,1684,1720,3404
<class,분당선,죽전,5628,6418,12046
<class,분당선,보정,787,752,1539
<class,분당선,이매,1869,1869,3738
<class,분당선,오리,4351,3739,8090
<class,분당선,미금,6304,6358,12662
<class,분당선,정자,5544,5690,11234
<class,분당선,수내,4893,4807,9700
<class,분당선,서현,10585,10503,21088
<class,분당선,야탑,9169,9617,18786
<class,분당선,모란,9165,9408,18573
<class,분당선,태평,6241,6236,12477
<class,분당선,가천대,2402,2867,5269
<class,분당선,선정릉,1559,1619,3178
<class,분당선,강남구청,2394,2759,5153
<class,분당선,압구정로데오,8455,8885,17340
<class,분당선,서울숲,2422,2457,4879
<class,분당선,수원,4042,3301,7343
<class,분당선,수서,4770,4354,9124
<class,분당선,대모산입구,1120,1041,2161
<class,분당선,개포동,1181,1203,2384
<class,분당선,구룡,470,434,904
<class,분당선,도곡,2193,2136,4329
<class,분당선,한티,5624,5672,11296
<class,분당선,선릉,2467,3453,5920
<class,과천선,범계,10408,9875,20283
<class,과천선,평촌,4615,4557,9172
<class,과천선,인덕원,7595,7536,15131
<class,과천선,정부과천청사,2590,2651,5241
<class,과천선,과천,1995,1789,3784
<class,과천선,대공원,1691,1777,3468
<class,과천선,경마공원,598,594,1192
<class,과천선,선바위,2460,2269,4729
<class,공항철도 1호선,영종,1351,1383,2734
<class,공항철도 1호선,인천공항2터미널,1362,1267,2629
<class,공항철도 1호선,인천공항1터미널,2500,2491,4991
<class,공항철도 1호선,공항화물청사,1000,1059,2059
<class,공항철도 1호선,운서,3250,3399,6649
<class,공항철도 1호선,청라국제도시,1850,1693,3543
<class,공항철도 1호선,검암,2453,2469,4922
<class,공항철도 1호선,계양,3031,3034,6065
<class,공항철도 1호선,김포공항,5590,2573,8163
<class,공항철도 1호선,마곡나루,1084,1149,2233
<class,공항철도 1호선,디지털미디어시티,2435,2360,4795
<class,공항철도 1호선,홍대입구,3907,3896,7803
<class,공항철도 1호선,공덕,669,968,1637
<class,공항철도 1호선,서울역,3039,2472,5511
<class,경춘선,춘천,612,589,1201
<class,경춘선,남춘천,1207,1300,2507
<class,경춘선,김유정,158,160,318
<class,경춘선,강촌,283,281,564
<class,경춘선,백양리,44,77,121
<class,경춘선,굴봉산,73,60,133
<class,경춘선,가평,725,640,1365
<class,경춘선,상천,208,176,384
<class,경춘선,청평,719,691,1410
<class,경춘선,대성리,282,226,508
<class,경춘선,마석,1623,1606,3229
<class,경춘선,천마산,753,717,1470
<class,경춘선,평내호평,2305,2225,4530
<class,경춘선,금곡,586,540,1126
<class,경춘선,사릉,1261,1277,2538
<class,경춘선,퇴계원,1445,1351,2796
<class,경춘선,별내,1066,1034,2100
<class,경춘선,갈매,1089,981,2070
<class,경춘선,신내,496,503,999
<class,경인선,도화,1807,1638,3445
<class,경인선,중동,3629,3505,7134
<class,경인선,온수,2639,2513,5152
<class,경인선,도원,1205,1281,2486
<class,경인선,간석,2425,2241,4666
<class,경인선,부개,3487,3347,6834
<class,경인선,주안,8530,7736,16266
<class,경인선,동암,7320,7422,14742
<class,경인선,백운,3149,3086,6235
<class,경인선,부평,16218,17379,33597
<class,경인선,송내,9715,9377,19092
<class,경인선,부천,16718,16978,33696
<class,경인선,역곡,10963,11069,22032
<class,경인선,오류동,5052,4797,9849
<class,경인선,개봉,8901,8849,17750
<class,경의선,임진강,19,19,38
<class,경의선,문산,2261,2272,4533
<class,경의선,파주,399,312,711
<class,경의선,월롱,539,577,1116
<class,경의선,금촌,2766,2843,5609
<class,경의선,금릉,1825,1756,3581
<class,경의선,운정,2095,2049,4144
<class,경의선,야당,2450,2321,4771
<class,경의선,탄현,2721,2646,5367
<class,경의선,일산,2999,2925,5924
<class,경의선,풍산,2121,2013,4134
<class,경의선,백마,2035,1927,3962
<class,경의선,곡산,200,203,403
<class,경의선,능곡,1423,1400,2823
<class,경의선,행신,2479,2467,4946
<class,경의선,강매,997,898,1895
<class,경의선,화전,449,454,903
<class,경의선,수색,642,673,1315
<class,경의선,디지털미디어시티,885,803,1688
<class,경의선,가좌,1938,1928,3866
<class,경의선,홍대입구,708,793,1501
<class,경의선,서강대,859,822,1681
<class,경의선,공덕,1140,925,2065
<class,경의선,효창공원앞,935,1040,1975
<class,경의선,신촌,163,150,313
<class,경의선,서울역,477,514,991
<class,경원선,소요산,2090,1770,3860
<class,경원선,동두천,762,937,1699
<class,경원선,보산,934,900,1834
<class,경원선,동두천중앙,1499,1503,3002
<class,경원선,지행,2975,2905,5880
<class,경원선,덕정,2270,2205,4475
<class,경원선,덕계,1132,1034,2166
<class,경원선,양주,3320,3111,6431
<class,경원선,녹양,1952,1956,3908
<class,경원선,가능,3054,2896,5950
<class,경원선,의정부,9693,10142,19835
<class,경원선,회룡,5137,5195,10332
<class,경원선,망월사,3158,3235,6393
<class,경원선,도봉산,5859,3861,9720
<class,경원선,도봉,2726,2563,5289
<class,경원선,방학,4326,4290,8616
<class,경원선,녹천,2035,1729,3764
<class,경원선,월계,2761,2708,5469
<class,경원선,광운대,3172,3125,6297
<class,경원선,석계,3556,3848,7404
<class,경원선,신이문,3548,3314,6862
<class,경원선,외대앞,3161,3161,6322
<class,경원선,청량리,7630,7828,15458
<class,경원선,왕십리,5792,7150,12942
<class,경원선,응봉,703,638,1341
<class,경원선,옥수,29,12,41
<class,경원선,한남,1500,1417,2917
<class,경원선,서빙고,707,611,1318
<class,경원선,이촌,1571,1210,2781
<class,경부선,광명,1109,840,1949
<class,경부선,서동탄,491,480,971
<class,경부선,당정,2110,2008,4118
<class,경부선,천안,2932,2870,5802
<class,경부선,두정,2363,2571,4934
<class,경부선,직산,357,310,667
<class,경부선,성환,1498,1565,3063
<class,경부선,평택,6604,6489,13093
<class,경부선,지제,1110,966,2076
<class,경부선,서정리,2572,2788,5360
<class,경부선,송탄,2187,2166,4353
<class,경부선,진위,531,448,979
<class,경부선,오산,4655,4751,9406
<class,경부선,오산대,1253,1121,2374
<class,경부선,세마,1006,966,1972
<class,경부선,병점,5402,5754,11156
<class,경부선,세류,1187,1246,2433
<class,경부선,독산,4358,4480,8838
<class,경부선,수원,18845,19061,37906
<class,경부선,화서,2418,2374,4792
<class,경부선,성균관대,4958,5081,10039
<class,경부선,의왕,3203,3144,6347
<class,경부선,군포,2314,2305,4619
<class,경부선,금정,9649,9671,19320
<class,경부선,명학,2458,2389,4847
<class,경부선,안양,9055,9027,18082
<class,경부선,관악,3139,2932,6071
<class,경부선,석수,3594,3550,7144
<class,경부선,금천구청,4336,4334,8670
<class,경부선,가산디지털단지,2882,4278,7160
<class,경부선,구로,6720,6934,13654
<class,경부선,신길,3240,2848,6088
<class,경부선,신도림,1292,1375,2667
<class,경부선,영등포,21565,21970,43535
<class,경부선,대방,3911,3934,7845
<class,경부선,노량진,4195,4115,8310
<class,경부선,용산,15207,13779,28986
<class,경부선,남영,2809,3091,5900
<class,경부선,서울역,2092,513,2605
<class,경강선,여주,891,853,1744
<class,경강선,세종대왕릉,135,136,271
<class,경강선,부발,766,769,1535
<class,경강선,이천,1235,1239,2474
<class,경강선,신둔도예촌,458,441,899
<class,경강선,곤지암,873,831,1704
<class,경강선,초월,1065,1021,2086
<class,경강선,경기광주,2452,2465,4917
<class,경강선,삼동,798,747,1545
<class,경강선,이매,385,291,676
<class,경강선,판교,1587,1563,3150
<class,9호선2~3단계,중앙보훈병원,2199,1996,4195
<class,9호선2~3단계,둔촌오륜,278,274,552
<class,9호선2~3단계,올림픽공원,1915,1910,3825
<class,9호선2~3단계,한성백제,857,777,1634
<class,9호선2~3단계,송파나루,1811,1899,3710
<class,9호선2~3단계,석촌,2824,2523,5347
<class,9호선2~3단계,석촌고분,2227,2271,4498
<class,9호선2~3단계,삼전,2702,2621,5323
<class,9호선2~3단계,종합운동장,1446,1400,2846
<class,9호선2~3단계,봉은사,4492,4367,8859
<class,9호선2~3단계,삼성중앙,1575,1595,3170
<class,9호선2~3단계,선정릉,2062,2321,4383
<class,9호선2~3단계,언주,2723,2665,5388
<class,9호선,신논현,12272,12017,24289
<class,9호선,사평,926,893,1819
<class,9호선,고속터미널,5633,6792,12425
<class,9호선,신반포,1006,935,1941
<class,9호선,구반포,866,957,1823
<class,9호선,동작,655,494,1149
<class,9호선,흑석,2712,2935,5647
<class,9호선,노량진,9732,10192,19924
<class,9호선,샛강,1307,1368,2675
<class,9호선,여의도,3503,3367,6870
<class,9호선,국회의사당,1723,1754,3477
<class,9호선,당산,5978,5867,11845
<class,9호선,선유도,1721,1743,3464
<class,9호선,신목동,1115,953,2068
<class,9호선,염창,5939,5855,11794
<class,9호선,등촌,3824,3931,7755
<class,9호선,증미,2420,2522,4942
<class,9호선,가양,7249,7409,14658
<class,9호선,양천향교,2870,3083,5953
<class,9호선,마곡나루,3267,3279,6546
<class,9호선,신방화,2576,2459,5035
<class,9호선,공항시장,1333,1466,2799
<class,9호선,김포공항,4344,5124,9468
<class,9호선,개화,736,642,1378
<class,8호선,모란,2272,1866,4138
<class,8호선,수진,2431,2353,4784
<class,8호선,신흥,2345,2484,4829
<class,8호선,단대오거리,4357,4072,8429
<class,8호선,남한산성입구,5355,4898,10253
<class,8호선,산성,3040,3079,6119
<class,8호선,복정,3468,3109,6577
<class,8호선,장지,7082,7066,14148
<class,8호선,문정,3805,3996,7801
<class,8호선,가락시장,2949,3163,6112
<class,8호선,송파,2827,3062,5889
<class,8호선,석촌,3256,3788,7044
<class,8호선,잠실,7427,7584,15011
<class,8호선,몽촌토성,2290,2362,4652
<class,8호선,강동구청,3438,3653,7091
<class,8호선,천호,7273,8424,15697
<class,8호선,암사,7253,6852,14105
<class,7호선,부평구청,3822,3404,7226
<class,7호선,굴포천,3511,3533,7044
<class,7호선,삼산체육관,1567,1481,3048
<class,7호선,상동,5086,4998,10084
<class,7호선,부천시청,5311,5251,10562
<class,7호선,신중동,5267,5123,10390
<class,7호선,춘의,2884,2800,5684
<class,7호선,부천종합운동장,1716,1539,3255
<class,7호선,까치울,2779,2797,5576
<class,7호선,온수,3449,3291,6740
<class,7호선,천왕,3655,3538,7193
<class,7호선,광명사거리,10002,10003,20005
<class,7호선,철산,8164,8106,16270
<class,7호선,가산디지털단지,8348,7926,16274
<class,7호선,남구로,5356,5433,10789
<class,7호선,대림,4185,4099,8284
<class,7호선,신풍,4738,4554,9292
<class,7호선,보라매,3049,3043,6092
<class,7호선,신대방삼거리,6370,6505,12875
<class,7호선,장승배기,4047,3956,8003
<class,7호선,상도,3819,3807,7626
<class,7호선,숭실대입구,4311,4546,8857
<class,7호선,남성,4508,4489,8997
<class,7호선,이수,6211,5946,12157
<class,7호선,내방,4439,4451,8890
<class,7호선,고속터미널,6786,4984,11770
<class,7호선,반포,2547,2372,4919
<class,7호선,논현,6241,6719,12960
<class,7호선,학동,4812,5038,9850
<class,7호선,강남구청,4752,5195,9947
<class,7호선,청담,5865,6086,11951
<class,7호선,뚝섬유원지,3051,2951,6002
<class,7호선,건대입구,6048,6063,12111
<class,7호선,어린이대공원,6519,6429,12948
<class,7호선,군자,6023,4865,10888
<class,7호선,중곡,4064,3952,8016
<class,7호선,용마산,2652,2712,5364
<class,7호선,사가정,7520,7373,14893
<class,7호선,면목,6737,6775,13512
<class,7호선,상봉,7765,7612,15377
<class,7호선,중화,4660,4605,9265
<class,7호선,먹골,4375,4358,8733
<class,7호선,태릉입구,3525,3119,6644
<class,7호선,공릉,4733,4965,9698
<class,7호선,하계,6884,6546,13430
<class,7호선,중계,5312,4819,10131
<class,7호선,노원,9538,9526,19064
<class,7호선,마들,5241,5133,10374
<class,7호선,수락산,6122,6047,12169
<class,7호선,도봉산,3799,5554,9353
<class,7호선,장암,776,491,1267
<class,6호선,봉화산,2929,2925,5854
<class,6호선,화랑대,3205,2773,5978
<class,6호선,태릉입구,2119,2244,4363
<class,6호선,석계,4978,4970,9948
<class,6호선,돌곶이,3203,2976,6179
<class,6호선,상월곡,2337,2102,4439
<class,6호선,월곡,4055,4212,8267
<class,6호선,고려대,2765,2782,5547
<class,6호선,안암,2937,3010,5947
<class,6호선,보문,2631,2540,5171
<class,6호선,창신,1173,1076,2249
<class,6호선,동묘앞,4197,3848,8045
<class,6호선,신당,2159,2096,4255
<class,6호선,청구,1321,1337,2658
<class,6호선,약수,1404,1415,2819
<class,6호선,버티고개,905,947,1852
<class,6호선,한강진,2785,3105,5890
<class,6호선,이태원,4820,4933,9753
<class,6호선,녹사평,2023,2063,4086
<class,6호선,삼각지,1770,1527,3297
<class,6호선,효창공원앞,2369,2208,4577
<class,6호선,공덕,5009,4848,9857
<class,6호선,대흥,2695,2695,5390
<class,6호선,광흥창,2661,2588,5249
<class,6호선,상수,3050,3520,6570
<class,6호선,합정,5557,5119,10676
<class,6호선,망원,6396,6986,13382
<class,6호선,마포구청,5111,4742,9853
<class,6호선,월드컵경기장,2531,2537,5068
<class,6호선,디지털미디어시티,3805,3985,7790
<class,6호선,증산,4492,4488,8980
<class,6호선,새절,4973,4774,9747
<class,6호선,구산,2942,2350,5292
<class,6호선,연신내,1,0,1
<class,6호선,독바위,1246,1495,2741
<class,6호선,불광,2248,2057,4305
<class,6호선,역촌,1571,1817,3388
<class,6호선,응암,7321,7429,14750
<class,5호선,하남풍산,1961,2075,4036
<class,5호선,미사,5132,5025,10157
<class,5호선,마천,2697,2727,5424
<class,5호선,거여,2728,2694,5422
<class,5호선,개롱,2164,2332,4496
<class,5호선,오금,1137,1075,2212
<class,5호선,방이,2556,2556,5112
<class,5호선,올림픽공원,1467,1400,2867
<class,5호선,둔촌동,3209,3303,6512
<class,5호선,상일동,5309,4957,10266
<class,5호선,고덕,3056,3041,6097
<class,5호선,명일,3062,3233,6295
<class,5호선,굽은다리,3964,3793,7757
<class,5호선,길동,3472,3703,7175
<class,5호선,강동,6910,6645,13555
<class,5호선,천호,9660,9100,18760
<class,5호선,광나루,5249,5256,10505
<class,5호선,아차산,7252,7315,14567
<class,5호선,군자,4480,5024,9504
<class,5호선,장한평,5681,5816,11497
<class,5호선,답십리,5586,5168,10754
<class,5호선,마장,2155,2068,4223
<class,5호선,왕십리,1921,2160,4081
<class,5호선,행당,2995,2679,5674
<class,5호선,신금호,2310,2486,4796
<class,5호선,청구,1361,1234,2595
<class,5호선,동대문역사문화공원,539,685,1224
<class,5호선,을지로4가,1453,1517,2970
<class,5호선,종로3가,4181,4145,8326
<class,5호선,광화문,6381,6228,12609
<class,5호선,서대문,3620,3560,7180
<class,5호선,충정로,982,1008,1990
<class,5호선,애오개,2004,2046,4050
<class,5호선,공덕,3398,3437,6835
<class,5호선,마포,3624,3728,7352
<class,5호선,여의나루,2112,2044,4156
<class,5호선,여의도,3804,4079,7883
<class,5호선,신길,1197,1468,2665
<class,5호선,영등포시장,3497,3779,7276
<class,5호선,영등포구청,971,1029,2000
<class,5호선,양평,1891,1984,3875
<class,5호선,오목교,8760,9030,17790
<class,5호선,목동,5949,6108,12057
<class,5호선,신정,4974,4269,9243
<class,5호선,까치산,12160,12147,24307
<class,5호선,화곡,10906,10210,21116
<class,5호선,우장산,5247,5401,10648
<class,5호선,발산,6102,6281,12383
<class,5호선,마곡,2427,2461,4888
<class,5호선,송정,2807,2883,5690
<class,5호선,김포공항,4315,3887,8202
<class,5호선,개화산,2149,2192,4341
<class,5호선,방화,2726,2626,5352
<class,4호선,쌍문,12277,11291,23568
<class,4호선,창동,11236,11911,23147
<class,4호선,노원,8913,9767,18680
<class,4호선,상계,8140,7761,15901
<class,4호선,당고개,5707,5451,11158
<class,4호선,남태령,383,378,761
<class,4호선,사당,8752,8333,17085
<class,4호선,총신대입구,7734,8434,16168
<class,4호선,동작,1100,1077,2177
<class,4호선,이촌,2406,2716,5122
<class,4호선,신용산,4667,4752,9419
<class,4호선,삼각지,1274,1548,2822
<class,4호선,숙대입구,4219,4101,8320
<class,4호선,서울역,2425,4003,6428
<class,4호선,회현,6789,7060,13849
<class,4호선,명동,6217,6604,12821
<class,4호선,충무로,5573,5809,11382
<class,4호선,동대문역사문화공원,4987,4512,9499
<class,4호선,동대문,5508,5612,11120
<class,4호선,혜화,10234,10444,20678
<class,4호선,한성대입구,5327,5242,10569
<class,4호선,성신여대입구,8838,8684,17522
<class,4호선,길음,7056,6948,14004
<class,4호선,미아사거리,12866,12528,25394
<class,4호선,미아,6345,6191,12536
<class,4호선,수유,15531,15112,30643
<class,3호선,오금,1902,1808,3710
<class,3호선,경찰병원,2064,2069,4133
<class,3호선,가락시장,3162,3202,6364
<class,3호선,수서,6183,5716,11899
<class,3호선,일원,2316,2331,4647
<class,3호선,대청,2996,2847,5843
<class,3호선,학여울,572,540,1112
<class,3호선,대치,4091,3847,7938
<class,3호선,도곡,1718,1670,3388
<class,3호선,매봉,3152,3082,6234
<class,3호선,양재,8731,9797,18528
<class,3호선,남부터미널,9634,9188,18822
<class,3호선,교대,2723,1843,4566
<class,3호선,고속터미널,23856,21535,45391
<class,3호선,잠원,1565,1568,3133
<class,3호선,신사,12035,12344,24379
<class,3호선,압구정,13628,13960,27588
<class,3호선,옥수,3599,3680,7279
<class,3호선,금호,3345,3257,6602
<class,3호선,약수,4961,4890,9851
<class,3호선,동대입구,2828,3273,6101
<class,3호선,충무로,2,0,2
<class,3호선,을지로3가,2082,2103,4185
<class,3호선,종로3가,2200,3036,5236
<class,3호선,안국,4235,4545,8780
<class,3호선,경복궁,5520,5715,11235
<class,3호선,독립문,2958,3232,6190
<class,3호선,무악재,1414,1489,2903
<class,3호선,홍제,7206,7060,14266
<class,3호선,녹번,5162,4780,9942
<class,3호선,불광,7531,8485,16016
<class,3호선,연신내,17233,16303,33536
<class,3호선,구파발,8041,8127,16168
<class,3호선,지축,1184,1177,2361
<class,2호선,용두,901,988,1889
<class,2호선,신정네거리,3761,3983,7744
<class,2호선,양천구청,2197,2320,4517
<class,2호선,도림천,507,483,990
<class,2호선,신설동,1796,1811,3607
<class,2호선,신답,488,533,1021
<class,2호선,용답,1173,1123,2296
<class,2호선,충정로,2610,2624,5234
<class,2호선,아현,3866,3895,7761
<class,2호선,이대,4202,4544,8746
<class,2호선,신촌,14068,14358,28426
<class,2호선,홍대입구,22086,23077,45163
<class,2호선,합정,11062,11761,22823
<class,2호선,당산,6059,6629,12688
<class,2호선,영등포구청,6282,6530,12812
<class,2호선,문래,5148,5313,10461
<class,2호선,신도림,19930,19642,39572
<class,2호선,대림,10276,10898,21174
<class,2호선,구로디지털단지,18136,18446,36582
<class,2호선,신대방,11219,11226,22445
<class,2호선,신림,27580,27810,55390
<class,2호선,봉천,9611,9380,18991
<class,2호선,서울대입구,18722,19228,37950
<class,2호선,낙성대,10747,11155,21902
<class,2호선,사당,14117,15073,29190
<class,2호선,방배,4810,4931,9741
<class,2호선,서초,4473,4038,8511
<class,2호선,교대,8040,8768,16808
<class,2호선,강남,26955,26265,53220
<class,2호선,역삼,8861,9540,18401
<class,2호선,선릉,10750,9807,20557
<class,2호선,삼성,13175,12988,26163
<class,2호선,종합운동장,2158,2216,4374
<class,2호선,잠실새내,8364,8828,17192
<class,2호선,잠실,28358,26540,54898
<class,2호선,잠실나루,3707,3690,7397
<class,2호선,강변,12457,11820,24277
<class,2호선,구의,8669,8867,17536
<class,2호선,건대입구,15666,17068,32734
<class,2호선,성수,6548,7352,13900
<class,2호선,뚝섬,4932,5257,10189
<class,2호선,한양대,1475,1506,2981
<class,2호선,왕십리,6261,5295,11556
<class,2호선,상왕십리,4956,4992,9948
<class,2호선,신당,5940,6298,12238
<class,2호선,동대문역사문화공원,4256,4473,8729
<class,2호선,을지로4가,3295,3308,6603
<class,2호선,을지로3가,3833,3671,7504
<class,2호선,을지로입구,11279,10899,22178
<class,2호선,시청,2943,2279,5222
<class,1호선,청량리,10534,10514,21048
<class,1호선,제기동,8727,9173,17900
<class,1호선,신설동,5013,4977,9990
<class,1호선,동대문,5624,5478,11102
<class,1호선,종로5가,7837,7863,15700
<class,1호선,종로3가,9509,8927,18436
<class,1호선,종각,7837,7398,15235
<class,1호선,시청,4165,3871,8036
<class,1호선,동묘앞,7075,7283,14358
<class,1호선,서울역,13135,11056,24191
<class,경인선,소사,4045,3650,7695
<class,경인선,구일,2172,2235,4407
<class,6호선,돌곶이,2456,2372,4828
<class,6호선,석계,3910,3969,7879
<class,6호선,태릉입구,1597,1718,3315
<class,6호선,화랑대,2615,2377,4992
<class,6호선,봉화산,2224,2207,4431
<class,7호선,장암,736,463,1199
<class,7호선,도봉산,3116,4609,7725
<class,7호선,수락산,5125,5092,10217
<class,7호선,마들,3443,3202,6645
<class,7호선,노원,6282,6206,12488
<class,7호선,중계,4017,3650,7667
<class,7호선,하계,5029,4779,9808
<class,7호선,공릉,3606,3817,7423
<class,7호선,태릉입구,2571,2432,5003
<class,7호선,먹골,3266,3297,6563
<class,7호선,중화,3426,3413,6839
<class,7호선,상봉,5733,5488,11221
<class,7호선,면목,5107,5158,10265
<class,7호선,사가정,5658,5555,11213
<class,7호선,용마산,1988,2179,4167
<class,7호선,중곡,3093,3012,6105
<class,7호선,군자,4405,3813,8218
<class,7호선,어린이대공원,5852,5920,11772
<class,7호선,건대입구,4661,4680,9341
<class,7호선,뚝섬유원지,2431,2347,4778
<class,7호선,청담,3667,3926,7593
<class,7호선,강남구청,2934,3211,6145
<class,7호선,학동,2952,3215,6167
<class,7호선,논현,3759,4060,7819
<class,7호선,반포,1715,1744,3459
<class,7호선,고속터미널,9182,4369,13551
<class,7호선,내방,3025,3092,6117
<class,7호선,이수,4398,4335,8733
<class,7호선,남성,3178,3373,6551
<class,7호선,숭실대입구,3129,3493,6622
<class,7호선,상도,2822,2988,5810
<class,7호선,장승배기,2935,2962,5897
<class,7호선,신대방삼거리,4688,4888,9576
<class,7호선,보라매,2316,2426,4742
<class,7호선,신풍,3515,3355,6870
<class,7호선,대림,3747,3475,7222
<class,7호선,남구로,4494,4218,8712
<class,7호선,가산디지털단지,6325,6146,12471
<class,7호선,광명사거리,7651,7501,15152
<class,7호선,천왕,2730,2604,5334
<class,7호선,온수,2394,2399,4793
<class,7호선,까치울,2189,2083,4272
<class,7호선,부천종합운동장,1417,1268,2685
<class,7호선,춘의,2135,1949,4084
<class,7호선,신중동,3971,3743,7714
<class,7호선,부천시청,3893,3769,7662
<class,7호선,상동,3690,3573,7263
<class,7호선,삼산체육관,1220,1179,2399
<class,7호선,굴포천,2758,2571,5329
<class,7호선,부평구청,2980,2611,5591
<class,8호선,암사,5372,5112,10484
<class,8호선,천호,5569,6409,11978
<class,8호선,강동구청,2605,2786,5391
<class,8호선,몽촌토성,1714,1808,3522
<class,8호선,잠실,5760,5870,11630
<class,8호선,석촌,2340,2807,5147
<class,8호선,송파,2130,2242,4372
<class,8호선,가락시장,2068,2828,4896
<class,8호선,문정,2882,3151,6033
<class,8호선,장지,5696,6230,11926
<class,8호선,복정,2560,2477,5037
<class,8호선,산성,2277,2354,4631
<class,8호선,남한산성입구,4152,4010,8162
<class,8호선,단대오거리,3193,3249,6442
<class,8호선,신흥,1771,1937,3708
<class,8호선,수진,1855,1761,3616
<class,8호선,모란,1612,1252,2864
<class,9호선,개화,617,571,1188
<class,9호선,김포공항,4806,5401,10207
<class,9호선,공항시장,968,1163,2131
<class,9호선,신방화,2003,2008,4011
<class,9호선,마곡나루,2542,2807,5349
<class,9호선,양천향교,2180,2521,4701
<class,9호선,가양,5431,5568,10999
<class,9호선,증미,1836,1963,3799
<class,9호선,등촌,2789,3038,5827
<class,9호선,염창,4531,4779,9310
<class,9호선,신목동,904,831,1735
<class,9호선,선유도,1310,1480,2790
<class,경인선,중동,2876,2585,5461
<class,경인선,온수,1955,1839,3794
<class,경인선,도원,876,869,1745
<class,경인선,간석,1945,1751,3696
<class,경인선,부개,2683,2525,5208
<class,경인선,소사,3384,2852,6236
<class,경인선,구일,1734,1737,3471
<class,경인선,인천,1556,1280,2836
<class,경인선,동인천,5224,4852,10076
<class,경인선,제물포,3071,2905,5976
<class,경인선,주안,6707,5902,12609
<class,경인선,동암,5814,5503,11317
<class,경인선,백운,2416,2295,4711
<class,경인선,부평,12578,12499,25077
<class,경인선,송내,7596,7167,14763
<class,경인선,부천,13282,12648,25930
<class,경인선,역곡,8357,8193,16550
<class,경인선,오류동,3814,3766,7580
<class,경인선,개봉,6825,6652,13477
<class,경의선,임진강,15,18,33
<class,경의선,문산,1890,1822,3712
<class,경의선,파주,348,310,658
<class,경의선,월롱,413,824,1237
<class,경의선,금촌,2225,2352,4577
<class,경의선,금릉,1363,1344,2707
<class,경의선,운정,1765,1657,3422
<class,경의선,야당,1945,1830,3775
<class,경의선,탄현,2226,2087,4313
<class,경의선,일산,2683,2424,5107
<class,경의선,풍산,1773,1619,3392
<class,경의선,백마,1687,1632,3319
<class,경의선,곡산,143,131,274
<class,경의선,능곡,1233,1142,2375
<class,경의선,행신,2178,2149,4327
<class,경의선,강매,741,712,1453
<class,경의선,화전,384,373,757
<class,경의선,수색,473,519,992
<class,경의선,디지털미디어시티,709,686,1395
<class,경의선,가좌,1483,1505,2988
<class,경의선,홍대입구,579,635,1214
<class,경의선,서강대,616,670,1286
<class,경의선,공덕,837,682,1519
<class,경의선,효창공원앞,685,867,1552
<class,경의선,신촌,103,116,219
<class,경의선,서울역,493,453,946
<class,경원선,소요산,2089,1735,3824
<class,경원선,동두천,756,861,1617
<class,경원선,보산,820,669,1489
<class,경원선,동두천중앙,1250,1168,2418
<class,6호선,버티고개,611,676,1287
<class,경원선,지행,2319,2125,4444
<class,경원선,덕정,1792,1873,3665
<class,경원선,덕계,884,827,1711
<class,경원선,양주,2710,2568,5278
<class,경원선,녹양,1588,1469,3057
<class,경원선,가능,2399,2192,4591
<class,경원선,의정부,7790,7638,15428
<class,경원선,회룡,3957,3828,7785
<class,경원선,망월사,2491,2541,5032
<class,경원선,도봉산,5493,3708,9201
<class,경원선,도봉,2152,1985,4137
<class,경원선,방학,3454,3274,6728
<class,경원선,녹천,1540,1383,2923
<class,경원선,월계,2244,2141,4385
<class,경원선,광운대,2489,2600,5089
<class,경원선,석계,2888,3139,6027
<class,경원선,신이문,2759,2591,5350
<class,경원선,외대앞,2584,2647,5231
<class,경원선,청량리,6894,6628,13522
<class,경원선,왕십리,4555,5779,10334
<class,경원선,응봉,554,496,1050
<class,경원선,옥수,37,12,49
<class,경원선,한남,1130,1110,2240
<class,경원선,서빙고,476,514,990
<class,경원선,이촌,1077,858,1935
<class,경부선,광명,1535,856,2391
<class,경부선,서동탄,458,386,844
<class,경부선,당정,1673,1697,3370
<class,경부선,천안,3425,3195,6620
<class,경부선,두정,2318,2535,4853
<class,경부선,직산,309,387,696
<class,경부선,성환,1369,1719,3088
<class,경부선,평택,6328,6970,13298
<class,경부선,지제,1309,1253,2562
<class,경부선,서정리,2143,4158,6301
<class,경부선,송탄,2016,2450,4466
<class,경부선,진위,440,448,888
<class,경부선,오산,4553,5137,9690
<class,경부선,오산대,1108,1078,2186
<class,경부선,세마,903,853,1756
<class,경부선,병점,4795,5551,10346
<class,경부선,세류,1268,1205,2473
<class,경부선,독산,3344,3638,6982
<class,경부선,수원,17961,17314,35275
<class,경부선,화서,2062,1990,4052
<class,경부선,성균관대,4207,4630,8837
<class,경부선,의왕,2446,2468,4914
<class,경부선,군포,1958,1900,3858
<class,공항철도 1호선,운서,2822,3256,6078
<class,공항철도 1호선,공항화물청사,738,827,1565
<class,공항철도 1호선,인천공항1터미널,2393,2370,4763
<class,공항철도 1호선,인천공항2터미널,1351,1286,2637
<class,공항철도 1호선,영종,1131,1107,2238
<class,과천선,선바위,1852,1778,3630
<class,과천선,경마공원,490,460,950
<class,과천선,대공원,1495,1593,3088
<class,과천선,과천,1560,1448,3008
<class,과천선,정부과천청사,2001,2141,4142
<class,과천선,인덕원,5628,5627,11255
<class,과천선,평촌,3406,3353,6759
<class,과천선,범계,7540,7147,14687
<class,분당선,선릉,1530,2294,3824
<class,분당선,한티,3937,4139,8076
<class,분당선,도곡,1430,1393,2823
<class,분당선,구룡,314,377,691
<class,분당선,개포동,887,925,1812
<class,분당선,대모산입구,830,792,1622
<class,분당선,수서,4605,4022,8627
<class,분당선,수원,3277,2678,5955
<class,분당선,서울숲,1937,1943,3880
<class,분당선,압구정로데오,5047,5418,10465
<class,분당선,강남구청,1557,1746,3303
<class,분당선,선정릉,1047,1158,2205
<class,분당선,가천대,1933,2469,4402
<class,분당선,태평,4935,4748,9683
<class,분당선,모란,6322,6744,13066
<class,분당선,야탑,7491,7235,14726
<class,분당선,서현,7656,7713,15369
<class,분당선,수내,3671,3530,7201
<class,분당선,정자,3917,4110,8027
<class,분당선,미금,4098,4425,8523
<class,분당선,오리,3110,2852,5962
<class,분당선,이매,1418,1470,2888
<class,분당선,보정,542,530,1072
<class,분당선,죽전,4527,5173,9700
<class,분당선,구성,1285,1280,2565
<class,분당선,신갈,1031,1065,2096
<class,분당선,기흥,2895,2745,5640
<class,분당선,상갈,1601,1700,3301
<class,분당선,청명,1023,1057,2080
<class,분당선,영통,2483,2554,5037
<class,분당선,망포,3415,3812,7227
<class,분당선,매탄권선,1373,1326,2699
<class,분당선,수원시청,4007,3946,7953
<class,분당선,매교,754,807,1561
<class,수인선,고색,889,948,1837
<class,수인선,오목천,698,711,1409
<class,수인선,어천,215,337,552
<class,9호선2~3단계,삼성중앙,1152,1214,2366
<class,9호선2~3단계,봉은사,3390,3331,6721
<class,9호선2~3단계,종합운동장,1050,1101,2151
<class,9호선2~3단계,삼전,2021,2132,4153
<class,9호선2~3단계,석촌고분,1767,1890,3657
<class,9호선2~3단계,석촌,2172,2041,4213
<class,9호선2~3단계,송파나루,1332,1521,2853
<class,수인선,야목,87,75,162
<class,수인선,사리,1197,1004,2201
<class,수인선,달월,37,30,67
<class,수인선,월곶,959,909,1868
<class,수인선,소래포구,2379,2288,4667
<class,수인선,인천논현,1784,1852,3636
<class,수인선,호구포,1124,1191,2315
<class,수인선,남동인더스파크,328,422,750
<class,수인선,원인재,1633,1658,3291
<class,수인선,연수,1616,1597,3213
<class,수인선,송도,905,858,1763
<class,수인선,인하대,1801,1697,3498
<class,수인선,숭의,1148,1061,2209
<class,수인선,신포,654,606,1260
<class,수인선,인천,509,806,1315
<class,안산선,산본,4818,5052,9870
<class,안산선,대야미,1621,1523,3144
<class,안산선,반월,1410,1438,2848
<class,안산선,상록수,5530,5287,10817
<class,안산선,한대앞,2776,2744,5520
<class,안산선,중앙,5838,5598,11436
<class,9호선2~3단계,한성백제,628,663,1291
<class,9호선2~3단계,올림픽공원,1463,1473,2936
<class,9호선2~3단계,둔촌오륜,227,232,459
<class,9호선2~3단계,중앙보훈병원,1723,1642,3365
<class,경강선,판교,1325,1230,2555
<class,경강선,이매,308,223,531
<class,경강선,삼동,559,535,1094
<class,경강선,경기광주,1926,1964,3890
<class,경강선,초월,878,953,1831
<class,경강선,곤지암,724,875,1599
<class,경강선,신둔도예촌,446,373,819
<class,경강선,이천,1060,1169,2229
<class,경강선,부발,633,1354,1987
<class,경강선,세종대왕릉,143,126,269
<class,경강선,여주,1052,788,1840
<class,경부선,서울역,3889,580,4469
<class,경부선,남영,2100,2404,4504
<class,경부선,용산,16227,12871,29098
<class,경부선,노량진,3046,3141,6187
<class,경부선,대방,3183,3578,6761
<class,경부선,영등포,18497,17774,36271
<class,경부선,신도림,1090,1096,2186
<class,경부선,신길,2724,2559,5283
<class,경부선,구로,5546,5575,11121
<class,경부선,가산디지털단지,2505,3653,6158
<class,경부선,금천구청,3585,3504,7089
<class,경부선,석수,3066,2988,6054
<class,경부선,관악,2646,2436,5082
<class,경부선,안양,7605,7249,14854
<class,경부선,명학,1921,1979,3900
<class,경부선,금정,7531,7871,15402
<class,우이신설선,화계,1221,1108,2329
<class,우이신설선,삼양,749,783,1532
<class,우이신설선,삼양사거리,913,903,1816
<class,우이신설선,솔샘,1564,1415,2979
<class,우이신설선,북한산보국문,2036,1983,4019
<class,우이신설선,정릉,1452,1285,2737
<class,우이신설선,성신여대입구,1082,1288,2370
<class,우이신설선,보문,548,570,1118
<class,우이신설선,신설동,656,625,1281
<class,일산선,원흥,2701,2665,5366
<class,일산선,삼송,5645,5626,11271
<class,일산선,원당,3545,3321,6866
<class,일산선,화정,5239,5319,10558
<class,일산선,대곡,518,463,981
<class,일산선,백석,3377,3349,6726
<class,일산선,마두,1843,1849,3692
<class,일산선,정발산,2631,2559,5190
<class,일산선,주엽,2373,949,3322
<class,일산선,대화,3603,3297,6900
<class,장항선,봉명,342,328,670
<class,장항선,쌍용,694,321,1015
<class,장항선,아산,1990,1231,3221
<class,장항선,배방,357,475,832
<class,장항선,온양온천,2108,2025,4133
<class,장항선,신창,484,584,1068
<class,중앙선,회기,7810,8289,16099
<class,중앙선,중랑,1973,1918,3891
<class,중앙선,상봉,2268,2161,4429
<class,중앙선,망우,2607,2558,5165
<class,중앙선,양원,440,445,885
<class,중앙선,구리,3943,4141,8084
<class,중앙선,도농,2611,2585,5196
<class,안산선,고잔,2318,2176,4494
<class,안산선,초지,1168,1115,2283
<class,안산선,안산,6229,5181,11410
<class,안산선,신길온천,683,567,1250
<class,안산선,정왕,2844,3227,6071
<class,안산선,오이도,3068,3014,6082
<class,안산선,수리산,1190,1164,2354
<class,우이신설선,북한산우이,1530,1718,3248
<class,우이신설선,솔밭공원,792,770,1562
<class,우이신설선,4.19민주묘지,1062,928,1990
<class,우이신설선,가오리,1367,1211,2578
<class,중앙선,양정,250,234,484
<class,중앙선,덕소,1903,1856,3759
<class,중앙선,도심,706,596,1302
<class,중앙선,팔당,736,762,1498
<class,중앙선,운길산,550,487,1037
<class,중앙선,양수,748,687,1435
<class,중앙선,지평,33,14,47
<class,중앙선,용문,933,699,1632
<class,중앙선,원덕,193,127,320
<class,중앙선,양평,1267,1047,2314
<class,중앙선,오빈,101,89,190
<class,중앙선,아신,217,237,454
<class,3호선,약수,3523,3512,7035
<class,6호선,약수,936,930,1866
<class,6호선,청구,1001,983,1984
<class,6호선,신당,1749,2576,4325
<class,6호선,동묘앞,3593,3482,7075
<class,6호선,창신,936,835,1771
<class,6호선,보문,2167,2177,4344
<class,6호선,안암,2361,2721,5082
<class,6호선,고려대,2171,2259,4430
<class,6호선,월곡,3166,3289,6455
<class,경인선,도화,1350,1290,2640
<class,경춘선,신내,460,441,901
<class,경춘선,갈매,849,682,1531
<class,경춘선,별내,847,852,1699
<class,경춘선,퇴계원,1208,1123,2331
<class,경춘선,사릉,969,968,1937
<class,경춘선,금곡,534,457,991
<class,경춘선,평내호평,1796,1666,3462
<class,경춘선,천마산,592,557,1149
<class,경춘선,마석,1372,1345,2717
<class,경춘선,대성리,248,186,434
<class,경춘선,청평,684,615,1299
<class,경춘선,상천,190,173,363
<class,경춘선,가평,629,554,1183
<class,경춘선,굴봉산,72,76,148
<class,경춘선,백양리,45,72,117
<class,경춘선,강촌,271,231,502
<class,경춘선,김유정,165,133,298
<class,경춘선,남춘천,1151,1208,2359
<class,경춘선,춘천,669,555,1224
<class,공항철도 1호선,서울역,3898,2847,6745
<class,공항철도 1호선,공덕,590,856,1446
<class,공항철도 1호선,홍대입구,3208,3285,6493
<class,공항철도 1호선,디지털미디어시티,1916,2039,3955
<class,공항철도 1호선,마곡나루,934,1067,2001
<class,공항철도 1호선,김포공항,7307,3153,10460
<class,공항철도 1호선,계양,2634,2492,5126
<class,공항철도 1호선,검암,2081,2077,4158
<class,공항철도 1호선,청라국제도시,1616,1433,3049
<class,9호선,당산,4584,4884,9468
<class,9호선,국회의사당,1733,1607,3340
<class,9호선,여의도,2833,2816,5649
<class,9호선,샛강,915,1042,1957
<class,9호선,노량진,7457,8261,15718
<class,9호선,노들,1344,1174,2518
<class,9호선,흑석,2023,2241,4264
<class,9호선,동작,510,427,937
<class,9호선,구반포,599,686,1285
<class,9호선,신반포,676,670,1346
<class,9호선,고속터미널,5713,5953,11666
<class,9호선,사평,644,735,1379
<class,9호선,신논현,7388,7228,14616
<class,9호선2~3단계,언주,1704,1822,3526
<class,9호선2~3단계,선정릉,1527,1737,3264
<class,6호선,한강진,2158,2441,4599
<class,6호선,이태원,4028,3868,7896
<class,6호선,녹사평,1599,1506,3105
<class,6호선,삼각지,1378,1132,2510
<class,6호선,효창공원앞,1793,1622,3415
<class,6호선,공덕,3632,3458,7090
<class,6호선,대흥,1942,2148,4090
<class,6호선,광흥창,1906,1957,3863
<class,6호선,상수,2347,2807,5154
<class,6호선,합정,4382,3944,8326
<class,6호선,망원,4645,5136,9781
<class,6호선,마포구청,4006,3837,7843
<class,6호선,월드컵경기장,2159,2008,4167
<class,6호선,디지털미디어시티,3022,3288,6310
<class,6호선,증산,3276,3493,6769
<class,6호선,새절,3938,3810,7748
<class,6호선,구산,2105,1643,3748
<class,6호선,독바위,957,1222,2179
<class,6호선,불광,1699,1608,3307
<class,6호선,역촌,1128,1228,2356
<class,6호선,응암,5520,5632,11152
<class,5호선,하남풍산,1445,1568,3013
<class,5호선,미사,3878,4022,7900
<class,5호선,마천,1953,2173,4126
<class,5호선,거여,2030,1971,4001
<class,5호선,개롱,1628,1760,3388
<class,5호선,오금,839,812,1651
<class,5호선,방이,1858,1890,3748
<class,5호선,올림픽공원,1133,1006,2139
<class,5호선,둔촌동,2341,2404,4745
<class,5호선,상일동,3911,3736,7647
<class,5호선,고덕,2272,2273,4545
<class,5호선,명일,2173,2198,4371
<class,5호선,굽은다리,3075,2846,5921
<class,5호선,길동,2377,2599,4976
<class,5호선,강동,5301,5306,10607
<class,5호선,천호,7152,6685,13837
<class,5호선,광나루,4423,4415,8838
<class,5호선,아차산,5998,6060,12058
<class,5호선,군자,3403,3885,7288
<class,5호선,장한평,4016,4184,8200
<class,5호선,답십리,4217,4055,8272
<class,5호선,마장,1545,1543,3088
<class,5호선,왕십리,1439,1604,3043
<class,5호선,행당,2267,2019,4286
<class,5호선,신금호,1715,1884,3599
<class,5호선,청구,979,927,1906
<class,5호선,동대문역사문화공원,412,458,870
<class,5호선,을지로4가,699,701,1400
<class,5호선,종로3가,2957,2903,5860
<class,5호선,광화문,5189,5285,10474
<class,5호선,서대문,2561,2567,5128
<class,5호선,충정로,810,842,1652
<class,5호선,애오개,1510,1638,3148
<class,5호선,공덕,2283,2466,4749
<class,5호선,마포,2501,2615,5116
<class,5호선,여의나루,1788,1825,3613
<class,5호선,여의도,2917,3053,5970
<class,5호선,신길,989,1256,2245
<class,5호선,영등포시장,2347,2523,4870
<class,5호선,영등포구청,732,787,1519
<class,5호선,양평,1433,1618,3051
<class,5호선,오목교,6415,6801,13216
<class,5호선,목동,4298,4382,8680
<class,5호선,신정,3676,3329,7005
<class,5호선,까치산,9147,9325,18472
<class,5호선,화곡,8121,7819,15940
<class,5호선,우장산,3503,3673,7176
<class,5호선,발산,4377,4545,8922
<class,5호선,마곡,1694,1750,3444
<class,5호선,송정,2161,2235,4396
<class,5호선,김포공항,4661,3779,8440
<class,5호선,개화산,1609,1698,3307
<class,5호선,방화,2112,2108,4220
<class,4호선,쌍문,9272,8337,17609
<class,4호선,창동,8467,8836,17303
<class,4호선,노원,6418,6921,13339
<class,4호선,상계,6098,5675,11773
<class,4호선,당고개,4684,4278,8962
<class,4호선,남태령,306,303,609
<class,4호선,사당,7229,7514,14743
<class,4호선,총신대입구,5490,6075,11565
<class,4호선,동작,881,929,1810
<class,4호선,이촌,1714,1974,3688
<class,4호선,신용산,3802,3663,7465
<class,4호선,삼각지,897,1152,2049
<class,4호선,숙대입구,3158,3088,6246
<class,4호선,서울역,2091,3664,5755
<class,4호선,회현,4778,4785,9563
<class,4호선,명동,4513,4772,9285
<class,4호선,충무로,3715,3934,7649
<class,4호선,동대문역사문화공원,4408,4630,9038
<class,4호선,동대문,3477,3958,7435
<class,4호선,혜화,8355,8621,16976
<class,4호선,한성대입구,4111,4241,8352
<class,4호선,성신여대입구,6559,6653,13212
<class,4호선,길음,5246,5261,10507
<class,4호선,미아사거리,9586,9211,18797
<class,4호선,미아,4754,4626,9380
<class,4호선,수유,11878,11498,23376
<class,3호선,오금,1379,1337,2716
<class,3호선,경찰병원,1536,1612,3148
<class,3호선,가락시장,2291,2498,4789
<class,3호선,수서,5413,4996,10409
<class,3호선,일원,1784,1952,3736
<class,3호선,대청,2254,2244,4498
<class,3호선,학여울,436,428,864
<class,3호선,대치,2667,2514,5181
<class,3호선,도곡,1076,1196,2272
<class,3호선,매봉,2197,2267,4464
<class,3호선,양재,6236,7731,13967
<class,3호선,남부터미널,8597,7712,16309
<class,3호선,교대,1797,1278,3075
<class,3호선,고속터미널,25617,19273,44890
<class,3호선,잠원,1115,1183,2298
<class,3호선,신사,6411,6654,13065
<class,3호선,압구정,6934,7381,14315
<class,3호선,옥수,2645,2925,5570
<class,3호선,금호,2494,2377,4871
<class,3호선,동대입구,2374,2817,5191
<class,3호선,을지로3가,1195,1163,2358
<class,3호선,종로3가,1459,1887,3346
<class,3호선,안국,3288,3496,6784
<class,3호선,경복궁,4169,4406,8575
<class,3호선,독립문,2196,2446,4642
<class,3호선,무악재,1070,1122,2192
<class,3호선,홍제,5102,4978,10080
<class,3호선,녹번,3859,3599,7458
<class,3호선,불광,5886,6639,12525
<class,3호선,연신내,12780,12211,24991
<class,3호선,구파발,6026,6407,12433
<class,3호선,지축,853,872,1725
<class,2호선,용두,681,748,1429
<class,2호선,신정네거리,2808,2686,5494
<class,2호선,양천구청,1736,1750,3486
<class,2호선,도림천,278,291,569
<class,2호선,신설동,1742,1890,3632
<class,2호선,신답,370,425,795
<class,2호선,용답,950,1029,1979
<class,2호선,충정로,2018,2117,4135
<class,2호선,아현,2899,3009,5908
<class,2호선,이대,3050,3484,6534
<class,2호선,신촌,10446,10634,21080
<class,2호선,홍대입구,17297,17265,34562
<class,2호선,합정,8798,9002,17800
<class,2호선,당산,4490,4848,9338
<class,2호선,영등포구청,4462,4879,9341
<class,2호선,문래,3675,3942,7617
<class,2호선,신도림,14572,14507,29079
<class,2호선,대림,8910,8812,17722
<class,2호선,구로디지털단지,13608,13914,27522
<class,2호선,신대방,8972,9058,18030
<class,2호선,신림,21370,22647,44017
<class,2호선,봉천,7086,7396,14482
<class,2호선,서울대입구,14441,15858,30299
<class,2호선,낙성대,8457,9615,18072
<class,2호선,사당,10723,11707,22430
<class,2호선,방배,3381,3670,7051
<class,2호선,서초,3492,3270,6762
<class,2호선,교대,5078,5658,10736
<class,2호선,강남,15585,14888,30473
<class,2호선,역삼,6076,6918,12994
<class,2호선,선릉,6908,6282,13190
<class,2호선,삼성,9945,9651,19596
<class,2호선,종합운동장,1635,1846,3481
<class,2호선,잠실새내,5613,5982,11595
<class,2호선,잠실,22484,21105,43589
<class,2호선,잠실나루,2637,2785,5422
<class,2호선,강변,12926,10948,23874
<class,2호선,구의,6602,6820,13422
<class,2호선,건대입구,12637,13651,26288
<class,2호선,성수,4985,5691,10676
<class,2호선,뚝섬,3684,3942,7626
<class,2호선,한양대,1171,1361,2532
<class,2호선,왕십리,4662,4086,8748
<class,2호선,상왕십리,3770,3939,7709
<class,2호선,신당,4685,5114,9799
<class,2호선,동대문역사문화공원,3603,4537,8140
<class,2호선,을지로4가,1508,1444,2952
<class,2호선,을지로3가,2683,2471,5154
<class,2호선,을지로입구,8792,8473,17265
<class,2호선,시청,2120,1741,3861
<class,1호선,청량리,7920,7810,15730
<class,1호선,제기동,5641,6088,11729
<class,1호선,신설동,4245,4413,8658
<class,1호선,동대문,5211,5605,10816
<class,1호선,종로5가,3881,4125,8006
<class,1호선,종로3가,6507,5928,12435
<class,1호선,종각,5717,5337,11054
<class,1호선,시청,3296,3144,6440
<class,1호선,동묘앞,7806,7925,15731
<class,1호선,서울역,14459,11444,25903
<class,7호선,철산,5680,5817,11497
<class,중앙선,신원,149,97,246
<class,중앙선,국수,315,269,584
<class,6호선,상월곡,1829,1720,3549
<class,분당선,오리,5248,4483,9731
<class,분당선,미금,7974,7943,15917
<class,분당선,정자,7504,7683,15187
<class,분당선,수내,6546,6242,12788
<class,분당선,서현,13426,13329,26755
<class,분당선,야탑,11646,12516,24162
<class,분당선,모란,12226,12401,24627
<class,분당선,태평,7961,7737,15698
<class,분당선,가천대,3144,3643,6787
<class,분당선,선정릉,2305,2419,4724
<class,분당선,강남구청,3529,4042,7571
<class,분당선,압구정로데오,11461,12019,23480
<class,분당선,서울숲,3261,3280,6541
<class,분당선,수원,4786,3994,8780
<class,분당선,수서,5948,6146,12094
<class,분당선,대모산입구,1803,1655,3458
<class,분당선,개포동,1647,1666,3313
<class,분당선,구룡,865,776,1641
<class,분당선,도곡,2836,2728,5564
<class,분당선,한티,7722,7553,15275
<class,분당선,선릉,3524,5138,8662
<class,과천선,범계,12881,12522,25403
<class,과천선,평촌,6096,6114,12210
<class,과천선,인덕원,9401,9318,18719
<class,과천선,정부과천청사,3029,3175,6204
<class,과천선,과천,2512,2087,4599
<class,중앙선,지평,19,10,29
<class,과천선,대공원,1151,1270,2421
<class,과천선,경마공원,699,707,1406
<class,중앙선,양원,617,587,1204
<class,중앙선,망우,3638,3604,7242
<class,중앙선,상봉,2913,3068,5981
<class,중앙선,중랑,2883,2814,5697
<class,중앙선,회기,11556,11076,22632
<class,장항선,신창,519,484,1003
<class,장항선,온양온천,2363,2407,4770
<class,장항선,배방,552,491,1043
<class,장항선,아산,1469,1473,2942
<class,장항선,쌍용,971,836,1807
<class,장항선,봉명,509,515,1024
<class,일산선,대화,5316,5010,10326
<class,일산선,주엽,3653,3607,7260
<class,일산선,정발산,3609,3695,7304
<class,일산선,마두,3078,3113,6191
<class,일산선,백석,4916,5132,10048
<class,일산선,대곡,681,581,1262
<class,일산선,화정,7879,8243,16122
<class,일산선,원당,5024,4830,9854
<class,일산선,삼송,8452,8427,16879
<class,일산선,원흥,4077,3907,7984
<class,우이신설선,신설동,910,849,1759
<class,우이신설선,보문,791,782,1573
<class,우이신설선,성신여대입구,1772,2065,3837
<class,우이신설선,정릉,2190,1960,4150
<class,우이신설선,북한산보국문,2789,2655,5444
<class,우이신설선,솔샘,2386,2163,4549
<class,우이신설선,삼양사거리,1269,1278,2547
<class,우이신설선,삼양,1049,1173,2222
<class,우이신설선,화계,1687,1522,3209
<class,우이신설선,가오리,1864,1810,3674
<class,우이신설선,4.19민주묘지,1314,1228,2542
<class,우이신설선,솔밭공원,1157,1100,2257
<class,우이신설선,북한산우이,1345,1337,2682
<class,안산선,수리산,1861,1655,3516
<class,안산선,오이도,4153,4243,8396
<class,안산선,정왕,3975,3985,7960
<class,안산선,신길온천,799,771,1570
<class,안산선,안산,6399,6416,12815
<class,안산선,초지,1975,2020,3995
<class,안산선,고잔,3717,3666,7383
<class,안산선,중앙,8893,9288,18181
<class,안산선,한대앞,4305,4433,8738
<class,안산선,상록수,8076,8160,16236
<class,안산선,반월,2205,2070,4275
<class,안산선,대야미,2363,2085,4448
<class,안산선,산본,7640,6908,14548
<class,수인선,인천,598,977,1575
<class,중앙선,원덕,143,139,282
<class,중앙선,용문,857,978,1835
<class,수인선,신포,856,886,1742
<class,수인선,숭의,1739,1671,3410
<class,수인선,인하대,3622,3227,6849
<class,수인선,송도,1266,1187,2453
<class,수인선,연수,2457,2508,4965
<class,수인선,야목,123,102,225
<class,수인선,어천,304,285,589
<class,수인선,오목천,1196,1091,2287
<class,수인선,고색,1630,1665,3295
<class,분당선,매교,1268,1360,2628
<class,수인선,원인재,2426,2594,5020
<class,5호선,청구,1786,1615,3401
<class,수인선,남동인더스파크,782,800,1582
<class,수인선,호구포,1812,1748,3560
<class,수인선,인천논현,2952,2984,5936
<class,수인선,소래포구,2745,2925,5670
<class,수인선,월곶,1326,1323,2649
<class,수인선,달월,35,31,66
<class,수인선,사리,1772,1542,3314
<class,분당선,수원시청,7335,7815,15150
<class,분당선,매탄권선,2389,2323,4712
<class,분당선,망포,6451,6025,12476
<class,분당선,영통,4498,4454,8952
<class,분당선,청명,1876,1854,3730
<class,분당선,상갈,2548,2540,5088
<class,과천선,선바위,2948,2720,5668
<class,공항철도 1호선,영종,1433,1514,2947
<class,공항철도 1호선,인천공항2터미널,1533,1403,2936
<class,공항철도 1호선,인천공항1터미널,2344,2493,4837
<class,공항철도 1호선,공항화물청사,1153,1206,2359
<class,공항철도 1호선,운서,3579,3675,7254
<class,공항철도 1호선,청라국제도시,2272,2130,4402
<class,공항철도 1호선,검암,2791,2798,5589
<class,공항철도 1호선,계양,3483,3551,7034
<class,공항철도 1호선,김포공항,5658,3140,8798
<class,공항철도 1호선,마곡나루,1416,1386,2802
<class,공항철도 1호선,디지털미디어시티,3125,3062,6187
<class,공항철도 1호선,홍대입구,4761,4800,9561
<class,공항철도 1호선,공덕,914,1378,2292
<class,공항철도 1호선,서울역,3444,3378,6822
<class,경춘선,춘천,605,584,1189
<class,경춘선,남춘천,1199,1249,2448
<class,경춘선,김유정,113,120,233
<class,경춘선,강촌,189,212,401
<class,경춘선,백양리,119,108,227
<class,경춘선,굴봉산,37,39,76
<class,경춘선,가평,687,681,1368
<class,경춘선,상천,121,120,241
<class,경춘선,청평,618,710,1328
<class,경춘선,대성리,236,207,443
<class,경춘선,마석,1610,1620,3230
<class,경춘선,천마산,778,738,1516
<class,경춘선,평내호평,2510,2517,5027
<class,경춘선,금곡,618,567,1185
<class,경춘선,사릉,1326,1301,2627
<class,경춘선,퇴계원,1505,1441,2946
<class,경춘선,별내,1244,1245,2489
<class,경춘선,갈매,1128,1044,2172
<class,경춘선,신내,573,579,1152
<class,경인선,도화,1930,1817,3747
<class,경인선,중동,4155,3939,8094
<class,경인선,온수,2975,2753,5728
<class,경인선,도원,1375,1368,2743
<class,경인선,간석,2662,2549,5211
<class,경인선,부개,3990,3764,7754
<class,경인선,소사,4839,4529,9368
<class,경인선,구일,2575,2490,5065
<class,경인선,인천,1685,1360,3045
<class,경인선,동인천,6874,6742,13616
<class,경인선,제물포,4633,4527,9160
<class,경인선,주안,10239,9370,19609
<class,경인선,동암,8019,8354,16373
<class,경인선,백운,3419,3424,6843
<class,경인선,부평,18550,20233,38783
<class,경인선,송내,11456,11568,23024
<class,경인선,부천,18706,19707,38413
<class,경인선,역곡,12928,12990,25918
<class,경인선,오류동,5740,5583,11323
<class,경인선,개봉,10423,10438,20861
<class,경의선,임진강,6,11,17
<class,경의선,문산,2372,2431,4803
<class,경의선,파주,447,326,773
<class,경의선,월롱,829,718,1547
<class,경의선,금촌,3008,2923,5931
<class,경의선,금릉,1952,1948,3900
<class,경의선,운정,2337,2306,4643
<class,경의선,야당,2778,2679,5457
<class,경의선,탄현,3098,3159,6257
<class,경의선,일산,3441,3458,6899
<class,경의선,풍산,2248,2266,4514
<class,경의선,백마,2358,2286,4644
<class,경의선,곡산,188,201,389
<class,경의선,능곡,1503,1552,3055
<class,경의선,행신,2876,2924,5800
<class,경의선,강매,1112,963,2075
<class,경의선,화전,1611,1461,3072
<class,경의선,수색,744,732,1476
<class,경의선,디지털미디어시티,1037,970,2007
<class,경의선,가좌,2283,2237,4520
<class,경의선,홍대입구,820,931,1751
<class,경의선,서강대,981,929,1910
<class,경의선,공덕,1554,1105,2659
<class,경의선,효창공원앞,1104,1270,2374
<class,경의선,신촌,201,205,406
<class,경의선,서울역,589,664,1253
<class,경원선,소요산,1382,1191,2573
<class,경원선,동두천,883,1019,1902
<class,경원선,보산,906,919,1825
<class,경원선,동두천중앙,1381,1459,2840
<class,경원선,지행,3031,2995,6026
<class,경원선,덕정,2420,2359,4779
<class,경원선,덕계,1143,1131,2274
<class,경원선,양주,3273,3296,6569
<class,경원선,녹양,2107,2009,4116
<class,경원선,가능,3157,3127,6284
<class,경원선,의정부,10443,10907,21350
<class,경원선,회룡,5363,5504,10867
<class,경원선,망월사,3393,3437,6830
<class,경원선,도봉산,4422,2728,7150
<class,경원선,도봉,2834,2691,5525
<class,경원선,방학,4597,4534,9131
<class,경원선,녹천,2206,1970,4176
<class,경원선,월계,2953,2718,5671
<class,경원선,광운대,3589,3604,7193
<class,경원선,석계,4123,4338,8461
<class,경원선,신이문,4135,3902,8037
<class,경원선,외대앞,3832,3852,7684
<class,경원선,청량리,8046,9094,17140
<class,경원선,왕십리,7411,8676,16087
<class,경원선,응봉,815,668,1483
<class,경원선,옥수,20,17,37
<class,경원선,한남,1828,1696,3524
<class,경원선,서빙고,762,721,1483
<class,경원선,이촌,1786,1334,3120
<class,경부선,광명,1323,1188,2511
<class,경부선,서동탄,527,551,1078
<class,경부선,당정,2609,2482,5091
<class,경부선,천안,3040,3225,6265
<class,경부선,두정,3008,2973,5981
<class,경부선,직산,359,320,679
<class,경부선,성환,1643,1587,3230
<class,경부선,평택,7496,7175,14671
<class,경부선,지제,1738,1557,3295
<class,경부선,서정리,4046,3229,7275
<class,경부선,송탄,2731,2457,5188
<class,경부선,진위,647,544,1191
<class,경부선,오산,5555,5390,10945
<class,경부선,오산대,1560,1430,2990
<class,경부선,세마,1248,1111,2359
<class,경부선,병점,7141,7061,14202
<class,경부선,세류,1461,1544,3005
<class,경부선,독산,5757,5767,11524
<class,경부선,수원,21380,23025,44405
<class,경부선,화서,2886,2927,5813
<class,경부선,성균관대,6211,6181,12392
<class,경부선,의왕,3720,3693,7413
<class,경부선,군포,3119,2919,6038
<class,경부선,금정,11706,11807,23513
<class,경부선,명학,3368,3224,6592
<class,경부선,안양,11003,11050,22053
<class,경부선,관악,3329,3253,6582
<class,경부선,석수,4137,3937,8074
<class,경부선,금천구청,5092,5225,10317
<class,경부선,가산디지털단지,3829,5300,9129
<class,경부선,구로,8388,8635,17023
<class,경부선,신길,4159,3431,7590
<class,경부선,신도림,1529,1551,3080
<class,경부선,영등포,25182,25854,51036
<class,경부선,대방,4890,4863,9753
<class,경부선,노량진,4793,4605,9398
<class,경부선,용산,16928,17657,34585
<class,경부선,남영,3501,3701,7202
<class,경부선,서울역,2336,775,3111
<class,경강선,여주,994,1003,1997
<class,경강선,세종대왕릉,127,136,263
<class,경강선,부발,1171,876,2047
<class,경강선,이천,1470,1538,3008
<class,경강선,신둔도예촌,546,531,1077
<class,경강선,곤지암,1116,1017,2133
<class,경강선,초월,1452,1351,2803
<class,경강선,경기광주,3167,3145,6312
<class,경강선,삼동,958,941,1899
<class,경강선,이매,474,387,861
<class,경강선,판교,1981,1903,3884
<class,9호선2~3단계,중앙보훈병원,2537,2287,4824
<class,9호선2~3단계,둔촌오륜,449,411,860
<class,9호선2~3단계,올림픽공원,2156,2116,4272
<class,9호선2~3단계,한성백제,1228,1082,2310
<class,9호선2~3단계,송파나루,2526,2616,5142
<class,9호선2~3단계,석촌,3769,3175,6944
<class,9호선2~3단계,석촌고분,3049,2978,6027
<class,9호선2~3단계,삼전,3534,3466,7000
<class,9호선2~3단계,종합운동장,1933,1811,3744
<class,9호선2~3단계,봉은사,5856,5914,11770
<class,9호선2~3단계,삼성중앙,2156,2122,4278
<class,9호선2~3단계,선정릉,2998,3159,6157
<class,9호선2~3단계,언주,4213,4098,8311
<class,9호선,신논현,15833,15431,31264
<class,9호선,사평,1292,1292,2584
<class,9호선,고속터미널,6598,8880,15478
<class,9호선,신반포,1425,1354,2779
<class,9호선,구반포,1335,1394,2729
<class,9호선,동작,706,509,1215
<class,9호선,흑석,3588,3669,7257
<class,9호선,노들,2001,1783,3784
<class,9호선,노량진,11948,11933,23881
<class,9호선,샛강,1702,1711,3413
<class,9호선,여의도,4943,4681,9624
<class,9호선,국회의사당,2489,2518,5007
<class,9호선,당산,7724,7302,15026
<class,9호선,선유도,2257,2333,4590
<class,9호선,신목동,1270,1141,2411
<class,9호선,염창,7233,6992,14225
<class,9호선,등촌,4816,4808,9624
<class,9호선,증미,3068,3087,6155
<class,9호선,가양,9215,8906,18121
<class,9호선,양천향교,3759,3791,7550
<class,9호선,마곡나루,4506,4459,8965
<class,9호선,신방화,3134,3114,6248
<class,9호선,공항시장,1559,1695,3254
<class,9호선,김포공항,4569,6287,10856
<class,9호선,개화,799,685,1484
<class,8호선,모란,2977,2367,5344
<class,8호선,수진,3330,3108,6438
<class,8호선,신흥,2901,3177,6078
<class,8호선,단대오거리,5614,5273,10887
<class,8호선,남한산성입구,6745,6122,12867
<class,8호선,산성,3675,3704,7379
<class,8호선,복정,4489,4002,8491
<class,8호선,장지,9216,9025,18241
<class,8호선,문정,6061,6066,12127
<class,8호선,가락시장,4134,4099,8233
<class,8호선,송파,3798,3855,7653
<class,8호선,석촌,4155,4795,8950
<class,8호선,잠실,9048,9634,18682
<class,8호선,몽촌토성,2852,2854,5706
<class,8호선,강동구청,4572,4655,9227
<class,8호선,천호,9164,10522,19686
<class,8호선,암사,8812,8351,17163
<class,7호선,부평구청,4677,4280,8957
<class,7호선,굴포천,4390,4559,8949
<class,7호선,삼산체육관,1975,1874,3849
<class,7호선,상동,6299,6436,12735
<class,7호선,부천시청,6387,6480,12867
<class,7호선,신중동,6451,6444,12895
<class,7호선,춘의,3879,3836,7715
<class,7호선,부천종합운동장,1938,1745,3683
<class,7호선,까치울,3334,3440,6774
<class,7호선,온수,4078,3979,8057
<class,7호선,천왕,4646,4412,9058
<class,7호선,광명사거리,11838,11963,23801
<class,7호선,철산,10200,10223,20423
<class,7호선,가산디지털단지,11121,10329,21450
<class,7호선,남구로,6310,6580,12890
<class,7호선,대림,4836,4972,9808
<class,7호선,신풍,5733,5563,11296
<class,7호선,보라매,4035,4038,8073
<class,7호선,신대방삼거리,8109,7749,15858
<class,7호선,장승배기,4942,4738,9680
<class,7호선,상도,5006,4721,9727
<class,7호선,숭실대입구,5518,5527,11045
<class,7호선,남성,5697,5276,10973
<class,7호선,이수,7955,7516,15471
<class,7호선,내방,5808,5620,11428
<class,7호선,고속터미널,7516,6647,14163
<class,7호선,반포,3027,2806,5833
<class,7호선,논현,8041,8832,16873
<class,7호선,학동,7609,7835,15444
<class,7호선,강남구청,6596,6899,13495
<class,7호선,청담,7938,8252,16190
<class,7호선,뚝섬유원지,3235,3247,6482
<class,7호선,건대입구,7865,7517,15382
<class,7호선,어린이대공원,5485,5262,10747
<class,7호선,군자,7269,5854,13123
<class,7호선,중곡,4755,4603,9358
<class,7호선,용마산,2918,2835,5753
<class,7호선,사가정,8519,8519,17038
<class,7호선,면목,7942,7894,15836
<class,7호선,상봉,9194,8877,18071
<class,7호선,중화,5531,5433,10964
<class,7호선,먹골,5188,5274,10462
<class,7호선,태릉입구,4115,3738,7853
<class,7호선,공릉,5719,5817,11536
<class,7호선,하계,7929,7624,15553
<class,7호선,중계,6184,5597,11781
<class,7호선,노원,10695,10804,21499
<class,7호선,마들,6194,5988,12182
<class,7호선,수락산,6334,6420,12754
<class,7호선,도봉산,3657,5147,8804
<class,7호선,장암,779,486,1265
<class,6호선,봉화산,3476,3324,6800
<class,6호선,화랑대,4165,3356,7521
<class,6호선,태릉입구,2493,2684,5177
<class,6호선,석계,5872,5725,11597
<class,6호선,돌곶이,3887,3740,7627
<class,6호선,상월곡,2779,2440,5219
<class,6호선,월곡,4893,4958,9851
<class,6호선,고려대,3434,3327,6761
<class,6호선,안암,3973,3915,7888
<class,6호선,보문,3340,3079,6419
<class,6호선,창신,1563,1242,2805
<class,6호선,동묘앞,4761,4401,9162
<class,6호선,신당,3672,2964,6636
<class,6호선,청구,1648,1701,3349
<class,6호선,약수,1567,1667,3234
<class,6호선,버티고개,1016,1005,2021
<class,6호선,한강진,2830,3359,6189
<class,6호선,이태원,5244,5554,10798
<class,6호선,녹사평,2326,2493,4819
<class,6호선,삼각지,2287,2008,4295
<class,6호선,효창공원앞,2998,2769,5767
<class,6호선,공덕,6449,6241,12690
<class,6호선,대흥,3356,3271,6627
<class,6호선,광흥창,3345,3146,6491
<class,6호선,상수,4230,4757,8987
<class,6호선,합정,6773,6383,13156
<class,6호선,망원,7604,8317,15921
<class,6호선,마포구청,6307,5672,11979
<class,6호선,월드컵경기장,2413,2488,4901
<class,6호선,디지털미디어시티,4534,4720,9254
<class,6호선,증산,5086,5032,10118
<class,6호선,새절,5864,5620,11484
<class,6호선,구산,3457,2816,6273
<class,6호선,독바위,1358,1477,2835
<class,6호선,불광,2425,2202,4627
<class,6호선,역촌,1832,2062,3894
<class,6호선,응암,8381,8460,16841
<class,5호선,하남풍산,2159,2493,4652
<class,5호선,미사,6433,6434,12867
<class,5호선,마천,3016,3010,6026
<class,5호선,거여,3480,3485,6965
<class,5호선,개롱,2847,2980,5827
<class,5호선,오금,1460,1375,2835
<class,5호선,방이,3369,3298,6667
<class,5호선,올림픽공원,1756,1584,3340
<class,5호선,둔촌동,4235,4199,8434
<class,5호선,상일동,6664,6308,12972
<class,5호선,고덕,3819,3732,7551
<class,5호선,명일,3784,3836,7620
<class,5호선,굽은다리,4880,4629,9509
<class,5호선,길동,4279,4499,8778
<class,5호선,강동,9153,8577,17730
<class,5호선,천호,11652,10961,22613
<class,5호선,광나루,5639,5281,10920
<class,5호선,아차산,7439,7501,14940
<class,5호선,군자,5619,6053,11672
<class,5호선,장한평,7245,7346,14591
<class,5호선,답십리,7080,6647,13727
<class,5호선,마장,2719,2581,5300
<class,5호선,왕십리,2311,2749,5060
<class,5호선,행당,3869,3403,7272
<class,5호선,신금호,2782,2844,5626
<class,5호선,동대문역사문화공원,777,953,1730
<class,5호선,을지로4가,2132,2356,4488
<class,5호선,종로3가,5267,5296,10563
<class,5호선,광화문,7795,7786,15581
<class,5호선,서대문,4395,4189,8584
<class,5호선,충정로,1292,1179,2471
<class,5호선,애오개,2476,2385,4861
<class,5호선,공덕,4294,4731,9025
<class,5호선,마포,4755,4785,9540
<class,5호선,여의나루,2200,2195,4395
<class,5호선,여의도,5389,5592,10981
<class,5호선,신길,1704,1796,3500
<class,5호선,영등포시장,4595,4634,9229
<class,5호선,영등포구청,1284,1262,2546
<class,5호선,양평,2501,2536,5037
<class,5호선,오목교,10533,10848,21381
<class,5호선,목동,7359,7556,14915
<class,5호선,신정,6201,5282,11483
<class,5호선,까치산,14392,14053,28445
<class,5호선,화곡,13019,12245,25264
<class,5호선,우장산,6129,6289,12418
<class,5호선,발산,7784,8029,15813
<class,5호선,마곡,2972,2826,5798
<class,5호선,송정,3417,3385,6802
<class,5호선,김포공항,4624,4711,9335
<class,5호선,개화산,2343,2295,4638
<class,5호선,방화,3246,3116,6362
<class,4호선,쌍문,14322,13332,27654
<class,4호선,창동,12544,13572,26116
<class,4호선,노원,10321,11183,21504
<class,4호선,상계,9202,8710,17912
<class,4호선,당고개,5948,5849,11797
<class,4호선,남태령,482,421,903
<class,4호선,사당,11590,9885,21475
<class,4호선,총신대입구,9375,10055,19430
<class,4호선,동작,995,1004,1999
<class,4호선,이촌,2861,3135,5996
<class,4호선,신용산,5405,5855,11260
<class,4호선,삼각지,1641,1869,3510
<class,4호선,숙대입구,5503,5278,10781
<class,4호선,서울역,3078,5493,8571
<class,4호선,회현,9654,10130,19784
<class,4호선,명동,6812,7686,14498
<class,4호선,충무로,7511,7806,15317
<class,4호선,동대문역사문화공원,6687,5580,12267
<class,4호선,동대문,8469,8403,16872
<class,4호선,혜화,12723,12776,25499
<class,4호선,한성대입구,6493,6218,12711
<class,4호선,성신여대입구,10530,10214,20744
<class,4호선,길음,8498,8356,16854
<class,4호선,미아사거리,14866,14815,29681
<class,4호선,미아,7527,7309,14836
<class,4호선,수유,18027,17865,35892
<class,3호선,오금,2397,2252,4649
<class,3호선,경찰병원,2814,2717,5531
<class,3호선,가락시장,4385,4016,8401
<class,3호선,수서,7502,7631,15133
<class,3호선,일원,3653,3565,7218
<class,3호선,대청,3860,3568,7428
<class,3호선,학여울,809,788,1597
<class,3호선,대치,5580,5200,10780
<class,3호선,도곡,2264,2234,4498
<class,3호선,매봉,4000,3851,7851
<class,3호선,양재,12243,13151,25394
<class,3호선,남부터미널,12584,12628,25212
<class,3호선,교대,3958,2464,6422
<class,3호선,고속터미널,28566,28244,56810
<class,3호선,잠원,2187,2012,4199
<class,3호선,신사,16581,16975,33556
<class,3호선,압구정,17258,17460,34718
<class,3호선,옥수,4153,4337,8490
<class,3호선,금호,3977,3722,7699
<class,3호선,약수,6102,5720,11822
<class,3호선,동대입구,2935,3145,6080
<class,3호선,을지로3가,2947,3198,6145
<class,3호선,종로3가,2791,3670,6461
<class,3호선,안국,5362,5784,11146
<class,3호선,경복궁,6056,5991,12047
<class,3호선,독립문,3189,3245,6434
<class,3호선,무악재,1758,1781,3539
<class,3호선,홍제,8332,8123,16455
<class,3호선,녹번,6500,5730,12230
<class,3호선,불광,8082,9168,17250
<class,3호선,연신내,19367,18600,37967
<class,3호선,구파발,9151,9183,18334
<class,3호선,지축,1290,1321,2611
<class,2호선,용두,1131,1106,2237
<class,2호선,신정네거리,4491,4718,9209
<class,2호선,양천구청,2765,2959,5724
<class,2호선,도림천,686,656,1342
<class,2호선,신설동,2119,1956,4075
<class,2호선,신답,603,668,1271
<class,2호선,용답,1395,1308,2703
<class,2호선,충정로,3544,3646,7190
<class,2호선,아현,4843,4757,9600
<class,2호선,이대,5859,5923,11782
<class,2호선,신촌,18366,18536,36902
<class,2호선,홍대입구,28225,29239,57464
<class,2호선,합정,14700,15157,29857
<class,2호선,당산,7268,8070,15338
<class,2호선,영등포구청,8367,8590,16957
<class,2호선,문래,7311,7493,14804
<class,2호선,신도림,25220,25470,50690
<class,2호선,대림,12001,12852,24853
<class,2호선,구로디지털단지,23215,23597,46812
<class,2호선,신대방,13475,13401,26876
<class,2호선,신림,35077,34224,69301
<class,2호선,봉천,12101,11561,23662
<class,2호선,서울대입구,24782,23907,48689
<class,2호선,낙성대,14298,13590,27888
<class,2호선,사당,17801,18888,36689
<class,2호선,방배,6461,6640,13101
<class,2호선,서초,6089,5511,11600
<class,2호선,교대,11005,12060,23065
<class,2호선,강남,36597,35527,72124
<class,2호선,역삼,13663,14337,28000
<class,2호선,선릉,15665,14007,29672
<class,2호선,삼성,18302,18113,36415
<class,2호선,종합운동장,2604,2778,5382
<class,2호선,잠실새내,10943,11288,22231
<class,2호선,잠실,35370,34201,69571
<class,2호선,잠실나루,4631,4478,9109
<class,2호선,강변,14590,14675,29265
<class,2호선,구의,11171,11265,22436
<class,2호선,건대입구,19175,20984,40159
<class,2호선,성수,9338,10213,19551
<class,2호선,뚝섬,6554,6738,13292
<class,2호선,한양대,2734,2725,5459
<class,2호선,왕십리,8790,7365,16155
<class,2호선,상왕십리,6368,6105,12473
<class,2호선,신당,7195,7357,14552
<class,2호선,동대문역사문화공원,5569,5751,11320
<class,2호선,을지로4가,4848,4813,9661
<class,2호선,을지로3가,5270,5208,10478
<class,2호선,을지로입구,13031,13002,26033
<class,2호선,시청,3740,3266,7006
<class,1호선,청량리,11244,10953,22197
<class,1호선,제기동,8808,9038,17846
<class,1호선,신설동,5946,5950,11896
<class,1호선,동대문,6780,6012,12792
<class,1호선,종로5가,10212,10244,20456
<class,1호선,종로3가,11016,10443,21459
<class,1호선,종각,9390,8893,18283
<class,1호선,시청,4859,4737,9596
<class,1호선,동묘앞,6238,6212,12450
<class,1호선,서울역,15359,14965,30324
<class,분당선,기흥,4592,4346,8938
<class,분당선,신갈,1933,1912,3845
<class,분당선,구성,2060,2173,4233
<class,분당선,죽전,7036,7903,14939
<class,분당선,보정,971,871,1842
<class,분당선,이매,2540,2497,5037
<class,중앙선,구리,6151,6512,12663
<class,중앙선,양평,1245,1222,2467
<class,중앙선,오빈,132,139,271
<class,중앙선,아신,248,240,488
<class,중앙선,국수,292,322,614
<class,중앙선,신원,81,98,179
<class,중앙선,양수,843,865,1708
<class,중앙선,운길산,389,431,820
<class,중앙선,팔당,601,639,1240
<class,중앙선,도심,936,828,1764
<class,중앙선,덕소,2619,2611,5230
<class,중앙선,양정,294,259,553
<class,중앙선,도농,3852,3836,7688
<class,2호선,건대입구,14025,14833,28858
<class,5호선,서대문,3088,2994,6082
<class,2호선,삼성,12179,11868,24047
<class,2호선,선릉,8310,7174,15484
<class,2호선,역삼,7045,7794,14839
<class,2호선,강남,17351,16793,34144
<class,2호선,교대,5905,6568,12473
<class,2호선,서초,3591,3318,6909
<class,2호선,방배,3907,4211,8118
<class,2호선,사당,11467,12736,24203
<class,2호선,낙성대,9578,9799,19377
<class,2호선,서울대입구,16483,16693,33176
<class,2호선,봉천,7943,7841,15784
<class,2호선,신림,23886,23482,47368
<class,2호선,신대방,9748,9337,19085
<class,2호선,구로디지털단지,14857,14606,29463
<class,2호선,대림,9403,9330,18733
<class,2호선,신도림,16492,16363,32855
<class,2호선,문래,3870,4086,7956
<class,2호선,영등포구청,4910,4903,9813
<class,2호선,당산,4915,5302,10217
<class,2호선,합정,10019,10182,20201
<class,2호선,홍대입구,20726,20287,41013
<class,2호선,신촌,12334,11965,24299
<class,2호선,이대,3650,3871,7521
<class,2호선,아현,3033,3090,6123
<class,2호선,충정로,2316,2393,4709
<class,2호선,용답,1042,1104,2146
<class,2호선,신답,383,421,804
<class,2호선,신설동,1737,1768,3505
<class,2호선,도림천,314,304,618
<class,2호선,양천구청,1770,1854,3624
<class,2호선,신정네거리,2847,2896,5743
<class,2호선,용두,679,664,1343
<class,3호선,지축,926,906,1832
<class,3호선,구파발,6049,6270,12319
<class,3호선,연신내,13286,12627,25913
<class,3호선,불광,5814,6551,12365
<class,3호선,녹번,4077,3753,7830
<class,3호선,무악재,1112,1162,2274
<class,중앙선,용문,1079,936,2015
<class,중앙선,원덕,145,105,250
<class,중앙선,양평,973,946,1919
<class,중앙선,오빈,91,89,180
<class,중앙선,아신,193,185,378
<class,중앙선,국수,250,258,508
<class,중앙선,신원,126,74,200
<class,중앙선,양수,730,713,1443
<class,중앙선,운길산,566,502,1068
<class,중앙선,팔당,700,730,1430
<class,중앙선,도심,693,658,1351
<class,중앙선,덕소,1941,1953,3894
<class,중앙선,양정,212,187,399
<class,중앙선,도농,2610,2643,5253
<class,중앙선,구리,4328,4598,8926
<class,중앙선,양원,425,495,920
<class,중앙선,망우,2528,2482,5010
<class,중앙선,상봉,2228,2131,4359
<class,중앙선,중랑,2044,1957,4001
<class,중앙선,회기,8376,8366,16742
<class,장항선,신창,459,488,947
<class,장항선,온양온천,1867,1958,3825
<class,장항선,배방,381,471,852
<class,장항선,아산,1500,1151,2651
<class,장항선,쌍용,687,695,1382
<class,장항선,봉명,367,343,710
<class,일산선,대화,3783,3549,7332
<class,일산선,주엽,2429,2394,4823
<class,일산선,정발산,2723,2664,5387
<class,일산선,마두,1903,1905,3808
<class,일산선,백석,3586,3509,7095
<class,일산선,대곡,528,395,923
<class,일산선,화정,5534,5747,11281
<class,일산선,원당,3622,3568,7190
<class,일산선,삼송,6259,6203,12462
<class,일산선,원흥,2809,2714,5523
<class,우이신설선,신설동,676,647,1323
<class,우이신설선,보문,533,564,1097
<class,우이신설선,성신여대입구,1224,1411,2635
<class,우이신설선,정릉,1517,1344,2861
<class,우이신설선,북한산보국문,2033,1946,3979
<class,우이신설선,솔샘,1567,1417,2984
<class,우이신설선,삼양사거리,907,913,1820
<class,우이신설선,삼양,715,749,1464
<class,우이신설선,화계,1212,1126,2338
<class,우이신설선,가오리,1404,1340,2744
<class,우이신설선,4.19민주묘지,1158,968,2126
<class,우이신설선,솔밭공원,831,833,1664
<class,우이신설선,북한산우이,1435,1454,2889
<class,안산선,수리산,1258,1184,2442
<class,안산선,오이도,3103,3024,6127
<class,안산선,정왕,2969,3182,6151
<class,안산선,신길온천,604,560,1164
<class,안산선,안산,6123,5547,11670
<class,안산선,초지,1309,1271,2580
<class,안산선,고잔,2439,2333,4772
<class,안산선,중앙,6295,6171,12466
<class,안산선,한대앞,3024,2981,6005
<class,안산선,상록수,5626,5510,11136
<class,안산선,반월,1424,1504,2928
<class,안산선,대야미,1680,1524,3204
<class,안산선,산본,4923,4359,9282
<class,수인선,인천,489,759,1248
<class,수인선,신포,627,558,1185
<class,수인선,숭의,1216,1115,2331
<class,수인선,인하대,1910,1805,3715
<class,수인선,송도,890,905,1795
<class,수인선,연수,1758,1723,3481
<class,수인선,원인재,1752,1763,3515
<class,수인선,남동인더스파크,370,400,770
<class,수인선,호구포,1168,1204,2372
<class,수인선,인천논현,1793,1862,3655
<class,수인선,소래포구,2473,2419,4892
<class,수인선,월곶,962,928,1890
<class,수인선,달월,32,29,61
<class,수인선,사리,1266,1120,2386
<class,수인선,야목,81,74,155
<class,수인선,어천,211,293,504
<class,수인선,오목천,786,752,1538
<class,수인선,고색,969,942,1911
<class,분당선,매교,822,840,1662
<class,분당선,수원시청,4634,4490,9124
<class,분당선,매탄권선,1503,1489,2992
<class,분당선,망포,3974,4203,8177
<class,분당선,영통,2761,2629,5390
<class,분당선,청명,1157,1150,2307
<class,분당선,상갈,1721,1708,3429
<class,분당선,기흥,3009,2960,5969
<class,분당선,신갈,1153,1236,2389
<class,분당선,구성,1307,1384,2691
<class,분당선,죽전,4589,5145,9734
<class,분당선,보정,615,572,1187
<class,분당선,이매,1579,1619,3198
<class,분당선,오리,3411,3058,6469
<class,분당선,미금,4424,4289,8713
<class,분당선,정자,4678,4848,9526
<class,분당선,수내,4074,3991,8065
<class,분당선,서현,8923,8905,17828
<class,분당선,야탑,7717,7977,15694
<class,분당선,모란,6923,7069,13992
<class,분당선,태평,5380,5044,10424
<class,분당선,가천대,2156,2651,4807
<class,분당선,선정릉,1379,1464,2843
<class,분당선,강남구청,1904,2310,4214
<class,분당선,압구정로데오,5921,6288,12209
<class,분당선,서울숲,2193,2215,4408
<class,분당선,수원,3428,2951,6379
<class,분당선,수서,4379,4461,8840
<class,분당선,대모산입구,911,827,1738
<class,분당선,개포동,1038,1034,2072
<class,분당선,구룡,340,379,719
<class,분당선,도곡,1431,1427,2858
<class,분당선,한티,4615,4645,9260
<class,분당선,선릉,1847,2532,4379
<class,과천선,범계,8451,8084,16535
<class,과천선,평촌,3806,3700,7506
<class,과천선,인덕원,6125,6231,12356
<class,과천선,정부과천청사,2140,2134,4274
<class,과천선,과천,1649,1422,3071
<class,과천선,대공원,1362,1488,2850
<class,과천선,경마공원,534,514,1048
<class,과천선,선바위,1855,1895,3750
<class,공항철도 1호선,영종,1211,1154,2365
<class,공항철도 1호선,인천공항2터미널,1415,1392,2807
<class,공항철도 1호선,인천공항1터미널,2340,2434,4774
<class,공항철도 1호선,공항화물청사,858,899,1757
<class,공항철도 1호선,운서,2917,3110,6027
<class,공항철도 1호선,청라국제도시,1624,1509,3133
<class,공항철도 1호선,검암,2146,2124,4270
<class,공항철도 1호선,계양,2567,2517,5084
<class,공항철도 1호선,김포공항,5375,2999,8374
<class,공항철도 1호선,마곡나루,981,1044,2025
<class,공항철도 1호선,디지털미디어시티,2061,2048,4109
<class,공항철도 1호선,홍대입구,3779,3464,7243
<class,공항철도 1호선,공덕,597,794,1391
<class,공항철도 1호선,서울역,3342,2723,6065
<class,경춘선,춘천,578,559,1137
<class,경춘선,남춘천,1149,1141,2290
<class,경춘선,김유정,199,187,386
<class,경춘선,강촌,278,250,528
<class,경춘선,백양리,110,112,222
<class,경춘선,굴봉산,68,79,147
<class,경춘선,가평,585,551,1136
<class,경춘선,상천,136,122,258
<class,경춘선,청평,643,539,1182
<class,경춘선,대성리,220,166,386
<class,경춘선,마석,1209,1210,2419
<class,경춘선,천마산,596,591,1187
<class,경춘선,평내호평,1835,1715,3550
<class,경춘선,금곡,465,437,902
<class,경춘선,사릉,896,982,1878
<class,경춘선,퇴계원,1125,1055,2180
<class,경춘선,별내,921,888,1809
<class,경춘선,갈매,803,701,1504
<class,경춘선,신내,400,441,841
<class,경인선,도화,1393,1328,2721
<class,경인선,중동,2889,2656,5545
<class,경인선,온수,1941,1913,3854
<class,경인선,도원,900,918,1818
<class,경인선,간석,1940,1820,3760
<class,경인선,부개,2729,2589,5318
<class,경인선,소사,3515,3382,6897
<class,경인선,구일,1766,1737,3503
<class,경인선,인천,1444,1169,2613
<class,경인선,동인천,5237,5054,10291
<class,경인선,제물포,3327,3233,6560
<class,경인선,주안,7157,6316,13473
<class,경인선,동암,5900,5771,11671
<class,경인선,백운,2359,2289,4648
<class,경인선,부평,13550,13867,27417
<class,경인선,송내,7609,7504,15113
<class,경인선,부천,13245,12799,26044
<class,경인선,역곡,9003,8738,17741
<class,경인선,오류동,3984,3772,7756
<class,경인선,개봉,7134,7042,14176
<class,경의선,임진강,11,10,21
<class,경의선,문산,1779,1764,3543
<class,경의선,파주,324,277,601
<class,경의선,월롱,453,860,1313
<class,경의선,금촌,2240,2478,4718
<class,경의선,금릉,1430,1393,2823
<class,경의선,운정,1772,1680,3452
<class,경의선,야당,2038,1875,3913
<class,경의선,탄현,2125,2097,4222
<class,경의선,일산,2423,2316,4739
<class,경의선,풍산,1792,1591,3383
<class,경의선,백마,1661,1688,3349
<class,경의선,곡산,139,145,284
<class,경의선,능곡,1198,1154,2352
<class,경의선,행신,2156,2170,4326
<class,경의선,강매,728,728,1456
<class,경의선,화전,426,404,830
<class,경의선,수색,497,513,1010
<class,경의선,디지털미디어시티,686,644,1330
<class,경의선,가좌,1486,1514,3000
<class,경의선,홍대입구,683,683,1366
<class,경의선,서강대,626,660,1286
<class,경의선,공덕,953,740,1693
<class,경의선,효창공원앞,744,873,1617
<class,경의선,신촌,126,140,266
<class,경의선,서울역,450,450,900
<class,경원선,소요산,1705,1482,3187
<class,경원선,동두천,712,814,1526
<class,경원선,보산,774,697,1471
<class,경원선,동두천중앙,1187,1169,2356
<class,경원선,지행,2421,2287,4708
<class,경원선,덕정,1886,1910,3796
<class,경원선,덕계,876,768,1644
<class,경원선,양주,2451,2476,4927
<class,경원선,녹양,1515,1476,2991
<class,경원선,가능,2298,2182,4480
<class,경원선,의정부,8148,8021,16169
<class,경원선,회룡,3845,3783,7628
<class,경원선,망월사,2491,2495,4986
<class,경원선,도봉산,4527,3068,7595
<class,경원선,도봉,2048,1886,3934
<class,경원선,방학,3248,3175,6423
<class,경원선,녹천,1562,1300,2862
<class,경원선,월계,2066,1919,3985
<class,경원선,광운대,2580,2585,5165
<class,경원선,석계,2860,3063,5923
<class,경원선,신이문,2935,2670,5605
<class,경원선,외대앞,2840,2704,5544
<class,경원선,청량리,6799,6746,13545
<class,경원선,왕십리,5011,5648,10659
<class,경원선,응봉,568,530,1098
<class,경원선,옥수,35,17,52
<class,경원선,한남,1192,1185,2377
<class,경원선,서빙고,501,510,1011
<class,경원선,이촌,1093,938,2031
<class,경부선,광명,1170,926,2096
<class,경부선,서동탄,444,397,841
<class,경부선,당정,1785,1762,3547
<class,경부선,천안,3057,2966,6023
<class,경부선,두정,2291,2557,4848
<class,경부선,직산,281,333,614
<class,경부선,성환,1365,1568,2933
<class,경부선,평택,6295,6716,13011
<class,경부선,지제,1170,1214,2384
<class,경부선,서정리,2359,3572,5931
<class,경부선,송탄,2141,2343,4484
<class,경부선,진위,406,436,842
<class,경부선,오산,4387,4786,9173
<class,경부선,오산대,1189,1122,2311
<class,경부선,세마,871,831,1702
<class,경부선,병점,5095,5691,10786
<class,경부선,세류,1128,1181,2309
<class,경부선,독산,3516,3575,7091
<class,경부선,수원,18411,18242,36653
<class,경부선,화서,2037,2017,4054
<class,경부선,성균관대,4366,4591,8957
<class,경부선,의왕,2481,2596,5077
<class,경부선,군포,2104,2182,4286
<class,경부선,금정,7977,8537,16514
<class,경부선,명학,2138,2083,4221
<class,경부선,안양,8110,7804,15914
<class,경부선,관악,2601,2431,5032
<class,경부선,석수,3021,2943,5964
<class,경부선,금천구청,3597,3575,7172
<class,경부선,가산디지털단지,2720,3668,6388
<class,경부선,구로,5944,5923,11867
<class,경부선,신길,2956,2468,5424
<class,경부선,신도림,1083,1106,2189
<class,경부선,영등포,19529,18997,38526
<class,경부선,대방,3304,3676,6980
<class,경부선,노량진,3418,3293,6711
<class,경부선,용산,14700,13261,27961
<class,경부선,남영,2260,2499,4759
<class,경부선,서울역,2766,678,3444
<class,경강선,여주,842,758,1600
<class,경강선,세종대왕릉,111,112,223
<class,경강선,부발,692,1259,1951
<class,경강선,이천,1056,1194,2250
<class,경강선,신둔도예촌,408,418,826
<class,경강선,곤지암,747,885,1632
<class,경강선,초월,870,924,1794
<class,경강선,경기광주,2155,2168,4323
<class,경강선,삼동,567,582,1149
<class,경강선,이매,341,236,577
<class,경강선,판교,1529,1399,2928
<class,9호선2~3단계,중앙보훈병원,1782,1737,3519
<class,9호선2~3단계,둔촌오륜,281,261,542
<class,9호선2~3단계,올림픽공원,1546,1547,3093
<class,9호선2~3단계,한성백제,799,693,1492
<class,9호선2~3단계,송파나루,1675,1758,3433
<class,9호선2~3단계,석촌,2588,2192,4780
<class,9호선2~3단계,석촌고분,2028,2046,4074
<class,9호선2~3단계,삼전,2402,2399,4801
<class,9호선2~3단계,종합운동장,1178,1128,2306
<class,9호선2~3단계,봉은사,4184,4049,8233
<class,9호선2~3단계,삼성중앙,1234,1325,2559
<class,9호선2~3단계,선정릉,1871,2078,3949
<class,9호선2~3단계,언주,2280,2272,4552
<class,9호선,신논현,8298,8100,16398
<class,9호선,사평,743,823,1566
<class,9호선,고속터미널,5219,6506,11725
<class,9호선,신반포,728,766,1494
<class,9호선,구반포,734,739,1473
<class,9호선,동작,513,431,944
<class,9호선,흑석,4422,3844,8266
<class,9호선,노들,1498,1312,2810
<class,9호선,노량진,8147,9035,17182
<class,9호선,샛강,1003,1043,2046
<class,9호선,여의도,3277,3022,6299
<class,9호선,국회의사당,1833,1815,3648
<class,9호선,당산,4977,4886,9863
<class,9호선,선유도,1448,1465,2913
<class,9호선,신목동,921,831,1752
<class,9호선,염창,4888,4930,9818
<class,9호선,등촌,2980,3060,6040
<class,9호선,증미,1564,1591,3155
<class,9호선,가양,5874,5885,11759
<class,9호선,양천향교,2482,2569,5051
<class,9호선,마곡나루,2885,2950,5835
<class,9호선,신방화,2060,1976,4036
<class,9호선,공항시장,984,1130,2114
<class,9호선,김포공항,4012,5420,9432
<class,9호선,개화,600,535,1135
<class,8호선,모란,1736,1424,3160
<class,8호선,수진,2107,1852,3959
<class,8호선,신흥,1992,2060,4052
<class,8호선,단대오거리,3404,3548,6952
<class,8호선,남한산성입구,4306,4021,8327
<class,8호선,산성,2528,2574,5102
<class,8호선,복정,2668,2706,5374
<class,8호선,장지,6121,6781,12902
<class,8호선,문정,3461,3637,7098
<class,8호선,가락시장,1872,2609,4481
<class,8호선,송파,2338,2469,4807
<class,8호선,석촌,2562,3018,5580
<class,8호선,잠실,6210,6409,12619
<class,8호선,몽촌토성,1893,1913,3806
<class,8호선,강동구청,2761,2994,5755
<class,8호선,천호,5905,6642,12547
<class,8호선,암사,5736,5314,11050
<class,7호선,부평구청,3087,2653,5740
<class,7호선,굴포천,2728,2746,5474
<class,7호선,삼산체육관,1247,1186,2433
<class,7호선,상동,3884,3649,7533
<class,7호선,부천시청,4025,3939,7964
<class,7호선,신중동,4078,3996,8074
<class,7호선,춘의,2131,2052,4183
<class,7호선,부천종합운동장,1264,1209,2473
<class,7호선,까치울,2223,2192,4415
<class,7호선,온수,2448,2372,4820
<class,7호선,천왕,2930,2887,5817
<class,7호선,광명사거리,7910,7893,15803
<class,7호선,철산,6309,6322,12631
<class,7호선,가산디지털단지,7230,6687,13917
<class,7호선,남구로,4590,4403,8993
<class,7호선,대림,4006,3731,7737
<class,7호선,신풍,3745,3511,7256
<class,7호선,보라매,2741,2642,5383
<class,7호선,신대방삼거리,5408,5345,10753
<class,7호선,장승배기,3341,3186,6527
<class,7호선,상도,4984,4704,9688
<class,7호선,숭실대입구,3479,3605,7084
<class,7호선,남성,3497,3592,7089
<class,7호선,이수,4851,4583,9434
<class,7호선,내방,3445,3490,6935
<class,7호선,고속터미널,6412,4717,11129
<class,7호선,반포,1693,1766,3459
<class,7호선,논현,4205,4444,8649
<class,7호선,학동,3786,3999,7785
<class,7호선,강남구청,3622,3856,7478
<class,7호선,청담,4082,4272,8354
<class,7호선,뚝섬유원지,2344,2263,4607
<class,7호선,건대입구,4941,4676,9617
<class,7호선,어린이대공원,4161,4021,8182
<class,7호선,군자,4695,3741,8436
<class,7호선,중곡,3169,3165,6334
<class,7호선,용마산,1962,2120,4082
<class,7호선,사가정,5693,5685,11378
<class,7호선,면목,5095,5205,10300
<class,7호선,상봉,5681,5280,10961
<class,7호선,중화,3552,3575,7127
<class,7호선,먹골,3324,3351,6675
<class,7호선,태릉입구,2740,2507,5247
<class,7호선,공릉,3927,4041,7968
<class,7호선,하계,5201,4987,10188
<class,7호선,중계,4054,3786,7840
<class,7호선,노원,7082,6798,13880
<class,7호선,마들,3538,3330,6868
<class,7호선,수락산,4700,4767,9467
<class,7호선,도봉산,2863,4286,7149
<class,7호선,장암,578,329,907
<class,6호선,봉화산,2240,2204,4444
<class,6호선,화랑대,2675,2334,5009
<class,6호선,태릉입구,1760,1865,3625
<class,6호선,석계,3941,4074,8015
<class,6호선,돌곶이,2643,2480,5123
<class,6호선,상월곡,1884,1673,3557
<class,6호선,월곡,3192,3182,6374
<class,6호선,고려대,2345,2317,4662
<class,6호선,안암,2864,2841,5705
<class,6호선,보문,2400,2265,4665
<class,6호선,창신,965,854,1819
<class,6호선,동묘앞,3551,3461,7012
<class,6호선,신당,1965,2802,4767
<class,6호선,청구,1093,1013,2106
<class,6호선,약수,1026,1008,2034
<class,6호선,버티고개,677,705,1382
<class,6호선,한강진,2177,2365,4542
<class,6호선,이태원,4226,4052,8278
<class,6호선,녹사평,1773,1718,3491
<class,6호선,삼각지,1639,1352,2991
<class,6호선,효창공원앞,1990,1817,3807
<class,6호선,공덕,3702,3498,7200
<class,6호선,대흥,2199,2202,4401
<class,6호선,광흥창,2270,2174,4444
<class,6호선,합정,4718,4226,8944
<class,6호선,망원,5204,5578,10782
<class,6호선,마포구청,4388,4003,8391
<class,6호선,월드컵경기장,1621,1562,3183
<class,6호선,디지털미디어시티,3076,3244,6320
<class,6호선,증산,3395,3461,6856
<class,6호선,새절,3962,3891,7853
<class,6호선,구산,2342,1796,4138
<class,6호선,연신내,1,0,1
<class,6호선,독바위,893,1075,1968
<class,6호선,불광,1820,1690,3510
<class,6호선,역촌,1137,1366,2503
<class,6호선,응암,5360,5487,10847
<class,5호선,하남풍산,1676,1811,3487
<class,5호선,미사,4277,4231,8508
<class,5호선,마천,1928,2054,3982
<class,5호선,거여,2195,2112,4307
<class,5호선,개롱,1767,1917,3684
<class,5호선,오금,961,953,1914
<class,5호선,방이,2207,2154,4361
<class,5호선,올림픽공원,1132,1005,2137
<class,5호선,둔촌동,2691,2787,5478
<class,5호선,상일동,4186,4092,8278
<class,5호선,고덕,2289,2214,4503
<class,5호선,명일,2363,2419,4782
<class,5호선,굽은다리,3039,2986,6025
<class,5호선,길동,2613,2805,5418
<class,5호선,강동,5650,5537,11187
<class,5호선,천호,7777,7267,15044
<class,5호선,광나루,4117,3936,8053
<class,5호선,아차산,5599,5679,11278
<class,5호선,군자,3650,4031,7681
<class,5호선,장한평,4473,4464,8937
<class,5호선,답십리,4308,4115,8423
<class,5호선,마장,1811,1785,3596
<class,5호선,왕십리,1445,1599,3044
<class,5호선,행당,2312,2156,4468
<class,5호선,신금호,1831,1951,3782
<class,5호선,청구,1058,1040,2098
<class,5호선,동대문역사문화공원,494,586,1080
<class,5호선,을지로4가,731,765,1496
<class,5호선,종로3가,3553,3172,6725
<class,5호선,광화문,5596,5671,11267
<class,5호선,충정로,907,911,1818
<class,5호선,애오개,1617,1699,3316
<class,5호선,공덕,2587,2628,5215
<class,5호선,마포,2955,2942,5897
<class,5호선,여의나루,1620,1627,3247
<class,5호선,여의도,3404,3799,7203
<class,5호선,신길,1139,1346,2485
<class,5호선,영등포시장,2667,2836,5503
<class,5호선,영등포구청,746,767,1513
<class,5호선,양평,1607,1606,3213
<class,5호선,오목교,7074,7306,14380
<class,5호선,목동,4596,4796,9392
<class,5호선,신정,3883,3484,7367
<class,5호선,까치산,9640,9480,19120
<class,5호선,화곡,8524,8161,16685
<class,5호선,우장산,3782,3954,7736
<class,5호선,발산,4795,4871,9666
<class,3호선,홍제,5427,5306,10733
<class,5호선,마곡,1838,1860,3698
<class,5호선,송정,2230,2248,4478
<class,5호선,김포공항,4021,3775,7796
<class,5호선,개화산,1631,1727,3358
<class,5호선,방화,2144,2138,4282
<class,4호선,쌍문,9606,8783,18389
<class,4호선,창동,8650,9191,17841
<class,4호선,노원,7098,7767,14865
<class,4호선,상계,6204,5880,12084
<class,4호선,당고개,4619,4510,9129
<class,4호선,남태령,336,284,620
<class,4호선,사당,7774,7898,15672
<class,4호선,총신대입구,5930,6419,12349
<class,4호선,동작,843,898,1741
<class,4호선,이촌,1831,2123,3954
<class,4호선,신용산,3719,3828,7547
<class,4호선,삼각지,1040,1216,2256
<class,4호선,숙대입구,3417,3332,6749
<class,4호선,서울역,2268,4107,6375
<class,4호선,회현,5037,5111,10148
<class,4호선,명동,5013,4977,9990
<class,4호선,충무로,5269,5230,10499
<class,4호선,동대문역사문화공원,5097,5062,10159
<class,4호선,동대문,3549,4145,7694
<class,4호선,혜화,9476,9784,19260
<class,4호선,한성대입구,4368,4367,8735
<class,4호선,성신여대입구,7482,7193,14675
<class,4호선,길음,5802,5729,11531
<class,4호선,미아사거리,9877,9444,19321
<class,4호선,미아,4947,4730,9677
<class,4호선,수유,12588,11992,24580
<class,3호선,오금,1679,1636,3315
<class,3호선,경찰병원,1673,1680,3353
<class,3호선,가락시장,2193,2416,4609
<class,3호선,수서,5559,5521,11080
<class,3호선,일원,2092,2275,4367
<class,3호선,대청,2542,2400,4942
<class,3호선,학여울,529,530,1059
<class,3호선,대치,3146,2984,6130
<class,3호선,도곡,1169,1233,2402
<class,3호선,매봉,2539,2571,5110
<class,3호선,양재,7309,8558,15867
<class,3호선,남부터미널,8132,8433,16565
<class,3호선,교대,2153,1502,3655
<class,3호선,고속터미널,22270,21035,43305
<class,3호선,잠원,1189,1231,2420
<class,3호선,신사,7995,8190,16185
<class,3호선,압구정,7621,7828,15449
<class,3호선,옥수,2819,3098,5917
<class,3호선,금호,2673,2619,5292
<class,3호선,약수,3774,3689,7463
<class,3호선,동대입구,5938,5922,11860
<class,3호선,을지로3가,1423,1390,2813
<class,3호선,종로3가,1715,2168,3883
<class,3호선,안국,3727,3854,7581
<class,3호선,경복궁,4190,4281,8471
<class,3호선,독립문,2146,2278,4424
<class,6호선,상수,2846,3187,6033
<class,1호선,서울역,12915,11442,24357
<class,1호선,동묘앞,7170,7380,14550
<class,1호선,시청,3543,3372,6915
<class,1호선,종각,6303,6017,12320
<class,1호선,종로3가,7088,6445,13533
<class,1호선,종로5가,4146,4306,8452
<class,1호선,동대문,5239,5553,10792
<class,1호선,신설동,4365,4328,8693
<class,1호선,제기동,5566,5871,11437
<class,중앙선,지평,20,14,34
<class,2호선,성수,5572,6036,11608
<class,2호선,뚝섬,4407,4478,8885
<class,2호선,한양대,4616,4035,8651
<class,2호선,왕십리,5598,4955,10553
<class,2호선,상왕십리,4128,4090,8218
<class,2호선,신당,5072,5279,10351
<class,2호선,동대문역사문화공원,4167,5171,9338
<class,1호선,청량리,8164,7965,16129
<class,2호선,시청,2474,1960,4434
<class,2호선,을지로입구,9868,9566,19434
<class,2호선,을지로3가,3377,2991,6368
<class,2호선,을지로4가,1759,1664,3423
<class,2호선,종합운동장,1713,1821,3534
<class,2호선,잠실새내,6410,6788,13198
<class,2호선,잠실,24208,23250,47458
<class,2호선,잠실나루,2868,2999,5867
<class,2호선,강변,11181,11111,22292
<class,2호선,구의,7214,7361,14575
<class,분당선,수내,6627,6287,12914
<class,3호선,잠원,2232,2123,4355
<class,경원선,양주,4236,4081,8317
<class,1호선,서울역,18125,17851,35976
<class,1호선,동묘앞,8746,9028,17774
<class,1호선,시청,6143,6108,12251
<class,1호선,종각,11176,10574,21750
<class,1호선,종로3가,14145,13348,27493
<class,1호선,종로5가,13292,13110,26402
<class,1호선,동대문,8287,7502,15789
<class,1호선,신설동,7252,7007,14259
<class,1호선,제기동,13126,13672,26798
<class,1호선,청량리,15013,15017,30030
<class,2호선,시청,5338,4594,9932
<class,2호선,을지로입구,14577,14347,28924
<class,2호선,을지로3가,6165,6093,12258
<class,2호선,을지로4가,6196,6297,12493
<class,2호선,동대문역사문화공원,6746,7112,13858
<class,2호선,신당,8298,8521,16819
<class,2호선,상왕십리,7105,6846,13951
<class,2호선,왕십리,9363,7932,17295
<class,2호선,한양대,2566,2436,5002
<class,2호선,뚝섬,7326,7811,15137
<class,2호선,성수,10701,11559,22260
<class,2호선,건대입구,22665,24503,47168
<class,2호선,구의,12330,12306,24636
<class,2호선,강변,16861,17274,34135
<class,2호선,잠실나루,5149,4976,10125
<class,2호선,잠실,39752,37982,77734
<class,2호선,잠실새내,11731,12214,23945
<class,2호선,종합운동장,2875,3015,5890
<class,2호선,삼성,19054,18846,37900
<class,2호선,선릉,17347,15251,32598
<class,2호선,역삼,14263,15158,29421
<class,2호선,강남,40353,39736,80089
<class,2호선,교대,12072,13097,25169
<class,2호선,서초,6781,6095,12876
<class,2호선,방배,7435,7674,15109
<class,2호선,사당,19741,21643,41384
<class,2호선,낙성대,16066,15383,31449
<class,2호선,서울대입구,27892,27010,54902
<class,2호선,봉천,13240,12487,25727
<class,2호선,신림,38116,37059,75175
<class,2호선,신대방,14915,14833,29748
<class,2호선,구로디지털단지,26077,26266,52343
<class,2호선,대림,13932,15010,28942
<class,2호선,신도림,28644,28212,56856
<class,2호선,문래,8076,8332,16408
<class,2호선,영등포구청,9231,9314,18545
<class,2호선,당산,8790,9540,18330
<class,2호선,합정,17269,18041,35310
<class,2호선,홍대입구,34850,36369,71219
<class,2호선,신촌,21658,21195,42853
<class,2호선,이대,6820,6931,13751
<class,2호선,아현,5495,5409,10904
<class,2호선,충정로,4081,4149,8230
<class,2호선,용답,1562,1496,3058
<class,2호선,신답,643,755,1398
<class,2호선,신설동,2548,2443,4991
<class,2호선,도림천,686,681,1367
<class,2호선,양천구청,3053,3259,6312
<class,2호선,신정네거리,5130,5433,10563
<class,2호선,용두,1417,1435,2852
<class,3호선,지축,1660,1645,3305
<class,3호선,구파발,10653,10639,21292
<class,3호선,연신내,22721,21735,44456
<class,3호선,불광,9721,11117,20838
<class,3호선,녹번,7364,6580,13944
<class,3호선,홍제,9566,9267,18833
<class,3호선,무악재,2021,2101,4122
<class,3호선,독립문,3808,4088,7896
<class,3호선,경복궁,7648,7681,15329
<class,3호선,안국,6727,7309,14036
<class,3호선,종로3가,3258,4511,7769
<class,3호선,을지로3가,3258,3556,6814
<class,3호선,충무로,2,0,2
<class,3호선,동대입구,3586,4033,7619
<class,3호선,약수,6968,6551,13519
<class,3호선,금호,4418,4223,8641
<class,3호선,옥수,4846,5058,9904
<class,3호선,압구정,18539,19027,37566
<class,3호선,신사,18234,18623,36857
<class,3호선,고속터미널,31694,32232,63926
<class,3호선,교대,4462,2730,7192
<class,3호선,남부터미널,14420,14490,28910
<class,3호선,양재,13424,14409,27833
<class,3호선,매봉,4263,4281,8544
<class,3호선,도곡,2346,2307,4653
<class,3호선,대치,5718,5307,11025
<class,3호선,학여울,856,806,1662
<class,3호선,대청,4214,3802,8016
<class,3호선,일원,3417,3466,6883
<class,3호선,수서,8154,8149,16303
<class,3호선,가락시장,4780,4485,9265
<class,3호선,경찰병원,2915,2889,5804
<class,3호선,오금,2637,2436,5073
<class,4호선,수유,20067,19922,39989
<class,4호선,미아,8447,8267,16714
<class,4호선,미아사거리,16819,16637,33456
<class,4호선,길음,9998,9635,19633
<class,4호선,성신여대입구,12060,11468,23528
<class,4호선,한성대입구,7453,7151,14604
<class,4호선,혜화,15347,15441,30788
<class,4호선,동대문,10050,10023,20073
<class,4호선,동대문역사문화공원,7806,6535,14341
<class,4호선,충무로,8607,8554,17161
<class,4호선,명동,8463,9587,18050
<class,4호선,회현,12046,12522,24568
<class,4호선,서울역,3586,6546,10132
<class,4호선,숙대입구,6093,5903,11996
<class,4호선,삼각지,1833,2219,4052
<class,4호선,신용산,6195,6555,12750
<class,4호선,이촌,3319,3592,6911
<class,4호선,동작,1333,1376,2709
<class,4호선,총신대입구,10817,11656,22473
<class,4호선,사당,13540,11448,24988
<class,4호선,남태령,506,427,933
<class,4호선,당고개,7425,6956,14381
<class,4호선,상계,10576,10037,20613
<class,4호선,노원,11663,12680,24343
<class,4호선,창동,14588,15853,30441
<class,4호선,쌍문,16155,15148,31303
<class,5호선,방화,3626,3502,7128
<class,5호선,개화산,2717,2739,5456
<class,5호선,김포공항,4983,5039,10022
<class,5호선,송정,3774,3713,7487
<class,5호선,마곡,3475,3376,6851
<class,5호선,발산,8549,8806,17355
<class,5호선,우장산,6933,7061,13994
<class,5호선,화곡,14822,14161,28983
<class,5호선,까치산,15939,15734,31673
<class,5호선,신정,6636,5843,12479
<class,5호선,목동,8275,8597,16872
<class,5호선,오목교,12128,12561,24689
<class,5호선,양평,2835,2758,5593
<class,5호선,영등포구청,1459,1386,2845
<class,5호선,영등포시장,5126,5320,10446
<class,5호선,신길,1766,2008,3774
<class,5호선,여의도,6041,6365,12406
<class,5호선,여의나루,2713,2684,5397
<class,5호선,마포,5269,5313,10582
<class,5호선,공덕,4833,5035,9868
<class,5호선,애오개,2783,2635,5418
<class,5호선,충정로,1427,1373,2800
<class,5호선,서대문,5018,4851,9869
<class,5호선,광화문,9472,9126,18598
<class,5호선,종로3가,6679,6566,13245
<class,5호선,을지로4가,2445,2526,4971
<class,5호선,동대문역사문화공원,855,1023,1878
<class,5호선,청구,2010,1846,3856
<class,5호선,신금호,3120,3202,6322
<class,5호선,행당,4086,3624,7710
<class,5호선,왕십리,2638,2943,5581
<class,5호선,마장,3131,3050,6181
<class,5호선,답십리,7887,7301,15188
<class,5호선,장한평,8213,8149,16362
<class,5호선,군자,6319,6810,13129
<class,5호선,아차산,8981,9079,18060
<class,5호선,광나루,6752,6306,13058
<class,5호선,천호,12860,12290,25150
<class,5호선,강동,9916,9291,19207
<class,5호선,길동,4674,4840,9514
<class,5호선,굽은다리,5149,4976,10125
<class,5호선,명일,4265,4360,8625
<class,5호선,고덕,4803,4616,9419
<class,5호선,상일동,7462,6943,14405
<class,5호선,둔촌동,4885,4836,9721
<class,5호선,올림픽공원,2150,1831,3981
<class,5호선,방이,3540,3525,7065
<class,5호선,오금,1501,1468,2969
<class,5호선,개롱,3156,3295,6451
<class,5호선,거여,3967,3802,7769
<class,5호선,마천,3317,3460,6777
<class,5호선,미사,7198,7008,14206
<class,5호선,하남풍산,2558,2875,5433
<class,6호선,응암,9866,9913,19779
<class,6호선,역촌,1948,2284,4232
<class,6호선,불광,3041,2752,5793
<class,6호선,독바위,1514,1764,3278
<class,6호선,구산,3977,3138,7115
<class,6호선,새절,6918,6585,13503
<class,6호선,증산,5850,5881,11731
<class,6호선,디지털미디어시티,5202,5487,10689
<class,6호선,월드컵경기장,2980,2988,5968
<class,6호선,마포구청,7059,6301,13360
<class,6호선,망원,9047,9752,18799
<class,6호선,합정,7911,7424,15335
<class,6호선,상수,4820,5457,10277
<class,6호선,광흥창,3850,3633,7483
<class,6호선,대흥,4530,4556,9086
<class,6호선,공덕,7176,6718,13894
<class,6호선,효창공원앞,3450,3108,6558
<class,6호선,삼각지,2717,2249,4966
<class,6호선,녹사평,2745,2949,5694
<class,6호선,이태원,6346,6578,12924
<class,6호선,한강진,3513,4241,7754
<class,6호선,버티고개,1159,1135,2294
<class,6호선,약수,1832,1918,3750
<class,6호선,청구,1918,1951,3869
<class,6호선,신당,4071,3227,7298
<class,6호선,동묘앞,5881,5323,11204
<class,6호선,창신,1686,1449,3135
<class,6호선,보문,3774,3400,7174
<class,6호선,안암,4404,4151,8555
<class,6호선,고려대,3845,3749,7594
<class,6호선,월곡,5945,5913,11858
<class,6호선,상월곡,3225,2845,6070
<class,6호선,돌곶이,4344,4121,8465
<class,6호선,석계,6760,6674,13434
<class,6호선,태릉입구,2966,3107,6073
<class,6호선,화랑대,4615,3978,8593
<class,6호선,봉화산,3896,3776,7672
<class,6호선,신내,1,0,1
<class,7호선,장암,985,666,1651
<class,7호선,도봉산,4586,6681,11267
<class,7호선,수락산,7444,7389,14833
<class,7호선,마들,6820,6643,13463
<class,7호선,노원,11713,11930,23643
<class,7호선,중계,7001,6288,13289
<class,7호선,하계,8958,8639,17597
<class,7호선,공릉,6590,6407,12997
<class,7호선,태릉입구,4499,4206,8705
<class,7호선,먹골,5910,5772,11682
<class,7호선,중화,6060,5988,12048
<class,7호선,상봉,10198,9841,20039
<class,7호선,면목,8683,8677,17360
<class,7호선,사가정,9596,9556,19152
<class,7호선,용마산,3429,3368,6797
<class,7호선,중곡,5383,5278,10661
<class,7호선,군자,8155,6316,14471
<class,7호선,어린이대공원,6281,6083,12364
<class,7호선,건대입구,8377,7878,16255
<class,7호선,뚝섬유원지,3975,3984,7959
<class,7호선,청담,8404,8780,17184
<class,7호선,강남구청,7182,7721,14903
<class,7호선,학동,7798,8230,16028
<class,7호선,논현,8764,9363,18127
<class,7호선,반포,3242,3008,6250
<class,7호선,고속터미널,8770,7230,16000
<class,7호선,내방,6247,6172,12419
<class,7호선,이수,9021,8303,17324
<class,7호선,남성,6102,5749,11851
<class,7호선,숭실대입구,5985,5919,11904
<class,7호선,상도,5492,5254,10746
<class,7호선,장승배기,5255,5264,10519
<class,7호선,신대방삼거리,9288,8747,18035
<class,7호선,보라매,4957,4701,9658
<class,7호선,신풍,6270,6107,12377
<class,7호선,대림,5359,5652,11011
<class,7호선,남구로,6953,7507,14460
<class,7호선,가산디지털단지,11878,10773,22651
<class,7호선,철산,11056,11472,22528
<class,7호선,광명사거리,13457,13504,26961
<class,7호선,천왕,5147,4920,10067
<class,7호선,온수,4453,4386,8839
<class,7호선,까치울,3725,3794,7519
<class,7호선,부천종합운동장,2278,2004,4282
<class,7호선,춘의,4270,4159,8429
<class,7호선,신중동,7231,7158,14389
<class,7호선,부천시청,7196,7032,14228
<class,7호선,상동,6948,7128,14076
<class,7호선,삼산체육관,2252,2107,4359
<class,7호선,굴포천,4721,5019,9740
<class,7호선,부평구청,5247,4661,9908
<class,8호선,암사,9666,9122,18788
<class,8호선,천호,9795,11019,20814
<class,8호선,강동구청,4696,4919,9615
<class,8호선,몽촌토성,3044,3063,6107
<class,8호선,잠실,9550,10100,19650
<class,8호선,석촌,4431,5178,9609
<class,8호선,송파,4093,4228,8321
<class,8호선,가락시장,4621,4555,9176
<class,8호선,문정,6349,6480,12829
<class,8호선,장지,9573,9372,18945
<class,8호선,복정,4758,4137,8895
<class,8호선,산성,3943,3964,7907
<class,8호선,남한산성입구,7189,6500,13689
<class,8호선,단대오거리,5860,5532,11392
<class,8호선,신흥,3107,3369,6476
<class,8호선,수진,3184,3015,6199
<class,8호선,모란,2943,2357,5300
<class,9호선,개화,974,803,1777
<class,9호선,김포공항,5215,7517,12732
<class,9호선,공항시장,1717,1906,3623
<class,9호선,신방화,3481,3428,6909
<class,9호선,마곡나루,5122,5086,10208
<class,9호선,양천향교,4212,4160,8372
<class,9호선,가양,10175,10019,20194
<class,9호선,증미,3367,3315,6682
<class,9호선,등촌,5506,5396,10902
<class,9호선,염창,8223,7876,16099
<class,9호선,신목동,1488,1360,2848
<class,9호선,선유도,2573,2491,5064
<class,9호선,당산,8802,8360,17162
<class,9호선,국회의사당,2609,2802,5411
<class,9호선,여의도,5577,5434,11011
<class,9호선,샛강,1807,1795,3602
<class,9호선,노량진,13803,13749,27552
<class,9호선,노들,2288,2055,4343
<class,9호선,흑석,3980,4011,7991
<class,9호선,동작,850,665,1515
<class,9호선,구반포,1447,1508,2955
<class,9호선,신반포,1556,1463,3019
<class,9호선,고속터미널,7737,10089,17826
<class,9호선,사평,1493,1434,2927
<class,9호선,신논현,17809,17142,34951
<class,9호선2~3단계,언주,4444,4382,8826
<class,9호선2~3단계,선정릉,3288,3625,6913
<class,9호선2~3단계,삼성중앙,2302,2269,4571
<class,9호선2~3단계,봉은사,6458,6577,13035
<class,9호선2~3단계,종합운동장,2037,1911,3948
<class,9호선2~3단계,삼전,3799,3445,7244
<class,9호선2~3단계,석촌고분,3225,3117,6342
<class,9호선2~3단계,석촌,4242,3675,7917
<class,9호선2~3단계,송파나루,2664,2773,5437
<class,9호선2~3단계,한성백제,1243,1121,2364
<class,9호선2~3단계,올림픽공원,2650,2516,5166
<class,9호선2~3단계,둔촌오륜,489,437,926
<class,9호선2~3단계,중앙보훈병원,2913,2690,5603
<class,경강선,판교,2038,1990,4028
<class,경강선,이매,545,373,918
<class,경강선,삼동,1025,1031,2056
<class,경강선,경기광주,3570,3449,7019
<class,경강선,초월,1505,1381,2886
<class,경강선,곤지암,1298,1248,2546
<class,경강선,신둔도예촌,678,645,1323
<class,경강선,이천,1683,1717,3400
<class,경강선,부발,1341,1022,2363
<class,경강선,세종대왕릉,172,177,349
<class,경강선,여주,1199,1212,2411
<class,경부선,서울역,2830,881,3711
<class,경부선,남영,4078,4222,8300
<class,경부선,용산,19603,20461,40064
<class,경부선,노량진,5819,5634,11453
<class,경부선,대방,5688,5693,11381
<class,경부선,영등포,28288,29528,57816
<class,경부선,신도림,1845,1982,3827
<class,경부선,신길,4736,3850,8586
<class,경부선,구로,9707,10014,19721
<class,경부선,가산디지털단지,4399,6058,10457
<class,경부선,금천구청,6039,6139,12178
<class,경부선,석수,5082,4777,9859
<class,경부선,관악,4371,4083,8454
<class,경부선,안양,12522,12784,25306
<class,경부선,명학,3886,3700,7586
<class,경부선,금정,13352,13458,26810
<class,경부선,군포,3716,3478,7194
<class,경부선,의왕,4187,4184,8371
<class,경부선,성균관대,6948,7015,13963
<class,경부선,화서,3538,3439,6977
<class,경부선,수원,24421,26746,51167
<class,경부선,독산,6359,6491,12850
<class,경부선,세류,1691,1791,3482
<class,경부선,병점,8206,8165,16371
<class,경부선,세마,1443,1247,2690
<class,경부선,오산대,1835,1652,3487
<class,경부선,오산,6358,5991,12349
<class,경부선,진위,781,665,1446
<class,경부선,송탄,3202,2866,6068
<class,경부선,서정리,4603,3661,8264
<class,경부선,지제,2063,1719,3782
<class,경부선,평택,8942,8472,17414
<class,경부선,성환,2113,1926,4039
<class,경부선,직산,496,475,971
<class,경부선,두정,3288,3371,6659
<class,경부선,천안,3916,4128,8044
<class,경부선,당정,2831,2736,5567
<class,경부선,서동탄,656,661,1317
<class,경부선,광명,1510,1399,2909
<class,경원선,이촌,2035,1579,3614
<class,경원선,서빙고,815,735,1550
<class,경원선,한남,2089,1956,4045
<class,경원선,옥수,24,16,40
<class,경원선,응봉,1024,879,1903
<class,경원선,왕십리,8455,9745,18200
<class,경원선,청량리,10338,11534,21872
<class,경원선,외대앞,7964,7669,15633
<class,경원선,신이문,4792,4463,9255
<class,경원선,석계,5064,5396,10460
<class,경원선,광운대,4234,4174,8408
<class,경원선,월계,3502,3426,6928
<class,경원선,녹천,2671,2388,5059
<class,경원선,방학,5589,5615,11204
<class,경원선,도봉,3400,3418,6818
<class,경원선,도봉산,6547,4196,10743
<class,경원선,망월사,4301,4486,8787
<class,경원선,회룡,6904,6934,13838
<class,경원선,의정부,12176,12648,24824
<class,경원선,가능,3803,3749,7552
<class,경원선,녹양,2477,2406,4883
<class,경원선,덕계,1507,1415,2922
<class,경원선,덕정,3054,2864,5918
<class,경원선,지행,3586,3625,7211
<class,경원선,동두천중앙,1789,1932,3721
<class,경원선,보산,1046,1102,2148
<class,경원선,동두천,995,1236,2231
<class,경원선,소요산,2183,1977,4160
<class,경의선,서울역,747,805,1552
<class,경의선,신촌,251,226,477
<class,경의선,효창공원앞,1321,1456,2777
<class,경의선,공덕,1658,1301,2959
<class,경의선,서강대,1538,1449,2987
<class,경의선,홍대입구,1029,1196,2225
<class,경의선,가좌,2725,2650,5375
<class,경의선,디지털미디어시티,1294,1189,2483
<class,경의선,수색,878,887,1765
<class,경의선,화전,686,642,1328
<class,경의선,강매,1407,1288,2695
<class,경의선,행신,3329,3498,6827
<class,경의선,능곡,1910,1893,3803
<class,경의선,곡산,215,232,447
<class,경의선,백마,2789,2692,5481
<class,경의선,풍산,2762,2730,5492
<class,경의선,일산,4109,4151,8260
<class,경의선,탄현,3531,3421,6952
<class,경의선,야당,3138,3135,6273
<class,경의선,운정,2836,2715,5551
<class,경의선,금릉,2379,2296,4675
<class,경의선,금촌,3835,3839,7674
<class,경의선,월롱,862,847,1709
<class,경의선,파주,514,407,921
<class,경의선,문산,2867,2840,5707
<class,경의선,임진강,13,9,22
<class,경인선,개봉,12260,12373,24633
<class,경인선,오류동,6749,6383,13132
<class,경인선,역곡,14828,14847,29675
<class,경인선,부천,21615,22581,44196
<class,경인선,송내,13004,12997,26001
<class,경인선,부평,21229,23249,44478
<class,경인선,백운,4026,3985,8011
<class,경인선,동암,9380,9624,19004
<class,경인선,주안,11169,10190,21359
<class,경인선,제물포,5380,5231,10611
<class,경인선,동인천,8281,8103,16384
<class,경인선,인천,2236,1879,4115
<class,경인선,구일,3204,2994,6198
<class,경인선,소사,5646,5501,11147
<class,경인선,부개,4753,4686,9439
<class,경인선,간석,3123,3002,6125
<class,경인선,도원,1516,1587,3103
<class,경인선,온수,3394,3340,6734
<class,경인선,중동,4892,4796,9688
<class,경인선,도화,2319,2100,4419
<class,경춘선,신내,724,738,1462
<class,경춘선,갈매,1406,1256,2662
<class,경춘선,별내,1551,1508,3059
<class,경춘선,퇴계원,1804,1704,3508
<class,경춘선,사릉,1623,1632,3255
<class,경춘선,금곡,759,704,1463
<class,경춘선,평내호평,3081,3018,6099
<class,경춘선,천마산,913,948,1861
<class,경춘선,마석,2093,2101,4194
<class,경춘선,대성리,332,280,612
<class,경춘선,청평,832,927,1759
<class,경춘선,상천,271,183,454
<class,경춘선,가평,800,850,1650
<class,경춘선,굴봉산,81,106,187
<class,경춘선,백양리,154,144,298
<class,경춘선,강촌,319,375,694
<class,경춘선,김유정,221,226,447
<class,경춘선,남춘천,1513,1593,3106
<class,경춘선,춘천,791,783,1574
<class,공항철도 1호선,서울역,3907,3856,7763
<class,공항철도 1호선,공덕,956,1437,2393
<class,공항철도 1호선,홍대입구,5975,5830,11805
<class,공항철도 1호선,디지털미디어시티,3434,3253,6687
<class,공항철도 1호선,마곡나루,1724,1769,3493
<class,공항철도 1호선,김포공항,6300,3720,10020
<class,공항철도 1호선,계양,4178,4131,8309
<class,공항철도 1호선,검암,3151,3144,6295
<class,공항철도 1호선,청라국제도시,2514,2453,4967
<class,공항철도 1호선,운서,4063,4092,8155
<class,공항철도 1호선,공항화물청사,1215,1184,2399
<class,공항철도 1호선,인천공항1터미널,2629,2858,5487
<class,공항철도 1호선,인천공항2터미널,1556,1376,2932
<class,공항철도 1호선,영종,1718,1839,3557
<class,과천선,선바위,3305,3096,6401
<class,과천선,경마공원,717,688,1405
<class,과천선,대공원,2085,2291,4376
<class,과천선,과천,3006,2710,5716
<class,과천선,정부과천청사,3675,3740,7415
<class,과천선,인덕원,10706,10473,21179
<class,과천선,평촌,6509,6577,13086
<class,과천선,범계,14097,13762,27859
<class,분당선,선릉,3910,5549,9459
<class,분당선,한티,7657,7468,15125
<class,분당선,도곡,3070,2799,5869
<class,분당선,구룡,807,766,1573
<class,분당선,개포동,1809,1835,3644
<class,분당선,대모산입구,1811,1625,3436
<class,분당선,수서,6202,6418,12620
<class,분당선,수원,5112,4061,9173
<class,분당선,서울숲,3745,3727,7472
<class,분당선,압구정로데오,12815,13354,26169
<class,분당선,강남구청,3649,4405,8054
<class,분당선,선정릉,2634,2615,5249
<class,분당선,가천대,3420,3879,7299
<class,분당선,태평,8311,8151,16462
<class,분당선,모란,12361,12566,24927
<class,분당선,야탑,12302,13079,25381
<class,분당선,서현,13912,13881,27793
<class,분당선,정자,7945,8002,15947
<class,분당선,미금,8137,8472,16609
<class,분당선,오리,5678,4781,10459
<class,분당선,이매,2681,2641,5322
<class,분당선,보정,1078,1010,2088
<class,분당선,죽전,7344,8154,15498
<class,분당선,구성,2218,2342,4560
<class,분당선,신갈,1945,1975,3920
<class,분당선,기흥,4859,4558,9417
<class,분당선,상갈,2679,2698,5377
<class,분당선,청명,1946,1878,3824
<class,분당선,영통,4692,4711,9403
<class,분당선,망포,6693,6181,12874
<class,분당선,매탄권선,2435,2288,4723
<class,분당선,수원시청,7624,8157,15781
<class,분당선,매교,1499,1570,3069
<class,수인선,고색,1690,1726,3416
<class,수인선,오목천,1344,1223,2567
<class,수인선,어천,358,310,668
<class,수인선,야목,125,119,244
<class,수인선,사리,2057,1740,3797
<class,수인선,달월,40,37,77
<class,수인선,월곶,1558,1462,3020
<class,수인선,소래포구,3577,3751,7328
<class,수인선,인천논현,3288,3374,6662
<class,수인선,호구포,1900,1807,3707
<class,수인선,남동인더스파크,932,884,1816
<class,수인선,원인재,2661,2829,5490
<class,수인선,연수,2717,2723,5440
<class,수인선,송도,1477,1434,2911
<class,수인선,인하대,3076,2805,5881
<class,수인선,숭의,2018,1935,3953
<class,수인선,신포,933,1007,1940
<class,수인선,인천,774,1229,2003
<class,안산선,산본,8549,9301,17850
<class,안산선,대야미,2842,2455,5297
<class,안산선,반월,2564,2300,4864
<class,안산선,상록수,9119,9472,18591
<class,안산선,한대앞,4840,4840,9680
<class,안산선,중앙,10054,10617,20671
<class,안산선,고잔,4098,4038,8136
<class,안산선,초지,2130,2182,4312
<class,안산선,안산,7713,8062,15775
<class,안산선,신길온천,995,980,1975
<class,안산선,정왕,4333,4524,8857
<class,안산선,오이도,5058,5266,10324
<class,안산선,수리산,2149,1890,4039
<class,우이신설선,북한산우이,1980,1921,3901
<class,우이신설선,솔밭공원,1341,1284,2625
<class,우이신설선,4.19민주묘지,1613,1506,3119
<class,우이신설선,가오리,2196,2192,4388
<class,우이신설선,화계,1813,1723,3536
<class,우이신설선,삼양,1213,1359,2572
<class,우이신설선,삼양사거리,1488,1468,2956
<class,우이신설선,솔샘,2827,2528,5355
<class,우이신설선,북한산보국문,3338,3205,6543
<class,우이신설선,정릉,2640,2380,5020
<class,우이신설선,성신여대입구,1979,2334,4313
<class,우이신설선,보문,878,913,1791
<class,우이신설선,신설동,1156,1053,2209
<class,일산선,원흥,4738,4465,9203
<class,일산선,삼송,9997,9824,19821
<class,일산선,원당,5918,5902,11820
<class,일산선,화정,9258,9710,18968
<class,일산선,대곡,815,637,1452
<class,일산선,백석,5677,5902,11579
<class,일산선,마두,3695,3795,7490
<class,일산선,정발산,4440,4459,8899
<class,일산선,주엽,4412,4532,8944
<class,일산선,대화,6259,5649,11908
<class,장항선,봉명,582,552,1134
<class,장항선,쌍용,1038,908,1946
<class,장항선,아산,1696,1667,3363
<class,장항선,배방,628,596,1224
<class,장항선,온양온천,2605,2578,5183
<class,장항선,신창,664,539,1203
<class,중앙선,회기,13589,12826,26415
<class,중앙선,중랑,3349,3174,6523
<class,중앙선,상봉,3593,3523,7116
<class,중앙선,망우,4358,4414,8772
<class,중앙선,양원,760,742,1502
<class,중앙선,구리,7339,7632,14971
<class,중앙선,도농,4636,4547,9183
<class,중앙선,양정,405,366,771
<class,중앙선,덕소,3200,3203,6403
<class,중앙선,도심,1180,1040,2220
<class,중앙선,팔당,883,992,1875
<class,중앙선,운길산,687,630,1317
<class,중앙선,양수,1159,1167,2326
<class,중앙선,신원,161,155,316
<class,중앙선,국수,429,503,932
<class,중앙선,아신,305,336,641
<class,중앙선,오빈,171,175,346
<class,중앙선,양평,1504,1595,3099
<class,중앙선,원덕,193,185,378
<class,중앙선,용문,1135,1242,2377
<class,중앙선,지평,22,19,41
<class,경부선,금천구청,4139,4147,8286
<class,경부선,구로,6430,6391,12821
<class,경부선,신길,3205,2857,6062
<class,경부선,신도림,1260,1209,2469
<class,경부선,영등포,21754,20890,42644
<class,경부선,대방,3592,4004,7596
<class,경부선,노량진,3834,3842,7676
<class,경부선,용산,17668,15715,33383
<class,경부선,남영,2586,2930,5516
<class,9호선2~3단계,봉은사,4496,4361,8857
<class,9호선2~3단계,삼성중앙,1333,1394,2727
<class,9호선2~3단계,선정릉,2110,2310,4420
<class,9호선2~3단계,언주,2524,2494,5018
<class,9호선,신논현,9569,8948,18517
<class,9호선,사평,791,901,1692
<class,9호선,고속터미널,6045,7190,13235
<class,9호선,신반포,799,861,1660
<class,9호선,구반포,784,851,1635
<class,9호선,동작,616,433,1049
<class,9호선,흑석,2574,2683,5257
<class,9호선,노들,1528,1423,2951
<class,9호선,노량진,8995,9680,18675
<class,9호선,샛강,1072,1154,2226
<class,9호선,여의도,3588,3312,6900
<class,9호선,국회의사당,2119,1860,3979
<class,9호선,당산,5590,5535,11125
<class,9호선,선유도,1730,1766,3496
<class,9호선,신목동,1026,902,1928
<class,9호선,염창,5397,5580,10977
<class,9호선,등촌,3309,3522,6831
<class,9호선,증미,2269,2282,4551
<class,9호선,가양,6669,6746,13415
<class,9호선,양천향교,2658,2849,5507
<class,9호선,마곡나루,3243,3264,6507
<class,9호선,신방화,2347,2333,4680
<class,9호선,공항시장,1162,1295,2457
<class,9호선,김포공항,4832,6822,11654
<class,9호선,개화,689,619,1308
<class,8호선,모란,1855,1529,3384
<class,8호선,수진,2253,2104,4357
<class,8호선,신흥,2134,2239,4373
<class,8호선,단대오거리,3842,3860,7702
<class,8호선,남한산성입구,4827,4781,9608
<class,8호선,산성,2678,2768,5446
<class,8호선,복정,2953,2906,5859
<class,8호선,장지,6698,7097,13795
<class,8호선,문정,4032,4187,8219
<class,8호선,가락시장,2453,3385,5838
<class,8호선,송파,2503,2654,5157
<class,8호선,석촌,2798,3435,6233
<class,8호선,잠실,7159,6982,14141
<class,8호선,몽촌토성,1975,2054,4029
<class,8호선,강동구청,3102,3220,6322
<class,8호선,천호,6489,7297,13786
<class,8호선,암사,6310,6087,12397
<class,7호선,부평구청,3514,3077,6591
<class,7호선,굴포천,3124,3251,6375
<class,7호선,삼산체육관,1497,1489,2986
<class,7호선,상동,4674,4378,9052
<class,7호선,부천시청,4686,4471,9157
<class,7호선,신중동,4714,4489,9203
<class,7호선,춘의,2517,2307,4824
<class,7호선,부천종합운동장,1499,1389,2888
<class,7호선,까치울,2532,2589,5121
<class,7호선,온수,2729,2647,5376
<class,7호선,천왕,3240,3186,6426
<class,7호선,철산,6988,6998,13986
<class,7호선,가산디지털단지,7977,7260,15237
<class,7호선,남구로,4980,4906,9886
<class,7호선,대림,4541,4336,8877
<class,7호선,신풍,4136,3944,8080
<class,7호선,보라매,2793,2900,5693
<class,7호선,신대방삼거리,5544,5621,11165
<class,7호선,장승배기,3405,3427,6832
<class,7호선,상도,3633,3567,7200
<class,7호선,숭실대입구,3869,4217,8086
<class,7호선,남성,3782,4047,7829
<class,7호선,이수,5348,5087,10435
<class,7호선,내방,3761,3752,7513
<class,9호선2~3단계,종합운동장,1340,1239,2579
<class,9호선2~3단계,삼전,2496,2537,5033
<class,9호선2~3단계,석촌고분,2122,2222,4344
<class,9호선2~3단계,석촌,2780,2408,5188
<class,9호선2~3단계,송파나루,1784,1942,3726
<class,9호선2~3단계,한성백제,794,783,1577
<class,9호선2~3단계,올림픽공원,1751,1759,3510
<class,9호선2~3단계,둔촌오륜,274,280,554
<class,9호선2~3단계,중앙보훈병원,1904,1850,3754
<class,경강선,판교,1722,1511,3233
<class,경강선,이매,413,287,700
<class,경강선,삼동,717,758,1475
<class,경강선,경기광주,2392,2500,4892
<class,경강선,초월,1090,1162,2252
<class,경강선,곤지암,914,1049,1963
<class,경강선,신둔도예촌,498,456,954
<class,경강선,이천,1310,1439,2749
<class,7호선,마들,3971,3921,7892
<class,7호선,노원,7441,7286,14727
<class,7호선,중계,4505,4215,8720
<class,7호선,하계,5855,5618,11473
<class,7호선,공릉,4297,4421,8718
<class,7호선,태릉입구,3192,2758,5950
<class,7호선,먹골,3839,3949,7788
<class,7호선,중화,3961,3919,7880
<class,7호선,상봉,6737,6327,13064
<class,7호선,면목,5682,5752,11434
<class,7호선,사가정,6476,6523,12999
<class,7호선,용마산,2199,2435,4634
<class,7호선,중곡,3444,3421,6865
<class,7호선,군자,5143,4216,9359
<class,7호선,어린이대공원,4464,4430,8894
<class,7호선,건대입구,5789,5562,11351
<class,7호선,뚝섬유원지,2730,2753,5483
<class,7호선,청담,4654,4924,9578
<class,7호선,강남구청,3863,4204,8067
<class,7호선,학동,4267,4439,8706
<class,7호선,논현,4542,4920,9462
<class,7호선,반포,2051,2046,4097
<class,4호선,명동,5899,5841,11740
<class,중앙선,아신,262,264,526
<class,중앙선,국수,337,342,679
<class,중앙선,신원,141,87,228
<class,중앙선,양수,877,841,1718
<class,중앙선,운길산,686,567,1253
<class,중앙선,팔당,783,824,1607
<class,중앙선,도심,767,702,1469
<class,중앙선,덕소,2229,2338,4567
<class,중앙선,양정,264,204,468
<class,중앙선,도농,3131,3027,6158
<class,중앙선,구리,4793,5175,9968
<class,중앙선,양원,514,522,1036
<class,중앙선,망우,3125,3147,6272
<class,중앙선,상봉,2566,2595,5161
<class,중앙선,중랑,2257,2204,4461
<class,중앙선,회기,9814,9913,19727
<class,7호선,고속터미널,8020,5229,13249
<class,장항선,신창,535,621,1156
<class,장항선,온양온천,2299,2247,4546
<class,장항선,배방,502,544,1046
<class,장항선,아산,1893,1391,3284
<class,장항선,쌍용,737,761,1498
<class,장항선,봉명,377,368,745
<class,일산선,대화,4243,4002,8245
<class,일산선,주엽,2857,2812,5669
<class,일산선,정발산,3140,3027,6167
<class,일산선,마두,2214,2162,4376
<class,일산선,백석,3977,3865,7842
<class,일산선,대곡,600,458,1058
<class,일산선,화정,6355,6441,12796
<class,일산선,원당,4088,3967,8055
<class,일산선,삼송,6859,6631,13490
<class,일산선,원흥,3196,3126,6322
<class,우이신설선,신설동,775,767,1542
<class,우이신설선,보문,679,641,1320
<class,우이신설선,성신여대입구,1491,1646,3137
<class,우이신설선,정릉,1825,1597,3422
<class,우이신설선,북한산보국문,2375,2325,4700
<class,우이신설선,솔샘,1808,1711,3519
<class,우이신설선,삼양사거리,978,1029,2007
<class,우이신설선,삼양,886,875,1761
<class,우이신설선,화계,1306,1234,2540
<class,우이신설선,가오리,1548,1499,3047
<class,우이신설선,4.19민주묘지,2082,1862,3944
<class,우이신설선,솔밭공원,1023,1005,2028
<class,우이신설선,북한산우이,1741,1718,3459
<class,안산선,수리산,1373,1372,2745
<class,안산선,오이도,3786,3589,7375
<class,안산선,정왕,3423,3749,7172
<class,안산선,신길온천,721,636,1357
<class,안산선,안산,7113,6451,13564
<class,안산선,초지,1439,1354,2793
<class,안산선,고잔,2776,2654,5430
<class,안산선,중앙,7267,6990,14257
<class,안산선,한대앞,3448,3368,6816
<class,안산선,상록수,6249,6255,12504
<class,안산선,반월,1637,1694,3331
<class,안산선,대야미,1915,1817,3732
<class,안산선,산본,5826,6282,12108
<class,수인선,인천,670,997,1667
<class,수인선,신포,684,711,1395
<class,수인선,숭의,1397,1355,2752
<class,수인선,인하대,2148,2083,4231
<class,수인선,송도,1143,1078,2221
<class,수인선,연수,2023,1899,3922
<class,수인선,원인재,1951,1983,3934
<class,수인선,남동인더스파크,552,596,1148
<class,수인선,오목천,850,847,1697
<class,수인선,고색,1054,1035,2089
<class,분당선,매교,909,989,1898
<class,분당선,수원시청,5210,4941,10151
<class,분당선,매탄권선,1598,1591,3189
<class,분당선,망포,4286,4625,8911
<class,분당선,영통,3094,3218,6312
<class,분당선,청명,1368,1305,2673
<class,분당선,상갈,1981,2055,4036
<class,분당선,기흥,3592,3314,6906
<class,분당선,신갈,1299,1402,2701
<class,분당선,구성,1516,1648,3164
<class,분당선,죽전,5462,6192,11654
<class,분당선,보정,730,686,1416
<class,분당선,이매,1869,1956,3825
<class,분당선,오리,3972,3453,7425
<class,분당선,미금,5028,5308,10336
<class,분당선,정자,5144,5289,10433
<class,분당선,수내,4452,4207,8659
<class,분당선,서현,9915,9596,19511
<class,분당선,야탑,8924,8521,17445
<class,분당선,모란,7814,8002,15816
<class,분당선,태평,5708,5575,11283
<class,분당선,가천대,2385,2954,5339
<class,4호선,혜화,11111,11198,22309
<class,분당선,선정릉,1489,1557,3046
<class,분당선,강남구청,2130,2489,4619
<class,분당선,압구정로데오,6935,7028,13963
<class,분당선,서울숲,2458,2482,4940
<class,분당선,수원,3917,3222,7139
<class,분당선,복정,1,0,1
<class,분당선,수서,4877,4947,9824
<class,분당선,대모산입구,978,953,1931
<class,분당선,개포동,1114,1128,2242
<class,분당선,구룡,410,413,823
<class,분당선,도곡,1770,1753,3523
<class,분당선,한티,5039,5016,10055
<class,분당선,선릉,2008,2852,4860
<class,과천선,범계,9477,8914,18391
<class,과천선,평촌,4288,4029,8317
<class,과천선,인덕원,6896,6828,13724
<class,과천선,정부과천청사,2435,2433,4868
<class,과천선,과천,1879,1873,3752
<class,과천선,대공원,1578,1716,3294
<class,과천선,경마공원,518,505,1023
<class,과천선,선바위,2203,2110,4313
<class,공항철도 1호선,영종,1349,1305,2654
<class,공항철도 1호선,인천공항2터미널,1490,1389,2879
<class,공항철도 1호선,인천공항1터미널,2530,2600,5130
<class,공항철도 1호선,공항화물청사,830,945,1775
<class,공항철도 1호선,운서,3251,3468,6719
<class,공항철도 1호선,청라국제도시,1882,1686,3568
<class,공항철도 1호선,검암,2299,2392,4691
<class,공항철도 1호선,계양,2883,2791,5674
<class,공항철도 1호선,김포공항,6833,3784,10617
<class,공항철도 1호선,마곡나루,1159,1203,2362
<class,공항철도 1호선,디지털미디어시티,2477,2397,4874
<class,공항철도 1호선,홍대입구,4647,4094,8741
<class,공항철도 1호선,공덕,795,1019,1814
<class,공항철도 1호선,서울역,3989,3450,7439
<class,경춘선,춘천,751,661,1412
<class,경춘선,남춘천,1589,1594,3183
<class,경춘선,김유정,227,209,436
<class,경춘선,강촌,404,336,740
<class,경춘선,백양리,148,133,281
<class,경춘선,굴봉산,83,78,161
<class,경춘선,가평,776,700,1476
<class,경춘선,상천,203,169,372
<class,경춘선,청평,733,639,1372
<class,경춘선,대성리,297,229,526
<class,경춘선,마석,1557,1567,3124
<class,경춘선,천마산,787,712,1499
<class,경춘선,평내호평,2183,2077,4260
<class,경춘선,금곡,574,553,1127
<class,경춘선,사릉,1142,1132,2274
<class,경춘선,퇴계원,1332,1233,2565
<class,경춘선,별내,1100,1064,2164
<class,경춘선,갈매,1011,851,1862
<class,경춘선,신내,556,540,1096
<class,경인선,도화,1548,1497,3045
<class,경인선,중동,3285,3025,6310
<class,경인선,온수,2193,2136,4329
<class,경인선,도원,1066,1055,2121
<class,경인선,간석,2162,2068,4230
<class,경인선,부개,3195,2993,6188
<class,경인선,소사,3927,3605,7532
<class,경인선,구일,2059,2017,4076
<class,경인선,인천,1782,1476,3258
<class,경인선,동인천,6093,5709,11802
<class,경인선,제물포,3748,3662,7410
<class,경인선,주안,7954,6947,14901
<class,경인선,동암,6563,6471,13034
<class,경인선,백운,2714,2690,5404
<class,경인선,부평,15666,15989,31655
<class,경인선,송내,8877,8555,17432
<class,경인선,부천,15639,15171,30810
<class,경인선,역곡,9638,9611,19249
<class,경인선,오류동,4517,4371,8888
<class,경인선,개봉,7872,8056,15928
<class,경의선,임진강,12,12,24
<class,경의선,문산,2055,2028,4083
<class,경의선,파주,383,327,710
<class,경의선,월롱,495,957,1452
<class,경의선,금촌,2512,2709,5221
<class,경의선,금릉,1618,1601,3219
<class,경의선,운정,1983,1887,3870
<class,경의선,야당,2245,2216,4461
<class,경의선,탄현,2555,2466,5021
<class,경의선,일산,2871,2609,5480
<class,경의선,풍산,2017,1891,3908
<class,경의선,백마,2024,1897,3921
<class,경의선,곡산,169,167,336
<class,경의선,능곡,1427,1336,2763
<class,경의선,행신,2492,2494,4986
<class,경의선,강매,849,836,1685
<class,경의선,화전,426,450,876
<class,경의선,수색,630,699,1329
<class,경의선,디지털미디어시티,806,755,1561
<class,경의선,가좌,1785,1810,3595
<class,경의선,홍대입구,832,925,1757
<class,경의선,서강대,794,749,1543
<class,경의선,공덕,1117,866,1983
<class,경의선,효창공원앞,828,987,1815
<class,경의선,신촌,137,155,292
<class,경의선,서울역,559,554,1113
<class,경원선,소요산,2066,1792,3858
<class,경원선,동두천,787,895,1682
<class,경원선,보산,860,773,1633
<class,경원선,동두천중앙,1417,1310,2727
<class,경원선,지행,2630,2534,5164
<class,경강선,부발,834,1499,2333
<class,경강선,세종대왕릉,139,131,270
<class,경강선,여주,1120,1006,2126
<class,수인선,호구포,1347,1410,2757
<class,수인선,인천논현,2239,2293,4532
<class,수인선,소래포구,3005,2921,5926
<class,수인선,월곶,1195,1138,2333
<class,수인선,달월,36,35,71
<class,수인선,사리,1526,1359,2885
<class,수인선,야목,71,61,132
<class,수인선,어천,270,339,609
<class,7호선,광명사거리,8891,8664,17555
<class,중앙선,지평,25,21,46
<class,중앙선,용문,1142,895,2037
<class,중앙선,원덕,204,134,338
<class,경원선,양주,3037,2964,6001
<class,중앙선,양평,1194,1143,2337
<class,중앙선,오빈,118,118,236
<class,1호선,서울역,15198,13900,29098
<class,1호선,동묘앞,8497,8690,17187
<class,1호선,시청,4129,3984,8113
<class,1호선,종각,7096,6561,13657
<class,1호선,종로3가,8250,7474,15724
<class,1호선,종로5가,5013,5150,10163
<class,1호선,동대문,5925,6306,12231
<class,1호선,신설동,4969,5022,9991
<class,1호선,제기동,6858,7299,14157
<class,1호선,청량리,9072,8925,17997
<class,2호선,시청,3246,2677,5923
<class,2호선,을지로입구,10337,9751,20088
<class,2호선,을지로3가,3731,3253,6984
<class,2호선,을지로4가,2056,2014,4070
<class,2호선,동대문역사문화공원,4521,5578,10099
<class,2호선,신당,5450,5890,11340
<class,2호선,상왕십리,4489,4568,9057
<class,2호선,왕십리,6222,5326,11548
<class,2호선,한양대,1583,1703,3286
<class,2호선,뚝섬,4782,4934,9716
<class,2호선,성수,6638,7147,13785
<class,2호선,건대입구,16249,17196,33445
<class,2호선,구의,7769,8083,15852
<class,2호선,강변,13763,12873,26636
<class,2호선,잠실나루,3196,3390,6586
<class,2호선,잠실,27903,26484,54387
<class,2호선,잠실새내,6951,7290,14241
<class,2호선,종합운동장,1832,2030,3862
<class,2호선,삼성,13196,12554,25750
<class,2호선,선릉,8964,7776,16740
<class,2호선,역삼,7683,8437,16120
<class,2호선,강남,20856,19654,40510
<class,2호선,교대,6669,7248,13917
<class,2호선,서초,4260,3848,8108
<class,2호선,방배,4220,4623,8843
<class,2호선,사당,13388,14539,27927
<class,2호선,낙성대,10526,10918,21444
<class,2호선,서울대입구,18229,18908,37137
<class,2호선,봉천,8494,8435,16929
<class,2호선,신림,25732,26180,51912
<class,2호선,신대방,10445,10397,20842
<class,2호선,구로디지털단지,16481,16494,32975
<class,2호선,대림,10065,10316,20381
<class,2호선,신도림,18015,17801,35816
<class,2호선,문래,4709,4872,9581
<class,2호선,영등포구청,5513,5895,11408
<class,2호선,당산,5616,5954,11570
<class,2호선,합정,11281,11633,22914
<class,2호선,홍대입구,24361,23774,48135
<class,2호선,신촌,13397,13419,26816
<class,2호선,이대,4026,4303,8329
<class,2호선,아현,3512,3589,7101
<class,2호선,충정로,2581,2585,5166
<class,2호선,용답,1136,1142,2278
<class,2호선,신답,431,515,946
<class,2호선,신설동,1995,2018,4013
<class,2호선,도림천,324,346,670
<class,2호선,양천구청,2090,2124,4214
<class,2호선,신정네거리,3334,3371,6705
<class,2호선,용두,807,816,1623
<class,3호선,지축,1119,1066,2185
<class,3호선,구파발,7396,7603,14999
<class,3호선,연신내,14894,14154,29048
<class,3호선,불광,6574,7557,14131
<class,3호선,녹번,4561,4177,8738
<class,3호선,홍제,5943,5903,11846
<class,3호선,무악재,1171,1293,2464
<class,3호선,독립문,2494,2720,5214
<class,3호선,경복궁,5170,5189,10359
<class,3호선,안국,4396,4743,9139
<class,3호선,종로3가,1834,2473,4307
<class,3호선,을지로3가,1559,1590,3149
<class,3호선,동대입구,2585,3025,5610
<class,3호선,약수,4120,4027,8147
<class,3호선,금호,2886,2920,5806
<class,3호선,옥수,3106,3453,6559
<class,3호선,압구정,8611,8840,17451
<class,3호선,신사,9224,9188,18412
<class,3호선,잠원,1335,1406,2741
<class,3호선,고속터미널,25846,23623,49469
<class,3호선,교대,2493,1581,4074
<class,3호선,남부터미널,9242,9421,18663
<class,3호선,양재,8053,9482,17535
<class,3호선,매봉,2600,2608,5208
<class,3호선,도곡,1356,1425,2781
<class,3호선,대치,3333,3187,6520
<class,3호선,학여울,575,601,1176
<class,3호선,대청,2637,2577,5214
<class,3호선,일원,2153,2422,4575
<class,3호선,수서,6090,5908,11998
<class,3호선,가락시장,2743,2907,5650
<class,3호선,경찰병원,1868,1945,3813
<class,3호선,오금,1696,1687,3383
<class,4호선,수유,13851,13207,27058
<class,4호선,미아,5359,5160,10519
<class,4호선,미아사거리,11176,10689,21865
<class,4호선,길음,6576,6558,13134
<class,4호선,성신여대입구,8145,8010,16155
<class,4호선,한성대입구,4852,4911,9763
<class,4호선,동대문,4101,4663,8764
<class,4호선,동대문역사문화공원,5518,5636,11154
<class,4호선,충무로,4564,4731,9295
<class,4호선,회현,5604,5670,11274
<class,4호선,서울역,2475,4866,7341
<class,4호선,숙대입구,3744,3724,7468
<class,4호선,삼각지,1170,1394,2564
<class,4호선,신용산,4409,4433,8842
<class,4호선,이촌,2031,2419,4450
<class,4호선,동작,929,973,1902
<class,4호선,총신대입구,6664,7326,13990
<class,4호선,사당,9083,8714,17797
<class,4호선,남태령,379,346,725
<class,4호선,당고개,5272,5000,10272
<class,4호선,상계,7120,6802,13922
<class,경부선,서울역,3498,774,4272
<class,4호선,노원,7652,8315,15967
<class,4호선,창동,9719,10312,20031
<class,4호선,쌍문,10686,9844,20530
<class,5호선,방화,2414,2485,4899
<class,5호선,개화산,1809,1946,3755
<class,5호선,김포공항,4961,4471,9432
<class,5호선,송정,2500,2567,5067
<class,5호선,마곡,2264,2260,4524
<class,5호선,발산,5356,5385,10741
<class,5호선,우장산,4231,4380,8611
<class,5호선,화곡,9449,9065,18514
<class,5호선,까치산,10613,10557,21170
<class,5호선,신정,4251,3879,8130
<class,5호선,목동,5153,5311,10464
<class,5호선,오목교,7864,8066,15930
<class,5호선,양평,1843,1982,3825
<class,5호선,영등포구청,986,958,1944
<class,5호선,영등포시장,2907,3105,6012
<class,5호선,신길,1256,1485,2741
<class,5호선,여의도,3684,3789,7473
<class,5호선,여의나루,1839,1834,3673
<class,5호선,마포,3115,3142,6257
<class,5호선,공덕,2960,3104,6064
<class,5호선,애오개,1741,1910,3651
<class,5호선,충정로,896,1029,1925
<class,5호선,서대문,3242,3090,6332
<class,5호선,광화문,6232,6008,12240
<class,5호선,종로3가,4307,3718,8025
<class,5호선,을지로4가,861,801,1662
<class,5호선,동대문역사문화공원,491,592,1083
<class,5호선,청구,1241,1139,2380
<class,5호선,신금호,1985,2122,4107
<class,5호선,행당,2607,2382,4989
<class,5호선,왕십리,1695,1925,3620
<class,5호선,마장,1828,1845,3673
<class,5호선,답십리,4909,4717,9626
<class,5호선,장한평,4919,4951,9870
<class,5호선,군자,3991,4353,8344
<class,5호선,아차산,6589,6583,13172
<class,5호선,광나루,4791,4837,9628
<class,5호선,천호,8631,8274,16905
<class,5호선,강동,6215,6228,12443
<class,5호선,길동,2901,3144,6045
<class,5호선,굽은다리,3505,3371,6876
<class,5호선,명일,2576,2675,5251
<class,5호선,고덕,2714,2760,5474
<class,5호선,상일동,4820,4580,9400
<class,5호선,둔촌동,3023,3059,6082
<class,5호선,올림픽공원,1267,1173,2440
<class,5호선,방이,2333,2278,4611
<class,5호선,오금,1006,960,1966
<class,5호선,개롱,1948,2127,4075
<class,5호선,거여,2442,2446,4888
<class,5호선,마천,2230,2446,4676
<class,5호선,미사,4920,4883,9803
<class,5호선,하남풍산,1989,2049,4038
<class,6호선,응암,6354,6442,12796
<class,6호선,역촌,1304,1509,2813
<class,6호선,불광,1942,1730,3672
<class,6호선,독바위,1035,1331,2366
<class,6호선,구산,2477,1897,4374
<class,6호선,새절,4369,4408,8777
<class,6호선,증산,3841,3925,7766
<class,6호선,디지털미디어시티,3501,3763,7264
<class,6호선,월드컵경기장,2357,2246,4603
<class,6호선,마포구청,4918,4545,9463
<class,6호선,망원,5848,6244,12092
<class,6호선,합정,5369,4746,10115
<class,6호선,상수,3331,3716,7047
<class,6호선,광흥창,2376,2317,4693
<class,6호선,대흥,2299,2432,4731
<class,6호선,공덕,4426,4254,8680
<class,6호선,효창공원앞,2245,1998,4243
<class,6호선,삼각지,1812,1497,3309
<class,6호선,녹사평,2151,2005,4156
<class,6호선,이태원,5071,4745,9816
<class,6호선,한강진,2630,2858,5488
<class,6호선,버티고개,758,824,1582
<class,6호선,약수,1062,1122,2184
<class,6호선,청구,1122,1169,2291
<class,6호선,신당,2150,3026,5176
<class,6호선,동묘앞,4030,3931,7961
<class,6호선,창신,1066,1045,2111
<class,6호선,보문,2552,2496,5048
<class,6호선,안암,3029,3105,6134
<class,6호선,고려대,2660,2602,5262
<class,6호선,월곡,3702,3723,7425
<class,6호선,상월곡,2129,1886,4015
<class,6호선,돌곶이,2971,2889,5860
<class,6호선,석계,4501,4543,9044
<class,6호선,태릉입구,1974,2058,4032
<class,6호선,화랑대,3055,2702,5757
<class,6호선,봉화산,2632,2614,5246
<class,7호선,장암,770,469,1239
<class,7호선,도봉산,3370,5088,8458
<class,7호선,수락산,5643,5702,11345
<class,경원선,덕정,2169,2232,4401
<class,경원선,덕계,1042,963,2005
<class,경원선,녹양,1724,1613,3337
<class,경원선,가능,2701,2580,5281
<class,경원선,의정부,9354,9243,18597
<class,경원선,회룡,4564,4533,9097
<class,경원선,망월사,2887,2931,5818
<class,경원선,도봉산,5579,3762,9341
<class,경원선,도봉,2398,2231,4629
<class,경원선,방학,3867,3768,7635
<class,경원선,녹천,1712,1479,3191
<class,경원선,월계,2465,2434,4899
<class,경원선,광운대,2924,2988,5912
<class,경원선,석계,3235,3543,6778
<class,경원선,신이문,3232,3054,6286
<class,경원선,외대앞,3254,3109,6363
<class,경원선,청량리,8410,7992,16402
<class,경원선,왕십리,5685,6748,12433
<class,경원선,응봉,676,624,1300
<class,경원선,옥수,37,12,49
<class,경원선,한남,1347,1362,2709
<class,경원선,서빙고,564,583,1147
<class,경원선,이촌,1272,1048,2320
<class,경부선,광명,1499,1026,2525
<class,경부선,서동탄,475,433,908
<class,경부선,당정,2029,2042,4071
<class,경부선,천안,3795,3581,7376
<class,경부선,두정,2647,2832,5479
<class,경부선,직산,323,378,701
<class,경부선,성환,1572,1826,3398
<class,경부선,평택,7571,8044,15615
<class,경부선,지제,1424,1455,2879
<class,경부선,서정리,2770,4298,7068
<class,경부선,송탄,2510,2699,5209
<class,경부선,진위,515,495,1010
<class,경부선,오산,5116,5576,10692
<class,경부선,오산대,1276,1175,2451
<class,경부선,세마,1033,963,1996
<class,경부선,병점,5911,6585,12496
<class,경부선,세류,1345,1401,2746
<class,경부선,독산,4001,4074,8075
<class,경부선,수원,21659,21081,42740
<class,경부선,화서,2479,2407,4886
<class,경부선,성균관대,4947,5262,10209
<class,경부선,의왕,2781,2836,5617
<class,경부선,군포,2380,2243,4623
<class,경부선,금정,9024,9473,18497
<class,경부선,명학,2439,2381,4820
<class,경부선,안양,8948,8594,17542
<class,경부선,관악,3031,2910,5941
<class,경부선,석수,3479,3433,6912
<class,경부선,가산디지털단지,3067,4188,7255
<class,6호선,고려대,4143,3790,7933
<class,중앙선,지평,35,49,84
<class,중앙선,용문,1196,1369,2565
<class,중앙선,양평,2206,2310,4516
<class,1호선,서울역,19819,19572,39391
<class,1호선,동묘앞,9622,10043,19665
<class,1호선,시청,6974,6981,13955
<class,1호선,종각,13291,12283,25574
<class,1호선,종로3가,16598,15552,32150
<class,1호선,종로5가,13883,13930,27813
<class,1호선,동대문,8571,7655,16226
<class,1호선,신설동,8025,7669,15694
<class,1호선,제기동,14311,14915,29226
<class,1호선,청량리,16038,16146,32184
<class,2호선,시청,6002,5227,11229
<class,2호선,을지로입구,16201,15836,32037
<class,2호선,을지로3가,6989,6941,13930
<class,2호선,을지로4가,6786,6911,13697
<class,2호선,동대문역사문화공원,7596,8092,15688
<class,2호선,신당,8861,9176,18037
<class,2호선,상왕십리,7768,7441,15209
<class,2호선,왕십리,10163,8868,19031
<class,2호선,한양대,2923,2719,5642
<class,2호선,뚝섬,9508,9755,19263
<class,2호선,성수,13204,14556,27760
<class,2호선,건대입구,25886,27953,53839
<class,2호선,구의,13240,13359,26599
<class,2호선,강변,18559,19568,38127
<class,2호선,잠실나루,5782,5602,11384
<class,2호선,잠실,44166,42434,86600
<class,2호선,잠실새내,12609,13072,25681
<class,2호선,종합운동장,3145,3310,6455
<class,2호선,삼성,20783,20874,41657
<class,2호선,선릉,19097,16908,36005
<class,2호선,역삼,14833,16201,31034
<class,2호선,강남,46935,45811,92746
<class,2호선,교대,13612,14905,28517
<class,2호선,서초,8057,7197,15254
<class,2호선,방배,8143,8376,16519
<class,2호선,사당,22582,24395,46977
<class,2호선,낙성대,17366,16266,33632
<class,5호선,마곡,3760,3655,7415
<class,2호선,서울대입구,30941,30090,61031
<class,2호선,봉천,14372,13455,27827
<class,2호선,신림,41656,40024,81680
<class,2호선,신대방,16250,15901,32151
<class,2호선,구로디지털단지,28129,28501,56630
<class,2호선,대림,14850,15870,30720
<class,2호선,신도림,31237,30847,62084
<class,2호선,문래,9012,9405,18417
<class,2호선,영등포구청,10076,10439,20515
<class,2호선,당산,10120,10860,20980
<class,2호선,합정,20246,21329,41575
<class,2호선,홍대입구,41910,44057,85967
<class,2호선,신촌,22163,22469,44632
<class,2호선,이대,7064,7499,14563
<class,2호선,아현,6268,6071,12339
<class,2호선,충정로,4247,4403,8650
<class,2호선,용답,1760,1632,3392
<class,2호선,신답,799,844,1643
<class,2호선,신설동,2622,2601,5223
<class,2호선,도림천,715,712,1427
<class,2호선,양천구청,3425,3517,6942
<class,2호선,신정네거리,5641,5782,11423
<class,2호선,용두,1571,1572,3143
<class,3호선,지축,1912,1817,3729
<class,3호선,구파발,11657,11686,23343
<class,3호선,연신내,24696,23233,47929
<class,3호선,불광,10436,11839,22275
<class,3호선,녹번,7923,6997,14920
<class,3호선,홍제,10459,9847,20306
<class,3호선,무악재,2151,2214,4365
<class,3호선,독립문,4394,4562,8956
<class,3호선,경복궁,9980,10203,20183
<class,3호선,안국,8627,9939,18566
<class,3호선,종로3가,3756,5651,9407
<class,3호선,을지로3가,3656,4085,7741
<class,3호선,충무로,1,0,1
<class,3호선,동대입구,4063,4656,8719
<class,3호선,약수,7556,7176,14732
<class,3호선,금호,5052,4628,9680
<class,3호선,옥수,5637,5751,11388
<class,3호선,압구정,20544,21095,41639
<class,3호선,신사,21044,21455,42499
<class,3호선,잠원,2594,2460,5054
<class,3호선,고속터미널,33398,34387,67785
<class,3호선,교대,4939,2989,7928
<class,3호선,남부터미널,15383,15529,30912
<class,3호선,양재,15216,16542,31758
<class,3호선,매봉,4710,4588,9298
<class,3호선,도곡,2668,2607,5275
<class,3호선,대치,7037,6227,13264
<class,3호선,학여울,884,828,1712
<class,3호선,대청,4558,4241,8799
<class,3호선,일원,3906,3861,7767
<class,3호선,수서,8618,8752,17370
<class,3호선,가락시장,5110,4938,10048
<class,3호선,경찰병원,3098,3011,6109
<class,3호선,오금,2801,2832,5633
<class,4호선,수유,21797,21441,43238
<class,4호선,미아,9114,9015,18129
<class,4호선,미아사거리,17862,17605,35467
<class,4호선,길음,11165,10743,21908
<class,4호선,성신여대입구,13155,12533,25688
<class,4호선,한성대입구,8324,7970,16294
<class,4호선,혜화,17769,18099,35868
<class,4호선,동대문,10712,10764,21476
<class,4호선,동대문역사문화공원,8677,7411,16088
<class,4호선,충무로,9483,9893,19376
<class,4호선,명동,9068,10324,19392
<class,4호선,회현,13064,13846,26910
<class,4호선,서울역,3831,7331,11162
<class,4호선,숙대입구,6868,6582,13450
<class,4호선,삼각지,2116,2641,4757
<class,4호선,신용산,6822,7242,14064
<class,4호선,이촌,4388,4841,9229
<class,4호선,동작,1614,1682,3296
<class,4호선,총신대입구,11794,12693,24487
<class,4호선,사당,14793,13026,27819
<class,4호선,남태령,656,505,1161
<class,4호선,당고개,7922,7775,15697
<class,4호선,상계,11514,10886,22400
<class,4호선,노원,13209,14389,27598
<class,4호선,창동,16683,17563,34246
<class,4호선,쌍문,17520,16098,33618
<class,5호선,방화,3859,3701,7560
<class,5호선,개화산,3000,3001,6001
<class,5호선,김포공항,5320,5548,10868
<class,5호선,송정,4147,3862,8009
<class,5호선,발산,9319,10128,19447
<class,5호선,우장산,7727,7812,15539
<class,5호선,화곡,16342,15263,31605
<class,5호선,까치산,17347,17033,34380
<class,5호선,신정,7291,6197,13488
<class,5호선,목동,8969,9341,18310
<class,5호선,오목교,13816,14312,28128
<class,5호선,양평,3028,2934,5962
<class,5호선,영등포구청,1741,1625,3366
<class,5호선,영등포시장,5675,5986,11661
<class,5호선,신길,2030,2160,4190
<class,5호선,여의도,6395,6902,13297
<class,5호선,여의나루,3654,3621,7275
<class,5호선,마포,5773,5848,11621
<class,5호선,공덕,5659,5727,11386
<class,5호선,애오개,3120,2927,6047
<class,5호선,충정로,1612,1505,3117
<class,5호선,서대문,5444,5410,10854
<class,5호선,광화문,10463,10272,20735
<class,5호선,종로3가,7774,8186,15960
<class,5호선,을지로4가,2579,2803,5382
<class,5호선,동대문역사문화공원,795,995,1790
<class,5호선,청구,2084,1972,4056
<class,5호선,신금호,3427,3408,6835
<class,5호선,행당,4462,3932,8394
<class,5호선,왕십리,2753,3222,5975
<class,5호선,마장,3410,3295,6705
<class,5호선,답십리,8326,7819,16145
<class,5호선,장한평,8854,8817,17671
<class,5호선,군자,6637,7382,14019
<class,5호선,아차산,9869,9899,19768
<class,5호선,광나루,7417,6953,14370
<class,5호선,천호,13415,12899,26314
<class,5호선,강동,10902,10262,21164
<class,5호선,길동,4903,5051,9954
<class,5호선,굽은다리,5557,5259,10816
<class,5호선,명일,4723,4742,9465
<class,5호선,고덕,4789,4644,9433
<class,5호선,상일동,8235,7654,15889
<class,5호선,둔촌동,5210,5080,10290
<class,5호선,올림픽공원,2253,2000,4253
<class,5호선,방이,4066,3993,8059
<class,5호선,오금,1929,1802,3731
<class,5호선,개롱,3480,3659,7139
<class,5호선,거여,4250,4102,8352
<class,5호선,마천,3631,3751,7382
<class,5호선,미사,7918,7870,15788
<class,5호선,하남풍산,2795,3106,5901
<class,6호선,응암,10493,10606,21099
<class,6호선,역촌,2122,2445,4567
<class,6호선,불광,2991,2803,5794
<class,6호선,독바위,1708,1986,3694
<class,6호선,구산,4431,3446,7877
<class,6호선,새절,7347,7069,14416
<class,6호선,증산,6267,6276,12543
<class,6호선,디지털미디어시티,5877,6137,12014
<class,6호선,월드컵경기장,3754,3691,7445
<class,6호선,마포구청,7785,6802,14587
<class,6호선,망원,10751,11818,22569
<class,6호선,합정,9529,8560,18089
<class,6호선,상수,5342,6201,11543
<class,6호선,광흥창,4036,3829,7865
<class,6호선,대흥,4135,4117,8252
<class,6호선,공덕,7953,7835,15788
<class,6호선,효창공원앞,3718,3189,6907
<class,6호선,삼각지,3152,2533,5685
<class,6호선,녹사평,3393,3474,6867
<class,6호선,이태원,7512,7720,15232
<class,6호선,한강진,4642,5605,10247
<class,6호선,버티고개,1256,1299,2555
<class,6호선,약수,2074,2088,4162
<class,6호선,청구,2064,2088,4152
<class,6호선,신당,4318,3522,7840
<class,6호선,동묘앞,6343,5911,12254
<class,6호선,창신,1831,1500,3331
<class,6호선,보문,4015,3679,7694
<class,6호선,안암,4629,4369,8998
<class,6호선,월곡,6122,6181,12303
<class,6호선,상월곡,3431,2992,6423
<class,6호선,돌곶이,4596,4373,8969
<class,6호선,석계,7145,7237,14382
<class,6호선,태릉입구,3231,3368,6599
<class,6호선,화랑대,5734,4756,10490
<class,6호선,봉화산,4263,4103,8366
<class,7호선,장암,1203,788,1991
<class,7호선,도봉산,5105,7160,12265
<class,7호선,수락산,8111,8198,16309
<class,7호선,마들,7151,6895,14046
<class,7호선,노원,12712,13370,26082
<class,7호선,중계,7515,6797,14312
<class,7호선,하계,9709,9127,18836
<class,7호선,공릉,7299,7140,14439
<class,7호선,태릉입구,5346,4753,10099
<class,7호선,먹골,6360,6244,12604
<class,7호선,중화,6479,6320,12799
<class,7호선,상봉,11018,10722,21740
<class,7호선,면목,9411,9260,18671
<class,7호선,사가정,10262,10279,20541
<class,7호선,용마산,3532,3647,7179
<class,7호선,중곡,5662,5424,11086
<class,7호선,군자,8967,6929,15896
<class,7호선,어린이대공원,6934,6438,13372
<class,7호선,건대입구,8803,8482,17285
<class,7호선,뚝섬유원지,5140,4921,10061
<class,7호선,청담,9416,9914,19330
<class,7호선,강남구청,8012,8598,16610
<class,7호선,학동,8506,8921,17427
<class,7호선,논현,9827,10622,20449
<class,7호선,반포,3562,3224,6786
<class,7호선,고속터미널,9807,7864,17671
<class,7호선,내방,6888,6656,13544
<class,7호선,이수,9719,9061,18780
<class,7호선,남성,6553,6095,12648
<class,7호선,숭실대입구,6417,6359,12776
<class,7호선,상도,6025,5643,11668
<class,7호선,장승배기,5780,5667,11447
<class,7호선,신대방삼거리,9649,9198,18847
<class,7호선,보라매,4850,4825,9675
<class,7호선,신풍,6817,6533,13350
<class,7호선,대림,5517,5900,11417
<class,7호선,남구로,7221,7741,14962
<class,7호선,가산디지털단지,12427,11519,23946
<class,7호선,철산,12150,12243,24393
<class,7호선,광명사거리,14407,14516,28923
<class,7호선,천왕,5436,5204,10640
<class,7호선,온수,4830,4717,9547
<class,7호선,까치울,4249,4140,8389
<class,7호선,부천종합운동장,2438,2214,4652
<class,7호선,춘의,4454,4247,8701
<class,7호선,신중동,7586,7585,15171
<class,7호선,부천시청,7663,7547,15210
<class,7호선,상동,7652,7899,15551
<class,7호선,삼산체육관,2433,2336,4769
<class,7호선,굴포천,5115,5302,10417
<class,7호선,부평구청,5800,5057,10857
<class,8호선,암사,10255,9544,19799
<class,8호선,천호,10291,11810,22101
<class,8호선,강동구청,5105,5260,10365
<class,8호선,몽촌토성,3201,3230,6431
<class,8호선,잠실,9899,10697,20596
<class,8호선,석촌,4843,5644,10487
<class,8호선,송파,4257,4277,8534
<class,8호선,가락시장,4856,5051,9907
<class,8호선,문정,6822,7011,13833
<class,8호선,장지,9963,9662,19625
<class,8호선,복정,5437,4787,10224
<class,8호선,산성,4208,4208,8416
<class,8호선,남한산성입구,7681,6891,14572
<class,8호선,단대오거리,6142,5912,12054
<class,8호선,신흥,3203,3359,6562
<class,8호선,수진,3579,3348,6927
<class,8호선,모란,3068,2449,5517
<class,9호선,개화,1017,867,1884
<class,9호선,김포공항,5441,8060,13501
<class,9호선,공항시장,1836,1965,3801
<class,9호선,신방화,3627,3603,7230
<class,9호선,마곡나루,5832,5711,11543
<class,9호선,양천향교,4599,4537,9136
<class,9호선,가양,11304,10771,22075
<class,9호선,증미,3500,3522,7022
<class,9호선,등촌,5942,5750,11692
<class,9호선,염창,9138,8723,17861
<class,9호선,신목동,1747,1571,3318
<class,9호선,선유도,2821,2811,5632
<class,9호선,당산,9889,9428,19317
<class,9호선,국회의사당,2953,3012,5965
<class,9호선,여의도,6203,5977,12180
<class,9호선,샛강,2014,2112,4126
<class,9호선,노량진,16271,16227,32498
<class,9호선,노들,2522,2152,4674
<class,9호선,흑석,4540,4414,8954
<class,9호선,동작,1058,816,1874
<class,9호선,구반포,1659,1825,3484
<class,9호선,신반포,1787,1575,3362
<class,9호선,고속터미널,8408,11355,19763
<class,9호선,사평,1561,1473,3034
<class,9호선,신논현,19731,19451,39182
<class,9호선2~3단계,언주,4857,4879,9736
<class,9호선2~3단계,선정릉,3833,4164,7997
<class,9호선2~3단계,삼성중앙,2424,2398,4822
<class,9호선2~3단계,봉은사,7412,7372,14784
<class,9호선2~3단계,종합운동장,2251,2093,4344
<class,9호선2~3단계,삼전,3947,3718,7665
<class,9호선2~3단계,석촌고분,3383,3268,6651
<class,9호선2~3단계,석촌,4919,4200,9119
<class,9호선2~3단계,송파나루,2940,3106,6046
<class,9호선2~3단계,한성백제,1397,1184,2581
<class,9호선2~3단계,올림픽공원,3029,3074,6103
<class,9호선2~3단계,둔촌오륜,569,506,1075
<class,9호선2~3단계,중앙보훈병원,3229,3013,6242
<class,경강선,판교,2219,2069,4288
<class,경강선,이매,591,449,1040
<class,경강선,삼동,1188,1156,2344
<class,경강선,경기광주,3672,3681,7353
<class,경강선,초월,1644,1523,3167
<class,경강선,곤지암,1334,1276,2610
<class,경강선,신둔도예촌,701,691,1392
<class,경강선,이천,1919,1980,3899
<class,경강선,부발,1474,1165,2639
<class,경강선,세종대왕릉,203,209,412
<class,경강선,여주,1415,1557,2972
<class,경부선,서울역,3149,960,4109
<class,경부선,남영,4441,4767,9208
<class,경부선,용산,20933,21985,42918
<class,경부선,노량진,6995,6587,13582
<class,경부선,대방,6296,6121,12417
<class,경부선,영등포,29349,30772,60121
<class,경부선,신도림,2243,2227,4470
<class,경부선,신길,5134,4314,9448
<class,경부선,구로,10575,11058,21633
<class,경부선,가산디지털단지,4968,6607,11575
<class,경부선,금천구청,6630,6709,13339
<class,경부선,석수,5602,5332,10934
<class,경부선,관악,4716,4498,9214
<class,경부선,안양,13970,14060,28030
<class,경부선,명학,4146,3959,8105
<class,경부선,금정,14683,14705,29388
<class,경부선,군포,3794,3528,7322
<class,경부선,의왕,4678,4601,9279
<class,경부선,성균관대,7759,7787,15546
<class,경부선,화서,3918,3953,7871
<class,경부선,수원,27275,29600,56875
<class,경부선,독산,7109,7137,14246
<class,경부선,세류,1897,1854,3751
<class,경부선,병점,9086,8808,17894
<class,경부선,세마,1627,1422,3049
<class,경부선,오산대,1947,1858,3805
<class,경부선,오산,7232,6791,14023
<class,경부선,진위,874,723,1597
<class,경부선,송탄,3367,2981,6348
<class,경부선,서정리,4863,3922,8785
<class,경부선,지제,2074,1848,3922
<class,경부선,평택,9761,9210,18971
<class,경부선,성환,2200,2137,4337
<class,경부선,직산,470,434,904
<class,경부선,두정,3464,3532,6996
<class,경부선,천안,4194,4342,8536
<class,경부선,당정,3101,3018,6119
<class,경부선,서동탄,804,808,1612
<class,경부선,광명,1791,1666,3457
<class,경원선,이촌,2322,1774,4096
<class,경원선,서빙고,1015,902,1917
<class,경원선,한남,2401,2166,4567
<class,경원선,옥수,24,25,49
<class,경원선,응봉,1108,978,2086
<class,경원선,왕십리,9164,10259,19423
<class,경원선,청량리,11026,12204,23230
<class,경원선,외대앞,4863,4705,9568
<class,경원선,신이문,5087,4628,9715
<class,경원선,석계,5607,5794,11401
<class,경원선,광운대,4777,4632,9409
<class,경원선,월계,4111,3756,7867
<class,경원선,녹천,2825,2448,5273
<class,경원선,방학,6083,5986,12069
<class,경원선,도봉,3595,3441,7036
<class,경원선,도봉산,7504,4991,12495
<class,경원선,망월사,4293,4490,8783
<class,경원선,회룡,7698,7743,15441
<class,경원선,의정부,13347,14021,27368
<class,경원선,가능,4104,3930,8034
<class,경원선,녹양,2687,2699,5386
<class,경원선,양주,4491,4401,8892
<class,경원선,덕계,1708,1506,3214
<class,경원선,덕정,3207,3133,6340
<class,경원선,지행,4005,3971,7976
<class,경원선,동두천중앙,1940,2019,3959
<class,경원선,보산,1120,1172,2292
<class,경원선,동두천,1185,1432,2617
<class,경원선,소요산,2732,2423,5155
<class,경의선,서울역,874,905,1779
<class,경의선,신촌,290,265,555
<class,경의선,효창공원앞,1354,1521,2875
<class,경의선,공덕,1882,1443,3325
<class,경의선,서강대,1209,1103,2312
<class,경의선,홍대입구,1320,1374,2694
<class,경의선,가좌,2937,2827,5764
<class,경의선,디지털미디어시티,1422,1329,2751
<class,경의선,수색,1022,1005,2027
<class,경의선,화전,712,687,1399
<class,경의선,강매,1491,1363,2854
<class,경의선,행신,3788,3908,7696
<class,경의선,능곡,2166,2092,4258
<class,경의선,곡산,309,337,646
<class,경의선,백마,3317,3173,6490
<class,경의선,풍산,3295,3274,6569
<class,경의선,일산,5060,5020,10080
<class,경의선,탄현,4124,4056,8180
<class,경의선,야당,3761,3640,7401
<class,경의선,운정,3229,3144,6373
<class,경의선,금릉,2742,2723,5465
<class,경의선,금촌,4077,4060,8137
<class,경의선,월롱,975,936,1911
<class,경의선,파주,608,478,1086
<class,경의선,문산,3220,3213,6433
<class,경의선,임진강,38,30,68
<class,경인선,개봉,13375,13414,26789
<class,경인선,오류동,7389,7028,14417
<class,경인선,역곡,16319,16158,32477
<class,경인선,부천,23802,24704,48506
<class,경인선,송내,14425,14326,28751
<class,경인선,부평,22937,25328,48265
<class,경인선,백운,4446,4384,8830
<class,경인선,동암,10460,10695,21155
<class,경인선,주안,12292,11187,23479
<class,경인선,제물포,5893,5814,11707
<class,경인선,동인천,9314,9156,18470
<class,경인선,인천,2953,2392,5345
<class,경인선,구일,3449,3304,6753
<class,경인선,소사,6237,6053,12290
<class,경인선,부개,5006,4833,9839
<class,경인선,간석,3465,3299,6764
<class,경인선,도원,1671,1712,3383
<class,경인선,온수,3845,3629,7474
<class,경인선,중동,5212,5009,10221
<class,경인선,도화,2485,2318,4803
<class,경춘선,신내,791,836,1627
<class,경춘선,갈매,1500,1314,2814
<class,경춘선,별내,1665,1634,3299
<class,경춘선,퇴계원,2132,1988,4120
<class,경춘선,사릉,1811,1726,3537
<class,경춘선,금곡,879,825,1704
<class,경춘선,평내호평,3520,3399,6919
<class,경춘선,천마산,1001,1081,2082
<class,경춘선,마석,2374,2464,4838
<class,경춘선,대성리,354,336,690
<class,경춘선,청평,940,1028,1968
<class,경춘선,상천,246,206,452
<class,경춘선,가평,936,1020,1956
<class,경춘선,굴봉산,79,96,175
<class,경춘선,백양리,159,157,316
<class,경춘선,강촌,323,381,704
<class,경춘선,김유정,274,279,553
<class,경춘선,남춘천,1604,1733,3337
<class,경춘선,춘천,949,925,1874
<class,공항철도 1호선,서울역,4466,4274,8740
<class,공항철도 1호선,공덕,1112,1685,2797
<class,공항철도 1호선,홍대입구,7364,7226,14590
<class,공항철도 1호선,디지털미디어시티,4193,3829,8022
<class,공항철도 1호선,마곡나루,2122,2280,4402
<class,공항철도 1호선,김포공항,6862,3886,10748
<class,공항철도 1호선,계양,4705,4370,9075
<class,공항철도 1호선,검암,3566,3688,7254
<class,공항철도 1호선,청라국제도시,3027,2884,5911
<class,공항철도 1호선,운서,4414,4457,8871
<class,공항철도 1호선,공항화물청사,1237,1240,2477
<class,공항철도 1호선,인천공항1터미널,2642,2793,5435
<class,공항철도 1호선,인천공항2터미널,1543,1393,2936
<class,공항철도 1호선,영종,1961,2047,4008
<class,과천선,선바위,3849,3435,7284
<class,과천선,경마공원,866,841,1707
<class,과천선,대공원,2527,2711,5238
<class,과천선,과천,3085,2892,5977
<class,과천선,정부과천청사,3875,3912,7787
<class,과천선,인덕원,12096,11705,23801
<class,과천선,평촌,7090,7145,14235
<class,과천선,범계,15385,15031,30416
<class,분당선,선릉,4250,6375,10625
<class,분당선,한티,8814,8516,17330
<class,분당선,도곡,3264,3015,6279
<class,분당선,구룡,891,810,1701
<class,분당선,개포동,1997,1974,3971
<class,분당선,대모산입구,2016,1815,3831
<class,분당선,수서,6857,6950,13807
<class,분당선,수원,5969,4851,10820
<class,분당선,서울숲,5016,4999,10015
<class,분당선,압구정로데오,14171,15143,29314
<class,분당선,강남구청,4151,5004,9155
<class,분당선,선정릉,2776,2938,5714
<class,분당선,가천대,3847,4309,8156
<class,분당선,태평,8852,8614,17466
<class,분당선,모란,12876,12842,25718
<class,분당선,야탑,13763,14348,28111
<class,분당선,서현,14968,15240,30208
<class,분당선,수내,7161,6704,13865
<class,분당선,정자,8892,8986,17878
<class,분당선,미금,8802,9090,17892
<class,분당선,오리,6220,5166,11386
<class,분당선,이매,2894,2767,5661
<class,분당선,보정,1265,1218,2483
<class,분당선,죽전,7873,8912,16785
<class,분당선,구성,2477,2625,5102
<class,분당선,신갈,2105,2126,4231
<class,분당선,기흥,5251,4962,10213
<class,분당선,상갈,3035,3079,6114
<class,분당선,청명,2060,2006,4066
<class,분당선,영통,5685,5429,11114
<class,분당선,망포,7352,6831,14183
<class,분당선,매탄권선,2636,2436,5072
<class,분당선,수원시청,8210,8994,17204
<class,분당선,매교,1619,1680,3299
<class,수인선,고색,1878,1887,3765
<class,수인선,오목천,1361,1227,2588
<class,수인선,어천,401,389,790
<class,수인선,야목,163,149,312
<class,수인선,사리,2283,2013,4296
<class,수인선,달월,47,40,87
<class,수인선,월곶,1639,1656,3295
<class,수인선,소래포구,4518,4671,9189
<class,수인선,인천논현,3677,3752,7429
<class,수인선,호구포,2130,2097,4227
<class,수인선,남동인더스파크,992,950,1942
<class,수인선,원인재,2909,2993,5902
<class,수인선,연수,3084,3198,6282
<class,수인선,송도,1698,1576,3274
<class,수인선,인하대,3332,3072,6404
<class,수인선,숭의,2324,2170,4494
<class,수인선,신포,1109,1179,2288
<class,수인선,인천,878,1498,2376
<class,안산선,산본,9610,10334,19944
<class,안산선,대야미,3063,2665,5728
<class,안산선,반월,2643,2562,5205
<class,안산선,상록수,9974,9951,19925
<class,안산선,한대앞,5359,5451,10810
<class,안산선,중앙,12526,12895,25421
<class,안산선,고잔,4779,4611,9390
<class,안산선,초지,2405,2437,4842
<class,안산선,안산,8134,8291,16425
<class,안산선,신길온천,1083,1061,2144
<class,안산선,정왕,4864,4816,9680
<class,안산선,오이도,5600,5880,11480
<class,안산선,수리산,2273,2131,4404
<class,우이신설선,북한산우이,2159,2252,4411
<class,우이신설선,솔밭공원,1488,1407,2895
<class,우이신설선,4.19민주묘지,1864,1613,3477
<class,우이신설선,가오리,2407,2269,4676
<class,우이신설선,화계,2019,1898,3917
<class,우이신설선,삼양,1304,1353,2657
<class,우이신설선,삼양사거리,1589,1580,3169
<class,우이신설선,솔샘,2940,2672,5612
<class,우이신설선,북한산보국문,3741,3411,7152
<class,우이신설선,정릉,2812,2406,5218
<class,우이신설선,성신여대입구,2196,2602,4798
<class,우이신설선,보문,945,924,1869
<class,우이신설선,신설동,1378,1251,2629
<class,일산선,원흥,5136,5083,10219
<class,일산선,삼송,10913,10742,21655
<class,일산선,원당,6629,6344,12973
<class,일산선,화정,10223,10701,20924
<class,일산선,대곡,916,779,1695
<class,일산선,백석,6270,6398,12668
<class,일산선,마두,3983,4058,8041
<class,일산선,정발산,4879,4854,9733
<class,일산선,주엽,5036,5071,10107
<class,일산선,대화,6647,6214,12861
<class,장항선,봉명,557,550,1107
<class,장항선,쌍용,1099,1034,2133
<class,장항선,아산,1928,1981,3909
<class,장항선,배방,658,652,1310
<class,장항선,온양온천,2840,2784,5624
<class,장항선,신창,700,647,1347
<class,중앙선,회기,15740,14595,30335
<class,중앙선,중랑,3590,3419,7009
<class,중앙선,상봉,3886,3865,7751
<class,중앙선,망우,4896,4951,9847
<class,중앙선,양원,892,841,1733
<class,중앙선,구리,8006,8348,16354
<class,중앙선,도농,5302,5021,10323
<class,중앙선,양정,393,359,752
<class,중앙선,덕소,3515,3542,7057
<class,중앙선,도심,1271,1116,2387
<class,중앙선,팔당,1018,1139,2157
<class,중앙선,운길산,858,755,1613
<class,중앙선,양수,1365,1452,2817
<class,중앙선,신원,264,162,426
<class,중앙선,국수,478,533,1011
<class,중앙선,아신,311,378,689
<class,중앙선,오빈,195,201,396
<class,중앙선,원덕,264,250,514
<class,9호선,동작,815,675,1490
<class,중앙선,용문,1275,1023,2298
<class,7호선,중곡,4118,4007,8125
<class,1호선,시청,5073,4913,9986
<class,1호선,서울역,16049,14725,30774
<class,1호선,동묘앞,10510,10859,21369
<class,1호선,종각,8840,7709,16549
<class,1호선,종로3가,10098,9047,19145
<class,1호선,종로5가,6012,6056,12068
<class,1호선,동대문,7072,7786,14858
<class,1호선,신설동,5880,5919,11799
<class,1호선,제기동,8491,8979,17470
<class,1호선,청량리,10637,10563,21200
<class,2호선,시청,4135,3321,7456
<class,2호선,을지로입구,11433,10901,22334
<class,2호선,을지로3가,4680,4180,8860
<class,2호선,을지로4가,2418,2502,4920
<class,2호선,동대문역사문화공원,5295,6437,11732
<class,2호선,신당,6345,6767,13112
<class,2호선,상왕십리,5310,5407,10717
<class,2호선,왕십리,6940,6127,13067
<class,2호선,한양대,1709,1775,3484
<class,2호선,뚝섬,6639,6874,13513
<class,2호선,성수,8857,9687,18544
<class,2호선,건대입구,19334,20291,39625
<class,2호선,구의,8909,9058,17967
<class,2호선,강변,14918,14353,29271
<class,2호선,잠실나루,3821,3869,7690
<class,2호선,잠실,31371,29238,60609
<class,2호선,잠실새내,7792,8209,16001
<class,2호선,종합운동장,2255,2523,4778
<class,2호선,삼성,14102,13815,27917
<class,2호선,선릉,9637,8228,17865
<class,2호선,역삼,8476,9453,17929
<class,2호선,강남,24876,23930,48806
<class,2호선,교대,7574,8416,15990
<class,2호선,서초,6054,5659,11713
<class,2호선,방배,4978,5293,10271
<class,2호선,사당,15326,17155,32481
<class,2호선,낙성대,11928,12349,24277
<class,2호선,서울대입구,20766,21423,42189
<class,2호선,봉천,9323,9281,18604
<class,2호선,신림,29027,28694,57721
<class,2호선,신대방,11720,11681,23401
<class,2호선,구로디지털단지,18036,17917,35953
<class,2호선,대림,11293,11478,22771
<class,2호선,신도림,20419,20200,40619
<class,2호선,문래,5422,5630,11052
<class,2호선,영등포구청,5829,6112,11941
<class,2호선,당산,6881,7193,14074
<class,2호선,합정,14156,14570,28726
<class,2호선,홍대입구,31486,31258,62744
<class,2호선,신촌,15243,14945,30188
<class,2호선,이대,4488,4842,9330
<class,2호선,아현,3995,3870,7865
<class,2호선,충정로,2934,3035,5969
<class,2호선,용답,1323,1370,2693
<class,2호선,신답,576,602,1178
<class,2호선,신설동,2347,2411,4758
<class,2호선,도림천,347,369,716
<class,2호선,양천구청,2417,2442,4859
<class,2호선,신정네거리,3656,3735,7391
<class,2호선,용두,894,918,1812
<class,3호선,지축,1273,1196,2469
<class,3호선,구파발,8295,8334,16629
<class,3호선,연신내,17441,16321,33762
<class,3호선,불광,7635,9019,16654
<class,3호선,녹번,5168,4677,9845
<class,3호선,홍제,6919,6655,13574
<class,3호선,무악재,1429,1528,2957
<class,3호선,독립문,3102,3475,6577
<class,3호선,경복궁,7286,7653,14939
<class,3호선,안국,6439,7079,13518
<class,3호선,종로3가,2247,3270,5517
<class,3호선,을지로3가,1900,1915,3815
<class,3호선,동대입구,3430,4038,7468
<class,3호선,약수,5089,4812,9901
<class,3호선,금호,3377,3349,6726
<class,3호선,옥수,4069,4253,8322
<class,3호선,압구정,10073,10382,20455
<class,3호선,신사,10927,11078,22005
<class,3호선,잠원,1852,1846,3698
<class,3호선,고속터미널,28080,25914,53994
<class,3호선,교대,2892,1822,4714
<class,3호선,남부터미널,10322,10667,20989
<class,3호선,양재,9336,10978,20314
<class,3호선,매봉,3283,3253,6536
<class,3호선,도곡,1477,1444,2921
<class,3호선,대치,4378,3920,8298
<class,3호선,학여울,590,560,1150
<class,3호선,대청,3028,2922,5950
<class,3호선,일원,2695,2760,5455
<class,3호선,수서,6465,6497,12962
<class,3호선,가락시장,2868,3113,5981
<class,3호선,경찰병원,2002,2154,4156
<class,3호선,오금,2134,2109,4243
<class,4호선,수유,15410,14713,30123
<class,4호선,미아,6334,6077,12411
<class,4호선,미아사거리,12385,11814,24199
<class,4호선,길음,7425,7284,14709
<class,4호선,성신여대입구,9117,8934,18051
<class,4호선,한성대입구,5782,5659,11441
<class,4호선,혜화,13862,14090,27952
<class,4호선,동대문,4926,5494,10420
<class,4호선,동대문역사문화공원,6601,6639,13240
<class,4호선,충무로,5479,5512,10991
<class,4호선,명동,7064,7294,14358
<class,4호선,회현,6541,6609,13150
<class,4호선,서울역,2831,5452,8283
<class,4호선,숙대입구,4624,4571,9195
<class,4호선,삼각지,1340,1712,3052
<class,4호선,신용산,4933,4871,9804
<class,4호선,이촌,3186,3748,6934
<class,4호선,동작,1460,1454,2914
<class,4호선,총신대입구,7621,8367,15988
<class,4호선,사당,10169,9987,20156
<class,4호선,남태령,377,352,729
<class,4호선,당고개,6180,5958,12138
<class,4호선,상계,8095,7687,15782
<class,4호선,노원,8957,9626,18583
<class,4호선,창동,12012,12576,24588
<class,4호선,쌍문,12098,11044,23142
<class,5호선,방화,2902,2762,5664
<class,5호선,개화산,2039,2139,4178
<class,5호선,김포공항,4881,4601,9482
<class,5호선,송정,2676,2775,5451
<class,5호선,마곡,2407,2430,4837
<class,5호선,발산,6045,6234,12279
<class,5호선,우장산,4836,4976,9812
<class,5호선,화곡,10432,9929,20361
<class,5호선,까치산,11913,11742,23655
<class,5호선,신정,4837,4381,9218
<class,5호선,목동,5756,6021,11777
<class,5호선,오목교,8782,9101,17883
<class,5호선,양평,1895,1976,3871
<class,5호선,영등포구청,1039,1056,2095
<class,5호선,영등포시장,3376,3497,6873
<class,5호선,신길,1366,1599,2965
<class,5호선,여의도,4120,4427,8547
<class,5호선,여의나루,3759,3697,7456
<class,5호선,마포,3536,3610,7146
<class,5호선,공덕,3175,3298,6473
<class,5호선,애오개,2024,2190,4214
<class,5호선,충정로,1052,1142,2194
<class,5호선,서대문,3675,3717,7392
<class,5호선,광화문,7769,7574,15343
<class,5호선,종로3가,5822,5183,11005
<class,5호선,을지로4가,1060,1039,2099
<class,5호선,동대문역사문화공원,547,665,1212
<class,5호선,청구,1390,1263,2653
<class,5호선,신금호,2217,2463,4680
<class,5호선,행당,3108,2863,5971
<class,5호선,왕십리,1799,2024,3823
<class,5호선,마장,2331,2317,4648
<class,5호선,답십리,5658,5217,10875
<class,5호선,장한평,5552,5460,11012
<class,5호선,군자,4533,4936,9469
<class,5호선,아차산,8245,8272,16517
<class,5호선,광나루,5685,5626,11311
<class,5호선,천호,9209,8633,17842
<class,5호선,강동,7185,7075,14260
<class,5호선,길동,3201,3357,6558
<class,5호선,굽은다리,3756,3512,7268
<class,5호선,명일,3171,3245,6416
<class,5호선,고덕,2870,2878,5748
<class,5호선,상일동,5397,5304,10701
<class,5호선,둔촌동,3345,3399,6744
<class,5호선,올림픽공원,1582,1346,2928
<class,5호선,방이,3000,2882,5882
<class,5호선,오금,1306,1170,2476
<class,5호선,개롱,2278,2413,4691
<class,5호선,거여,2769,2816,5585
<class,5호선,마천,2585,2823,5408
<class,5호선,미사,5402,5379,10781
<class,5호선,하남풍산,2085,2226,4311
<class,6호선,응암,7135,7313,14448
<class,6호선,역촌,1482,1796,3278
<class,6호선,불광,2306,2172,4478
<class,6호선,독바위,1297,1643,2940
<class,6호선,구산,2849,2243,5092
<class,6호선,새절,5120,5088,10208
<class,6호선,증산,4364,4495,8859
<class,6호선,디지털미디어시티,4045,4255,8300
<class,6호선,월드컵경기장,2701,2648,5349
<class,6호선,마포구청,5677,5035,10712
<class,6호선,망원,7470,8171,15641
<class,6호선,합정,6730,6035,12765
<class,6호선,상수,3930,4432,8362
<class,6호선,광흥창,3159,3045,6204
<class,6호선,대흥,2659,2751,5410
<class,6호선,공덕,5186,4821,10007
<class,6호선,효창공원앞,2505,2288,4793
<class,6호선,삼각지,2206,1711,3917
<class,6호선,녹사평,2728,2620,5348
<class,6호선,이태원,6003,5667,11670
<class,6호선,한강진,3670,4232,7902
<class,6호선,버티고개,842,907,1749
<class,6호선,약수,1328,1351,2679
<class,6호선,청구,1327,1305,2632
<class,6호선,신당,2480,3206,5686
<class,6호선,동묘앞,4776,4467,9243
<class,6호선,창신,1304,1189,2493
<class,6호선,보문,2918,2754,5672
<class,6호선,안암,3345,3565,6910
<class,6호선,고려대,2956,2863,5819
<class,6호선,월곡,4181,4175,8356
<class,6호선,상월곡,2420,2219,4639
<class,6호선,돌곶이,3408,3227,6635
<class,6호선,석계,4949,4935,9884
<class,6호선,태릉입구,2363,2402,4765
<class,6호선,화랑대,3682,3190,6872
<class,6호선,봉화산,2924,2863,5787
<class,7호선,장암,1029,697,1726
<class,7호선,도봉산,4180,6367,10547
<class,7호선,수락산,6615,6746,13361
<class,7호선,마들,4706,4381,9087
<class,7호선,노원,8375,8302,16677
<class,7호선,중계,5133,4744,9877
<class,7호선,하계,6983,6671,13654
<class,7호선,공릉,4925,5110,10035
<class,7호선,태릉입구,3571,3389,6960
<class,7호선,먹골,4316,4201,8517
<class,7호선,중화,4591,4506,9097
<class,7호선,상봉,7268,6847,14115
<class,7호선,면목,6320,6375,12695
<class,7호선,사가정,7424,7201,14625
<class,7호선,용마산,2588,2810,5398
<class,7호선,군자,5868,4764,10632
<class,7호선,어린이대공원,5205,5129,10334
<class,7호선,건대입구,5783,5670,11453
<class,7호선,뚝섬유원지,4704,4359,9063
<class,7호선,청담,4866,5114,9980
<class,7호선,강남구청,4368,4682,9050
<class,7호선,학동,4584,4813,9397
<class,7호선,논현,5310,5533,10843
<class,7호선,반포,2009,2058,4067
<class,7호선,고속터미널,8795,5992,14787
<class,7호선,내방,4064,4282,8346
<class,7호선,이수,6069,5693,11762
<class,7호선,남성,4155,4262,8417
<class,7호선,숭실대입구,4380,4644,9024
<class,7호선,상도,3949,4052,8001
<class,7호선,장승배기,4131,3948,8079
<class,7호선,신대방삼거리,6492,6352,12844
<class,7호선,보라매,3332,3364,6696
<class,7호선,신풍,4761,4525,9286
<class,7호선,대림,4733,4462,9195
<class,7호선,남구로,5517,5243,10760
<class,7호선,가산디지털단지,8483,7953,16436
<class,7호선,철산,7941,8062,16003
<class,7호선,광명사거리,9742,9576,19318
<class,7호선,천왕,3897,3762,7659
<class,7호선,온수,2994,3140,6134
<class,7호선,까치울,2903,2875,5778
<class,7호선,부천종합운동장,1792,1684,3476
<class,7호선,춘의,2720,2611,5331
<class,7호선,신중동,5173,4947,10120
<class,7호선,부천시청,4922,4759,9681
<class,7호선,상동,4836,4819,9655
<class,7호선,삼산체육관,1724,1661,3385
<class,7호선,굴포천,3475,3373,6848
<class,7호선,부평구청,3890,3316,7206
<class,8호선,암사,7079,6695,13774
<class,8호선,천호,6943,7876,14819
<class,8호선,강동구청,3414,3598,7012
<class,8호선,몽촌토성,2490,2433,4923
<class,8호선,잠실,7184,7545,14729
<class,8호선,석촌,3221,3857,7078
<class,8호선,송파,2768,2988,5756
<class,8호선,가락시장,2649,3422,6071
<class,8호선,문정,4205,4363,8568
<class,8호선,장지,7237,7481,14718
<class,8호선,복정,3667,3506,7173
<class,8호선,산성,3125,3186,6311
<class,8호선,남한산성입구,5601,5154,10755
<class,8호선,단대오거리,4269,4273,8542
<class,8호선,신흥,2255,2352,4607
<class,8호선,수진,2460,2268,4728
<class,8호선,모란,2811,2318,5129
<class,9호선,개화,862,679,1541
<class,9호선,김포공항,5005,7258,12263
<class,9호선,공항시장,1273,1367,2640
<class,9호선,신방화,2527,2499,5026
<class,9호선,마곡나루,3858,3962,7820
<class,9호선,양천향교,3016,3234,6250
<class,9호선,가양,7455,7593,15048
<class,9호선,증미,1886,1888,3774
<class,9호선,등촌,3847,4019,7866
<class,9호선,염창,6205,6143,12348
<class,9호선,신목동,1230,1065,2295
<class,9호선,선유도,1920,1970,3890
<class,9호선,당산,6399,6233,12632
<class,9호선,국회의사당,3058,2822,5880
<class,9호선,여의도,4296,3922,8218
<class,9호선,샛강,1216,1229,2445
<class,9호선,노량진,10375,11066,21441
<class,9호선,노들,1870,1644,3514
<class,9호선,흑석,3046,3153,6199
<class,9호선,구반포,867,869,1736
<class,9호선,신반포,1056,1122,2178
<class,9호선,고속터미널,6668,8174,14842
<class,9호선,사평,905,1001,1906
<class,9호선,신논현,11202,10650,21852
<class,9호선2~3단계,언주,2729,2722,5451
<class,9호선2~3단계,선정릉,2363,2514,4877
<class,9호선2~3단계,삼성중앙,1416,1513,2929
<class,9호선2~3단계,봉은사,4877,4683,9560
<class,9호선2~3단계,종합운동장,1363,1335,2698
<class,9호선2~3단계,삼전,2697,2667,5364
<class,9호선2~3단계,석촌고분,2339,2328,4667
<class,9호선2~3단계,석촌,3242,2948,6190
<class,9호선2~3단계,송파나루,2035,2228,4263
<class,9호선2~3단계,한성백제,1047,912,1959
<class,9호선2~3단계,올림픽공원,2241,2214,4455
<class,9호선2~3단계,둔촌오륜,317,329,646
<class,9호선2~3단계,중앙보훈병원,2334,2288,4622
<class,경강선,판교,1738,1579,3317
<class,경강선,이매,463,346,809
<class,경강선,삼동,737,768,1505
<class,경강선,경기광주,2708,2788,5496
<class,경강선,초월,1125,1193,2318
<class,경강선,곤지암,1062,1119,2181
<class,경강선,신둔도예촌,555,513,1068
<class,경강선,이천,1512,1565,3077
<class,경강선,부발,916,1569,2485
<class,경강선,세종대왕릉,162,158,320
<class,경강선,여주,1297,1183,2480
<class,경부선,서울역,3484,790,4274
<class,경부선,남영,3095,3472,6567
<class,경부선,용산,18319,16708,35027
<class,경부선,노량진,4677,4567,9244
<class,경부선,대방,4393,4680,9073
<class,경부선,영등포,22525,21801,44326
<class,경부선,신도림,1589,1575,3164
<class,경부선,신길,3740,3261,7001
<class,경부선,구로,7388,7373,14761
<class,경부선,가산디지털단지,3439,4734,8173
<class,경부선,금천구청,4810,4689,9499
<class,경부선,석수,4076,4188,8264
<class,경부선,관악,3770,3393,7163
<class,경부선,안양,10164,9852,20016
<class,경부선,명학,2667,2629,5296
<class,경부선,금정,10232,10705,20937
<class,경부선,군포,2568,2474,5042
<class,경부선,의왕,3309,3279,6588
<class,경부선,성균관대,5801,6097,11898
<class,경부선,화서,2838,2784,5622
<class,경부선,수원,23385,23091,46476
<class,경부선,독산,4576,4634,9210
<class,경부선,세류,1506,1543,3049
<class,경부선,병점,6472,7239,13711
<class,경부선,세마,1167,1092,2259
<class,경부선,오산대,1465,1377,2842
<class,경부선,오산,5389,5908,11297
<class,경부선,진위,547,583,1130
<class,경부선,송탄,2577,2851,5428
<class,경부선,서정리,3034,4399,7433
<class,경부선,지제,1407,1443,2850
<class,경부선,평택,8099,8720,16819
<class,경부선,성환,1763,1970,3733
<class,경부선,직산,369,409,778
<class,경부선,두정,2921,3166,6087
<class,경부선,천안,4223,4057,8280
<class,경부선,당정,2238,2301,4539
<class,경부선,서동탄,632,578,1210
<class,경부선,광명,1561,1123,2684
<class,경원선,이촌,1675,1287,2962
<class,경원선,서빙고,826,819,1645
<class,경원선,한남,1568,1545,3113
<class,경원선,옥수,47,10,57
<class,경원선,응봉,820,732,1552
<class,경원선,왕십리,6139,6875,13014
<class,경원선,청량리,8884,8911,17795
<class,경원선,외대앞,3554,3407,6961
<class,경원선,신이문,3700,3479,7179
<class,경원선,석계,3792,4058,7850
<class,경원선,광운대,3263,3312,6575
<class,경원선,월계,2916,2645,5561
<class,경원선,녹천,2186,1916,4102
<class,경원선,방학,4507,4382,8889
<class,경원선,도봉,2765,2605,5370
<class,경원선,도봉산,7352,5244,12596
<class,경원선,망월사,3091,3275,6366
<class,경원선,회룡,5649,5552,11201
<class,경원선,의정부,10224,10127,20351
<class,경원선,가능,3158,2919,6077
<class,경원선,녹양,1977,1896,3873
<class,경원선,양주,3514,3335,6849
<class,경원선,덕계,1178,1083,2261
<class,경원선,덕정,2336,2433,4769
<class,경원선,지행,3032,2923,5955
<class,경원선,동두천중앙,1543,1434,2977
<class,경원선,보산,951,906,1857
<class,경원선,동두천,929,1100,2029
<class,경원선,소요산,2985,2603,5588
<class,경의선,서울역,622,612,1234
<class,경의선,신촌,203,220,423
<class,경의선,효창공원앞,995,1134,2129
<class,경의선,공덕,1274,1019,2293
<class,경의선,서강대,820,795,1615
<class,경의선,홍대입구,1015,1056,2071
<class,경의선,가좌,2126,2156,4282
<class,경의선,디지털미디어시티,1042,860,1902
<class,경의선,수색,687,711,1398
<class,경의선,화전,521,519,1040
<class,경의선,강매,1085,997,2082
<class,경의선,행신,3033,2972,6005
<class,경의선,능곡,1613,1512,3125
<class,경의선,곡산,190,201,391
<class,경의선,백마,2254,2192,4446
<class,경의선,풍산,2456,2389,4845
<class,경의선,일산,3299,3265,6564
<class,경의선,탄현,3015,2913,5928
<class,경의선,야당,2616,2558,5174
<class,경의선,운정,2329,2186,4515
<class,경의선,금릉,1946,1824,3770
<class,경의선,금촌,2898,3101,5999
<class,경의선,월롱,533,927,1460
<class,경의선,파주,450,397,847
<class,경의선,문산,2583,2607,5190
<class,경의선,임진강,44,34,78
<class,경인선,개봉,8851,9050,17901
<class,경인선,오류동,5210,4862,10072
<class,경인선,역곡,10765,10503,21268
<class,경인선,부천,16644,15901,32545
<class,경인선,송내,9942,9770,19712
<class,경인선,부평,17352,17540,34892
<class,경인선,백운,3001,2911,5912
<class,경인선,동암,7481,7370,14851
<class,경인선,주안,8977,7937,16914
<class,경인선,제물포,4377,4242,8619
<class,경인선,동인천,7161,6924,14085
<class,경인선,인천,2829,2292,5121
<class,경인선,구일,2450,2411,4861
<class,경인선,소사,4374,4163,8537
<class,경인선,부개,3439,3303,6742
<class,경인선,간석,2466,2291,4757
<class,경인선,도원,1308,1325,2633
<class,경인선,온수,2675,2645,5320
<class,경인선,중동,3736,3455,7191
<class,경인선,도화,1782,1710,3492
<class,경춘선,신내,575,595,1170
<class,경춘선,갈매,1103,961,2064
<class,경춘선,별내,1264,1240,2504
<class,경춘선,퇴계원,1502,1384,2886
<class,경춘선,사릉,1269,1241,2510
<class,경춘선,금곡,646,632,1278
<class,경춘선,평내호평,2445,2353,4798
<class,경춘선,천마산,888,808,1696
<class,경춘선,마석,1692,1702,3394
<class,경춘선,대성리,414,291,705
<class,경춘선,청평,913,842,1755
<class,경춘선,상천,311,234,545
<class,경춘선,가평,1004,868,1872
<class,경춘선,굴봉산,108,133,241
<class,경춘선,백양리,205,151,356
<class,경춘선,강촌,474,375,849
<class,경춘선,김유정,281,314,595
<class,경춘선,남춘천,1532,1619,3151
<class,경춘선,춘천,1020,809,1829
<class,공항철도 1호선,서울역,4265,3662,7927
<class,공항철도 1호선,공덕,849,1195,2044
<class,공항철도 1호선,홍대입구,6020,5465,11485
<class,공항철도 1호선,디지털미디어시티,2712,2613,5325
<class,공항철도 1호선,마곡나루,1544,1598,3142
<class,공항철도 1호선,김포공항,7233,4081,11314
<class,공항철도 1호선,계양,3353,3246,6599
<class,공항철도 1호선,검암,2666,2800,5466
<class,공항철도 1호선,청라국제도시,2158,2067,4225
<class,공항철도 1호선,운서,3525,3732,7257
<class,공항철도 1호선,공항화물청사,822,924,1746
<class,공항철도 1호선,인천공항1터미널,2761,2688,5449
<class,공항철도 1호선,인천공항2터미널,1393,1248,2641
<class,공항철도 1호선,영종,1567,1569,3136
<class,과천선,선바위,2550,2488,5038
<class,과천선,경마공원,567,569,1136
<class,과천선,대공원,2814,2942,5756
<class,과천선,과천,2250,2004,4254
<class,과천선,정부과천청사,2767,2929,5696
<class,과천선,인덕원,8203,8032,16235
<class,과천선,평촌,4597,4492,9089
<class,과천선,범계,10510,10310,20820
<class,분당선,선릉,2156,2916,5072
<class,분당선,한티,6329,6057,12386
<class,분당선,도곡,1859,1924,3783
<class,분당선,구룡,481,499,980
<class,분당선,개포동,1254,1321,2575
<class,분당선,대모산입구,1378,1321,2699
<class,분당선,수서,5460,5487,10947
<class,분당선,수원,4423,3490,7913
<class,분당선,서울숲,3680,3796,7476
<class,분당선,압구정로데오,7582,8102,15684
<class,분당선,강남구청,2313,2757,5070
<class,분당선,선정릉,1541,1795,3336
<class,분당선,가천대,2531,3034,5565
<class,분당선,태평,6181,5927,12108
<class,분당선,모란,11036,11405,22441
<class,분당선,야탑,9719,9968,19687
<class,분당선,서현,10569,10428,20997
<class,분당선,수내,4669,4602,9271
<class,분당선,정자,5816,5808,11624
<class,분당선,미금,5361,5851,11212
<class,분당선,오리,4329,3794,8123
<class,분당선,이매,2073,2149,4222
<class,분당선,보정,810,773,1583
<class,분당선,죽전,5923,6641,12564
<class,분당선,구성,1710,1802,3512
<class,분당선,신갈,1466,1538,3004
<class,분당선,기흥,3841,3613,7454
<class,분당선,상갈,2146,2222,4368
<class,분당선,청명,1492,1444,2936
<class,분당선,영통,3520,3471,6991
<class,분당선,망포,4571,4872,9443
<class,분당선,매탄권선,1784,1819,3603
<class,분당선,수원시청,5419,5263,10682
<class,분당선,매교,1081,1107,2188
<class,수인선,고색,1249,1260,2509
<class,수인선,오목천,957,989,1946
<class,수인선,어천,326,399,725
<class,수인선,야목,120,112,232
<class,수인선,사리,1686,1484,3170
<class,수인선,달월,27,28,55
<class,수인선,월곶,1265,1181,2446
<class,수인선,소래포구,4091,3897,7988
<class,수인선,인천논현,2395,2460,4855
<class,수인선,호구포,1602,1640,3242
<class,수인선,남동인더스파크,501,568,1069
<class,수인선,원인재,2254,2242,4496
<class,수인선,연수,2258,2192,4450
<class,수인선,송도,1348,1222,2570
<class,수인선,인하대,2385,2201,4586
<class,수인선,숭의,1506,1428,2934
<class,수인선,신포,862,863,1725
<class,수인선,인천,788,1236,2024
<class,안산선,산본,6508,6865,13373
<class,안산선,대야미,2309,2116,4425
<class,안산선,반월,1945,1910,3855
<class,안산선,상록수,7067,6953,14020
<class,안산선,한대앞,3835,3707,7542
<class,안산선,중앙,8869,8521,17390
<class,안산선,고잔,3141,2977,6118
<class,안산선,초지,1597,1617,3214
<class,안산선,안산,7820,7038,14858
<class,안산선,신길온천,816,758,1574
<class,안산선,정왕,3656,3829,7485
<class,안산선,오이도,4409,4458,8867
<class,안산선,수리산,1604,1686,3290
<class,우이신설선,북한산우이,2218,2461,4679
<class,우이신설선,솔밭공원,1054,1076,2130
<class,우이신설선,4.19민주묘지,1538,1298,2836
<class,우이신설선,가오리,1854,1755,3609
<class,우이신설선,화계,1595,1491,3086
<class,우이신설선,삼양,969,956,1925
<class,우이신설선,삼양사거리,1195,1179,2374
<class,우이신설선,솔샘,2014,1901,3915
<class,우이신설선,북한산보국문,2775,2461,5236
<class,우이신설선,정릉,2055,1822,3877
<class,우이신설선,성신여대입구,1602,1805,3407
<class,우이신설선,보문,693,742,1435
<class,우이신설선,신설동,908,915,1823
<class,일산선,원흥,3734,3555,7289
<class,일산선,삼송,7985,7872,15857
<class,일산선,원당,4777,4625,9402
<class,일산선,화정,6998,7269,14267
<class,일산선,대곡,691,579,1270
<class,일산선,백석,4466,4356,8822
<class,일산선,마두,2544,2540,5084
<class,일산선,정발산,3772,3711,7483
<class,일산선,주엽,3279,3207,6486
<class,일산선,대화,4555,4260,8815
<class,장항선,봉명,469,454,923
<class,장항선,쌍용,967,948,1915
<class,장항선,아산,2061,1511,3572
<class,장항선,배방,603,689,1292
<class,장항선,온양온천,3241,3300,6541
<class,장항선,신창,718,723,1441
<class,중앙선,회기,10808,10767,21575
<class,중앙선,중랑,2601,2527,5128
<class,중앙선,상봉,3120,3071,6191
<class,중앙선,망우,3386,3455,6841
<class,중앙선,양원,621,688,1309
<class,중앙선,구리,5764,5919,11683
<class,중앙선,도농,3652,3709,7361
<class,중앙선,양정,322,266,588
<class,중앙선,덕소,2639,2662,5301
<class,중앙선,도심,921,830,1751
<class,중앙선,팔당,1215,1216,2431
<class,중앙선,운길산,869,766,1635
<class,중앙선,양수,1261,1155,2416
<class,중앙선,신원,223,158,381
<class,중앙선,국수,480,447,927
<class,중앙선,아신,321,286,607
<class,중앙선,오빈,123,117,240
<class,중앙선,양평,1499,1328,2827
<class,중앙선,원덕,215,183,398
<class,중앙선,지평,44,30,74
<class,수인선,사리,2343,1981,4324
<class,6호선,공덕,8143,7816,15959
<class,경원선,동두천,1149,1375,2524
<class,1호선,서울역,19916,19323,39239
<class,1호선,동묘앞,8969,9312,18281
<class,1호선,시청,7080,7002,14082
<class,1호선,종각,13267,12430,25697
<class,1호선,종로3가,16478,15372,31850
<class,1호선,종로5가,13906,13999,27905
<class,1호선,동대문,8543,7806,16349
<class,1호선,신설동,7878,7479,15357
<class,1호선,제기동,14031,14657,28688
<class,1호선,청량리,16512,16349,32861
<class,2호선,시청,6026,5353,11379
<class,2호선,을지로입구,16216,15864,32080
<class,2호선,을지로3가,7401,7192,14593
<class,2호선,을지로4가,6358,6543,12901
<class,2호선,동대문역사문화공원,7031,7593,14624
<class,2호선,신당,9135,9370,18505
<class,2호선,상왕십리,7934,7499,15433
<class,2호선,왕십리,10308,9056,19364
<class,2호선,한양대,2484,2363,4847
<class,2호선,뚝섬,9709,10000,19709
<class,2호선,성수,13495,14968,28463
<class,2호선,건대입구,26762,28794,55556
<class,2호선,구의,13508,13364,26872
<class,2호선,강변,18697,19503,38200
<class,2호선,잠실나루,5730,5521,11251
<class,2호선,잠실,45980,44184,90164
<class,2호선,잠실새내,13385,13839,27224
<class,2호선,종합운동장,3291,3640,6931
<class,2호선,삼성,21860,21986,43846
<class,2호선,선릉,19292,17171,36463
<class,2호선,역삼,14826,16028,30854
<class,2호선,강남,48890,48134,97024
<class,2호선,교대,13501,15052,28553
<class,2호선,서초,7557,6662,14219
<class,2호선,방배,8000,8170,16170
<class,2호선,사당,22676,24606,47282
<class,2호선,낙성대,17099,16195,33294
<class,2호선,서울대입구,31084,30123,61207
<class,2호선,봉천,14416,13501,27917
<class,2호선,신림,41411,40059,81470
<class,2호선,신대방,16217,15966,32183
<class,2호선,구로디지털단지,28651,28766,57417
<class,2호선,대림,14812,15805,30617
<class,2호선,신도림,31746,31558,63304
<class,2호선,문래,9429,9810,19239
<class,2호선,영등포구청,9980,10157,20137
<class,2호선,당산,9879,10770,20649
<class,2호선,합정,20632,21993,42625
<class,2호선,홍대입구,44160,46513,90673
<class,2호선,신촌,22925,23295,46220
<class,2호선,이대,7282,7589,14871
<class,2호선,아현,6151,5950,12101
<class,2호선,충정로,4490,4585,9075
<class,2호선,용답,1590,1612,3202
<class,2호선,신답,850,872,1722
<class,2호선,신설동,2576,2623,5199
<class,2호선,도림천,753,707,1460
<class,2호선,양천구청,3439,3493,6932
<class,2호선,신정네거리,5661,5879,11540
<class,2호선,용두,1498,1515,3013
<class,3호선,지축,2024,1892,3916
<class,3호선,구파발,11906,11853,23759
<class,3호선,연신내,24939,23784,48723
<class,3호선,불광,10663,11960,22623
<class,3호선,녹번,7878,7113,14991
<class,3호선,홍제,10583,10081,20664
<class,3호선,무악재,2238,2212,4450
<class,3호선,독립문,4380,4564,8944
<class,3호선,경복궁,9838,9996,19834
<class,3호선,안국,8994,10222,19216
<class,3호선,종로3가,4092,5632,9724
<class,3호선,을지로3가,3675,4129,7804
<class,3호선,충무로,2,0,2
<class,3호선,동대입구,3913,4316,8229
<class,3호선,약수,7529,7133,14662
<class,3호선,금호,5106,4738,9844
<class,3호선,옥수,5771,5825,11596
<class,3호선,압구정,21194,21791,42985
<class,3호선,신사,21771,22059,43830
<class,3호선,잠원,2570,2583,5153
<class,3호선,고속터미널,35084,35475,70559
<class,3호선,교대,5039,3047,8086
<class,3호선,남부터미널,15367,15497,30864
<class,3호선,양재,14876,16317,31193
<class,3호선,매봉,4785,4673,9458
<class,3호선,도곡,2538,2520,5058
<class,3호선,대치,7352,6461,13813
<class,3호선,학여울,877,843,1720
<class,3호선,대청,4533,4161,8694
<class,3호선,일원,3734,3699,7433
<class,3호선,수서,8872,9036,17908
<class,3호선,가락시장,5467,5195,10662
<class,3호선,경찰병원,3222,3134,6356
<class,3호선,오금,2909,2705,5614
<class,4호선,수유,21978,21740,43718
<class,4호선,미아,9298,8967,18265
<class,4호선,미아사거리,18168,17899,36067
<class,4호선,길음,11158,10717,21875
<class,4호선,성신여대입구,13678,13142,26820
<class,4호선,한성대입구,8406,7925,16331
<class,4호선,혜화,18151,18382,36533
<class,4호선,동대문,10646,10908,21554
<class,4호선,동대문역사문화공원,8896,7744,16640
<class,4호선,충무로,9606,9790,19396
<class,4호선,명동,9130,10183,19313
<class,4호선,회현,12903,13989,26892
<class,4호선,서울역,3937,7388,11325
<class,4호선,숙대입구,6857,6612,13469
<class,4호선,삼각지,2137,2550,4687
<class,4호선,신용산,7020,7439,14459
<class,4호선,이촌,4401,4816,9217
<class,4호선,동작,1506,1479,2985
<class,4호선,총신대입구,11778,12747,24525
<class,4호선,사당,14985,13060,28045
<class,4호선,남태령,587,470,1057
<class,4호선,당고개,8059,7621,15680
<class,4호선,상계,11434,10850,22284
<class,4호선,노원,13191,14558,27749
<class,4호선,창동,17130,18224,35354
<class,4호선,쌍문,17851,16468,34319
<class,5호선,방화,3814,3619,7433
<class,5호선,개화산,2978,2984,5962
<class,5호선,김포공항,5604,5798,11402
<class,5호선,송정,4096,4117,8213
<class,5호선,마곡,3934,3813,7747
<class,5호선,발산,9529,10167,19696
<class,5호선,우장산,7982,8007,15989
<class,5호선,화곡,16318,15360,31678
<class,5호선,까치산,17582,16973,34555
<class,5호선,신정,7421,6490,13911
<class,5호선,목동,9181,9489,18670
<class,5호선,오목교,13989,14331,28320
<class,5호선,양평,2970,2904,5874
<class,5호선,영등포구청,1604,1611,3215
<class,5호선,영등포시장,5592,5746,11338
<class,5호선,신길,1937,2256,4193
<class,5호선,여의도,6369,6811,13180
<class,5호선,여의나루,3187,3165,6352
<class,5호선,마포,5809,5964,11773
<class,5호선,공덕,5702,5893,11595
<class,5호선,애오개,3125,3019,6144
<class,5호선,충정로,1511,1395,2906
<class,5호선,서대문,5355,5348,10703
<class,5호선,광화문,10969,10624,21593
<class,5호선,종로3가,8158,8147,16305
<class,5호선,을지로4가,2878,3149,6027
<class,5호선,동대문역사문화공원,848,1140,1988
<class,5호선,청구,2098,1988,4086
<class,5호선,신금호,3389,3306,6695
<class,5호선,행당,4677,4075,8752
<class,5호선,왕십리,2792,3188,5980
<class,5호선,마장,3605,3567,7172
<class,5호선,답십리,8672,7970,16642
<class,5호선,장한평,9018,9014,18032
<class,5호선,군자,7003,7745,14748
<class,5호선,아차산,9477,9485,18962
<class,5호선,광나루,7184,6690,13874
<class,5호선,천호,13549,12943,26492
<class,5호선,강동,10814,10196,21010
<class,5호선,길동,4973,5153,10126
<class,5호선,굽은다리,5763,5386,11149
<class,5호선,명일,4867,4778,9645
<class,5호선,고덕,4875,4654,9529
<class,5호선,상일동,8540,7823,16363
<class,5호선,둔촌동,5091,5021,10112
<class,5호선,올림픽공원,2256,2037,4293
<class,5호선,방이,4111,4045,8156
<class,5호선,오금,1778,1600,3378
<class,5호선,개롱,3460,3572,7032
<class,5호선,거여,4338,4249,8587
<class,5호선,마천,3558,3595,7153
<class,5호선,미사,8050,8091,16141
<class,5호선,하남풍산,2816,3042,5858
<class,6호선,응암,10440,10485,20925
<class,6호선,역촌,2194,2490,4684
<class,6호선,불광,3113,2866,5979
<class,6호선,독바위,1639,1825,3464
<class,6호선,구산,4359,3415,7774
<class,6호선,새절,7322,6948,14270
<class,6호선,증산,6447,6346,12793
<class,6호선,디지털미디어시티,5680,5935,11615
<class,6호선,월드컵경기장,3807,3830,7637
<class,6호선,마포구청,7717,6857,14574
<class,6호선,망원,10934,11791,22725
<class,6호선,합정,9380,8680,18060
<class,6호선,상수,5706,6654,12360
<class,6호선,광흥창,4167,3995,8162
<class,6호선,대흥,4181,4129,8310
<class,6호선,효창공원앞,3743,3393,7136
<class,6호선,삼각지,3137,2626,5763
<class,6호선,녹사평,3575,3679,7254
<class,6호선,이태원,7669,7928,15597
<class,6호선,한강진,5025,5802,10827
<class,6호선,버티고개,1265,1268,2533
<class,6호선,약수,2075,2102,4177
<class,6호선,청구,2131,2014,4145
<class,6호선,신당,4644,3797,8441
<class,6호선,동묘앞,6260,5672,11932
<class,6호선,창신,1818,1520,3338
<class,6호선,보문,4077,3716,7793
<class,6호선,안암,4825,4681,9506
<class,6호선,고려대,4244,4059,8303
<class,6호선,월곡,6447,6329,12776
<class,6호선,상월곡,3417,3092,6509
<class,6호선,돌곶이,4814,4544,9358
<class,6호선,석계,7112,7019,14131
<class,6호선,태릉입구,3271,3419,6690
<class,6호선,화랑대,5165,4335,9500
<class,6호선,봉화산,4299,4169,8468
<class,7호선,장암,1111,791,1902
<class,7호선,도봉산,4796,6728,11524
<class,7호선,수락산,8051,7950,16001
<class,7호선,마들,7374,6956,14330
<class,7호선,노원,12895,13343,26238
<class,7호선,중계,7532,6798,14330
<class,7호선,하계,9823,9180,19003
<class,7호선,공릉,7276,7191,14467
<class,7호선,태릉입구,5100,4697,9797
<class,7호선,먹골,6295,6294,12589
<class,7호선,중화,6549,6338,12887
<class,7호선,상봉,11137,10716,21853
<class,7호선,면목,9259,9069,18328
<class,7호선,사가정,10340,10283,20623
<class,7호선,용마산,3637,3597,7234
<class,7호선,중곡,5828,5568,11396
<class,7호선,군자,8886,6908,15794
<class,7호선,어린이대공원,6738,6441,13179
<class,7호선,건대입구,8951,8808,17759
<class,7호선,뚝섬유원지,4630,4419,9049
<class,7호선,청담,9272,9641,18913
<class,7호선,강남구청,8033,8792,16825
<class,7호선,학동,8681,9099,17780
<class,7호선,논현,9864,10533,20397
<class,7호선,반포,3540,3295,6835
<class,7호선,고속터미널,10040,8301,18341
<class,7호선,내방,6773,6652,13425
<class,7호선,이수,10136,9424,19560
<class,7호선,남성,6476,6112,12588
<class,7호선,숭실대입구,7003,6880,13883
<class,7호선,상도,5944,5658,11602
<class,7호선,장승배기,5915,5630,11545
<class,7호선,신대방삼거리,9502,9041,18543
<class,7호선,보라매,5026,4949,9975
<class,7호선,신풍,6925,6610,13535
<class,7호선,대림,5617,6045,11662
<class,7호선,남구로,7228,7629,14857
<class,7호선,가산디지털단지,12447,11568,24015
<class,7호선,철산,12339,12512,24851
<class,7호선,광명사거리,14413,14542,28955
<class,7호선,천왕,5811,5588,11399
<class,7호선,온수,4839,4704,9543
<class,7호선,까치울,4142,4166,8308
<class,7호선,부천종합운동장,2337,2273,4610
<class,7호선,춘의,4265,4216,8481
<class,7호선,신중동,7861,7913,15774
<class,7호선,부천시청,7745,7720,15465
<class,7호선,상동,7823,7925,15748
<class,7호선,삼산체육관,2551,2405,4956
<class,7호선,굴포천,5108,5283,10391
<class,7호선,부평구청,5708,5068,10776
<class,8호선,암사,10551,9975,20526
<class,8호선,천호,10351,12120,22471
<class,8호선,강동구청,5139,5186,10325
<class,8호선,몽촌토성,3341,3250,6591
<class,8호선,잠실,10371,11280,21651
<class,8호선,석촌,4917,5795,10712
<class,8호선,송파,4417,4501,8918
<class,8호선,가락시장,5086,5089,10175
<class,8호선,문정,6796,6852,13648
<class,8호선,장지,10271,10032,20303
<class,8호선,복정,5459,4699,10158
<class,8호선,산성,4072,4143,8215
<class,8호선,남한산성입구,7658,6887,14545
<class,8호선,단대오거리,6211,5879,12090
<class,8호선,신흥,3083,3303,6386
<class,8호선,수진,3454,3180,6634
<class,8호선,모란,3135,2458,5593
<class,9호선,개화,994,851,1845
<class,9호선,김포공항,5829,8601,14430
<class,9호선,공항시장,1868,1962,3830
<class,9호선,신방화,3824,3680,7504
<class,9호선,마곡나루,5699,5719,11418
<class,9호선,양천향교,4712,4603,9315
<class,9호선,가양,11252,10849,22101
<class,9호선,증미,3367,3496,6863
<class,9호선,등촌,6020,5799,11819
<class,9호선,염창,9168,8750,17918
<class,9호선,신목동,1694,1497,3191
<class,9호선,선유도,2795,2841,5636
<class,9호선,당산,9963,9290,19253
<class,9호선,국회의사당,3010,3098,6108
<class,9호선,여의도,6072,5748,11820
<class,9호선,샛강,2088,2204,4292
<class,9호선,노량진,15932,16201,32133
<class,9호선,노들,2521,2228,4749
<class,9호선,흑석,4286,4370,8656
<class,9호선,동작,1021,770,1791
<class,9호선,구반포,1646,1755,3401
<class,9호선,신반포,1914,1833,3747
<class,9호선,고속터미널,8713,11653,20366
<class,9호선,사평,1627,1514,3141
<class,9호선,신논현,20266,19934,40200
<class,9호선2~3단계,언주,4816,4712,9528
<class,9호선2~3단계,선정릉,3765,4198,7963
<class,9호선2~3단계,삼성중앙,2523,2551,5074
<class,9호선2~3단계,봉은사,7705,7790,15495
<class,9호선2~3단계,종합운동장,2447,2139,4586
<class,9호선2~3단계,삼전,4044,3795,7839
<class,9호선2~3단계,석촌고분,3465,3335,6800
<class,9호선2~3단계,석촌,4983,4178,9161
<class,9호선2~3단계,송파나루,3031,3276,6307
<class,9호선2~3단계,한성백제,1462,1249,2711
<class,9호선2~3단계,올림픽공원,2907,3055,5962
<class,9호선2~3단계,둔촌오륜,556,502,1058
<class,9호선2~3단계,중앙보훈병원,3267,2996,6263
<class,경강선,판교,2175,2121,4296
<class,경강선,이매,551,435,986
<class,경강선,삼동,1149,1073,2222
<class,경강선,경기광주,3826,3666,7492
<class,경강선,초월,1694,1592,3286
<class,경강선,곤지암,1378,1349,2727
<class,경강선,신둔도예촌,717,697,1414
<class,경강선,이천,1841,1937,3778
<class,경강선,부발,1450,1163,2613
<class,경강선,세종대왕릉,178,207,385
<class,경강선,여주,1330,1399,2729
<class,경부선,서울역,3154,878,4032
<class,경부선,남영,4805,4992,9797
<class,경부선,용산,21473,22570,44043
<class,경부선,노량진,6741,6445,13186
<class,경부선,대방,6136,6091,12227
<class,경부선,영등포,30010,31202,61212
<class,경부선,신도림,2103,2204,4307
<class,경부선,신길,5117,4181,9298
<class,경부선,구로,10646,10817,21463
<class,경부선,가산디지털단지,4865,6525,11390
<class,경부선,금천구청,6569,6401,12970
<class,경부선,석수,5409,5093,10502
<class,경부선,관악,4565,4429,8994
<class,경부선,안양,14072,14160,28232
<class,경부선,명학,4212,3978,8190
<class,경부선,금정,14620,14888,29508
<class,경부선,군포,3598,3472,7070
<class,경부선,의왕,4625,4655,9280
<class,경부선,성균관대,7891,7834,15725
<class,경부선,화서,3844,3830,7674
<class,경부선,수원,27006,29176,56182
<class,경부선,독산,7057,7125,14182
<class,경부선,세류,1931,1977,3908
<class,경부선,병점,8986,8838,17824
<class,경부선,세마,1608,1374,2982
<class,경부선,오산대,1916,1741,3657
<class,경부선,오산,6950,6500,13450
<class,경부선,진위,868,770,1638
<class,경부선,송탄,3288,2961,6249
<class,경부선,서정리,4785,3870,8655
<class,경부선,지제,2070,1837,3907
<class,경부선,평택,9814,9156,18970
<class,경부선,성환,2102,1918,4020
<class,경부선,직산,528,497,1025
<class,경부선,두정,3511,3562,7073
<class,경부선,천안,4192,4388,8580
<class,경부선,당정,3140,3143,6283
<class,경부선,서동탄,834,833,1667
<class,경부선,광명,1729,1447,3176
<class,경원선,이촌,2366,1739,4105
<class,경원선,서빙고,977,925,1902
<class,경원선,한남,2287,2183,4470
<class,경원선,옥수,27,25,52
<class,경원선,응봉,1112,911,2023
<class,경원선,왕십리,9117,10297,19414
<class,경원선,청량리,11138,12364,23502
<class,경원선,외대앞,4722,4515,9237
<class,경원선,신이문,5145,4620,9765
<class,경원선,석계,5362,5820,11182
<class,경원선,광운대,4443,4469,8912
<class,경원선,월계,3833,3623,7456
<class,경원선,녹천,2648,2269,4917
<class,경원선,방학,6001,5901,11902
<class,경원선,도봉,3662,3525,7187
<class,경원선,도봉산,6413,4190,10603
<class,경원선,망월사,4276,4526,8802
<class,경원선,회룡,7528,7458,14986
<class,경원선,의정부,13499,14248,27747
<class,경원선,가능,4028,3933,7961
<class,경원선,녹양,2715,2647,5362
<class,경원선,양주,4678,4529,9207
<class,경원선,덕계,1562,1502,3064
<class,경원선,덕정,3203,3046,6249
<class,경원선,지행,4060,4029,8089
<class,경원선,동두천중앙,2062,2153,4215
<class,경원선,보산,1063,1083,2146
<class,경원선,소요산,2191,1902,4093
<class,경의선,서울역,850,1008,1858
<class,경의선,신촌,329,308,637
<class,경의선,효창공원앞,1453,1621,3074
<class,경의선,공덕,1975,1520,3495
<class,경의선,서강대,1256,1179,2435
<class,경의선,홍대입구,1266,1401,2667
<class,경의선,가좌,2970,2959,5929
<class,경의선,디지털미디어시티,1376,1266,2642
<class,경의선,수색,992,1010,2002
<class,경의선,화전,747,682,1429
<class,경의선,강매,1497,1383,2880
<class,경의선,행신,3876,3997,7873
<class,경의선,능곡,2108,1951,4059
<class,경의선,곡산,279,281,560
<class,경의선,백마,3235,3190,6425
<class,경의선,풍산,3161,3090,6251
<class,경의선,일산,4595,4538,9133
<class,경의선,탄현,4029,3970,7999
<class,경의선,야당,3790,3665,7455
<class,경의선,운정,3219,3218,6437
<class,경의선,금릉,2681,2677,5358
<class,경의선,금촌,4157,4096,8253
<class,경의선,월롱,988,929,1917
<class,경의선,파주,602,418,1020
<class,경의선,문산,3175,3197,6372
<class,경의선,임진강,23,22,45
<class,경인선,개봉,13331,13498,26829
<class,경인선,오류동,7589,7093,14682
<class,경인선,역곡,16574,16345,32919
<class,경인선,부천,24400,24942,49342
<class,경인선,송내,14586,14806,29392
<class,경인선,부평,23570,25795,49365
<class,경인선,백운,4336,4429,8765
<class,경인선,동암,10570,10902,21472
<class,경인선,주안,12267,11058,23325
<class,경인선,제물포,5895,5808,11703
<class,경인선,동인천,9253,9151,18404
<class,경인선,인천,2749,2358,5107
<class,경인선,구일,3370,3225,6595
<class,경인선,소사,6196,6134,12330
<class,경인선,부개,5230,4969,10199
<class,경인선,간석,3389,3343,6732
<class,경인선,도원,1685,1705,3390
<class,경인선,온수,3813,3682,7495
<class,경인선,중동,5250,4968,10218
<class,경인선,도화,2520,2298,4818
<class,경춘선,신내,797,783,1580
<class,경춘선,갈매,1452,1359,2811
<class,경춘선,별내,1704,1652,3356
<class,경춘선,퇴계원,2021,1893,3914
<class,경춘선,사릉,1751,1746,3497
<class,경춘선,금곡,808,727,1535
<class,경춘선,평내호평,3413,3254,6667
<class,경춘선,천마산,1039,1014,2053
<class,경춘선,마석,2274,2270,4544
<class,경춘선,대성리,336,299,635
<class,경춘선,청평,920,988,1908
<class,경춘선,상천,200,190,390
<class,경춘선,가평,949,1021,1970
<class,경춘선,굴봉산,85,83,168
<class,경춘선,백양리,168,178,346
<class,경춘선,강촌,297,344,641
<class,경춘선,김유정,262,243,505
<class,경춘선,남춘천,1639,1727,3366
<class,경춘선,춘천,832,861,1693
<class,공항철도 1호선,서울역,4394,4250,8644
<class,공항철도 1호선,공덕,1124,1665,2789
<class,공항철도 1호선,홍대입구,8013,7493,15506
<class,공항철도 1호선,디지털미디어시티,3811,3475,7286
<class,공항철도 1호선,마곡나루,2086,2234,4320
<class,공항철도 1호선,김포공항,7512,4143,11655
<class,공항철도 1호선,계양,4681,4414,9095
<class,공항철도 1호선,검암,3528,3510,7038
<class,공항철도 1호선,청라국제도시,2949,2839,5788
<class,공항철도 1호선,운서,4360,4342,8702
<class,공항철도 1호선,공항화물청사,1192,1203,2395
<class,공항철도 1호선,인천공항1터미널,2586,2789,5375
<class,공항철도 1호선,인천공항2터미널,1565,1423,2988
<class,공항철도 1호선,영종,1986,2133,4119
<class,과천선,선바위,3584,3386,6970
<class,과천선,경마공원,809,805,1614
<class,과천선,대공원,2176,2399,4575
<class,과천선,과천,3140,2911,6051
<class,과천선,정부과천청사,4032,4137,8169
<class,과천선,인덕원,12095,11873,23968
<class,과천선,평촌,7402,7383,14785
<class,과천선,범계,15812,15304,31116
<class,분당선,선릉,4241,6194,10435
<class,분당선,한티,9324,9025,18349
<class,분당선,도곡,3559,3152,6711
<class,분당선,구룡,981,947,1928
<class,분당선,개포동,2023,1951,3974
<class,분당선,대모산입구,1849,1614,3463
<class,분당선,수서,6719,6887,13606
<class,분당선,복정,2,0,2
<class,분당선,수원,5725,4623,10348
<class,분당선,서울숲,4869,5125,9994
<class,분당선,압구정로데오,14570,15594,30164
<class,분당선,강남구청,4277,5076,9353
<class,분당선,선정릉,2888,2900,5788
<class,분당선,가천대,3722,4226,7948
<class,분당선,태평,8894,8554,17448
<class,분당선,모란,13227,13284,26511
<class,분당선,야탑,13758,14728,28486
<class,분당선,서현,15747,15735,31482
<class,분당선,수내,7298,6979,14277
<class,분당선,정자,9013,9152,18165
<class,분당선,미금,8951,9331,18282
<class,분당선,오리,6276,5292,11568
<class,분당선,이매,3048,2875,5923
<class,분당선,보정,1287,1150,2437
<class,분당선,죽전,8092,9075,17167
<class,분당선,구성,2517,2676,5193
<class,분당선,신갈,2247,2261,4508
<class,분당선,기흥,5374,5148,10522
<class,분당선,상갈,3059,3020,6079
<class,분당선,청명,2128,2037,4165
<class,분당선,영통,5424,5453,10877
<class,분당선,망포,7271,6829,14100
<class,분당선,매탄권선,2687,2581,5268
<class,분당선,수원시청,8246,8984,17230
<class,분당선,매교,1624,1651,3275
<class,수인선,고색,1863,1799,3662
<class,수인선,오목천,1380,1245,2625
<class,수인선,어천,424,407,831
<class,수인선,야목,133,109,242
<class,수인선,달월,55,41,96
<class,수인선,월곶,1650,1707,3357
<class,수인선,소래포구,4054,4209,8263
<class,수인선,인천논현,3839,3901,7740
<class,수인선,호구포,2026,1944,3970
<class,수인선,남동인더스파크,959,927,1886
<class,수인선,원인재,3055,3110,6165
<class,수인선,연수,3080,3147,6227
<class,수인선,송도,1701,1568,3269
<class,수인선,인하대,3387,3155,6542
<class,수인선,숭의,2326,2137,4463
<class,수인선,신포,1137,1190,2327
<class,수인선,인천,804,1361,2165
<class,안산선,산본,9758,10396,20154
<class,안산선,대야미,3129,2664,5793
<class,안산선,반월,2769,2500,5269
<class,안산선,상록수,9997,10039,20036
<class,안산선,한대앞,5383,5393,10776
<class,안산선,중앙,11874,12467,24341
<class,안산선,고잔,4641,4606,9247
<class,안산선,초지,2517,2506,5023
<class,안산선,안산,8090,8526,16616
<class,안산선,신길온천,1091,1060,2151
<class,안산선,정왕,4719,4903,9622
<class,안산선,오이도,5599,5720,11319
<class,안산선,수리산,2266,2011,4277
<class,우이신설선,북한산우이,1980,2029,4009
<class,우이신설선,솔밭공원,1488,1390,2878
<class,우이신설선,4.19민주묘지,1788,1578,3366
<class,우이신설선,가오리,2398,2277,4675
<class,우이신설선,화계,2017,1910,3927
<class,우이신설선,삼양,1298,1434,2732
<class,우이신설선,삼양사거리,1564,1550,3114
<class,우이신설선,솔샘,3020,2764,5784
<class,우이신설선,북한산보국문,3792,3525,7317
<class,우이신설선,정릉,2837,2347,5184
<class,우이신설선,성신여대입구,2255,2603,4858
<class,우이신설선,보문,936,946,1882
<class,우이신설선,신설동,1243,1185,2428
<class,일산선,원흥,5174,5010,10184
<class,일산선,삼송,11080,11068,22148
<class,일산선,원당,6545,6405,12950
<class,일산선,화정,10364,10870,21234
<class,일산선,대곡,982,743,1725
<class,일산선,백석,6337,6290,12627
<class,일산선,마두,4067,4128,8195
<class,일산선,정발산,4892,5068,9960
<class,일산선,주엽,5098,5072,10170
<class,일산선,대화,6636,6020,12656
<class,장항선,봉명,566,561,1127
<class,장항선,쌍용,1125,1030,2155
<class,장항선,아산,1797,1788,3585
<class,장항선,배방,687,666,1353
<class,장항선,온양온천,2692,2719,5411
<class,장항선,신창,727,683,1410
<class,중앙선,회기,14676,13931,28607
<class,중앙선,중랑,3531,3441,6972
<class,중앙선,상봉,3942,3963,7905
<class,중앙선,망우,4847,4813,9660
<class,중앙선,양원,838,851,1689
<class,중앙선,구리,8033,8393,16426
<class,중앙선,도농,5337,5077,10414
<class,중앙선,양정,412,379,791
<class,중앙선,덕소,3572,3598,7170
<class,중앙선,도심,1334,1159,2493
<class,중앙선,팔당,919,1017,1936
<class,중앙선,운길산,657,660,1317
<class,중앙선,양수,1170,1186,2356
<class,중앙선,신원,170,135,305
<class,중앙선,국수,442,499,941
<class,중앙선,아신,314,386,700
<class,중앙선,오빈,167,181,348
<class,중앙선,양평,1748,1881,3629
<class,중앙선,원덕,268,289,557
<class,중앙선,용문,1824,1890,3714
<class,중앙선,지평,37,32,69
<class,경원선,창동,1,0,1
<class,중앙선,아신,336,291,627
<class,9호선,염창,6509,6436,12945
<class,2호선,잠실나루,3973,3980,7953
<class,중앙선,오빈,129,121,250
<class,1호선,서울역,16353,15029,31382
<class,1호선,동묘앞,10108,10458,20566
<class,중앙선,양평,1466,1331,2797
<class,1호선,시청,5006,4721,9727
<class,1호선,종각,8605,7698,16303
<class,1호선,종로3가,10411,9334,19745
<class,1호선,종로5가,6215,6310,12525
<class,1호선,동대문,6979,7469,14448
<class,1호선,신설동,5926,5826,11752
<class,1호선,제기동,9605,10195,19800
<class,1호선,청량리,11452,11341,22793
<class,2호선,시청,4167,3470,7637
<class,2호선,을지로입구,11760,11342,23102
<class,2호선,을지로3가,4905,4542,9447
<class,2호선,을지로4가,2506,2537,5043
<class,2호선,동대문역사문화공원,5416,6480,11896
<class,2호선,신당,6625,7043,13668
<class,2호선,상왕십리,5171,5265,10436
<class,2호선,왕십리,7106,6352,13458
<class,2호선,한양대,1586,1684,3270
<class,2호선,뚝섬,6724,6994,13718
<class,2호선,성수,9249,10116,19365
<class,2호선,건대입구,20125,21050,41175
<class,2호선,구의,9035,9021,18056
<class,2호선,강변,15446,14811,30257
<class,2호선,잠실,32832,31151,63983
<class,2호선,잠실새내,8151,8397,16548
<class,2호선,종합운동장,2455,2674,5129
<class,2호선,삼성,15281,15070,30351
<class,2호선,선릉,9673,8596,18269
<class,2호선,역삼,8794,9750,18544
<class,2호선,강남,26240,25201,51441
<class,2호선,교대,7552,8563,16115
<class,2호선,서초,6574,6130,12704
<class,2호선,방배,5066,5413,10479
<class,2호선,사당,15543,17251,32794
<class,2호선,낙성대,12214,12515,24729
<class,2호선,서울대입구,21272,21927,43199
<class,2호선,봉천,9664,9486,19150
<class,2호선,신림,29480,29176,58656
<class,2호선,신대방,11855,11467,23322
<class,2호선,구로디지털단지,18969,18970,37939
<class,2호선,대림,11617,11675,23292
<class,2호선,신도림,21259,21040,42299
<class,2호선,문래,5632,5952,11584
<class,2호선,영등포구청,6074,6434,12508
<class,2호선,당산,6786,7280,14066
<class,2호선,합정,14490,15358,29848
<class,2호선,홍대입구,32732,32794,65526
<class,2호선,신촌,16085,15516,31601
<class,2호선,이대,4715,4989,9704
<class,2호선,아현,3975,4058,8033
<class,2호선,충정로,2829,2876,5705
<class,2호선,용답,1297,1228,2525
<class,2호선,신답,578,586,1164
<class,2호선,신설동,2272,2459,4731
<class,2호선,도림천,383,386,769
<class,2호선,양천구청,2532,2585,5117
<class,2호선,신정네거리,3931,3957,7888
<class,2호선,용두,1067,1048,2115
<class,3호선,지축,1264,1239,2503
<class,3호선,구파발,8543,8819,17362
<class,3호선,연신내,17581,16698,34279
<class,3호선,불광,7784,8959,16743
<class,3호선,녹번,5335,4887,10222
<class,3호선,홍제,6972,6697,13669
<class,3호선,무악재,1406,1517,2923
<class,3호선,독립문,3067,3268,6335
<class,3호선,경복궁,7176,7422,14598
<class,3호선,안국,6309,7041,13350
<class,3호선,종로3가,2430,3294,5724
<class,3호선,을지로3가,2061,1991,4052
<class,3호선,동대입구,3051,3482,6533
<class,3호선,약수,5049,4928,9977
<class,3호선,금호,3329,3243,6572
<class,3호선,옥수,3761,4187,7948
<class,3호선,압구정,10793,11037,21830
<class,3호선,신사,11326,11384,22710
<class,3호선,잠원,1617,1661,3278
<class,3호선,고속터미널,28289,26155,54444
<class,3호선,교대,2973,1904,4877
<class,3호선,남부터미널,10469,10867,21336
<class,3호선,양재,9296,11113,20409
<class,3호선,매봉,3273,3247,6520
<class,3호선,도곡,1445,1581,3026
<class,3호선,대치,4367,3908,8275
<class,3호선,학여울,603,624,1227
<class,3호선,대청,3031,2918,5949
<class,3호선,일원,2520,2728,5248
<class,3호선,수서,6779,6764,13543
<class,3호선,가락시장,3039,3283,6322
<class,3호선,경찰병원,2169,2163,4332
<class,3호선,오금,1958,1943,3901
<class,4호선,수유,15871,15022,30893
<class,4호선,미아,6584,6310,12894
<class,4호선,미아사거리,12933,12249,25182
<class,4호선,길음,7702,7501,15203
<class,4호선,성신여대입구,9520,9032,18552
<class,4호선,한성대입구,5660,5806,11466
<class,4호선,혜화,13961,14574,28535
<class,4호선,동대문,4827,5391,10218
<class,4호선,동대문역사문화공원,6376,6469,12845
<class,4호선,충무로,5355,5421,10776
<class,4호선,명동,7177,7299,14476
<class,4호선,회현,6259,6476,12735
<class,4호선,서울역,2914,5509,8423
<class,4호선,숙대입구,4796,4690,9486
<class,4호선,삼각지,1358,1697,3055
<class,4호선,신용산,5111,5252,10363
<class,4호선,이촌,3040,3522,6562
<class,4호선,동작,1334,1322,2656
<class,4호선,총신대입구,7911,8631,16542
<class,4호선,사당,10449,10214,20663
<class,4호선,남태령,397,337,734
<class,4호선,당고개,6075,5771,11846
<class,4호선,상계,8236,7817,16053
<class,4호선,노원,9021,9783,18804
<class,4호선,창동,12534,13135,25669
<class,4호선,쌍문,12618,11373,23991
<class,5호선,방화,2755,2745,5500
<class,5호선,개화산,2146,2255,4401
<class,5호선,김포공항,5250,4893,10143
<class,5호선,송정,2924,2921,5845
<class,5호선,마곡,2511,2595,5106
<class,5호선,발산,6214,6414,12628
<class,5호선,우장산,4991,5058,10049
<class,5호선,화곡,11013,10504,21517
<class,5호선,까치산,11984,11938,23922
<class,5호선,신정,4994,4388,9382
<class,5호선,목동,5764,6041,11805
<class,5호선,오목교,9421,9750,19171
<class,5호선,양평,2042,2074,4116
<class,5호선,영등포구청,1125,1125,2250
<class,5호선,영등포시장,3459,3649,7108
<class,5호선,신길,1415,1495,2910
<class,5호선,여의도,4229,4462,8691
<class,5호선,여의나루,3328,3303,6631
<class,5호선,마포,3592,3645,7237
<class,5호선,공덕,3422,3513,6935
<class,5호선,애오개,2108,2245,4353
<class,5호선,충정로,1128,1202,2330
<class,5호선,서대문,3547,3558,7105
<class,5호선,광화문,7821,7871,15692
<class,5호선,종로3가,5819,5083,10902
<class,5호선,을지로4가,1073,1140,2213
<class,5호선,동대문역사문화공원,557,617,1174
<class,5호선,청구,1436,1336,2772
<class,5호선,신금호,2359,2440,4799
<class,5호선,행당,3019,2782,5801
<class,5호선,왕십리,1904,2185,4089
<class,5호선,마장,2306,2302,4608
<class,5호선,답십리,5718,5415,11133
<class,5호선,장한평,5522,5526,11048
<class,5호선,군자,4587,5122,9709
<class,5호선,아차산,7683,8034,15717
<class,5호선,광나루,5747,5735,11482
<class,5호선,천호,9688,9062,18750
<class,5호선,강동,7162,6924,14086
<class,5호선,길동,3248,3418,6666
<class,5호선,굽은다리,3996,3902,7898
<class,5호선,명일,3272,3295,6567
<class,5호선,고덕,3202,3177,6379
<class,5호선,상일동,5625,5349,10974
<class,5호선,둔촌동,3293,3523,6816
<class,5호선,올림픽공원,1593,1468,3061
<class,5호선,방이,2999,2828,5827
<class,5호선,오금,1094,1104,2198
<class,5호선,개롱,2482,2685,5167
<class,5호선,거여,2896,2804,5700
<class,5호선,마천,2606,2791,5397
<class,5호선,미사,5555,5494,11049
<class,5호선,하남풍산,2107,2297,4404
<class,6호선,응암,7392,7552,14944
<class,6호선,역촌,1611,1781,3392
<class,6호선,불광,2288,2167,4455
<class,6호선,독바위,1247,1580,2827
<class,6호선,연신내,1,0,1
<class,6호선,구산,2913,2291,5204
<class,6호선,새절,5336,5046,10382
<class,6호선,증산,4480,4600,9080
<class,6호선,디지털미디어시티,3945,4204,8149
<class,6호선,월드컵경기장,3254,3101,6355
<class,6호선,마포구청,5549,5092,10641
<class,6호선,망원,7384,8004,15388
<class,6호선,합정,6931,6061,12992
<class,6호선,상수,4213,4693,8906
<class,6호선,광흥창,3098,3087,6185
<class,6호선,대흥,2829,2878,5707
<class,6호선,공덕,5348,5096,10444
<class,6호선,효창공원앞,2611,2297,4908
<class,6호선,삼각지,2215,1750,3965
<class,6호선,녹사평,2827,2760,5587
<class,6호선,이태원,6297,5934,12231
<class,6호선,한강진,3641,4374,8015
<class,6호선,버티고개,839,899,1738
<class,6호선,약수,1280,1314,2594
<class,6호선,청구,1373,1345,2718
<class,6호선,신당,2744,3414,6158
<class,6호선,동묘앞,5043,4804,9847
<class,6호선,창신,1302,1200,2502
<class,6호선,보문,2990,2881,5871
<class,6호선,안암,3437,3543,6980
<class,6호선,고려대,3179,3001,6180
<class,6호선,월곡,4400,4338,8738
<class,6호선,상월곡,2569,2347,4916
<class,6호선,돌곶이,3470,3279,6749
<class,6호선,석계,5053,5233,10286
<class,6호선,태릉입구,2293,2539,4832
<class,6호선,화랑대,3603,3166,6769
<class,6호선,봉화산,3056,2962,6018
<class,7호선,장암,886,623,1509
<class,7호선,도봉산,4108,6182,10290
<class,7호선,수락산,6778,6657,13435
<class,7호선,마들,4706,4320,9026
<class,7호선,노원,8354,8529,16883
<class,7호선,중계,5267,4767,10034
<class,7호선,하계,6889,6534,13423
<class,7호선,공릉,5059,5227,10286
<class,7호선,태릉입구,3667,3254,6921
<class,7호선,먹골,4282,4225,8507
<class,7호선,중화,4653,4609,9262
<class,7호선,상봉,7746,7247,14993
<class,7호선,면목,6524,6522,13046
<class,7호선,사가정,7466,7219,14685
<class,7호선,용마산,2677,2871,5548
<class,7호선,중곡,4168,4063,8231
<class,7호선,군자,6010,4863,10873
<class,7호선,어린이대공원,5134,4918,10052
<class,7호선,건대입구,6551,6595,13146
<class,7호선,뚝섬유원지,4352,4077,8429
<class,7호선,청담,5661,5915,11576
<class,7호선,강남구청,4422,4941,9363
<class,7호선,학동,4423,4807,9230
<class,7호선,논현,5178,5492,10670
<class,7호선,반포,2277,2379,4656
<class,7호선,고속터미널,8552,5677,14229
<class,7호선,내방,4056,4223,8279
<class,7호선,이수,6552,6176,12728
<class,7호선,남성,4243,4281,8524
<class,7호선,숭실대입구,4538,4784,9322
<class,7호선,상도,4093,4037,8130
<class,7호선,장승배기,3936,3838,7774
<class,7호선,신대방삼거리,6221,6140,12361
<class,7호선,보라매,3396,3491,6887
<class,7호선,신풍,4682,4574,9256
<class,7호선,대림,5008,4604,9612
<class,7호선,남구로,5416,5305,10721
<class,7호선,가산디지털단지,8336,7703,16039
<class,7호선,철산,8107,8055,16162
<class,7호선,광명사거리,9971,9809,19780
<class,7호선,천왕,3893,3702,7595
<class,7호선,온수,3044,3060,6104
<class,7호선,까치울,3003,2955,5958
<class,7호선,부천종합운동장,1765,1603,3368
<class,7호선,춘의,2684,2500,5184
<class,7호선,신중동,5147,5119,10266
<class,7호선,부천시청,5237,5085,10322
<class,7호선,상동,5150,5053,10203
<class,7호선,삼산체육관,1760,1619,3379
<class,7호선,굴포천,3545,3597,7142
<class,7호선,부평구청,4019,3398,7417
<class,8호선,암사,7262,6814,14076
<class,8호선,천호,7276,8317,15593
<class,8호선,강동구청,3434,3642,7076
<class,8호선,몽촌토성,2315,2359,4674
<class,8호선,잠실,7744,8172,15916
<class,8호선,석촌,3270,4007,7277
<class,8호선,송파,2894,3056,5950
<class,8호선,가락시장,2848,3583,6431
<class,8호선,문정,4424,4770,9194
<class,8호선,장지,7309,7816,15125
<class,8호선,복정,3547,3486,7033
<class,8호선,산성,3073,3116,6189
<class,8호선,남한산성입구,5505,5183,10688
<class,8호선,단대오거리,4265,4143,8408
<class,8호선,신흥,2240,2398,4638
<class,8호선,수진,2398,2237,4635
<class,8호선,모란,2043,1719,3762
<class,9호선,개화,796,675,1471
<class,9호선,김포공항,5363,7539,12902
<class,9호선,공항시장,1338,1484,2822
<class,9호선,신방화,2670,2641,5311
<class,9호선,마곡나루,3905,3986,7891
<class,9호선,양천향교,3086,3264,6350
<class,9호선,가양,7898,7754,15652
<class,9호선,증미,2369,2384,4753
<class,9호선,등촌,3952,4119,8071
<class,9호선,신목동,1270,1169,2439
<class,9호선,선유도,2085,2065,4150
<class,9호선,당산,6523,6400,12923
<class,9호선,국회의사당,3055,2806,5861
<class,9호선,여의도,4262,4054,8316
<class,9호선,샛강,1312,1310,2622
<class,9호선,노량진,10913,11534,22447
<class,9호선,노들,1786,1636,3422
<class,9호선,흑석,2855,3049,5904
<class,중앙선,지평,43,19,62
<class,9호선,동작,857,688,1545
<class,9호선,구반포,885,969,1854
<class,9호선,신반포,1007,1095,2102
<class,중앙선,용문,1315,1076,2391
<class,9호선,고속터미널,6962,8609,15571
<class,9호선,사평,1139,1167,2306
<class,9호선,신논현,11605,10726,22331
<class,9호선2~3단계,언주,2703,2800,5503
<class,9호선2~3단계,선정릉,2348,2590,4938
<class,9호선2~3단계,삼성중앙,1533,1627,3160
<class,9호선2~3단계,봉은사,5303,5173,10476
<class,9호선2~3단계,종합운동장,1501,1391,2892
<class,9호선2~3단계,삼전,2831,2902,5733
<class,9호선2~3단계,석촌고분,2373,2368,4741
<class,9호선2~3단계,석촌,3393,2882,6275
<class,9호선2~3단계,송파나루,1994,2320,4314
<class,9호선2~3단계,한성백제,1001,896,1897
<class,9호선2~3단계,올림픽공원,2283,2282,4565
<class,9호선2~3단계,둔촌오륜,363,342,705
<class,9호선2~3단계,중앙보훈병원,2148,2096,4244
<class,경강선,판교,1807,1615,3422
<class,경강선,이매,409,306,715
<class,경강선,삼동,722,728,1450
<class,경강선,경기광주,2771,2757,5528
<class,경강선,초월,1172,1194,2366
<class,경강선,곤지암,1062,1109,2171
<class,경강선,신둔도예촌,570,539,1109
<class,경강선,이천,1433,1627,3060
<class,경강선,부발,886,1525,2411
<class,경강선,세종대왕릉,168,133,301
<class,경강선,여주,1323,1158,2481
<class,경부선,서울역,3488,757,4245
<class,경부선,남영,3106,3392,6498
<class,경부선,용산,19026,17347,36373
<class,경부선,노량진,4738,4558,9296
<class,경부선,대방,4413,4666,9079
<class,경부선,영등포,23209,22845,46054
<class,경부선,신도림,1494,1559,3053
<class,경부선,신길,3931,3462,7393
<class,경부선,구로,7348,7259,14607
<class,경부선,가산디지털단지,3451,4883,8334
<class,경부선,금천구청,4786,4724,9510
<class,경부선,석수,4064,4096,8160
<class,경부선,관악,3831,3488,7319
<class,경부선,안양,10365,10075,20440
<class,경부선,명학,2631,2603,5234
<class,경부선,금정,10177,10637,20814
<class,경부선,군포,2471,2365,4836
<class,경부선,의왕,3305,3261,6566
<class,경부선,성균관대,5611,5867,11478
<class,경부선,화서,2705,2755,5460
<class,경부선,수원,23629,23507,47136
<class,경부선,독산,4562,4766,9328
<class,경부선,세류,1453,1496,2949
<class,경부선,병점,6656,7311,13967
<class,경부선,세마,1104,1053,2157
<class,경부선,오산대,1474,1364,2838
<class,경부선,오산,5618,6098,11716
<class,경부선,진위,554,552,1106
<class,경부선,송탄,2609,2817,5426
<class,경부선,서정리,3054,4271,7325
<class,경부선,지제,1445,1450,2895
<class,경부선,평택,8340,8537,16877
<class,경부선,성환,1758,1992,3750
<class,경부선,직산,384,440,824
<class,경부선,두정,2864,3195,6059
<class,경부선,천안,3946,3821,7767
<class,경부선,당정,2401,2319,4720
<class,경부선,서동탄,560,596,1156
<class,경부선,광명,1576,1156,2732
<class,경원선,이촌,1644,1310,2954
<class,경원선,서빙고,820,848,1668
<class,경원선,한남,1683,1690,3373
<class,경원선,옥수,33,16,49
<class,경원선,응봉,862,764,1626
<class,경원선,왕십리,6675,7386,14061
<class,경원선,청량리,9574,9386,18960
<class,경원선,외대앞,3620,3609,7229
<class,경원선,신이문,3780,3597,7377
<class,경원선,석계,3833,4204,8037
<class,경원선,광운대,3441,3418,6859
<class,경원선,월계,2969,2748,5717
<class,경원선,녹천,2216,1904,4120
<class,경원선,창동,1,0,1
<class,경원선,방학,4636,4459,9095
<class,경원선,도봉,2775,2625,5400
<class,경원선,도봉산,7121,4890,12011
<class,경원선,망월사,3201,3324,6525
<class,경원선,회룡,5640,5578,11218
<class,경원선,의정부,10322,10274,20596
<class,경원선,가능,3067,2846,5913
<class,경원선,녹양,2091,1939,4030
<class,경원선,양주,3640,3472,7112
<class,경원선,덕계,1195,1119,2314
<class,경원선,덕정,2396,2397,4793
<class,경원선,지행,3076,2917,5993
<class,경원선,동두천중앙,1610,1480,3090
<class,경원선,보산,956,885,1841
<class,경원선,동두천,910,1092,2002
<class,경원선,소요산,2711,2394,5105
<class,경의선,서울역,679,582,1261
<class,경의선,신촌,213,200,413
<class,경의선,효창공원앞,1006,1125,2131
<class,경의선,공덕,1228,964,2192
<class,경의선,서강대,943,863,1806
<class,경의선,홍대입구,1055,1116,2171
<class,경의선,가좌,2040,1987,4027
<class,경의선,디지털미디어시티,989,878,1867
<class,경의선,수색,723,761,1484
<class,경의선,화전,503,500,1003
<class,경의선,강매,1059,1034,2093
<class,경의선,행신,2912,2856,5768
<class,경의선,능곡,1680,1648,3328
<class,경의선,곡산,231,195,426
<class,경의선,백마,2415,2311,4726
<class,경의선,풍산,2466,2394,4860
<class,경의선,일산,3372,3156,6528
<class,경의선,탄현,2940,2788,5728
<class,경의선,야당,2711,2609,5320
<class,경의선,운정,2367,2362,4729
<class,경의선,금릉,1953,1892,3845
<class,경의선,금촌,3072,3255,6327
<class,경의선,월롱,624,1030,1654
<class,경의선,파주,469,354,823
<class,경의선,문산,2387,2414,4801
<class,경의선,임진강,39,23,62
<class,경인선,개봉,9222,9093,18315
<class,경인선,오류동,5443,4922,10365
<class,경인선,역곡,11114,11124,22238
<class,경인선,부천,18114,17555,35669
<class,경인선,송내,10147,9809,19956
<class,경인선,부평,17812,18142,35954
<class,경인선,백운,3157,3126,6283
<class,경인선,동암,7505,7119,14624
<class,경인선,주안,8952,7988,16940
<class,경인선,제물포,4403,4213,8616
<class,경인선,동인천,7009,6784,13793
<class,경인선,인천,2505,2033,4538
<class,경인선,구일,2664,2632,5296
<class,경인선,소사,4575,4299,8874
<class,경인선,부개,3530,3376,6906
<class,경인선,간석,2428,2363,4791
<class,경인선,도원,1286,1328,2614
<class,경인선,온수,2693,2625,5318
<class,경인선,중동,3819,3512,7331
<class,경인선,도화,1908,1765,3673
<class,경춘선,신내,597,608,1205
<class,경춘선,갈매,1099,990,2089
<class,경춘선,별내,1262,1222,2484
<class,경춘선,퇴계원,1448,1359,2807
<class,경춘선,사릉,1284,1282,2566
<class,경춘선,금곡,685,637,1322
<class,경춘선,평내호평,2612,2367,4979
<class,경춘선,천마산,846,870,1716
<class,경춘선,마석,1872,1819,3691
<class,경춘선,대성리,318,265,583
<class,경춘선,청평,917,810,1727
<class,경춘선,상천,272,226,498
<class,경춘선,가평,878,789,1667
<class,경춘선,굴봉산,102,106,208
<class,경춘선,백양리,193,163,356
<class,경춘선,강촌,363,326,689
<class,경춘선,김유정,223,216,439
<class,경춘선,남춘천,1515,1446,2961
<class,경춘선,춘천,943,787,1730
<class,공항철도 1호선,서울역,4296,3711,8007
<class,공항철도 1호선,공덕,860,1169,2029
<class,공항철도 1호선,홍대입구,6195,5711,11906
<class,공항철도 1호선,디지털미디어시티,2701,2718,5419
<class,공항철도 1호선,마곡나루,1582,1692,3274
<class,공항철도 1호선,김포공항,7986,4279,12265
<class,공항철도 1호선,계양,3343,3321,6664
<class,공항철도 1호선,검암,2740,2790,5530
<class,공항철도 1호선,청라국제도시,2215,2066,4281
<class,공항철도 1호선,운서,3661,3883,7544
<class,공항철도 1호선,공항화물청사,885,943,1828
<class,공항철도 1호선,인천공항1터미널,2781,2889,5670
<class,공항철도 1호선,인천공항2터미널,1454,1428,2882
<class,공항철도 1호선,영종,1632,1538,3170
<class,과천선,선바위,2465,2338,4803
<class,과천선,경마공원,601,550,1151
<class,과천선,대공원,2522,2748,5270
<class,과천선,과천,2410,2134,4544
<class,과천선,정부과천청사,2884,2952,5836
<class,과천선,인덕원,8022,8027,16049
<class,과천선,평촌,4738,4503,9241
<class,과천선,범계,10506,10342,20848
<class,분당선,선릉,2210,3229,5439
<class,분당선,한티,6091,5877,11968
<class,분당선,도곡,1995,1972,3967
<class,분당선,구룡,507,543,1050
<class,분당선,개포동,1339,1332,2671
<class,분당선,대모산입구,1227,1122,2349
<class,분당선,수서,5369,5235,10604
<class,분당선,수원,4404,3486,7890
<class,분당선,서울숲,3493,3532,7025
<class,분당선,압구정로데오,7863,8335,16198
<class,분당선,강남구청,2489,2897,5386
<class,분당선,선정릉,1723,1717,3440
<class,분당선,가천대,2481,3043,5524
<class,분당선,태평,6374,5890,12264
<class,분당선,모란,8694,8956,17650
<class,분당선,야탑,10042,10385,20427
<class,분당선,서현,11288,11120,22408
<class,분당선,수내,4810,4686,9496
<class,분당선,정자,5757,6044,11801
<class,분당선,미금,5715,6110,11825
<class,분당선,오리,4491,4052,8543
<class,분당선,이매,2145,2154,4299
<class,분당선,보정,836,823,1659
<class,분당선,죽전,6194,6925,13119
<class,분당선,구성,1794,1867,3661
<class,분당선,신갈,1479,1562,3041
<class,분당선,기흥,3842,3625,7467
<class,분당선,상갈,2247,2382,4629
<class,분당선,청명,1337,1380,2717
<class,분당선,영통,3612,3660,7272
<class,분당선,망포,4827,5133,9960
<class,분당선,매탄권선,1856,1877,3733
<class,분당선,수원시청,5890,5693,11583
<class,분당선,매교,1159,1129,2288
<class,수인선,고색,1061,1187,2248
<class,중앙선,원덕,226,211,437
<class,수인선,오목천,993,966,1959
<class,수인선,어천,331,366,697
<class,수인선,야목,113,96,209
<class,수인선,사리,1775,1495,3270
<class,수인선,달월,35,42,77
<class,수인선,월곶,1300,1188,2488
<class,수인선,소래포구,3726,3662,7388
<class,수인선,인천논현,2572,2605,5177
<class,수인선,호구포,1533,1530,3063
<class,수인선,남동인더스파크,585,559,1144
<class,수인선,원인재,2153,2232,4385
<class,수인선,연수,2322,2262,4584
<class,수인선,송도,1351,1253,2604
<class,수인선,인하대,2496,2361,4857
<class,수인선,숭의,1572,1506,3078
<class,수인선,신포,893,875,1768
<class,수인선,인천,829,1270,2099
<class,안산선,산본,6767,7197,13964
<class,안산선,대야미,2363,2109,4472
<class,안산선,반월,1831,1852,3683
<class,안산선,상록수,7246,7166,14412
<class,안산선,한대앞,3852,3652,7504
<class,안산선,중앙,8679,8532,17211
<class,안산선,고잔,3159,3006,6165
<class,안산선,초지,1730,1663,3393
<class,안산선,안산,7607,6960,14567
<class,안산선,신길온천,888,791,1679
<class,안산선,정왕,3607,3867,7474
<class,안산선,오이도,4297,4240,8537
<class,안산선,수리산,1598,1613,3211
<class,우이신설선,북한산우이,2002,2181,4183
<class,우이신설선,솔밭공원,1108,1114,2222
<class,우이신설선,4.19민주묘지,1524,1321,2845
<class,우이신설선,가오리,1849,1768,3617
<class,우이신설선,화계,1553,1504,3057
<class,우이신설선,삼양,1002,1029,2031
<class,우이신설선,삼양사거리,1227,1146,2373
<class,우이신설선,솔샘,2149,1995,4144
<class,우이신설선,북한산보국문,2728,2560,5288
<class,우이신설선,정릉,2073,1762,3835
<class,우이신설선,성신여대입구,1634,1877,3511
<class,우이신설선,보문,756,717,1473
<class,우이신설선,신설동,966,977,1943
<class,일산선,원흥,3715,3641,7356
<class,일산선,삼송,8242,7953,16195
<class,일산선,원당,4686,4544,9230
<class,일산선,화정,7233,7538,14771
<class,일산선,대곡,717,529,1246
<class,일산선,백석,4550,4341,8891
<class,일산선,마두,2580,2607,5187
<class,일산선,정발산,3740,3744,7484
<class,일산선,주엽,3353,3416,6769
<class,일산선,대화,4750,4256,9006
<class,장항선,봉명,392,411,803
<class,장항선,쌍용,853,890,1743
<class,장항선,아산,1966,1523,3489
<class,장항선,배방,529,567,1096
<class,장항선,온양온천,2485,2429,4914
<class,장항선,신창,635,695,1330
<class,중앙선,회기,11116,11214,22330
<class,중앙선,중랑,2662,2596,5258
<class,중앙선,상봉,3037,3052,6089
<class,중앙선,망우,3583,3619,7202
<class,중앙선,양원,634,633,1267
<class,중앙선,구리,5701,5912,11613
<class,중앙선,도농,3693,3732,7425
<class,중앙선,양정,353,285,638
<class,중앙선,덕소,2588,2644,5232
<class,중앙선,도심,928,877,1805
<class,중앙선,팔당,1039,1089,2128
<class,중앙선,운길산,866,797,1663
<class,중앙선,양수,1207,1122,2329
<class,중앙선,신원,249,160,409
<class,중앙선,국수,420,384,804
<class,1호선,청량리,17731,18079,35810
<class,2호선,시청,6597,5874,12471
<class,2호선,을지로입구,17188,16877,34065
<class,2호선,을지로3가,7924,7828,15752
<class,2호선,을지로4가,6691,6874,13565
<class,2호선,동대문역사문화공원,7577,8094,15671
<class,2호선,신당,9577,10031,19608
<class,2호선,상왕십리,8147,7847,15994
<class,2호선,왕십리,11097,9653,20750
<class,2호선,한양대,3231,3215,6446
<class,2호선,뚝섬,10653,10967,21620
<class,2호선,성수,14715,16410,31125
<class,2호선,건대입구,23681,24809,48490
<class,2호선,구의,14349,14087,28436
<class,2호선,강변,19728,20428,40156
<class,2호선,잠실나루,6143,5980,12123
<class,2호선,잠실,48865,46847,95712
<class,2호선,잠실새내,13706,14274,27980
<class,2호선,종합운동장,3408,3772,7180
<class,2호선,삼성,21851,21889,43740
<class,2호선,선릉,19671,17481,37152
<class,2호선,역삼,16319,17774,34093
<class,2호선,강남,50933,50582,101515
<class,2호선,교대,14693,16232,30925
<class,2호선,서초,8493,7519,16012
<class,1호선,서울역,20172,20327,40499
<class,2호선,방배,8380,8665,17045
<class,분당선,태평,9430,8948,18378
<class,2호선,사당,24876,26678,51554
<class,2호선,낙성대,18132,16911,35043
<class,2호선,서울대입구,33078,32421,65499
<class,2호선,봉천,15130,14330,29460
<class,2호선,신림,43649,42048,85697
<class,2호선,신대방,16902,16260,33162
<class,2호선,구로디지털단지,30101,30119,60220
<class,2호선,대림,15806,16977,32783
<class,2호선,신도림,33229,32965,66194
<class,2호선,문래,10060,10566,20626
<class,2호선,영등포구청,10622,10825,21447
<class,2호선,당산,10541,11496,22037
<class,2호선,합정,22000,23809,45809
<class,2호선,홍대입구,46793,49822,96615
<class,2호선,신촌,23908,24455,48363
<class,2호선,이대,7800,8203,16003
<class,2호선,아현,6622,6248,12870
<class,2호선,충정로,4500,4709,9209
<class,2호선,용답,1730,1699,3429
<class,2호선,신답,917,922,1839
<class,2호선,신설동,2715,2646,5361
<class,2호선,도림천,794,794,1588
<class,2호선,양천구청,3713,3811,7524
<class,2호선,신정네거리,6120,6175,12295
<class,2호선,용두,1732,1739,3471
<class,3호선,지축,2036,1959,3995
<class,3호선,구파발,12830,12737,25567
<class,3호선,연신내,26207,24835,51042
<class,3호선,불광,11305,12617,23922
<class,3호선,녹번,8440,7327,15767
<class,3호선,홍제,11041,10588,21629
<class,3호선,무악재,2334,2383,4717
<class,3호선,독립문,4770,4855,9625
<class,3호선,경복궁,10820,11366,22186
<class,3호선,안국,9785,11379,21164
<class,3호선,종로3가,4313,6204,10517
<class,3호선,을지로3가,3910,4224,8134
<class,3호선,동대입구,4446,4991,9437
<class,3호선,약수,8147,7632,15779
<class,3호선,금호,5189,4921,10110
<class,3호선,옥수,5992,6003,11995
<class,3호선,압구정,23378,23855,47233
<class,3호선,신사,22708,23184,45892
<class,3호선,잠원,2931,2779,5710
<class,3호선,고속터미널,36983,37371,74354
<class,3호선,교대,5561,3348,8909
<class,3호선,남부터미널,16451,16897,33348
<class,3호선,양재,16508,17734,34242
<class,3호선,매봉,5017,4749,9766
<class,3호선,도곡,2716,2666,5382
<class,3호선,대치,7767,6950,14717
<class,3호선,학여울,935,929,1864
<class,3호선,대청,4859,4540,9399
<class,3호선,일원,4330,4290,8620
<class,3호선,수서,9415,9504,18919
<class,3호선,가락시장,5828,5588,11416
<class,3호선,경찰병원,3400,3295,6695
<class,3호선,오금,2967,2910,5877
<class,4호선,수유,23014,22581,45595
<class,4호선,미아,9707,9470,19177
<class,4호선,미아사거리,19101,18565,37666
<class,4호선,길음,11749,11591,23340
<class,4호선,성신여대입구,13939,13117,27056
<class,4호선,한성대입구,8728,8336,17064
<class,4호선,혜화,19618,19995,39613
<class,4호선,동대문,11245,11347,22592
<class,4호선,동대문역사문화공원,8965,7509,16474
<class,4호선,충무로,9467,9834,19301
<class,4호선,명동,9660,10991,20651
<class,4호선,회현,13451,14391,27842
<class,4호선,서울역,4050,7763,11813
<class,4호선,숙대입구,7515,7526,15041
<class,4호선,삼각지,2163,2724,4887
<class,4호선,신용산,7367,7813,15180
<class,4호선,이촌,4722,5203,9925
<class,4호선,동작,1769,1750,3519
<class,4호선,총신대입구,12529,13455,25984
<class,4호선,사당,15875,13981,29856
<class,4호선,남태령,773,590,1363
<class,4호선,당고개,8372,8077,16449
<class,4호선,상계,12003,11467,23470
<class,4호선,노원,13756,14665,28421
<class,4호선,창동,17892,18950,36842
<class,4호선,쌍문,19036,17587,36623
<class,5호선,방화,4002,3879,7881
<class,5호선,개화산,3177,3140,6317
<class,5호선,김포공항,5681,6184,11865
<class,5호선,송정,4296,4149,8445
<class,5호선,마곡,4058,4000,8058
<class,5호선,발산,10043,10823,20866
<class,5호선,우장산,8277,8412,16689
<class,5호선,화곡,17134,15899,33033
<class,5호선,까치산,18151,17752,35903
<class,5호선,신정,7703,6739,14442
<class,5호선,목동,9727,9672,19399
<class,5호선,오목교,14067,14518,28585
<class,5호선,양평,3224,3086,6310
<class,5호선,영등포구청,1784,1648,3432
<class,5호선,영등포시장,5989,6232,12221
<class,5호선,신길,2106,2298,4404
<class,5호선,여의도,6635,7123,13758
<class,5호선,여의나루,4014,3901,7915
<class,5호선,마포,6274,6300,12574
<class,5호선,공덕,5809,6122,11931
<class,5호선,애오개,3259,3092,6351
<class,5호선,충정로,1700,1554,3254
<class,5호선,서대문,5986,5876,11862
<class,5호선,광화문,11524,11535,23059
<class,5호선,종로3가,9014,9049,18063
<class,5호선,을지로4가,2969,3307,6276
<class,5호선,동대문역사문화공원,902,1085,1987
<class,5호선,청구,2269,2127,4396
<class,5호선,신금호,3742,3832,7574
<class,5호선,행당,4591,3995,8586
<class,5호선,왕십리,3019,3525,6544
<class,5호선,마장,3959,3848,7807
<class,5호선,답십리,8884,8211,17095
<class,5호선,장한평,9360,9056,18416
<class,5호선,군자,7267,8057,15324
<class,5호선,아차산,10270,10229,20499
<class,5호선,광나루,8061,7851,15912
<class,5호선,천호,14525,13710,28235
<class,5호선,강동,11131,10528,21659
<class,5호선,길동,5193,5410,10603
<class,5호선,굽은다리,6102,5659,11761
<class,5호선,명일,5328,5260,10588
<class,5호선,고덕,5289,5047,10336
<class,5호선,상일동,8743,8210,16953
<class,5호선,둔촌동,5706,5730,11436
<class,5호선,올림픽공원,2457,2105,4562
<class,5호선,방이,4287,4184,8471
<class,5호선,오금,1908,1739,3647
<class,5호선,개롱,4038,4089,8127
<class,5호선,거여,4618,4564,9182
<class,5호선,마천,3830,3969,7799
<class,5호선,미사,8314,8295,16609
<class,5호선,하남풍산,3001,3233,6234
<class,6호선,응암,11122,11168,22290
<class,6호선,역촌,2215,2569,4784
<class,6호선,불광,3320,3100,6420
<class,6호선,독바위,1742,2032,3774
<class,6호선,구산,4766,3680,8446
<class,6호선,새절,7879,7504,15383
<class,6호선,증산,6690,6664,13354
<class,6호선,디지털미디어시티,6130,6226,12356
<class,6호선,월드컵경기장,3666,3759,7425
<class,6호선,마포구청,8109,7103,15212
<class,6호선,망원,11577,12733,24310
<class,6호선,합정,10302,9471,19773
<class,6호선,상수,6003,7053,13056
<class,6호선,광흥창,4475,4144,8619
<class,6호선,대흥,4191,4321,8512
<class,6호선,공덕,8512,8153,16665
<class,6호선,효창공원앞,4072,3574,7646
<class,6호선,삼각지,3391,2748,6139
<class,6호선,녹사평,3897,3992,7889
<class,6호선,이태원,8294,8711,17005
<class,6호선,한강진,5939,7040,12979
<class,6호선,버티고개,1367,1365,2732
<class,6호선,약수,2166,2221,4387
<class,6호선,청구,2183,2207,4390
<class,6호선,신당,5222,4297,9519
<class,6호선,동묘앞,6444,5929,12373
<class,6호선,창신,1931,1562,3493
<class,6호선,보문,4298,3910,8208
<class,6호선,안암,5030,4898,9928
<class,6호선,고려대,4444,4116,8560
<class,6호선,월곡,6379,6383,12762
<class,6호선,상월곡,3483,3125,6608
<class,6호선,돌곶이,4999,4728,9727
<class,6호선,석계,7776,7634,15410
<class,6호선,태릉입구,3524,3604,7128
<class,6호선,화랑대,5857,4900,10757
<class,6호선,봉화산,4503,4343,8846
<class,7호선,장암,1264,816,2080
<class,7호선,도봉산,5216,7307,12523
<class,7호선,수락산,8951,8821,17772
<class,7호선,마들,7621,7306,14927
<class,7호선,노원,13380,14007,27387
<class,7호선,중계,7758,6999,14757
<class,7호선,하계,10289,9591,19880
<class,7호선,공릉,7342,7388,14730
<class,7호선,태릉입구,5369,4850,10219
<class,7호선,먹골,6781,6471,13252
<class,7호선,중화,7200,6882,14082
<class,7호선,상봉,11313,10959,22272
<class,7호선,면목,9836,9673,19509
<class,7호선,사가정,11105,10635,21740
<class,7호선,용마산,3961,3915,7876
<class,7호선,중곡,5879,5655,11534
<class,7호선,군자,9286,7223,16509
<class,7호선,어린이대공원,6860,6610,13470
<class,7호선,건대입구,8666,8252,16918
<class,7호선,뚝섬유원지,5318,5188,10506
<class,7호선,청담,10087,10814,20901
<class,7호선,강남구청,8322,8926,17248
<class,7호선,학동,9127,9892,19019
<class,7호선,논현,10430,11071,21501
<class,7호선,반포,3820,3505,7325
<class,7호선,고속터미널,10013,8279,18292
<class,7호선,내방,6954,7014,13968
<class,7호선,이수,10587,9772,20359
<class,7호선,남성,6791,6337,13128
<class,7호선,숭실대입구,6714,6632,13346
<class,7호선,상도,6262,5945,12207
<class,7호선,장승배기,6091,5830,11921
<class,7호선,신대방삼거리,10261,9626,19887
<class,7호선,보라매,5483,5200,10683
<class,7호선,신풍,7154,6905,14059
<class,7호선,대림,5860,6228,12088
<class,7호선,남구로,7525,8007,15532
<class,7호선,가산디지털단지,13344,12283,25627
<class,7호선,철산,12536,12806,25342
<class,7호선,광명사거리,15417,15454,30871
<class,7호선,천왕,5786,5439,11225
<class,7호선,온수,5397,5091,10488
<class,7호선,까치울,4457,4317,8774
<class,7호선,부천종합운동장,2551,2328,4879
<class,7호선,춘의,4521,4424,8945
<class,7호선,신중동,8193,8117,16310
<class,7호선,부천시청,8044,7931,15975
<class,7호선,상동,8319,8379,16698
<class,분당선,강남구청,4456,5279,9735
<class,7호선,삼산체육관,2777,2560,5337
<class,7호선,굴포천,5439,5467,10906
<class,7호선,부평구청,5924,5215,11139
<class,8호선,암사,10980,10104,21084
<class,8호선,천호,10905,12766,23671
<class,8호선,강동구청,5533,5502,11035
<class,8호선,몽촌토성,3454,3568,7022
<class,8호선,잠실,10708,11711,22419
<class,8호선,석촌,5087,6062,11149
<class,8호선,송파,4544,4711,9255
<class,8호선,가락시장,5556,5668,11224
<class,8호선,문정,7342,7594,14936
<class,8호선,장지,10705,10308,21013
<class,8호선,복정,5769,4920,10689
<class,8호선,산성,4480,4524,9004
<class,8호선,남한산성입구,8013,7293,15306
<class,8호선,단대오거리,6474,6084,12558
<class,8호선,신흥,3354,3637,6991
<class,8호선,수진,3602,3289,6891
<class,8호선,모란,3319,2710,6029
<class,9호선,개화,1191,986,2177
<class,9호선,김포공항,5916,9614,15530
<class,9호선,공항시장,1922,2031,3953
<class,9호선,신방화,4058,3920,7978
<class,9호선,마곡나루,6148,6151,12299
<class,9호선,양천향교,4978,4902,9880
<class,9호선,가양,11980,11284,23264
<class,9호선,증미,3663,3757,7420
<class,9호선,등촌,6489,6275,12764
<class,9호선,염창,9727,9319,19046
<class,9호선,신목동,1827,1595,3422
<class,9호선,선유도,3067,3026,6093
<class,9호선,당산,10299,9556,19855
<class,9호선,국회의사당,2876,2948,5824
<class,9호선,여의도,6259,5965,12224
<class,9호선,샛강,2043,2118,4161
<class,9호선,노량진,16829,16781,33610
<class,9호선,노들,2584,2271,4855
<class,9호선,흑석,5033,4809,9842
<class,9호선,동작,1194,897,2091
<class,9호선,구반포,1642,1755,3397
<class,9호선,신반포,1786,1620,3406
<class,9호선,고속터미널,9170,12641,21811
<class,9호선,사평,1727,1614,3341
<class,9호선,신논현,21520,21487,43007
<class,9호선2~3단계,언주,5148,5087,10235
<class,9호선2~3단계,선정릉,4022,4507,8529
<class,9호선2~3단계,삼성중앙,2509,2499,5008
<class,9호선2~3단계,봉은사,7456,7522,14978
<class,9호선2~3단계,종합운동장,2561,2269,4830
<class,9호선2~3단계,삼전,4405,4008,8413
<class,9호선2~3단계,석촌고분,3522,3356,6878
<class,9호선2~3단계,석촌,5380,4470,9850
<class,9호선2~3단계,송파나루,3323,3521,6844
<class,9호선2~3단계,한성백제,1438,1269,2707
<class,9호선2~3단계,올림픽공원,3157,3089,6246
<class,9호선2~3단계,둔촌오륜,544,527,1071
<class,9호선2~3단계,중앙보훈병원,3514,3264,6778
<class,경강선,판교,2496,2402,4898
<class,경강선,이매,618,465,1083
<class,경강선,삼동,1219,1100,2319
<class,경강선,경기광주,4027,3866,7893
<class,경강선,초월,1743,1709,3452
<class,경강선,곤지암,1414,1278,2692
<class,경강선,신둔도예촌,764,761,1525
<class,경강선,이천,1959,2028,3987
<class,경강선,부발,1442,1179,2621
<class,경강선,세종대왕릉,201,218,419
<class,경강선,여주,1358,1445,2803
<class,경부선,서울역,3381,984,4365
<class,경부선,남영,4905,5127,10032
<class,경부선,용산,22187,23921,46108
<class,경부선,노량진,7079,6763,13842
<class,경부선,대방,6483,6506,12989
<class,경부선,영등포,31010,32590,63600
<class,경부선,신도림,2276,2350,4626
<class,경부선,신길,5560,4535,10095
<class,경부선,구로,10940,11117,22057
<class,경부선,가산디지털단지,4960,6847,11807
<class,경부선,금천구청,6976,6990,13966
<class,경부선,석수,5640,5529,11169
<class,경부선,관악,4983,4776,9759
<class,경부선,안양,14823,14811,29634
<class,경부선,명학,4170,4125,8295
<class,경부선,금정,15198,15254,30452
<class,경부선,군포,3901,3675,7576
<class,경부선,의왕,4886,4860,9746
<class,경부선,성균관대,8374,8248,16622
<class,경부선,화서,4205,4212,8417
<class,경부선,수원,28825,31364,60189
<class,경부선,독산,7614,7724,15338
<class,경부선,세류,1957,1953,3910
<class,경부선,병점,9668,9445,19113
<class,경부선,세마,1649,1497,3146
<class,경부선,오산대,2100,1955,4055
<class,경부선,오산,7123,6899,14022
<class,경부선,진위,858,761,1619
<class,경부선,송탄,3463,3071,6534
<class,경부선,서정리,5074,4187,9261
<class,경부선,지제,2099,1836,3935
<class,경부선,평택,10038,9694,19732
<class,경부선,성환,2241,2057,4298
<class,경부선,직산,502,495,997
<class,경부선,두정,3600,3603,7203
<class,경부선,천안,4317,4502,8819
<class,경부선,당정,3369,3293,6662
<class,경부선,서동탄,896,870,1766
<class,경부선,광명,1730,1585,3315
<class,경원선,이촌,2460,1843,4303
<class,경원선,서빙고,1108,997,2105
<class,경원선,한남,2440,2311,4751
<class,경원선,옥수,27,23,50
<class,경원선,응봉,1201,1052,2253
<class,경원선,왕십리,9906,11027,20933
<class,경원선,청량리,12144,13468,25612
<class,경원선,외대앞,5000,4850,9850
<class,경원선,신이문,5589,5100,10689
<class,경원선,석계,5757,6143,11900
<class,경원선,광운대,4929,4748,9677
<class,경원선,월계,4133,3828,7961
<class,경원선,녹천,2995,2499,5494
<class,경원선,방학,6468,6364,12832
<class,경원선,도봉,3789,3600,7389
<class,경원선,도봉산,7186,4824,12010
<class,경원선,망월사,4678,4827,9505
<class,경원선,회룡,7999,8241,16240
<class,경원선,의정부,14315,15029,29344
<class,경원선,가능,4399,4192,8591
<class,경원선,녹양,2870,2853,5723
<class,경원선,양주,4859,4638,9497
<class,경원선,덕계,1729,1586,3315
<class,경원선,덕정,3427,3274,6701
<class,경원선,지행,4214,4251,8465
<class,경원선,동두천중앙,2126,2075,4201
<class,경원선,보산,1058,1067,2125
<class,경원선,동두천,1302,1516,2818
<class,경원선,소요산,2620,2250,4870
<class,경의선,서울역,880,951,1831
<class,경의선,신촌,289,285,574
<class,경의선,효창공원앞,1491,1595,3086
<class,경의선,공덕,1910,1500,3410
<class,경의선,서강대,1340,1199,2539
<class,경의선,홍대입구,1422,1550,2972
<class,경의선,가좌,3212,3092,6304
<class,경의선,디지털미디어시티,1514,1304,2818
<class,경의선,수색,1040,1033,2073
<class,경의선,화전,737,719,1456
<class,경의선,강매,1604,1451,3055
<class,경의선,행신,3992,4057,8049
<class,경의선,능곡,2228,2140,4368
<class,경의선,곡산,310,316,626
<class,경의선,백마,3490,3370,6860
<class,경의선,풍산,3407,3365,6772
<class,경의선,일산,5088,4942,10030
<class,경의선,탄현,4276,4148,8424
<class,경의선,야당,4014,3889,7903
<class,경의선,운정,3582,3370,6952
<class,경의선,금릉,2908,2873,5781
<class,경의선,금촌,4652,4741,9393
<class,경의선,월롱,987,917,1904
<class,경의선,파주,663,543,1206
<class,경의선,문산,3476,3401,6877
<class,경의선,임진강,38,26,64
<class,경인선,개봉,13878,13834,27712
<class,경인선,오류동,7841,7220,15061
<class,경인선,역곡,17081,17128,34209
<class,경인선,부천,25065,25890,50955
<class,경인선,송내,15432,15189,30621
<class,경인선,부평,24777,27306,52083
<class,경인선,백운,4693,4592,9285
<class,경인선,동암,10762,11064,21826
<class,경인선,주안,12843,11563,24406
<class,경인선,제물포,6243,5948,12191
<class,경인선,동인천,9776,9559,19335
<class,경인선,인천,3017,2489,5506
<class,경인선,구일,3814,3590,7404
<class,경인선,소사,6253,6101,12354
<class,경인선,부개,5497,5071,10568
<class,경인선,간석,3516,3443,6959
<class,경인선,도원,2084,2066,4150
<class,경인선,온수,4003,3901,7904
<class,경인선,중동,5548,5333,10881
<class,경인선,도화,2661,2440,5101
<class,경춘선,신내,842,826,1668
<class,경춘선,갈매,1575,1393,2968
<class,경춘선,별내,1738,1656,3394
<class,경춘선,퇴계원,2153,2038,4191
<class,경춘선,사릉,1865,1831,3696
<class,경춘선,금곡,902,885,1787
<class,경춘선,평내호평,3660,3507,7167
<class,경춘선,천마산,1129,1130,2259
<class,경춘선,마석,2380,2364,4744
<class,경춘선,대성리,349,374,723
<class,경춘선,청평,1028,1021,2049
<class,경춘선,상천,250,234,484
<class,경춘선,가평,1023,1131,2154
<class,1호선,종로3가,17899,16988,34887
<class,경춘선,굴봉산,103,91,194
<class,경춘선,백양리,184,186,370
<class,경춘선,강촌,372,403,775
<class,경춘선,김유정,271,257,528
<class,경춘선,남춘천,1658,1791,3449
<class,경춘선,춘천,898,839,1737
<class,공항철도 1호선,서울역,4513,4437,8950
<class,공항철도 1호선,공덕,1181,1672,2853
<class,공항철도 1호선,홍대입구,8633,8144,16777
<class,공항철도 1호선,디지털미디어시티,4165,3803,7968
<class,공항철도 1호선,마곡나루,2190,2371,4561
<class,공항철도 1호선,김포공항,8022,4659,12681
<class,공항철도 1호선,계양,5056,4727,9783
<class,공항철도 1호선,검암,3643,3665,7308
<class,공항철도 1호선,청라국제도시,3115,3049,6164
<class,공항철도 1호선,운서,4448,4665,9113
<class,공항철도 1호선,공항화물청사,1174,1226,2400
<class,공항철도 1호선,인천공항1터미널,2616,2702,5318
<class,공항철도 1호선,인천공항2터미널,1535,1409,2944
<class,공항철도 1호선,영종,2022,2087,4109
<class,과천선,선바위,3996,3589,7585
<class,과천선,경마공원,829,823,1652
<class,과천선,대공원,2814,3032,5846
<class,과천선,과천,3493,3214,6707
<class,과천선,정부과천청사,4428,4509,8937
<class,과천선,인덕원,12433,12496,24929
<class,과천선,평촌,7573,7463,15036
<class,과천선,범계,16378,15912,32290
<class,분당선,선릉,4306,6324,10630
<class,분당선,한티,9665,9396,19061
<class,분당선,도곡,3554,3193,6747
<class,분당선,구룡,960,983,1943
<class,분당선,개포동,2097,2112,4209
<class,분당선,대모산입구,2397,2171,4568
<class,분당선,수서,7256,7400,14656
<class,분당선,복정,1,0,1
<class,분당선,수원,6273,5028,11301
<class,분당선,서울숲,5429,5477,10906
<class,분당선,압구정로데오,16287,17773,34060
<class,분당선,가천대,3798,4338,8136
<class,분당선,선정릉,3111,3318,6429
<class,1호선,종로5가,14959,15324,30283
<class,중앙선,지평,41,47,88
<class,중앙선,용문,1298,1425,2723
<class,중앙선,원덕,280,273,553
<class,중앙선,양평,1872,1966,3838
<class,중앙선,오빈,194,221,415
<class,중앙선,아신,398,424,822
<class,중앙선,국수,522,550,1072
<class,중앙선,신원,197,150,347
<class,중앙선,양수,1420,1455,2875
<class,중앙선,운길산,909,834,1743
<class,중앙선,팔당,1159,1229,2388
<class,중앙선,도심,1345,1173,2518
<class,중앙선,덕소,3653,3714,7367
<class,중앙선,양정,419,358,777
<class,중앙선,도농,5468,5279,10747
<class,중앙선,구리,8478,8845,17323
<class,중앙선,양원,862,821,1683
<class,중앙선,망우,5483,5397,10880
<class,중앙선,상봉,4143,4200,8343
<class,중앙선,중랑,3795,3698,7493
<class,중앙선,회기,15542,14567,30109
<class,장항선,신창,676,656,1332
<class,장항선,온양온천,2836,2851,5687
<class,장항선,배방,726,666,1392
<class,장항선,아산,1934,1893,3827
<class,장항선,쌍용,1196,1061,2257
<class,장항선,봉명,639,610,1249
<class,일산선,대화,7013,6488,13501
<class,일산선,주엽,5455,5453,10908
<class,일산선,정발산,5216,5292,10508
<class,일산선,마두,4164,4286,8450
<class,일산선,백석,6524,6657,13181
<class,일산선,대곡,986,858,1844
<class,일산선,화정,10868,11239,22107
<class,일산선,원당,6837,6751,13588
<class,일산선,삼송,11719,11740,23459
<class,일산선,원흥,5612,5459,11071
<class,우이신설선,신설동,1282,1198,2480
<class,우이신설선,보문,989,1008,1997
<class,우이신설선,성신여대입구,2309,2755,5064
<class,우이신설선,정릉,3060,2566,5626
<class,우이신설선,북한산보국문,4220,3746,7966
<class,우이신설선,솔샘,3228,2905,6133
<class,우이신설선,삼양사거리,1653,1636,3289
<class,우이신설선,삼양,1344,1405,2749
<class,우이신설선,화계,2155,2002,4157
<class,우이신설선,가오리,2423,2305,4728
<class,우이신설선,4.19민주묘지,1826,1601,3427
<class,우이신설선,솔밭공원,1543,1528,3071
<class,우이신설선,북한산우이,2193,2190,4383
<class,안산선,수리산,2441,2122,4563
<class,안산선,오이도,6178,6282,12460
<class,안산선,정왕,5029,5019,10048
<class,안산선,신길온천,1117,1097,2214
<class,안산선,안산,8255,8084,16339
<class,안산선,초지,2532,2715,5247
<class,안산선,고잔,4847,4672,9519
<class,안산선,중앙,12443,12908,25351
<class,안산선,한대앞,5704,5660,11364
<class,안산선,상록수,10431,10563,20994
<class,안산선,반월,2855,2635,5490
<class,안산선,대야미,3303,2819,6122
<class,안산선,산본,10250,11043,21293
<class,수인선,인천,930,1578,2508
<class,수인선,신포,1318,1370,2688
<class,수인선,숭의,2377,2243,4620
<class,수인선,인하대,3575,3343,6918
<class,수인선,송도,1894,1719,3613
<class,수인선,연수,3128,3167,6295
<class,수인선,원인재,3138,3184,6322
<class,수인선,남동인더스파크,973,971,1944
<class,수인선,호구포,2093,2021,4114
<class,수인선,인천논현,3824,4042,7866
<class,수인선,소래포구,4146,4175,8321
<class,수인선,월곶,1786,1722,3508
<class,수인선,달월,49,51,100
<class,수인선,사리,2489,2190,4679
<class,수인선,야목,136,124,260
<class,수인선,어천,432,401,833
<class,수인선,오목천,1475,1336,2811
<class,수인선,고색,1914,1947,3861
<class,분당선,매교,1793,1871,3664
<class,분당선,수원시청,8873,9593,18466
<class,분당선,매탄권선,2840,2753,5593
<class,분당선,망포,7915,7220,15135
<class,분당선,영통,5544,5546,11090
<class,분당선,청명,2270,2238,4508
<class,분당선,상갈,3229,3247,6476
<class,분당선,기흥,5689,5421,11110
<class,분당선,신갈,2331,2388,4719
<class,분당선,구성,2616,2779,5395
<class,분당선,죽전,9312,10024,19336
<class,분당선,보정,1385,1282,2667
<class,분당선,이매,3336,3154,6490
<class,분당선,오리,6727,5686,12413
<class,분당선,미금,9582,9981,19563
<class,분당선,정자,9600,9622,19222
<class,분당선,수내,7737,7190,14927
<class,분당선,서현,15988,16110,32098
<class,1호선,동대문,8850,7830,16680
<class,1호선,신설동,8418,8188,16606
<class,1호선,동묘앞,9739,10119,19858
<class,분당선,야탑,14424,15189,29613
<class,분당선,모란,13919,14239,28158
<class,1호선,제기동,16464,17388,33852
<class,1호선,시청,7484,7416,14900
<class,1호선,종각,14295,13388,27683
<class,5호선,신금호,2376,2618,4994
<class,6호선,약수,1364,1373,2737
<class,일산선,대화,4957,4660,9617
<class,장항선,쌍용,901,886,1787
<class,장항선,봉명,426,443,869
<class,장항선,아산,1811,1504,3315
<class,장항선,배방,574,609,1183
<class,장항선,온양온천,2349,2481,4830
<class,장항선,신창,625,640,1265
<class,중앙선,회기,12058,11776,23834
<class,중앙선,중랑,2719,2646,5365
<class,중앙선,상봉,3007,3179,6186
<class,중앙선,망우,3778,3781,7559
<class,중앙선,양원,616,667,1283
<class,중앙선,구리,5889,6234,12123
<class,중앙선,도농,3598,3633,7231
<class,중앙선,양정,349,297,646
<class,중앙선,덕소,2753,2773,5526
<class,중앙선,도심,978,927,1905
<class,중앙선,팔당,1051,1050,2101
<class,중앙선,운길산,709,669,1378
<class,중앙선,양수,1145,1105,2250
<class,중앙선,신원,240,135,375
<class,중앙선,국수,431,394,825
<class,중앙선,아신,338,325,663
<class,중앙선,오빈,130,144,274
<class,중앙선,양평,1492,1359,2851
<class,중앙선,원덕,188,174,362
<class,중앙선,용문,1294,1055,2349
<class,중앙선,지평,38,21,59
<class,7호선,천왕,4088,3999,8087
<class,일산선,주엽,3621,3553,7174
<class,일산선,정발산,4011,3920,7931
<class,일산선,마두,2716,2703,5419
<class,일산선,백석,4690,4665,9355
<class,일산선,대곡,779,602,1381
<class,일산선,화정,7526,7711,15237
<class,일산선,원당,5033,4882,9915
<class,일산선,삼송,8676,8560,17236
<class,일산선,원흥,3909,3814,7723
<class,우이신설선,신설동,998,960,1958
<class,우이신설선,보문,786,781,1567
<class,우이신설선,성신여대입구,1882,2059,3941
<class,우이신설선,정릉,2105,1813,3918
<class,우이신설선,북한산보국문,2914,2613,5527
<class,우이신설선,솔샘,2195,2047,4242
<class,우이신설선,삼양사거리,1221,1204,2425
<class,우이신설선,삼양,1037,1053,2090
<class,우이신설선,화계,1646,1537,3183
<class,우이신설선,가오리,1912,1794,3706
<class,우이신설선,4.19민주묘지,1517,1373,2890
<class,우이신설선,솔밭공원,1207,1136,2343
<class,우이신설선,북한산우이,1937,2121,4058
<class,안산선,수리산,1653,1540,3193
<class,안산선,오이도,4503,4371,8874
<class,안산선,정왕,3945,4191,8136
<class,안산선,신길온천,840,829,1669
<class,안산선,안산,7507,6985,14492
<class,안산선,초지,1718,1729,3447
<class,안산선,고잔,3118,3042,6160
<class,안산선,중앙,8859,8772,17631
<class,안산선,한대앞,4002,3960,7962
<class,안산선,상록수,7588,7429,15017
<class,안산선,반월,1908,1892,3800
<class,안산선,대야미,2183,2089,4272
<class,안산선,산본,6871,7195,14066
<class,수인선,인천,856,1291,2147
<class,수인선,신포,886,838,1724
<class,수인선,숭의,1624,1536,3160
<class,수인선,인하대,2632,2459,5091
<class,수인선,송도,1339,1178,2517
<class,수인선,연수,2423,2358,4781
<class,수인선,원인재,2300,2338,4638
<class,수인선,남동인더스파크,618,634,1252
<class,수인선,호구포,1533,1611,3144
<class,수인선,인천논현,2576,2694,5270
<class,수인선,소래포구,3504,3366,6870
<class,수인선,월곶,1250,1266,2516
<class,수인선,달월,39,37,76
<class,수인선,사리,1750,1514,3264
<class,수인선,야목,127,103,230
<class,수인선,어천,287,359,646
<class,수인선,오목천,965,933,1898
<class,수인선,고색,1149,1282,2431
<class,분당선,매교,1216,1261,2477
<class,분당선,수원시청,5763,5532,11295
<class,분당선,매탄권선,2042,1967,4009
<class,분당선,망포,4993,5178,10171
<class,분당선,영통,3856,3749,7605
<class,분당선,청명,1572,1522,3094
<class,분당선,상갈,2312,2410,4722
<class,분당선,기흥,3970,3862,7832
<class,분당선,신갈,1561,1636,3197
<class,분당선,구성,1751,1964,3715
<class,분당선,죽전,6579,7359,13938
<class,분당선,보정,819,818,1637
<class,분당선,이매,2233,2353,4586
<class,분당선,오리,4501,4014,8515
<class,분당선,미금,5804,6283,12087
<class,분당선,정자,6031,6095,12126
<class,분당선,수내,5159,4880,10039
<class,분당선,서현,11606,11391,22997
<class,분당선,야탑,10318,10752,21070
<class,분당선,모란,9240,9538,18778
<class,분당선,태평,6606,6238,12844
<class,분당선,가천대,2981,3551,6532
<class,분당선,선정릉,1765,1874,3639
<class,분당선,강남구청,2420,2887,5307
<class,분당선,압구정로데오,8602,9120,17722
<class,분당선,서울숲,3700,3764,7464
<class,분당선,수원,4550,3712,8262
<class,분당선,수서,5374,5463,10837
<class,분당선,대모산입구,1448,1332,2780
<class,분당선,개포동,1541,1581,3122
<class,분당선,구룡,562,537,1099
<class,분당선,도곡,1978,2038,4016
<class,분당선,한티,6832,6423,13255
<class,분당선,선릉,2142,3075,5217
<class,과천선,범계,11332,10890,22222
<class,과천선,평촌,4778,4602,9380
<class,과천선,인덕원,8543,8501,17044
<class,과천선,정부과천청사,2946,3162,6108
<class,과천선,과천,2345,2211,4556
<class,과천선,대공원,2174,2317,4491
<class,과천선,경마공원,488,460,948
<class,과천선,선바위,2639,2503,5142
<class,공항철도 1호선,영종,1603,1622,3225
<class,공항철도 1호선,인천공항2터미널,1406,1264,2670
<class,공항철도 1호선,인천공항1터미널,2599,2618,5217
<class,공항철도 1호선,공항화물청사,908,991,1899
<class,공항철도 1호선,운서,3906,3861,7767
<class,공항철도 1호선,청라국제도시,2212,2115,4327
<class,공항철도 1호선,검암,2679,2701,5380
<class,공항철도 1호선,계양,3528,3435,6963
<class,공항철도 1호선,김포공항,8219,4730,12949
<class,공항철도 1호선,마곡나루,1423,1596,3019
<class,공항철도 1호선,디지털미디어시티,2721,2718,5439
<class,공항철도 1호선,홍대입구,6711,5992,12703
<class,공항철도 1호선,공덕,866,1146,2012
<class,공항철도 1호선,서울역,4091,4015,8106
<class,경춘선,춘천,873,785,1658
<class,경춘선,남춘천,2027,1955,3982
<class,경춘선,김유정,317,321,638
<class,경춘선,강촌,402,347,749
<class,경춘선,백양리,176,127,303
<class,경춘선,굴봉산,109,123,232
<class,경춘선,가평,1009,920,1929
<class,경춘선,상천,260,201,461
<class,경춘선,청평,931,790,1721
<class,경춘선,대성리,395,296,691
<class,경춘선,마석,1907,1869,3776
<class,경춘선,천마산,867,860,1727
<class,경춘선,평내호평,2682,2537,5219
<class,경춘선,금곡,741,701,1442
<class,경춘선,사릉,1356,1390,2746
<class,경춘선,퇴계원,1626,1539,3165
<class,경춘선,별내,1244,1124,2368
<class,경춘선,갈매,1131,1023,2154
<class,경춘선,신내,618,635,1253
<class,경인선,도화,1969,1772,3741
<class,경인선,중동,3905,3592,7497
<class,경인선,온수,2869,2729,5598
<class,경인선,도원,1318,1345,2663
<class,경인선,간석,2579,2447,5026
<class,경인선,부개,3761,3575,7336
<class,경인선,소사,4325,4095,8420
<class,경인선,구일,2466,2402,4868
<class,경인선,인천,2499,2017,4516
<class,경인선,동인천,7258,6964,14222
<class,경인선,제물포,4404,4304,8708
<class,경인선,주안,9449,8312,17761
<class,경인선,동암,7813,7715,15528
<class,경인선,백운,3212,3204,6416
<class,경인선,부평,18967,19446,38413
<class,경인선,송내,10441,10367,20808
<class,경인선,부천,18720,18328,37048
<class,경인선,역곡,11810,11769,23579
<class,경인선,오류동,5753,5213,10966
<class,경인선,개봉,9195,9402,18597
<class,경의선,임진강,23,20,43
<class,경의선,문산,2435,2475,4910
<class,경의선,파주,418,335,753
<class,경의선,월롱,624,1013,1637
<class,경의선,금촌,3061,3159,6220
<class,경의선,금릉,1922,1940,3862
<class,경의선,운정,2425,2430,4855
<class,경의선,야당,2850,2682,5532
<class,경의선,탄현,3044,2871,5915
<class,경의선,일산,3475,3446,6921
<class,경의선,풍산,2578,2477,5055
<class,경의선,백마,2404,2430,4834
<class,경의선,곡산,207,221,428
<class,경의선,능곡,1698,1693,3391
<class,경의선,행신,3026,2931,5957
<class,경의선,강매,1117,1100,2217
<class,경의선,화전,530,528,1058
<class,경의선,수색,688,717,1405
<class,경의선,디지털미디어시티,1002,920,1922
<class,경의선,가좌,2271,2312,4583
<class,경의선,홍대입구,1115,1184,2299
<class,경의선,서강대,920,864,1784
<class,경의선,공덕,1265,1080,2345
<class,경의선,효창공원앞,992,1177,2169
<class,경의선,신촌,224,201,425
<class,경의선,서울역,698,676,1374
<class,경원선,소요산,2625,2313,4938
<class,경원선,동두천,961,1196,2157
<class,경원선,보산,969,858,1827
<class,경원선,동두천중앙,1640,1593,3233
<class,경원선,지행,3274,3171,6445
<class,경원선,덕정,2570,2630,5200
<class,경원선,덕계,1255,1146,2401
<class,경원선,양주,3651,3568,7219
<class,경원선,녹양,2250,2152,4402
<class,경원선,가능,3140,2969,6109
<class,경원선,의정부,11279,11372,22651
<class,경원선,회룡,5793,5759,11552
<class,경원선,망월사,3906,4024,7930
<class,경원선,도봉산,6825,4841,11666
<class,경원선,도봉,2876,2674,5550
<class,경원선,방학,4856,4721,9577
<class,경원선,녹천,2215,1904,4119
<class,경원선,월계,3224,2979,6203
<class,경원선,광운대,3596,3585,7181
<class,경원선,석계,3942,4234,8176
<class,경원선,신이문,4044,3755,7799
<class,경원선,외대앞,3658,3647,7305
<class,경원선,청량리,9849,9797,19646
<class,경원선,왕십리,7214,7962,15176
<class,경원선,응봉,787,757,1544
<class,경원선,옥수,44,21,65
<class,경원선,한남,1645,1651,3296
<class,경원선,서빙고,808,826,1634
<class,경원선,이촌,1697,1382,3079
<class,경부선,광명,1560,1226,2786
<class,경부선,서동탄,619,594,1213
<class,경부선,당정,2350,2439,4789
<class,경부선,천안,4068,3727,7795
<class,경부선,두정,2822,3028,5850
<class,경부선,직산,374,415,789
<class,경부선,성환,1680,1968,3648
<class,경부선,평택,8245,8491,16736
<class,경부선,지제,1369,1498,2867
<class,경부선,서정리,3195,4344,7539
<class,경부선,송탄,2470,2730,5200
<class,경부선,진위,521,542,1063
<class,경부선,오산,5536,5967,11503
<class,경부선,오산대,1489,1432,2921
<class,경부선,세마,1237,1187,2424
<class,경부선,병점,7108,7670,14778
<class,경부선,세류,1448,1522,2970
<class,경부선,독산,5217,5351,10568
<class,경부선,수원,24419,24463,48882
<class,경부선,화서,2931,2797,5728
<class,경부선,성균관대,5920,6124,12044
<class,경부선,의왕,3448,3425,6873
<class,경부선,군포,2542,2490,5032
<class,경부선,금정,10555,11121,21676
<class,경부선,명학,2720,2703,5423
<class,경부선,안양,10704,10576,21280
<class,경부선,관악,3766,3471,7237
<class,경부선,석수,4111,4082,8193
<class,경부선,금천구청,4867,4826,9693
<class,경부선,가산디지털단지,3465,4802,8267
<class,경부선,구로,7620,7677,15297
<class,경부선,신길,4054,3392,7446
<class,경부선,신도림,1563,1666,3229
<class,경부선,영등포,24356,23700,48056
<class,경부선,대방,4563,4863,9426
<class,경부선,노량진,4927,4676,9603
<class,경부선,용산,19301,18543,37844
<class,경부선,남영,3495,3518,7013
<class,경부선,서울역,3473,874,4347
<class,경강선,여주,1220,1080,2300
<class,경강선,세종대왕릉,164,157,321
<class,경강선,부발,923,1533,2456
<class,경강선,이천,1483,1655,3138
<class,경강선,신둔도예촌,580,572,1152
<class,경강선,곤지암,1077,1158,2235
<class,경강선,초월,1227,1241,2468
<class,경강선,경기광주,2851,2902,5753
<class,경강선,삼동,799,781,1580
<class,경강선,이매,446,307,753
<class,경강선,판교,1931,1761,3692
<class,9호선2~3단계,중앙보훈병원,2341,2171,4512
<class,9호선2~3단계,둔촌오륜,377,346,723
<class,9호선2~3단계,올림픽공원,2070,2110,4180
<class,9호선2~3단계,한성백제,1067,938,2005
<class,9호선2~3단계,송파나루,2370,2575,4945
<class,9호선2~3단계,석촌,3467,2950,6417
<class,9호선2~3단계,석촌고분,2451,2438,4889
<class,9호선2~3단계,삼전,2895,2842,5737
<class,9호선2~3단계,종합운동장,1721,1479,3200
<class,9호선2~3단계,봉은사,5295,5025,10320
<class,9호선2~3단계,삼성중앙,1577,1644,3221
<class,9호선2~3단계,선정릉,2510,2774,5284
<class,9호선2~3단계,언주,2856,2762,5618
<class,9호선,신논현,12216,11319,23535
<class,9호선,사평,967,1100,2067
<class,9호선,고속터미널,6828,9100,15928
<class,9호선,신반포,1094,1120,2214
<class,9호선,구반포,942,1001,1943
<class,9호선,동작,842,690,1532
<class,9호선,흑석,2993,3801,6794
<class,9호선,노들,1906,1709,3615
<class,9호선,노량진,11512,12032,23544
<class,9호선,샛강,1350,1411,2761
<class,9호선,여의도,4501,4050,8551
<class,9호선,국회의사당,3286,3007,6293
<class,9호선,당산,6748,6631,13379
<class,9호선,선유도,2156,2083,4239
<class,9호선,신목동,1324,1207,2531
<class,9호선,염창,6612,6611,13223
<class,9호선,등촌,4402,4543,8945
<class,9호선,증미,2658,2632,5290
<class,9호선,가양,8009,8015,16024
<class,9호선,양천향교,3265,3362,6627
<class,9호선,마곡나루,4132,4025,8157
<class,9호선,신방화,2811,2758,5569
<class,9호선,공항시장,1388,1541,2929
<class,9호선,김포공항,5683,8786,14469
<class,9호선,개화,817,712,1529
<class,8호선,모란,2217,1881,4098
<class,8호선,수진,2445,2175,4620
<class,8호선,신흥,2386,2536,4922
<class,8호선,단대오거리,4558,4446,9004
<class,8호선,남한산성입구,5749,5311,11060
<class,8호선,산성,3059,3165,6224
<class,8호선,복정,3773,3622,7395
<class,8호선,장지,7623,7930,15553
<class,8호선,문정,4409,4512,8921
<class,8호선,가락시장,3133,3891,7024
<class,8호선,송파,3002,3246,6248
<class,8호선,석촌,3347,4148,7495
<class,8호선,잠실,8363,8584,16947
<class,8호선,몽촌토성,2441,2380,4821
<class,8호선,강동구청,3681,3873,7554
<class,8호선,천호,7555,8634,16189
<class,8호선,암사,7321,6968,14289
<class,7호선,부평구청,4046,3608,7654
<class,7호선,굴포천,3719,3803,7522
<class,7호선,삼산체육관,1786,1762,3548
<class,7호선,상동,5404,5308,10712
<class,7호선,부천시청,5489,5409,10898
<class,7호선,신중동,5527,5267,10794
<class,7호선,춘의,2771,2627,5398
<class,7호선,부천종합운동장,1743,1569,3312
<class,7호선,까치울,2981,3009,5990
<class,7호선,온수,3348,3407,6755
<class,7호선,광명사거리,10376,10274,20650
<class,7호선,철산,8089,8282,16371
<class,7호선,가산디지털단지,8856,8035,16891
<class,7호선,남구로,5610,5509,11119
<class,7호선,대림,5556,5173,10729
<class,7호선,신풍,5139,4733,9872
<class,7호선,보라매,3612,3486,7098
<class,7호선,신대방삼거리,6523,6321,12844
<class,7호선,장승배기,4146,4035,8181
<class,7호선,상도,4314,4315,8629
<class,7호선,숭실대입구,4761,4995,9756
<class,1호선,서울역,16216,15540,31756
<class,7호선,남성,4442,4412,8854
<class,7호선,이수,6716,6306,13022
<class,7호선,내방,4227,4433,8660
<class,7호선,고속터미널,7812,5848,13660
<class,7호선,반포,2320,2350,4670
<class,7호선,논현,5313,5684,10997
<class,7호선,학동,4654,4945,9599
<class,7호선,강남구청,4346,4829,9175
<class,7호선,청담,5472,5817,11289
<class,7호선,뚝섬유원지,3935,3778,7713
<class,7호선,건대입구,6082,5887,11969
<class,7호선,어린이대공원,5494,5174,10668
<class,7호선,군자,6119,4886,11005
<class,7호선,중곡,4212,4194,8406
<class,7호선,용마산,2538,2851,5389
<class,7호선,사가정,7615,7337,14952
<class,7호선,면목,6654,6710,13364
<class,7호선,상봉,7883,7480,15363
<class,7호선,중화,4750,4693,9443
<class,7호선,먹골,4526,4469,8995
<class,7호선,태릉입구,3840,3550,7390
<class,7호선,공릉,5397,5443,10840
<class,7호선,하계,7073,6700,13773
<class,7호선,중계,5386,4980,10366
<class,7호선,노원,8951,8748,17699
<class,7호선,마들,4903,4647,9550
<class,7호선,수락산,6710,6642,13352
<class,7호선,도봉산,3957,5931,9888
<class,7호선,장암,997,708,1705
<class,6호선,봉화산,3138,3085,6223
<class,6호선,화랑대,3880,3399,7279
<class,6호선,태릉입구,2436,2553,4989
<class,6호선,석계,5232,5408,10640
<class,6호선,돌곶이,3719,3416,7135
<class,6호선,상월곡,2566,2309,4875
<class,6호선,월곡,4490,4440,8930
<class,6호선,고려대,3194,3098,6292
<class,6호선,안암,3609,3680,7289
<class,6호선,보문,3212,2930,6142
<class,6호선,창신,1364,1292,2656
<class,6호선,동묘앞,5184,4908,10092
<class,6호선,신당,3243,3954,7197
<class,6호선,청구,1408,1413,2821
<class,6호선,버티고개,943,971,1914
<class,6호선,한강진,4189,4814,9003
<class,6호선,이태원,6538,6306,12844
<class,6호선,녹사평,3039,2892,5931
<class,6호선,삼각지,2362,1864,4226
<class,6호선,효창공원앞,2689,2523,5212
<class,6호선,공덕,5585,5278,10863
<class,6호선,대흥,2955,2972,5927
<class,6호선,광흥창,3392,3253,6645
<class,6호선,상수,4559,4932,9491
<class,6호선,합정,7429,6554,13983
<class,6호선,망원,8504,9119,17623
<class,6호선,마포구청,5881,5456,11337
<class,6호선,월드컵경기장,3056,2957,6013
<class,6호선,디지털미디어시티,4172,4342,8514
<class,6호선,증산,4711,4813,9524
<class,6호선,새절,5459,5335,10794
<class,6호선,구산,3048,2435,5483
<class,6호선,독바위,1293,1605,2898
<class,6호선,불광,2384,2232,4616
<class,6호선,역촌,1591,1823,3414
<class,6호선,응암,7739,7776,15515
<class,5호선,하남풍산,2117,2359,4476
<class,5호선,미사,5733,5626,11359
<class,5호선,마천,2632,2813,5445
<class,5호선,거여,2966,2878,5844
<class,5호선,개롱,2396,2635,5031
<class,5호선,오금,1319,1275,2594
<class,5호선,방이,3110,2966,6076
<class,5호선,올림픽공원,1519,1318,2837
<class,5호선,둔촌동,3752,3920,7672
<class,5호선,상일동,5832,5581,11413
<class,5호선,고덕,3354,3261,6615
<class,5호선,명일,3495,3577,7072
<class,5호선,굽은다리,4298,3983,8281
<class,5호선,길동,3456,3641,7097
<class,5호선,강동,7512,7149,14661
<class,5호선,천호,10286,9504,19790
<class,5호선,광나루,5844,5726,11570
<class,5호선,아차산,8089,8115,16204
<class,5호선,군자,4773,5147,9920
<class,5호선,장한평,5909,5775,11684
<class,5호선,답십리,5901,5562,11463
<class,5호선,마장,2730,2800,5530
<class,5호선,왕십리,2137,2377,4514
<class,5호선,행당,3181,2832,6013
<class,5호선,청구,1557,1426,2983
<class,5호선,동대문역사문화공원,584,639,1223
<class,5호선,을지로4가,1207,1299,2506
<class,5호선,종로3가,6241,5687,11928
<class,5호선,광화문,8780,8615,17395
<class,5호선,서대문,3916,3956,7872
<class,5호선,충정로,1176,1228,2404
<class,5호선,애오개,2239,2366,4605
<class,5호선,공덕,3522,3546,7068
<class,5호선,마포,3785,3851,7636
<class,5호선,여의나루,3181,3327,6508
<class,5호선,여의도,4321,4512,8833
<class,5호선,신길,1477,1672,3149
<class,5호선,영등포시장,3514,3638,7152
<class,5호선,영등포구청,1076,1068,2144
<class,5호선,양평,2226,2221,4447
<class,5호선,오목교,9607,9832,19439
<class,5호선,목동,6091,6297,12388
<class,5호선,신정,5114,4624,9738
<class,5호선,까치산,12769,12555,25324
<class,5호선,화곡,11426,10882,22308
<class,5호선,우장산,5375,5572,10947
<class,5호선,발산,6491,6625,13116
<class,5호선,마곡,2650,2662,5312
<class,5호선,송정,2903,2922,5825
<class,5호선,김포공항,5541,5591,11132
<class,5호선,개화산,2136,2253,4389
<class,5호선,방화,2953,2936,5889
<class,4호선,쌍문,13123,12006,25129
<class,4호선,창동,12898,13545,26443
<class,4호선,노원,9324,10062,19386
<class,4호선,상계,8544,7967,16511
<class,4호선,당고개,6154,5930,12084
<class,4호선,남태령,468,387,855
<class,4호선,사당,10582,10335,20917
<class,4호선,총신대입구,8106,9018,17124
<class,4호선,동작,1242,1222,2464
<class,4호선,이촌,3556,3899,7455
<class,4호선,신용산,5348,5430,10778
<class,4호선,삼각지,1382,1792,3174
<class,4호선,숙대입구,5117,4937,10054
<class,4호선,서울역,2958,5825,8783
<class,4호선,회현,6664,6752,13416
<class,4호선,명동,7082,7007,14089
<class,4호선,충무로,5645,5634,11279
<class,4호선,동대문역사문화공원,6551,6516,13067
<class,4호선,동대문,4985,5609,10594
<class,4호선,혜화,15451,15640,31091
<class,4호선,한성대입구,6230,6119,12349
<class,4호선,성신여대입구,10030,9586,19616
<class,4호선,길음,7893,7891,15784
<class,4호선,미아사거리,13316,12529,25845
<class,4호선,미아,6772,6682,13454
<class,4호선,수유,16346,15695,32041
<class,3호선,오금,2108,2072,4180
<class,3호선,경찰병원,2113,2275,4388
<class,3호선,가락시장,3302,3567,6869
<class,3호선,수서,6877,7003,13880
<class,3호선,일원,2882,3027,5909
<class,3호선,대청,3220,3078,6298
<class,3호선,학여울,655,625,1280
<class,3호선,대치,4748,4365,9113
<class,3호선,도곡,1569,1524,3093
<class,3호선,매봉,3433,3438,6871
<class,3호선,양재,9889,11379,21268
<class,3호선,남부터미널,10207,10946,21153
<class,3호선,교대,3178,1966,5144
<class,3호선,고속터미널,29290,28652,57942
<class,3호선,잠원,1901,1921,3822
<class,3호선,신사,12160,12042,24202
<class,3호선,압구정,11789,12037,23826
<class,3호선,옥수,4106,4411,8517
<class,3호선,금호,3563,3367,6930
<class,3호선,약수,5370,5143,10513
<class,3호선,동대입구,3470,3806,7276
<class,3호선,충무로,1,0,1
<class,3호선,을지로3가,2071,2158,4229
<class,3호선,종로3가,2700,3546,6246
<class,3호선,안국,6818,7295,14113
<class,3호선,경복궁,8151,8164,16315
<class,3호선,독립문,3398,3611,7009
<class,3호선,무악재,1518,1620,3138
<class,3호선,홍제,7332,7097,14429
<class,3호선,녹번,5401,4884,10285
<class,3호선,불광,8104,9201,17305
<class,3호선,연신내,18313,17252,35565
<class,3호선,구파발,8901,9133,18034
<class,3호선,지축,1358,1362,2720
<class,2호선,용두,1199,1204,2403
<class,2호선,신정네거리,4060,4177,8237
<class,2호선,양천구청,2549,2587,5136
<class,2호선,도림천,352,403,755
<class,2호선,신설동,2479,2454,4933
<class,2호선,신답,581,650,1231
<class,2호선,용답,1293,1308,2601
<class,2호선,충정로,3005,3161,6166
<class,2호선,아현,4484,4436,8920
<class,2호선,이대,5411,5660,11071
<class,2호선,신촌,17383,16785,34168
<class,2호선,홍대입구,35830,35093,70923
<class,2호선,합정,15360,15849,31209
<class,2호선,당산,6814,7360,14174
<class,2호선,영등포구청,6628,6804,13432
<class,2호선,문래,6412,6600,13012
<class,2호선,신도림,21851,22012,43863
<class,2호선,대림,12009,12218,24227
<class,2호선,구로디지털단지,19948,19924,39872
<class,2호선,신대방,12216,12121,24337
<class,2호선,신림,30461,29752,60213
<class,2호선,봉천,10074,9675,19749
<class,2호선,서울대입구,22908,22885,45793
<class,2호선,낙성대,12707,12713,25420
<class,2호선,사당,15970,17839,33809
<class,2호선,방배,5250,5724,10974
<class,2호선,서초,6986,6448,13434
<class,2호선,교대,8370,9195,17565
<class,2호선,강남,27923,26788,54711
<class,2호선,역삼,9242,10101,19343
<class,2호선,선릉,9836,8675,18511
<class,2호선,삼성,15198,14555,29753
<class,2호선,종합운동장,2423,2715,5138
<class,2호선,잠실새내,8515,9020,17535
<class,2호선,잠실,34938,33188,68126
<class,2호선,잠실나루,3917,4068,7985
<class,2호선,강변,15179,14877,30056
<class,2호선,구의,9464,9527,18991
<class,2호선,건대입구,17846,18185,36031
<class,2호선,성수,10028,10913,20941
<class,2호선,뚝섬,7037,7214,14251
<class,2호선,한양대,1873,1877,3750
<class,2호선,왕십리,7770,6852,14622
<class,2호선,상왕십리,5571,5526,11097
<class,2호선,신당,7109,7430,14539
<class,2호선,동대문역사문화공원,5843,6964,12807
<class,2호선,을지로4가,2794,2719,5513
<class,2호선,을지로3가,5435,4894,10329
<class,2호선,을지로입구,12297,11710,24007
<class,2호선,시청,4382,3559,7941
<class,1호선,청량리,12436,12618,25054
<class,1호선,신설동,6056,6146,12202
<class,1호선,동대문,7033,7843,14876
<class,1호선,종로5가,6889,6852,13741
<class,1호선,종로3가,10665,9734,20399
<class,1호선,종각,9458,8401,17859
<class,1호선,시청,5293,4932,10225
<class,1호선,동묘앞,10672,10792,21464
<class,1호선,제기동,10574,11317,21891
<class,중앙선,도농,3934,3687,7621
<class,중앙선,구리,6309,6574,12883
<class,중앙선,양원,619,637,1256
<class,중앙선,망우,3848,4033,7881
<class,중앙선,상봉,3270,3419,6689
<class,중앙선,중랑,2727,2721,5448
<class,중앙선,회기,9984,10883,20867
<class,장항선,신창,798,615,1413
<class,장항선,온양온천,2810,2513,5323
<class,장항선,배방,574,533,1107
<class,장항선,아산,1907,1430,3337
<class,장항선,쌍용,934,796,1730
<class,장항선,봉명,379,383,762
<class,일산선,대화,5231,4796,10027
<class,일산선,주엽,3541,3465,7006
<class,일산선,정발산,4346,4580,8926
<class,일산선,마두,2941,2896,5837
<class,일산선,백석,4792,4688,9480
<class,2호선,잠실,38212,35590,73802
<class,2호선,잠실새내,8170,8865,17035
<class,2호선,종합운동장,2385,2466,4851
<class,1호선,서울역,19374,14324,33698
<class,1호선,동묘앞,8574,9357,17931
<class,경원선,도봉,2896,2682,5578
<class,2호선,대림,10700,11083,21783
<class,2호선,신도림,20875,21190,42065
<class,2호선,문래,5630,5904,11534
<class,2호선,영등포구청,5791,6361,12152
<class,2호선,당산,7037,7447,14484
<class,2호선,합정,14199,15727,29926
<class,2호선,홍대입구,35347,39122,74469
<class,2호선,신촌,13893,14998,28891
<class,2호선,이대,3813,4456,8269
<class,2호선,아현,3837,3822,7659
<class,2호선,충정로,2612,2802,5414
<class,2호선,용답,1100,1163,2263
<class,2호선,신답,574,614,1188
<class,2호선,신설동,1881,1884,3765
<class,2호선,도림천,369,391,760
<class,2호선,양천구청,2428,2494,4922
<class,2호선,신정네거리,4003,4000,8003
<class,2호선,용두,752,854,1606
<class,3호선,지축,1491,1394,2885
<class,3호선,구파발,9258,9711,18969
<class,3호선,연신내,18465,17604,36069
<class,3호선,불광,7881,9430,17311
<class,3호선,녹번,5288,4928,10216
<class,3호선,홍제,7099,6914,14013
<class,3호선,무악재,1526,1592,3118
<class,3호선,독립문,3254,3880,7134
<class,중앙선,지평,58,32,90
<class,중앙선,용문,1781,1322,3103
<class,중앙선,원덕,368,285,653
<class,중앙선,양평,2345,1815,4160
<class,중앙선,오빈,178,147,325
<class,중앙선,아신,498,419,917
<class,중앙선,국수,513,434,947
<class,중앙선,신원,281,183,464
<class,중앙선,양수,1651,1565,3216
<class,중앙선,운길산,1243,1196,2439
<class,중앙선,팔당,1375,1412,2787
<class,3호선,경복궁,9652,11422,21074
<class,3호선,안국,7867,9304,17171
<class,3호선,종로3가,2782,4529,7311
<class,3호선,을지로3가,2122,2172,4294
<class,3호선,동대입구,3577,4412,7989
<class,3호선,약수,4772,4865,9637
<class,3호선,금호,3473,3222,6695
<class,3호선,옥수,4250,4377,8627
<class,3호선,압구정,8367,8992,17359
<class,3호선,신사,11256,12248,23504
<class,3호선,잠원,1808,1822,3630
<class,3호선,고속터미널,39503,24201,63704
<class,3호선,교대,2799,1814,4613
<class,3호선,남부터미널,12652,9760,22412
<class,3호선,양재,8369,9644,18013
<class,3호선,매봉,2979,2974,5953
<class,3호선,도곡,1548,1519,3067
<class,3호선,대치,4164,3689,7853
<class,3호선,학여울,547,499,1046
<class,3호선,대청,2943,2908,5851
<class,3호선,일원,2368,2422,4790
<class,3호선,수서,6849,5866,12715
<class,3호선,가락시장,2987,2941,5928
<class,2호선,삼성,14401,14317,28718
<class,2호선,선릉,7862,7493,15355
<class,2호선,역삼,6712,8130,14842
<class,2호선,강남,25420,25063,50483
<class,2호선,교대,7220,8069,15289
<class,2호선,서초,4464,3750,8214
<class,2호선,방배,4514,4809,9323
<class,2호선,사당,15681,17454,33135
<class,2호선,낙성대,9673,10916,20589
<class,1호선,시청,5492,5409,10901
<class,2호선,서울대입구,18237,21264,39501
<class,1호선,종각,10947,9664,20611
<class,1호선,종로3가,12456,11093,23549
<class,2호선,봉천,8469,8998,17467
<class,1호선,종로5가,7384,7822,15206
<class,1호선,동대문,7782,7636,15418
<class,1호선,신설동,5197,5442,10639
<class,1호선,제기동,5254,5521,10775
<class,1호선,청량리,9361,9167,18528
<class,2호선,시청,3747,2980,6727
<class,2호선,을지로입구,13003,11914,24917
<class,2호선,을지로3가,4577,4435,9012
<class,2호선,을지로4가,2085,2181,4266
<class,2호선,동대문역사문화공원,5375,6147,11522
<class,2호선,신당,5848,6422,12270
<class,2호선,상왕십리,4888,4975,9863
<class,2호선,왕십리,6625,6426,13051
<class,2호선,한양대,1398,1481,2879
<class,2호선,뚝섬,6581,7071,13652
<class,2호선,신림,26538,29288,55826
<class,2호선,성수,8872,10423,19295
<class,2호선,건대입구,17466,19388,36854
<class,2호선,구의,8291,8865,17156
<class,2호선,강변,20164,15232,35396
<class,2호선,신대방,10849,11707,22556
<class,2호선,구로디지털단지,17463,18626,36089
<class,2호선,잠실나루,3715,3752,7467
<class,중앙선,도심,1128,984,2112
<class,중앙선,덕소,2993,2989,5982
<class,중앙선,양정,362,297,659
<class,3호선,경찰병원,2034,2190,4224
<class,3호선,오금,1862,1778,3640
<class,4호선,수유,16234,16477,32711
<class,4호선,미아,6252,5921,12173
<class,4호선,미아사거리,12925,12656,25581
<class,4호선,길음,7575,7307,14882
<class,4호선,성신여대입구,9358,9693,19051
<class,4호선,한성대입구,5575,5735,11310
<class,4호선,혜화,14302,15436,29738
<class,4호선,동대문,4986,5140,10126
<class,4호선,동대문역사문화공원,6311,5762,12073
<class,4호선,충무로,5760,6165,11925
<class,4호선,명동,8787,9579,18366
<class,4호선,회현,6688,7183,13871
<class,4호선,서울역,2849,5304,8153
<class,4호선,숙대입구,4239,4272,8511
<class,4호선,삼각지,1289,1841,3130
<class,4호선,신용산,5640,5229,10869
<class,4호선,이촌,3476,3816,7292
<class,4호선,동작,1510,1578,3088
<class,4호선,총신대입구,7809,8666,16475
<class,4호선,사당,10423,9835,20258
<class,4호선,남태령,440,395,835
<class,4호선,당고개,6306,5928,12234
<class,4호선,상계,8618,7794,16412
<class,4호선,노원,10162,11073,21235
<class,4호선,창동,11805,12497,24302
<class,4호선,쌍문,12776,11493,24269
<class,5호선,방화,2928,2865,5793
<class,5호선,개화산,2321,2417,4738
<class,5호선,김포공항,6742,5709,12451
<class,5호선,송정,2898,2938,5836
<class,5호선,마곡,2414,2361,4775
<class,5호선,발산,6274,6743,13017
<class,5호선,우장산,5158,5159,10317
<class,5호선,화곡,11204,10955,22159
<class,5호선,까치산,12337,12581,24918
<class,5호선,신정,4890,4477,9367
<class,5호선,목동,6014,6255,12269
<class,5호선,오목교,9522,9967,19489
<class,5호선,양평,1627,1893,3520
<class,5호선,영등포구청,1044,1028,2072
<class,5호선,영등포시장,3147,3586,6733
<class,5호선,신길,1143,1434,2577
<class,5호선,여의도,3987,4393,8380
<class,5호선,여의나루,4649,4473,9122
<class,5호선,마포,3613,3712,7325
<class,5호선,공덕,3449,3677,7126
<class,5호선,애오개,1893,1992,3885
<class,5호선,충정로,918,965,1883
<class,5호선,서대문,3385,3571,6956
<class,5호선,광화문,9966,9895,19861
<class,5호선,종로3가,7148,7253,14401
<class,5호선,을지로4가,1059,1124,2183
<class,5호선,동대문역사문화공원,456,628,1084
<class,5호선,청구,1380,1336,2716
<class,5호선,신금호,2298,2468,4766
<class,5호선,행당,3056,2636,5692
<class,5호선,왕십리,1872,2343,4215
<class,5호선,마장,2035,1956,3991
<class,5호선,답십리,5473,5272,10745
<class,5호선,장한평,5414,5614,11028
<class,5호선,군자,4555,5241,9796
<class,5호선,아차산,8276,8615,16891
<class,5호선,광나루,6057,5943,12000
<class,5호선,천호,10110,9504,19614
<class,5호선,강동,6614,6549,13163
<class,5호선,길동,3050,3188,6238
<class,5호선,굽은다리,4309,3970,8279
<class,5호선,명일,3229,3166,6395
<class,5호선,고덕,3207,3167,6374
<class,5호선,상일동,6060,5509,11569
<class,5호선,둔촌동,3057,3203,6260
<class,5호선,올림픽공원,1704,1536,3240
<class,5호선,방이,2513,2439,4952
<class,5호선,오금,1035,1046,2081
<class,5호선,개롱,2374,2463,4837
<class,5호선,거여,2771,2687,5458
<class,5호선,마천,2678,2760,5438
<class,5호선,미사,5497,5765,11262
<class,5호선,하남풍산,2427,2552,4979
<class,6호선,응암,7567,7566,15133
<class,6호선,역촌,1412,1745,3157
<class,6호선,불광,2307,2195,4502
<class,6호선,독바위,1318,1744,3062
<class,6호선,구산,3084,2239,5323
<class,6호선,새절,5268,5181,10449
<class,6호선,증산,4517,4692,9209
<class,6호선,디지털미디어시티,4009,4258,8267
<class,6호선,월드컵경기장,3493,3416,6909
<class,6호선,마포구청,4956,4847,9803
<class,6호선,망원,7102,8303,15405
<class,6호선,합정,7494,6796,14290
<class,6호선,상수,3939,4754,8693
<class,6호선,광흥창,2598,2467,5065
<class,6호선,대흥,2437,2581,5018
<class,6호선,공덕,4991,4963,9954
<class,6호선,효창공원앞,2418,2150,4568
<class,6호선,삼각지,2301,1789,4090
<class,6호선,녹사평,3044,3216,6260
<class,6호선,이태원,7482,7426,14908
<class,6호선,한강진,4413,5154,9567
<class,6호선,버티고개,960,1029,1989
<class,6호선,약수,1237,1370,2607
<class,6호선,청구,1312,1357,2669
<class,6호선,신당,2719,2556,5275
<class,6호선,동묘앞,4792,4468,9260
<class,6호선,창신,1290,1126,2416
<class,6호선,보문,2696,2710,5406
<class,6호선,안암,2858,3233,6091
<class,6호선,고려대,2646,2796,5442
<class,6호선,월곡,4179,4278,8457
<class,6호선,상월곡,2387,2163,4550
<class,6호선,돌곶이,3247,3098,6345
<class,6호선,석계,5256,5205,10461
<class,6호선,태릉입구,2254,2512,4766
<class,6호선,화랑대,3840,3266,7106
<class,6호선,봉화산,3177,3080,6257
<class,7호선,장암,1221,884,2105
<class,7호선,도봉산,4666,6936,11602
<class,7호선,수락산,7116,6887,14003
<class,7호선,마들,5368,5215,10583
<class,7호선,노원,9656,9836,19492
<class,7호선,중계,5669,5062,10731
<class,7호선,하계,6973,6694,13667
<class,7호선,공릉,5051,5441,10492
<class,7호선,태릉입구,3491,3365,6856
<class,7호선,먹골,4239,4257,8496
<class,7호선,중화,4461,4434,8895
<class,7호선,상봉,7948,7700,15648
<class,7호선,면목,6334,6329,12663
<class,7호선,사가정,7563,7432,14995
<class,7호선,용마산,2739,3063,5802
<class,7호선,중곡,3883,3979,7862
<class,7호선,군자,5720,4856,10576
<class,7호선,어린이대공원,4161,4744,8905
<class,7호선,건대입구,6014,6227,12241
<class,7호선,뚝섬유원지,5315,4933,10248
<class,7호선,청담,4266,4737,9003
<class,7호선,강남구청,3276,3948,7224
<class,7호선,학동,3048,3372,6420
<class,7호선,논현,4506,5086,9592
<class,7호선,반포,2311,2139,4450
<class,7호선,고속터미널,12885,5192,18077
<class,7호선,내방,3783,4016,7799
<class,7호선,이수,6070,6246,12316
<class,7호선,남성,3994,4219,8213
<class,7호선,숭실대입구,3994,4495,8489
<class,7호선,상도,3384,3687,7071
<class,7호선,장승배기,3681,3735,7416
<class,7호선,신대방삼거리,5514,6028,11542
<class,7호선,보라매,2789,3074,5863
<class,7호선,신풍,4373,4353,8726
<class,7호선,대림,4893,5092,9985
<class,7호선,남구로,5251,5186,10437
<class,7호선,가산디지털단지,9564,9238,18802
<class,7호선,철산,8841,8762,17603
<class,7호선,광명사거리,9657,9330,18987
<class,7호선,천왕,3643,3530,7173
<class,7호선,온수,3162,3144,6306
<class,7호선,까치울,3055,2982,6037
<class,7호선,부천종합운동장,1827,1639,3466
<class,7호선,춘의,2627,2476,5103
<class,7호선,신중동,5438,5379,10817
<class,7호선,부천시청,5928,5688,11616
<class,7호선,상동,5391,5403,10794
<class,7호선,삼산체육관,2041,1820,3861
<class,7호선,굴포천,3766,3751,7517
<class,7호선,부평구청,4179,3488,7667
<class,8호선,암사,7236,6779,14015
<class,8호선,천호,7281,8831,16112
<class,8호선,강동구청,3316,3505,6821
<class,8호선,몽촌토성,2359,2455,4814
<class,8호선,잠실,9425,9968,19393
<class,8호선,석촌,3072,3960,7032
<class,8호선,송파,2701,2722,5423
<class,8호선,가락시장,2529,2763,5292
<class,8호선,문정,3518,3797,7315
<class,8호선,장지,7277,7385,14662
<class,8호선,복정,3446,3265,6711
<class,8호선,산성,3145,3317,6462
<class,8호선,남한산성입구,5790,5249,11039
<class,8호선,단대오거리,4428,4194,8622
<class,8호선,신흥,2277,2511,4788
<class,8호선,수진,2256,2019,4275
<class,8호선,모란,2336,1960,4296
<class,9호선,개화,963,822,1785
<class,9호선,김포공항,6935,8405,15340
<class,9호선,공항시장,1285,1412,2697
<class,9호선,신방화,2464,2517,4981
<class,9호선,마곡나루,3801,4144,7945
<class,9호선,양천향교,2933,3279,6212
<class,9호선,가양,7286,7681,14967
<class,9호선,증미,2212,2437,4649
<class,9호선,등촌,3643,3960,7603
<class,9호선,염창,6068,6297,12365
<class,9호선,신목동,1345,1180,2525
<class,9호선,선유도,1761,1955,3716
<class,9호선,당산,5955,6334,12289
<class,9호선,국회의사당,1629,1610,3239
<class,9호선,여의도,4025,4047,8072
<class,9호선,샛강,1251,1234,2485
<class,9호선,노량진,10294,11590,21884
<class,9호선,노들,1769,1601,3370
<class,9호선,흑석,2721,2922,5643
<class,9호선,동작,740,608,1348
<class,9호선,구반포,825,910,1735
<class,9호선,신반포,1026,964,1990
<class,9호선,고속터미널,9239,8644,17883
<class,9호선,사평,1063,999,2062
<class,9호선,신논현,11642,11666,23308
<class,9호선2~3단계,언주,1895,2110,4005
<class,9호선2~3단계,선정릉,1956,2391,4347
<class,9호선2~3단계,삼성중앙,1372,1461,2833
<class,9호선2~3단계,봉은사,5079,5373,10452
<class,9호선2~3단계,종합운동장,1465,1488,2953
<class,9호선2~3단계,삼전,2536,2660,5196
<class,9호선2~3단계,석촌고분,2095,2311,4406
<class,9호선2~3단계,석촌,3199,3049,6248
<class,9호선2~3단계,송파나루,1923,2418,4341
<class,9호선2~3단계,한성백제,949,915,1864
<class,9호선2~3단계,올림픽공원,2393,2354,4747
<class,9호선2~3단계,둔촌오륜,273,299,572
<class,9호선2~3단계,중앙보훈병원,2462,2293,4755
<class,경강선,판교,2009,2024,4033
<class,경강선,이매,585,369,954
<class,경강선,삼동,889,849,1738
<class,경강선,경기광주,3319,3191,6510
<class,경강선,초월,1360,1221,2581
<class,경강선,곤지암,1325,1291,2616
<class,경강선,신둔도예촌,697,575,1272
<class,경강선,이천,1953,1690,3643
<class,경강선,부발,965,873,1838
<class,경강선,세종대왕릉,254,225,479
<class,경강선,여주,1881,1381,3262
<class,경부선,서울역,4000,617,4617
<class,경부선,남영,2890,3322,6212
<class,경부선,용산,22449,18916,41365
<class,경부선,노량진,5040,5045,10085
<class,경부선,대방,4234,4474,8708
<class,경부선,영등포,27249,28303,55552
<class,경부선,신도림,1509,1802,3311
<class,경부선,신길,3468,3158,6626
<class,경부선,구로,7301,7863,15164
<class,경부선,가산디지털단지,3688,5764,9452
<class,경부선,금천구청,5103,5239,10342
<class,경부선,석수,4436,4364,8800
<class,경부선,관악,4157,3695,7852
<class,경부선,안양,11472,11295,22767
<class,경부선,명학,2643,2395,5038
<class,경부선,금정,11251,11480,22731
<class,경부선,군포,2687,2457,5144
<class,경부선,의왕,3565,3457,7022
<class,경부선,성균관대,5770,6327,12097
<class,경부선,화서,3160,3078,6238
<class,경부선,수원,30811,30692,61503
<class,경부선,독산,4400,4722,9122
<class,경부선,세류,1557,1559,3116
<class,경부선,병점,7227,7747,14974
<class,경부선,세마,1296,1186,2482
<class,경부선,오산대,1644,1603,3247
<class,경부선,오산,6614,6619,13233
<class,경부선,진위,655,558,1213
<class,경부선,송탄,2816,2799,5615
<class,경부선,서정리,3132,3410,6542
<class,경부선,지제,1377,1174,2551
<class,경부선,평택,9689,9002,18691
<class,경부선,성환,2013,1922,3935
<class,경부선,직산,499,445,944
<class,경부선,두정,2879,2957,5836
<class,경부선,천안,5110,4326,9436
<class,경부선,당정,2443,2396,4839
<class,경부선,서동탄,748,646,1394
<class,경부선,광명,1818,1089,2907
<class,경원선,이촌,1716,1377,3093
<class,경원선,서빙고,739,687,1426
<class,경원선,한남,1645,1608,3253
<class,경원선,옥수,35,9,44
<class,경원선,응봉,956,851,1807
<class,경원선,왕십리,6664,8087,14751
<class,경원선,청량리,9356,8965,18321
<class,경원선,외대앞,3117,3335,6452
<class,경원선,신이문,3819,3531,7350
<class,경원선,석계,4038,4517,8555
<class,경원선,광운대,3344,3544,6888
<class,경원선,월계,3009,2850,5859
<class,경원선,녹천,2223,1902,4125
<class,경원선,창동,1,0,1
<class,경원선,방학,4618,4515,9133
<class,경원선,도봉산,8050,5702,13752
<class,경원선,망월사,3222,3375,6597
<class,경원선,회룡,5935,5700,11635
<class,경원선,의정부,12466,13063,25529
<class,경원선,가능,3271,2960,6231
<class,경원선,녹양,2267,2037,4304
<class,경원선,양주,4118,3810,7928
<class,경원선,덕계,1361,1145,2506
<class,경원선,덕정,2769,2565,5334
<class,경원선,지행,3688,3318,7006
<class,경원선,동두천중앙,1835,1669,3504
<class,경원선,보산,1119,1030,2149
<class,경원선,동두천,998,1181,2179
<class,경원선,소요산,3246,2673,5919
<class,경의선,서울역,731,669,1400
<class,경의선,신촌,186,199,385
<class,경의선,효창공원앞,937,1087,2024
<class,경의선,공덕,1214,1197,2411
<class,경의선,서강대,907,924,1831
<class,경의선,홍대입구,1129,1374,2503
<class,경의선,가좌,2202,2243,4445
<class,경의선,디지털미디어시티,1093,994,2087
<class,경의선,수색,644,650,1294
<class,경의선,화전,480,484,964
<class,경의선,강매,1242,1166,2408
<class,경의선,행신,3169,3122,6291
<class,경의선,능곡,1691,1638,3329
<class,경의선,곡산,227,242,469
<class,경의선,백마,2530,2396,4926
<class,경의선,풍산,2636,2490,5126
<class,경의선,일산,3830,3618,7448
<class,경의선,탄현,3266,2987,6253
<class,경의선,야당,3238,3040,6278
<class,경의선,운정,2630,2390,5020
<class,경의선,금릉,2294,2120,4414
<class,경의선,금촌,3556,3589,7145
<class,경의선,월롱,595,673,1268
<class,경의선,파주,545,447,992
<class,경의선,문산,3032,2766,5798
<class,경의선,임진강,80,56,136
<class,경인선,개봉,9555,9503,19058
<class,경인선,오류동,5071,4944,10015
<class,경인선,역곡,11787,11490,23277
<class,경인선,부천,18478,18878,37356
<class,경인선,송내,10868,10493,21361
<class,경인선,부평,22283,23100,45383
<class,경인선,백운,3472,3258,6730
<class,경인선,동암,8418,8295,16713
<class,경인선,주안,9776,8698,18474
<class,경인선,제물포,4637,4374,9011
<class,경인선,동인천,8047,7749,15796
<class,경인선,인천,4413,3719,8132
<class,경인선,구일,2610,2539,5149
<class,경인선,소사,4497,4116,8613
<class,경인선,부개,3794,3406,7200
<class,경인선,간석,2855,2599,5454
<class,경인선,도원,1305,1344,2649
<class,경인선,온수,2907,2646,5553
<class,경인선,중동,3927,3727,7654
<class,경인선,도화,1912,1782,3694
<class,경춘선,신내,555,584,1139
<class,경춘선,갈매,1095,993,2088
<class,경춘선,별내,1196,1220,2416
<class,경춘선,퇴계원,1715,1551,3266
<class,경춘선,사릉,1529,1330,2859
<class,경춘선,금곡,709,617,1326
<class,경춘선,평내호평,2949,2705,5654
<class,경춘선,천마산,988,961,1949
<class,경춘선,마석,2236,2168,4404
<class,경춘선,대성리,476,380,856
<class,경춘선,청평,1302,1089,2391
<class,경춘선,상천,242,210,452
<class,경춘선,가평,1494,1241,2735
<class,경춘선,굴봉산,145,146,291
<class,경춘선,백양리,329,285,614
<class,경춘선,강촌,562,452,1014
<class,경춘선,김유정,368,415,783
<class,경춘선,남춘천,2005,1751,3756
<class,경춘선,춘천,1700,1310,3010
<class,공항철도 1호선,서울역,4957,3264,8221
<class,공항철도 1호선,공덕,819,1193,2012
<class,공항철도 1호선,홍대입구,6784,6954,13738
<class,공항철도 1호선,디지털미디어시티,2724,2788,5512
<class,공항철도 1호선,마곡나루,1475,1722,3197
<class,공항철도 1호선,김포공항,9303,4219,13522
<class,공항철도 1호선,계양,3880,3600,7480
<class,공항철도 1호선,검암,3006,3006,6012
<class,공항철도 1호선,청라국제도시,2394,2184,4578
<class,공항철도 1호선,운서,3623,3987,7610
<class,공항철도 1호선,공항화물청사,858,889,1747
<class,공항철도 1호선,인천공항1터미널,2940,2910,5850
<class,공항철도 1호선,인천공항2터미널,1492,1283,2775
<class,공항철도 1호선,영종,1796,1794,3590
<class,과천선,선바위,2660,2379,5039
<class,과천선,경마공원,385,347,732
<class,과천선,대공원,3815,4015,7830
<class,과천선,과천,2544,2122,4666
<class,과천선,정부과천청사,3209,3230,6439
<class,과천선,인덕원,8932,8798,17730
<class,과천선,평촌,4866,4943,9809
<class,과천선,범계,12367,11769,24136
<class,분당선,선릉,1833,2755,4588
<class,분당선,한티,5663,5553,11216
<class,분당선,도곡,1955,1850,3805
<class,분당선,구룡,478,488,966
<class,분당선,개포동,1227,1199,2426
<class,분당선,대모산입구,1028,977,2005
<class,분당선,수서,5550,4420,9970
<class,분당선,수원,5732,4562,10294
<class,분당선,서울숲,3607,3839,7446
<class,분당선,압구정로데오,6631,7427,14058
<class,분당선,강남구청,2006,2424,4430
<class,분당선,선정릉,1300,1437,2737
<class,분당선,가천대,2286,2960,5246
<class,분당선,태평,6257,5982,12239
<class,분당선,모란,8852,9387,18239
<class,분당선,야탑,10661,10425,21086
<class,분당선,서현,11853,12012,23865
<class,분당선,수내,3964,3955,7919
<class,분당선,정자,5698,6309,12007
<class,분당선,미금,5907,6197,12104
<class,분당선,오리,4232,3647,7879
<class,분당선,이매,2122,2277,4399
<class,분당선,보정,943,868,1811
<class,분당선,죽전,6723,7730,14453
<class,분당선,구성,1867,1940,3807
<class,분당선,신갈,1571,1631,3202
<class,분당선,기흥,4242,4045,8287
<class,분당선,상갈,2621,2496,5117
<class,분당선,청명,1661,1551,3212
<class,분당선,영통,3535,3857,7392
<class,분당선,망포,5075,5159,10234
<class,분당선,매탄권선,2022,1953,3975
<class,분당선,수원시청,5549,6215,11764
<class,분당선,매교,1082,1110,2192
<class,수인선,고색,1221,1308,2529
<class,수인선,오목천,1166,1053,2219
<class,수인선,어천,406,429,835
<class,수인선,야목,140,134,274
<class,수인선,사리,2258,1798,4056
<class,수인선,달월,48,57,105
<class,수인선,월곶,1778,1536,3314
<class,수인선,소래포구,5119,5064,10183
<class,수인선,인천논현,2805,2932,5737
<class,수인선,호구포,1546,1695,3241
<class,수인선,남동인더스파크,538,548,1086
<class,수인선,원인재,2463,2568,5031
<class,수인선,연수,2560,2528,5088
<class,수인선,송도,1380,1325,2705
<class,수인선,인하대,2436,2408,4844
<class,수인선,숭의,1634,1482,3116
<class,수인선,신포,1048,1120,2168
<class,수인선,인천,1243,1975,3218
<class,안산선,산본,7682,8164,15846
<class,안산선,대야미,2561,2196,4757
<class,안산선,반월,2148,1989,4137
<class,안산선,상록수,8034,7766,15800
<class,안산선,한대앞,4066,4028,8094
<class,안산선,중앙,10417,10167,20584
<class,안산선,고잔,3518,3212,6730
<class,안산선,초지,1963,1838,3801
<class,안산선,안산,9208,8977,18185
<class,안산선,신길온천,950,902,1852
<class,안산선,정왕,4026,4601,8627
<class,안산선,오이도,6377,6505,12882
<class,안산선,수리산,1811,1788,3599
<class,우이신설선,북한산우이,2768,2880,5648
<class,우이신설선,솔밭공원,1130,1089,2219
<class,우이신설선,4.19민주묘지,1493,1326,2819
<class,우이신설선,가오리,1894,1718,3612
<class,우이신설선,화계,1548,1431,2979
<class,우이신설선,삼양,967,996,1963
<class,우이신설선,삼양사거리,1109,1084,2193
<class,우이신설선,솔샘,2174,1960,4134
<class,우이신설선,북한산보국문,2687,2496,5183
<class,우이신설선,정릉,2072,1690,3762
<class,우이신설선,성신여대입구,1531,1970,3501
<class,우이신설선,보문,642,665,1307
<class,우이신설선,신설동,867,788,1655
<class,일산선,원흥,3853,3759,7612
<class,일산선,삼송,9150,8977,18127
<class,일산선,원당,5201,4901,10102
<class,일산선,화정,8166,8449,16615
<class,일산선,대곡,773,615,1388
<class,9호선,노량진,9918,11574,21492
<class,7호선,춘의,2656,2447,5103
<class,경원선,창동,1,0,1
<class,우이신설선,보문,712,681,1393
<class,우이신설선,신설동,902,913,1815
<class,일산선,원흥,3772,3608,7380
<class,일산선,삼송,8314,8245,16559
<class,일산선,원당,4914,4709,9623
<class,일산선,화정,7507,7675,15182
<class,일산선,대곡,746,549,1295
<class,일산선,백석,4575,4467,9042
<class,일산선,마두,2632,2662,5294
<class,일산선,정발산,4054,3995,8049
<class,일산선,주엽,3253,3165,6418
<class,일산선,대화,4784,4480,9264
<class,장항선,봉명,390,418,808
<class,장항선,쌍용,909,870,1779
<class,장항선,아산,2271,1616,3887
<class,장항선,배방,624,670,1294
<class,장항선,온양온천,3131,2993,6124
<class,장항선,신창,860,791,1651
<class,중앙선,회기,10297,11522,21819
<class,중앙선,중랑,2531,2560,5091
<class,중앙선,상봉,3074,3156,6230
<class,중앙선,망우,3612,3518,7130
<class,중앙선,양원,656,689,1345
<class,중앙선,구리,6256,6389,12645
<class,중앙선,도농,3888,3831,7719
<class,중앙선,양정,361,311,672
<class,중앙선,덕소,2815,2867,5682
<class,중앙선,도심,943,856,1799
<class,중앙선,팔당,1201,1183,2384
<class,중앙선,운길산,943,867,1810
<class,중앙선,양수,1300,1176,2476
<class,중앙선,신원,222,143,365
<class,중앙선,국수,451,431,882
<class,중앙선,아신,412,320,732
<class,중앙선,오빈,144,130,274
<class,중앙선,양평,1904,1497,3401
<class,중앙선,원덕,252,191,443
<class,중앙선,용문,1709,1179,2888
<class,중앙선,지평,53,37,90
<class,분당선,영통,3346,3622,6968
<class,분당선,청명,1415,1414,2829
<class,분당선,상갈,2324,2338,4662
<class,분당선,기흥,4055,3876,7931
<class,분당선,신갈,1571,1590,3161
<class,분당선,구성,1876,1858,3734
<class,분당선,죽전,6085,7008,13093
<class,분당선,보정,833,762,1595
<class,분당선,이매,2225,2326,4551
<class,분당선,오리,4131,3672,7803
<class,분당선,미금,5695,6271,11966
<class,분당선,정자,5670,6168,11838
<class,분당선,수내,4632,4561,9193
<class,분당선,서현,11676,11541,23217
<class,분당선,야탑,10946,10500,21446
<class,분당선,모란,10435,11118,21553
<class,분당선,태평,6345,6089,12434
<class,분당선,가천대,2417,3126,5543
<class,분당선,선정릉,1369,1519,2888
<class,분당선,강남구청,2391,2846,5237
<class,분당선,압구정로데오,7515,8207,15722
<class,분당선,서울숲,3434,3566,7000
<class,분당선,수원,5215,4245,9460
<class,분당선,수서,6184,5128,11312
<class,분당선,대모산입구,1042,1025,2067
<class,분당선,개포동,1290,1311,2601
<class,분당선,구룡,485,487,972
<class,분당선,도곡,1836,1757,3593
<class,분당선,한티,5859,5723,11582
<class,분당선,선릉,1796,2694,4490
<class,과천선,범계,11355,10767,22122
<class,과천선,평촌,4669,4562,9231
<class,과천선,인덕원,8314,8352,16666
<class,과천선,정부과천청사,2991,3180,6171
<class,과천선,과천,2470,2119,4589
<class,과천선,대공원,2814,3005,5819
<class,과천선,경마공원,440,411,851
<class,과천선,선바위,2595,2399,4994
<class,공항철도 1호선,영종,1667,1637,3304
<class,공항철도 1호선,인천공항2터미널,1389,1270,2659
<class,공항철도 1호선,인천공항1터미널,2668,2629,5297
<class,공항철도 1호선,공항화물청사,805,902,1707
<class,공항철도 1호선,운서,3597,4087,7684
<class,공항철도 1호선,청라국제도시,2327,2171,4498
<class,공항철도 1호선,검암,2803,2818,5621
<class,공항철도 1호선,계양,3554,3494,7048
<class,공항철도 1호선,김포공항,12693,4938,17631
<class,공항철도 1호선,마곡나루,1387,1549,2936
<class,공항철도 1호선,디지털미디어시티,2561,2789,5350
<class,공항철도 1호선,홍대입구,6645,6558,13203
<class,공항철도 1호선,공덕,856,1119,1975
<class,공항철도 1호선,서울역,5047,3875,8922
<class,경춘선,춘천,1388,959,2347
<class,경춘선,남춘천,2022,1663,3685
<class,경춘선,김유정,325,285,610
<class,경춘선,강촌,558,406,964
<class,경춘선,백양리,184,130,314
<class,경춘선,굴봉산,100,100,200
<class,경춘선,가평,1222,889,2111
<class,경춘선,상천,283,204,487
<class,경춘선,청평,1205,877,2082
<class,경춘선,대성리,464,336,800
<class,경춘선,마석,1940,1861,3801
<class,경춘선,천마산,901,845,1746
<class,경춘선,평내호평,2771,2528,5299
<class,경춘선,금곡,699,657,1356
<class,경춘선,사릉,1404,1337,2741
<class,경춘선,퇴계원,1615,1469,3084
<class,경춘선,별내,1243,1244,2487
<class,경춘선,갈매,1125,997,2122
<class,경춘선,신내,571,544,1115
<class,경인선,도화,1976,1757,3733
<class,경인선,중동,3854,3430,7284
<class,경인선,온수,2754,2704,5458
<class,경인선,도원,1390,1367,2757
<class,경인선,간석,2496,2332,4828
<class,경인선,부개,3670,3278,6948
<class,경인선,소사,4480,4045,8525
<class,경인선,구일,2398,2487,4885
<class,경인선,인천,3234,2625,5859
<class,경인선,동인천,7346,6946,14292
<class,경인선,제물포,4429,4257,8686
<class,경인선,주안,9492,8391,17883
<class,경인선,동암,7955,7549,15504
<class,경인선,백운,3195,3042,6237
<class,경인선,부평,19627,19506,39133
<class,경인선,송내,10330,9841,20171
<class,경인선,부천,17180,16735,33915
<class,경인선,역곡,10948,10730,21678
<class,경인선,오류동,5116,5180,10296
<class,경인선,개봉,9134,9065,18199
<class,경의선,임진강,45,29,74
<class,경의선,문산,2801,2612,5413
<class,경의선,파주,537,403,940
<class,경의선,월롱,561,1070,1631
<class,경의선,금촌,3324,3513,6837
<class,경의선,금릉,2151,2078,4229
<class,경의선,운정,2514,2355,4869
<class,경의선,야당,2959,2767,5726
<class,경의선,탄현,3141,2930,6071
<class,경의선,일산,3617,3196,6813
<class,경의선,풍산,2613,2448,5061
<class,경의선,백마,2428,2289,4717
<class,경의선,곡산,231,196,427
<class,경의선,능곡,1668,1586,3254
<class,경의선,행신,2871,2983,5854
<class,경의선,강매,1098,1098,2196
<class,경의선,화전,469,495,964
<class,경의선,수색,635,683,1318
<class,경의선,디지털미디어시티,980,914,1894
<class,경의선,가좌,1926,2090,4016
<class,경의선,홍대입구,1173,1349,2522
<class,경의선,서강대,893,928,1821
<class,경의선,공덕,1053,1045,2098
<class,경의선,효창공원앞,987,1119,2106
<class,경의선,신촌,158,180,338
<class,경의선,서울역,683,681,1364
<class,경원선,소요산,3174,2551,5725
<class,경원선,동두천,988,1166,2154
<class,경원선,보산,1150,951,2101
<class,경원선,동두천중앙,1718,1518,3236
<class,경원선,지행,3555,3257,6812
<class,경원선,덕정,2572,2555,5127
<class,경원선,덕계,1283,1167,2450
<class,경원선,양주,4012,3741,7753
<class,경원선,녹양,2131,1996,4127
<class,경원선,가능,3192,2974,6166
<class,경원선,의정부,11693,11975,23668
<class,경원선,회룡,5778,5768,11546
<class,경원선,망월사,3341,3465,6806
<class,경원선,도봉산,7610,5310,12920
<class,경원선,도봉,2744,2715,5459
<class,경원선,방학,4654,4536,9190
<class,경원선,녹천,2022,1771,3793
<class,경원선,월계,2838,2589,5427
<class,경원선,광운대,3088,3326,6414
<class,경원선,석계,3863,4315,8178
<class,경원선,신이문,3651,3479,7130
<class,경원선,외대앞,3156,3385,6541
<class,경원선,청량리,9153,8565,17718
<class,경원선,왕십리,6136,7527,13663
<class,경원선,응봉,767,700,1467
<class,경원선,옥수,47,12,59
<class,경원선,한남,1528,1535,3063
<class,경원선,서빙고,814,847,1661
<class,경원선,이촌,1695,1391,3086
<class,경부선,광명,1822,1121,2943
<class,경부선,서동탄,716,680,1396
<class,경부선,당정,2446,2371,4817
<class,경부선,천안,5271,4468,9739
<class,경부선,두정,2989,3150,6139
<class,경부선,직산,426,456,882
<class,경부선,성환,1955,2224,4179
<class,경부선,평택,9707,10025,19732
<class,경부선,지제,1494,1552,3046
<class,경부선,서정리,3077,5005,8082
<class,경부선,송탄,2673,3166,5839
<class,경부선,진위,641,615,1256
<class,경부선,오산,6656,7241,13897
<class,경부선,오산대,1613,1577,3190
<class,경부선,세마,1314,1212,2526
<class,경부선,병점,7050,8179,15229
<class,경부선,세류,1835,1656,3491
<class,경부선,독산,4364,4813,9177
<class,경부선,수원,28612,28008,56620
<class,경부선,화서,2955,2855,5810
<class,경부선,성균관대,5832,6529,12361
<class,경부선,의왕,3431,3372,6803
<class,경부선,군포,2575,2461,5036
<class,경부선,금정,10832,11128,21960
<class,경부선,명학,2533,2521,5054
<class,경부선,안양,10959,10683,21642
<class,경부선,관악,3899,3565,7464
<class,경부선,석수,4080,4059,8139
<class,경부선,금천구청,4821,4781,9602
<class,경부선,가산디지털단지,3506,5335,8841
<class,경부선,구로,7345,7410,14755
<class,경부선,신길,3729,3514,7243
<class,경부선,신도림,1560,1654,3214
<class,경부선,영등포,24689,24430,49119
<class,경부선,대방,4120,4846,8966
<class,경부선,노량진,4251,4252,8503
<class,경부선,용산,22014,18039,40053
<class,경부선,남영,2887,3347,6234
<class,경부선,서울역,5117,854,5971
<class,경강선,여주,1722,1299,3021
<class,경강선,세종대왕릉,263,202,465
<class,경강선,부발,1005,1453,2458
<class,경강선,이천,1797,1821,3618
<class,경강선,신둔도예촌,677,592,1269
<class,경강선,곤지암,1142,1381,2523
<class,경강선,초월,1319,1269,2588
<class,경강선,경기광주,3062,3181,6243
<class,경강선,삼동,819,825,1644
<class,경강선,이매,530,379,909
<class,경강선,판교,1925,1860,3785
<class,9호선2~3단계,중앙보훈병원,2325,2216,4541
<class,9호선2~3단계,둔촌오륜,322,339,661
<class,9호선2~3단계,올림픽공원,2311,2350,4661
<class,9호선2~3단계,한성백제,972,1028,2000
<class,9호선2~3단계,송파나루,2004,2503,4507
<class,9호선2~3단계,석촌,3219,3123,6342
<class,9호선2~3단계,석촌고분,2270,2455,4725
<class,9호선2~3단계,삼전,2578,2923,5501
<class,9호선2~3단계,종합운동장,1514,1523,3037
<class,9호선2~3단계,봉은사,5424,5548,10972
<class,9호선2~3단계,삼성중앙,1305,1504,2809
<class,9호선2~3단계,선정릉,2031,2500,4531
<class,9호선2~3단계,언주,2053,2320,4373
<class,9호선,신논현,11297,11348,22645
<class,9호선,사평,959,1071,2030
<class,9호선,고속터미널,10938,9036,19974
<class,9호선,신반포,1088,1054,2142
<class,9호선,구반포,893,953,1846
<class,9호선,동작,753,612,1365
<class,9호선,흑석,2753,3046,5799
<class,9호선,노들,1770,1622,3392
<class,9호선,샛강,1170,1178,2348
<class,9호선,여의도,3982,4045,8027
<class,9호선,국회의사당,2722,2672,5394
<class,9호선,당산,6040,6661,12701
<class,9호선,선유도,1886,2136,4022
<class,9호선,신목동,1249,1084,2333
<class,9호선,염창,5963,6644,12607
<class,9호선,등촌,3633,4028,7661
<class,9호선,증미,1787,2068,3855
<class,9호선,가양,7114,7536,14650
<class,9호선,양천향교,2880,3511,6391
<class,9호선,마곡나루,3498,4007,7505
<class,9호선,신방화,2610,2673,5283
<class,9호선,공항시장,1243,1401,2644
<class,9호선,김포공항,7844,9263,17107
<class,9호선,개화,823,727,1550
<class,8호선,모란,2714,2209,4923
<class,8호선,수진,2344,2257,4601
<class,8호선,신흥,2329,2511,4840
<class,8호선,단대오거리,4364,4376,8740
<class,8호선,남한산성입구,5597,5301,10898
<class,8호선,산성,3118,3221,6339
<class,8호선,복정,3596,3574,7170
<class,8호선,장지,7168,7491,14659
<class,8호선,문정,3438,3980,7418
<class,8호선,가락시장,2231,3053,5284
<class,8호선,송파,2709,2869,5578
<class,8호선,석촌,3014,3962,6976
<class,8호선,잠실,8010,8523,16533
<class,8호선,몽촌토성,2186,2313,4499
<class,8호선,강동구청,3424,3625,7049
<class,8호선,천호,6991,8226,15217
<class,8호선,암사,6969,6696,13665
<class,7호선,부평구청,3942,3309,7251
<class,7호선,굴포천,3498,3420,6918
<class,7호선,삼산체육관,1865,1612,3477
<class,7호선,상동,4899,4729,9628
<class,7호선,부천시청,5026,4907,9933
<class,7호선,신중동,5183,5207,10390
<class,7호선,부천종합운동장,1749,1513,3262
<class,7호선,까치울,2946,2926,5872
<class,7호선,온수,3107,3232,6339
<class,7호선,천왕,3629,3455,7084
<class,7호선,광명사거리,9444,9274,18718
<class,7호선,철산,7950,8056,16006
<class,7호선,가산디지털단지,8746,8663,17409
<class,7호선,남구로,5419,5257,10676
<class,7호선,대림,4957,4719,9676
<class,7호선,신풍,4556,4418,8974
<class,7호선,보라매,2981,3230,6211
<class,7호선,신대방삼거리,5761,6403,12164
<class,7호선,장승배기,3766,3989,7755
<class,7호선,상도,3681,4122,7803
<class,7호선,숭실대입구,4117,4867,8984
<class,7호선,남성,4144,4476,8620
<class,7호선,이수,5859,5983,11842
<class,7호선,내방,3868,4175,8043
<class,7호선,고속터미널,16987,5791,22778
<class,7호선,반포,2152,2043,4195
<class,7호선,논현,4602,5105,9707
<class,7호선,학동,3462,3833,7295
<class,7호선,강남구청,3636,4312,7948
<class,7호선,청담,4349,4695,9044
<class,7호선,뚝섬유원지,4759,4470,9229
<class,7호선,건대입구,5485,5788,11273
<class,7호선,어린이대공원,4448,5357,9805
<class,7호선,군자,5460,4979,10439
<class,7호선,중곡,3900,3965,7865
<class,7호선,용마산,2488,2843,5331
<class,7호선,사가정,7392,7312,14704
<class,7호선,면목,6064,6326,12390
<class,7호선,상봉,7118,6731,13849
<class,7호선,중화,4434,4299,8733
<class,7호선,먹골,4108,4204,8312
<class,7호선,공릉,4859,5459,10318
<class,7호선,하계,6882,6650,13532
<class,7호선,중계,5346,4933,10279
<class,7호선,노원,8770,9015,17785
<class,7호선,마들,4535,4322,8857
<class,7호선,수락산,6699,6541,13240
<class,7호선,도봉산,4115,6093,10208
<class,7호선,장암,1079,753,1832
<class,6호선,봉화산,3029,2921,5950
<class,6호선,화랑대,3646,3208,6854
<class,6호선,태릉입구,2204,2452,4656
<class,6호선,석계,4859,5129,9988
<class,6호선,돌곶이,3283,3207,6490
<class,6호선,상월곡,2350,2323,4673
<class,6호선,월곡,3953,4134,8087
<class,6호선,고려대,2872,2982,5854
<class,6호선,안암,3054,3761,6815
<class,6호선,보문,2690,2958,5648
<class,6호선,창신,1310,1298,2608
<class,6호선,동묘앞,4752,4361,9113
<class,6호선,신당,2635,2586,5221
<class,6호선,청구,1363,1325,2688
<class,6호선,약수,1182,1313,2495
<class,6호선,버티고개,851,896,1747
<class,6호선,한강진,4320,5051,9371
<class,6호선,이태원,6360,6071,12431
<class,6호선,녹사평,2792,2876,5668
<class,6호선,삼각지,2158,1661,3819
<class,6호선,효창공원앞,2420,2204,4624
<class,6호선,공덕,4779,4621,9400
<class,6호선,대흥,2529,2788,5317
<class,6호선,광흥창,2825,2739,5564
<class,6호선,상수,3677,4428,8105
<class,6호선,합정,6689,5925,12614
<class,6호선,망원,6704,7777,14481
<class,6호선,마포구청,5090,5126,10216
<class,6호선,월드컵경기장,2462,2416,4878
<class,6호선,디지털미디어시티,3923,4160,8083
<class,6호선,증산,4318,4466,8784
<class,6호선,새절,5076,5016,10092
<class,6호선,구산,2904,2283,5187
<class,6호선,독바위,1196,1555,2751
<class,6호선,불광,2245,2085,4330
<class,6호선,역촌,1408,1718,3126
<class,6호선,응암,6940,7316,14256
<class,5호선,하남풍산,2315,2450,4765
<class,5호선,미사,5376,5568,10944
<class,5호선,마천,2581,2802,5383
<class,5호선,거여,2832,2807,5639
<class,5호선,개롱,2184,2437,4621
<class,5호선,오금,1132,1087,2219
<class,5호선,방이,2721,2695,5416
<class,5호선,올림픽공원,1544,1408,2952
<class,5호선,둔촌동,3237,3385,6622
<class,5호선,상일동,5642,5479,11121
<class,5호선,고덕,3008,2973,5981
<class,5호선,명일,3204,3193,6397
<class,5호선,굽은다리,3945,3737,7682
<class,5호선,길동,3061,3177,6238
<class,5호선,강동,6513,6979,13492
<class,5호선,천호,9529,9249,18778
<class,5호선,광나루,5809,5629,11438
<class,5호선,아차산,7771,8036,15807
<class,5호선,군자,4360,5179,9539
<class,5호선,장한평,5345,5647,10992
<class,5호선,답십리,5398,5269,10667
<class,5호선,마장,2006,1923,3929
<class,5호선,왕십리,1737,1999,3736
<class,5호선,행당,3045,2808,5853
<class,5호선,신금호,2154,2437,4591
<class,5호선,청구,1358,1299,2657
<class,5호선,동대문역사문화공원,474,518,992
<class,5호선,을지로4가,983,1039,2022
<class,5호선,종로3가,6134,5637,11771
<class,5호선,광화문,8361,8627,16988
<class,5호선,서대문,3366,3386,6752
<class,5호선,충정로,1057,1190,2247
<class,5호선,애오개,1976,2143,4119
<class,5호선,공덕,3030,3216,6246
<class,5호선,마포,3601,3674,7275
<class,5호선,여의나루,3784,3804,7588
<class,5호선,여의도,3969,4394,8363
<class,5호선,신길,1254,1663,2917
<class,5호선,영등포시장,3013,3399,6412
<class,5호선,영등포구청,1005,1053,2058
<class,5호선,양평,1715,2061,3776
<class,5호선,오목교,9218,9497,18715
<class,5호선,목동,5854,6110,11964
<class,5호선,신정,4782,4453,9235
<class,5호선,까치산,11835,12333,24168
<class,5호선,화곡,10580,10503,21083
<class,5호선,우장산,4891,5101,9992
<class,5호선,발산,6204,6599,12803
<class,5호선,마곡,2337,2545,4882
<class,5호선,송정,2746,2915,5661
<class,5호선,김포공항,7306,5883,13189
<class,5호선,개화산,2143,2184,4327
<class,5호선,방화,2760,2728,5488
<class,4호선,쌍문,12392,11359,23751
<class,4호선,창동,11531,12071,23602
<class,4호선,노원,9613,10244,19857
<class,4호선,상계,8414,7735,16149
<class,4호선,당고개,6298,5901,12199
<class,4호선,남태령,433,392,825
<class,4호선,사당,10243,10275,20518
<class,4호선,총신대입구,7462,8335,15797
<class,4호선,동작,1298,1310,2608
<class,4호선,이촌,3136,3581,6717
<class,4호선,신용산,5494,5179,10673
<class,4호선,삼각지,1293,1772,3065
<class,4호선,숙대입구,4558,4633,9191
<class,4호선,서울역,2817,5259,8076
<class,4호선,회현,6249,6477,12726
<class,4호선,명동,7534,7935,15469
<class,4호선,충무로,5282,5619,10901
<class,4호선,동대문역사문화공원,6228,5494,11722
<class,4호선,동대문,4610,4486,9096
<class,4호선,혜화,14461,15648,30109
<class,4호선,한성대입구,5725,5981,11706
<class,4호선,성신여대입구,9375,9837,19212
<class,4호선,길음,7293,7357,14650
<class,4호선,미아사거리,12696,12191,24887
<class,4호선,미아,6183,6128,12311
<class,4호선,수유,15736,15732,31468
<class,3호선,오금,1948,1961,3909
<class,3호선,경찰병원,1970,2198,4168
<class,3호선,가락시장,2713,2916,5629
<class,3호선,수서,7123,6324,13447
<class,3호선,일원,2402,2547,4949
<class,3호선,대청,2998,3023,6021
<class,3호선,학여울,576,571,1147
<class,3호선,대치,4158,3728,7886
<class,3호선,도곡,1499,1484,2983
<class,3호선,매봉,3017,3133,6150
<class,3호선,양재,8257,10513,18770
<class,3호선,남부터미널,15042,11753,26795
<class,3호선,교대,2852,1931,4783
<class,3호선,고속터미널,46854,27780,74634
<class,3호선,잠원,1685,1715,3400
<class,3호선,신사,10572,11320,21892
<class,3호선,압구정,10794,11273,22067
<class,3호선,옥수,4100,4500,8600
<class,3호선,금호,3478,3319,6797
<class,3호선,약수,4869,5051,9920
<class,3호선,동대입구,3405,4067,7472
<class,3호선,을지로3가,2036,1977,4013
<class,3호선,종로3가,2597,3710,6307
<class,3호선,안국,6589,7727,14316
<class,3호선,경복궁,7701,8539,16240
<class,3호선,독립문,3086,3539,6625
<class,3호선,무악재,1505,1622,3127
<class,3호선,홍제,6807,6787,13594
<class,3호선,녹번,5133,4802,9935
<class,3호선,불광,7694,9133,16827
<class,3호선,연신내,17114,16748,33862
<class,3호선,구파발,8439,8799,17238
<class,3호선,지축,1369,1239,2608
<class,2호선,용두,734,791,1525
<class,2호선,신정네거리,3927,3965,7892
<class,2호선,양천구청,2463,2547,5010
<class,2호선,도림천,390,417,807
<class,2호선,신설동,2045,2223,4268
<class,2호선,신답,539,600,1139
<class,2호선,용답,1201,1357,2558
<class,2호선,충정로,2509,2591,5100
<class,2호선,아현,3958,4064,8022
<class,2호선,이대,4083,4807,8890
<class,2호선,신촌,15377,15714,31091
<class,2호선,홍대입구,34249,36113,70362
<class,2호선,합정,13615,14895,28510
<class,2호선,당산,6573,7039,13612
<class,2호선,영등포구청,5259,5635,10894
<class,2호선,문래,5106,5503,10609
<class,2호선,신도림,20764,20863,41627
<class,2호선,대림,11452,11495,22947
<class,2호선,구로디지털단지,17496,18365,35861
<class,2호선,신대방,11281,12046,23327
<class,2호선,신림,27130,30521,57651
<class,2호선,봉천,8874,9686,18560
<class,2호선,서울대입구,19164,22625,41789
<class,2호선,낙성대,10999,12695,23694
<class,2호선,사당,15363,17409,32772
<class,2호선,방배,4832,5316,10148
<class,2호선,서초,6118,5629,11747
<class,2호선,교대,7362,8190,15552
<class,2호선,강남,24652,24027,48679
<class,2호선,역삼,7523,8876,16399
<class,2호선,선릉,8081,7604,15685
<class,2호선,삼성,14091,13768,27859
<class,2호선,종합운동장,2457,2638,5095
<class,2호선,잠실새내,8082,8729,16811
<class,2호선,잠실,34562,32548,67110
<class,2호선,잠실나루,3813,3819,7632
<class,2호선,강변,22095,15869,37964
<class,2호선,구의,8318,8997,17315
<class,2호선,건대입구,17712,19498,37210
<class,2호선,성수,8599,9871,18470
<class,2호선,뚝섬,6476,7069,13545
<class,2호선,한양대,1343,1643,2986
<class,2호선,왕십리,6631,6490,13121
<class,2호선,상왕십리,5119,5345,10464
<class,2호선,신당,6069,6676,12745
<class,2호선,동대문역사문화공원,5291,5940,11231
<class,2호선,을지로4가,2063,2115,4178
<class,2호선,을지로3가,4929,4621,9550
<class,2호선,을지로입구,12227,11522,23749
<class,2호선,시청,4001,3325,7326
<class,1호선,청량리,9155,9054,18209
<class,1호선,제기동,5872,6183,12055
<class,1호선,신설동,5224,5718,10942
<class,1호선,동대문,7228,7000,14228
<class,1호선,종로5가,5780,6060,11840
<class,1호선,종로3가,10589,9277,19866
<class,1호선,종각,9275,8386,17661
<class,1호선,시청,5015,5090,10105
<class,1호선,동묘앞,9133,9720,18853
<class,1호선,서울역,19379,14674,34053
<class,7호선,태릉입구,3495,3539,7034
<class,수인선,고색,1081,1172,2253
<class,분당선,매교,1039,1163,2202
<class,분당선,수원시청,5447,5545,10992
<class,분당선,매탄권선,1942,1808,3750
<class,분당선,망포,4800,5413,10213
<class,수인선,오목천,990,1043,2033
<class,수인선,어천,339,492,831
<class,수인선,야목,121,106,227
<class,수인선,사리,1910,1645,3555
<class,수인선,달월,40,38,78
<class,수인선,월곶,1391,1296,2687
<class,수인선,소래포구,3859,3798,7657
<class,수인선,인천논현,2527,2574,5101
<class,수인선,호구포,1443,1586,3029
<class,수인선,남동인더스파크,482,565,1047
<class,수인선,원인재,2286,2368,4654
<class,수인선,연수,2459,2369,4828
<class,수인선,송도,1292,1227,2519
<class,수인선,인하대,2358,2279,4637
<class,수인선,숭의,1640,1486,3126
<class,수인선,신포,839,819,1658
<class,수인선,인천,1056,1566,2622
<class,안산선,산본,6802,7387,14189
<class,안산선,대야미,2288,2129,4417
<class,안산선,반월,1988,2047,4035
<class,안산선,상록수,7684,7313,14997
<class,안산선,한대앞,3951,3842,7793
<class,안산선,중앙,9942,9468,19410
<class,안산선,고잔,3327,3116,6443
<class,안산선,초지,1914,1765,3679
<class,안산선,안산,8607,7395,16002
<class,안산선,신길온천,922,817,1739
<class,안산선,정왕,4067,4506,8573
<class,안산선,오이도,4987,4894,9881
<class,안산선,수리산,1631,1541,3172
<class,우이신설선,북한산우이,2742,2811,5553
<class,우이신설선,솔밭공원,1095,1080,2175
<class,우이신설선,4.19민주묘지,1603,1359,2962
<class,우이신설선,가오리,1832,1687,3519
<class,우이신설선,화계,1553,1532,3085
<class,우이신설선,삼양,921,929,1850
<class,우이신설선,삼양사거리,1167,1135,2302
<class,우이신설선,솔샘,2206,2034,4240
<class,우이신설선,북한산보국문,2664,2574,5238
<class,우이신설선,정릉,2103,1835,3938
<class,우이신설선,성신여대입구,1704,2000,3704
<class,2호선,신당,10155,10310,20465
<class,2호선,상왕십리,8639,8199,16838
<class,2호선,왕십리,11513,10121,21634
<class,2호선,한양대,3265,3410,6675
<class,2호선,뚝섬,11689,12438,24127
<class,2호선,성수,16034,17893,33927
<class,2호선,건대입구,29277,30924,60201
<class,2호선,구의,14838,14505,29343
<class,2호선,강변,22884,22718,45602
<class,2호선,잠실나루,6502,6308,12810
<class,2호선,잠실,55404,52812,108216
<class,2호선,잠실새내,14580,15230,29810
<class,2호선,종합운동장,3864,4148,8012
<class,2호선,삼성,24654,24674,49328
<class,2호선,선릉,21767,19460,41227
<class,2호선,역삼,17547,19232,36779
<class,2호선,강남,56460,53046,109506
<class,2호선,교대,15816,17726,33542
<class,2호선,서초,9625,8298,17923
<class,2호선,방배,9049,9451,18500
<class,2호선,사당,26240,28703,54943
<class,2호선,낙성대,19403,18134,37537
<class,2호선,서울대입구,35575,34615,70190
<class,2호선,봉천,16281,15065,31346
<class,2호선,신림,46128,44792,90920
<class,2호선,신대방,17952,17629,35581
<class,2호선,구로디지털단지,31986,31703,63689
<class,2호선,대림,16338,17335,33673
<class,2호선,신도림,37701,37673,75374
<class,2호선,문래,11039,11501,22540
<class,2호선,영등포구청,11327,11640,22967
<class,2호선,당산,11751,12703,24454
<class,2호선,합정,24363,26260,50623
<class,2호선,홍대입구,54166,58150,112316
<class,중앙선,지평,31,53,84
<class,중앙선,용문,2668,2770,5438
<class,중앙선,원덕,385,365,750
<class,중앙선,양평,2240,2385,4625
<class,중앙선,오빈,207,198,405
<class,중앙선,아신,447,461,908
<class,경의선,행신,4526,4524,9050
<class,경의선,능곡,2303,2310,4613
<class,경의선,곡산,329,324,653
<class,경의선,백마,3825,3607,7432
<class,경의선,풍산,3641,3581,7222
<class,경의선,일산,5394,5158,10552
<class,경의선,탄현,4678,4563,9241
<class,경의선,야당,4355,4212,8567
<class,경의선,운정,3770,3549,7319
<class,경의선,금릉,3166,3071,6237
<class,경의선,금촌,4721,4553,9274
<class,경의선,월롱,1085,991,2076
<class,경의선,파주,690,526,1216
<class,경의선,문산,3955,3880,7835
<class,경의선,임진강,48,35,83
<class,경인선,개봉,14698,14758,29456
<class,경인선,오류동,8243,7590,15833
<class,경인선,역곡,18217,18137,36354
<class,경인선,부천,26416,27291,53707
<class,경인선,송내,16325,16031,32356
<class,경인선,부평,26980,29464,56444
<class,경인선,백운,4942,4893,9835
<class,경인선,동암,11677,11796,23473
<class,경인선,주안,14563,12869,27432
<class,경인선,제물포,6817,6475,13292
<class,경인선,동인천,10844,10385,21229
<class,경인선,인천,3843,3278,7121
<class,경인선,구일,4188,3943,8131
<class,경인선,소사,7049,6805,13854
<class,경인선,부개,5931,5444,11375
<class,경인선,간석,3852,3746,7598
<class,경인선,도원,2007,2029,4036
<class,경인선,온수,4309,4009,8318
<class,경인선,중동,5911,5611,11522
<class,경인선,도화,2886,2614,5500
<class,경춘선,신내,883,899,1782
<class,경춘선,갈매,1694,1423,3117
<class,경춘선,별내,1778,1755,3533
<class,경춘선,퇴계원,2237,2123,4360
<class,경춘선,사릉,2039,1941,3980
<class,경춘선,금곡,925,880,1805
<class,경춘선,평내호평,3931,3796,7727
<class,경춘선,천마산,1229,1189,2418
<class,경춘선,마석,2626,2694,5320
<class,경춘선,대성리,475,466,941
<class,경춘선,청평,1231,1234,2465
<class,경춘선,상천,323,283,606
<class,경춘선,가평,1204,1201,2405
<class,경춘선,굴봉산,116,133,249
<class,경춘선,백양리,265,229,494
<class,경춘선,강촌,516,529,1045
<class,경춘선,김유정,410,421,831
<class,경춘선,남춘천,2055,2059,4114
<class,경춘선,춘천,1183,1119,2302
<class,공항철도 1호선,서울역,5696,5756,11452
<class,공항철도 1호선,공덕,1364,1915,3279
<class,공항철도 1호선,홍대입구,10031,9531,19562
<class,공항철도 1호선,디지털미디어시티,4583,4419,9002
<class,공항철도 1호선,마곡나루,2503,2759,5262
<class,공항철도 1호선,김포공항,9382,5023,14405
<class,공항철도 1호선,계양,5640,5145,10785
<class,공항철도 1호선,검암,4212,4374,8586
<class,공항철도 1호선,청라국제도시,3493,3333,6826
<class,공항철도 1호선,운서,5002,5112,10114
<class,공항철도 1호선,공항화물청사,1191,1261,2452
<class,공항철도 1호선,인천공항1터미널,2895,3099,5994
<class,공항철도 1호선,인천공항2터미널,1523,1367,2890
<class,공항철도 1호선,영종,2385,2451,4836
<class,과천선,선바위,4452,4018,8470
<class,과천선,경마공원,963,936,1899
<class,과천선,대공원,3565,3909,7474
<class,과천선,과천,3868,3322,7190
<class,과천선,정부과천청사,5025,5202,10227
<class,과천선,인덕원,13628,13146,26774
<class,과천선,평촌,8406,8246,16652
<class,과천선,범계,18055,17858,35913
<class,분당선,선릉,4822,7180,12002
<class,분당선,한티,10241,9814,20055
<class,분당선,도곡,4006,3750,7756
<class,분당선,구룡,1024,990,2014
<class,분당선,개포동,2297,2226,4523
<class,분당선,대모산입구,2399,2102,4501
<class,분당선,수서,8334,8775,17109
<class,분당선,복정,1,0,1
<class,분당선,수원,6916,5844,12760
<class,분당선,서울숲,6529,6723,13252
<class,분당선,압구정로데오,17341,19160,36501
<class,분당선,강남구청,4873,5850,10723
<class,분당선,선정릉,3367,3443,6810
<class,분당선,가천대,4156,4740,8896
<class,분당선,태평,9660,9164,18824
<class,분당선,모란,14457,14780,29237
<class,분당선,야탑,15285,16094,31379
<class,분당선,서현,17235,17670,34905
<class,분당선,수내,8143,7540,15683
<class,분당선,정자,10095,8086,18181
<class,분당선,미금,10008,10305,20313
<class,분당선,오리,7089,5917,13006
<class,분당선,이매,3504,3364,6868
<class,분당선,보정,1427,1280,2707
<class,분당선,죽전,9249,10529,19778
<class,분당선,구성,2832,3006,5838
<class,분당선,신갈,2496,2524,5020
<class,분당선,기흥,6188,5912,12100
<class,분당선,상갈,3489,3532,7021
<class,분당선,청명,2542,2409,4951
<class,분당선,영통,5827,5851,11678
<class,분당선,망포,8361,7724,16085
<class,분당선,매탄권선,3090,2918,6008
<class,분당선,수원시청,10086,10615,20701
<class,분당선,매교,1902,1949,3851
<class,수인선,고색,1789,1921,3710
<class,수인선,오목천,1617,1412,3029
<class,수인선,어천,521,453,974
<class,수인선,야목,160,140,300
<class,수인선,사리,2814,2404,5218
<class,수인선,달월,60,51,111
<class,수인선,월곶,1886,1882,3768
<class,수인선,소래포구,4763,4801,9564
<class,수인선,인천논현,4121,4144,8265
<class,수인선,호구포,2198,2196,4394
<class,수인선,남동인더스파크,992,924,1916
<class,수인선,원인재,3232,3321,6553
<class,수인선,연수,3418,3395,6813
<class,수인선,송도,2024,1900,3924
<class,수인선,인하대,3764,3613,7377
<class,수인선,숭의,2507,2311,4818
<class,수인선,신포,1340,1339,2679
<class,수인선,인천,1160,1935,3095
<class,안산선,산본,11243,11925,23168
<class,안산선,대야미,3698,3191,6889
<class,안산선,반월,2961,2756,5717
<class,안산선,상록수,11300,11250,22550
<class,안산선,한대앞,6017,6061,12078
<class,안산선,중앙,13995,14414,28409
<class,안산선,고잔,5560,5398,10958
<class,안산선,초지,2875,2931,5806
<class,안산선,안산,8523,8558,17081
<class,안산선,신길온천,1248,1199,2447
<class,안산선,정왕,5166,5306,10472
<class,안산선,오이도,6802,6989,13791
<class,안산선,수리산,2554,2241,4795
<class,우이신설선,북한산우이,3069,3131,6200
<class,우이신설선,솔밭공원,1556,1560,3116
<class,우이신설선,4.19민주묘지,2053,1767,3820
<class,우이신설선,가오리,2624,2542,5166
<class,우이신설선,화계,2226,2064,4290
<class,우이신설선,삼양,1407,1505,2912
<class,우이신설선,삼양사거리,1753,1828,3581
<class,우이신설선,솔샘,3327,2930,6257
<class,우이신설선,북한산보국문,4144,3839,7983
<class,우이신설선,정릉,3274,2706,5980
<class,우이신설선,성신여대입구,2499,2925,5424
<class,우이신설선,보문,1023,1052,2075
<class,우이신설선,신설동,1407,1338,2745
<class,일산선,원흥,5877,5624,11501
<class,일산선,삼송,12615,12273,24888
<class,일산선,원당,7361,7014,14375
<class,일산선,화정,11574,12092,23666
<class,일산선,대곡,1119,940,2059
<class,일산선,백석,6878,6885,13763
<class,일산선,마두,4462,4606,9068
<class,일산선,정발산,5945,6164,12109
<class,일산선,주엽,5534,5507,11041
<class,경의선,강매,1719,1585,3304
<class,일산선,대화,7408,6711,14119
<class,경의선,화전,880,794,1674
<class,경의선,디지털미디어시티,1628,1518,3146
<class,경의선,가좌,3479,3318,6797
<class,경의선,홍대입구,1595,1790,3385
<class,경의선,서강대,1375,1383,2758
<class,경의선,공덕,2283,1761,4044
<class,경의선,효창공원앞,1598,1777,3375
<class,경의선,신촌,350,350,700
<class,4호선,쌍문,19805,18142,37947
<class,4호선,창동,17927,19001,36928
<class,4호선,노원,15040,16456,31496
<class,4호선,상계,12751,12020,24771
<class,경의선,서울역,1106,1205,2311
<class,경원선,소요산,3293,2908,6201
<class,경원선,동두천,1387,1630,3017
<class,2호선,신촌,26964,27408,54372
<class,2호선,이대,8366,9017,17383
<class,2호선,아현,6614,6316,12930
<class,경원선,보산,1826,1719,3545
<class,경원선,동두천중앙,2423,2513,4936
<class,경원선,지행,4945,4810,9755
<class,경원선,덕정,3732,3421,7153
<class,경원선,덕계,1843,1699,3542
<class,경원선,양주,5475,5341,10816
<class,경원선,녹양,3197,3082,6279
<class,경원선,가능,4602,4390,8992
<class,경원선,의정부,15756,16763,32519
<class,경원선,회룡,8676,8602,17278
<class,경원선,망월사,4847,4982,9829
<class,경원선,도봉산,8849,6061,14910
<class,경원선,도봉,4178,3968,8146
<class,경원선,방학,6677,6483,13160
<class,경원선,녹천,3134,2634,5768
<class,경원선,월계,4322,3943,8265
<class,경원선,광운대,5046,5024,10070
<class,경원선,석계,6031,6562,12593
<class,경원선,신이문,5776,5161,10937
<class,경원선,외대앞,5225,5003,10228
<class,경원선,청량리,12992,14582,27574
<class,경원선,왕십리,10838,12228,23066
<class,경원선,응봉,1360,1126,2486
<class,경원선,옥수,23,31,54
<class,경원선,한남,2574,2373,4947
<class,경원선,서빙고,1191,1009,2200
<class,경원선,이촌,2774,2038,4812
<class,경부선,광명,1996,1808,3804
<class,경부선,서동탄,933,928,1861
<class,경부선,당정,3689,3537,7226
<class,경부선,천안,4573,4669,9242
<class,경부선,두정,4176,4316,8492
<class,경부선,직산,514,489,1003
<class,경부선,성환,2336,2161,4497
<class,경부선,평택,10843,10461,21304
<class,경부선,지제,2287,2121,4408
<class,경부선,서정리,5589,4535,10124
<class,경부선,송탄,4039,3783,7822
<class,경부선,진위,901,800,1701
<class,경부선,오산,8032,7534,15566
<class,경부선,오산대,2306,2080,4386
<class,경부선,세마,1881,1706,3587
<class,경부선,병점,10404,10444,20848
<class,경부선,세류,2116,2175,4291
<class,경부선,독산,7825,7780,15605
<class,경부선,수원,33228,35490,68718
<class,경부선,화서,4532,4546,9078
<class,경부선,성균관대,9224,9195,18419
<class,경부선,의왕,5330,5185,10515
<class,경부선,군포,4130,3794,7924
<class,경부선,금정,16323,16473,32796
<class,경부선,명학,4564,4411,8975
<class,경부선,안양,16043,15999,32042
<class,경부선,관악,5415,5092,10507
<class,경부선,석수,6192,5948,12140
<class,경부선,금천구청,7527,7443,14970
<class,경부선,가산디지털단지,5548,7448,12996
<class,경부선,구로,12325,12807,25132
<class,경부선,신길,6032,4997,11029
<class,경부선,신도림,2563,2633,5196
<class,경부선,영등포,34638,35927,70565
<class,경부선,대방,7210,7222,14432
<class,경부선,노량진,7523,6976,14499
<class,경부선,용산,25505,26724,52229
<class,경부선,남영,5522,5589,11111
<class,경부선,서울역,4380,1189,5569
<class,경강선,여주,1602,1750,3352
<class,경강선,세종대왕릉,230,260,490
<class,경강선,부발,1576,1332,2908
<class,경강선,이천,2329,2427,4756
<class,경강선,신둔도예촌,930,907,1837
<class,경강선,곤지암,1557,1537,3094
<class,경강선,초월,1876,1728,3604
<class,경강선,경기광주,4482,4176,8658
<class,경강선,삼동,1401,1292,2693
<class,경강선,이매,653,598,1251
<class,경강선,판교,2630,2530,5160
<class,9호선2~3단계,중앙보훈병원,3716,3464,7180
<class,9호선2~3단계,둔촌오륜,566,535,1101
<class,9호선2~3단계,올림픽공원,3554,3431,6985
<class,9호선2~3단계,한성백제,1694,1449,3143
<class,9호선2~3단계,송파나루,3392,3766,7158
<class,9호선2~3단계,석촌,5879,4861,10740
<class,9호선2~3단계,석촌고분,3891,3739,7630
<class,9호선2~3단계,삼전,4381,4081,8462
<class,9호선2~3단계,종합운동장,2920,2631,5551
<class,9호선2~3단계,봉은사,9135,9292,18427
<class,9호선2~3단계,삼성중앙,2777,2822,5599
<class,9호선2~3단계,선정릉,4473,4878,9351
<class,9호선2~3단계,언주,5632,5696,11328
<class,9호선,신논현,24188,23716,47904
<class,9호선,사평,1751,1682,3433
<class,9호선,고속터미널,10186,14096,24282
<class,9호선,신반포,2111,2028,4139
<class,9호선,구반포,1945,2099,4044
<class,9호선,동작,1163,986,2149
<class,9호선,흑석,4906,4854,9760
<class,9호선,노들,2848,2355,5203
<class,9호선,노량진,17350,17613,34963
<class,9호선,샛강,2179,2086,4265
<class,9호선,여의도,7620,7363,14983
<class,9호선,국회의사당,3460,3619,7079
<class,9호선,당산,11344,10554,21898
<class,9호선,선유도,3350,3243,6593
<class,9호선,신목동,2082,1745,3827
<class,9호선,염창,10298,9672,19970
<class,9호선,등촌,6498,6354,12852
<class,9호선,증미,3853,3732,7585
<class,9호선,가양,12615,11973,24588
<class,9호선,양천향교,5325,5111,10436
<class,9호선,마곡나루,6934,7002,13936
<class,9호선,신방화,4089,3928,8017
<class,9호선,공항시장,2018,2264,4282
<class,9호선,김포공항,7215,10563,17778
<class,9호선,개화,1178,970,2148
<class,8호선,모란,3447,2770,6217
<class,8호선,수진,3733,3495,7228
<class,8호선,신흥,3398,3577,6975
<class,8호선,단대오거리,6882,6424,13306
<class,8호선,남한산성입구,8471,7686,16157
<class,8호선,산성,4667,4767,9434
<class,8호선,복정,6369,5569,11938
<class,8호선,장지,11454,10997,22451
<class,8호선,문정,8000,8280,16280
<class,8호선,가락시장,5359,5290,10649
<class,8호선,송파,4783,4827,9610
<class,8호선,석촌,5228,6297,11525
<class,8호선,잠실,11395,12870,24265
<class,8호선,몽촌토성,3941,3997,7938
<class,8호선,강동구청,5609,5760,11369
<class,8호선,천호,11294,13147,24441
<class,8호선,암사,11514,10628,22142
<class,7호선,부평구청,6218,5470,11688
<class,7호선,굴포천,5707,5958,11665
<class,7호선,삼산체육관,3007,2749,5756
<class,7호선,상동,8636,8848,17484
<class,7호선,부천시청,8423,8263,16686
<class,7호선,신중동,8829,8624,17453
<class,7호선,춘의,4748,4618,9366
<class,7호선,부천종합운동장,2836,2539,5375
<class,7호선,까치울,4701,4841,9542
<class,7호선,온수,5283,5110,10393
<class,7호선,천왕,6120,5791,11911
<class,7호선,광명사거리,15631,15565,31196
<class,7호선,철산,13510,13622,27132
<class,7호선,가산디지털단지,13729,12791,26520
<class,7호선,남구로,7787,8280,16067
<class,7호선,대림,5911,6332,12243
<class,7호선,신풍,7466,7167,14633
<class,4호선,당고개,9014,8500,17514
<class,4호선,남태령,788,573,1361
<class,4호선,사당,17148,14858,32006
<class,4호선,총신대입구,12954,14197,27151
<class,4호선,동작,2006,1984,3990
<class,4호선,이촌,5223,5840,11063
<class,4호선,신용산,8019,8695,16714
<class,4호선,삼각지,2514,3181,5695
<class,4호선,숙대입구,8024,7995,16019
<class,4호선,서울역,4532,9068,13600
<class,4호선,회현,15310,16695,32005
<class,4호선,명동,11217,12879,24096
<class,4호선,충무로,11097,11722,22819
<class,4호선,동대문역사문화공원,9311,8121,17432
<class,4호선,동대문,12914,13053,25967
<class,4호선,혜화,22521,22866,45387
<class,4호선,한성대입구,9232,8838,18070
<class,4호선,성신여대입구,15276,14356,29632
<class,4호선,길음,12462,11700,24162
<class,4호선,미아사거리,20261,19685,39946
<class,4호선,미아,10103,9698,19801
<class,4호선,수유,24500,24015,48515
<class,3호선,오금,3241,3124,6365
<class,3호선,경찰병원,3606,3471,7077
<class,3호선,가락시장,5640,5440,11080
<class,3호선,수서,10647,11096,21743
<class,3호선,일원,4455,4418,8873
<class,3호선,대청,5247,4931,10178
<class,3호선,학여울,1278,1238,2516
<class,3호선,대치,8351,7375,15726
<class,3호선,도곡,3211,3168,6379
<class,3호선,매봉,5513,5214,10727
<class,3호선,양재,17705,18879,36584
<class,3호선,남부터미널,18640,18891,37531
<class,3호선,무악재,2477,2585,5062
<class,3호선,홍제,11737,11159,22896
<class,3호선,녹번,8948,7710,16658
<class,3호선,교대,5706,3508,9214
<class,3호선,고속터미널,41778,41188,82966
<class,3호선,잠원,3212,3138,6350
<class,3호선,신사,25595,26337,51932
<class,3호선,압구정,24003,24852,48855
<class,3호선,옥수,6517,6709,13226
<class,3호선,금호,5736,5184,10920
<class,3호선,약수,8289,7975,16264
<class,3호선,동대입구,4886,5528,10414
<class,3호선,충무로,1,0,1
<class,2호선,충정로,5041,5241,10282
<class,2호선,용답,1807,1745,3552
<class,2호선,신답,992,998,1990
<class,2호선,신설동,3012,2937,5949
<class,2호선,도림천,878,808,1686
<class,2호선,양천구청,4139,4265,8404
<class,2호선,신정네거리,6470,6678,13148
<class,2호선,용두,1667,1583,3250
<class,3호선,지축,2301,2203,4504
<class,3호선,구파발,13511,13594,27105
<class,3호선,연신내,27778,26046,53824
<class,7호선,보라매,5656,5540,11196
<class,7호선,신대방삼거리,10391,9802,20193
<class,7호선,장승배기,6555,6290,12845
<class,7호선,상도,6542,6320,12862
<class,7호선,숭실대입구,7119,7106,14225
<class,7호선,남성,7139,6654,13793
<class,7호선,이수,11079,10327,21406
<class,7호선,내방,7236,7208,14444
<class,7호선,고속터미널,11279,8932,20211
<class,7호선,반포,3878,3688,7566
<class,7호선,논현,10828,11674,22502
<class,7호선,학동,10222,10881,21103
<class,7호선,강남구청,9370,10232,19602
<class,7호선,청담,11077,11555,22632
<class,7호선,뚝섬유원지,7433,7165,14598
<class,7호선,건대입구,9640,9655,19295
<class,7호선,어린이대공원,7773,7486,15259
<class,7호선,군자,9725,7413,17138
<class,7호선,중곡,6197,5998,12195
<class,7호선,용마산,4407,4596,9003
<class,7호선,사가정,11609,11305,22914
<class,7호선,면목,10229,10028,20257
<class,7호선,상봉,12358,11737,24095
<class,7호선,중화,7259,7113,14372
<class,7호선,먹골,7184,7088,14272
<class,7호선,태릉입구,5771,5264,11035
<class,7호선,공릉,7728,7901,15629
<class,7호선,하계,11056,10322,21378
<class,7호선,중계,8553,7656,16209
<class,7호선,노원,14140,14806,28946
<class,7호선,마들,7967,7489,15456
<class,7호선,수락산,9380,9217,18597
<class,7호선,도봉산,5854,8411,14265
<class,7호선,장암,1363,994,2357
<class,6호선,봉화산,4773,4548,9321
<class,6호선,화랑대,6224,5257,11481
<class,6호선,태릉입구,3734,4043,7777
<class,6호선,석계,8145,8048,16193
<class,6호선,돌곶이,5370,5096,10466
<class,6호선,상월곡,3759,3342,7101
<class,6호선,월곡,6806,6677,13483
<class,6호선,고려대,5557,5440,10997
<class,6호선,안암,6143,6097,12240
<class,6호선,보문,4703,4191,8894
<class,6호선,창신,1986,1713,3699
<class,6호선,동묘앞,7425,6946,14371
<class,6호선,신당,5309,4433,9742
<class,6호선,청구,2390,2345,4735
<class,6호선,약수,2184,2277,4461
<class,6호선,버티고개,1468,1530,2998
<class,6호선,한강진,7383,8784,16167
<class,6호선,이태원,9707,10182,19889
<class,6호선,녹사평,4437,4611,9048
<class,6호선,삼각지,3947,3216,7163
<class,6호선,효창공원앞,4276,3881,8157
<class,6호선,공덕,9335,8909,18244
<class,6호선,대흥,4643,4675,9318
<class,6호선,광흥창,4912,4566,9478
<class,6호선,상수,6762,7793,14555
<class,6호선,합정,11070,10208,21278
<class,6호선,망원,12100,13559,25659
<class,6호선,마포구청,8750,7532,16282
<class,6호선,월드컵경기장,4122,4249,8371
<class,6호선,디지털미디어시티,6678,6837,13515
<class,6호선,증산,6981,6853,13834
<class,6호선,새절,8305,7856,16161
<class,6호선,구산,4949,3802,8751
<class,6호선,독바위,1876,2223,4099
<class,6호선,불광,3629,3369,6998
<class,6호선,역촌,2377,2774,5151
<class,6호선,응암,11486,11405,22891
<class,5호선,하남풍산,3374,3585,6959
<class,5호선,미사,8993,8864,17857
<class,5호선,마천,4018,4153,8171
<class,5호선,거여,4995,4760,9755
<class,중앙선,국수,560,608,1168
<class,중앙선,신원,257,247,504
<class,중앙선,양수,1732,1664,3396
<class,중앙선,운길산,1070,1035,2105
<class,중앙선,팔당,1422,1459,2881
<class,중앙선,도심,1464,1332,2796
<class,중앙선,덕소,4122,4095,8217
<class,중앙선,양정,488,424,912
<class,중앙선,도농,5933,5649,11582
<class,중앙선,구리,9334,9462,18796
<class,중앙선,양원,1003,968,1971
<class,중앙선,망우,5551,5397,10948
<class,중앙선,상봉,4429,4482,8911
<class,경의선,수색,1215,1105,2320
<class,경원선,창동,1,0,1
<class,5호선,개롱,3771,4007,7778
<class,5호선,오금,1955,1852,3807
<class,5호선,방이,4653,4558,9211
<class,5호선,올림픽공원,2672,2406,5078
<class,5호선,둔촌동,5600,5673,11273
<class,5호선,상일동,9501,8808,18309
<class,5호선,고덕,5353,5187,10540
<class,5호선,명일,5432,5331,10763
<class,5호선,굽은다리,6239,5845,12084
<class,5호선,길동,5377,5459,10836
<class,5호선,강동,11971,11286,23257
<class,5호선,천호,15116,14446,29562
<class,5호선,광나루,8760,8436,17196
<class,5호선,아차산,11566,11400,22966
<class,5호선,군자,7675,8638,16313
<class,5호선,장한평,9904,9836,19740
<class,5호선,답십리,9365,8550,17915
<class,5호선,마장,3652,3380,7032
<class,5호선,왕십리,3245,3694,6939
<class,5호선,행당,5025,4354,9379
<class,5호선,신금호,3823,3938,7761
<class,5호선,청구,2328,2140,4468
<class,5호선,동대문역사문화공원,930,1154,2084
<class,5호선,을지로4가,3131,3451,6582
<class,5호선,종로3가,10467,10905,21372
<class,5호선,광화문,13177,12928,26105
<class,5호선,서대문,6231,6128,12359
<class,5호선,충정로,1799,1694,3493
<class,5호선,애오개,3417,3259,6676
<class,5호선,공덕,6432,6780,13212
<class,5호선,마포,6441,6655,13096
<class,5호선,여의나루,6891,6860,13751
<class,5호선,여의도,7768,8832,16600
<class,5호선,신길,2327,2554,4881
<class,5호선,영등포시장,6626,7059,13685
<class,5호선,영등포구청,1779,1768,3547
<class,5호선,양평,3372,3274,6646
<class,5호선,오목교,15529,16061,31590
<class,5호선,목동,10107,10335,20442
<class,5호선,신정,8165,6992,15157
<class,5호선,까치산,19559,19039,38598
<class,5호선,화곡,18156,16806,34962
<class,5호선,우장산,8641,8593,17234
<class,5호선,발산,11771,12273,24044
<class,5호선,마곡,4272,4297,8569
<class,5호선,송정,4664,4537,9201
<class,5호선,김포공항,6611,6587,13198
<class,5호선,개화산,3417,3396,6813
<class,중앙선,회기,16880,16332,33212
<class,장항선,신창,806,664,1470
<class,장항선,온양온천,2830,2952,5782
<class,장항선,배방,749,718,1467
<class,장항선,아산,2058,1984,4042
<class,장항선,쌍용,1241,1146,2387
<class,5호선,방화,4364,4120,8484
<class,중앙선,중랑,3951,3854,7805
<class,1호선,종각,16344,14808,31152
<class,1호선,종로3가,19769,18618,38387
<class,1호선,종로5가,16124,16425,32549
<class,1호선,동대문,9650,8894,18544
<class,1호선,신설동,8747,8401,17148
<class,1호선,제기동,14447,14892,29339
<class,1호선,청량리,16943,16968,33911
<class,장항선,봉명,616,605,1221
<class,3호선,불광,11876,13566,25442
<class,2호선,시청,7612,6703,14315
<class,2호선,을지로입구,18415,17936,36351
<class,2호선,을지로3가,8599,8529,17128
<class,3호선,독립문,5014,5393,10407
<class,3호선,경복궁,12634,13252,25886
<class,3호선,안국,11864,13670,25534
<class,3호선,종로3가,5032,7239,12271
<class,3호선,을지로3가,4365,4803,9168
<class,1호선,시청,8461,8691,17152
<class,1호선,서울역,24061,23535,47596
<class,2호선,을지로4가,6658,6769,13427
<class,1호선,동묘앞,10852,11506,22358
<class,2호선,동대문역사문화공원,8585,9146,17731
<class,4호선,노원,10237,11229,21466
<class,중앙선,지평,47,41,88
<class,중앙선,용문,1552,1328,2880
<class,중앙선,원덕,273,220,493
<class,중앙선,양평,1811,1728,3539
<class,중앙선,오빈,138,146,284
<class,중앙선,아신,460,385,845
<class,중앙선,국수,536,511,1047
<class,중앙선,신원,291,205,496
<class,중앙선,양수,1696,1511,3207
<class,중앙선,운길산,1143,1093,2236
<class,중앙선,팔당,1340,1430,2770
<class,중앙선,도심,1144,1003,2147
<class,중앙선,덕소,3007,3159,6166
<class,중앙선,양정,440,379,819
<class,중앙선,도농,4115,4155,8270
<class,중앙선,구리,6779,7126,13905
<class,중앙선,양원,743,830,1573
<class,중앙선,망우,4198,4212,8410
<class,중앙선,상봉,3625,3543,7168
<class,중앙선,중랑,3011,2836,5847
<class,중앙선,회기,12801,12641,25442
<class,장항선,신창,681,763,1444
<class,장항선,온양온천,2496,2527,5023
<class,장항선,배방,635,690,1325
<class,장항선,아산,1949,1538,3487
<class,장항선,쌍용,902,932,1834
<class,장항선,봉명,471,438,909
<class,일산선,대화,5484,4960,10444
<class,일산선,주엽,3835,3679,7514
<class,일산선,정발산,4504,4434,8938
<class,일산선,마두,2973,3024,5997
<class,일산선,백석,5022,4964,9986
<class,일산선,대곡,918,702,1620
<class,일산선,화정,8196,8483,16679
<class,일산선,원당,5496,5307,10803
<class,일산선,삼송,9089,9016,18105
<class,일산선,원흥,4181,3979,8160
<class,우이신설선,신설동,1099,1068,2167
<class,우이신설선,보문,794,807,1601
<class,우이신설선,성신여대입구,1883,2101,3984
<class,우이신설선,정릉,2278,1962,4240
<class,우이신설선,북한산보국문,3235,2886,6121
<class,우이신설선,솔샘,2400,2224,4624
<class,우이신설선,삼양사거리,1352,1299,2651
<class,우이신설선,삼양,1102,1143,2245
<class,우이신설선,화계,1843,1620,3463
<class,우이신설선,가오리,1980,1948,3928
<class,우이신설선,4.19민주묘지,1788,1561,3349
<class,우이신설선,솔밭공원,1272,1265,2537
<class,우이신설선,북한산우이,2598,2780,5378
<class,안산선,수리산,1828,1864,3692
<class,안산선,오이도,5610,5463,11073
<class,안산선,정왕,4021,4294,8315
<class,안산선,신길온천,951,947,1898
<class,안산선,안산,8121,7419,15540
<class,안산선,초지,1980,1994,3974
<class,안산선,고잔,3532,3584,7116
<class,안산선,중앙,10416,10468,20884
<class,안산선,한대앞,4513,4377,8890
<class,안산선,상록수,8112,7868,15980
<class,안산선,반월,2188,2234,4422
<class,안산선,대야미,2769,2453,5222
<class,안산선,산본,7684,8213,15897
<class,수인선,인천,1166,1697,2863
<class,수인선,신포,965,973,1938
<class,수인선,숭의,1820,1667,3487
<class,수인선,인하대,2878,2681,5559
<class,수인선,송도,1480,1463,2943
<class,수인선,연수,2658,2511,5169
<class,수인선,원인재,2471,2619,5090
<class,수인선,남동인더스파크,584,567,1151
<class,수인선,호구포,1746,1732,3478
<class,수인선,인천논현,2773,2878,5651
<class,수인선,소래포구,4419,4358,8777
<class,수인선,월곶,1519,1400,2919
<class,수인선,달월,53,55,108
<class,수인선,사리,2111,1869,3980
<class,수인선,야목,136,127,263
<class,수인선,어천,369,438,807
<class,수인선,오목천,1104,1095,2199
<class,수인선,고색,1257,1383,2640
<class,분당선,매교,1321,1382,2703
<class,분당선,수원시청,6640,6424,13064
<class,분당선,매탄권선,2166,2077,4243
<class,분당선,망포,5436,5626,11062
<class,분당선,영통,4025,3995,8020
<class,분당선,청명,1769,1702,3471
<class,분당선,상갈,2600,2622,5222
<class,분당선,기흥,4195,4195,8390
<class,분당선,신갈,1807,1877,3684
<class,분당선,구성,2085,2255,4340
<class,분당선,죽전,6999,8116,15115
<class,분당선,보정,953,881,1834
<class,분당선,이매,2446,2507,4953
<class,분당선,오리,4726,4129,8855
<class,분당선,미금,6357,6719,13076
<class,분당선,정자,6778,5334,12112
<class,분당선,수내,5247,5129,10376
<class,분당선,서현,12451,12494,24945
<class,분당선,야탑,11005,11287,22292
<class,분당선,모란,9787,9957,19744
<class,분당선,태평,6923,6591,13514
<class,분당선,가천대,3045,3441,6486
<class,분당선,선정릉,1917,2012,3929
<class,분당선,강남구청,2796,3372,6168
<class,분당선,압구정로데오,9429,10154,19583
<class,분당선,서울숲,5183,5367,10550
<class,분당선,수원,5378,4293,9671
<class,분당선,수서,7158,6617,13775
<class,분당선,대모산입구,1485,1473,2958
<class,분당선,개포동,1516,1554,3070
<class,분당선,구룡,587,604,1191
<class,분당선,도곡,2189,2197,4386
<class,분당선,한티,7252,6945,14197
<class,분당선,선릉,2470,3788,6258
<class,과천선,범계,12538,12033,24571
<class,과천선,평촌,5247,5036,10283
<class,과천선,인덕원,9404,9310,18714
<class,과천선,정부과천청사,3407,3649,7056
<class,과천선,과천,2767,2507,5274
<class,과천선,대공원,3863,3997,7860
<class,과천선,경마공원,773,772,1545
<class,과천선,선바위,2991,2857,5848
<class,공항철도 1호선,영종,1937,1911,3848
<class,공항철도 1호선,인천공항2터미널,1452,1331,2783
<class,공항철도 1호선,인천공항1터미널,3095,3096,6191
<class,공항철도 1호선,공항화물청사,886,967,1853
<class,공항철도 1호선,운서,4068,4415,8483
<class,공항철도 1호선,청라국제도시,2603,2501,5104
<class,공항철도 1호선,검암,3128,3266,6394
<class,공항철도 1호선,계양,4115,4071,8186
<class,공항철도 1호선,김포공항,9657,4897,14554
<class,공항철도 1호선,마곡나루,1752,1937,3689
<class,공항철도 1호선,디지털미디어시티,3171,3191,6362
<class,공항철도 1호선,홍대입구,8279,7254,15533
<class,공항철도 1호선,공덕,995,1363,2358
<class,공항철도 1호선,서울역,5234,4688,9922
<class,경춘선,춘천,1121,976,2097
<class,경춘선,남춘천,1794,1858,3652
<class,경춘선,김유정,428,446,874
<class,경춘선,강촌,614,491,1105
<class,경춘선,백양리,189,207,396
<class,경춘선,굴봉산,151,146,297
<class,경춘선,가평,1156,1121,2277
<class,경춘선,상천,337,278,615
<class,경춘선,청평,1183,974,2157
<class,경춘선,대성리,561,407,968
<class,경춘선,마석,2047,2150,4197
<class,경춘선,천마산,948,1001,1949
<class,경춘선,평내호평,2958,2867,5825
<class,경춘선,금곡,766,738,1504
<class,경춘선,사릉,1432,1419,2851
<class,경춘선,퇴계원,1730,1587,3317
<class,경춘선,별내,1440,1342,2782
<class,경춘선,갈매,1285,1166,2451
<class,경춘선,신내,686,698,1384
<class,경인선,도화,2061,1959,4020
<class,경인선,중동,4158,3953,8111
<class,경인선,온수,3216,3133,6349
<class,경인선,도원,1609,1568,3177
<class,경인선,간석,2691,2641,5332
<class,경인선,부개,4148,3867,8015
<class,경인선,소사,5114,4802,9916
<class,경인선,구일,2953,2874,5827
<class,경인선,인천,3590,2997,6587
<class,경인선,동인천,8102,7785,15887
<class,경인선,제물포,4778,4735,9513
<class,경인선,주안,10393,9112,19505
<class,경인선,동암,8442,8359,16801
<class,경인선,백운,3468,3440,6908
<class,경인선,부평,20187,20789,40976
<class,경인선,송내,11478,11358,22836
<class,경인선,부천,19971,19746,39717
<class,경인선,역곡,12469,12509,24978
<class,경인선,오류동,5998,5533,11531
<class,경인선,개봉,10337,10263,20600
<class,경의선,임진강,57,42,99
<class,경의선,문산,2869,2839,5708
<class,경의선,파주,501,428,929
<class,경의선,월롱,674,1139,1813
<class,경의선,금촌,3843,4037,7880
<class,경의선,금릉,2255,2201,4456
<class,경의선,운정,2858,2686,5544
<class,경의선,야당,3446,3309,6755
<class,경의선,탄현,3548,3382,6930
<class,경의선,일산,3914,3835,7749
<class,경의선,풍산,2940,2822,5762
<class,경의선,백마,2817,2750,5567
<class,경의선,곡산,252,234,486
<class,경의선,능곡,1890,1797,3687
<class,경의선,행신,3500,3462,6962
<class,경의선,강매,1229,1202,2431
<class,경의선,화전,599,622,1221
<class,경의선,수색,755,835,1590
<class,경의선,디지털미디어시티,1153,1100,2253
<class,경의선,가좌,2461,2452,4913
<class,경의선,홍대입구,1320,1527,2847
<class,경의선,서강대,1013,987,2000
<class,경의선,공덕,1511,1244,2755
<class,경의선,효창공원앞,1166,1300,2466
<class,경의선,신촌,253,253,506
<class,경의선,서울역,807,813,1620
<class,경원선,소요산,3723,3225,6948
<class,경원선,동두천,1062,1385,2447
<class,경원선,보산,1413,1191,2604
<class,경원선,동두천중앙,1771,1663,3434
<class,경원선,지행,3750,3629,7379
<class,경원선,덕정,2778,2785,5563
<class,경원선,덕계,1344,1287,2631
<class,경원선,양주,4154,4061,8215
<class,경원선,녹양,2402,2333,4735
<class,경원선,가능,3321,3143,6464
<class,경원선,의정부,12429,12539,24968
<class,경원선,회룡,6366,6306,12672
<class,경원선,망월사,3704,3816,7520
<class,경원선,도봉산,8735,6478,15213
<class,경원선,도봉,3158,2998,6156
<class,경원선,방학,5220,4957,10177
<class,경원선,녹천,2318,2019,4337
<class,경원선,월계,3308,3173,6481
<class,경원선,광운대,3805,3838,7643
<class,경원선,석계,4388,4705,9093
<class,경원선,신이문,4327,3988,8315
<class,경원선,외대앞,4022,3876,7898
<class,경원선,청량리,11069,10621,21690
<class,경원선,왕십리,7816,8636,16452
<class,경원선,응봉,963,949,1912
<class,경원선,옥수,37,15,52
<class,경원선,한남,1762,1728,3490
<class,경원선,서빙고,1070,1080,2150
<class,경원선,이촌,2164,1568,3732
<class,경부선,광명,1876,1338,3214
<class,경부선,서동탄,694,760,1454
<class,경부선,당정,2635,2727,5362
<class,경부선,천안,4351,4161,8512
<class,경부선,두정,3457,3587,7044
<class,경부선,직산,417,520,937
<class,경부선,성환,1924,2181,4105
<class,경부선,평택,9103,9479,18582
<class,경부선,지제,1724,1651,3375
<class,경부선,서정리,3414,4694,8108
<class,경부선,송탄,2921,3279,6200
<class,경부선,진위,612,672,1284
<class,경부선,오산,6198,6747,12945
<class,경부선,오산대,1740,1640,3380
<class,경부선,세마,1445,1331,2776
<class,경부선,병점,7842,8414,16256
<class,경부선,세류,1702,1733,3435
<class,경부선,독산,5205,5252,10457
<class,경부선,수원,28536,28078,56614
<class,경부선,화서,3202,3182,6384
<class,경부선,성균관대,6886,7315,14201
<class,경부선,의왕,3861,3946,7807
<class,경부선,군포,2789,2699,5488
<class,경부선,금정,11793,12206,23999
<class,경부선,명학,3006,3035,6041
<class,경부선,안양,12010,11522,23532
<class,경부선,관악,4352,3914,8266
<class,경부선,석수,4726,4659,9385
<class,경부선,금천구청,5464,5449,10913
<class,경부선,가산디지털단지,3911,5405,9316
<class,경부선,구로,8182,8350,16532
<class,경부선,신길,4474,3797,8271
<class,경부선,신도림,1872,1990,3862
<class,경부선,영등포,27179,26281,53460
<class,경부선,대방,5175,5364,10539
<class,경부선,노량진,5166,4948,10114
<class,경부선,용산,22487,20674,43161
<class,경부선,남영,3582,3825,7407
<class,경부선,서울역,4462,1055,5517
<class,경강선,여주,1471,1368,2839
<class,경강선,세종대왕릉,185,188,373
<class,경강선,부발,1088,1703,2791
<class,경강선,이천,1670,1934,3604
<class,경강선,신둔도예촌,690,635,1325
<class,경강선,곤지암,1100,1231,2331
<class,경강선,초월,1390,1275,2665
<class,경강선,경기광주,3173,3230,6403
<class,경강선,삼동,865,811,1676
<class,경강선,이매,535,434,969
<class,경강선,판교,2071,1900,3971
<class,9호선2~3단계,중앙보훈병원,2608,2543,5151
<class,9호선2~3단계,둔촌오륜,385,392,777
<class,9호선2~3단계,올림픽공원,2562,2634,5196
<class,9호선2~3단계,한성백제,1300,1083,2383
<class,9호선2~3단계,송파나루,2465,2690,5155
<class,9호선2~3단계,석촌,3878,3297,7175
<class,9호선2~3단계,석촌고분,2642,2535,5177
<class,9호선2~3단계,삼전,2980,2997,5977
<class,9호선2~3단계,종합운동장,1725,1600,3325
<class,9호선2~3단계,봉은사,6017,5929,11946
<class,9호선2~3단계,삼성중앙,1579,1622,3201
<class,9호선2~3단계,선정릉,2773,3020,5793
<class,9호선2~3단계,언주,3311,3287,6598
<class,9호선,신논현,14063,13489,27552
<class,9호선,사평,1116,1181,2297
<class,9호선,고속터미널,7909,10358,18267
<class,9호선,신반포,1415,1442,2857
<class,9호선,구반포,1161,1217,2378
<class,9호선,동작,986,814,1800
<class,9호선,흑석,3320,3581,6901
<class,9호선,노들,2122,1859,3981
<class,9호선,노량진,11946,12671,24617
<class,9호선,샛강,1547,1563,3110
<class,9호선,여의도,5316,4990,10306
<class,9호선,국회의사당,3849,3520,7369
<class,9호선,당산,7339,7011,14350
<class,9호선,선유도,2451,2376,4827
<class,9호선,신목동,1430,1292,2722
<class,9호선,염창,7275,7146,14421
<class,9호선,등촌,4465,4534,8999
<class,9호선,증미,2630,2661,5291
<class,9호선,가양,8846,8814,17660
<class,9호선,양천향교,3612,3740,7352
<class,9호선,마곡나루,5110,5129,10239
<class,9호선,신방화,3023,3005,6028
<class,9호선,공항시장,1521,1676,3197
<class,9호선,김포공항,6498,9829,16327
<class,9호선,개화,910,821,1731
<class,8호선,모란,2262,1911,4173
<class,8호선,수진,2583,2315,4898
<class,8호선,신흥,2402,2581,4983
<class,8호선,단대오거리,4808,4817,9625
<class,8호선,남한산성입구,6123,5738,11861
<class,8호선,산성,3451,3488,6939
<class,8호선,복정,4309,4098,8407
<class,8호선,장지,8126,8371,16497
<class,8호선,문정,4837,5218,10055
<class,8호선,가락시장,2939,3878,6817
<class,8호선,송파,3236,3310,6546
<class,8호선,석촌,3654,4547,8201
<class,8호선,잠실,8586,9298,17884
<class,8호선,몽촌토성,2807,2781,5588
<class,8호선,강동구청,3867,4015,7882
<class,8호선,천호,8227,9303,17530
<class,8호선,암사,7814,7425,15239
<class,7호선,부평구청,4374,3856,8230
<class,7호선,굴포천,3942,3980,7922
<class,7호선,삼산체육관,2173,2050,4223
<class,7호선,상동,5960,5847,11807
<class,7호선,부천시청,5781,5648,11429
<class,7호선,신중동,5981,5780,11761
<class,7호선,춘의,2980,2840,5820
<class,7호선,부천종합운동장,2010,1860,3870
<class,7호선,까치울,3465,3444,6909
<class,7호선,온수,3350,3445,6795
<class,7호선,천왕,4444,4230,8674
<class,7호선,광명사거리,10747,10583,21330
<class,7호선,철산,8982,9206,18188
<class,7호선,가산디지털단지,9412,8770,18182
<class,7호선,남구로,5949,5799,11748
<class,7호선,대림,5517,5072,10589
<class,7호선,신풍,5303,4983,10286
<class,7호선,보라매,3819,3757,7576
<class,7호선,신대방삼거리,6999,6872,13871
<class,7호선,장승배기,4519,4469,8988
<class,7호선,상도,4548,4552,9100
<class,7호선,숭실대입구,4850,5109,9959
<class,7호선,남성,4773,4732,9505
<class,7호선,이수,7116,6951,14067
<class,7호선,내방,4693,4772,9465
<class,7호선,고속터미널,8993,6631,15624
<class,7호선,반포,2522,2535,5057
<class,7호선,논현,6022,6344,12366
<class,7호선,학동,5304,5662,10966
<class,7호선,강남구청,5162,5667,10829
<class,7호선,청담,6197,6613,12810
<class,7호선,뚝섬유원지,7826,7479,15305
<class,7호선,건대입구,6965,7073,14038
<class,7호선,어린이대공원,6042,5779,11821
<class,7호선,군자,6669,5219,11888
<class,7호선,중곡,4698,4431,9129
<class,7호선,용마산,2870,3360,6230
<class,7호선,사가정,8304,8078,16382
<class,7호선,면목,7449,7303,14752
<class,7호선,상봉,8628,8007,16635
<class,7호선,중화,5197,5082,10279
<class,7호선,먹골,4827,4723,9550
<class,7호선,태릉입구,4183,3763,7946
<class,7호선,공릉,5783,5813,11596
<class,7호선,하계,7923,7624,15547
<class,7호선,중계,5884,5490,11374
<class,7호선,노원,9356,9590,18946
<class,7호선,마들,5109,4849,9958
<class,7호선,수락산,7676,7490,15166
<class,7호선,도봉산,4859,7295,12154
<class,7호선,장암,1326,899,2225
<class,6호선,봉화산,3482,3403,6885
<class,6호선,화랑대,4295,3632,7927
<class,6호선,태릉입구,2710,2833,5543
<class,6호선,석계,5686,5781,11467
<class,6호선,돌곶이,3982,3666,7648
<class,6호선,상월곡,2756,2484,5240
<class,6호선,월곡,4821,4824,9645
<class,6호선,고려대,3972,4054,8026
<class,6호선,안암,4601,4570,9171
<class,6호선,보문,3504,3243,6747
<class,6호선,창신,1425,1294,2719
<class,6호선,동묘앞,5781,5403,11184
<class,6호선,신당,3314,4051,7365
<class,6호선,청구,1527,1502,3029
<class,6호선,약수,1429,1454,2883
<class,6호선,버티고개,971,1077,2048
<class,6호선,한강진,5447,6208,11655
<class,6호선,이태원,7879,7637,15516
<class,6호선,녹사평,3682,3527,7209
<class,6호선,삼각지,2846,2244,5090
<class,6호선,효창공원앞,2947,2639,5586
<class,6호선,공덕,6061,5621,11682
<class,6호선,대흥,3078,3216,6294
<class,6호선,광흥창,3687,3576,7263
<class,6호선,상수,4708,5180,9888
<class,6호선,합정,8157,7380,15537
<class,6호선,망원,8665,9295,17960
<class,6호선,마포구청,6414,5750,12164
<class,6호선,월드컵경기장,3586,3485,7071
<class,6호선,디지털미디어시티,4477,4795,9272
<class,6호선,증산,5016,5137,10153
<class,6호선,새절,5850,5662,11512
<class,6호선,구산,3421,2460,5881
<class,6호선,독바위,1475,1926,3401
<class,6호선,불광,2810,2397,5207
<class,6호선,역촌,1628,1935,3563
<class,6호선,응암,8262,8407,16669
<class,5호선,하남풍산,2441,2577,5018
<class,5호선,미사,6458,6231,12689
<class,5호선,마천,2952,3306,6258
<class,5호선,거여,3190,3131,6321
<class,5호선,개롱,2702,2900,5602
<class,5호선,오금,1452,1346,2798
<class,5호선,방이,3102,3117,6219
<class,5호선,올림픽공원,1892,1696,3588
<class,5호선,둔촌동,3998,3955,7953
<class,5호선,상일동,6523,6202,12725
<class,5호선,고덕,3624,3606,7230
<class,5호선,명일,3838,3837,7675
<class,5호선,굽은다리,4588,4320,8908
<class,5호선,길동,3576,3631,7207
<class,5호선,강동,8257,8046,16303
<class,5호선,천호,10999,10387,21386
<class,5호선,광나루,6574,6642,13216
<class,5호선,아차산,9197,9463,18660
<class,5호선,군자,5308,5807,11115
<class,5호선,장한평,6188,6152,12340
<class,5호선,답십리,6353,6021,12374
<class,5호선,마장,2476,2384,4860
<class,5호선,왕십리,2164,2501,4665
<class,5호선,행당,3595,3200,6795
<class,5호선,신금호,2668,2851,5519
<class,5호선,청구,1616,1451,3067
<class,5호선,동대문역사문화공원,593,666,1259
<class,5호선,을지로4가,1337,1433,2770
<class,5호선,종로3가,7358,6816,14174
<class,5호선,광화문,9834,9502,19336
<class,5호선,서대문,3977,4008,7985
<class,5호선,충정로,1283,1291,2574
<class,5호선,애오개,2330,2422,4752
<class,5호선,공덕,3914,4031,7945
<class,5호선,마포,4122,4107,8229
<class,5호선,여의나루,8953,9083,18036
<class,5호선,여의도,5559,5893,11452
<class,5호선,신길,1678,1878,3556
<class,5호선,영등포시장,4064,4281,8345
<class,5호선,영등포구청,1194,1208,2402
<class,5호선,양평,2306,2286,4592
<class,5호선,오목교,10475,11059,21534
<class,5호선,목동,6708,6955,13663
<class,5호선,신정,5654,4999,10653
<class,5호선,까치산,13887,13588,27475
<class,5호선,화곡,12366,11861,24227
<class,5호선,우장산,5694,5798,11492
<class,5호선,발산,7529,7830,15359
<class,5호선,마곡,2791,2968,5759
<class,5호선,송정,3253,3243,6496
<class,5호선,김포공항,6083,5777,11860
<class,5호선,개화산,2360,2407,4767
<class,5호선,방화,3302,3163,6465
<class,4호선,쌍문,14008,12639,26647
<class,4호선,창동,13187,13747,26934
<class,4호선,상계,9042,8517,17559
<class,4호선,당고개,7093,6759,13852
<class,4호선,남태령,434,391,825
<class,4호선,사당,12075,11402,23477
<class,4호선,총신대입구,8874,9608,18482
<class,4호선,동작,1730,1734,3464
<class,4호선,이촌,3927,4570,8497
<class,4호선,신용산,5966,6176,12142
<class,4호선,삼각지,1564,2103,3667
<class,4호선,숙대입구,5802,5768,11570
<class,4호선,서울역,3334,6756,10090
<class,4호선,회현,7205,7386,14591
<class,4호선,명동,8715,8847,17562
<class,4호선,충무로,6578,6434,13012
<class,4호선,동대문역사문화공원,7127,7042,14169
<class,4호선,동대문,5796,6543,12339
<class,4호선,혜화,17821,18217,36038
<class,4호선,한성대입구,6477,6434,12911
<class,4호선,성신여대입구,10853,10505,21358
<class,4호선,길음,8632,8256,16888
<class,4호선,미아사거리,14260,13558,27818
<class,4호선,미아,7125,6796,13921
<class,4호선,수유,17563,16639,34202
<class,3호선,오금,2353,2314,4667
<class,3호선,경찰병원,2468,2445,4913
<class,3호선,가락시장,3452,3625,7077
<class,3호선,수서,8497,8426,16923
<class,3호선,일원,2927,3086,6013
<class,3호선,대청,3584,3466,7050
<class,3호선,학여울,873,872,1745
<class,3호선,대치,5072,4541,9613
<class,3호선,도곡,1750,1804,3554
<class,3호선,매봉,3661,3699,7360
<class,3호선,양재,11138,12863,24001
<class,3호선,남부터미널,11974,12683,24657
<class,3호선,교대,3541,2066,5607
<class,3호선,고속터미널,32519,30583,63102
<class,3호선,잠원,2188,2279,4467
<class,3호선,신사,13724,13892,27616
<class,3호선,압구정,12346,12679,25025
<class,3호선,옥수,4554,4817,9371
<class,1호선,청량리,11586,11396,22982
<class,2호선,시청,4742,4027,8769
<class,2호선,을지로입구,13295,12531,25826
<class,2호선,을지로3가,6094,5643,11737
<class,2호선,을지로4가,2770,2507,5277
<class,2호선,동대문역사문화공원,6174,7636,13810
<class,2호선,상왕십리,5903,5808,11711
<class,2호선,왕십리,8131,7224,15355
<class,2호선,한양대,2139,2291,4430
<class,2호선,뚝섬,8809,9246,18055
<class,2호선,성수,11246,12541,23787
<class,2호선,건대입구,22327,22552,44879
<class,2호선,구의,9938,10023,19961
<class,2호선,강변,17218,16982,34200
<class,2호선,잠실나루,4295,4380,8675
<class,2호선,잠실,39272,37175,76447
<class,2호선,잠실새내,9343,9865,19208
<class,2호선,종합운동장,2819,3068,5887
<class,2호선,삼성,17151,16872,34023
<class,2호선,선릉,11384,10100,21484
<class,2호선,역삼,10062,11204,21266
<class,2호선,강남,32075,31031,63106
<class,2호선,교대,8960,10022,18982
<class,2호선,서초,8441,7896,16337
<class,2호선,방배,5794,6186,11980
<class,2호선,사당,17838,20139,37977
<class,2호선,낙성대,13993,13987,27980
<class,2호선,서울대입구,24631,25040,49671
<class,2호선,봉천,10728,10235,20963
<class,2호선,신림,33364,32322,65686
<class,2호선,신대방,13266,13093,26359
<class,2호선,구로디지털단지,21140,20793,41933
<class,2호선,대림,12900,12900,25800
<class,2호선,신도림,25245,25455,50700
<class,2호선,문래,7082,7384,14466
<class,2호선,영등포구청,7045,7183,14228
<class,2호선,당산,7947,8348,16295
<class,2호선,합정,17319,18078,35397
<class,2호선,홍대입구,41508,42091,83599
<class,2호선,신촌,19261,18891,38152
<class,2호선,이대,5850,6042,11892
<class,2호선,아현,4394,4405,8799
<class,2호선,충정로,3400,3542,6942
<class,2호선,용답,1388,1348,2736
<class,2호선,신답,661,708,1369
<class,2호선,신설동,2624,2616,5240
<class,2호선,도림천,447,492,939
<class,2호선,양천구청,2841,2972,5813
<class,2호선,신정네거리,4568,4563,9131
<class,2호선,용두,1042,1070,2112
<class,3호선,지축,1619,1476,3095
<class,3호선,구파발,9644,9842,19486
<class,3호선,연신내,19666,18636,38302
<class,3호선,불광,8293,10053,18346
<class,3호선,녹번,5908,5426,11334
<class,3호선,홍제,7811,7578,15389
<class,3호선,무악재,1586,1788,3374
<class,3호선,독립문,3668,4259,7927
<class,3호선,경복궁,9317,9911,19228
<class,3호선,안국,8096,9171,17267
<class,3호선,종로3가,3249,4676,7925
<class,3호선,을지로3가,2403,2344,4747
<class,3호선,동대입구,3946,4651,8597
<class,1호선,서울역,19650,17865,37515
<class,1호선,동묘앞,11818,12254,24072
<class,1호선,시청,5985,5805,11790
<class,1호선,종각,10628,9207,19835
<class,1호선,종로3가,12583,11196,23779
<class,1호선,종로5가,7657,7748,15405
<class,1호선,동대문,8109,8457,16566
<class,1호선,신설동,6707,6681,13388
<class,1호선,제기동,8641,9066,17707
<class,2호선,신당,7392,7847,15239
<class,3호선,약수,5807,5613,11420
<class,3호선,금호,3847,3663,7510
<class,7호선,신풍,7547,7312,14859
<class,1호선,서울역,26442,28588,55030
<class,1호선,동묘앞,11380,11950,23330
<class,1호선,시청,8899,9000,17899
<class,1호선,종각,16747,15236,31983
<class,1호선,종로3가,20695,19485,40180
<class,1호선,종로5가,16608,16859,33467
<class,1호선,동대문,10170,9424,19594
<class,1호선,신설동,9053,8671,17724
<class,1호선,제기동,14004,14303,28307
<class,1호선,청량리,17096,17057,34153
<class,2호선,시청,7683,6570,14253
<class,2호선,을지로입구,19125,18834,37959
<class,2호선,을지로3가,9235,9162,18397
<class,2호선,을지로4가,6646,6760,13406
<class,2호선,동대문역사문화공원,9395,9940,19335
<class,2호선,신당,10203,10626,20829
<class,2호선,상왕십리,9030,8435,17465
<class,2호선,왕십리,12271,10487,22758
<class,2호선,한양대,3486,3490,6976
<class,2호선,뚝섬,12712,13287,25999
<class,2호선,성수,16529,18498,35027
<class,2호선,건대입구,30672,32163,62835
<class,2호선,구의,15049,14453,29502
<class,2호선,강변,24315,26386,50701
<class,2호선,잠실나루,6671,6460,13131
<class,2호선,잠실,56574,53383,109957
<class,2호선,잠실새내,15103,15807,30910
<class,2호선,종합운동장,4335,4607,8942
<class,2호선,삼성,26483,27124,53607
<class,2호선,선릉,21905,19682,41587
<class,2호선,역삼,17334,18967,36301
<class,2호선,강남,57464,57150,114614
<class,2호선,교대,16107,17744,33851
<class,2호선,서초,9989,8664,18653
<class,2호선,방배,9221,9429,18650
<class,2호선,사당,26767,29730,56497
<class,2호선,낙성대,19810,18126,37936
<class,2호선,서울대입구,35583,34114,69697
<class,2호선,봉천,15908,14680,30588
<class,2호선,신림,47205,44450,91655
<class,2호선,신대방,18497,17845,36342
<class,2호선,구로디지털단지,32169,31547,63716
<class,2호선,대림,16660,17872,34532
<class,2호선,신도림,38297,38679,76976
<class,2호선,문래,11285,11596,22881
<class,2호선,영등포구청,11645,11883,23528
<class,2호선,당산,12042,12916,24958
<class,2호선,합정,25124,27068,52192
<class,2호선,홍대입구,56129,60023,116152
<class,2호선,신촌,26571,26397,52968
<class,2호선,이대,8990,9133,18123
<class,2호선,아현,6833,6747,13580
<class,2호선,충정로,5304,5593,10897
<class,2호선,용답,1887,1853,3740
<class,2호선,신답,967,1025,1992
<class,2호선,신설동,3194,3096,6290
<class,2호선,도림천,783,797,1580
<class,2호선,양천구청,4200,4354,8554
<class,2호선,신정네거리,6602,6617,13219
<class,2호선,용두,1579,1516,3095
<class,3호선,지축,2363,2261,4624
<class,3호선,구파발,14033,13816,27849
<class,3호선,연신내,28642,26953,55595
<class,3호선,불광,12369,13988,26357
<class,3호선,녹번,9145,7997,17142
<class,3호선,홍제,12152,11330,23482
<class,3호선,무악재,2445,2493,4938
<class,3호선,독립문,5342,5872,11214
<class,3호선,경복궁,13348,14486,27834
<class,3호선,안국,12124,14050,26174
<class,3호선,종로3가,4972,7357,12329
<class,3호선,을지로3가,4543,5077,9620
<class,3호선,동대입구,5170,5946,11116
<class,3호선,약수,8624,8126,16750
<class,3호선,금호,5808,5251,11059
<class,3호선,옥수,6848,6922,13770
<class,3호선,압구정,24487,25075,49562
<class,3호선,신사,25333,25843,51176
<class,3호선,잠원,3594,3564,7158
<class,3호선,고속터미널,44514,47278,91792
<class,3호선,교대,6068,3661,9729
<class,3호선,남부터미널,19978,20825,40803
<class,3호선,양재,18127,19512,37639
<class,3호선,매봉,5512,5342,10854
<class,3호선,도곡,3162,3183,6345
<class,3호선,대치,8910,7871,16781
<class,3호선,학여울,1987,2039,4026
<class,3호선,대청,5293,4788,10081
<class,3호선,일원,4327,4202,8529
<class,3호선,수서,11364,12004,23368
<class,3호선,가락시장,5898,5629,11527
<class,3호선,경찰병원,3775,3704,7479
<class,3호선,오금,3714,3493,7207
<class,4호선,수유,24717,24343,49060
<class,4호선,미아,10268,9647,19915
<class,4호선,미아사거리,20725,19933,40658
<class,4호선,길음,13167,12300,25467
<class,4호선,성신여대입구,15588,14706,30294
<class,4호선,한성대입구,9727,9328,19055
<class,4호선,혜화,23939,24648,48587
<class,4호선,동대문,13590,13952,27542
<class,4호선,동대문역사문화공원,10555,9163,19718
<class,4호선,충무로,11616,12090,23706
<class,4호선,명동,12136,13652,25788
<class,4호선,회현,16300,17728,34028
<class,4호선,서울역,4746,11221,15967
<class,4호선,숙대입구,8049,7808,15857
<class,4호선,삼각지,2516,3267,5783
<class,4호선,신용산,8564,9269,17833
<class,4호선,이촌,5388,6069,11457
<class,4호선,동작,2267,2272,4539
<class,4호선,총신대입구,13522,14597,28119
<class,4호선,사당,18199,15623,33822
<class,4호선,남태령,913,651,1564
<class,4호선,당고개,9073,8558,17631
<class,4호선,상계,13038,12357,25395
<class,4호선,노원,15499,16651,32150
<class,4호선,창동,18566,19559,38125
<class,4호선,쌍문,20433,18513,38946
<class,5호선,방화,4451,4208,8659
<class,5호선,개화산,3469,3453,6922
<class,5호선,김포공항,6841,6966,13807
<class,5호선,송정,4870,4723,9593
<class,5호선,마곡,4466,4392,8858
<class,5호선,발산,12167,12840,25007
<class,5호선,우장산,8963,8915,17878
<class,5호선,화곡,19150,17636,36786
<class,5호선,까치산,20172,19380,39552
<class,5호선,신정,8481,7286,15767
<class,5호선,목동,10922,10887,21809
<class,5호선,오목교,15935,16735,32670
<class,5호선,양평,3482,3322,6804
<class,5호선,영등포구청,1916,1973,3889
<class,5호선,영등포시장,6959,7417,14376
<class,5호선,신길,2464,2623,5087
<class,5호선,여의도,15387,14654,30041
<class,5호선,여의나루,16216,19325,35541
<class,5호선,마포,6895,7115,14010
<class,5호선,공덕,6865,7310,14175
<class,5호선,애오개,3544,3363,6907
<class,5호선,충정로,1892,1691,3583
<class,5호선,서대문,6518,6265,12783
<class,5호선,광화문,13922,13808,27730
<class,5호선,종로3가,10933,11254,22187
<class,5호선,을지로4가,3243,3584,6827
<class,5호선,동대문역사문화공원,951,1235,2186
<class,5호선,청구,2369,2163,4532
<class,5호선,신금호,3860,3929,7789
<class,5호선,행당,5365,4604,9969
<class,5호선,왕십리,3331,3874,7205
<class,5호선,마장,3625,3424,7049
<class,5호선,답십리,9737,8966,18703
<class,5호선,장한평,10269,9932,20201
<class,5호선,군자,7960,8594,16554
<class,5호선,아차산,11990,11805,23795
<class,5호선,광나루,9561,9155,18716
<class,5호선,천호,15773,15273,31046
<class,5호선,강동,12541,11611,24152
<class,5호선,길동,5548,5620,11168
<class,5호선,굽은다리,6392,5943,12335
<class,5호선,명일,5712,5709,11421
<class,5호선,고덕,5520,5438,10958
<class,5호선,상일동,9946,9225,19171
<class,5호선,둔촌동,5828,5835,11663
<class,5호선,올림픽공원,2630,2375,5005
<class,5호선,방이,4744,4577,9321
<class,5호선,오금,2445,2154,4599
<class,5호선,개롱,4225,4333,8558
<class,5호선,거여,5043,4780,9823
<class,5호선,마천,4262,4330,8592
<class,5호선,미사,9401,9171,18572
<class,5호선,하남풍산,3322,3487,6809
<class,6호선,응암,11908,11771,23679
<class,6호선,역촌,2405,2749,5154
<class,6호선,불광,3735,3654,7389
<class,6호선,독바위,1947,2301,4248
<class,6호선,연신내,1,0,1
<class,6호선,구산,4937,3808,8745
<class,6호선,새절,8445,8067,16512
<class,6호선,증산,7153,7065,14218
<class,6호선,디지털미디어시티,6794,7009,13803
<class,6호선,월드컵경기장,4655,4600,9255
<class,6호선,마포구청,9088,7821,16909
<class,6호선,망원,12427,13781,26208
<class,6호선,합정,11741,10523,22264
<class,6호선,상수,6966,8276,15242
<class,6호선,광흥창,4798,4466,9264
<class,6호선,대흥,4745,4673,9418
<class,6호선,공덕,9615,9330,18945
<class,6호선,효창공원앞,4373,3929,8302
<class,6호선,삼각지,4158,3153,7311
<class,6호선,녹사평,4695,5021,9716
<class,6호선,이태원,10489,10618,21107
<class,6호선,한강진,7247,8842,16089
<class,6호선,버티고개,1457,1505,2962
<class,6호선,약수,2273,2228,4501
<class,6호선,청구,2442,2307,4749
<class,6호선,신당,5558,4549,10107
<class,6호선,동묘앞,7689,7152,14841
<class,6호선,창신,2066,1784,3850
<class,6호선,보문,4843,4344,9187
<class,6호선,안암,6253,6145,12398
<class,6호선,고려대,5313,4913,10226
<class,6호선,월곡,7096,6952,14048
<class,6호선,상월곡,3811,3249,7060
<class,6호선,돌곶이,5594,5159,10753
<class,6호선,석계,8518,8298,16816
<class,6호선,태릉입구,3922,4181,8103
<class,6호선,화랑대,6276,5375,11651
<class,6호선,봉화산,4918,4715,9633
<class,7호선,장암,1573,1041,2614
<class,7호선,도봉산,6260,9025,15285
<class,7호선,수락산,10067,9843,19910
<class,7호선,마들,8202,7746,15948
<class,7호선,노원,14778,15353,30131
<class,7호선,중계,8675,7651,16326
<class,7호선,하계,11663,10835,22498
<class,7호선,공릉,8135,8165,16300
<class,7호선,태릉입구,6007,5425,11432
<class,7호선,먹골,7390,7347,14737
<class,7호선,중화,7412,7045,14457
<class,7호선,상봉,12677,11842,24519
<class,7호선,면목,10468,10079,20547
<class,7호선,사가정,11935,11562,23497
<class,7호선,용마산,4271,4354,8625
<class,7호선,중곡,6533,6025,12558
<class,7호선,군자,10131,7547,17678
<class,7호선,어린이대공원,8310,7996,16306
<class,7호선,건대입구,10007,10032,20039
<class,7호선,뚝섬유원지,9167,8799,17966
<class,7호선,청담,11025,11945,22970
<class,7호선,강남구청,9340,10422,19762
<class,7호선,학동,10537,11341,21878
<class,7호선,논현,11049,11736,22785
<class,7호선,반포,4260,3958,8218
<class,7호선,고속터미널,12903,10234,23137
<class,7호선,내방,7384,7300,14684
<class,7호선,이수,11401,10499,21900
<class,7호선,남성,7407,6776,14183
<class,7호선,숭실대입구,7457,7504,14961
<class,7호선,상도,6777,6381,13158
<class,7호선,장승배기,6793,6480,13273
<class,7호선,신대방삼거리,10892,9910,20802
<class,7호선,보라매,6228,5910,12138
<class,7호선,대림,6288,6608,12896
<class,7호선,남구로,7986,8465,16451
<class,7호선,가산디지털단지,14389,13127,27516
<class,7호선,철산,14053,14235,28288
<class,7호선,광명사거리,15629,15535,31164
<class,7호선,천왕,6257,5947,12204
<class,7호선,온수,5545,5335,10880
<class,7호선,까치울,4877,4859,9736
<class,7호선,부천종합운동장,2894,2639,5533
<class,7호선,춘의,4755,4599,9354
<class,7호선,신중동,9070,8760,17830
<class,7호선,부천시청,8736,8692,17428
<class,7호선,상동,9177,9326,18503
<class,7호선,삼산체육관,3158,3001,6159
<class,7호선,굴포천,5967,6167,12134
<class,7호선,부평구청,6727,5876,12603
<class,8호선,암사,12001,11048,23049
<class,8호선,천호,11788,13560,25348
<class,8호선,강동구청,5848,5766,11614
<class,8호선,몽촌토성,3938,3960,7898
<class,8호선,잠실,11415,12852,24267
<class,8호선,석촌,5561,6643,12204
<class,8호선,송파,4970,5016,9986
<class,8호선,가락시장,5364,5337,10701
<class,8호선,문정,8106,8274,16380
<class,8호선,장지,11617,11011,22628
<class,8호선,복정,6603,5612,12215
<class,8호선,산성,4884,4945,9829
<class,8호선,남한산성입구,8742,7881,16623
<class,8호선,단대오거리,7047,6495,13542
<class,8호선,신흥,3524,3682,7206
<class,8호선,수진,3821,3448,7269
<class,8호선,모란,3233,2775,6008
<class,9호선,개화,1393,1112,2505
<class,9호선,김포공항,7287,12305,19592
<class,9호선,공항시장,2067,2241,4308
<class,9호선,신방화,4438,4203,8641
<class,9호선,마곡나루,7320,7157,14477
<class,9호선,양천향교,5515,5195,10710
<class,9호선,가양,13481,12798,26279
<class,9호선,증미,4075,3973,8048
<class,9호선,등촌,6829,6561,13390
<class,9호선,염창,10974,10138,21112
<class,9호선,신목동,2047,1854,3901
<class,9호선,선유도,3653,3650,7303
<class,9호선,당산,12328,11117,23445
<class,9호선,국회의사당,3937,3970,7907
<class,9호선,여의도,16512,15801,32313
<class,9호선,샛강,2498,2297,4795
<class,9호선,노량진,18904,18983,37887
<class,9호선,노들,3053,2604,5657
<class,9호선,흑석,5295,5277,10572
<class,9호선,동작,1445,1195,2640
<class,9호선,구반포,2015,2191,4206
<class,9호선,신반포,2295,2268,4563
<class,9호선,고속터미널,11120,16478,27598
<class,9호선,사평,1962,1883,3845
<class,9호선,신논현,25437,25242,50679
<class,9호선2~3단계,언주,5476,5365,10841
<class,9호선2~3단계,선정릉,4944,5498,10442
<class,9호선2~3단계,삼성중앙,2841,2872,5713
<class,9호선2~3단계,봉은사,9695,10084,19779
<class,9호선2~3단계,종합운동장,2727,2521,5248
<class,9호선2~3단계,삼전,4700,4251,8951
<class,9호선2~3단계,석촌고분,3937,3719,7656
<class,9호선2~3단계,석촌,5893,4900,10793
<class,9호선2~3단계,송파나루,3552,3813,7365
<class,9호선2~3단계,한성백제,1777,1444,3221
<class,9호선2~3단계,올림픽공원,3845,3856,7701
<class,9호선2~3단계,둔촌오륜,627,569,1196
<class,9호선2~3단계,중앙보훈병원,4012,3675,7687
<class,경강선,판교,2647,2544,5191
<class,경강선,이매,782,556,1338
<class,경강선,삼동,1392,1266,2658
<class,경강선,경기광주,4750,4494,9244
<class,경강선,초월,2147,1941,4088
<class,경강선,곤지암,1673,1723,3396
<class,경강선,신둔도예촌,939,915,1854
<class,경강선,이천,2405,2562,4967
<class,경강선,부발,1683,1380,3063
<class,경강선,세종대왕릉,267,306,573
<class,경강선,여주,1790,2110,3900
<class,경부선,서울역,5215,1627,6842
<class,경부선,남영,5450,5583,11033
<class,경부선,용산,27766,31588,59354
<class,경부선,노량진,7989,7282,15271
<class,경부선,대방,7656,7506,15162
<class,경부선,영등포,36100,37963,74063
<class,경부선,신도림,2729,2831,5560
<class,경부선,신길,6098,4896,10994
<class,경부선,구로,12703,13201,25904
<class,경부선,가산디지털단지,5770,7658,13428
<class,경부선,금천구청,7868,7836,15704
<class,경부선,석수,6735,6513,13248
<class,경부선,관악,5692,5341,11033
<class,경부선,안양,16828,16766,33594
<class,경부선,명학,4900,4683,9583
<class,경부선,금정,17169,16976,34145
<class,경부선,군포,4016,3741,7757
<class,경부선,의왕,5680,5497,11177
<class,경부선,성균관대,9600,9620,19220
<class,경부선,화서,4805,4887,9692
<class,경부선,수원,34763,37869,72632
<class,경부선,독산,8015,8179,16194
<class,경부선,세류,2358,2310,4668
<class,경부선,병점,10997,10758,21755
<class,경부선,세마,1914,1731,3645
<class,경부선,오산대,2446,2352,4798
<class,경부선,오산,8804,8107,16911
<class,경부선,진위,994,871,1865
<class,경부선,송탄,4303,3803,8106
<class,경부선,서정리,5841,4776,10617
<class,경부선,지제,2555,2408,4963
<class,경부선,평택,11907,11389,23296
<class,경부선,성환,2587,2387,4974
<class,경부선,직산,601,559,1160
<class,경부선,두정,4335,4556,8891
<class,경부선,천안,5141,5493,10634
<class,경부선,당정,3786,3520,7306
<class,경부선,서동탄,969,977,1946
<class,경부선,광명,2166,2286,4452
<class,경원선,이촌,3052,2162,5214
<class,경원선,서빙고,1258,1114,2372
<class,경원선,한남,2666,2587,5253
<class,경원선,옥수,46,27,73
<class,경원선,응봉,1391,1166,2557
<class,경원선,왕십리,11304,12667,23971
<class,경원선,청량리,13986,16037,30023
<class,경원선,외대앞,5513,5243,10756
<class,경원선,신이문,5849,5373,11222
<class,경원선,석계,6307,6673,12980
<class,경원선,광운대,5306,5194,10500
<class,경원선,월계,4404,4135,8539
<class,경원선,녹천,3075,2543,5618
<class,경원선,창동,2,0,2
<class,경원선,방학,6871,6722,13593
<class,경원선,도봉,4155,3914,8069
<class,경원선,도봉산,9503,6359,15862
<class,경원선,망월사,5111,5272,10383
<class,경원선,회룡,8962,8926,17888
<class,경원선,의정부,16498,17311,33809
<class,경원선,가능,4752,4466,9218
<class,경원선,녹양,3309,3189,6498
<class,경원선,양주,5747,5548,11295
<class,경원선,덕계,2007,1849,3856
<class,경원선,덕정,3972,3758,7730
<class,경원선,지행,5007,4873,9880
<class,경원선,동두천중앙,2316,2282,4598
<class,경원선,보산,1727,1684,3411
<class,경원선,동두천,1340,1741,3081
<class,경원선,소요산,3723,3168,6891
<class,경의선,서울역,1215,1326,2541
<class,경의선,신촌,313,324,637
<class,경의선,효창공원앞,1626,1788,3414
<class,경의선,공덕,2319,1814,4133
<class,경의선,서강대,1559,1483,3042
<class,경의선,홍대입구,1711,2031,3742
<class,경의선,가좌,3522,3509,7031
<class,경의선,디지털미디어시티,1766,1545,3311
<class,경의선,수색,1246,1218,2464
<class,경의선,화전,931,917,1848
<class,경의선,강매,1829,1700,3529
<class,경의선,행신,4790,4950,9740
<class,경의선,능곡,2604,2528,5132
<class,경의선,곡산,338,353,691
<class,경의선,백마,4106,3864,7970
<class,경의선,풍산,3930,3821,7751
<class,경의선,일산,5636,5556,11192
<class,경의선,탄현,4792,4774,9566
<class,경의선,야당,4770,4524,9294
<class,경의선,운정,4086,3906,7992
<class,경의선,금릉,3400,3240,6640
<class,경의선,금촌,5044,4781,9825
<class,경의선,월롱,1202,1056,2258
<class,경의선,파주,747,581,1328
<class,경의선,문산,4188,4025,8213
<class,경의선,임진강,68,32,100
<class,경인선,개봉,15487,15017,30504
<class,경인선,오류동,8675,7984,16659
<class,경인선,역곡,18821,18624,37445
<class,경인선,부천,27726,28450,56176
<class,경인선,송내,17094,16949,34043
<class,경인선,부평,28124,30605,58729
<class,경인선,백운,5199,5074,10273
<class,경인선,동암,12006,12185,24191
<class,경인선,주안,14767,13165,27932
<class,경인선,제물포,6961,6700,13661
<class,경인선,동인천,11213,10915,22128
<class,경인선,인천,4412,3884,8296
<class,경인선,구일,4457,4123,8580
<class,경인선,소사,7460,7130,14590
<class,경인선,부개,5953,5517,11470
<class,경인선,간석,4098,3927,8025
<class,경인선,도원,2032,2092,4124
<class,경인선,온수,4535,4249,8784
<class,경인선,중동,6113,5711,11824
<class,경인선,도화,2950,2660,5610
<class,경춘선,신내,1037,1088,2125
<class,경춘선,갈매,1786,1548,3334
<class,경춘선,별내,1951,1935,3886
<class,경춘선,퇴계원,2453,2323,4776
<class,경춘선,사릉,2125,2071,4196
<class,경춘선,금곡,1058,1008,2066
<class,경춘선,평내호평,4305,4242,8547
<class,경춘선,천마산,1294,1303,2597
<class,경춘선,마석,2842,2817,5659
<class,경춘선,대성리,613,506,1119
<class,경춘선,청평,1448,1614,3062
<class,경춘선,상천,333,300,633
<class,경춘선,가평,1665,1817,3482
<class,경춘선,굴봉산,137,171,308
<class,경춘선,백양리,199,194,393
<class,경춘선,강촌,589,577,1166
<class,경춘선,김유정,550,619,1169
<class,경춘선,남춘천,2685,2915,5600
<class,경춘선,춘천,1585,1564,3149
<class,공항철도 1호선,서울역,6222,6895,13117
<class,공항철도 1호선,공덕,1321,2054,3375
<class,공항철도 1호선,홍대입구,10436,10063,20499
<class,공항철도 1호선,디지털미디어시티,5068,4524,9592
<class,공항철도 1호선,마곡나루,2663,2895,5558
<class,공항철도 1호선,김포공항,11102,5131,16233
<class,공항철도 1호선,계양,6115,5521,11636
<class,공항철도 1호선,검암,4513,4487,9000
<class,공항철도 1호선,청라국제도시,3843,3552,7395
<class,공항철도 1호선,운서,5247,5516,10763
<class,공항철도 1호선,공항화물청사,1253,1286,2539
<class,공항철도 1호선,인천공항1터미널,3264,3512,6776
<class,공항철도 1호선,인천공항2터미널,1597,1498,3095
<class,공항철도 1호선,영종,2523,2614,5137
<class,과천선,선바위,4871,4053,8924
<class,과천선,경마공원,996,974,1970
<class,과천선,대공원,4721,5055,9776
<class,과천선,과천,4024,3541,7565
<class,과천선,정부과천청사,5261,5261,10522
<class,과천선,인덕원,14523,13797,28320
<class,과천선,평촌,8590,8502,17092
<class,과천선,범계,18781,18202,36983
<class,분당선,선릉,4788,7230,12018
<class,분당선,한티,10630,10215,20845
<class,분당선,도곡,4213,3774,7987
<class,분당선,구룡,1166,1071,2237
<class,분당선,개포동,2354,2306,4660
<class,분당선,대모산입구,2498,2230,4728
<class,분당선,수서,8882,9948,18830
<class,분당선,복정,1,0,1
<class,분당선,수원,7168,6085,13253
<class,분당선,서울숲,6946,7064,14010
<class,분당선,압구정로데오,17568,19523,37091
<class,분당선,강남구청,5081,6103,11184
<class,분당선,선정릉,3461,3628,7089
<class,분당선,가천대,4392,4926,9318
<class,분당선,태평,9726,9374,19100
<class,분당선,모란,14987,14628,29615
<class,분당선,야탑,16194,16930,33124
<class,분당선,서현,17426,17675,35101
<class,분당선,수내,8342,7554,15896
<class,분당선,정자,10181,10333,20514
<class,분당선,미금,10078,10413,20491
<class,분당선,오리,7228,6038,13266
<class,분당선,이매,4003,3902,7905
<class,분당선,보정,1552,1483,3035
<class,분당선,죽전,9788,10836,20624
<class,분당선,구성,2968,3066,6034
<class,분당선,신갈,2531,2522,5053
<class,분당선,기흥,6114,5903,12017
<class,분당선,상갈,3632,3539,7171
<class,분당선,청명,2494,2369,4863
<class,분당선,영통,6069,6037,12106
<class,분당선,망포,8531,7745,16276
<class,분당선,매탄권선,3107,2939,6046
<class,분당선,수원시청,9946,10628,20574
<class,분당선,매교,1944,1998,3942
<class,수인선,고색,1895,1951,3846
<class,수인선,오목천,1632,1470,3102
<class,수인선,어천,534,491,1025
<class,수인선,야목,183,163,346
<class,수인선,사리,2941,2509,5450
<class,수인선,달월,59,56,115
<class,수인선,월곶,2051,1944,3995
<class,수인선,소래포구,5583,5750,11333
<class,수인선,인천논현,4232,4307,8539
<class,수인선,호구포,2387,2251,4638
<class,수인선,남동인더스파크,993,960,1953
<class,수인선,원인재,3476,3641,7117
<class,수인선,연수,3549,3511,7060
<class,수인선,송도,1927,1959,3886
<class,수인선,인하대,3988,3784,7772
<class,수인선,숭의,2527,2387,4914
<class,수인선,신포,1391,1466,2857
<class,수인선,인천,1307,2288,3595
<class,안산선,산본,11777,12421,24198
<class,안산선,대야미,3792,3214,7006
<class,안산선,반월,3261,3066,6327
<class,안산선,상록수,11669,11750,23419
<class,안산선,한대앞,6394,6395,12789
<class,안산선,중앙,14970,15627,30597
<class,안산선,고잔,5973,5919,11892
<class,안산선,초지,3045,3070,6115
<class,안산선,안산,9428,9569,18997
<class,안산선,신길온천,1304,1237,2541
<class,안산선,정왕,5633,5729,11362
<class,안산선,오이도,7602,7938,15540
<class,안산선,수리산,2630,2542,5172
<class,우이신설선,북한산우이,3094,3150,6244
<class,우이신설선,솔밭공원,1734,1596,3330
<class,우이신설선,4.19민주묘지,2322,2064,4386
<class,우이신설선,가오리,2748,2460,5208
<class,우이신설선,화계,2328,2126,4454
<class,우이신설선,삼양,1412,1492,2904
<class,우이신설선,삼양사거리,1726,1759,3485
<class,우이신설선,솔샘,3523,3215,6738
<class,우이신설선,북한산보국문,4287,3900,8187
<class,우이신설선,정릉,3249,2748,5997
<class,우이신설선,성신여대입구,2549,2964,5513
<class,우이신설선,보문,1001,989,1990
<class,우이신설선,신설동,1354,1276,2630
<class,일산선,원흥,6294,6024,12318
<class,일산선,삼송,13195,12671,25866
<class,일산선,원당,7833,7445,15278
<class,일산선,화정,11958,12344,24302
<class,일산선,대곡,1242,1020,2262
<class,일산선,백석,7151,7267,14418
<class,일산선,마두,4645,4798,9443
<class,일산선,정발산,6040,6278,12318
<class,일산선,주엽,5835,5726,11561
<class,일산선,대화,7841,7051,14892
<class,장항선,봉명,626,610,1236
<class,장항선,쌍용,1301,1143,2444
<class,장항선,아산,2272,2364,4636
<class,장항선,배방,866,784,1650
<class,장항선,온양온천,3262,3274,6536
<class,장항선,신창,835,874,1709
<class,중앙선,회기,18143,17322,35465
<class,중앙선,중랑,3981,3908,7889
<class,중앙선,상봉,4785,4887,9672
<class,중앙선,망우,5847,5711,11558
<class,중앙선,양원,1062,1041,2103
<class,중앙선,구리,9716,10132,19848
<class,중앙선,도농,6463,6045,12508
<class,중앙선,양정,583,522,1105
<class,중앙선,덕소,4345,4406,8751
<class,중앙선,도심,1624,1380,3004
<class,중앙선,팔당,1483,1671,3154
<class,중앙선,운길산,1374,1314,2688
<class,중앙선,양수,1998,2025,4023
<class,중앙선,신원,330,252,582
<class,중앙선,국수,670,702,1372
<class,중앙선,아신,527,630,1157
<class,중앙선,오빈,245,261,506
<class,중앙선,양평,2396,2720,5116
<class,중앙선,원덕,335,327,662
<class,중앙선,용문,1714,2045,3759
<class,중앙선,지평,36,49,85
<class,1호선,서울역,21297,19222,40519
<class,1호선,동묘앞,11963,12664,24627
<class,1호선,시청,6614,6620,13234
<class,1호선,종각,12345,10590,22935
<class,1호선,종로3가,14060,12440,26500
<class,1호선,종로5가,8563,8684,17247
<class,1호선,동대문,9136,9572,18708
<class,1호선,신설동,6804,6711,13515
<class,1호선,제기동,8795,9031,17826
<class,1호선,청량리,12434,12209,24643
<class,2호선,시청,5530,4504,10034
<class,2호선,을지로입구,15160,14364,29524
<class,2호선,을지로3가,7028,6622,13650
<class,2호선,을지로4가,3119,3072,6191
<class,2호선,동대문역사문화공원,7402,8967,16369
<class,2호선,신당,7795,8262,16057
<class,2호선,상왕십리,6451,6317,12768
<class,2호선,왕십리,8746,7798,16544
<class,2호선,한양대,2225,2310,4535
<class,2호선,뚝섬,9429,9696,19125
<class,2호선,성수,11813,13355,25168
<class,2호선,건대입구,24880,25475,50355
<class,2호선,구의,10767,10554,21321
<class,2호선,강변,18926,18855,37781
<class,2호선,잠실나루,4693,4599,9292
<class,2호선,잠실,43141,40772,83913
<class,2호선,잠실새내,10183,10717,20900
<class,2호선,종합운동장,3166,3496,6662
<class,2호선,삼성,19391,19404,38795
<class,2호선,선릉,11609,10305,21914
<class,2호선,역삼,10239,11455,21694
<class,2호선,강남,34214,33161,67375
<class,2호선,교대,9597,10616,20213
<class,2호선,서초,9060,8285,17345
<class,2호선,방배,6173,6535,12708
<class,2호선,사당,19225,21952,41177
<class,2호선,낙성대,15023,14315,29338
<class,2호선,서울대입구,26633,26661,53294
<class,2호선,봉천,11249,10634,21883
<class,2호선,신림,35241,34373,69614
<class,2호선,신대방,13826,13454,27280
<class,2호선,구로디지털단지,22678,21777,44455
<class,2호선,대림,13492,13835,27327
<class,2호선,신도림,26936,27063,53999
<class,2호선,문래,7168,7432,14600
<class,2호선,영등포구청,7326,7359,14685
<class,2호선,당산,8361,9132,17493
<class,2호선,합정,18742,19732,38474
<class,2호선,홍대입구,46495,48937,95432
<class,2호선,신촌,20115,20005,40120
<class,2호선,이대,6326,6494,12820
<class,2호선,아현,4857,4750,9607
<class,2호선,충정로,3520,3797,7317
<class,2호선,용답,1606,1511,3117
<class,2호선,신답,695,705,1400
<class,2호선,신설동,2806,2830,5636
<class,2호선,도림천,480,477,957
<class,2호선,양천구청,3234,3281,6515
<class,2호선,신정네거리,4814,4805,9619
<class,2호선,용두,1069,1029,2098
<class,3호선,지축,1784,1687,3471
<class,3호선,구파발,10582,10887,21469
<class,3호선,연신내,21202,19925,41127
<class,3호선,불광,9546,11290,20836
<class,3호선,녹번,6368,5677,12045
<class,3호선,홍제,8572,8149,16721
<class,3호선,무악재,1676,1847,3523
<class,3호선,독립문,4276,4968,9244
<class,3호선,경복궁,10517,11621,22138
<class,3호선,안국,9157,10541,19698
<class,3호선,종로3가,3496,5217,8713
<class,3호선,을지로3가,2867,2935,5802
<class,3호선,동대입구,4474,5091,9565
<class,3호선,약수,6274,5944,12218
<class,3호선,금호,4145,3862,8007
<class,3호선,옥수,4963,5246,10209
<class,3호선,압구정,13293,13929,27222
<class,3호선,신사,14293,14705,28998
<class,3호선,잠원,2255,2243,4498
<class,3호선,고속터미널,34902,33509,68411
<class,3호선,교대,3840,2304,6144
<class,3호선,남부터미널,13057,13065,26122
<class,3호선,양재,11603,12865,24468
<class,3호선,매봉,3704,3750,7454
<class,3호선,도곡,1757,1909,3666
<class,3호선,대치,5483,4786,10269
<class,3호선,학여울,1700,1868,3568
<class,3호선,대청,3692,3495,7187
<class,3호선,일원,3180,3168,6348
<class,3호선,수서,8651,8236,16887
<class,3호선,가락시장,3414,3786,7200
<class,3호선,경찰병원,2505,2530,5035
<class,3호선,오금,2367,2476,4843
<class,4호선,수유,18897,18332,37229
<class,4호선,미아,7727,7220,14947
<class,4호선,미아사거리,15218,14525,29743
<class,4호선,길음,9034,8877,17911
<class,4호선,성신여대입구,11846,11251,23097
<class,4호선,한성대입구,7204,7159,14363
<class,4호선,혜화,20026,20757,40783
<class,4호선,동대문,6888,7484,14372
<class,4호선,동대문역사문화공원,8349,8529,16878
<class,4호선,충무로,7473,7516,14989
<class,4호선,명동,10121,10754,20875
<class,4호선,회현,8105,8645,16750
<class,4호선,서울역,3625,7576,11201
<class,4호선,숙대입구,6317,5997,12314
<class,4호선,삼각지,1779,2366,4145
<class,4호선,신용산,6363,6537,12900
<class,4호선,이촌,4032,4600,8632
<class,4호선,동작,1597,1670,3267
<class,4호선,총신대입구,9527,10381,19908
<class,4호선,사당,13369,12384,25753
<class,4호선,남태령,615,478,1093
<class,4호선,당고개,7392,7001,14393
<class,4호선,상계,9804,9170,18974
<class,4호선,노원,11486,12588,24074
<class,4호선,창동,14144,14850,28994
<class,4호선,쌍문,15249,13842,29091
<class,5호선,방화,3384,3361,6745
<class,5호선,개화산,2569,2609,5178
<class,5호선,김포공항,6290,5988,12278
<class,5호선,송정,3558,3377,6935
<class,5호선,마곡,3252,3319,6571
<class,5호선,발산,7947,8421,16368
<class,5호선,우장산,6168,6303,12471
<class,5호선,화곡,13245,12503,25748
<class,5호선,까치산,14871,14648,29519
<class,5호선,신정,6144,5271,11415
<class,5호선,목동,7318,7532,14850
<class,5호선,오목교,11326,11699,23025
<class,5호선,양평,2429,2410,4839
<class,5호선,영등포구청,1272,1244,2516
<class,5호선,영등포시장,4271,4520,8791
<class,5호선,신길,1755,1901,3656
<class,5호선,여의도,12921,11062,23983
<class,5호선,여의나루,13955,17798,31753
<class,5호선,마포,4632,4700,9332
<class,5호선,공덕,4487,4526,9013
<class,5호선,애오개,2605,2665,5270
<class,5호선,충정로,1469,1422,2891
<class,5호선,서대문,4576,4458,9034
<class,5호선,광화문,10953,10930,21883
<class,5호선,종로3가,8669,8440,17109
<class,5호선,을지로4가,1545,1574,3119
<class,5호선,동대문역사문화공원,614,747,1361
<class,5호선,청구,1758,1611,3369
<class,5호선,신금호,2745,2915,5660
<class,5호선,행당,3867,3509,7376
<class,5호선,왕십리,2110,2620,4730
<class,5호선,마장,2795,2702,5497
<class,5호선,답십리,6975,6340,13315
<class,5호선,장한평,6827,6676,13503
<class,5호선,군자,5731,6409,12140
<class,5호선,아차산,10226,10178,20404
<class,5호선,광나루,7382,7085,14467
<class,5호선,천호,11519,10878,22397
<class,5호선,강동,8784,8372,17156
<class,5호선,길동,3756,3896,7652
<class,5호선,굽은다리,4730,4371,9101
<class,5호선,명일,4314,4301,8615
<class,5호선,고덕,3835,3775,7610
<class,5호선,상일동,7049,6486,13535
<class,5호선,둔촌동,4358,4311,8669
<class,5호선,올림픽공원,1944,1777,3721
<class,5호선,방이,3415,3377,6792
<class,5호선,오금,1566,1390,2956
<class,5호선,개롱,2752,3029,5781
<class,5호선,거여,3453,3336,6789
<class,5호선,마천,3127,3382,6509
<class,5호선,미사,6853,6878,13731
<class,5호선,하남풍산,2685,2894,5579
<class,6호선,응암,8553,8438,16991
<class,6호선,역촌,1778,2039,3817
<class,6호선,불광,3140,2870,6010
<class,6호선,독바위,1634,1992,3626
<class,6호선,연신내,1,0,1
<class,6호선,구산,3387,2613,6000
<class,6호선,새절,6099,5907,12006
<class,6호선,증산,5511,5513,11024
<class,6호선,디지털미디어시티,4814,4975,9789
<class,6호선,월드컵경기장,3197,3072,6269
<class,6호선,마포구청,6945,6062,13007
<class,6호선,망원,9505,10608,20113
<class,6호선,합정,9047,8169,17216
<class,6호선,상수,5550,6384,11934
<class,6호선,광흥창,3888,3742,7630
<class,6호선,대흥,3423,3454,6877
<class,6호선,공덕,6434,6139,12573
<class,6호선,효창공원앞,3313,2959,6272
<class,6호선,삼각지,3172,2326,5498
<class,6호선,녹사평,3997,4041,8038
<class,6호선,이태원,9355,9179,18534
<class,6호선,한강진,6324,7446,13770
<class,6호선,버티고개,1061,1119,2180
<class,6호선,약수,1528,1568,3096
<class,6호선,청구,1609,1641,3250
<class,6호선,신당,3976,4490,8466
<class,6호선,동묘앞,6185,5861,12046
<class,6호선,창신,1575,1372,2947
<class,6호선,보문,3652,3360,7012
<class,6호선,안암,4974,5188,10162
<class,6호선,고려대,3999,3805,7804
<class,6호선,월곡,4992,4907,9899
<class,6호선,상월곡,2984,2719,5703
<class,6호선,돌곶이,4333,4028,8361
<class,6호선,석계,6258,6154,12412
<class,6호선,태릉입구,2933,3034,5967
<class,6호선,화랑대,4663,4163,8826
<class,6호선,봉화산,3637,3464,7101
<class,6호선,신내,2,0,2
<class,7호선,장암,1394,1084,2478
<class,7호선,도봉산,5363,8171,13534
<class,7호선,수락산,8292,8178,16470
<class,7호선,마들,5590,5185,10775
<class,7호선,노원,10437,10723,21160
<class,7호선,중계,6246,5688,11934
<class,7호선,하계,8709,8137,16846
<class,7호선,공릉,6413,6543,12956
<class,7호선,태릉입구,4528,4133,8661
<class,7호선,먹골,5309,5186,10495
<class,7호선,중화,5627,5373,11000
<class,7호선,상봉,8815,8132,16947
<class,7호선,면목,7558,7470,15028
<class,7호선,사가정,9011,8683,17694
<class,7호선,용마산,3361,3796,7157
<class,7호선,중곡,4791,4560,9351
<class,7호선,군자,7075,5550,12625
<class,7호선,어린이대공원,6377,6373,12750
<class,7호선,건대입구,7403,7716,15119
<class,7호선,뚝섬유원지,7174,6843,14017
<class,7호선,청담,6355,6538,12893
<class,7호선,강남구청,5310,5759,11069
<class,7호선,학동,5389,5733,11122
<class,7호선,논현,6032,6427,12459
<class,7호선,반포,2688,2614,5302
<class,7호선,고속터미널,9603,6831,16434
<class,7호선,내방,4763,4939,9702
<class,7호선,이수,7786,7312,15098
<class,7호선,남성,5049,4786,9835
<class,7호선,숭실대입구,5471,5524,10995
<class,7호선,상도,4903,4820,9723
<class,7호선,장승배기,4521,4311,8832
<class,7호선,신대방삼거리,7332,7108,14440
<class,7호선,보라매,4251,4127,8378
<class,7호선,신풍,5674,5333,11007
<class,7호선,대림,5802,5559,11361
<class,7호선,남구로,6224,6035,12259
<class,7호선,가산디지털단지,10675,9906,20581
<class,7호선,철산,9776,10048,19824
<class,7호선,광명사거리,11411,11307,22718
<class,7호선,천왕,4823,4494,9317
<class,7호선,온수,3673,3739,7412
<class,7호선,까치울,3599,3600,7199
<class,7호선,부천종합운동장,2416,2283,4699
<class,7호선,춘의,3208,2962,6170
<class,7호선,신중동,6200,6199,12399
<class,7호선,부천시청,6087,6018,12105
<class,7호선,상동,6331,6303,12634
<class,7호선,삼산체육관,2254,2103,4357
<class,7호선,굴포천,4150,4203,8353
<class,7호선,부평구청,4569,4061,8630
<class,8호선,암사,8468,7896,16364
<class,8호선,천호,8280,9662,17942
<class,8호선,강동구청,4156,4099,8255
<class,8호선,몽촌토성,2815,2895,5710
<class,8호선,잠실,8840,9836,18676
<class,8호선,석촌,3979,4911,8890
<class,8호선,송파,3351,3411,6762
<class,8호선,가락시장,3128,3946,7074
<class,8호선,문정,5002,5266,10268
<class,8호선,장지,8556,8329,16885
<class,8호선,복정,4778,4237,9015
<class,8호선,산성,3713,3775,7488
<class,8호선,남한산성입구,6627,6140,12767
<class,8호선,단대오거리,5057,4845,9902
<class,8호선,신흥,2603,2766,5369
<class,8호선,수진,2828,2495,5323
<class,8호선,모란,2267,2035,4302
<class,9호선,개화,960,885,1845
<class,9호선,김포공항,6478,10319,16797
<class,9호선,공항시장,1588,1704,3292
<class,9호선,신방화,3271,3172,6443
<class,9호선,마곡나루,5472,5453,10925
<class,9호선,양천향교,3843,3850,7693
<class,9호선,가양,9797,9232,19029
<class,9호선,증미,2341,2351,4692
<class,9호선,등촌,4734,4838,9572
<class,9호선,염창,8004,7642,15646
<class,9호선,신목동,1567,1372,2939
<class,9호선,선유도,2697,2741,5438
<class,9호선,당산,8386,7880,16266
<class,9호선,국회의사당,4005,3637,7642
<class,9호선,여의도,13862,12940,26802
<class,9호선,샛강,1741,1557,3298
<class,9호선,노량진,13442,14147,27589
<class,9호선,노들,2427,2150,4577
<class,9호선,흑석,3619,3843,7462
<class,9호선,동작,1102,878,1980
<class,9호선,구반포,1075,1221,2296
<class,9호선,신반포,1388,1416,2804
<class,9호선,고속터미널,8450,11664,20114
<class,9호선,사평,1240,1228,2468
<class,9호선,신논현,15295,14923,30218
<class,9호선2~3단계,언주,3265,3182,6447
<class,9호선2~3단계,선정릉,3073,3308,6381
<class,9호선2~3단계,삼성중앙,1730,1858,3588
<class,9호선2~3단계,봉은사,7089,7138,14227
<class,9호선2~3단계,종합운동장,1926,1760,3686
<class,9호선2~3단계,삼전,3199,3151,6350
<class,9호선2~3단계,석촌고분,2839,2704,5543
<class,9호선2~3단계,석촌,4196,3625,7821
<class,9호선2~3단계,송파나루,2553,2895,5448
<class,9호선2~3단계,한성백제,1303,1042,2345
<class,9호선2~3단계,올림픽공원,2736,2732,5468
<class,9호선2~3단계,둔촌오륜,420,404,824
<class,9호선2~3단계,중앙보훈병원,2803,2644,5447
<class,경강선,판교,2169,2063,4232
<class,경강선,이매,596,412,1008
<class,경강선,삼동,996,945,1941
<class,경강선,경기광주,3467,3411,6878
<class,경강선,초월,1456,1433,2889
<class,경강선,곤지암,1385,1429,2814
<class,경강선,신둔도예촌,734,693,1427
<class,경강선,이천,1935,2027,3962
<class,경강선,부발,1132,1194,2326
<class,경강선,세종대왕릉,221,221,442
<class,경강선,여주,1635,1539,3174
<class,경부선,서울역,4501,1078,5579
<class,경부선,남영,4270,4356,8626
<class,경부선,용산,24675,23127,47802
<class,경부선,노량진,5884,5580,11464
<class,경부선,대방,5389,5663,11052
<class,경부선,영등포,29696,29330,59026
<class,경부선,신도림,1997,2061,4058
<class,경부선,신길,4682,3928,8610
<class,경부선,구로,9112,9402,18514
<class,경부선,가산디지털단지,4283,5845,10128
<class,경부선,금천구청,5804,5615,11419
<class,경부선,석수,5200,5143,10343
<class,경부선,관악,4611,4118,8729
<class,경부선,안양,13339,13168,26507
<class,경부선,명학,3135,3166,6301
<class,경부선,금정,12945,12921,25866
<class,경부선,군포,2814,2603,5417
<class,경부선,의왕,4055,4104,8159
<class,경부선,성균관대,7390,7645,15035
<class,경부선,화서,3543,3540,7083
<class,경부선,수원,31242,31297,62539
<class,경부선,독산,5681,5769,11450
<class,경부선,세류,1769,1895,3664
<class,경부선,병점,8423,9033,17456
<class,경부선,세마,1551,1429,2980
<class,경부선,오산대,1974,1773,3747
<class,경부선,오산,7155,7249,14404
<class,경부선,진위,658,647,1305
<class,경부선,송탄,3159,3168,6327
<class,경부선,서정리,3706,4038,7744
<class,경부선,지제,1803,1519,3322
<class,경부선,평택,9533,9839,19372
<class,경부선,성환,2035,2154,4189
<class,경부선,직산,469,482,951
<class,경부선,두정,3613,3987,7600
<class,경부선,천안,4667,4584,9251
<class,경부선,당정,2906,2822,5728
<class,경부선,서동탄,818,840,1658
<class,경부선,광명,1810,1451,3261
<class,경원선,이촌,2100,1568,3668
<class,경원선,서빙고,1054,1133,2187
<class,경원선,한남,1943,1933,3876
<class,경원선,옥수,55,37,92
<class,경원선,응봉,1064,1006,2070
<class,경원선,왕십리,8193,9128,17321
<class,경원선,청량리,11890,11744,23634
<class,경원선,외대앞,4454,4518,8972
<class,경원선,신이문,4534,4176,8710
<class,경원선,석계,4768,5079,9847
<class,경원선,광운대,4182,4206,8388
<class,경원선,월계,3428,3100,6528
<class,경원선,녹천,2721,2309,5030
<class,경원선,방학,5374,5107,10481
<class,경원선,도봉,3427,3140,6567
<class,경원선,도봉산,9377,6587,15964
<class,경원선,망월사,4085,4300,8385
<class,경원선,회룡,6728,6942,13670
<class,경원선,의정부,13002,13513,26515
<class,경원선,가능,3747,3445,7192
<class,경원선,녹양,2535,2433,4968
<class,경원선,양주,4514,4457,8971
<class,경원선,덕계,1523,1417,2940
<class,경원선,덕정,3019,2984,6003
<class,경원선,지행,3960,3881,7841
<class,경원선,동두천중앙,1815,1719,3534
<class,경원선,보산,1233,1359,2592
<class,경원선,동두천,1119,1581,2700
<class,경원선,소요산,3912,3388,7300
<class,경의선,서울역,770,801,1571
<class,경의선,신촌,231,294,525
<class,경의선,효창공원앞,1236,1433,2669
<class,경의선,공덕,1690,1323,3013
<class,경의선,서강대,1215,1116,2331
<class,경의선,홍대입구,1476,1736,3212
<class,경의선,가좌,2695,2673,5368
<class,경의선,디지털미디어시티,1229,1156,2385
<class,경의선,수색,858,864,1722
<class,경의선,화전,866,855,1721
<class,경의선,강매,1430,1308,2738
<class,경의선,행신,3871,3769,7640
<class,경의선,능곡,1997,1984,3981
<class,경의선,곡산,313,299,612
<class,경의선,백마,3023,2966,5989
<class,경의선,풍산,3127,3057,6184
<class,경의선,일산,4917,4800,9717
<class,경의선,탄현,3812,3739,7551
<class,경의선,야당,3792,3620,7412
<class,경의선,운정,3162,2976,6138
<class,경의선,금릉,2535,2492,5027
<class,경의선,금촌,3788,3927,7715
<class,경의선,월롱,809,901,1710
<class,경의선,파주,601,505,1106
<class,경의선,문산,3151,3046,6197
<class,경의선,임진강,86,67,153
<class,경의선,서울역,54,22,76
<class,경인선,개봉,11083,11118,22201
<class,경인선,오류동,6363,5986,12349
<class,경인선,역곡,13533,13464,26997
<class,경인선,부천,20418,20812,41230
<class,경인선,송내,12545,12271,24816
<class,경인선,부평,22364,23935,46299
<class,경인선,백운,3837,3679,7516
<class,경인선,동암,9270,9321,18591
<class,경인선,주안,11221,9974,21195
<class,경인선,제물포,5439,5209,10648
<class,경인선,동인천,9370,8893,18263
<class,경인선,인천,4174,3538,7712
<class,경인선,구일,3132,3082,6214
<class,경인선,소사,5620,5288,10908
<class,경인선,부개,4335,4094,8429
<class,경인선,간석,2884,2745,5629
<class,경인선,도원,1499,1601,3100
<class,경인선,온수,3423,3207,6630
<class,경인선,중동,4509,4132,8641
<class,경인선,도화,2220,1978,4198
<class,경춘선,신내,768,809,1577
<class,경춘선,갈매,1350,1229,2579
<class,경춘선,별내,1609,1530,3139
<class,경춘선,퇴계원,1841,1673,3514
<class,경춘선,사릉,1633,1656,3289
<class,경춘선,금곡,829,785,1614
<class,경춘선,평내호평,3284,3197,6481
<class,경춘선,천마산,1013,1037,2050
<class,경춘선,마석,2553,2610,5163
<class,경춘선,대성리,597,481,1078
<class,경춘선,청평,1431,1279,2710
<class,경춘선,상천,456,342,798
<class,경춘선,가평,1447,1430,2877
<class,경춘선,굴봉산,189,211,400
<class,경춘선,백양리,248,202,450
<class,경춘선,강촌,800,660,1460
<class,경춘선,김유정,631,683,1314
<class,경춘선,남춘천,1939,2035,3974
<class,경춘선,춘천,1583,1402,2985
<class,공항철도 1호선,서울역,5283,4864,10147
<class,공항철도 1호선,공덕,977,1410,2387
<class,공항철도 1호선,홍대입구,8709,8048,16757
<class,공항철도 1호선,디지털미디어시티,3185,3241,6426
<class,공항철도 1호선,마곡나루,1924,2211,4135
<class,공항철도 1호선,김포공항,9626,5047,14673
<class,공항철도 1호선,계양,4485,4229,8714
<class,공항철도 1호선,검암,3404,3544,6948
<class,공항철도 1호선,청라국제도시,2791,2701,5492
<class,공항철도 1호선,운서,4684,4824,9508
<class,공항철도 1호선,공항화물청사,897,939,1836
<class,공항철도 1호선,인천공항1터미널,3523,3563,7086
<class,공항철도 1호선,인천공항2터미널,1582,1395,2977
<class,공항철도 1호선,영종,2116,2196,4312
<class,과천선,선바위,3351,3086,6437
<class,과천선,경마공원,862,823,1685
<class,과천선,대공원,4646,4844,9490
<class,과천선,과천,3039,2686,5725
<class,과천선,정부과천청사,3877,4010,7887
<class,과천선,인덕원,10543,10217,20760
<class,과천선,평촌,5796,5699,11495
<class,과천선,범계,13810,13229,27039
<class,분당선,선릉,2665,3896,6561
<class,분당선,한티,7529,7137,14666
<class,분당선,도곡,2221,2114,4335
<class,분당선,구룡,669,646,1315
<class,분당선,개포동,1656,1654,3310
<class,분당선,대모산입구,1600,1479,3079
<class,분당선,수서,6873,6629,13502
<class,분당선,수원,5920,4741,10661
<class,분당선,서울숲,5074,5153,10227
<class,분당선,압구정로데오,9972,11126,21098
<class,분당선,강남구청,3056,3608,6664
<class,분당선,선정릉,2190,2195,4385
<class,분당선,가천대,3680,4174,7854
<class,분당선,태평,7354,7006,14360
<class,분당선,모란,10673,10693,21366
<class,분당선,야탑,11431,12012,23443
<class,분당선,서현,13300,13521,26821
<class,분당선,수내,5721,5484,11205
<class,분당선,정자,7133,7217,14350
<class,분당선,미금,6454,7007,13461
<class,분당선,오리,5104,4324,9428
<class,분당선,이매,2616,2700,5316
<class,분당선,보정,996,981,1977
<class,분당선,죽전,7504,8377,15881
<class,분당선,구성,2110,2225,4335
<class,분당선,신갈,1885,1946,3831
<class,분당선,기흥,4582,4493,9075
<class,분당선,상갈,2779,2786,5565
<class,분당선,청명,1726,1688,3414
<class,분당선,영통,4179,4243,8422
<class,분당선,망포,5919,5801,11720
<class,분당선,매탄권선,2388,2177,4565
<class,분당선,수원시청,7135,7380,14515
<class,분당선,매교,1314,1361,2675
<class,수인선,고색,1383,1512,2895
<class,수인선,오목천,1312,1184,2496
<class,수인선,어천,454,444,898
<class,수인선,야목,157,119,276
<class,수인선,사리,2255,2017,4272
<class,수인선,달월,61,78,139
<class,수인선,월곶,1619,1570,3189
<class,수인선,소래포구,5486,5470,10956
<class,수인선,인천논현,3003,3015,6018
<class,수인선,호구포,1816,1845,3661
<class,수인선,남동인더스파크,562,495,1057
<class,수인선,원인재,2797,2888,5685
<class,수인선,연수,2921,2860,5781
<class,수인선,송도,1613,1591,3204
<class,수인선,인하대,3121,2962,6083
<class,수인선,숭의,1823,1739,3562
<class,수인선,신포,1119,1119,2238
<class,수인선,인천,1411,2186,3597
<class,안산선,산본,8403,8869,17272
<class,안산선,대야미,2838,2553,5391
<class,안산선,반월,2413,2294,4707
<class,안산선,상록수,8716,8689,17405
<class,안산선,한대앞,4803,4819,9622
<class,안산선,중앙,11403,11647,23050
<class,안산선,고잔,3997,3994,7991
<class,안산선,초지,2238,2196,4434
<class,안산선,안산,9284,8624,17908
<class,안산선,신길온천,1013,984,1997
<class,안산선,정왕,4637,4782,9419
<class,안산선,오이도,6531,6582,13113
<class,안산선,수리산,2027,2030,4057
<class,우이신설선,북한산우이,2956,3290,6246
<class,우이신설선,솔밭공원,1337,1254,2591
<class,우이신설선,4.19민주묘지,1855,1626,3481
<class,우이신설선,가오리,2237,2040,4277
<class,우이신설선,화계,1882,1765,3647
<class,우이신설선,삼양,1094,1031,2125
<class,우이신설선,삼양사거리,1388,1408,2796
<class,우이신설선,솔샘,2626,2368,4994
<class,우이신설선,북한산보국문,3549,3200,6749
<class,우이신설선,정릉,2459,2075,4534
<class,우이신설선,성신여대입구,1901,2316,4217
<class,우이신설선,보문,837,858,1695
<class,우이신설선,신설동,1095,1031,2126
<class,일산선,원흥,4675,4509,9184
<class,일산선,삼송,9927,9656,19583
<class,일산선,원당,5800,5521,11321
<class,일산선,화정,9043,9460,18503
<class,일산선,대곡,908,765,1673
<class,일산선,백석,5257,5342,10599
<class,일산선,마두,3175,3223,6398
<class,일산선,정발산,4769,4866,9635
<class,일산선,주엽,3932,3974,7906
<class,일산선,대화,5888,5314,11202
<class,장항선,봉명,460,472,932
<class,장항선,쌍용,973,931,1904
<class,장항선,아산,1961,1580,3541
<class,장항선,배방,605,636,1241
<class,장항선,온양온천,2773,2768,5541
<class,장항선,신창,821,898,1719
<class,중앙선,회기,14447,14275,28722
<class,중앙선,중랑,3228,3177,6405
<class,중앙선,상봉,3853,3826,7679
<class,중앙선,망우,4199,4177,8376
<class,중앙선,양원,812,831,1643
<class,중앙선,구리,7559,7738,15297
<class,중앙선,도농,4615,4659,9274
<class,중앙선,양정,445,415,860
<class,중앙선,덕소,3515,3552,7067
<class,중앙선,도심,1312,1120,2432
<class,중앙선,팔당,1629,1807,3436
<class,중앙선,운길산,1486,1329,2815
<class,중앙선,양수,1859,1758,3617
<class,중앙선,신원,387,256,643
<class,중앙선,국수,616,611,1227
<class,중앙선,아신,535,510,1045
<class,중앙선,오빈,216,236,452
<class,중앙선,양평,3299,3187,6486
<class,중앙선,원덕,322,304,626
<class,중앙선,용문,1899,1716,3615
<class,중앙선,지평,30,31,61
<class,경춘선,대성리,516,469,985
<class,중앙선,국수,622,653,1275
<class,1호선,서울역,24081,24111,48192
<class,1호선,동묘앞,11369,12066,23435
<class,1호선,시청,8798,9143,17941
<class,1호선,종각,17768,15743,33511
<class,1호선,종로3가,20753,19762,40515
<class,1호선,종로5가,17121,17001,34122
<class,1호선,동대문,9954,9440,19394
<class,1호선,신설동,8887,8795,17682
<class,1호선,제기동,14604,14941,29545
<class,1호선,청량리,17418,17479,34897
<class,2호선,시청,8137,6804,14941
<class,2호선,을지로입구,19378,18578,37956
<class,2호선,을지로3가,9458,9209,18667
<class,2호선,을지로4가,6775,7060,13835
<class,2호선,동대문역사문화공원,9095,9888,18983
<class,2호선,신당,10677,11053,21730
<class,2호선,상왕십리,9089,8572,17661
<class,2호선,왕십리,12953,11092,24045
<class,2호선,한양대,3975,4051,8026
<class,2호선,뚝섬,12688,12948,25636
<class,2호선,성수,17048,18756,35804
<class,2호선,건대입구,32316,33333,65649
<class,2호선,구의,15123,14832,29955
<class,2호선,강변,22859,23302,46161
<class,2호선,잠실나루,6754,6818,13572
<class,2호선,잠실,55515,52895,108410
<class,2호선,잠실새내,15764,16317,32081
<class,2호선,종합운동장,4550,4902,9452
<class,2호선,삼성,30293,30369,60662
<class,2호선,선릉,23052,20520,43572
<class,2호선,역삼,18223,19875,38098
<class,2호선,강남,59524,58708,118232
<class,2호선,교대,16418,18317,34735
<class,2호선,서초,9656,8422,18078
<class,2호선,방배,9643,9941,19584
<class,2호선,사당,28105,31189,59294
<class,2호선,낙성대,20709,19340,40049
<class,2호선,서울대입구,37283,36507,73790
<class,2호선,봉천,16512,15120,31632
<class,2호선,신림,47598,45867,93465
<class,2호선,신대방,18491,18168,36659
<class,2호선,구로디지털단지,32938,32423,65361
<class,2호선,대림,17396,18592,35988
<class,2호선,신도림,38721,38791,77512
<class,2호선,문래,11566,12025,23591
<class,2호선,영등포구청,11560,11890,23450
<class,2호선,당산,12120,13307,25427
<class,2호선,합정,26142,28195,54337
<class,2호선,홍대입구,58451,61417,119868
<class,2호선,신촌,28446,28611,57057
<class,2호선,이대,9199,9540,18739
<class,2호선,아현,7063,6788,13851
<class,2호선,충정로,5528,5859,11387
<class,2호선,용답,2001,1949,3950
<class,2호선,신답,956,1025,1981
<class,2호선,신설동,3171,2982,6153
<class,2호선,도림천,825,804,1629
<class,2호선,양천구청,4102,4177,8279
<class,2호선,신정네거리,6778,7033,13811
<class,2호선,용두,1614,1653,3267
<class,3호선,지축,2431,2461,4892
<class,3호선,구파발,14479,14548,29027
<class,3호선,연신내,29040,27023,56063
<class,3호선,불광,12378,14202,26580
<class,3호선,녹번,9406,8377,17783
<class,3호선,홍제,12572,12071,24643
<class,3호선,무악재,2503,2742,5245
<class,3호선,독립문,5321,5816,11137
<class,3호선,경복궁,13685,14013,27698
<class,3호선,안국,12319,13624,25943
<class,3호선,종로3가,5314,7505,12819
<class,3호선,을지로3가,4612,5193,9805
<class,3호선,충무로,1,0,1
<class,3호선,동대입구,5085,5715,10800
<class,3호선,약수,8807,8228,17035
<class,3호선,금호,5825,5413,11238
<class,3호선,옥수,6876,6865,13741
<class,3호선,압구정,24179,25038,49217
<class,3호선,신사,25173,25543,50716
<class,3호선,잠원,3747,3663,7410
<class,3호선,고속터미널,42823,42520,85343
<class,3호선,교대,6268,3705,9973
<class,3호선,남부터미널,19360,19375,38735
<class,3호선,양재,18446,20113,38559
<class,3호선,매봉,5526,5303,10829
<class,3호선,도곡,3303,3279,6582
<class,3호선,대치,8855,7898,16753
<class,3호선,학여울,1147,1184,2331
<class,3호선,대청,5334,5017,10351
<class,3호선,일원,4265,4257,8522
<class,3호선,수서,10991,11351,22342
<class,3호선,가락시장,6019,5696,11715
<class,3호선,경찰병원,3821,3603,7424
<class,중앙선,아신,508,522,1030
<class,3호선,오금,3450,3228,6678
<class,4호선,수유,25366,24650,50016
<class,4호선,미아,10324,9881,20205
<class,4호선,미아사거리,20700,20178,40878
<class,4호선,길음,13068,12537,25605
<class,4호선,성신여대입구,16059,15295,31354
<class,4호선,한성대입구,10021,9540,19561
<class,4호선,혜화,23910,24296,48206
<class,4호선,동대문,13892,13922,27814
<class,4호선,동대문역사문화공원,10778,9029,19807
<class,4호선,충무로,12070,12329,24399
<class,4호선,명동,11637,13190,24827
<class,4호선,회현,16938,18026,34964
<class,4호선,서울역,4944,9390,14334
<class,4호선,숙대입구,8632,8300,16932
<class,4호선,삼각지,2648,3557,6205
<class,4호선,신용산,8296,9076,17372
<class,4호선,이촌,5245,5942,11187
<class,4호선,동작,1957,2065,4022
<class,4호선,총신대입구,14136,15171,29307
<class,4호선,사당,18761,16036,34797
<class,4호선,남태령,909,727,1636
<class,4호선,당고개,9384,8881,18265
<class,4호선,상계,13404,12601,26005
<class,4호선,노원,15398,16525,31923
<class,4호선,창동,18803,19968,38771
<class,4호선,쌍문,20219,18452,38671
<class,5호선,방화,4544,4257,8801
<class,5호선,개화산,3453,3463,6916
<class,5호선,김포공항,6567,6952,13519
<class,5호선,송정,4826,4696,9522
<class,5호선,마곡,4572,4562,9134
<class,5호선,발산,12211,12828,25039
<class,5호선,우장산,9082,9231,18313
<class,5호선,화곡,18880,17826,36706
<class,5호선,까치산,19930,19324,39254
<class,5호선,신정,8541,7317,15858
<class,5호선,목동,10830,11010,21840
<class,5호선,오목교,15629,16304,31933
<class,5호선,양평,3510,3338,6848
<class,5호선,영등포구청,2012,1867,3879
<class,5호선,영등포시장,6554,6829,13383
<class,5호선,신길,2439,2621,5060
<class,5호선,여의도,13906,12961,26867
<class,5호선,여의나루,11428,15426,26854
<class,5호선,마포,6861,6854,13715
<class,5호선,공덕,6675,7126,13801
<class,5호선,애오개,3673,3535,7208
<class,5호선,충정로,1975,1814,3789
<class,5호선,서대문,6597,6390,12987
<class,5호선,광화문,13775,13820,27595
<class,5호선,종로3가,11588,11417,23005
<class,5호선,을지로4가,3263,3559,6822
<class,5호선,동대문역사문화공원,854,1186,2040
<class,5호선,청구,2476,2308,4784
<class,5호선,신금호,3878,3930,7808
<class,5호선,행당,5476,4742,10218
<class,5호선,왕십리,3396,3936,7332
<class,5호선,마장,3757,3644,7401
<class,5호선,답십리,9867,9092,18959
<class,5호선,장한평,10444,10317,20761
<class,5호선,군자,7968,8757,16725
<class,5호선,아차산,12292,12024,24316
<class,5호선,광나루,9047,8723,17770
<class,5호선,천호,15828,15247,31075
<class,5호선,강동,12675,11904,24579
<class,5호선,길동,5495,5645,11140
<class,5호선,굽은다리,6560,6147,12707
<class,5호선,명일,5808,5642,11450
<class,5호선,고덕,6829,6441,13270
<class,5호선,상일동,9877,9154,19031
<class,5호선,둔촌동,6074,6008,12082
<class,5호선,올림픽공원,2691,2479,5170
<class,5호선,방이,4822,4658,9480
<class,5호선,오금,2100,1899,3999
<class,5호선,개롱,4108,4237,8345
<class,5호선,거여,5005,4906,9911
<class,5호선,마천,4170,4345,8515
<class,5호선,미사,9382,9223,18605
<class,5호선,하남풍산,3254,3627,6881
<class,6호선,응암,11824,11878,23702
<class,6호선,역촌,2438,2759,5197
<class,6호선,불광,3933,3628,7561
<class,6호선,독바위,1977,2424,4401
<class,6호선,구산,5173,3856,9029
<class,6호선,새절,8451,8144,16595
<class,6호선,증산,7283,7231,14514
<class,6호선,디지털미디어시티,6609,6889,13498
<class,6호선,월드컵경기장,4315,4297,8612
<class,6호선,마포구청,8934,7941,16875
<class,6호선,망원,12867,14071,26938
<class,6호선,합정,12034,11144,23178
<class,6호선,상수,7355,8678,16033
<class,6호선,광흥창,4877,4586,9463
<class,6호선,대흥,5013,5045,10058
<class,6호선,공덕,9303,9029,18332
<class,6호선,효창공원앞,4421,3953,8374
<class,6호선,삼각지,4378,3558,7936
<class,6호선,녹사평,4822,5114,9936
<class,6호선,이태원,10712,10870,21582
<class,6호선,한강진,7450,9084,16534
<class,6호선,버티고개,1459,1523,2982
<class,6호선,약수,2299,2427,4726
<class,6호선,청구,2425,2420,4845
<class,6호선,신당,5891,4716,10607
<class,6호선,동묘앞,7935,7281,15216
<class,6호선,창신,2119,1769,3888
<class,6호선,보문,4690,4395,9085
<class,6호선,안암,6865,6689,13554
<class,6호선,고려대,5360,4931,10291
<class,6호선,월곡,6897,6902,13799
<class,6호선,상월곡,3792,3441,7233
<class,6호선,돌곶이,5572,5208,10780
<class,6호선,석계,8312,8262,16574
<class,6호선,태릉입구,3810,4125,7935
<class,6호선,화랑대,6483,5427,11910
<class,6호선,봉화산,5101,4961,10062
<class,7호선,장암,1591,1127,2718
<class,7호선,도봉산,6392,9130,15522
<class,7호선,수락산,9881,10040,19921
<class,7호선,마들,8729,8227,16956
<class,7호선,노원,15447,15720,31167
<class,7호선,중계,8605,7708,16313
<class,7호선,하계,11900,11008,22908
<class,7호선,공릉,8295,8229,16524
<class,7호선,태릉입구,6076,5526,11602
<class,7호선,먹골,7960,7853,15813
<class,7호선,중화,7540,7265,14805
<class,7호선,상봉,12720,12085,24805
<class,7호선,면목,10664,10577,21241
<class,7호선,사가정,12220,11785,24005
<class,7호선,용마산,4273,4575,8848
<class,7호선,중곡,6448,6124,12572
<class,7호선,군자,10090,7800,17890
<class,7호선,어린이대공원,8331,8018,16349
<class,7호선,건대입구,10568,10701,21269
<class,7호선,뚝섬유원지,6865,6886,13751
<class,7호선,청담,10978,11725,22703
<class,7호선,강남구청,9783,10608,20391
<class,7호선,학동,10035,10626,20661
<class,7호선,논현,11216,11943,23159
<class,7호선,반포,4553,4306,8859
<class,7호선,고속터미널,11916,9775,21691
<class,7호선,내방,7686,7575,15261
<class,7호선,이수,11393,10675,22068
<class,7호선,남성,7450,6940,14390
<class,7호선,숭실대입구,7754,7879,15633
<class,7호선,상도,7063,6811,13874
<class,7호선,장승배기,6560,6335,12895
<class,7호선,신대방삼거리,10670,10144,20814
<class,7호선,보라매,5826,5499,11325
<class,7호선,신풍,7555,7341,14896
<class,7호선,대림,6406,6716,13122
<class,7호선,남구로,7984,8552,16536
<class,7호선,가산디지털단지,14546,13331,27877
<class,7호선,철산,14196,14470,28666
<class,7호선,광명사거리,16047,15870,31917
<class,7호선,천왕,6504,6159,12663
<class,7호선,온수,5477,5405,10882
<class,7호선,까치울,5059,5022,10081
<class,7호선,부천종합운동장,2931,2681,5612
<class,7호선,춘의,4790,4590,9380
<class,7호선,신중동,9048,9011,18059
<class,7호선,부천시청,8910,8688,17598
<class,7호선,상동,9363,9458,18821
<class,7호선,삼산체육관,2991,2795,5786
<class,7호선,굴포천,6109,6477,12586
<class,7호선,부평구청,6503,5851,12354
<class,8호선,암사,12034,11121,23155
<class,8호선,천호,11791,13634,25425
<class,8호선,강동구청,5869,5989,11858
<class,8호선,몽촌토성,3934,3906,7840
<class,8호선,잠실,11773,13136,24909
<class,8호선,석촌,5569,6713,12282
<class,8호선,송파,5088,5090,10178
<class,8호선,가락시장,5448,5373,10821
<class,8호선,문정,8200,8344,16544
<class,8호선,장지,12244,11524,23768
<class,8호선,복정,6537,5887,12424
<class,8호선,산성,4905,4894,9799
<class,8호선,남한산성입구,8829,8047,16876
<class,8호선,단대오거리,7121,6823,13944
<class,8호선,신흥,3553,3839,7392
<class,8호선,수진,3904,3535,7439
<class,8호선,모란,3254,2801,6055
<class,9호선,개화,1391,1201,2592
<class,9호선,김포공항,6781,11276,18057
<class,9호선,공항시장,2093,2221,4314
<class,9호선,신방화,4385,4352,8737
<class,9호선,마곡나루,7278,7079,14357
<class,9호선,양천향교,5581,5428,11009
<class,9호선,가양,13184,12548,25732
<class,9호선,증미,3866,3881,7747
<class,9호선,등촌,6776,6720,13496
<class,9호선,염창,10715,10224,20939
<class,9호선,신목동,2174,1926,4100
<class,9호선,선유도,3586,3581,7167
<class,9호선,당산,12196,11281,23477
<class,9호선,국회의사당,3813,3958,7771
<class,9호선,여의도,13740,12587,26327
<class,9호선,샛강,2495,2374,4869
<class,9호선,노량진,19365,19436,38801
<class,9호선,노들,2946,2635,5581
<class,9호선,흑석,5377,5322,10699
<class,9호선,동작,1209,1044,2253
<class,9호선,구반포,1976,2021,3997
<class,9호선,신반포,2278,2200,4478
<class,9호선,고속터미널,11000,14878,25878
<class,9호선,사평,2169,2012,4181
<class,9호선,신논현,25069,24676,49745
<class,9호선2~3단계,언주,5661,5538,11199
<class,9호선2~3단계,선정릉,4779,5244,10023
<class,9호선2~3단계,삼성중앙,2863,2879,5742
<class,9호선2~3단계,봉은사,11411,11871,23282
<class,9호선2~3단계,종합운동장,2904,2530,5434
<class,9호선2~3단계,삼전,4593,4321,8914
<class,9호선2~3단계,석촌고분,4006,3850,7856
<class,9호선2~3단계,석촌,5920,4883,10803
<class,9호선2~3단계,송파나루,3733,3951,7684
<class,9호선2~3단계,한성백제,1700,1532,3232
<class,9호선2~3단계,올림픽공원,3827,3802,7629
<class,9호선2~3단계,둔촌오륜,623,583,1206
<class,9호선2~3단계,중앙보훈병원,3990,3741,7731
<class,경강선,판교,2653,2568,5221
<class,경강선,이매,739,554,1293
<class,경강선,삼동,1362,1287,2649
<class,경강선,경기광주,4694,4303,8997
<class,경강선,초월,1986,1844,3830
<class,경강선,곤지암,1589,1699,3288
<class,경강선,신둔도예촌,916,873,1789
<class,경강선,이천,2209,2368,4577
<class,경강선,부발,1630,1409,3039
<class,경강선,세종대왕릉,283,296,579
<class,경강선,여주,1667,1949,3616
<class,경부선,서울역,4112,1211,5323
<class,경부선,남영,5444,5551,10995
<class,경부선,용산,26019,27281,53300
<class,경부선,노량진,7984,7201,15185
<class,경부선,대방,7631,7700,15331
<class,경부선,영등포,36112,37430,73542
<class,경부선,신도림,2729,2775,5504
<class,경부선,신길,6047,5020,11067
<class,경부선,구로,12579,13228,25807
<class,경부선,가산디지털단지,5546,7766,13312
<class,경부선,금천구청,7922,7802,15724
<class,경부선,석수,6650,6261,12911
<class,경부선,관악,5702,5281,10983
<class,경부선,안양,17025,17066,34091
<class,경부선,명학,4662,4681,9343
<class,경부선,금정,16997,17369,34366
<class,경부선,군포,4192,3879,8071
<class,경부선,의왕,5540,5460,11000
<class,경부선,성균관대,9498,9369,18867
<class,경부선,화서,4802,4896,9698
<class,경부선,수원,34131,36620,70751
<class,경부선,독산,7896,7830,15726
<class,경부선,세류,2181,2234,4415
<class,경부선,병점,10879,10794,21673
<class,경부선,세마,1987,1700,3687
<class,경부선,오산대,2432,2132,4564
<class,경부선,오산,8511,7908,16419
<class,경부선,진위,1007,851,1858
<class,경부선,송탄,4363,3890,8253
<class,경부선,서정리,5572,4654,10226
<class,경부선,지제,2356,2161,4517
<class,경부선,평택,11447,11228,22675
<class,경부선,성환,2683,2451,5134
<class,경부선,직산,544,520,1064
<class,경부선,두정,4727,4779,9506
<class,경부선,천안,4999,5113,10112
<class,경부선,당정,3784,3670,7454
<class,경부선,서동탄,961,967,1928
<class,경부선,광명,2067,1951,4018
<class,경원선,이촌,2976,2207,5183
<class,경원선,서빙고,1194,1099,2293
<class,경원선,한남,2701,2531,5232
<class,경원선,옥수,40,31,71
<class,경원선,응봉,1356,1207,2563
<class,경원선,왕십리,11295,12941,24236
<class,경원선,청량리,13504,14866,28370
<class,경원선,외대앞,5993,5604,11597
<class,경원선,신이문,5897,5488,11385
<class,경원선,석계,6268,6643,12911
<class,경원선,광운대,5534,5332,10866
<class,경원선,월계,4308,4010,8318
<class,경원선,녹천,3133,2726,5859
<class,경원선,방학,6806,6818,13624
<class,경원선,도봉,4362,4135,8497
<class,경원선,도봉산,9325,6559,15884
<class,경원선,망월사,5165,5328,10493
<class,경원선,회룡,8919,9060,17979
<class,경원선,의정부,15853,16571,32424
<class,경원선,가능,4628,4470,9098
<class,경원선,녹양,3245,3108,6353
<class,경원선,양주,5689,5358,11047
<class,경원선,덕계,1920,1726,3646
<class,경원선,덕정,3829,3705,7534
<class,경원선,지행,4244,4164,8408
<class,경원선,동두천중앙,2104,2062,4166
<class,경원선,보산,930,938,1868
<class,경원선,동두천,1405,1826,3231
<class,경원선,소요산,3402,2907,6309
<class,경의선,서울역,1072,1264,2336
<class,경의선,신촌,321,358,679
<class,경의선,효창공원앞,1654,1767,3421
<class,경의선,공덕,2420,1832,4252
<class,경의선,서강대,1560,1538,3098
<class,경의선,홍대입구,1605,1920,3525
<class,경의선,가좌,3564,3416,6980
<class,경의선,디지털미디어시티,1731,1634,3365
<class,경의선,수색,1230,1210,2440
<class,경의선,화전,965,909,1874
<class,경의선,강매,1838,1734,3572
<class,경의선,행신,4779,4797,9576
<class,경의선,능곡,2526,2429,4955
<class,경의선,곡산,331,361,692
<class,경의선,백마,4016,3850,7866
<class,경의선,풍산,3855,3810,7665
<class,경의선,일산,5501,5445,10946
<class,경의선,탄현,4868,4673,9541
<class,경의선,야당,4704,4579,9283
<class,경의선,운정,4057,3815,7872
<class,경의선,금릉,3274,3134,6408
<class,경의선,금촌,5328,5201,10529
<class,경의선,월롱,1212,1194,2406
<class,경의선,파주,799,608,1407
<class,경의선,문산,4131,4084,8215
<class,경의선,임진강,51,54,105
<class,경인선,개봉,15584,15266,30850
<class,경인선,오류동,8684,8042,16726
<class,경인선,역곡,19044,18908,37952
<class,경인선,부천,27478,28624,56102
<class,경인선,송내,16950,17011,33961
<class,경인선,부평,28111,30574,58685
<class,경인선,백운,5169,4986,10155
<class,경인선,동암,12123,12250,24373
<class,경인선,주안,14984,13407,28391
<class,경인선,제물포,6916,6723,13639
<class,경인선,동인천,11193,11000,22193
<class,경인선,인천,3752,3199,6951
<class,경인선,구일,4331,4102,8433
<class,경인선,소사,7585,7245,14830
<class,경인선,부개,5862,5627,11489
<class,경인선,간석,4118,3959,8077
<class,경인선,도원,2684,2811,5495
<class,경인선,온수,4605,4301,8906
<class,경인선,중동,6334,6034,12368
<class,경인선,도화,2860,2642,5502
<class,경춘선,신내,984,989,1973
<class,경춘선,갈매,1758,1601,3359
<class,경춘선,별내,1822,1782,3604
<class,경춘선,퇴계원,2421,2263,4684
<class,경춘선,사릉,2119,1985,4104
<class,경춘선,금곡,964,884,1848
<class,경춘선,평내호평,4099,4043,8142
<class,경춘선,천마산,1211,1221,2432
<class,경춘선,마석,2713,2721,5434
<class,경춘선,청평,1299,1366,2665
<class,경춘선,상천,420,313,733
<class,경춘선,가평,1261,1368,2629
<class,경춘선,굴봉산,120,151,271
<class,경춘선,백양리,82,111,193
<class,경춘선,강촌,590,552,1142
<class,경춘선,김유정,365,418,783
<class,경춘선,남춘천,2181,2172,4353
<class,경춘선,춘천,1265,1287,2552
<class,공항철도 1호선,서울역,5498,5544,11042
<class,공항철도 1호선,공덕,1377,2095,3472
<class,공항철도 1호선,홍대입구,10001,9838,19839
<class,공항철도 1호선,디지털미디어시티,4745,4441,9186
<class,공항철도 1호선,마곡나루,2680,2934,5614
<class,공항철도 1호선,김포공항,9455,5148,14603
<class,공항철도 1호선,계양,5992,5502,11494
<class,공항철도 1호선,검암,4180,4245,8425
<class,공항철도 1호선,청라국제도시,3669,3512,7181
<class,공항철도 1호선,운서,5088,5212,10300
<class,공항철도 1호선,공항화물청사,1332,1301,2633
<class,공항철도 1호선,인천공항1터미널,2919,3074,5993
<class,공항철도 1호선,인천공항2터미널,1633,1441,3074
<class,공항철도 1호선,영종,2511,2570,5081
<class,과천선,선바위,4836,4156,8992
<class,과천선,경마공원,1016,996,2012
<class,과천선,대공원,4247,4580,8827
<class,과천선,과천,3924,3513,7437
<class,과천선,정부과천청사,5506,5591,11097
<class,과천선,인덕원,14323,13873,28196
<class,과천선,평촌,8421,8233,16654
<class,과천선,범계,19038,18400,37438
<class,분당선,선릉,4981,7820,12801
<class,분당선,한티,11209,10787,21996
<class,분당선,도곡,4156,3797,7953
<class,분당선,구룡,1104,1048,2152
<class,분당선,개포동,2430,2431,4861
<class,분당선,대모산입구,2355,2096,4451
<class,분당선,수서,8704,9215,17919
<class,분당선,복정,1,0,1
<class,분당선,수원,7370,6123,13493
<class,분당선,서울숲,6492,6895,13387
<class,분당선,압구정로데오,18081,19764,37845
<class,분당선,강남구청,4971,6066,11037
<class,분당선,선정릉,3677,3787,7464
<class,분당선,가천대,4608,5240,9848
<class,분당선,태평,9989,9525,19514
<class,분당선,모란,15199,15295,30494
<class,분당선,야탑,16006,16880,32886
<class,분당선,서현,17888,17899,35787
<class,분당선,수내,8380,7954,16334
<class,분당선,정자,10446,10737,21183
<class,분당선,미금,10421,10751,21172
<class,분당선,오리,7615,6386,14001
<class,분당선,이매,3729,3636,7365
<class,분당선,보정,1519,1399,2918
<class,분당선,죽전,9928,11154,21082
<class,분당선,구성,2958,3127,6085
<class,분당선,신갈,2679,2755,5434
<class,분당선,기흥,6249,5958,12207
<class,분당선,상갈,3777,3700,7477
<class,분당선,청명,2560,2493,5053
<class,분당선,영통,6443,6320,12763
<class,분당선,망포,8725,8058,16783
<class,분당선,매탄권선,3305,3123,6428
<class,분당선,수원시청,10405,11205,21610
<class,분당선,매교,1986,1925,3911
<class,수인선,고색,2042,2100,4142
<class,수인선,오목천,1795,1508,3303
<class,수인선,어천,540,475,1015
<class,수인선,야목,177,138,315
<class,수인선,사리,2911,2543,5454
<class,수인선,달월,67,78,145
<class,수인선,월곶,2054,1947,4001
<class,수인선,소래포구,5490,5699,11189
<class,수인선,인천논현,4266,4368,8634
<class,수인선,호구포,2291,2303,4594
<class,수인선,남동인더스파크,1085,988,2073
<class,수인선,원인재,3401,3529,6930
<class,수인선,연수,3522,3682,7204
<class,수인선,송도,2001,1986,3987
<class,수인선,인하대,4257,4013,8270
<class,수인선,숭의,2676,2448,5124
<class,수인선,신포,1405,1464,2869
<class,수인선,인천,1099,1926,3025
<class,안산선,산본,11745,12513,24258
<class,안산선,대야미,3827,3290,7117
<class,안산선,반월,3154,2975,6129
<class,안산선,상록수,11958,11783,23741
<class,안산선,한대앞,6750,6705,13455
<class,안산선,중앙,14984,15492,30476
<class,안산선,고잔,5717,5775,11492
<class,안산선,초지,2950,3034,5984
<class,안산선,안산,8961,8904,17865
<class,안산선,신길온천,1321,1308,2629
<class,안산선,정왕,5715,5757,11472
<class,안산선,오이도,6958,7387,14345
<class,안산선,수리산,2685,2453,5138
<class,우이신설선,북한산우이,3056,3198,6254
<class,우이신설선,솔밭공원,1696,1692,3388
<class,우이신설선,4.19민주묘지,2254,1865,4119
<class,우이신설선,가오리,2742,2537,5279
<class,우이신설선,화계,2410,2198,4608
<class,우이신설선,삼양,1507,1590,3097
<class,우이신설선,삼양사거리,1754,1731,3485
<class,우이신설선,솔샘,3601,3302,6903
<class,우이신설선,북한산보국문,4441,4008,8449
<class,우이신설선,정릉,3330,2931,6261
<class,우이신설선,성신여대입구,2707,3092,5799
<class,우이신설선,보문,1054,1046,2100
<class,우이신설선,신설동,1405,1318,2723
<class,일산선,원흥,6313,6091,12404
<class,일산선,지축,1,0,1
<class,일산선,삼송,12756,12497,25253
<class,일산선,원당,7969,7693,15662
<class,일산선,화정,12130,12536,24666
<class,일산선,대곡,1217,1048,2265
<class,일산선,백석,7093,7269,14362
<class,일산선,마두,4836,4894,9730
<class,일산선,정발산,6052,6233,12285
<class,일산선,주엽,5774,5879,11653
<class,일산선,대화,8208,7486,15694
<class,장항선,봉명,670,639,1309
<class,장항선,쌍용,1329,1241,2570
<class,장항선,아산,2249,2184,4433
<class,장항선,배방,858,804,1662
<class,장항선,온양온천,3163,3209,6372
<class,장항선,신창,1026,881,1907
<class,중앙선,회기,18445,17368,35813
<class,중앙선,중랑,4122,3942,8064
<class,중앙선,상봉,4666,4740,9406
<class,중앙선,망우,5848,5697,11545
<class,중앙선,양원,1107,1135,2242
<class,중앙선,구리,9537,9974,19511
<class,중앙선,도농,6164,5962,12126
<class,중앙선,양정,543,504,1047
<class,중앙선,덕소,4349,4235,8584
<class,중앙선,도심,1531,1366,2897
<class,중앙선,팔당,1469,1653,3122
<class,중앙선,운길산,1342,1281,2623
<class,중앙선,양수,1953,1958,3911
<class,중앙선,신원,308,243,551
<class,중앙선,지평,41,71,112
<class,중앙선,용문,1688,1887,3575
<class,중앙선,원덕,334,374,708
<class,중앙선,양평,2203,2401,4604
<class,중앙선,오빈,206,229,435
<class,9호선,노들,2283,2043,4326
<class,중앙선,지평,41,56,97
<class,중앙선,용문,1664,1406,3070
<class,중앙선,원덕,330,264,594
<class,중앙선,양평,1895,1750,3645
<class,중앙선,오빈,182,166,348
<class,중앙선,아신,419,413,832
<class,중앙선,국수,631,562,1193
<class,중앙선,신원,330,203,533
<class,중앙선,양수,1557,1495,3052
<class,중앙선,운길산,1309,1185,2494
<class,중앙선,팔당,1455,1561,3016
<class,중앙선,도심,1193,1053,2246
<class,중앙선,덕소,3157,3181,6338
<class,중앙선,양정,478,438,916
<class,중앙선,도농,4333,4337,8670
<class,중앙선,구리,7003,7345,14348
<class,중앙선,양원,810,889,1699
<class,중앙선,망우,4350,4379,8729
<class,중앙선,상봉,3840,3701,7541
<class,중앙선,중랑,3130,3036,6166
<class,중앙선,회기,13971,14141,28112
<class,장항선,신창,842,1214,2056
<class,장항선,온양온천,2851,2812,5663
<class,장항선,배방,684,804,1488
<class,장항선,아산,2307,1760,4067
<class,장항선,쌍용,1010,1076,2086
<class,장항선,봉명,469,473,942
<class,일산선,대화,5800,5301,11101
<class,일산선,주엽,3900,3796,7696
<class,일산선,정발산,4633,4584,9217
<class,일산선,마두,3160,3201,6361
<class,일산선,백석,5076,5005,10081
<class,일산선,대곡,996,741,1737
<class,일산선,화정,8559,8931,17490
<class,일산선,원당,5778,5536,11314
<class,일산선,삼송,9456,9318,18774
<class,일산선,원흥,4549,4452,9001
<class,우이신설선,신설동,1135,1154,2289
<class,우이신설선,보문,840,849,1689
<class,우이신설선,성신여대입구,2056,2314,4370
<class,우이신설선,정릉,2458,2203,4661
<class,우이신설선,북한산보국문,3520,3126,6646
<class,우이신설선,솔샘,2550,2346,4896
<class,우이신설선,삼양사거리,1374,1357,2731
<class,우이신설선,삼양,1184,1182,2366
<class,우이신설선,화계,1856,1760,3616
<class,우이신설선,가오리,2238,2040,4278
<class,우이신설선,4.19민주묘지,1793,1617,3410
<class,우이신설선,솔밭공원,1346,1285,2631
<class,우이신설선,북한산우이,2882,2909,5791
<class,안산선,수리산,1972,1981,3953
<class,안산선,오이도,5534,5414,10948
<class,안산선,정왕,4319,5034,9353
<class,안산선,신길온천,1043,1021,2064
<class,안산선,안산,8451,7962,16413
<class,안산선,초지,2059,1955,4014
<class,안산선,고잔,4077,3951,8028
<class,안산선,중앙,10755,10571,21326
<class,안산선,한대앞,4790,4663,9453
<class,안산선,상록수,8617,8380,16997
<class,안산선,반월,2243,2359,4602
<class,안산선,대야미,2897,2555,5452
<class,안산선,산본,8026,8585,16611
<class,수인선,인천,1050,1521,2571
<class,수인선,신포,1062,1063,2125
<class,수인선,숭의,1862,1774,3636
<class,수인선,인하대,3228,3031,6259
<class,수인선,송도,1535,1471,3006
<class,수인선,연수,2847,2758,5605
<class,수인선,원인재,2508,2626,5134
<class,수인선,남동인더스파크,592,611,1203
<class,수인선,호구포,1718,1736,3454
<class,수인선,인천논현,2906,2946,5852
<class,수인선,소래포구,4772,4634,9406
<class,수인선,월곶,1478,1347,2825
<class,수인선,달월,53,67,120
<class,수인선,사리,2142,1922,4064
<class,수인선,야목,154,133,287
<class,수인선,어천,398,465,863
<class,수인선,오목천,1161,1127,2288
<class,수인선,고색,1514,1565,3079
<class,분당선,매교,1343,1373,2716
<class,분당선,수원시청,6723,6568,13291
<class,분당선,매탄권선,2220,2137,4357
<class,분당선,망포,5576,5956,11532
<class,분당선,영통,4268,4418,8686
<class,분당선,청명,1699,1736,3435
<class,분당선,상갈,2633,2704,5337
<class,분당선,기흥,4385,4307,8692
<class,분당선,신갈,1817,1805,3622
<class,분당선,구성,2134,2354,4488
<class,분당선,죽전,7383,8411,15794
<class,분당선,보정,1003,895,1898
<class,분당선,이매,2571,2840,5411
<class,분당선,오리,4907,4327,9234
<class,분당선,미금,6517,7039,13556
<class,분당선,정자,6906,6450,13356
<class,분당선,수내,5542,5316,10858
<class,분당선,서현,12679,12742,25421
<class,분당선,야탑,11393,11821,23214
<class,분당선,모란,10101,10351,20452
<class,분당선,태평,7108,6661,13769
<class,분당선,가천대,3452,4221,7673
<class,분당선,선정릉,2134,2191,4325
<class,분당선,강남구청,2804,3373,6177
<class,분당선,압구정로데오,9649,10431,20080
<class,분당선,서울숲,4885,4934,9819
<class,분당선,수원,5482,4483,9965
<class,분당선,수서,7279,6795,14074
<class,분당선,대모산입구,1316,1256,2572
<class,분당선,개포동,1924,1938,3862
<class,분당선,구룡,662,731,1393
<class,분당선,도곡,2536,2560,5096
<class,분당선,한티,7213,7050,14263
<class,분당선,선릉,2528,3854,6382
<class,과천선,범계,13321,12605,25926
<class,과천선,평촌,5702,5475,11177
<class,과천선,인덕원,9967,9701,19668
<class,과천선,정부과천청사,3673,4074,7747
<class,과천선,과천,2925,2682,5607
<class,과천선,대공원,3987,4094,8081
<class,과천선,경마공원,854,895,1749
<class,과천선,선바위,3291,3135,6426
<class,공항철도 1호선,영종,1948,1901,3849
<class,공항철도 1호선,인천공항2터미널,1430,1344,2774
<class,공항철도 1호선,인천공항1터미널,2715,2772,5487
<class,공항철도 1호선,공항화물청사,900,1012,1912
<class,공항철도 1호선,운서,4206,4438,8644
<class,공항철도 1호선,청라국제도시,2669,2599,5268
<class,공항철도 1호선,검암,3224,3308,6532
<class,공항철도 1호선,계양,4267,4095,8362
<class,공항철도 1호선,김포공항,9535,4849,14384
<class,공항철도 1호선,마곡나루,1935,2180,4115
<class,공항철도 1호선,디지털미디어시티,3268,3205,6473
<class,공항철도 1호선,홍대입구,7781,7143,14924
<class,공항철도 1호선,공덕,976,1373,2349
<class,공항철도 1호선,서울역,5402,4942,10344
<class,경춘선,춘천,1179,1267,2446
<class,경춘선,남춘천,2452,2807,5259
<class,경춘선,김유정,395,446,841
<class,경춘선,강촌,623,554,1177
<class,경춘선,백양리,73,57,130
<class,경춘선,굴봉산,140,115,255
<class,경춘선,가평,1151,985,2136
<class,경춘선,상천,407,341,748
<class,경춘선,청평,1370,1139,2509
<class,경춘선,대성리,570,407,977
<class,경춘선,마석,2241,2177,4418
<class,경춘선,천마산,1048,1094,2142
<class,경춘선,평내호평,3285,3200,6485
<class,경춘선,금곡,862,751,1613
<class,경춘선,사릉,1528,1540,3068
<class,경춘선,퇴계원,1955,1718,3673
<class,경춘선,별내,1499,1425,2924
<class,경춘선,갈매,1386,1177,2563
<class,경춘선,신내,737,701,1438
<class,경인선,도화,2229,1989,4218
<class,경인선,중동,4502,4168,8670
<class,경인선,온수,3391,3202,6593
<class,경인선,도원,1572,1688,3260
<class,경인선,간석,2858,2765,5623
<class,경인선,부개,4313,4051,8364
<class,경인선,소사,5450,5363,10813
<class,경인선,구일,3279,3254,6533
<class,경인선,인천,3345,2815,6160
<class,경인선,동인천,8654,8208,16862
<class,경인선,제물포,5139,4915,10054
<class,경인선,주안,10838,9481,20319
<class,경인선,동암,8847,8752,17599
<class,경인선,백운,3702,3721,7423
<class,경인선,부평,20984,21536,42520
<class,경인선,송내,12225,11750,23975
<class,경인선,부천,20965,20518,41483
<class,경인선,역곡,13335,13339,26674
<class,경인선,오류동,6410,6293,12703
<class,경인선,개봉,10906,10953,21859
<class,경의선,임진강,62,50,112
<class,경의선,문산,3083,3120,6203
<class,경의선,파주,549,560,1109
<class,경의선,월롱,753,1218,1971
<class,경의선,금촌,3635,3828,7463
<class,경의선,금릉,2431,2260,4691
<class,경의선,운정,2980,2784,5764
<class,경의선,야당,3562,3328,6890
<class,경의선,탄현,3811,3487,7298
<class,경의선,일산,4187,3906,8093
<class,경의선,풍산,3047,2874,5921
<class,경의선,백마,2993,2934,5927
<class,경의선,곡산,302,265,567
<class,경의선,능곡,1986,2020,4006
<class,경의선,행신,3799,3615,7414
<class,경의선,강매,1342,1293,2635
<class,경의선,화전,733,782,1515
<class,경의선,수색,802,886,1688
<class,경의선,디지털미디어시티,1237,1108,2345
<class,경의선,가좌,2487,2507,4994
<class,경의선,홍대입구,1383,1459,2842
<class,경의선,서강대,1114,1147,2261
<class,경의선,공덕,1454,1209,2663
<class,경의선,효창공원앞,1197,1417,2614
<class,경의선,신촌,208,248,456
<class,경의선,서울역,870,823,1693
<class,경원선,소요산,3393,2881,6274
<class,경원선,동두천,1074,1440,2514
<class,경원선,보산,823,723,1546
<class,경원선,동두천중앙,1666,1588,3254
<class,경원선,지행,3375,3299,6674
<class,경원선,덕정,2877,2874,5751
<class,경원선,덕계,1467,1385,2852
<class,경원선,양주,4288,4248,8536
<class,경원선,녹양,2437,2311,4748
<class,경원선,가능,3667,3512,7179
<class,경원선,의정부,11754,11837,23591
<class,경원선,회룡,6714,6757,13471
<class,경원선,망월사,4002,4221,8223
<class,경원선,도봉산,9121,6556,15677
<class,경원선,도봉,3256,3017,6273
<class,경원선,방학,5346,5085,10431
<class,경원선,녹천,2490,2139,4629
<class,경원선,월계,3790,3487,7277
<class,경원선,광운대,4069,4173,8242
<class,경원선,석계,4633,5078,9711
<class,경원선,신이문,4504,4212,8716
<class,경원선,외대앞,4506,4495,9001
<class,경원선,청량리,11304,11274,22578
<class,경원선,왕십리,8294,9517,17811
<class,경원선,응봉,1090,1030,2120
<class,경원선,옥수,50,20,70
<class,경원선,한남,1809,1827,3636
<class,경원선,서빙고,1184,1152,2336
<class,경원선,이촌,2168,1684,3852
<class,경부선,광명,1847,1459,3306
<class,경부선,서동탄,654,698,1352
<class,경부선,당정,2793,2807,5600
<class,경부선,천안,4847,4613,9460
<class,경부선,두정,3662,4337,7999
<class,경부선,직산,442,525,967
<class,경부선,성환,2135,2580,4715
<class,경부선,평택,9744,10499,20243
<class,경부선,지제,1979,1773,3752
<class,경부선,서정리,3851,5114,8965
<class,경부선,송탄,3231,3549,6780
<class,경부선,진위,700,674,1374
<class,경부선,오산,6720,7099,13819
<class,경부선,오산대,1797,1733,3530
<class,경부선,세마,1494,1393,2887
<class,경부선,병점,8122,8872,16994
<class,경부선,세류,1729,1756,3485
<class,경부선,독산,5410,5495,10905
<class,경부선,수원,29310,28735,58045
<class,경부선,화서,3480,3309,6789
<class,경부선,성균관대,6997,7430,14427
<class,경부선,의왕,3892,4005,7897
<class,경부선,군포,2787,2579,5366
<class,경부선,금정,12303,12544,24847
<class,경부선,명학,3342,3324,6666
<class,경부선,안양,12807,12071,24878
<class,경부선,관악,4652,4332,8984
<class,경부선,석수,4871,4881,9752
<class,경부선,금천구청,5811,5691,11502
<class,경부선,가산디지털단지,4134,5701,9835
<class,경부선,구로,9018,9223,18241
<class,경부선,신길,4627,3962,8589
<class,경부선,신도림,1997,1991,3988
<class,경부선,영등포,28566,27632,56198
<class,경부선,대방,5503,5826,11329
<class,경부선,노량진,5425,5271,10696
<class,경부선,용산,23263,21980,45243
<class,경부선,남영,4027,4221,8248
<class,경부선,서울역,4597,1104,5701
<class,경강선,여주,1632,1572,3204
<class,경강선,세종대왕릉,280,265,545
<class,경강선,부발,1026,1565,2591
<class,경강선,이천,1652,1768,3420
<class,경강선,신둔도예촌,727,732,1459
<class,경강선,곤지암,1187,1350,2537
<class,경강선,초월,1310,1348,2658
<class,경강선,경기광주,3256,3266,6522
<class,경강선,삼동,886,828,1714
<class,경강선,이매,616,403,1019
<class,경강선,판교,2007,1896,3903
<class,9호선2~3단계,중앙보훈병원,2863,2713,5576
<class,9호선2~3단계,둔촌오륜,399,408,807
<class,9호선2~3단계,올림픽공원,2643,2811,5454
<class,9호선2~3단계,한성백제,1353,1094,2447
<class,9호선2~3단계,송파나루,2468,2787,5255
<class,9호선2~3단계,석촌,4006,3505,7511
<class,9호선2~3단계,석촌고분,2777,2774,5551
<class,9호선2~3단계,삼전,3070,3105,6175
<class,9호선2~3단계,종합운동장,1899,1738,3637
<class,9호선2~3단계,봉은사,7731,7738,15469
<class,9호선2~3단계,삼성중앙,1839,1886,3725
<class,9호선2~3단계,선정릉,2894,3272,6166
<class,9호선2~3단계,언주,3298,3163,6461
<class,9호선,신논현,14510,13704,28214
<class,9호선,사평,1226,1310,2536
<class,9호선,고속터미널,8486,11326,19812
<class,9호선,신반포,1386,1536,2922
<class,9호선,구반포,1091,1217,2308
<class,9호선,동작,1014,863,1877
<class,9호선,흑석,3621,3875,7496
<class,9호선,노량진,12992,13849,26841
<class,9호선,샛강,1669,1583,3252
<class,9호선,여의도,10401,9416,19817
<class,9호선,국회의사당,4067,3663,7730
<class,9호선,당산,8097,7757,15854
<class,9호선,선유도,2539,2552,5091
<class,9호선,신목동,1570,1427,2997
<class,9호선,염창,7654,7513,15167
<class,9호선,등촌,4761,4801,9562
<class,9호선,증미,2762,2942,5704
<class,9호선,가양,9641,9488,19129
<class,9호선,양천향교,3828,3982,7810
<class,9호선,마곡나루,4950,4964,9914
<class,9호선,신방화,3050,2928,5978
<class,9호선,공항시장,1627,1828,3455
<class,9호선,김포공항,6381,9403,15784
<class,9호선,개화,1040,901,1941
<class,8호선,모란,2319,1973,4292
<class,8호선,수진,2856,2446,5302
<class,8호선,신흥,2539,2693,5232
<class,8호선,단대오거리,4791,4922,9713
<class,8호선,남한산성입구,6275,5837,12112
<class,8호선,산성,3575,3655,7230
<class,8호선,복정,4628,4289,8917
<class,8호선,장지,8587,8671,17258
<class,8호선,문정,5086,5440,10526
<class,8호선,가락시장,3066,3829,6895
<class,8호선,송파,3430,3622,7052
<class,8호선,석촌,3643,4582,8225
<class,8호선,잠실,8884,9435,18319
<class,8호선,몽촌토성,2860,2811,5671
<class,8호선,강동구청,4052,4234,8286
<class,8호선,천호,8258,9479,17737
<class,8호선,암사,8301,7812,16113
<class,7호선,부평구청,4623,4116,8739
<class,7호선,굴포천,4174,4174,8348
<class,7호선,삼산체육관,2507,2363,4870
<class,7호선,상동,6608,6173,12781
<class,7호선,부천시청,6175,5765,11940
<class,7호선,신중동,6224,6073,12297
<class,7호선,부천종합운동장,2185,2139,4324
<class,7호선,까치울,3773,3637,7410
<class,7호선,온수,3781,3814,7595
<class,7호선,천왕,4744,4620,9364
<class,7호선,광명사거리,11408,11128,22536
<class,7호선,철산,9538,9437,18975
<class,7호선,가산디지털단지,10548,9784,20332
<class,7호선,남구로,6161,5948,12109
<class,7호선,대림,5985,5628,11613
<class,7호선,신풍,5487,5128,10615
<class,7호선,보라매,4499,4494,8993
<class,7호선,신대방삼거리,7184,7094,14278
<class,7호선,장승배기,4576,4490,9066
<class,7호선,상도,4973,4945,9918
<class,7호선,숭실대입구,5424,5785,11209
<class,7호선,남성,4959,4981,9940
<class,7호선,이수,7724,7248,14972
<class,7호선,내방,4720,4814,9534
<class,7호선,고속터미널,9618,6774,16392
<class,7호선,반포,2673,2708,5381
<class,7호선,논현,5926,6281,12207
<class,7호선,학동,5427,5921,11348
<class,7호선,강남구청,4924,5374,10298
<class,7호선,청담,6741,7257,13998
<class,7호선,뚝섬유원지,6779,6353,13132
<class,7호선,건대입구,7611,7510,15121
<class,7호선,어린이대공원,6094,6089,12183
<class,7호선,군자,6903,5532,12435
<class,7호선,중곡,4689,4447,9136
<class,7호선,용마산,3214,3731,6945
<class,7호선,사가정,8794,8515,17309
<class,7호선,면목,7429,7417,14846
<class,7호선,상봉,8800,8332,17132
<class,7호선,중화,5500,5298,10798
<class,7호선,먹골,5121,5128,10249
<class,7호선,태릉입구,4341,3903,8244
<class,7호선,공릉,6144,6276,12420
<class,7호선,하계,8320,7973,16293
<class,7호선,중계,6277,5832,12109
<class,7호선,노원,10212,10169,20381
<class,7호선,마들,5486,5046,10532
<class,7호선,수락산,8174,8133,16307
<class,7호선,도봉산,5195,7746,12941
<class,7호선,장암,1349,1010,2359
<class,6호선,봉화산,3625,3455,7080
<class,6호선,화랑대,4484,3906,8390
<class,6호선,태릉입구,2700,3028,5728
<class,6호선,석계,6247,6263,12510
<class,6호선,돌곶이,4320,4027,8347
<class,6호선,상월곡,2874,2615,5489
<class,6호선,월곡,5108,5067,10175
<class,6호선,고려대,3792,3655,7447
<class,6호선,안암,5109,5488,10597
<class,6호선,보문,3670,3451,7121
<class,6호선,창신,1532,1391,2923
<class,6호선,동묘앞,6227,5917,12144
<class,6호선,신당,4000,4783,8783
<class,6호선,청구,1565,1599,3164
<class,6호선,약수,1527,1528,3055
<class,6호선,버티고개,1049,1149,2198
<class,6호선,한강진,5985,6708,12693
<class,6호선,이태원,7994,7617,15611
<class,6호선,녹사평,3472,3590,7062
<class,6호선,삼각지,2969,2271,5240
<class,6호선,효창공원앞,3157,2898,6055
<class,6호선,공덕,6347,5900,12247
<class,6호선,대흥,3346,3469,6815
<class,6호선,광흥창,3957,3838,7795
<class,6호선,상수,5026,5809,10835
<class,6호선,합정,8834,7779,16613
<class,6호선,망원,9077,9596,18673
<class,6호선,마포구청,6723,5970,12693
<class,6호선,월드컵경기장,5813,5825,11638
<class,6호선,디지털미디어시티,4760,5042,9802
<class,6호선,증산,5174,5407,10581
<class,6호선,새절,6109,5873,11982
<class,6호선,구산,3633,2830,6463
<class,6호선,독바위,1576,2025,3601
<class,6호선,불광,3023,2794,5817
<class,6호선,역촌,1700,2127,3827
<class,6호선,응암,8846,8883,17729
<class,5호선,하남풍산,2530,2683,5213
<class,5호선,미사,6569,6523,13092
<class,5호선,마천,3097,3360,6457
<class,5호선,거여,3567,3576,7143
<class,5호선,개롱,3090,3285,6375
<class,5호선,오금,1601,1523,3124
<class,5호선,방이,3554,3476,7030
<class,5호선,올림픽공원,2036,1813,3849
<class,5호선,둔촌동,4098,4184,8282
<class,5호선,상일동,6869,6624,13493
<class,5호선,고덕,4002,3931,7933
<class,5호선,명일,4115,4126,8241
<class,5호선,굽은다리,4725,4424,9149
<class,5호선,길동,3746,3913,7659
<class,5호선,강동,8559,8440,16999
<class,5호선,천호,11524,10758,22282
<class,5호선,광나루,6990,7091,14081
<class,5호선,아차산,9771,9783,19554
<class,5호선,군자,5536,6055,11591
<class,5호선,장한평,6641,6464,13105
<class,5호선,답십리,6825,6355,13180
<class,5호선,마장,2639,2519,5158
<class,5호선,왕십리,2406,2604,5010
<class,5호선,행당,3633,3387,7020
<class,5호선,신금호,2648,2910,5558
<class,5호선,청구,1765,1532,3297
<class,5호선,동대문역사문화공원,587,672,1259
<class,5호선,을지로4가,1344,1399,2743
<class,5호선,종로3가,7492,6906,14398
<class,5호선,광화문,10671,10335,21006
<class,5호선,서대문,4196,4219,8415
<class,5호선,충정로,1347,1432,2779
<class,5호선,애오개,2500,2529,5029
<class,5호선,공덕,4309,4283,8592
<class,5호선,마포,4525,4321,8846
<class,5호선,여의나루,10941,13146,24087
<class,5호선,여의도,9649,9037,18686
<class,5호선,신길,1730,1934,3664
<class,5호선,영등포시장,4092,4253,8345
<class,5호선,영등포구청,1326,1312,2638
<class,5호선,양평,2430,2412,4842
<class,5호선,오목교,11462,11708,23170
<class,5호선,목동,7197,7220,14417
<class,5호선,신정,5872,5375,11247
<class,5호선,까치산,14674,14247,28921
<class,5호선,화곡,12908,12124,25032
<class,5호선,우장산,6016,6216,12232
<class,5호선,발산,7865,8312,16177
<class,5호선,마곡,3076,3095,6171
<class,5호선,송정,3509,3545,7054
<class,5호선,김포공항,6253,5868,12121
<class,5호선,개화산,2580,2658,5238
<class,5호선,방화,3408,3372,6780
<class,4호선,쌍문,14944,13501,28445
<class,4호선,창동,14203,14964,29167
<class,4호선,노원,10866,11696,22562
<class,4호선,상계,9843,9134,18977
<class,4호선,당고개,7324,6866,14190
<class,4호선,남태령,774,692,1466
<class,4호선,사당,13208,12372,25580
<class,4호선,총신대입구,9367,10258,19625
<class,4호선,동작,1741,1756,3497
<class,4호선,이촌,3942,4554,8496
<class,4호선,신용산,6268,6480,12748
<class,4호선,삼각지,1766,2292,4058
<class,4호선,숙대입구,6157,5909,12066
<class,4호선,서울역,3335,6719,10054
<class,4호선,회현,7246,7454,14700
<class,4호선,명동,8686,8799,17485
<class,4호선,충무로,7184,7403,14587
<class,4호선,동대문역사문화공원,7860,7725,15585
<class,4호선,동대문,6589,7416,14005
<class,4호선,혜화,18079,18605,36684
<class,4호선,한성대입구,6918,6993,13911
<class,4호선,성신여대입구,11611,11140,22751
<class,4호선,길음,9021,8903,17924
<class,4호선,미아사거리,15066,14318,29384
<class,4호선,미아,7322,7051,14373
<class,4호선,수유,18539,17695,36234
<class,3호선,오금,2665,2655,5320
<class,3호선,경찰병원,2606,2566,5172
<class,3호선,가락시장,3592,3806,7398
<class,3호선,수서,8799,8707,17506
<class,3호선,일원,2933,3078,6011
<class,3호선,대청,3712,3553,7265
<class,3호선,학여울,779,774,1553
<class,3호선,대치,5486,4823,10309
<class,3호선,도곡,1900,1982,3882
<class,3호선,매봉,3780,3902,7682
<class,3호선,양재,12068,14045,26113
<class,3호선,남부터미널,12149,12878,25027
<class,3호선,교대,3621,2300,5921
<class,3호선,고속터미널,33636,32105,65741
<class,3호선,잠원,2140,2116,4256
<class,3호선,신사,13036,12958,25994
<class,3호선,압구정,12682,13104,25786
<class,3호선,옥수,4825,5193,10018
<class,3호선,금호,4064,3857,7921
<class,3호선,약수,6047,5785,11832
<class,3호선,동대입구,4144,4824,8968
<class,3호선,충무로,1,0,1
<class,3호선,을지로3가,2505,2517,5022
<class,3호선,종로3가,3383,4522,7905
<class,3호선,안국,8370,9291,17661
<class,3호선,경복궁,9365,9920,19285
<class,3호선,독립문,3781,4253,8034
<class,3호선,무악재,1719,1920,3639
<class,3호선,홍제,8258,8084,16342
<class,3호선,녹번,6210,5689,11899
<class,3호선,불광,9286,10740,20026
<class,3호선,연신내,20804,19451,40255
<class,3호선,구파발,10698,11044,21742
<class,3호선,지축,1759,1586,3345
<class,2호선,용두,1120,1166,2286
<class,2호선,신정네거리,4690,4849,9539
<class,2호선,양천구청,2890,3022,5912
<class,2호선,도림천,400,455,855
<class,2호선,신설동,2870,2889,5759
<class,2호선,신답,722,716,1438
<class,2호선,용답,1563,1609,3172
<class,2호선,충정로,3587,3941,7528
<class,2호선,아현,4674,4786,9460
<class,2호선,이대,5962,6453,12415
<class,2호선,신촌,20516,19659,40175
<class,2호선,홍대입구,42483,42177,84660
<class,2호선,합정,17692,18526,36218
<class,2호선,당산,8301,8963,17264
<class,2호선,영등포구청,7257,7444,14701
<class,2호선,문래,7439,7629,15068
<class,2호선,신도림,26319,26215,52534
<class,2호선,대림,13825,14019,27844
<class,2호선,구로디지털단지,21955,21273,43228
<class,2호선,신대방,13762,13665,27427
<class,2호선,신림,34161,33073,67234
<class,2호선,봉천,11313,11086,22399
<class,2호선,서울대입구,25956,26463,52419
<class,2호선,낙성대,14974,15156,30130
<class,2호선,사당,19272,21512,40784
<class,2호선,방배,6204,6657,12861
<class,2호선,서초,9491,8951,18442
<class,2호선,교대,9588,10722,20310
<class,2호선,강남,33301,31925,65226
<class,2호선,역삼,10440,11618,22058
<class,2호선,선릉,12067,10494,22561
<class,2호선,삼성,20312,19908,40220
<class,2호선,종합운동장,3407,3806,7213
<class,2호선,잠실새내,9775,10078,19853
<class,2호선,잠실,39966,37372,77338
<class,2호선,잠실나루,4657,4762,9419
<class,2호선,강변,17960,18237,36197
<class,2호선,구의,10640,10600,21240
<class,2호선,건대입구,24060,24506,48566
<class,2호선,성수,11311,12533,23844
<class,2호선,뚝섬,9109,9147,18256
<class,2호선,한양대,2211,2428,4639
<class,2호선,왕십리,8917,7869,16786
<class,2호선,상왕십리,6541,6268,12809
<class,2호선,신당,7917,8399,16316
<class,2호선,동대문역사문화공원,6932,8542,15474
<class,2호선,을지로4가,2947,2883,5830
<class,2호선,을지로3가,6309,5867,12176
<class,2호선,을지로입구,13906,13048,26954
<class,2호선,시청,5086,4200,9286
<class,1호선,청량리,12172,12024,24196
<class,1호선,제기동,9282,9770,19052
<class,1호선,신설동,7166,7065,14231
<class,1호선,동대문,8638,9310,17948
<class,1호선,종로5가,8100,8000,16100
<class,1호선,종로3가,12986,11449,24435
<class,1호선,종각,11463,9904,21367
<class,1호선,시청,6133,6139,12272
<class,1호선,동묘앞,12714,13109,25823
<class,1호선,서울역,20003,18339,38342
<class,7호선,춘의,3116,2959,6075
<class,분당선,상갈,3822,3758,7580
<class,중앙선,양정,642,572,1214
<class,중앙선,덕소,4536,4596,9132
<class,중앙선,도심,1645,1443,3088
<class,중앙선,팔당,1636,1787,3423
<class,중앙선,운길산,1477,1360,2837
<class,중앙선,양수,2076,2105,4181
<class,중앙선,신원,317,318,635
<class,중앙선,국수,756,758,1514
<class,중앙선,아신,565,565,1130
<class,중앙선,오빈,268,299,567
<class,중앙선,양평,3802,3885,7687
<class,중앙선,원덕,492,504,996
<class,중앙선,용문,1913,2077,3990
<class,중앙선,지평,38,68,106
<class,분당선,영통,6485,6508,12993
<class,분당선,망포,9020,8161,17181
<class,분당선,매탄권선,3323,3143,6466
<class,분당선,수원시청,10329,11420,21749
<class,분당선,매교,2000,2061,4061
<class,수인선,고색,2147,2197,4344
<class,수인선,오목천,1868,1569,3437
<class,수인선,어천,526,485,1011
<class,수인선,야목,193,188,381
<class,수인선,사리,3049,2601,5650
<class,수인선,달월,66,89,155
<class,수인선,월곶,2137,2070,4207
<class,수인선,소래포구,5992,6122,12114
<class,수인선,인천논현,4294,4401,8695
<class,수인선,호구포,2365,2374,4739
<class,수인선,남동인더스파크,992,963,1955
<class,수인선,원인재,3492,3618,7110
<class,수인선,연수,3667,3690,7357
<class,수인선,송도,2154,2041,4195
<class,수인선,인하대,4178,3894,8072
<class,수인선,숭의,2747,2630,5377
<class,수인선,신포,1327,1463,2790
<class,수인선,인천,1203,2112,3315
<class,안산선,산본,11851,12661,24512
<class,안산선,대야미,3912,3412,7324
<class,안산선,반월,3402,3124,6526
<class,안산선,상록수,11966,12158,24124
<class,안산선,한대앞,6762,6729,13491
<class,안산선,중앙,15306,15767,31073
<class,안산선,고잔,5884,5847,11731
<class,7호선,장암,1719,1298,3017
<class,4호선,동대문,14431,14715,29146
<class,안산선,초지,3149,3141,6290
<class,안산선,안산,9426,9468,18894
<class,안산선,신길온천,1450,1340,2790
<class,안산선,정왕,5990,5947,11937
<class,안산선,오이도,7459,7716,15175
<class,안산선,수리산,2798,2616,5414
<class,우이신설선,북한산우이,4135,4159,8294
<class,우이신설선,솔밭공원,1794,1667,3461
<class,우이신설선,4.19민주묘지,2365,2142,4507
<class,우이신설선,가오리,2838,2683,5521
<class,분당선,청명,2469,2448,4917
<class,우이신설선,화계,2469,2313,4782
<class,우이신설선,삼양,1500,1579,3079
<class,우이신설선,삼양사거리,1782,1781,3563
<class,우이신설선,솔샘,3666,3261,6927
<class,우이신설선,북한산보국문,4426,4047,8473
<class,우이신설선,정릉,3441,2915,6356
<class,우이신설선,성신여대입구,2794,3189,5983
<class,우이신설선,보문,1162,1075,2237
<class,우이신설선,신설동,1488,1451,2939
<class,1호선,서울역,25323,25416,50739
<class,1호선,동묘앞,11730,12431,24161
<class,1호선,시청,9089,9569,18658
<class,1호선,종각,18599,16679,35278
<class,1호선,종로3가,21841,20479,42320
<class,1호선,종로5가,17477,17635,35112
<class,1호선,동대문,10561,9800,20361
<class,1호선,신설동,8904,8682,17586
<class,1호선,제기동,14972,15364,30336
<class,1호선,청량리,17668,17793,35461
<class,2호선,시청,7978,6957,14935
<class,2호선,을지로입구,19760,19296,39056
<class,2호선,을지로3가,9761,9469,19230
<class,2호선,을지로4가,6867,7203,14070
<class,2호선,동대문역사문화공원,9476,10186,19662
<class,2호선,신당,10639,10947,21586
<class,2호선,상왕십리,9368,8832,18200
<class,2호선,왕십리,13532,11622,25154
<class,2호선,한양대,4484,4602,9086
<class,2호선,뚝섬,13172,13534,26706
<class,2호선,성수,17559,19767,37326
<class,2호선,건대입구,33315,34652,67967
<class,2호선,구의,15579,15149,30728
<class,2호선,강변,24638,25079,49717
<class,2호선,잠실나루,7620,7422,15042
<class,2호선,잠실,57842,54807,112649
<class,2호선,잠실새내,15590,16448,32038
<class,2호선,종합운동장,4470,4870,9340
<class,2호선,삼성,27236,27107,54343
<class,2호선,선릉,23357,20937,44294
<class,2호선,역삼,18245,20020,38265
<class,2호선,강남,59848,59603,119451
<class,2호선,교대,16932,18686,35618
<class,2호선,서초,9904,8585,18489
<class,2호선,방배,9731,9830,19561
<class,2호선,사당,28554,31504,60058
<class,2호선,낙성대,21132,19275,40407
<class,2호선,서울대입구,37302,36692,73994
<class,2호선,봉천,16934,15641,32575
<class,일산선,원흥,6660,6278,12938
<class,2호선,신림,49382,46983,96365
<class,2호선,신대방,19115,18528,37643
<class,2호선,구로디지털단지,33358,33282,66640
<class,2호선,대림,17634,18830,36464
<class,2호선,신도림,39780,39769,79549
<class,2호선,문래,11436,12143,23579
<class,2호선,영등포구청,12285,12513,24798
<class,2호선,당산,12681,13433,26114
<class,2호선,합정,26517,28823,55340
<class,2호선,홍대입구,59481,64133,123614
<class,2호선,신촌,28795,28890,57685
<class,2호선,이대,9339,9811,19150
<class,2호선,아현,7304,6981,14285
<class,2호선,충정로,5379,5637,11016
<class,2호선,용답,2091,2032,4123
<class,2호선,신답,1013,1070,2083
<class,2호선,신설동,3132,3006,6138
<class,2호선,도림천,832,822,1654
<class,2호선,양천구청,4758,4706,9464
<class,2호선,신정네거리,6821,7100,13921
<class,2호선,용두,1747,1660,3407
<class,일산선,삼송,13180,12834,26014
<class,3호선,지축,2532,2441,4973
<class,3호선,구파발,14435,14602,29037
<class,3호선,연신내,29358,27644,57002
<class,3호선,불광,12591,14490,27081
<class,3호선,녹번,9631,8533,18164
<class,3호선,홍제,12627,11921,24548
<class,3호선,무악재,2645,2885,5530
<class,3호선,독립문,5518,6113,11631
<class,3호선,경복궁,13718,14308,28026
<class,3호선,안국,13288,15046,28334
<class,3호선,종로3가,5421,8040,13461
<class,3호선,을지로3가,4913,5361,10274
<class,3호선,충무로,1,0,1
<class,3호선,동대입구,5663,6495,12158
<class,3호선,약수,8788,8226,17014
<class,3호선,금호,6071,5425,11496
<class,3호선,옥수,7006,7172,14178
<class,3호선,압구정,24233,25443,49676
<class,3호선,신사,25608,26229,51837
<class,3호선,잠원,3603,3501,7104
<class,3호선,고속터미널,45132,45280,90412
<class,3호선,교대,6571,3969,10540
<class,3호선,남부터미널,19785,19974,39759
<class,3호선,양재,19350,20903,40253
<class,3호선,매봉,5609,5401,11010
<class,3호선,도곡,3410,3401,6811
<class,3호선,대치,8961,7952,16913
<class,3호선,학여울,3001,3263,6264
<class,3호선,대청,5399,4924,10323
<class,3호선,일원,4320,4314,8634
<class,3호선,수서,11847,11904,23751
<class,3호선,가락시장,6148,5764,11912
<class,3호선,경찰병원,3816,3702,7518
<class,3호선,오금,3801,3771,7572
<class,4호선,수유,25946,25324,51270
<class,4호선,미아,10435,9953,20388
<class,4호선,미아사거리,21057,20575,41632
<class,4호선,길음,13437,12482,25919
<class,4호선,성신여대입구,16385,15425,31810
<class,4호선,한성대입구,10132,9709,19841
<class,4호선,혜화,24520,24995,49515
<class,4호선,동대문역사문화공원,10934,9241,20175
<class,4호선,충무로,12390,12752,25142
<class,4호선,명동,11519,13022,24541
<class,4호선,회현,16598,17889,34487
<class,4호선,서울역,4906,9748,14654
<class,4호선,숙대입구,8477,8155,16632
<class,4호선,삼각지,2744,3455,6199
<class,4호선,신용산,8676,9227,17903
<class,4호선,이촌,5353,6022,11375
<class,4호선,동작,2207,2296,4503
<class,4호선,총신대입구,14100,15190,29290
<class,4호선,사당,19090,16636,35726
<class,4호선,남태령,1059,818,1877
<class,4호선,당고개,9846,9436,19282
<class,4호선,상계,13424,12615,26039
<class,4호선,노원,15724,17291,33015
<class,4호선,창동,19369,20508,39877
<class,4호선,쌍문,20743,18832,39575
<class,5호선,방화,4541,4324,8865
<class,5호선,개화산,3570,3600,7170
<class,5호선,김포공항,6927,7340,14267
<class,5호선,송정,4959,4870,9829
<class,5호선,마곡,4623,4748,9371
<class,5호선,발산,12968,13456,26424
<class,5호선,우장산,9286,9254,18540
<class,5호선,화곡,19517,18234,37751
<class,5호선,까치산,20745,19827,40572
<class,5호선,신정,8736,7396,16132
<class,5호선,목동,11023,11246,22269
<class,5호선,오목교,16407,16946,33353
<class,5호선,양평,3611,3442,7053
<class,5호선,영등포구청,2063,1980,4043
<class,5호선,영등포시장,6690,6999,13689
<class,5호선,신길,2511,2682,5193
<class,5호선,여의도,13691,13434,27125
<class,일산선,원당,8007,7750,15757
<class,일산선,화정,12229,12876,25105
<class,일산선,대곡,1278,1050,2328
<class,일산선,백석,7343,7468,14811
<class,일산선,마두,4960,4901,9861
<class,일산선,정발산,6478,6637,13115
<class,일산선,주엽,6028,5932,11960
<class,일산선,대화,8045,7179,15224
<class,장항선,봉명,684,610,1294
<class,장항선,쌍용,1411,1313,2724
<class,장항선,아산,2389,2274,4663
<class,장항선,배방,928,842,1770
<class,장항선,온양온천,3372,3357,6729
<class,장항선,신창,1056,972,2028
<class,중앙선,회기,19089,18124,37213
<class,중앙선,중랑,4332,4120,8452
<class,중앙선,상봉,4830,5087,9917
<class,중앙선,망우,6085,5891,11976
<class,중앙선,양원,1191,1184,2375
<class,중앙선,구리,10070,10349,20419
<class,5호선,여의나루,14694,18094,32788
<class,5호선,마포,7147,7098,14245
<class,5호선,공덕,6979,7222,14201
<class,5호선,애오개,3772,3583,7355
<class,5호선,충정로,1979,1792,3771
<class,5호선,서대문,6637,6362,12999
<class,5호선,광화문,14731,14671,29402
<class,5호선,종로3가,11700,11937,23637
<class,5호선,을지로4가,3303,3676,6979
<class,5호선,동대문역사문화공원,935,1141,2076
<class,5호선,청구,2617,2345,4962
<class,5호선,신금호,3936,3993,7929
<class,5호선,행당,5577,4828,10405
<class,5호선,왕십리,3444,3837,7281
<class,5호선,마장,3696,3501,7197
<class,5호선,답십리,10039,9193,19232
<class,5호선,장한평,10401,10270,20671
<class,5호선,군자,8082,8905,16987
<class,5호선,아차산,12182,12157,24339
<class,5호선,광나루,10417,10110,20527
<class,5호선,천호,16126,15319,31445
<class,5호선,강동,12586,11716,24302
<class,5호선,길동,5636,5723,11359
<class,5호선,굽은다리,6760,6274,13034
<class,5호선,명일,5497,5577,11074
<class,5호선,고덕,5672,5586,11258
<class,5호선,상일동,10294,9566,19860
<class,5호선,둔촌동,6100,5945,12045
<class,5호선,올림픽공원,2813,2515,5328
<class,5호선,방이,5015,4943,9958
<class,5호선,오금,2545,2185,4730
<class,5호선,개롱,4409,4617,9026
<class,5호선,거여,5337,5155,10492
<class,5호선,마천,4353,4436,8789
<class,5호선,미사,9608,9501,19109
<class,5호선,하남풍산,3426,3636,7062
<class,6호선,응암,12226,12116,24342
<class,6호선,역촌,2433,2837,5270
<class,6호선,불광,3883,3582,7465
<class,6호선,독바위,1938,2223,4161
<class,6호선,구산,5283,3943,9226
<class,6호선,새절,8652,8243,16895
<class,6호선,증산,7279,7206,14485
<class,6호선,디지털미디어시티,6864,6916,13780
<class,6호선,월드컵경기장,4460,4552,9012
<class,6호선,마포구청,9031,7863,16894
<class,6호선,망원,12927,14547,27474
<class,6호선,합정,12414,11295,23709
<class,6호선,상수,7549,8534,16083
<class,6호선,광흥창,4999,4640,9639
<class,6호선,대흥,5184,5125,10309
<class,6호선,공덕,9718,9180,18898
<class,6호선,효창공원앞,4582,3996,8578
<class,6호선,삼각지,4505,3543,8048
<class,6호선,녹사평,5031,5411,10442
<class,6호선,이태원,11421,11843,23264
<class,6호선,한강진,7676,9262,16938
<class,6호선,버티고개,1447,1575,3022
<class,6호선,약수,2202,2356,4558
<class,6호선,청구,2419,2466,4885
<class,6호선,신당,5545,4484,10029
<class,6호선,동묘앞,7937,7324,15261
<class,6호선,창신,2105,1790,3895
<class,6호선,보문,4946,4454,9400
<class,6호선,안암,6913,6589,13502
<class,6호선,고려대,5266,5103,10369
<class,6호선,월곡,7321,7052,14373
<class,6호선,상월곡,4032,3503,7535
<class,6호선,돌곶이,5863,5472,11335
<class,6호선,석계,8522,8441,16963
<class,6호선,태릉입구,3927,4245,8172
<class,6호선,화랑대,6479,5485,11964
<class,6호선,봉화산,5102,4930,10032
<class,7호선,도봉산,6394,9179,15573
<class,7호선,수락산,10305,10088,20393
<class,7호선,마들,8327,7806,16133
<class,7호선,노원,15096,15765,30861
<class,7호선,중계,8946,7899,16845
<class,7호선,하계,11838,10955,22793
<class,7호선,공릉,8388,8282,16670
<class,7호선,태릉입구,6201,5487,11688
<class,7호선,먹골,7598,7522,15120
<class,7호선,중화,7838,7432,15270
<class,7호선,상봉,12968,12322,25290
<class,7호선,면목,10846,10704,21550
<class,7호선,사가정,12479,11828,24307
<class,7호선,용마산,4490,4628,9118
<class,7호선,중곡,6488,6106,12594
<class,7호선,군자,10218,7706,17924
<class,7호선,어린이대공원,8328,7813,16141
<class,7호선,건대입구,10390,10754,21144
<class,7호선,뚝섬유원지,9268,8886,18154
<class,7호선,청담,11265,12147,23412
<class,7호선,강남구청,9483,10297,19780
<class,7호선,학동,10053,10928,20981
<class,7호선,논현,11567,12262,23829
<class,7호선,반포,4314,4071,8385
<class,7호선,고속터미널,12568,10210,22778
<class,7호선,내방,7868,7723,15591
<class,7호선,이수,11892,11142,23034
<class,7호선,남성,7247,6760,14007
<class,7호선,숭실대입구,7764,7865,15629
<class,7호선,상도,7080,6740,13820
<class,7호선,장승배기,6569,6198,12767
<class,7호선,신대방삼거리,10651,10087,20738
<class,7호선,보라매,5850,5551,11401
<class,7호선,신풍,7829,7474,15303
<class,7호선,대림,6419,6956,13375
<class,7호선,남구로,8154,8343,16497
<class,7호선,가산디지털단지,14992,13842,28834
<class,7호선,철산,14676,14887,29563
<class,7호선,광명사거리,16839,16729,33568
<class,7호선,천왕,6504,6235,12739
<class,7호선,온수,5633,5549,11182
<class,7호선,까치울,5157,5092,10249
<class,7호선,부천종합운동장,3417,3148,6565
<class,7호선,춘의,5029,4708,9737
<class,7호선,신중동,9309,9239,18548
<class,7호선,부천시청,9113,8912,18025
<class,7호선,상동,9418,9661,19079
<class,7호선,삼산체육관,3115,2946,6061
<class,7호선,굴포천,5977,6258,12235
<class,7호선,부평구청,6775,5896,12671
<class,8호선,암사,12119,11344,23463
<class,8호선,천호,12000,14029,26029
<class,8호선,강동구청,5975,6038,12013
<class,8호선,몽촌토성,4201,4209,8410
<class,8호선,잠실,11858,13420,25278
<class,8호선,석촌,5706,7076,12782
<class,8호선,송파,5446,5450,10896
<class,8호선,가락시장,5466,5771,11237
<class,8호선,문정,8428,8700,17128
<class,8호선,장지,12855,12219,25074
<class,8호선,복정,6868,6014,12882
<class,8호선,산성,4786,4906,9692
<class,8호선,남한산성입구,9014,8107,17121
<class,8호선,단대오거리,7417,6952,14369
<class,8호선,신흥,3692,3856,7548
<class,8호선,수진,3885,3579,7464
<class,8호선,모란,3404,2955,6359
<class,9호선,개화,1365,1163,2528
<class,9호선,김포공항,7179,11952,19131
<class,9호선,공항시장,2129,2228,4357
<class,9호선,신방화,4409,4301,8710
<class,9호선,마곡나루,7481,7362,14843
<class,9호선,양천향교,5510,5522,11032
<class,9호선,가양,13244,12606,25850
<class,9호선,증미,4040,3937,7977
<class,9호선,등촌,6919,6663,13582
<class,9호선,염창,10987,10464,21451
<class,9호선,신목동,2223,1992,4215
<class,9호선,선유도,3535,3610,7145
<class,9호선,당산,11952,10977,22929
<class,9호선,국회의사당,3909,4095,8004
<class,9호선,여의도,13727,13004,26731
<class,9호선,샛강,2566,2466,5032
<class,9호선,노량진,20224,20041,40265
<class,9호선,노들,3064,2553,5617
<class,9호선,흑석,5555,5574,11129
<class,9호선,동작,1330,1072,2402
<class,9호선,구반포,1918,2076,3994
<class,9호선,신반포,2359,2319,4678
<class,9호선,고속터미널,11426,16251,27677
<class,9호선,사평,1901,1867,3768
<class,9호선,신논현,25552,24926,50478
<class,9호선2~3단계,언주,5763,5680,11443
<class,9호선2~3단계,선정릉,4856,5282,10138
<class,9호선2~3단계,삼성중앙,2994,3095,6089
<class,9호선2~3단계,봉은사,10224,10585,20809
<class,9호선2~3단계,종합운동장,3009,2544,5553
<class,중앙선,도농,6566,6228,12794
<class,9호선2~3단계,삼전,4752,4288,9040
<class,9호선2~3단계,석촌고분,3955,3843,7798
<class,9호선2~3단계,석촌,6301,5143,11444
<class,9호선2~3단계,송파나루,3589,4004,7593
<class,9호선2~3단계,한성백제,1748,1555,3303
<class,9호선2~3단계,올림픽공원,3928,3916,7844
<class,9호선2~3단계,둔촌오륜,624,597,1221
<class,9호선2~3단계,중앙보훈병원,4305,3957,8262
<class,경강선,판교,2796,2610,5406
<class,경강선,이매,781,657,1438
<class,경강선,삼동,1344,1272,2616
<class,경강선,경기광주,4824,4554,9378
<class,경강선,초월,2067,1897,3964
<class,경강선,곤지암,1634,1764,3398
<class,경강선,신둔도예촌,879,894,1773
<class,경강선,이천,2313,2414,4727
<class,경강선,부발,1625,1399,3024
<class,경강선,세종대왕릉,257,310,567
<class,경강선,여주,1897,2157,4054
<class,경부선,서울역,4466,1317,5783
<class,경부선,남영,5253,5462,10715
<class,경부선,용산,27656,29658,57314
<class,경부선,노량진,8503,7816,16319
<class,경부선,대방,7951,8045,15996
<class,경부선,영등포,37491,38630,76121
<class,경부선,신도림,2924,3134,6058
<class,경부선,신길,6274,5084,11358
<class,경부선,구로,12881,13517,26398
<class,경부선,가산디지털단지,5846,7905,13751
<class,경부선,금천구청,8169,8281,16450
<class,경부선,석수,6763,6293,13056
<class,경부선,관악,6003,5758,11761
<class,경부선,안양,17600,17702,35302
<class,경부선,명학,5007,4935,9942
<class,경부선,금정,17794,17772,35566
<class,경부선,군포,4217,3870,8087
<class,경부선,의왕,5879,5702,11581
<class,경부선,성균관대,10189,10149,20338
<class,경부선,화서,5076,5013,10089
<class,경부선,수원,35126,37926,73052
<class,경부선,독산,8363,8251,16614
<class,경부선,세류,2262,2340,4602
<class,경부선,병점,11549,11293,22842
<class,경부선,세마,2049,1774,3823
<class,경부선,오산대,2624,2371,4995
<class,경부선,오산,8933,8640,17573
<class,경부선,진위,1022,859,1881
<class,경부선,송탄,4353,3923,8276
<class,경부선,서정리,5888,4885,10773
<class,경부선,지제,2478,2414,4892
<class,경부선,평택,12251,11618,23869
<class,경부선,성환,2660,2421,5081
<class,경부선,직산,602,544,1146
<class,경부선,두정,4896,5028,9924
<class,경부선,천안,5424,5780,11204
<class,경부선,당정,3865,3693,7558
<class,경부선,서동탄,1017,1000,2017
<class,경부선,광명,2193,2028,4221
<class,경원선,이촌,2880,2135,5015
<class,경원선,서빙고,1303,1127,2430
<class,경원선,한남,2754,2534,5288
<class,경원선,옥수,30,37,67
<class,경원선,응봉,1621,1483,3104
<class,경원선,왕십리,12053,13416,25469
<class,경원선,청량리,13868,15463,29331
<class,경원선,외대앞,6046,5790,11836
<class,경원선,신이문,6106,5571,11677
<class,경원선,석계,6506,6823,13329
<class,경원선,광운대,5629,5422,11051
<class,경원선,월계,4431,4091,8522
<class,경원선,녹천,3266,2751,6017
<class,경원선,방학,7023,6689,13712
<class,경원선,도봉,4236,4038,8274
<class,경원선,도봉산,9451,6463,15914
<class,경원선,망월사,5443,5675,11118
<class,경원선,회룡,9350,9296,18646
<class,경원선,의정부,16254,16999,33253
<class,경원선,가능,4735,4646,9381
<class,경원선,녹양,3411,3285,6696
<class,경원선,양주,5972,5796,11768
<class,경원선,덕계,2076,1873,3949
<class,경원선,덕정,3962,3747,7709
<class,경원선,지행,4698,4728,9426
<class,경원선,동두천중앙,2342,2307,4649
<class,경원선,보산,977,1009,1986
<class,경원선,동두천,1364,1865,3229
<class,경원선,소요산,3812,3230,7042
<class,경의선,서울역,1136,1306,2442
<class,경의선,신촌,318,368,686
<class,경의선,효창공원앞,1621,1789,3410
<class,경의선,공덕,2476,2064,4540
<class,경의선,서강대,1474,1446,2920
<class,경의선,홍대입구,1879,2058,3937
<class,경의선,가좌,3695,3516,7211
<class,경의선,디지털미디어시티,1772,1615,3387
<class,경의선,수색,1249,1233,2482
<class,경의선,화전,1051,1018,2069
<class,경의선,강매,1826,1757,3583
<class,경의선,행신,4927,4937,9864
<class,경의선,능곡,2677,2588,5265
<class,경의선,곡산,448,436,884
<class,경의선,백마,4281,4081,8362
<class,경의선,풍산,4126,4033,8159
<class,경의선,일산,6922,6760,13682
<class,경의선,탄현,5082,4899,9981
<class,경의선,야당,4882,4821,9703
<class,경의선,운정,4281,4101,8382
<class,경의선,금릉,3401,3347,6748
<class,경의선,금촌,5215,4999,10214
<class,경의선,월롱,1190,1076,2266
<class,경의선,파주,828,636,1464
<class,경의선,문산,4259,4023,8282
<class,경의선,임진강,55,44,99
<class,경인선,개봉,16126,15936,32062
<class,경인선,오류동,8839,8043,16882
<class,경인선,역곡,19738,19577,39315
<class,경인선,부천,28384,29717,58101
<class,경인선,송내,17456,17496,34952
<class,경인선,부평,29689,32094,61783
<class,경인선,백운,5306,5231,10537
<class,경인선,동암,12311,12659,24970
<class,경인선,주안,15823,13744,29567
<class,경인선,제물포,7233,6938,14171
<class,경인선,동인천,11373,11137,22510
<class,경인선,인천,4253,3679,7932
<class,경인선,구일,4712,4276,8988
<class,경인선,소사,7479,7194,14673
<class,경인선,부개,6061,5699,11760
<class,경인선,간석,4297,4050,8347
<class,경인선,도원,2799,2757,5556
<class,경인선,온수,4585,4331,8916
<class,경인선,중동,6376,6020,12396
<class,경인선,도화,3101,2867,5968
<class,경춘선,신내,975,1007,1982
<class,경춘선,갈매,1929,1618,3547
<class,경춘선,별내,2020,1998,4018
<class,경춘선,퇴계원,2532,2383,4915
<class,경춘선,사릉,2254,2180,4434
<class,경춘선,금곡,1088,1036,2124
<class,경춘선,평내호평,4413,4455,8868
<class,경춘선,천마산,1254,1273,2527
<class,경춘선,마석,3281,3371,6652
<class,경춘선,대성리,562,508,1070
<class,경춘선,청평,1533,1537,3070
<class,경춘선,상천,394,372,766
<class,경춘선,가평,1432,1554,2986
<class,경춘선,굴봉산,140,180,320
<class,경춘선,백양리,104,102,206
<class,경춘선,강촌,647,693,1340
<class,경춘선,김유정,440,516,956
<class,경춘선,남춘천,2221,2378,4599
<class,경춘선,춘천,1526,1321,2847
<class,공항철도 1호선,서울역,5985,5937,11922
<class,공항철도 1호선,공덕,1294,2050,3344
<class,공항철도 1호선,홍대입구,10967,10486,21453
<class,공항철도 1호선,디지털미디어시티,4699,4393,9092
<class,공항철도 1호선,마곡나루,2798,3035,5833
<class,공항철도 1호선,김포공항,10142,5346,15488
<class,공항철도 1호선,계양,6127,5646,11773
<class,공항철도 1호선,검암,4871,4769,9640
<class,공항철도 1호선,청라국제도시,3782,3635,7417
<class,공항철도 1호선,운서,5131,5305,10436
<class,공항철도 1호선,공항화물청사,1263,1318,2581
<class,공항철도 1호선,인천공항1터미널,2965,3131,6096
<class,공항철도 1호선,인천공항2터미널,1523,1417,2940
<class,공항철도 1호선,영종,2615,2694,5309
<class,과천선,선바위,4937,4413,9350
<class,과천선,경마공원,976,983,1959
<class,과천선,대공원,4694,4981,9675
<class,과천선,과천,4162,3684,7846
<class,과천선,정부과천청사,5568,5678,11246
<class,과천선,인덕원,14895,14180,29075
<class,과천선,평촌,8465,8474,16939
<class,과천선,범계,19309,18833,38142
<class,분당선,선릉,5122,7784,12906
<class,분당선,한티,11109,10805,21914
<class,분당선,도곡,4313,3829,8142
<class,분당선,구룡,1063,1044,2107
<class,분당선,개포동,2532,2507,5039
<class,분당선,대모산입구,2288,2054,4342
<class,분당선,수서,8909,9489,18398
<class,분당선,수원,7585,6292,13877
<class,분당선,서울숲,7086,7314,14400
<class,분당선,압구정로데오,17840,20167,38007
<class,분당선,강남구청,5087,6221,11308
<class,분당선,선정릉,3611,3728,7339
<class,분당선,가천대,4722,5267,9989
<class,분당선,태평,10250,9657,19907
<class,분당선,모란,15165,15104,30269
<class,분당선,야탑,16335,17217,33552
<class,분당선,서현,17981,17926,35907
<class,분당선,수내,8601,8029,16630
<class,분당선,정자,10483,10810,21293
<class,분당선,미금,10553,10869,21422
<class,분당선,오리,7369,6137,13506
<class,분당선,이매,3831,3721,7552
<class,분당선,보정,1526,1409,2935
<class,분당선,죽전,10176,11400,21576
<class,분당선,구성,2993,3215,6208
<class,분당선,신갈,2715,2774,5489
<class,분당선,기흥,6331,6027,12358
<class,안산선,한대앞,4776,4731,9507
<class,2호선,잠실나루,4724,4793,9517
<class,2호선,을지로3가,6588,6019,12607
<class,경의선,효창공원앞,1164,1318,2482
<class,경의선,신촌,274,297,571
<class,2호선,강변,19318,19194,38512
<class,경의선,서울역,836,811,1647
<class,경원선,소요산,3801,3190,6991
<class,경원선,동두천,1154,1546,2700
<class,경원선,보산,883,839,1722
<class,경원선,동두천중앙,1795,1655,3450
<class,경원선,지행,3724,3637,7361
<class,경원선,덕정,2971,2986,5957
<class,경원선,덕계,1542,1445,2987
<class,경원선,양주,4408,4396,8804
<class,경원선,녹양,2530,2481,5011
<class,경원선,가능,3590,3383,6973
<class,경원선,의정부,12884,12940,25824
<class,경원선,회룡,6761,6646,13407
<class,경원선,망월사,4215,4442,8657
<class,경원선,도봉산,8898,6424,15322
<class,경원선,도봉,3314,3037,6351
<class,경원선,방학,5315,5008,10323
<class,경원선,녹천,2411,2110,4521
<class,경원선,월계,3256,2990,6246
<class,경원선,광운대,4074,4218,8292
<class,경원선,석계,4656,5140,9796
<class,경원선,신이문,4438,4230,8668
<class,경원선,외대앞,4475,4582,9057
<class,경원선,청량리,11778,11472,23250
<class,경원선,왕십리,7846,8969,16815
<class,경원선,응봉,1039,979,2018
<class,경원선,옥수,43,20,63
<class,경원선,한남,1886,1874,3760
<class,경원선,서빙고,1212,1252,2464
<class,경원선,이촌,2157,1606,3763
<class,경부선,광명,2095,1444,3539
<class,경부선,서동탄,770,773,1543
<class,경부선,당정,2834,2842,5676
<class,경부선,천안,5414,5109,10523
<class,경부선,두정,4034,4691,8725
<class,경부선,직산,453,523,976
<class,경부선,성환,2162,2791,4953
<class,경부선,평택,10506,10853,21359
<class,경부선,지제,2038,1825,3863
<class,경부선,서정리,3791,5241,9032
<class,경부선,송탄,3336,3718,7054
<class,경부선,진위,722,752,1474
<class,경부선,오산,7033,7673,14706
<class,경부선,오산대,2054,1964,4018
<class,경부선,세마,1561,1539,3100
<class,경부선,병점,8795,9541,18336
<class,경부선,세류,1872,1952,3824
<class,경부선,독산,5586,5760,11346
<class,경부선,수원,31847,30929,62776
<class,경부선,화서,3720,3788,7508
<class,경부선,성균관대,7222,7718,14940
<class,경부선,의왕,4201,4157,8358
<class,경부선,군포,2921,2672,5593
<class,경부선,금정,12387,12820,25207
<class,경부선,명학,3361,3274,6635
<class,경부선,안양,13100,12542,25642
<class,경부선,관악,4801,4397,9198
<class,경부선,석수,4855,4945,9800
<class,경부선,금천구청,6031,5811,11842
<class,경부선,가산디지털단지,4332,6190,10522
<class,경부선,구로,9341,9464,18805
<class,경부선,신길,4506,3959,8465
<class,경부선,신도림,2000,2113,4113
<class,경부선,영등포,30106,28889,58995
<class,경부선,대방,5405,5748,11153
<class,경부선,노량진,5764,5293,11057
<class,경부선,용산,25119,23124,48243
<class,경부선,남영,3811,4314,8125
<class,경부선,서울역,5061,1108,6169
<class,경강선,여주,1788,1684,3472
<class,경강선,세종대왕릉,259,238,497
<class,경강선,부발,1124,1707,2831
<class,경강선,이천,1806,1993,3799
<class,경강선,신둔도예촌,749,781,1530
<class,경강선,곤지암,1334,1570,2904
<class,경강선,초월,1476,1439,2915
<class,경강선,경기광주,3462,3423,6885
<class,경강선,삼동,959,990,1949
<class,경강선,이매,593,520,1113
<class,경강선,판교,2135,1980,4115
<class,9호선2~3단계,중앙보훈병원,2927,2733,5660
<class,9호선2~3단계,둔촌오륜,431,446,877
<class,9호선2~3단계,올림픽공원,2692,2757,5449
<class,9호선2~3단계,한성백제,1215,1168,2383
<class,9호선2~3단계,송파나루,2545,2751,5296
<class,9호선2~3단계,석촌,4234,3613,7847
<class,9호선2~3단계,석촌고분,2699,2732,5431
<class,9호선2~3단계,삼전,3173,3144,6317
<class,9호선2~3단계,종합운동장,1815,1696,3511
<class,9호선2~3단계,봉은사,6986,6876,13862
<class,9호선2~3단계,삼성중앙,1780,1814,3594
<class,9호선2~3단계,선정릉,2795,3167,5962
<class,9호선2~3단계,언주,3376,3309,6685
<class,9호선,신논현,14225,13566,27791
<class,9호선,사평,1177,1178,2355
<class,9호선,고속터미널,9066,12475,21541
<class,9호선,신반포,1354,1514,2868
<class,9호선,구반포,1104,1150,2254
<class,9호선,동작,1071,868,1939
<class,9호선,흑석,3701,3895,7596
<class,9호선,노들,2330,2060,4390
<class,9호선,노량진,13576,14980,28556
<class,9호선,샛강,1761,1638,3399
<class,9호선,여의도,10347,9419,19766
<class,9호선,국회의사당,3996,3608,7604
<class,9호선,당산,8015,7644,15659
<class,9호선,선유도,2513,2441,4954
<class,9호선,신목동,1545,1319,2864
<class,9호선,염창,7658,7733,15391
<class,9호선,등촌,4683,4668,9351
<class,9호선,증미,2304,2347,4651
<class,9호선,가양,9125,9087,18212
<class,9호선,양천향교,3739,3958,7697
<class,9호선,마곡나루,5233,5211,10444
<class,9호선,신방화,3096,3035,6131
<class,9호선,공항시장,1545,1720,3265
<class,분당선,청명,1752,1830,3582
<class,9호선,김포공항,6692,10534,17226
<class,9호선,개화,966,821,1787
<class,8호선,모란,4547,3766,8313
<class,8호선,수진,2918,2564,5482
<class,8호선,신흥,2725,2921,5646
<class,8호선,단대오거리,5406,5291,10697
<class,8호선,남한산성입구,6515,6205,12720
<class,8호선,산성,3782,3883,7665
<class,8호선,복정,4758,4503,9261
<class,8호선,장지,9234,9202,18436
<class,8호선,문정,5024,5447,10471
<class,8호선,가락시장,3190,3844,7034
<class,8호선,송파,3336,3539,6875
<class,8호선,석촌,3831,4805,8636
<class,8호선,잠실,8579,9468,18047
<class,8호선,몽촌토성,2882,2751,5633
<class,8호선,강동구청,4236,4327,8563
<class,8호선,천호,8580,9585,18165
<class,8호선,암사,8410,7894,16304
<class,7호선,부평구청,4648,4108,8756
<class,7호선,굴포천,4071,4106,8177
<class,7호선,삼산체육관,2214,2056,4270
<class,7호선,상동,6465,6051,12516
<class,7호선,부천시청,6206,6101,12307
<class,7호선,신중동,6245,6092,12337
<class,7호선,춘의,3197,3042,6239
<class,7호선,부천종합운동장,2932,2545,5477
<class,7호선,까치울,3699,3589,7288
<class,7호선,온수,3601,3666,7267
<class,7호선,천왕,4550,4333,8883
<class,7호선,광명사거리,11421,11198,22619
<class,7호선,철산,9618,9621,19239
<class,7호선,가산디지털단지,10600,9961,20561
<class,7호선,남구로,6239,6096,12335
<class,7호선,대림,5977,5738,11715
<class,7호선,신풍,5535,5205,10740
<class,7호선,보라매,3805,3825,7630
<class,7호선,신대방삼거리,7299,7235,14534
<class,7호선,장승배기,4759,4562,9321
<class,7호선,상도,4852,4869,9721
<class,7호선,숭실대입구,5312,5804,11116
<class,7호선,남성,4900,4945,9845
<class,7호선,이수,7592,7145,14737
<class,7호선,내방,4692,4972,9664
<class,7호선,고속터미널,10770,7319,18089
<class,7호선,반포,2588,2621,5209
<class,7호선,논현,6004,6427,12431
<class,7호선,학동,5351,5756,11107
<class,7호선,강남구청,5063,5496,10559
<class,7호선,청담,6357,6724,13081
<class,7호선,뚝섬유원지,7415,6921,14336
<class,7호선,건대입구,7299,7370,14669
<class,7호선,어린이대공원,6577,6429,13006
<class,7호선,군자,7053,5616,12669
<class,7호선,중곡,4766,4565,9331
<class,7호선,용마산,3020,3569,6589
<class,7호선,사가정,8783,8515,17298
<class,7호선,면목,7482,7500,14982
<class,7호선,상봉,8711,7915,16626
<class,7호선,중화,5565,5301,10866
<class,7호선,먹골,5139,4942,10081
<class,7호선,태릉입구,4423,4069,8492
<class,7호선,공릉,5954,6223,12177
<class,7호선,하계,8239,7837,16076
<class,7호선,중계,6204,5680,11884
<class,7호선,노원,10123,10191,20314
<class,7호선,마들,5316,5050,10366
<class,7호선,수락산,8151,8210,16361
<class,7호선,도봉산,4904,7384,12288
<class,7호선,장암,1481,1005,2486
<class,6호선,봉화산,3437,3345,6782
<class,6호선,화랑대,4423,3950,8373
<class,6호선,태릉입구,2856,3011,5867
<class,6호선,석계,5879,6093,11972
<class,6호선,돌곶이,4304,4072,8376
<class,6호선,상월곡,2923,2746,5669
<class,6호선,월곡,5004,4903,9907
<class,6호선,고려대,3732,3576,7308
<class,6호선,안암,4995,5422,10417
<class,6호선,보문,3670,3511,7181
<class,6호선,창신,1590,1443,3033
<class,6호선,동묘앞,6156,5878,12034
<class,6호선,신당,3188,3972,7160
<class,6호선,청구,1625,1610,3235
<class,6호선,약수,1503,1599,3102
<class,6호선,버티고개,1098,1122,2220
<class,6호선,한강진,5679,6623,12302
<class,6호선,이태원,8313,8022,16335
<class,6호선,녹사평,3753,3684,7437
<class,6호선,삼각지,3072,2336,5408
<class,6호선,효창공원앞,3081,2881,5962
<class,6호선,공덕,6255,5645,11900
<class,6호선,대흥,3383,3510,6893
<class,6호선,광흥창,3774,3601,7375
<class,6호선,상수,5023,5682,10705
<class,6호선,합정,8600,7615,16215
<class,6호선,망원,9030,9861,18891
<class,6호선,마포구청,6614,6035,12649
<class,6호선,월드컵경기장,3131,3134,6265
<class,6호선,디지털미디어시티,4631,4851,9482
<class,6호선,증산,5209,5212,10421
<class,6호선,새절,5970,5839,11809
<class,6호선,구산,3420,2630,6050
<class,6호선,연신내,1,0,1
<class,6호선,독바위,1493,1941,3434
<class,6호선,불광,3043,2750,5793
<class,6호선,역촌,1843,2159,4002
<class,6호선,응암,8560,8653,17213
<class,5호선,하남풍산,2506,2632,5138
<class,5호선,미사,6626,6545,13171
<class,5호선,마천,3128,3351,6479
<class,5호선,거여,3516,3465,6981
<class,5호선,개롱,2897,3076,5973
<class,5호선,오금,1399,1278,2677
<class,5호선,방이,3462,3494,6956
<class,5호선,올림픽공원,1997,1759,3756
<class,5호선,둔촌동,4121,4254,8375
<class,5호선,상일동,6962,6643,13605
<class,5호선,고덕,3667,3596,7263
<class,5호선,명일,3976,4038,8014
<class,5호선,굽은다리,4843,4383,9226
<class,5호선,길동,3749,3842,7591
<class,5호선,강동,8565,8376,16941
<class,5호선,천호,11347,10897,22244
<class,5호선,광나루,6858,6877,13735
<class,5호선,아차산,9566,9655,19221
<class,5호선,군자,5548,6110,11658
<class,5호선,장한평,6727,6618,13345
<class,5호선,답십리,6709,6233,12942
<class,5호선,마장,2695,2525,5220
<class,5호선,왕십리,2180,2477,4657
<class,5호선,행당,3696,3363,7059
<class,5호선,신금호,2718,2889,5607
<class,5호선,청구,1651,1639,3290
<class,5호선,동대문역사문화공원,592,740,1332
<class,5호선,을지로4가,1389,1419,2808
<class,5호선,종로3가,8230,7434,15664
<class,5호선,광화문,10520,10462,20982
<class,5호선,서대문,4532,4500,9032
<class,5호선,충정로,1424,1496,2920
<class,5호선,애오개,2471,2561,5032
<class,5호선,공덕,4197,4288,8485
<class,5호선,마포,4356,4394,8750
<class,5호선,여의나루,12307,14789,27096
<class,5호선,여의도,9720,9061,18781
<class,5호선,신길,1711,1922,3633
<class,5호선,영등포시장,4204,4581,8785
<class,5호선,영등포구청,1247,1140,2387
<class,5호선,양평,2316,2389,4705
<class,5호선,오목교,11148,11530,22678
<class,5호선,목동,7231,7298,14529
<class,5호선,신정,6031,5400,11431
<class,5호선,까치산,14663,14468,29131
<class,5호선,화곡,13208,12347,25555
<class,5호선,우장산,6082,6304,12386
<class,5호선,발산,8237,8586,16823
<class,5호선,마곡,3132,3247,6379
<class,5호선,송정,3523,3459,6982
<class,5호선,김포공항,6352,6133,12485
<class,5호선,개화산,2596,2648,5244
<class,5호선,방화,3387,3221,6608
<class,4호선,쌍문,14344,13055,27399
<class,4호선,창동,14015,14813,28828
<class,4호선,노원,11055,11859,22914
<class,4호선,상계,9623,9124,18747
<class,4호선,당고개,7525,7020,14545
<class,4호선,남태령,587,523,1110
<class,4호선,사당,13072,12183,25255
<class,4호선,총신대입구,9253,10204,19457
<class,4호선,동작,1595,1633,3228
<class,4호선,이촌,3971,4600,8571
<class,4호선,신용산,6545,6624,13169
<class,4호선,삼각지,1766,2329,4095
<class,4호선,숙대입구,6261,5959,12220
<class,4호선,서울역,3626,7149,10775
<class,4호선,회현,7531,7842,15373
<class,4호선,명동,8688,9002,17690
<class,4호선,충무로,7352,7319,14671
<class,4호선,동대문역사문화공원,7873,7893,15766
<class,4호선,동대문,6814,7468,14282
<class,4호선,혜화,19636,20368,40004
<class,4호선,한성대입구,7085,7116,14201
<class,4호선,성신여대입구,12044,11483,23527
<class,4호선,길음,9205,9132,18337
<class,4호선,미아사거리,14992,14454,29446
<class,4호선,미아,7505,7084,14589
<class,4호선,수유,18946,17757,36703
<class,3호선,오금,2413,2425,4838
<class,3호선,경찰병원,2634,2622,5256
<class,3호선,가락시장,3274,3590,6864
<class,3호선,수서,9129,8965,18094
<class,3호선,일원,3048,3199,6247
<class,3호선,대청,3676,3577,7253
<class,3호선,학여울,2235,2499,4734
<class,3호선,대치,5590,4921,10511
<class,3호선,도곡,1798,1922,3720
<class,3호선,매봉,3853,3892,7745
<class,3호선,양재,11906,13940,25846
<class,3호선,남부터미널,12909,13995,26904
<class,3호선,교대,3803,2430,6233
<class,3호선,고속터미널,36561,34745,71306
<class,3호선,잠원,2147,2200,4347
<class,3호선,신사,13473,13612,27085
<class,중앙선,상봉,3709,3750,7459
<class,중앙선,중랑,3205,3158,6363
<class,중앙선,회기,14218,14450,28668
<class,장항선,신창,893,1278,2171
<class,장항선,온양온천,4007,3935,7942
<class,장항선,배방,693,870,1563
<class,장항선,아산,2813,1993,4806
<class,장항선,쌍용,1208,1295,2503
<class,장항선,봉명,567,628,1195
<class,일산선,대화,5787,5284,11071
<class,일산선,주엽,3924,3883,7807
<class,일산선,정발산,5168,5080,10248
<class,일산선,마두,3179,3174,6353
<class,3호선,압구정,12458,13010,25468
<class,3호선,옥수,4904,5121,10025
<class,3호선,금호,4097,3902,7999
<class,3호선,약수,6238,5921,12159
<class,분당선,영통,4372,4363,8735
<class,분당선,망포,5702,6169,11871
<class,분당선,매탄권선,2363,2290,4653
<class,분당선,수원시청,7088,6891,13979
<class,분당선,매교,1304,1377,2681
<class,수인선,고색,1398,1525,2923
<class,수인선,오목천,1309,1196,2505
<class,수인선,어천,465,527,992
<class,수인선,야목,145,120,265
<class,수인선,사리,2249,1957,4206
<class,수인선,달월,67,61,128
<class,수인선,월곶,1558,1402,2960
<class,수인선,소래포구,5150,5061,10211
<class,수인선,인천논현,2820,2904,5724
<class,수인선,호구포,1766,1803,3569
<class,수인선,남동인더스파크,634,627,1261
<class,수인선,원인재,2567,2693,5260
<class,수인선,연수,2843,2684,5527
<class,수인선,송도,1533,1499,3032
<class,수인선,인하대,3137,3065,6202
<class,수인선,숭의,1857,1764,3621
<class,수인선,신포,1031,983,2014
<class,수인선,인천,1087,1707,2794
<class,안산선,산본,8367,8716,17083
<class,안산선,대야미,2923,2593,5516
<class,안산선,반월,2297,2313,4610
<class,분당선,상갈,2702,2756,5458
<class,분당선,기흥,4658,4533,9191
<class,분당선,신갈,1899,1962,3861
<class,분당선,구성,2167,2252,4419
<class,분당선,죽전,7534,8488,16022
<class,분당선,보정,1014,969,1983
<class,분당선,이매,2918,3043,5961
<class,분당선,오리,5381,4655,10036
<class,분당선,미금,6768,7319,14087
<class,분당선,정자,7013,7181,14194
<class,분당선,수내,5692,5411,11103
<class,분당선,서현,13023,13103,26126
<class,분당선,야탑,11991,12202,24193
<class,분당선,모란,17513,17983,35496
<class,분당선,태평,7699,7341,15040
<class,분당선,가천대,3413,4292,7705
<class,분당선,선정릉,1933,1990,3923
<class,분당선,강남구청,3086,3656,6742
<class,분당선,압구정로데오,9421,10272,19693
<class,분당선,서울숲,5132,5297,10429
<class,분당선,수원,5812,4710,10522
<class,분당선,수서,7872,7383,15255
<class,분당선,대모산입구,1707,1652,3359
<class,분당선,개포동,1682,1654,3336
<class,분당선,구룡,650,746,1396
<class,분당선,도곡,2358,2205,4563
<class,분당선,한티,7537,7222,14759
<class,분당선,선릉,2652,3934,6586
<class,과천선,범계,13610,12807,26417
<class,과천선,평촌,5693,5530,11223
<class,과천선,인덕원,10295,10144,20439
<class,과천선,정부과천청사,3847,4025,7872
<class,과천선,과천,2836,2543,5379
<class,과천선,대공원,3858,4130,7988
<class,과천선,경마공원,918,872,1790
<class,과천선,선바위,3360,3100,6460
<class,공항철도 1호선,영종,2163,2045,4208
<class,공항철도 1호선,인천공항2터미널,1419,1345,2764
<class,공항철도 1호선,인천공항1터미널,2997,2991,5988
<class,공항철도 1호선,공항화물청사,922,990,1912
<class,공항철도 1호선,운서,4166,4554,8720
<class,공항철도 1호선,청라국제도시,2830,2692,5522
<class,공항철도 1호선,검암,3842,3910,7752
<class,공항철도 1호선,계양,4397,4295,8692
<class,공항철도 1호선,김포공항,10725,5562,16287
<class,공항철도 1호선,마곡나루,1951,2202,4153
<class,공항철도 1호선,디지털미디어시티,3098,3117,6215
<class,공항철도 1호선,홍대입구,8610,7795,16405
<class,공항철도 1호선,공덕,1006,1309,2315
<class,공항철도 1호선,서울역,5772,5345,11117
<class,경춘선,춘천,1376,1432,2808
<class,경춘선,남춘천,1982,2268,4250
<class,경춘선,김유정,392,448,840
<class,경춘선,강촌,653,503,1156
<class,경춘선,백양리,121,74,195
<class,경춘선,굴봉산,174,160,334
<class,경춘선,가평,1338,1116,2454
<class,경춘선,상천,472,351,823
<class,경춘선,청평,1431,1229,2660
<class,경춘선,대성리,596,437,1033
<class,경춘선,마석,2236,2259,4495
<class,경춘선,천마산,1039,983,2022
<class,경춘선,평내호평,3273,3147,6420
<class,경춘선,금곡,863,803,1666
<class,경춘선,사릉,1596,1533,3129
<class,경춘선,퇴계원,1869,1690,3559
<class,경춘선,별내,1569,1439,3008
<class,경춘선,갈매,1310,1183,2493
<class,경춘선,신내,686,784,1470
<class,경인선,도화,2168,1984,4152
<class,경인선,중동,4444,4120,8564
<class,경인선,온수,3278,3308,6586
<class,경인선,도원,1641,1666,3307
<class,경인선,간석,2994,2746,5740
<class,경인선,부개,4273,4031,8304
<class,경인선,소사,5324,5086,10410
<class,경인선,구일,3027,3006,6033
<class,경인선,인천,3682,3011,6693
<class,경인선,동인천,8625,8327,16952
<class,경인선,제물포,5224,4992,10216
<class,경인선,주안,11147,9779,20926
<class,2호선,구의,10646,10718,21364
<class,2호선,건대입구,24420,25097,49517
<class,2호선,성수,11566,13027,24593
<class,1호선,서울역,21400,19108,40508
<class,1호선,동묘앞,12482,12790,25272
<class,1호선,시청,6310,6046,12356
<class,1호선,종각,11458,9844,21302
<class,1호선,종로3가,13338,11811,25149
<class,1호선,종로5가,8496,8533,17029
<class,1호선,동대문,8811,9541,18352
<class,1호선,신설동,6821,6900,13721
<class,1호선,제기동,9072,9562,18634
<class,1호선,청량리,12478,12213,24691
<class,2호선,시청,5113,4261,9374
<class,2호선,을지로입구,14047,13305,27352
<class,2호선,을지로4가,2935,2779,5714
<class,2호선,동대문역사문화공원,6567,8009,14576
<class,2호선,신당,7691,8125,15816
<class,2호선,상왕십리,6559,6370,12929
<class,2호선,왕십리,8604,7506,16110
<class,2호선,한양대,2178,2430,4608
<class,2호선,뚝섬,8694,9317,18011
<class,경인선,동암,9062,8888,17950
<class,경인선,백운,3722,3696,7418
<class,경인선,부평,22186,22438,44624
<class,경인선,송내,12358,11987,24345
<class,경인선,부천,20418,20099,40517
<class,경인선,역곡,13505,13375,26880
<class,경인선,오류동,6517,6193,12710
<class,경인선,개봉,10926,10863,21789
<class,경의선,임진강,69,58,127
<class,경의선,문산,3639,3598,7237
<class,3호선,동대입구,4384,4903,9287
<class,일산선,대곡,1015,830,1845
<class,일산선,화정,8839,9027,17866
<class,일산선,원당,5891,5734,11625
<class,일산선,삼송,9702,9343,19045
<class,일산선,원흥,4797,4780,9577
<class,우이신설선,신설동,1173,1130,2303
<class,우이신설선,보문,864,919,1783
<class,우이신설선,성신여대입구,2044,2277,4321
<class,우이신설선,정릉,2525,2205,4730
<class,우이신설선,북한산보국문,3436,3094,6530
<class,우이신설선,솔샘,2589,2392,4981
<class,우이신설선,삼양사거리,1391,1397,2788
<class,우이신설선,삼양,1097,1127,2224
<class,우이신설선,화계,1912,1812,3724
<class,우이신설선,가오리,2201,2095,4296
<class,우이신설선,4.19민주묘지,1822,1600,3422
<class,우이신설선,솔밭공원,1353,1278,2631
<class,우이신설선,북한산우이,2976,3109,6085
<class,안산선,수리산,1931,1935,3866
<class,안산선,오이도,5888,5766,11654
<class,안산선,정왕,4649,5348,9997
<class,안산선,신길온천,1029,964,1993
<class,안산선,안산,8945,8281,17226
<class,안산선,초지,2243,2108,4351
<class,안산선,고잔,4038,3947,7985
<class,안산선,상록수,8737,8589,17326
<class,안산선,중앙,11335,11310,22645
<class,3호선,을지로3가,2646,2631,5277
<class,3호선,종로3가,3565,4992,8557
<class,3호선,안국,8874,9872,18746
<class,3호선,경복궁,9679,10046,19725
<class,3호선,독립문,3918,4329,8247
<class,3호선,무악재,1721,1970,3691
<class,3호선,홍제,8511,8176,16687
<class,3호선,녹번,6518,6024,12542
<class,3호선,불광,9274,10849,20123
<class,3호선,연신내,20638,19376,40014
<class,3호선,구파발,10493,10656,21149
<class,3호선,지축,1736,1641,3377
<class,2호선,용두,984,959,1943
<class,2호선,신정네거리,4843,4760,9603
<class,2호선,양천구청,3013,3100,6113
<class,경의선,파주,597,584,1181
<class,2호선,도림천,473,458,931
<class,2호선,신설동,2850,2787,5637
<class,2호선,신답,673,762,1435
<class,2호선,용답,1543,1684,3227
<class,2호선,충정로,3624,3779,7403
<class,2호선,아현,4691,4834,9525
<class,2호선,이대,6193,6562,12755
<class,2호선,신촌,20931,20243,41174
<class,2호선,홍대입구,43930,43360,87290
<class,일산선,백석,5176,5135,10311
<class,중앙선,지평,46,33,79
<class,중앙선,용문,1776,1459,3235
<class,중앙선,원덕,451,352,803
<class,중앙선,양평,2087,1872,3959
<class,중앙선,오빈,220,203,423
<class,중앙선,아신,522,509,1031
<class,중앙선,국수,662,604,1266
<class,중앙선,신원,330,260,590
<class,중앙선,양수,1761,1606,3367
<class,중앙선,운길산,1388,1248,2636
<class,중앙선,팔당,1546,1633,3179
<class,중앙선,도심,1110,1046,2156
<class,중앙선,덕소,3251,3215,6466
<class,중앙선,양정,476,407,883
<class,중앙선,도농,4582,4511,9093
<class,중앙선,구리,7202,7408,14610
<class,중앙선,양원,773,832,1605
<class,중앙선,망우,4379,4358,8737
<class,경의선,월롱,677,1247,1924
<class,경의선,금촌,3792,3991,7783
<class,경의선,금릉,2441,2367,4808
<class,경의선,운정,3207,2949,6156
<class,경의선,야당,3675,3424,7099
<class,경의선,탄현,3777,3486,7263
<class,경의선,일산,4323,3979,8302
<class,경의선,풍산,3183,2956,6139
<class,경의선,백마,3049,2912,5961
<class,경의선,곡산,312,324,636
<class,경의선,능곡,2051,2001,4052
<class,경의선,행신,3870,3713,7583
<class,경의선,강매,1350,1281,2631
<class,경의선,화전,813,839,1652
<class,경의선,수색,816,876,1692
<class,경의선,디지털미디어시티,1248,1094,2342
<class,경의선,가좌,2606,2633,5239
<class,경의선,홍대입구,1505,1688,3193
<class,경의선,서강대,1134,1183,2317
<class,경의선,공덕,1540,1193,2733
<class,2호선,합정,18005,19163,37168
<class,2호선,당산,8068,8735,16803
<class,2호선,영등포구청,7397,7528,14925
<class,2호선,문래,6898,7211,14109
<class,2호선,신도림,27174,27243,54417
<class,2호선,대림,13819,14241,28060
<class,2호선,구로디지털단지,22322,22004,44326
<class,2호선,신대방,13941,13718,27659
<class,2호선,신림,34807,34430,69237
<class,2호선,봉천,11328,11080,22408
<class,2호선,서울대입구,26608,27343,53951
<class,2호선,낙성대,14987,15337,30324
<class,2호선,사당,19066,21489,40555
<class,2호선,방배,6389,6781,13170
<class,2호선,서초,9369,8745,18114
<class,2호선,교대,9682,10610,20292
<class,2호선,강남,33791,32573,66364
<class,2호선,역삼,11014,12118,23132
<class,2호선,선릉,12274,10751,23025
<class,2호선,삼성,19040,18377,37417
<class,2호선,종합운동장,3688,4126,7814
<class,2호선,잠실새내,9967,10467,20434
<class,2호선,잠실,40886,37801,78687
<class,경춘선,굴봉산,128,147,275
<class,경춘선,가평,1146,1287,2433
<class,경춘선,상천,218,178,396
<class,경춘선,청평,1078,1222,2300
<class,경춘선,대성리,381,388,769
<class,경춘선,마석,2529,2577,5106
<class,경춘선,천마산,1135,1112,2247
<class,경춘선,평내호평,3818,3778,7596
<class,경춘선,금곡,902,830,1732
<class,경춘선,사릉,1943,1855,3798
<class,경춘선,퇴계원,2264,2105,4369
<class,경춘선,별내,1721,1726,3447
<class,경춘선,갈매,1620,1392,3012
<class,경춘선,신내,910,857,1767
<class,경인선,도화,2651,2497,5148
<class,경인선,중동,5789,5424,11213
<class,경인선,온수,4320,3992,8312
<class,경인선,도원,1899,1926,3825
<class,경인선,간석,3808,3705,7513
<class,경인선,부개,5628,5187,10815
<class,경인선,소사,7147,6991,14138
<class,경인선,구일,3730,3627,7357
<class,경인선,인천,2579,2270,4849
<class,경인선,동인천,9872,9596,19468
<class,경인선,제물포,6456,6306,12762
<class,경인선,주안,14278,12687,26965
<class,경인선,동암,11063,11540,22603
<class,경인선,백운,4823,4705,9528
<class,경인선,부평,26585,28871,55456
<class,경인선,송내,16293,16187,32480
<class,경인선,부천,25900,26776,52676
<class,경인선,역곡,18224,18015,36239
<class,경인선,오류동,8312,7527,15839
<class,경인선,개봉,14849,14585,29434
<class,경의선,임진강,26,22,48
<class,경의선,문산,3721,3651,7372
<class,경의선,파주,725,566,1291
<class,경의선,월롱,1126,1044,2170
<class,경의선,금촌,4621,4470,9091
<class,경의선,금릉,3063,2974,6037
<class,경의선,운정,4096,3817,7913
<class,경의선,야당,4399,4338,8737
<class,경의선,탄현,4611,4564,9175
<class,경의선,일산,5317,5206,10523
<class,경의선,풍산,3617,3533,7150
<class,경의선,백마,3796,3634,7430
<class,경의선,곡산,335,331,666
<class,경의선,능곡,2380,2304,4684
<class,경의선,행신,4494,4618,9112
<class,경의선,강매,1676,1606,3282
<class,경의선,화전,982,910,1892
<class,경의선,수색,1113,1122,2235
<class,경의선,디지털미디어시티,1757,1500,3257
<class,경의선,가좌,3284,3198,6482
<class,경의선,홍대입구,1663,1776,3439
<class,경의선,서강대,1559,1459,3018
<class,경의선,공덕,2331,1738,4069
<class,경의선,효창공원앞,1619,1731,3350
<class,경의선,신촌,312,327,639
<class,경의선,서울역,1051,1196,2247
<class,중앙선,국수,528,551,1079
<class,중앙선,신원,197,178,375
<class,중앙선,양수,1390,1534,2924
<class,중앙선,운길산,887,847,1734
<class,중앙선,팔당,972,1107,2079
<class,중앙선,도심,1368,1183,2551
<class,중앙선,지평,39,45,84
<class,중앙선,용문,2274,2458,4732
<class,중앙선,원덕,327,415,742
<class,중앙선,양평,1937,2073,4010
<class,중앙선,오빈,212,223,435
<class,중앙선,아신,431,471,902
<class,분당선,복정,1,0,1
<class,중앙선,덕소,3976,4062,8038
<class,중앙선,양정,480,420,900
<class,중앙선,도농,5994,5808,11802
<class,중앙선,구리,9064,9476,18540
<class,중앙선,양원,964,934,1898
<class,중앙선,망우,5312,5140,10452
<class,중앙선,상봉,4332,4351,8683
<class,중앙선,중랑,3844,3777,7621
<class,중앙선,회기,17634,16839,34473
<class,장항선,신창,991,895,1886
<class,장항선,온양온천,3094,3104,6198
<class,장항선,배방,888,771,1659
<class,장항선,아산,2356,2247,4603
<class,장항선,쌍용,1356,1199,2555
<class,장항선,봉명,649,617,1266
<class,일산선,대화,8403,7750,16153
<class,일산선,주엽,5464,5485,10949
<class,일산선,정발산,5295,5453,10748
<class,일산선,마두,4568,4427,8995
<class,일산선,백석,6716,6737,13453
<class,일산선,대곡,1110,928,2038
<class,일산선,화정,11108,11494,22602
<class,일산선,원당,7244,7006,14250
<class,일산선,삼송,11905,11565,23470
<class,일산선,원흥,6005,5815,11820
<class,우이신설선,신설동,1202,1137,2339
<class,우이신설선,보문,999,975,1974
<class,우이신설선,성신여대입구,2514,2870,5384
<class,우이신설선,정릉,3030,2579,5609
<class,우이신설선,북한산보국문,3939,3596,7535
<class,우이신설선,솔샘,3369,2913,6282
<class,우이신설선,삼양사거리,1563,1588,3151
<class,우이신설선,삼양,1312,1348,2660
<class,우이신설선,화계,2060,1973,4033
<class,우이신설선,가오리,2528,2432,4960
<class,우이신설선,4.19민주묘지,1836,1742,3578
<class,우이신설선,솔밭공원,1545,1461,3006
<class,우이신설선,북한산우이,2220,2175,4395
<class,안산선,수리산,2503,2120,4623
<class,안산선,오이도,6323,6467,12790
<class,안산선,정왕,5575,5711,11286
<class,안산선,신길온천,1178,1160,2338
<class,안산선,안산,8489,8894,17383
<class,안산선,초지,2827,2875,5702
<class,안산선,고잔,5607,5629,11236
<class,안산선,중앙,13771,14313,28084
<class,경부선,직산,532,547,1079
<class,안산선,한대앞,6216,6355,12571
<class,안산선,상록수,10991,10924,21915
<class,안산선,반월,3002,2735,5737
<class,안산선,대야미,3357,2899,6256
<class,안산선,산본,10813,11545,22358
<class,수인선,인천,815,1351,2166
<class,수인선,신포,1144,1187,2331
<class,수인선,숭의,2301,2133,4434
<class,수인선,인하대,3825,3511,7336
<class,수인선,송도,1718,1669,3387
<class,수인선,연수,3317,3329,6646
<class,수인선,원인재,3126,3356,6482
<class,수인선,남동인더스파크,953,894,1847
<class,수인선,호구포,2144,2031,4175
<class,수인선,인천논현,3876,4042,7918
<class,수인선,소래포구,3940,4136,8076
<class,수인선,월곶,1778,1767,3545
<class,수인선,달월,38,38,76
<class,수인선,사리,2707,2423,5130
<class,수인선,야목,152,150,302
<class,수인선,어천,514,450,964
<class,수인선,오목천,1699,1430,3129
<class,수인선,고색,1947,2048,3995
<class,분당선,매교,1798,1795,3593
<class,분당선,수원시청,10381,11323,21704
<class,분당선,매탄권선,3143,2980,6123
<class,분당선,망포,8460,7785,16245
<class,분당선,영통,6078,5952,12030
<class,분당선,청명,2494,2423,4917
<class,분당선,상갈,3426,3445,6871
<class,분당선,기흥,5813,5629,11442
<class,분당선,신갈,2474,2467,4941
<class,분당선,구성,2722,2986,5708
<class,분당선,죽전,8944,10018,18962
<class,분당선,보정,1388,1248,2636
<class,분당선,이매,3594,3389,6983
<class,분당선,오리,7020,5742,12762
<class,분당선,미금,9903,10079,19982
<class,분당선,정자,9921,10056,19977
<class,분당선,수내,7867,7411,15278
<class,분당선,서현,16845,16843,33688
<class,분당선,야탑,15462,16295,31757
<class,분당선,모란,14309,14076,28385
<class,분당선,태평,9607,9121,18728
<class,분당선,가천대,4648,5125,9773
<class,분당선,선정릉,3717,3795,7512
<class,분당선,강남구청,5035,6196,11231
<class,분당선,압구정로데오,17013,19183,36196
<class,분당선,서울숲,5537,5791,11328
<class,분당선,수원,7026,5601,12627
<class,분당선,수서,8903,9314,18217
<class,분당선,대모산입구,2067,1891,3958
<class,분당선,개포동,2336,2259,4595
<class,분당선,구룡,1280,1188,2468
<class,분당선,도곡,4147,3760,7907
<class,분당선,한티,10985,10499,21484
<class,분당선,선릉,4634,7207,11841
<class,과천선,범계,18092,17602,35694
<class,과천선,평촌,8519,8288,16807
<class,과천선,인덕원,13439,13293,26732
<class,과천선,정부과천청사,4788,4809,9597
<class,과천선,과천,3458,3276,6734
<class,과천선,대공원,1976,2177,4153
<class,과천선,경마공원,807,804,1611
<class,과천선,선바위,4457,3942,8399
<class,공항철도 1호선,영종,2412,2456,4868
<class,공항철도 1호선,인천공항2터미널,1573,1537,3110
<class,공항철도 1호선,인천공항1터미널,2690,2887,5577
<class,공항철도 1호선,공항화물청사,1250,1281,2531
<class,공항철도 1호선,운서,4846,4841,9687
<class,공항철도 1호선,청라국제도시,3476,3402,6878
<class,공항철도 1호선,검암,4161,4116,8277
<class,공항철도 1호선,계양,5656,5106,10762
<class,공항철도 1호선,김포공항,10348,5485,15833
<class,공항철도 1호선,마곡나루,2363,2705,5068
<class,공항철도 1호선,디지털미디어시티,4739,4396,9135
<class,공항철도 1호선,홍대입구,9816,9950,19766
<class,공항철도 1호선,공덕,1319,1981,3300
<class,공항철도 1호선,서울역,5721,5725,11446
<class,경춘선,춘천,1178,1073,2251
<class,경춘선,남춘천,2019,2088,4107
<class,경춘선,김유정,354,424,778
<class,경춘선,강촌,407,412,819
<class,경원선,양주,5301,5048,10349
<class,경원선,녹양,3027,2911,5938
<class,경원선,소요산,2300,1886,4186
<class,경원선,동두천,1362,1684,3046
<class,경원선,보산,1228,1234,2462
<class,경원선,동두천중앙,2257,2268,4525
<class,경원선,지행,4519,4426,8945
<class,경원선,덕정,3656,3482,7138
<class,경원선,덕계,1859,1734,3593
<class,경원선,가능,4411,4252,8663
<class,경원선,의정부,15045,15888,30933
<class,경원선,회룡,8303,8400,16703
<class,경원선,망월사,4723,4795,9518
<class,경원선,도봉산,5954,3896,9850
<class,경원선,도봉,3895,3679,7574
<class,경원선,방학,6363,6290,12653
<class,경원선,녹천,3092,2565,5657
<class,경원선,월계,3977,3628,7605
<class,경원선,광운대,5060,4934,9994
<class,경원선,석계,5777,6132,11909
<class,경원선,신이문,5495,5105,10600
<class,경원선,외대앞,5562,5381,10943
<class,경원선,청량리,13037,14217,27254
<class,경원선,왕십리,11155,12695,23850
<class,경원선,응봉,1185,1019,2204
<class,경원선,옥수,34,26,60
<class,경원선,한남,2447,2310,4757
<class,경원선,서빙고,1078,1006,2084
<class,경원선,이촌,2536,1919,4455
<class,경부선,광명,2224,2029,4253
<class,경부선,서동탄,935,950,1885
<class,경부선,당정,3618,3488,7106
<class,경부선,천안,5033,5063,10096
<class,경부선,두정,4811,5001,9812
<class,1호선,서울역,24995,24978,49973
<class,1호선,동묘앞,6199,6524,12723
<class,1호선,시청,8285,8603,16888
<class,1호선,종각,15963,14898,30861
<class,1호선,종로3가,18992,18297,37289
<class,1호선,종로5가,15851,16139,31990
<class,1호선,동대문,9067,8191,17258
<class,1호선,신설동,7796,7597,15393
<class,1호선,제기동,12228,12218,24446
<class,1호선,청량리,15458,15631,31089
<class,2호선,시청,7538,6795,14333
<class,2호선,을지로입구,18200,17946,36146
<class,2호선,을지로3가,9196,9017,18213
<class,2호선,을지로4가,6365,6265,12630
<class,2호선,동대문역사문화공원,8716,9256,17972
<class,2호선,신당,9665,9931,19596
<class,2호선,상왕십리,8971,8414,17385
<class,2호선,왕십리,12504,10726,23230
<class,2호선,한양대,3767,3823,7590
<class,2호선,뚝섬,11006,11442,22448
<class,2호선,성수,16117,17817,33934
<class,2호선,건대입구,30222,31891,62113
<class,2호선,구의,14874,14611,29485
<class,2호선,강변,23186,23367,46553
<class,2호선,잠실나루,6444,6200,12644
<class,2호선,잠실,54613,52258,106871
<class,2호선,잠실새내,15090,15869,30959
<class,2호선,종합운동장,4184,4720,8904
<class,2호선,삼성,29590,30542,60132
<class,2호선,선릉,22128,19827,41955
<class,2호선,역삼,18766,20351,39117
<class,2호선,강남,59408,58252,117660
<class,2호선,교대,16234,17942,34176
<class,2호선,서초,9781,8420,18201
<class,2호선,방배,9415,9689,19104
<class,2호선,사당,26370,28941,55311
<class,2호선,낙성대,19508,17868,37376
<class,2호선,서울대입구,34637,33703,68340
<class,2호선,봉천,15657,14448,30105
<class,2호선,신림,45755,42805,88560
<class,2호선,신대방,17828,17272,35100
<class,2호선,구로디지털단지,31924,31765,63689
<class,2호선,대림,16384,17630,34014
<class,2호선,신도림,36919,36929,73848
<class,2호선,문래,10873,11561,22434
<class,2호선,영등포구청,12197,12299,24496
<class,2호선,당산,10985,12202,23187
<class,2호선,합정,24437,26346,50783
<class,2호선,홍대입구,53907,58015,111922
<class,2호선,신촌,27810,27936,55746
<class,2호선,이대,8975,9116,18091
<class,2호선,아현,6773,6529,13302
<class,2호선,충정로,5094,5447,10541
<class,2호선,용답,1859,1783,3642
<class,2호선,신답,846,945,1791
<class,2호선,신설동,2443,2374,4817
<class,2호선,도림천,733,734,1467
<class,2호선,양천구청,3962,4059,8021
<class,2호선,신정네거리,6425,6648,13073
<class,2호선,용두,1509,1556,3065
<class,3호선,지축,2205,2139,4344
<class,3호선,구파발,12620,12770,25390
<class,3호선,연신내,25857,24917,50774
<class,3호선,불광,11077,12063,23140
<class,3호선,녹번,9011,7759,16770
<class,3호선,홍제,11587,10880,22467
<class,3호선,무악재,2454,2445,4899
<class,3호선,독립문,4608,4609,9217
<class,3호선,경복궁,10539,10769,21308
<class,3호선,안국,11202,12822,24024
<class,3호선,종로3가,5040,7188,12228
<class,3호선,을지로3가,4412,4920,9332
<class,3호선,동대입구,5155,5460,10615
<class,3호선,약수,8008,7549,15557
<class,3호선,금호,5401,4958,10359
<class,3호선,옥수,6280,6403,12683
<class,3호선,압구정,22880,23798,46678
<class,3호선,신사,22501,23455,45956
<class,3호선,잠원,3162,3084,6246
<class,3호선,고속터미널,43498,43569,87067
<class,3호선,교대,6239,3744,9983
<class,3호선,남부터미널,19010,19370,38380
<class,3호선,양재,18859,20271,39130
<class,3호선,매봉,5503,5204,10707
<class,3호선,도곡,3215,3242,6457
<class,3호선,대치,8666,7692,16358
<class,3호선,학여울,1038,1032,2070
<class,3호선,대청,5125,4787,9912
<class,3호선,일원,4336,4261,8597
<class,3호선,수서,11371,11508,22879
<class,3호선,가락시장,5742,5556,11298
<class,3호선,경찰병원,3652,3492,7144
<class,3호선,오금,3339,3099,6438
<class,4호선,수유,23874,23743,47617
<class,4호선,미아,9834,9378,19212
<class,4호선,미아사거리,20115,19623,39738
<class,4호선,길음,12690,11801,24491
<class,4호선,성신여대입구,15152,14375,29527
<class,4호선,한성대입구,9316,8950,18266
<class,4호선,혜화,23023,23846,46869
<class,4호선,동대문,12299,12516,24815
<class,4호선,동대문역사문화공원,9589,8381,17970
<class,4호선,충무로,11307,11586,22893
<class,4호선,명동,10113,11554,21667
<class,4호선,회현,14496,15319,29815
<class,4호선,서울역,4585,9501,14086
<class,4호선,숙대입구,8245,7916,16161
<class,4호선,삼각지,2648,3393,6041
<class,4호선,신용산,8317,8858,17175
<class,4호선,이촌,5192,5678,10870
<class,4호선,동작,1483,1581,3064
<class,4호선,총신대입구,12605,13624,26229
<class,4호선,사당,17782,15228,33010
<class,4호선,남태령,789,562,1351
<class,4호선,당고개,8580,8276,16856
<class,4호선,상계,12420,11712,24132
<class,4호선,노원,14468,15722,30190
<class,4호선,창동,17319,18275,35594
<class,4호선,쌍문,19250,17490,36740
<class,5호선,방화,4069,3905,7974
<class,5호선,개화산,3210,3131,6341
<class,5호선,김포공항,6674,6998,13672
<class,5호선,송정,4505,4324,8829
<class,5호선,마곡,4499,4458,8957
<class,5호선,발산,12170,12602,24772
<class,5호선,우장산,8671,8555,17226
<class,5호선,화곡,17946,16498,34444
<class,5호선,까치산,18783,18181,36964
<class,5호선,신정,8266,7091,15357
<class,5호선,목동,10251,10394,20645
<class,5호선,오목교,14807,15316,30123
<class,5호선,양평,3382,3264,6646
<class,5호선,영등포구청,1778,1762,3540
<class,5호선,영등포시장,6558,6818,13376
<class,5호선,신길,2332,2428,4760
<class,5호선,여의도,12025,11858,23883
<class,5호선,여의나루,6956,9555,16511
<class,5호선,마포,6804,6824,13628
<class,5호선,공덕,6604,6865,13469
<class,5호선,애오개,3448,3310,6758
<class,5호선,충정로,2068,1848,3916
<class,5호선,서대문,6364,6124,12488
<class,5호선,광화문,11918,12209,24127
<class,5호선,종로3가,10386,10200,20586
<class,5호선,을지로4가,2875,3118,5993
<class,5호선,동대문역사문화공원,963,1168,2131
<class,5호선,청구,2385,2237,4622
<class,5호선,신금호,3652,3703,7355
<class,5호선,행당,5042,4377,9419
<class,5호선,왕십리,3154,3582,6736
<class,5호선,마장,3439,3265,6704
<class,5호선,답십리,9422,8594,18016
<class,5호선,장한평,9783,9749,19532
<class,5호선,군자,7540,8480,16020
<class,5호선,아차산,10327,10133,20460
<class,5호선,광나루,8460,7894,16354
<class,5호선,천호,14836,14036,28872
<class,5호선,강동,12347,11337,23684
<class,5호선,길동,5273,5403,10676
<class,5호선,굽은다리,6429,6044,12473
<class,5호선,명일,5122,5176,10298
<class,5호선,고덕,5292,5069,10361
<class,5호선,상일동,9565,8933,18498
<class,5호선,둔촌동,5682,5694,11376
<class,5호선,올림픽공원,2407,2174,4581
<class,5호선,방이,4832,4775,9607
<class,5호선,오금,1970,1791,3761
<class,5호선,개롱,3836,4015,7851
<class,5호선,거여,5050,4781,9831
<class,5호선,마천,3855,3962,7817
<class,5호선,미사,8803,8786,17589
<class,5호선,하남풍산,3205,3532,6737
<class,6호선,응암,11025,11177,22202
<class,6호선,역촌,2260,2638,4898
<class,6호선,불광,3450,3125,6575
<class,6호선,독바위,1689,1785,3474
<class,6호선,구산,4817,3688,8505
<class,6호선,새절,7947,7566,15513
<class,6호선,증산,6717,6599,13316
<class,6호선,디지털미디어시티,6262,6372,12634
<class,6호선,월드컵경기장,3073,3283,6356
<class,6호선,마포구청,8381,7343,15724
<class,6호선,망원,11152,12267,23419
<class,6호선,합정,11015,10143,21158
<class,6호선,상수,6854,7946,14800
<class,6호선,광흥창,4731,4406,9137
<class,6호선,대흥,4902,4902,9804
<class,6호선,공덕,8960,8423,17383
<class,6호선,효창공원앞,4210,3798,8008
<class,6호선,삼각지,4261,3557,7818
<class,6호선,녹사평,4246,4534,8780
<class,6호선,이태원,10579,10920,21499
<class,6호선,한강진,6907,8369,15276
<class,6호선,버티고개,1363,1335,2698
<class,6호선,약수,2074,2256,4330
<class,6호선,청구,2366,2346,4712
<class,6호선,신당,5259,4356,9615
<class,6호선,동묘앞,5971,5621,11592
<class,6호선,창신,1994,1571,3565
<class,6호선,보문,4629,4103,8732
<class,6호선,안암,6511,6263,12774
<class,6호선,고려대,5027,4608,9635
<class,6호선,월곡,6778,6658,13436
<class,6호선,상월곡,3748,3297,7045
<class,6호선,돌곶이,5385,5102,10487
<class,6호선,석계,7844,7835,15679
<class,6호선,태릉입구,3599,3949,7548
<class,6호선,화랑대,6017,4987,11004
<class,6호선,봉화산,4755,4612,9367
<class,7호선,장암,1226,725,1951
<class,7호선,도봉산,5022,6792,11814
<class,7호선,수락산,8796,8756,17552
<class,7호선,마들,7853,7409,15262
<class,7호선,노원,14491,14754,29245
<class,7호선,중계,8279,7418,15697
<class,7호선,하계,10956,10258,21214
<class,7호선,공릉,7980,7890,15870
<class,7호선,태릉입구,5812,5217,11029
<class,7호선,먹골,7363,7293,14656
<class,7호선,중화,7193,6819,14012
<class,7호선,상봉,12126,11525,23651
<class,7호선,면목,10048,9951,19999
<class,7호선,사가정,11180,10917,22097
<class,7호선,용마산,4145,4024,8169
<class,7호선,중곡,6097,5677,11774
<class,7호선,군자,9827,7390,17217
<class,7호선,어린이대공원,7531,7102,14633
<class,7호선,건대입구,9586,9621,19207
<class,7호선,뚝섬유원지,5011,4829,9840
<class,7호선,청담,10840,11524,22364
<class,7호선,강남구청,9645,10500,20145
<class,7호선,학동,10479,11192,21671
<class,7호선,논현,10698,11563,22261
<class,7호선,반포,4015,3806,7821
<class,7호선,고속터미널,12287,9563,21850
<class,7호선,내방,7454,7417,14871
<class,7호선,이수,11122,10472,21594
<class,7호선,남성,7125,6676,13801
<class,7호선,숭실대입구,7472,7262,14734
<class,7호선,상도,6577,6209,12786
<class,7호선,장승배기,6438,6124,12562
<class,7호선,신대방삼거리,10127,9486,19613
<class,7호선,보라매,5345,5155,10500
<class,7호선,신풍,7374,7144,14518
<class,7호선,대림,6334,6789,13123
<class,7호선,남구로,8032,8545,16577
<class,7호선,가산디지털단지,13763,12694,26457
<class,7호선,철산,13598,13798,27396
<class,7호선,광명사거리,15160,15036,30196
<class,7호선,천왕,6092,5647,11739
<class,7호선,온수,5153,5119,10272
<class,7호선,까치울,4745,4691,9436
<class,7호선,부천종합운동장,3324,2827,6151
<class,7호선,춘의,4704,4583,9287
<class,7호선,신중동,8880,8787,17667
<class,7호선,부천시청,8291,8068,16359
<class,7호선,상동,9012,9329,18341
<class,7호선,삼산체육관,2817,2653,5470
<class,7호선,굴포천,5749,5949,11698
<class,7호선,부평구청,6248,5591,11839
<class,8호선,암사,11224,10325,21549
<class,8호선,천호,11491,13280,24771
<class,8호선,강동구청,5581,5709,11290
<class,8호선,몽촌토성,3443,3481,6924
<class,8호선,잠실,11232,12933,24165
<class,8호선,석촌,5324,6433,11757
<class,8호선,송파,5165,5134,10299
<class,8호선,가락시장,5344,5351,10695
<class,8호선,문정,8115,8335,16450
<class,8호선,장지,11613,10972,22585
<class,8호선,복정,6303,5549,11852
<class,8호선,산성,4270,4238,8508
<class,8호선,남한산성입구,7888,7053,14941
<class,8호선,단대오거리,6705,6284,12989
<class,8호선,신흥,3280,3564,6844
<class,8호선,수진,3699,3330,7029
<class,8호선,모란,3048,2652,5700
<class,9호선,개화,1209,1016,2225
<class,9호선,김포공항,6961,11769,18730
<class,9호선,공항시장,2079,2113,4192
<class,9호선,신방화,4285,4092,8377
<class,9호선,마곡나루,6890,7055,13945
<class,9호선,양천향교,5373,5158,10531
<class,9호선,가양,12680,11990,24670
<class,9호선,증미,3875,3759,7634
<class,9호선,등촌,6523,6359,12882
<class,9호선,염창,10245,9614,19859
<class,9호선,신목동,1937,1648,3585
<class,9호선,선유도,3266,3253,6519
<class,9호선,당산,11804,10899,22703
<class,9호선,국회의사당,4006,4270,8276
<class,9호선,여의도,11777,10649,22426
<class,9호선,샛강,2348,2356,4704
<class,9호선,노량진,19395,19243,38638
<class,9호선,노들,2750,2315,5065
<class,9호선,흑석,4905,4877,9782
<class,9호선,동작,1138,906,2044
<class,9호선,구반포,2047,2141,4188
<class,9호선,신반포,2100,2004,4104
<class,9호선,고속터미널,10339,15133,25472
<class,9호선,사평,1880,1786,3666
<class,9호선,신논현,24447,24179,48626
<class,9호선2~3단계,언주,6025,5797,11822
<class,9호선2~3단계,선정릉,4751,5241,9992
<class,9호선2~3단계,삼성중앙,2867,2880,5747
<class,9호선2~3단계,봉은사,10875,11403,22278
<class,9호선2~3단계,종합운동장,3070,2648,5718
<class,9호선2~3단계,삼전,4349,4111,8460
<class,9호선2~3단계,석촌고분,3837,3661,7498
<class,9호선2~3단계,석촌,5807,4834,10641
<class,9호선2~3단계,송파나루,3541,3845,7386
<class,9호선2~3단계,한성백제,1490,1335,2825
<class,9호선2~3단계,올림픽공원,3380,3249,6629
<class,9호선2~3단계,둔촌오륜,611,571,1182
<class,9호선2~3단계,중앙보훈병원,3808,3473,7281
<class,경강선,판교,2576,2345,4921
<class,경강선,이매,652,560,1212
<class,경강선,삼동,1301,1225,2526
<class,경강선,경기광주,4300,4117,8417
<class,경강선,초월,1862,1718,3580
<class,경강선,곤지암,1486,1605,3091
<class,경강선,신둔도예촌,879,852,1731
<class,경강선,이천,2100,2233,4333
<class,경강선,부발,1475,1358,2833
<class,경강선,세종대왕릉,239,247,486
<class,경강선,여주,1569,1818,3387
<class,경부선,서울역,4549,1396,5945
<class,경부선,남영,5617,5733,11350
<class,경부선,용산,27238,29119,56357
<class,경부선,노량진,7508,6890,14398
<class,경부선,대방,7161,7248,14409
<class,경부선,영등포,35681,37094,72775
<class,경부선,신도림,2415,2620,5035
<class,경부선,신길,5741,4738,10479
<class,경부선,구로,12561,12963,25524
<class,경부선,가산디지털단지,5502,7474,12976
<class,경부선,금천구청,7253,7400,14653
<class,경부선,석수,5948,5311,11259
<class,경부선,관악,4935,4795,9730
<class,경부선,안양,16247,16435,32682
<class,경부선,명학,4867,4688,9555
<class,경부선,금정,16289,16301,32590
<class,경부선,군포,4097,3771,7868
<class,경부선,의왕,5100,5060,10160
<class,경부선,성균관대,9375,9222,18597
<class,경부선,화서,4534,4558,9092
<class,경부선,수원,33497,36256,69753
<class,경부선,독산,7678,7671,15349
<class,경부선,세류,2118,2180,4298
<class,경부선,병점,10247,10081,20328
<class,경부선,세마,1857,1668,3525
<class,경부선,오산대,2195,2054,4249
<class,경부선,오산,8162,7709,15871
<class,경부선,진위,915,790,1705
<class,경부선,송탄,4076,3846,7922
<class,경부선,서정리,5444,4389,9833
<class,경부선,지제,2294,2222,4516
<class,경부선,평택,11218,10671,21889
<class,경부선,성환,2561,2351,4912
<class,경춘선,백양리,105,122,227
<class,분당선,죽전,7351,8538,15889
<class,1호선,서울역,22852,20681,43533
<class,1호선,동묘앞,12226,12557,24783
<class,1호선,종각,11362,9662,21024
<class,1호선,종로3가,13218,11970,25188
<class,1호선,종로5가,8537,8409,16946
<class,1호선,동대문,8468,9229,17697
<class,1호선,신설동,6758,6898,13656
<class,1호선,제기동,9841,10338,20179
<class,1호선,청량리,13071,12858,25929
<class,2호선,시청,5205,4214,9419
<class,2호선,을지로입구,13823,12986,26809
<class,2호선,을지로3가,6617,6047,12664
<class,2호선,을지로4가,2975,2834,5809
<class,2호선,동대문역사문화공원,6401,7707,14108
<class,2호선,신당,7587,8003,15590
<class,2호선,상왕십리,6446,6354,12800
<class,2호선,왕십리,8911,7755,16666
<class,2호선,한양대,2454,2636,5090
<class,2호선,성수,12169,13283,25452
<class,2호선,건대입구,25481,25766,51247
<class,2호선,구의,10460,10573,21033
<class,2호선,강변,19310,19229,38539
<class,2호선,잠실나루,5367,5509,10876
<class,2호선,잠실,42409,39373,81782
<class,2호선,잠실새내,9963,10237,20200
<class,2호선,종합운동장,3630,4129,7759
<class,2호선,삼성,20972,20642,41614
<class,2호선,선릉,12219,10869,23088
<class,2호선,역삼,11626,12396,24022
<class,2호선,강남,34376,33107,67483
<class,2호선,교대,9908,11141,21049
<class,2호선,서초,9908,9208,19116
<class,2호선,방배,6429,6834,13263
<class,2호선,뚝섬,8549,9094,17643
<class,2호선,사당,20072,22047,42119
<class,2호선,낙성대,14959,15621,30580
<class,2호선,서울대입구,26340,27113,53453
<class,2호선,봉천,11832,11328,23160
<class,2호선,신림,34889,34177,69066
<class,2호선,신대방,14155,14141,28296
<class,2호선,구로디지털단지,22863,22496,45359
<class,2호선,대림,13829,14188,28017
<class,2호선,신도림,26615,26772,53387
<class,2호선,문래,7109,7370,14479
<class,2호선,영등포구청,8239,8428,16667
<class,2호선,당산,8068,9032,17100
<class,2호선,합정,18723,19851,38574
<class,2호선,홍대입구,45513,44339,89852
<class,2호선,신촌,21696,20859,42555
<class,2호선,이대,6346,6795,13141
<class,2호선,아현,4750,4894,9644
<class,2호선,충정로,3582,3800,7382
<class,2호선,용답,1596,1669,3265
<class,2호선,신답,702,765,1467
<class,2호선,신설동,2953,2814,5767
<class,2호선,도림천,463,499,962
<class,2호선,양천구청,3039,3151,6190
<class,2호선,신정네거리,4802,4879,9681
<class,2호선,용두,1129,1126,2255
<class,3호선,지축,1740,1599,3339
<class,3호선,구파발,10972,11355,22327
<class,3호선,연신내,20560,19380,39940
<class,3호선,불광,9458,10760,20218
<class,3호선,녹번,6592,6002,12594
<class,3호선,홍제,8597,8421,17018
<class,3호선,무악재,1824,2025,3849
<class,3호선,독립문,3840,4480,8320
<class,3호선,경복궁,9662,9717,19379
<class,3호선,안국,9842,10761,20603
<class,3호선,종로3가,3749,4840,8589
<class,3호선,을지로3가,2659,2643,5302
<class,3호선,동대입구,4426,4942,9368
<class,3호선,금호,4148,3911,8059
<class,3호선,옥수,4865,5216,10081
<class,3호선,압구정,12479,12968,25447
<class,3호선,신사,13232,13080,26312
<class,3호선,잠원,2140,2204,4344
<class,3호선,고속터미널,37132,34791,71923
<class,3호선,교대,3935,2405,6340
<class,3호선,남부터미널,13185,13979,27164
<class,3호선,양재,12282,14399,26681
<class,3호선,매봉,3871,3856,7727
<class,3호선,도곡,1838,1911,3749
<class,3호선,대치,5394,4898,10292
<class,3호선,학여울,687,693,1380
<class,3호선,대청,3638,3626,7264
<class,3호선,일원,2982,3106,6088
<class,3호선,수서,9383,9360,18743
<class,3호선,가락시장,3681,3911,7592
<class,3호선,경찰병원,2542,2608,5150
<class,3호선,오금,2595,2527,5122
<class,4호선,수유,18552,17918,36470
<class,4호선,미아,7507,7304,14811
<class,4호선,미아사거리,15221,14608,29829
<class,4호선,길음,9359,9086,18445
<class,4호선,성신여대입구,11754,11603,23357
<class,4호선,한성대입구,7156,7127,14283
<class,4호선,혜화,18996,19703,38699
<class,4호선,동대문,6477,7069,13546
<class,4호선,동대문역사문화공원,7989,7691,15680
<class,4호선,충무로,7602,7686,15288
<class,4호선,명동,9108,9157,18265
<class,4호선,회현,7518,7530,15048
<class,4호선,서울역,3670,7701,11371
<class,4호선,숙대입구,6280,6078,12358
<class,4호선,삼각지,1828,2387,4215
<class,4호선,신용산,6795,6901,13696
<class,4호선,이촌,3913,4536,8449
<class,4호선,동작,1518,1544,3062
<class,4호선,총신대입구,9339,10175,19514
<class,4호선,사당,13405,12731,26136
<class,4호선,남태령,560,456,1016
<class,4호선,당고개,7321,6915,14236
<class,4호선,상계,9553,9074,18627
<class,4호선,노원,10847,11565,22412
<class,4호선,창동,13843,14570,28413
<class,4호선,쌍문,14672,13422,28094
<class,5호선,방화,3304,3338,6642
<class,일산선,화정,8847,8983,17830
<class,일산선,원당,5817,5610,11427
<class,일산선,삼송,9501,9317,18818
<class,일산선,원흥,4670,4444,9114
<class,중앙선,지평,51,60,111
<class,중앙선,용문,1791,1499,3290
<class,중앙선,원덕,456,395,851
<class,중앙선,양평,1970,1688,3658
<class,중앙선,오빈,165,168,333
<class,중앙선,아신,518,468,986
<class,중앙선,국수,630,559,1189
<class,중앙선,신원,353,277,630
<class,중앙선,양수,1899,1561,3460
<class,중앙선,운길산,1392,1189,2581
<class,중앙선,팔당,1353,1492,2845
<class,중앙선,도심,1106,988,2094
<class,중앙선,덕소,3079,3115,6194
<class,중앙선,양정,493,432,925
<class,중앙선,도농,4324,4285,8609
<class,중앙선,구리,7030,7372,14402
<class,중앙선,양원,799,855,1654
<class,중앙선,망우,4213,4303,8516
<class,중앙선,상봉,3690,3645,7335
<class,중앙선,중랑,3140,3079,6219
<class,중앙선,회기,14489,14654,29143
<class,장항선,신창,898,1236,2134
<class,장항선,온양온천,3035,3025,6060
<class,장항선,배방,711,847,1558
<class,장항선,아산,2781,1860,4641
<class,장항선,쌍용,1059,1148,2207
<class,장항선,봉명,475,498,973
<class,일산선,대화,6615,6169,12784
<class,일산선,주엽,4043,3935,7978
<class,일산선,정발산,4670,4461,9131
<class,일산선,마두,3212,3236,6448
<class,일산선,백석,5434,5170,10604
<class,일산선,대곡,1012,828,1840
<class,1호선,시청,6338,6294,12632
<class,5호선,개화산,2472,2613,5085
<class,5호선,김포공항,6800,6506,13306
<class,5호선,송정,3509,3401,6910
<class,5호선,마곡,3155,3285,6440
<class,5호선,발산,8467,8739,17206
<class,5호선,우장산,6162,6321,12483
<class,5호선,화곡,13142,12339,25481
<class,5호선,까치산,14641,14356,28997
<class,5호선,신정,6006,5442,11448
<class,5호선,목동,7254,7582,14836
<class,5호선,오목교,11109,11285,22394
<class,5호선,양평,2469,2560,5029
<class,5호선,영등포구청,1357,1338,2695
<class,5호선,영등포시장,4523,4809,9332
<class,5호선,신길,1618,2023,3641
<class,5호선,여의도,9210,8624,17834
<class,5호선,여의나루,9111,11442,20553
<class,5호선,마포,4376,4406,8782
<class,5호선,공덕,4308,4312,8620
<class,5호선,애오개,2485,2578,5063
<class,5호선,충정로,1522,1496,3018
<class,5호선,서대문,4414,4311,8725
<class,5호선,광화문,10120,9840,19960
<class,5호선,종로3가,8427,7512,15939
<class,5호선,을지로4가,1288,1422,2710
<class,5호선,동대문역사문화공원,616,747,1363
<class,5호선,청구,1627,1559,3186
<class,5호선,신금호,2653,2838,5491
<class,5호선,행당,3556,3339,6895
<class,5호선,왕십리,2341,2637,4978
<class,5호선,마장,2693,2469,5162
<class,5호선,답십리,6722,6380,13102
<class,5호선,장한평,6740,6789,13529
<class,5호선,군자,5538,6130,11668
<class,5호선,아차산,10257,10265,20522
<class,5호선,광나루,6932,6802,13734
<class,5호선,천호,11736,11046,22782
<class,5호선,강동,9075,8916,17991
<class,5호선,길동,3791,3882,7673
<class,5호선,굽은다리,5042,4690,9732
<class,5호선,명일,4047,4049,8096
<class,5호선,고덕,3852,3975,7827
<class,5호선,상일동,6915,6792,13707
<class,5호선,둔촌동,4279,4324,8603
<class,5호선,올림픽공원,1918,1677,3595
<class,5호선,방이,3644,3503,7147
<class,5호선,오금,1475,1381,2856
<class,5호선,개롱,2715,2975,5690
<class,5호선,거여,3376,3421,6797
<class,5호선,마천,3182,3374,6556
<class,5호선,미사,6794,6641,13435
<class,5호선,하남풍산,2545,2694,5239
<class,6호선,응암,8726,8756,17482
<class,6호선,역촌,1762,2044,3806
<class,6호선,불광,2996,2647,5643
<class,6호선,독바위,1546,1955,3501
<class,6호선,구산,3491,2862,6353
<class,6호선,새절,6163,5915,12078
<class,6호선,증산,5189,5318,10507
<class,6호선,디지털미디어시티,4695,5056,9751
<class,6호선,월드컵경기장,3273,3376,6649
<class,6호선,마포구청,6494,6149,12643
<class,6호선,망원,9175,9868,19043
<class,6호선,합정,8835,7947,16782
<class,6호선,상수,5450,5982,11432
<class,6호선,광흥창,4029,3943,7972
<class,6호선,대흥,3323,3618,6941
<class,6호선,공덕,6350,5935,12285
<class,6호선,효창공원앞,2971,2814,5785
<class,6호선,삼각지,3146,2483,5629
<class,6호선,녹사평,3542,3540,7082
<class,6호선,이태원,8950,8405,17355
<class,6호선,한강진,6059,6861,12920
<class,6호선,버티고개,1039,1126,2165
<class,6호선,약수,1531,1537,3068
<class,6호선,청구,1598,1606,3204
<class,6호선,신당,3137,3878,7015
<class,6호선,동묘앞,6195,5744,11939
<class,6호선,창신,1587,1437,3024
<class,6호선,보문,3640,3525,7165
<class,6호선,안암,5186,5606,10792
<class,6호선,고려대,3828,3684,7512
<class,6호선,월곡,5168,5167,10335
<class,6호선,상월곡,3017,2731,5748
<class,6호선,돌곶이,4476,4128,8604
<class,6호선,석계,6115,6182,12297
<class,6호선,태릉입구,2849,3016,5865
<class,6호선,화랑대,4678,4063,8741
<class,6호선,봉화산,3679,3617,7296
<class,7호선,장암,1312,1001,2313
<class,7호선,도봉산,4876,7440,12316
<class,7호선,수락산,8199,7991,16190
<class,7호선,마들,5449,5115,10564
<class,7호선,노원,10188,10057,20245
<class,7호선,중계,6242,5712,11954
<class,7호선,하계,8356,7906,16262
<class,7호선,공릉,6141,6286,12427
<class,7호선,태릉입구,4328,4009,8337
<class,7호선,먹골,5150,5124,10274
<class,7호선,중화,5334,5285,10619
<class,7호선,상봉,9165,8418,17583
<class,7호선,면목,7392,7475,14867
<class,7호선,사가정,8757,8397,17154
<class,7호선,용마산,3012,3566,6578
<class,7호선,중곡,4730,4637,9367
<class,7호선,군자,7167,5626,12793
<class,7호선,어린이대공원,7937,7761,15698
<class,7호선,건대입구,8118,8187,16305
<class,7호선,뚝섬유원지,5935,5574,11509
<class,7호선,청담,6680,7130,13810
<class,7호선,강남구청,5582,5967,11549
<class,7호선,학동,5737,6184,11921
<class,7호선,논현,5990,6558,12548
<class,7호선,반포,2680,2693,5373
<class,7호선,고속터미널,11170,7381,18551
<class,7호선,내방,4757,4964,9721
<class,7호선,이수,7925,7546,15471
<class,7호선,남성,5028,5182,10210
<class,7호선,숭실대입구,5453,5836,11289
<class,7호선,상도,4822,4876,9698
<class,7호선,장승배기,4631,4625,9256
<class,7호선,신대방삼거리,7182,7204,14386
<class,7호선,보라매,3842,3878,7720
<class,7호선,신풍,5550,5193,10743
<class,7호선,대림,6418,5843,12261
<class,7호선,남구로,6492,6302,12794
<class,7호선,가산디지털단지,10586,9807,20393
<class,7호선,철산,9804,9813,19617
<class,7호선,광명사거리,11667,11498,23165
<class,7호선,천왕,4525,4332,8857
<class,7호선,온수,3657,3702,7359
<class,7호선,까치울,3950,3762,7712
<class,7호선,부천종합운동장,2861,2622,5483
<class,7호선,춘의,3183,2994,6177
<class,7호선,신중동,6314,6237,12551
<class,7호선,부천시청,6451,6227,12678
<class,7호선,상동,6804,6562,13366
<class,7호선,삼산체육관,2178,2156,4334
<class,7호선,굴포천,4308,4260,8568
<class,7호선,부평구청,4769,4220,8989
<class,8호선,암사,8524,8038,16562
<class,8호선,천호,8608,9873,18481
<class,8호선,강동구청,4156,4344,8500
<class,8호선,몽촌토성,2936,2784,5720
<class,8호선,잠실,9107,9950,19057
<class,8호선,석촌,4096,4819,8915
<class,8호선,송파,3393,3582,6975
<class,8호선,가락시장,3181,4011,7192
<class,8호선,문정,5220,5480,10700
<class,8호선,장지,8924,9081,18005
<class,8호선,복정,4707,4445,9152
<class,8호선,산성,3477,3523,7000
<class,8호선,남한산성입구,6314,5936,12250
<class,8호선,단대오거리,5024,5000,10024
<class,8호선,신흥,2555,2799,5354
<class,8호선,수진,2728,2488,5216
<class,8호선,모란,2416,1999,4415
<class,9호선,개화,1006,881,1887
<class,9호선,김포공항,6728,10943,17671
<class,9호선,공항시장,1556,1724,3280
<class,9호선,신방화,3268,3215,6483
<class,9호선,마곡나루,5363,5286,10649
<class,9호선,양천향교,4006,4142,8148
<class,9호선,가양,9511,9561,19072
<class,9호선,증미,2870,2905,5775
<class,9호선,등촌,4728,4990,9718
<class,9호선,염창,7732,7878,15610
<class,9호선,신목동,1542,1358,2900
<class,9호선,선유도,2431,2483,4914
<class,9호선,당산,8229,8068,16297
<class,9호선,국회의사당,4100,3905,8005
<class,9호선,여의도,9640,7973,17613
<class,9호선,샛강,1714,1601,3315
<class,9호선,노량진,13885,14559,28444
<class,9호선,노들,2237,2074,4311
<class,9호선,흑석,3485,3770,7255
<class,9호선,동작,1020,871,1891
<class,9호선,구반포,1079,1135,2214
<class,9호선,신반포,1461,1502,2963
<class,9호선,고속터미널,8751,12145,20896
<class,9호선,사평,1248,1296,2544
<class,9호선,신논현,14748,13956,28704
<class,9호선2~3단계,언주,3614,3589,7203
<class,9호선2~3단계,선정릉,2954,3415,6369
<class,9호선2~3단계,삼성중앙,1723,1794,3517
<class,9호선2~3단계,봉은사,7559,7613,15172
<class,9호선2~3단계,종합운동장,2002,1771,3773
<class,9호선2~3단계,삼전,3298,3342,6640
<class,9호선2~3단계,석촌고분,2792,2758,5550
<class,9호선2~3단계,석촌,4180,3645,7825
<class,9호선2~3단계,송파나루,2716,2958,5674
<class,9호선2~3단계,한성백제,1258,1179,2437
<class,9호선2~3단계,올림픽공원,2734,2700,5434
<class,9호선2~3단계,둔촌오륜,397,415,812
<class,9호선2~3단계,중앙보훈병원,2912,2745,5657
<class,경강선,판교,2107,1921,4028
<class,경강선,이매,536,510,1046
<class,경강선,삼동,1037,917,1954
<class,경강선,경기광주,3315,3356,6671
<class,경강선,초월,1418,1436,2854
<class,경강선,곤지암,1218,1426,2644
<class,경강선,신둔도예촌,714,804,1518
<class,경강선,이천,1757,1940,3697
<class,경강선,부발,1079,1570,2649
<class,경강선,세종대왕릉,271,237,508
<class,경강선,여주,1840,1643,3483
<class,경부선,서울역,5506,1207,6713
<class,경부선,남영,3848,4181,8029
<class,경부선,용산,26472,23985,50457
<class,경부선,노량진,5647,5505,11152
<class,경부선,대방,5725,6010,11735
<class,경부선,영등포,30587,29365,59952
<class,경부선,신도림,1997,1999,3996
<class,경부선,신길,4567,3941,8508
<class,경부선,구로,9454,9493,18947
<class,경부선,가산디지털단지,4192,5919,10111
<class,경부선,금천구청,5868,5700,11568
<class,경부선,석수,4895,4905,9800
<class,경부선,관악,4728,4254,8982
<class,경부선,안양,12727,12347,25074
<class,경부선,명학,3148,3111,6259
<class,경부선,금정,12461,12601,25062
<class,경부선,군포,2852,2677,5529
<class,경부선,의왕,3793,3890,7683
<class,경부선,성균관대,6961,7512,14473
<class,경부선,화서,3512,3364,6876
<class,경부선,수원,31577,30503,62080
<class,경부선,독산,5461,5678,11139
<class,경부선,세류,1760,1858,3618
<class,경부선,병점,8087,9145,17232
<class,경부선,세마,1536,1423,2959
<class,경부선,오산대,1873,1906,3779
<class,경부선,오산,6819,7367,14186
<class,경부선,진위,702,723,1425
<class,경부선,송탄,3284,3683,6967
<class,경부선,서정리,3591,5228,8819
<class,경부선,지제,2074,1827,3901
<class,경부선,평택,9964,10714,20678
<class,경부선,성환,2198,2716,4914
<class,경부선,직산,534,560,1094
<class,경부선,두정,3969,4477,8446
<class,경부선,천안,5240,5028,10268
<class,경부선,당정,2847,2876,5723
<class,경부선,서동탄,754,740,1494
<class,경부선,광명,2098,1463,3561
<class,경원선,이촌,2102,1648,3750
<class,경원선,서빙고,1135,1135,2270
<class,경원선,한남,1809,1805,3614
<class,경원선,옥수,65,22,87
<class,경원선,응봉,1244,1341,2585
<class,경원선,왕십리,8838,9894,18732
<class,경원선,청량리,11986,11795,23781
<class,경원선,외대앞,4459,4555,9014
<class,경원선,신이문,4333,4211,8544
<class,경원선,석계,4609,5032,9641
<class,경원선,광운대,4081,4246,8327
<class,경원선,월계,3460,3264,6724
<class,경원선,녹천,2405,2032,4437
<class,경원선,방학,5363,5133,10496
<class,경원선,도봉,3228,3049,6277
<class,경원선,도봉산,8592,5952,14544
<class,경원선,망월사,4097,4309,8406
<class,경원선,회룡,6730,6631,13361
<class,경원선,의정부,12794,12837,25631
<class,경원선,가능,3613,3402,7015
<class,경원선,녹양,2536,2482,5018
<class,경원선,양주,4632,4687,9319
<class,경원선,덕계,1525,1519,3044
<class,경원선,덕정,2959,2988,5947
<class,경원선,지행,3807,3751,7558
<class,경원선,동두천중앙,1831,1726,3557
<class,경원선,보산,1142,1125,2267
<class,경원선,동두천,1185,1548,2733
<class,경원선,소요산,3256,2722,5978
<class,경의선,서울역,937,932,1869
<class,경의선,신촌,247,253,500
<class,경의선,효창공원앞,1192,1442,2634
<class,경의선,공덕,1624,1242,2866
<class,경의선,서강대,1147,1185,2332
<class,경의선,홍대입구,1336,1648,2984
<class,경의선,가좌,2471,2508,4979
<class,경의선,디지털미디어시티,1273,1166,2439
<class,경의선,수색,844,868,1712
<class,경의선,화전,753,793,1546
<class,경의선,강매,1285,1240,2525
<class,경의선,행신,3870,3623,7493
<class,경의선,능곡,2012,1990,4002
<class,경의선,곡산,326,301,627
<class,경의선,백마,2980,2920,5900
<class,경의선,풍산,3151,3026,6177
<class,경의선,일산,4200,3967,8167
<class,경의선,탄현,3755,3551,7306
<class,경의선,야당,3624,3398,7022
<class,경의선,운정,3181,3091,6272
<class,경의선,금릉,2387,2329,4716
<class,경의선,금촌,4099,4324,8423
<class,경의선,월롱,717,1237,1954
<class,경의선,파주,596,548,1144
<class,경의선,문산,3220,3133,6353
<class,경의선,임진강,47,39,86
<class,경인선,개봉,10751,10888,21639
<class,경인선,오류동,6665,6365,13030
<class,경인선,역곡,13675,13582,27257
<class,경인선,부천,20914,20761,41675
<class,경인선,송내,12397,12006,24403
<class,경인선,부평,22301,22412,44713
<class,경인선,백운,3733,3724,7457
<class,경인선,동암,9024,8825,17849
<class,경인선,주안,11080,9876,20956
<class,경인선,제물포,5118,4992,10110
<class,경인선,동인천,8507,8092,16599
<class,경인선,인천,3270,2587,5857
<class,경인선,구일,2974,2984,5958
<class,경인선,소사,5471,5168,10639
<class,경인선,부개,4286,4049,8335
<class,경인선,간석,2964,2709,5673
<class,경인선,도원,1685,1743,3428
<class,경인선,온수,3477,3306,6783
<class,경인선,중동,4356,4152,8508
<class,경인선,도화,2195,2067,4262
<class,경춘선,신내,767,771,1538
<class,경춘선,갈매,1377,1160,2537
<class,경춘선,별내,1463,1391,2854
<class,경춘선,퇴계원,1885,1739,3624
<class,경춘선,사릉,1625,1647,3272
<class,경춘선,금곡,815,753,1568
<class,경춘선,평내호평,3187,3053,6240
<class,경춘선,천마산,983,905,1888
<class,경춘선,마석,2361,2219,4580
<class,경춘선,대성리,471,379,850
<class,경춘선,청평,1321,1062,2383
<class,경춘선,상천,331,284,615
<class,경춘선,가평,1296,1094,2390
<class,경춘선,굴봉산,158,152,310
<class,경춘선,백양리,88,96,184
<class,경춘선,강촌,608,575,1183
<class,경춘선,김유정,420,423,843
<class,경춘선,남춘천,1974,2313,4287
<class,경춘선,춘천,1234,1312,2546
<class,공항철도 1호선,서울역,6058,5414,11472
<class,공항철도 1호선,공덕,1021,1388,2409
<class,공항철도 1호선,홍대입구,8268,7749,16017
<class,공항철도 1호선,디지털미디어시티,3203,3315,6518
<class,공항철도 1호선,마곡나루,1812,2229,4041
<class,공항철도 1호선,김포공항,10801,5745,16546
<class,공항철도 1호선,계양,4500,4278,8778
<class,공항철도 1호선,검암,3477,3679,7156
<class,공항철도 1호선,청라국제도시,2787,2642,5429
<class,공항철도 1호선,운서,4293,4575,8868
<class,공항철도 1호선,공항화물청사,934,998,1932
<class,공항철도 1호선,인천공항1터미널,2852,2768,5620
<class,공항철도 1호선,인천공항2터미널,1471,1349,2820
<class,공항철도 1호선,영종,2239,2062,4301
<class,과천선,선바위,3302,3099,6401
<class,과천선,경마공원,873,890,1763
<class,과천선,대공원,3583,3814,7397
<class,과천선,과천,2891,2571,5462
<class,과천선,정부과천청사,3740,4043,7783
<class,과천선,인덕원,10042,9963,20005
<class,과천선,평촌,5494,5343,10837
<class,과천선,범계,13181,12425,25606
<class,분당선,선릉,2747,4049,6796
<class,분당선,한티,7330,7098,14428
<class,분당선,도곡,2557,2510,5067
<class,분당선,구룡,709,785,1494
<class,분당선,개포동,1876,1859,3735
<class,분당선,대모산입구,1461,1361,2822
<class,분당선,수서,7677,7316,14993
<class,분당선,수원,5643,4688,10331
<class,분당선,서울숲,4754,4707,9461
<class,분당선,압구정로데오,10173,10909,21082
<class,분당선,강남구청,3068,3836,6904
<class,분당선,선정릉,2094,2281,4375
<class,분당선,가천대,3372,4199,7571
<class,분당선,태평,7303,6944,14247
<class,분당선,모란,10379,10473,20852
<class,분당선,야탑,12154,12522,24676
<class,분당선,서현,12983,12828,25811
<class,분당선,수내,5572,5421,10993
<class,분당선,정자,6773,7203,13976
<class,분당선,미금,6829,7222,14051
<class,분당선,오리,5094,4499,9593
<class,분당선,이매,2722,2756,5478
<class,분당선,보정,1008,894,1902
<class,3호선,약수,6171,5871,12042
<class,분당선,구성,2098,2318,4416
<class,분당선,신갈,1821,1866,3687
<class,분당선,기흥,4681,4460,9141
<class,분당선,상갈,2689,2734,5423
<class,분당선,청명,1802,1891,3693
<class,분당선,영통,4462,4527,8989
<class,분당선,망포,5719,6143,11862
<class,분당선,매탄권선,2394,2320,4714
<class,분당선,수원시청,7065,7037,14102
<class,분당선,매교,1293,1351,2644
<class,수인선,고색,1410,1491,2901
<class,수인선,오목천,1197,1152,2349
<class,수인선,어천,448,499,947
<class,수인선,야목,126,106,232
<class,수인선,사리,2232,1944,4176
<class,수인선,달월,52,57,109
<class,수인선,월곶,1556,1387,2943
<class,수인선,소래포구,4374,4345,8719
<class,수인선,인천논현,2953,3013,5966
<class,수인선,호구포,1754,1865,3619
<class,수인선,남동인더스파크,655,642,1297
<class,수인선,원인재,2573,2690,5263
<class,수인선,연수,2792,2644,5436
<class,수인선,송도,1524,1453,2977
<class,수인선,인하대,3156,3004,6160
<class,수인선,숭의,1783,1671,3454
<class,수인선,신포,1073,1105,2178
<class,수인선,인천,995,1523,2518
<class,안산선,산본,8104,8560,16664
<class,안산선,대야미,2830,2601,5431
<class,안산선,반월,2278,2327,4605
<class,안산선,상록수,8611,8538,17149
<class,안산선,한대앞,4883,4801,9684
<class,안산선,중앙,11369,11230,22599
<class,안산선,고잔,4191,4106,8297
<class,안산선,초지,2093,2045,4138
<class,안산선,안산,9334,8344,17678
<class,안산선,신길온천,1030,951,1981
<class,안산선,정왕,4687,5280,9967
<class,안산선,오이도,5551,5548,11099
<class,안산선,수리산,1983,1959,3942
<class,우이신설선,북한산우이,2977,3109,6086
<class,우이신설선,솔밭공원,1369,1335,2704
<class,우이신설선,4.19민주묘지,1881,1670,3551
<class,우이신설선,가오리,2212,2147,4359
<class,우이신설선,화계,1928,1868,3796
<class,우이신설선,삼양,1199,1182,2381
<class,우이신설선,삼양사거리,1377,1357,2734
<class,우이신설선,솔샘,2556,2394,4950
<class,우이신설선,북한산보국문,3561,3231,6792
<class,우이신설선,정릉,2475,2228,4703
<class,우이신설선,성신여대입구,2255,2368,4623
<class,우이신설선,보문,852,852,1704
<class,우이신설선,신설동,1084,1089,2173
<class,5호선,영등포시장,6581,6976,13557
<class,5호선,신길,2275,2545,4820
<class,5호선,여의도,13563,11933,25496
<class,5호선,여의나루,5903,9876,15779
<class,5호선,마포,7048,7199,14247
<class,5호선,공덕,6703,7197,13900
<class,5호선,애오개,3576,3445,7021
<class,5호선,충정로,1852,1665,3517
<class,5호선,서대문,6598,6366,12964
<class,5호선,광화문,12969,12906,25875
<class,5호선,종로3가,10714,10255,20969
<class,5호선,을지로4가,3029,3375,6404
<class,5호선,동대문역사문화공원,990,1151,2141
<class,5호선,청구,2333,2314,4647
<class,5호선,신금호,3675,3735,7410
<class,5호선,행당,5211,4691,9902
<class,5호선,왕십리,3281,3583,6864
<class,5호선,마장,3601,3480,7081
<class,5호선,답십리,9612,8796,18408
<class,5호선,장한평,10010,9896,19906
<class,5호선,군자,7788,8425,16213
<class,5호선,아차산,11665,11367,23032
<class,5호선,광나루,8997,8458,17455
<class,5호선,천호,15950,14687,30637
<class,5호선,강동,12026,11582,23608
<class,5호선,길동,5800,5990,11790
<class,5호선,굽은다리,6585,6286,12871
<class,5호선,명일,5698,5687,11385
<class,5호선,고덕,5567,5448,11015
<class,공항철도 1호선,인천공항1터미널,2600,2782,5382
<class,공항철도 1호선,공항화물청사,1182,1264,2446
<class,공항철도 1호선,운서,4735,4776,9511
<class,공항철도 1호선,청라국제도시,3384,3294,6678
<class,공항철도 1호선,검암,4001,3996,7997
<class,공항철도 1호선,계양,5711,5167,10878
<class,공항철도 1호선,김포공항,11071,5423,16494
<class,공항철도 1호선,마곡나루,2363,2613,4976
<class,공항철도 1호선,디지털미디어시티,4752,4414,9166
<class,공항철도 1호선,홍대입구,8860,8712,17572
<class,공항철도 1호선,공덕,1400,2246,3646
<class,공항철도 1호선,서울역,5833,7061,12894
<class,경춘선,춘천,1128,1066,2194
<class,경춘선,남춘천,2425,2485,4910
<class,경춘선,김유정,323,399,722
<class,경춘선,강촌,432,488,920
<class,경춘선,백양리,104,101,205
<class,경춘선,굴봉산,127,148,275
<class,경춘선,가평,1108,1256,2364
<class,경춘선,상천,217,221,438
<class,경춘선,청평,1247,1252,2499
<class,경춘선,대성리,413,381,794
<class,경춘선,마석,2617,2625,5242
<class,경춘선,천마산,1142,1190,2332
<class,경춘선,평내호평,3941,3853,7794
<class,경춘선,금곡,871,871,1742
<class,경춘선,사릉,1982,1944,3926
<class,경춘선,퇴계원,2212,2126,4338
<class,경춘선,별내,1743,1705,3448
<class,경춘선,갈매,1671,1492,3163
<class,경춘선,신내,872,872,1744
<class,경인선,도화,2746,2545,5291
<class,경인선,중동,5886,5736,11622
<class,경인선,온수,4373,4169,8542
<class,경인선,도원,1748,1798,3546
<class,경인선,간석,3824,3782,7606
<class,경인선,부개,5511,5275,10786
<class,경인선,소사,7033,6954,13987
<class,경인선,구일,3754,3735,7489
<class,우이신설선,솔밭공원,1576,1473,3049
<class,경인선,인천,2761,2153,4914
<class,경인선,동인천,9776,9734,19510
<class,경인선,제물포,6558,6406,12964
<class,경인선,주안,13995,12397,26392
<class,경인선,동암,11100,11359,22459
<class,경인선,백운,4814,4882,9696
<class,경인선,부평,26834,28707,55541
<class,경인선,송내,16498,16647,33145
<class,경인선,부천,25925,26469,52394
<class,경인선,역곡,18097,17848,35945
<class,경인선,오류동,8084,7513,15597
<class,경인선,개봉,14644,14928,29572
<class,경의선,임진강,20,23,43
<class,경의선,문산,3724,3570,7294
<class,우이신설선,북한산우이,2353,2464,4817
<class,안산선,수리산,2412,2121,4533
<class,안산선,오이도,6199,6385,12584
<class,안산선,정왕,5380,5519,10899
<class,안산선,신길온천,1105,1107,2212
<class,안산선,안산,8199,8570,16769
<class,안산선,초지,2823,2878,5701
<class,안산선,고잔,5585,5556,11141
<class,안산선,중앙,13702,14001,27703
<class,안산선,한대앞,6197,6114,12311
<class,안산선,상록수,10866,10925,21791
<class,안산선,반월,2987,2794,5781
<class,안산선,대야미,3359,2970,6329
<class,안산선,산본,10904,11476,22380
<class,수인선,인천,803,1426,2229
<class,수인선,신포,1093,1137,2230
<class,수인선,숭의,2241,2157,4398
<class,수인선,인하대,3668,3426,7094
<class,수인선,송도,1716,1682,3398
<class,수인선,연수,3264,3273,6537
<class,수인선,원인재,3062,3284,6346
<class,수인선,남동인더스파크,985,939,1924
<class,수인선,호구포,2237,2131,4368
<class,수인선,인천논현,3847,3992,7839
<class,수인선,소래포구,4280,4452,8732
<class,수인선,월곶,1772,1783,3555
<class,수인선,달월,56,48,104
<class,수인선,사리,2659,2524,5183
<class,수인선,야목,165,136,301
<class,수인선,어천,521,448,969
<class,수인선,오목천,1686,1459,3145
<class,경의선,파주,757,577,1334
<class,수인선,고색,1879,1907,3786
<class,분당선,매교,1755,1766,3521
<class,분당선,수원시청,10309,10920,21229
<class,분당선,매탄권선,2992,2922,5914
<class,분당선,망포,8439,7713,16152
<class,분당선,영통,5954,5959,11913
<class,분당선,청명,2361,2363,4724
<class,경의선,월롱,1099,1050,2149
<class,분당선,상갈,3385,3366,6751
<class,분당선,기흥,5902,5830,11732
<class,분당선,신갈,2490,2476,4966
<class,분당선,구성,2781,2962,5743
<class,분당선,죽전,8906,10041,18947
<class,분당선,보정,1471,1379,2850
<class,분당선,이매,3796,3679,7475
<class,분당선,오리,6853,5912,12765
<class,분당선,미금,9850,10285,20135
<class,분당선,정자,10097,10385,20482
<class,분당선,수내,8067,7701,15768
<class,분당선,서현,16681,16760,33441
<class,분당선,야탑,15596,16263,31859
<class,분당선,모란,14453,14190,28643
<class,분당선,태평,9779,9113,18892
<class,분당선,가천대,4513,5004,9517
<class,분당선,선정릉,3536,3555,7091
<class,분당선,강남구청,5040,6030,11070
<class,분당선,압구정로데오,16787,18301,35088
<class,분당선,서울숲,5369,5566,10935
<class,분당선,수원,6626,5591,12217
<class,분당선,수서,9071,9739,18810
<class,분당선,대모산입구,2325,2074,4399
<class,분당선,개포동,2471,2349,4820
<class,분당선,구룡,1103,1075,2178
<class,분당선,도곡,4050,3748,7798
<class,분당선,한티,11189,10848,22037
<class,분당선,선릉,4991,7445,12436
<class,과천선,범계,18277,17704,35981
<class,과천선,평촌,8233,8217,16450
<class,과천선,인덕원,13639,13637,27276
<class,과천선,정부과천청사,5192,5102,10294
<class,과천선,과천,3859,3656,7515
<class,과천선,대공원,2563,2776,5339
<class,과천선,경마공원,881,864,1745
<class,6호선,약수,2211,2147,4358
<class,경원선,월계,4020,3838,7858
<class,경원선,광운대,5123,5067,10190
<class,경원선,석계,6118,6198,12316
<class,경원선,신이문,5557,5180,10737
<class,경원선,외대앞,5573,5451,11024
<class,경원선,청량리,13296,14717,28013
<class,경원선,왕십리,11234,12631,23865
<class,경원선,응봉,1880,1880,3760
<class,과천선,선바위,4514,3983,8497
<class,공항철도 1호선,영종,2351,2363,4714
<class,공항철도 1호선,인천공항2터미널,1557,1473,3030
<class,경의선,금촌,4621,4446,9067
<class,경의선,금릉,3067,2951,6018
<class,경의선,운정,3843,3678,7521
<class,경의선,야당,4360,4218,8578
<class,경의선,탄현,4673,4651,9324
<class,경의선,일산,5358,5178,10536
<class,경의선,풍산,3603,3536,7139
<class,경의선,백마,3859,3705,7564
<class,경의선,곡산,369,375,744
<class,경의선,능곡,2512,2392,4904
<class,경의선,행신,4566,4610,9176
<class,경의선,강매,1608,1494,3102
<class,경의선,화전,939,871,1810
<class,경의선,수색,1121,1118,2239
<class,우이신설선,4.19민주묘지,2005,1897,3902
<class,경의선,디지털미디어시티,1540,1489,3029
<class,경의선,가좌,3450,3353,6803
<class,경의선,홍대입구,1442,1746,3188
<class,경의선,서강대,1452,1446,2898
<class,경의선,공덕,2713,1888,4601
<class,경의선,효창공원앞,1491,1690,3181
<class,경의선,신촌,325,337,662
<class,경의선,서울역,1082,1176,2258
<class,경원선,소요산,2528,2213,4741
<class,경원선,동두천,1432,1719,3151
<class,경원선,보산,1392,1277,2669
<class,경원선,동두천중앙,2149,2232,4381
<class,경원선,지행,4613,4558,9171
<class,경원선,덕정,3871,3694,7565
<class,경원선,덕계,1993,1778,3771
<class,경원선,양주,5462,5246,10708
<class,경원선,녹양,3111,3022,6133
<class,경원선,가능,4361,4290,8651
<class,경원선,의정부,15766,16134,31900
<class,경원선,회룡,8346,8427,16773
<class,경원선,망월사,4841,4958,9799
<class,경원선,도봉산,6669,4382,11051
<class,경원선,도봉,3942,3876,7818
<class,경원선,옥수,40,21,61
<class,경원선,한남,2544,2389,4933
<class,경원선,서빙고,1150,1054,2204
<class,경원선,이촌,2560,1988,4548
<class,경부선,광명,2202,2103,4305
<class,경부선,서동탄,934,970,1904
<class,경부선,당정,3601,3581,7182
<class,경원선,방학,6565,6499,13064
<class,경부선,천안,5237,5345,10582
<class,경부선,두정,4640,4730,9370
<class,경부선,직산,558,563,1121
<class,경부선,성환,2527,2362,4889
<class,경부선,평택,11161,10596,21757
<class,경부선,지제,2349,2325,4674
<class,경부선,서정리,5511,4671,10182
<class,경부선,송탄,3946,3560,7506
<class,경부선,진위,902,802,1704
<class,경부선,오산,8240,7801,16041
<class,경부선,오산대,2281,2054,4335
<class,경부선,세마,1916,1701,3617
<class,경부선,병점,10261,10096,20357
<class,5호선,상일동,9283,8758,18041
<class,경부선,세류,2234,2208,4442
<class,중앙선,용문,1519,1641,3160
<class,경부선,독산,7695,7742,15437
<class,경부선,수원,32611,34715,67326
<class,경부선,화서,4585,4604,9189
<class,경부선,성균관대,9200,9066,18266
<class,경부선,의왕,5150,5091,10241
<class,경부선,군포,3779,3583,7362
<class,경부선,금정,16420,16286,32706
<class,경부선,명학,4800,4681,9481
<class,경부선,안양,16174,16310,32484
<class,경부선,관악,5234,4969,10203
<class,경부선,석수,6134,5736,11870
<class,경부선,금천구청,7295,7323,14618
<class,경부선,가산디지털단지,5227,7218,12445
<class,경부선,구로,12405,12834,25239
<class,경부선,신길,5766,4791,10557
<class,경부선,신도림,2270,2383,4653
<class,경부선,영등포,37538,38489,76027
<class,경부선,대방,7481,7656,15137
<class,경부선,노량진,7447,7038,14485
<class,경부선,용산,28050,29327,57377
<class,경부선,남영,5326,5454,10780
<class,경부선,서울역,5016,1536,6552
<class,경강선,여주,1659,1909,3568
<class,경강선,세종대왕릉,254,276,530
<class,경강선,부발,1552,1346,2898
<class,경강선,이천,2132,2228,4360
<class,경강선,신둔도예촌,877,893,1770
<class,경강선,곤지암,1538,1635,3173
<class,경강선,초월,1835,1705,3540
<class,경강선,경기광주,4414,4096,8510
<class,경강선,삼동,1263,1272,2535
<class,경강선,이매,661,569,1230
<class,경강선,판교,2533,2459,4992
<class,9호선2~3단계,중앙보훈병원,3923,3485,7408
<class,9호선2~3단계,둔촌오륜,650,595,1245
<class,9호선2~3단계,올림픽공원,3295,3187,6482
<class,9호선2~3단계,한성백제,1559,1371,2930
<class,9호선2~3단계,송파나루,3836,4011,7847
<class,9호선2~3단계,석촌,5737,4685,10422
<class,9호선2~3단계,석촌고분,3929,3822,7751
<class,9호선2~3단계,삼전,4475,4250,8725
<class,9호선2~3단계,종합운동장,3340,2755,6095
<class,9호선2~3단계,봉은사,10134,10291,20425
<class,9호선2~3단계,삼성중앙,2927,2928,5855
<class,9호선2~3단계,선정릉,4534,5195,9729
<class,9호선2~3단계,언주,5560,5556,11116
<class,9호선,신논현,24521,23781,48302
<class,9호선,사평,2007,1973,3980
<class,9호선,고속터미널,10571,15353,25924
<class,9호선,신반포,2175,2169,4344
<class,9호선,구반포,1865,1981,3846
<class,9호선,동작,1207,972,2179
<class,9호선,흑석,5193,5276,10469
<class,9호선,노들,2796,2520,5316
<class,9호선,노량진,19898,19519,39417
<class,9호선,샛강,2440,2459,4899
<class,9호선,여의도,12800,11115,23915
<class,9호선,국회의사당,3910,4196,8106
<class,9호선,당산,11951,10946,22897
<class,중앙선,원덕,404,482,886
<class,9호선,선유도,3300,3400,6700
<class,9호선,신목동,1990,1883,3873
<class,9호선,염창,10454,9962,20416
<class,9호선,등촌,6695,6542,13237
<class,9호선,증미,3783,3824,7607
<class,9호선,가양,12556,11875,24431
<class,9호선,양천향교,5450,5269,10719
<class,9호선,마곡나루,6942,6806,13748
<class,9호선,신방화,4311,4322,8633
<class,9호선,공항시장,2077,2179,4256
<class,9호선,김포공항,7279,11281,18560
<class,9호선,개화,1328,1095,2423
<class,8호선,모란,3292,2810,6102
<class,8호선,수진,3829,3540,7369
<class,8호선,신흥,3481,3633,7114
<class,8호선,단대오거리,6842,6470,13312
<class,8호선,남한산성입구,8258,7619,15877
<class,8호선,산성,4363,4538,8901
<class,5호선,둔촌동,5826,5737,11563
<class,5호선,올림픽공원,2485,2251,4736
<class,5호선,방이,5054,4922,9976
<class,5호선,오금,2089,1900,3989
<class,5호선,개롱,3961,4297,8258
<class,5호선,거여,5185,4950,10135
<class,8호선,복정,6425,5578,12003
<class,8호선,장지,11807,11078,22885
<class,8호선,문정,8355,8448,16803
<class,8호선,가락시장,5336,5429,10765
<class,8호선,송파,5084,5340,10424
<class,8호선,석촌,5583,6528,12111
<class,8호선,잠실,12369,13811,26180
<class,8호선,몽촌토성,3887,3869,7756
<class,8호선,강동구청,5745,5831,11576
<class,8호선,천호,11405,13514,24919
<class,8호선,암사,11610,10839,22449
<class,7호선,부평구청,6401,5601,12002
<class,7호선,굴포천,5804,6147,11951
<class,7호선,삼산체육관,3222,3044,6266
<class,7호선,상동,9360,9401,18761
<class,7호선,부천시청,8635,8440,17075
<class,7호선,신중동,8771,8833,17604
<class,우이신설선,가오리,2668,2575,5243
<class,우이신설선,화계,2222,2093,4315
<class,우이신설선,삼양,1324,1400,2724
<class,우이신설선,삼양사거리,1682,1656,3338
<class,우이신설선,솔샘,3462,3035,6497
<class,우이신설선,북한산보국문,4173,3745,7918
<class,우이신설선,정릉,3026,2620,5646
<class,우이신설선,성신여대입구,2587,2778,5365
<class,우이신설선,보문,1027,1103,2130
<class,우이신설선,신설동,1212,1213,2425
<class,일산선,원흥,6181,5908,12089
<class,일산선,지축,1,0,1
<class,일산선,삼송,12208,11900,24108
<class,일산선,원당,7313,7102,14415
<class,일산선,화정,11510,11974,23484
<class,일산선,대곡,1122,934,2056
<class,일산선,백석,6725,7001,13726
<class,일산선,마두,4562,4775,9337
<class,일산선,정발산,5480,5535,11015
<class,일산선,주엽,5622,5609,11231
<class,일산선,대화,7864,7334,15198
<class,장항선,봉명,652,589,1241
<class,장항선,쌍용,1334,1230,2564
<class,장항선,아산,2335,2350,4685
<class,장항선,배방,812,715,1527
<class,장항선,온양온천,3096,3061,6157
<class,장항선,신창,994,863,1857
<class,중앙선,회기,18099,17153,35252
<class,중앙선,중랑,4008,3885,7893
<class,중앙선,상봉,4435,4530,8965
<class,중앙선,망우,5482,5399,10881
<class,중앙선,양원,986,1017,2003
<class,중앙선,구리,9069,9507,18576
<class,중앙선,도농,6044,5965,12009
<class,중앙선,양정,557,442,999
<class,중앙선,덕소,3906,3933,7839
<class,중앙선,도심,1347,1250,2597
<class,중앙선,팔당,1086,1033,2119
<class,중앙선,운길산,951,958,1909
<class,중앙선,양수,1545,1566,3111
<class,중앙선,신원,233,217,450
<class,중앙선,국수,513,550,1063
<class,중앙선,아신,454,456,910
<class,중앙선,오빈,210,251,461
<class,중앙선,양평,2004,2176,4180
<class,7호선,춘의,4722,4593,9315
<class,7호선,부천종합운동장,2982,2712,5694
<class,7호선,까치울,4721,4723,9444
<class,7호선,온수,5287,5209,10496
<class,7호선,천왕,6406,6060,12466
<class,7호선,광명사거리,15214,15178,30392
<class,7호선,철산,13598,14005,27603
<class,7호선,가산디지털단지,13775,12624,26399
<class,7호선,남구로,7978,8499,16477
<class,7호선,대림,6241,6774,13015
<class,7호선,신풍,7488,7332,14820
<class,7호선,보라매,5526,5355,10881
<class,7호선,신대방삼거리,10416,9721,20137
<class,7호선,장승배기,6201,6134,12335
<class,7호선,상도,6815,6302,13117
<class,7호선,숭실대입구,7455,7530,14985
<class,7호선,남성,7220,6823,14043
<class,7호선,이수,12201,11498,23699
<class,7호선,내방,7760,7602,15362
<class,7호선,고속터미널,12348,9881,22229
<class,7호선,반포,4041,3722,7763
<class,7호선,논현,10640,11614,22254
<class,7호선,학동,10261,10761,21022
<class,7호선,강남구청,9099,9959,19058
<class,7호선,청담,10845,11737,22582
<class,7호선,뚝섬유원지,4780,4744,9524
<class,7호선,건대입구,9965,10132,20097
<class,7호선,어린이대공원,7996,7645,15641
<class,7호선,군자,9904,7681,17585
<class,7호선,중곡,6162,6047,12209
<class,7호선,용마산,4021,4167,8188
<class,7호선,사가정,11502,11226,22728
<class,7호선,면목,10360,10316,20676
<class,7호선,상봉,12321,11648,23969
<class,7호선,중화,7315,6968,14283
<class,7호선,먹골,7501,7440,14941
<class,7호선,태릉입구,5974,5318,11292
<class,7호선,공릉,8214,8074,16288
<class,7호선,하계,11482,10766,22248
<class,7호선,중계,8872,7969,16841
<class,7호선,노원,14703,14795,29498
<class,7호선,마들,8055,7745,15800
<class,7호선,수락산,9182,8963,18145
<class,7호선,도봉산,5488,7308,12796
<class,7호선,장암,1209,810,2019
<class,6호선,신내,1,0,1
<class,6호선,봉화산,4733,4638,9371
<class,6호선,화랑대,6032,5113,11145
<class,6호선,태릉입구,3632,3930,7562
<class,6호선,석계,7976,8011,15987
<class,6호선,돌곶이,5414,4991,10405
<class,6호선,상월곡,3803,3328,7131
<class,6호선,월곡,6776,6656,13432
<class,6호선,고려대,4935,4796,9731
<class,6호선,안암,6473,6016,12489
<class,6호선,보문,4601,4217,8818
<class,6호선,창신,2132,1811,3943
<class,6호선,동묘앞,6289,5742,12031
<class,6호선,신당,6035,4959,10994
<class,6호선,청구,2370,2436,4806
<class,6호선,버티고개,1380,1465,2845
<class,6호선,한강진,6668,7815,14483
<class,6호선,이태원,9970,10415,20385
<class,6호선,녹사평,4105,4216,8321
<class,6호선,삼각지,4138,3393,7531
<class,6호선,효창공원앞,4105,3716,7821
<class,6호선,공덕,9285,8782,18067
<class,6호선,대흥,4736,4933,9669
<class,6호선,광흥창,4715,4476,9191
<class,6호선,상수,7179,8099,15278
<class,6호선,합정,10866,10015,20881
<class,6호선,망원,11361,12128,23489
<class,6호선,마포구청,8422,7783,16205
<class,6호선,월드컵경기장,3332,3477,6809
<class,6호선,디지털미디어시티,6367,6624,12991
<class,6호선,증산,6684,6605,13289
<class,6호선,새절,7983,7863,15846
<class,6호선,구산,4967,3928,8895
<class,6호선,독바위,1824,2067,3891
<class,6호선,불광,3695,3283,6978
<class,6호선,역촌,2431,2885,5316
<class,6호선,응암,11391,11337,22728
<class,5호선,하남검단산,6883,7075,13958
<class,5호선,하남시청,4765,4691,9456
<class,5호선,하남풍산,2936,2872,5808
<class,5호선,미사,10413,10280,20693
<class,5호선,강일,2496,2533,5029
<class,5호선,마천,4034,4257,8291
<class,1호선,서울역,25680,26331,52011
<class,1호선,동묘앞,7132,7581,14713
<class,1호선,시청,8497,9087,17584
<class,1호선,종각,16772,15535,32307
<class,1호선,종로3가,19115,18466,37581
<class,1호선,종로5가,17214,16689,33903
<class,1호선,동대문,9446,8542,17988
<class,1호선,신설동,8130,7824,15954
<class,1호선,제기동,13115,13249,26364
<class,1호선,청량리,16525,16482,33007
<class,2호선,시청,7621,6427,14048
<class,2호선,을지로입구,17999,17922,35921
<class,2호선,을지로3가,8933,8804,17737
<class,2호선,을지로4가,6252,6418,12670
<class,2호선,동대문역사문화공원,8675,9579,18254
<class,2호선,신당,9756,10230,19986
<class,중앙선,지평,49,53,102
<class,2호선,상왕십리,9064,8580,17644
<class,2호선,왕십리,12665,10745,23410
<class,2호선,한양대,3275,3104,6379
<class,2호선,뚝섬,11234,11439,22673
<class,2호선,성수,15429,16793,32222
<class,2호선,건대입구,30071,31422,61493
<class,2호선,구의,14727,14626,29353
<class,2호선,강변,23234,23658,46892
<class,2호선,잠실나루,6650,6536,13186
<class,2호선,잠실,54645,52199,106844
<class,2호선,잠실새내,15423,15894,31317
<class,2호선,종합운동장,4373,5121,9494
<class,2호선,삼성,28502,28704,57206
<class,2호선,선릉,22528,20323,42851
<class,2호선,역삼,19437,20718,40155
<class,2호선,강남,58994,57950,116944
<class,2호선,교대,16135,17815,33950
<class,2호선,서초,10079,8736,18815
<class,2호선,방배,9307,9511,18818
<class,2호선,사당,26439,28947,55386
<class,2호선,낙성대,19418,18074,37492
<class,2호선,서울대입구,34618,33042,67660
<class,2호선,봉천,15704,14656,30360
<class,2호선,신림,45280,43400,88680
<class,2호선,신대방,17782,17445,35227
<class,2호선,구로디지털단지,31733,31574,63307
<class,2호선,대림,16075,17095,33170
<class,2호선,신도림,37784,38077,75861
<class,경원선,녹천,2802,2434,5236
<class,2호선,문래,10801,11249,22050
<class,2호선,영등포구청,11857,12280,24137
<class,2호선,당산,10757,12162,22919
<class,2호선,합정,23892,25181,49073
<class,2호선,홍대입구,51026,53740,104766
<class,2호선,신촌,27702,28000,55702
<class,2호선,이대,9030,9277,18307
<class,2호선,아현,6874,6647,13521
<class,2호선,충정로,5109,5484,10593
<class,2호선,용답,1930,1890,3820
<class,2호선,신답,910,935,1845
<class,2호선,신설동,2601,2534,5135
<class,2호선,도림천,781,735,1516
<class,2호선,양천구청,3957,4237,8194
<class,2호선,신정네거리,6677,6811,13488
<class,2호선,용두,1476,1524,3000
<class,3호선,지축,2251,2185,4436
<class,3호선,구파발,12905,12806,25711
<class,3호선,연신내,26402,25184,51586
<class,3호선,불광,11397,12492,23889
<class,3호선,녹번,8939,7936,16875
<class,3호선,홍제,11998,11350,23348
<class,3호선,무악재,2429,2478,4907
<class,3호선,독립문,4992,5263,10255
<class,3호선,경복궁,11350,11109,22459
<class,3호선,안국,12418,13641,26059
<class,3호선,종로3가,5241,7011,12252
<class,3호선,을지로3가,4474,4789,9263
<class,3호선,충무로,1,0,1
<class,3호선,동대입구,5322,5811,11133
<class,3호선,약수,8323,7844,16167
<class,3호선,금호,5612,5235,10847
<class,3호선,옥수,6318,6520,12838
<class,3호선,압구정,23244,24268,47512
<class,3호선,신사,22961,23227,46188
<class,3호선,잠원,3064,2985,6049
<class,3호선,고속터미널,44464,44664,89128
<class,3호선,교대,6074,3777,9851
<class,3호선,남부터미널,19770,20157,39927
<class,3호선,양재,19287,20615,39902
<class,3호선,매봉,5673,5493,11166
<class,3호선,도곡,3353,3301,6654
<class,3호선,대치,8890,7782,16672
<class,3호선,학여울,1624,1705,3329
<class,3호선,대청,5094,4848,9942
<class,3호선,일원,4269,4278,8547
<class,3호선,수서,11836,12278,24114
<class,3호선,가락시장,5880,5452,11332
<class,3호선,경찰병원,3825,3762,7587
<class,3호선,오금,3510,3245,6755
<class,4호선,수유,24120,23797,47917
<class,4호선,미아,9737,9388,19125
<class,4호선,미아사거리,19943,19455,39398
<class,4호선,길음,12871,12290,25161
<class,4호선,성신여대입구,15147,14490,29637
<class,4호선,한성대입구,9341,8955,18296
<class,4호선,혜화,23229,23371,46600
<class,4호선,동대문,12529,12513,25042
<class,4호선,동대문역사문화공원,10164,8526,18690
<class,4호선,충무로,11911,12081,23992
<class,4호선,명동,9908,11216,21124
<class,4호선,회현,15394,15569,30963
<class,4호선,서울역,4752,10188,14940
<class,4호선,숙대입구,8299,8049,16348
<class,4호선,삼각지,2695,3595,6290
<class,4호선,신용산,8009,8843,16852
<class,4호선,이촌,5360,5891,11251
<class,4호선,동작,1510,1581,3091
<class,4호선,총신대입구,12634,13622,26256
<class,4호선,사당,18154,15611,33765
<class,4호선,남태령,885,684,1569
<class,4호선,당고개,8682,8280,16962
<class,4호선,상계,12415,11933,24348
<class,4호선,노원,14834,15793,30627
<class,4호선,창동,17262,18499,35761
<class,4호선,쌍문,19501,17975,37476
<class,5호선,방화,4454,4250,8704
<class,5호선,개화산,3401,3352,6753
<class,5호선,김포공항,7121,7222,14343
<class,5호선,송정,4752,4560,9312
<class,5호선,마곡,4576,4645,9221
<class,5호선,발산,12000,12343,24343
<class,5호선,우장산,8696,8833,17529
<class,5호선,화곡,18128,16895,35023
<class,5호선,까치산,19040,18478,37518
<class,5호선,신정,8346,7246,15592
<class,5호선,목동,10281,10449,20730
<class,5호선,오목교,15468,15763,31231
<class,5호선,양평,3372,3397,6769
<class,5호선,영등포구청,1826,1777,3603
<class,경의선,공덕,1426,1116,2542
<class,경의선,신촌,234,234,468
<class,경의선,서울역,857,729,1586
<class,경원선,소요산,2238,1898,4136
<class,경원선,동두천,1089,1322,2411
<class,경원선,보산,1141,1152,2293
<class,경원선,동두천중앙,1676,1604,3280
<class,경원선,지행,3578,3458,7036
<class,경원선,덕정,2694,2802,5496
<class,경원선,덕계,1316,1284,2600
<class,경원선,양주,3798,3813,7611
<class,경원선,녹양,2238,2121,4359
<class,경원선,가능,3341,3173,6514
<class,경원선,의정부,11865,12026,23891
<class,경원선,회룡,6198,6045,12243
<class,경원선,망월사,3517,3699,7216
<class,경원선,도봉산,5362,3575,8937
<class,경원선,도봉,2839,2709,5548
<class,경원선,방학,4632,4374,9006
<class,경원선,창동,1,0,1
<class,경원선,녹천,2293,2055,4348
<class,경원선,월계,3043,2802,5845
<class,경원선,광운대,3771,3826,7597
<class,경원선,석계,4130,4567,8697
<class,경원선,신이문,3996,3786,7782
<class,경원선,외대앞,4734,4790,9524
<class,경원선,청량리,10351,10356,20707
<class,경원선,왕십리,7492,8527,16019
<class,경원선,응봉,998,1035,2033
<class,경원선,옥수,50,11,61
<class,경원선,한남,1667,1620,3287
<class,경원선,서빙고,1120,1083,2203
<class,경원선,이촌,1856,1478,3334
<class,경부선,광명,2194,1437,3631
<class,경부선,서동탄,668,634,1302
<class,경부선,당정,2601,2591,5192
<class,경부선,천안,5011,4712,9723
<class,경부선,두정,3910,4389,8299
<class,경부선,직산,448,486,934
<class,경부선,성환,2171,2606,4777
<class,경부선,평택,9598,10204,19802
<class,경부선,지제,1883,1677,3560
<class,경부선,서정리,3444,4802,8246
<class,경부선,송탄,2989,3304,6293
<class,경부선,진위,617,625,1242
<class,경부선,오산,6675,7290,13965
<class,경부선,오산대,1736,1651,3387
<class,경부선,세마,1363,1302,2665
<class,경부선,병점,7578,8457,16035
<class,경부선,세류,1662,1735,3397
<class,경부선,독산,5125,5288,10413
<class,경부선,수원,28714,27902,56616
<class,경부선,화서,3200,3125,6325
<class,경부선,성균관대,6476,6930,13406
<class,경부선,의왕,3578,3619,7197
<class,경부선,군포,2599,2488,5087
<class,경부선,금정,11745,11898,23643
<class,경부선,명학,3002,2961,5963
<class,경부선,안양,11792,11583,23375
<class,경부선,관악,3547,3367,6914
<class,경부선,석수,4190,3910,8100
<class,경부선,금천구청,5280,5324,10604
<class,경부선,가산디지털단지,4022,5520,9542
<class,경부선,구로,8900,8923,17823
<class,경부선,신길,4297,3678,7975
<class,경부선,신도림,1704,1614,3318
<class,경부선,영등포,28509,27258,55767
<class,경부선,대방,5227,5638,10865
<class,경부선,노량진,5316,5138,10454
<class,경부선,용산,25694,23265,48959
<class,경부선,남영,3704,4082,7786
<class,경부선,서울역,5864,1253,7117
<class,경강선,여주,1513,1420,2933
<class,경강선,세종대왕릉,210,189,399
<class,경강선,부발,1033,1586,2619
<class,경강선,이천,1566,1781,3347
<class,경강선,신둔도예촌,720,736,1456
<class,경강선,곤지암,1179,1354,2533
<class,경강선,초월,1303,1298,2601
<class,경강선,경기광주,2951,2939,5890
<class,경강선,삼동,817,824,1641
<class,경강선,이매,522,442,964
<class,경강선,판교,1966,1766,3732
<class,9호선2~3단계,중앙보훈병원,2477,2327,4804
<class,9호선2~3단계,둔촌오륜,351,362,713
<class,9호선2~3단계,올림픽공원,2470,2459,4929
<class,9호선2~3단계,한성백제,1105,1028,2133
<class,9호선2~3단계,송파나루,2454,2693,5147
<class,9호선2~3단계,석촌,4070,3519,7589
<class,9호선2~3단계,석촌고분,2605,2654,5259
<class,9호선2~3단계,삼전,3007,2935,5942
<class,9호선2~3단계,종합운동장,1801,1661,3462
<class,9호선2~3단계,봉은사,6698,6445,13143
<class,9호선2~3단계,삼성중앙,1742,1815,3557
<class,9호선2~3단계,선정릉,2616,2854,5470
<class,9호선2~3단계,언주,3122,3204,6326
<class,9호선,신논현,13456,12918,26374
<class,9호선,사평,1133,1208,2341
<class,9호선,고속터미널,8641,11746,20387
<class,9호선,신반포,1333,1354,2687
<class,9호선,구반포,1000,1062,2062
<class,9호선,동작,1008,845,1853
<class,9호선,흑석,3332,3593,6925
<class,9호선,노들,2033,1799,3832
<class,9호선,노량진,13195,14081,27276
<class,9호선,샛강,1478,1458,2936
<class,9호선,여의도,8968,8039,17007
<class,9호선,국회의사당,4159,3777,7936
<class,9호선,당산,7529,7278,14807
<class,9호선,선유도,2295,2336,4631
<class,9호선,신목동,1463,1328,2791
<class,9호선,염창,7024,7139,14163
<class,9호선,등촌,4352,4558,8910
<class,9호선,증미,2264,2262,4526
<class,9호선,가양,8627,8495,17122
<class,9호선,양천향교,3631,3877,7508
<class,9호선,마곡나루,4937,4873,9810
<class,9호선,신방화,2908,2866,5774
<class,9호선,공항시장,1515,1691,3206
<class,9호선,김포공항,6586,9809,16395
<class,9호선,개화,841,811,1652
<class,8호선,모란,2192,1844,4036
<class,8호선,수진,2528,2292,4820
<class,8호선,신흥,2412,2477,4889
<class,8호선,단대오거리,4599,4649,9248
<class,8호선,남한산성입구,5551,5280,10831
<class,8호선,산성,3060,3105,6165
<class,8호선,복정,4184,4007,8191
<class,8호선,장지,8307,8309,16616
<class,8호선,문정,5259,5468,10727
<class,8호선,가락시장,2855,3563,6418
<class,8호선,송파,2990,3236,6226
<class,8호선,석촌,3736,4702,8438
<class,8호선,잠실,8781,9586,18367
<class,8호선,몽촌토성,2587,2661,5248
<class,8호선,강동구청,3808,3946,7754
<class,8호선,천호,7959,9145,17104
<class,8호선,암사,7722,7387,15109
<class,7호선,부평구청,4373,3868,8241
<class,7호선,굴포천,3919,3883,7802
<class,7호선,삼산체육관,2115,1947,4062
<class,7호선,상동,6009,5870,11879
<class,7호선,부천시청,5481,5437,10918
<class,7호선,신중동,5922,5833,11755
<class,7호선,춘의,2957,2783,5740
<class,7호선,부천종합운동장,1969,1838,3807
<class,7호선,까치울,3409,3375,6784
<class,7호선,온수,3365,3449,6814
<class,7호선,천왕,4417,4205,8622
<class,7호선,광명사거리,10623,10443,21066
<class,7호선,철산,8842,8854,17696
<class,7호선,가산디지털단지,9754,9103,18857
<class,7호선,남구로,6028,5842,11870
<class,7호선,대림,5955,5520,11475
<class,7호선,신풍,5255,4953,10208
<class,7호선,보라매,3603,3670,7273
<class,7호선,신대방삼거리,6568,6693,13261
<class,7호선,장승배기,4398,4374,8772
<class,7호선,상도,4644,4661,9305
<class,7호선,숭실대입구,5003,5395,10398
<class,7호선,남성,4697,4694,9391
<class,7호선,이수,7362,6953,14315
<class,7호선,내방,4582,4743,9325
<class,7호선,고속터미널,10736,7150,17886
<class,7호선,반포,2376,2408,4784
<class,7호선,논현,5625,6119,11744
<class,7호선,학동,5430,5848,11278
<class,7호선,강남구청,4865,5366,10231
<class,7호선,청담,5954,6286,12240
<class,7호선,뚝섬유원지,4073,3820,7893
<class,7호선,건대입구,6240,6593,12833
<class,7호선,어린이대공원,5896,5909,11805
<class,7호선,군자,6640,5354,11994
<class,7호선,중곡,4436,4230,8666
<class,7호선,용마산,2692,2767,5459
<class,7호선,사가정,7807,7693,15500
<class,7호선,면목,7021,7026,14047
<class,7호선,상봉,7871,7259,15130
<class,7호선,중화,4972,5056,10028
<class,7호선,먹골,4539,4440,8979
<class,7호선,태릉입구,4039,3757,7796
<class,7호선,공릉,5561,5697,11258
<class,7호선,하계,7761,7398,15159
<class,7호선,중계,5768,5334,11102
<class,7호선,노원,9640,9487,19127
<class,7호선,마들,4970,4665,9635
<class,7호선,수락산,6468,6311,12779
<class,7호선,도봉산,3764,5366,9130
<class,7호선,장암,986,624,1610
<class,6호선,신내,1,0,1
<class,6호선,봉화산,3308,3256,6564
<class,6호선,화랑대,4108,3533,7641
<class,6호선,태릉입구,2467,2752,5219
<class,6호선,돌곶이,3961,3878,7839
<class,6호선,상월곡,2782,2495,5277
<class,6호선,월곡,4512,4450,8962
<class,6호선,고려대,3602,3471,7073
<class,6호선,안암,4495,4887,9382
<class,6호선,보문,3358,3165,6523
<class,6호선,창신,1391,1317,2708
<class,6호선,동묘앞,4545,4487,9032
<class,6호선,신당,2974,3626,6600
<class,6호선,청구,1521,1442,2963
<class,6호선,약수,1346,1432,2778
<class,6호선,버티고개,960,1011,1971
<class,6호선,한강진,5235,5918,11153
<class,6호선,이태원,7757,7298,15055
<class,6호선,녹사평,2954,2967,5921
<class,6호선,삼각지,2721,2153,4874
<class,우이신설선,정릉,2174,1878,4052
<class,6호선,석계,5464,5551,11015
<class,우이신설선,솔밭공원,1160,1181,2341
<class,우이신설선,4.19민주묘지,1501,1317,2818
<class,우이신설선,가오리,1958,1892,3850
<class,우이신설선,화계,1682,1645,3327
<class,우이신설선,삼양,991,910,1901
<class,우이신설선,삼양사거리,1198,1185,2383
<class,우이신설선,솔샘,2338,2196,4534
<class,5호선,광나루,5674,5351,11025
<class,5호선,천호,10739,9858,20597
<class,5호선,강동,7914,7914,15828
<class,5호선,길동,3643,3908,7551
<class,5호선,굽은다리,4498,4258,8756
<class,5호선,명일,3947,3924,7871
<class,우이신설선,북한산보국문,2990,2786,5776
<class,5호선,고덕,3443,3548,6991
<class,5호선,상일동,6123,5950,12073
<class,5호선,둔촌동,3973,4105,8078
<class,5호선,올림픽공원,1653,1459,3112
<class,5호선,방이,3401,3299,6700
<class,5호선,오금,1324,1267,2591
<class,5호선,개롱,2506,2809,5315
<class,5호선,거여,3314,3331,6645
<class,5호선,마천,2645,2907,5552
<class,5호선,강일,1767,1788,3555
<class,5호선,미사,6985,6928,13913
<class,5호선,하남풍산,2118,2113,4231
<class,5호선,하남시청,3229,3216,6445
<class,5호선,하남검단산,4653,4642,9295
<class,6호선,응암,7690,7824,15514
<class,6호선,역촌,1727,1995,3722
<class,6호선,불광,2715,2379,5094
<class,6호선,독바위,1292,1412,2704
<class,6호선,구산,3152,2512,5664
<class,6호선,새절,5626,5463,11089
<class,6호선,증산,4648,4897,9545
<class,6호선,디지털미디어시티,4168,4541,8709
<class,6호선,월드컵경기장,2096,2124,4220
<class,6호선,마포구청,6140,5656,11796
<class,6호선,망원,7926,8546,16472
<class,6호선,합정,7614,6762,14376
<class,6호선,상수,4725,5319,10044
<class,6호선,광흥창,3605,3518,7123
<class,6호선,대흥,3022,3129,6151
<class,분당선,매교,1135,1120,2255
<class,수인선,고색,1228,1360,2588
<class,수인선,오목천,1122,1153,2275
<class,수인선,어천,392,458,850
<class,수인선,야목,136,109,245
<class,수인선,사리,2067,1774,3841
<class,수인선,달월,36,28,64
<class,수인선,월곶,1426,1339,2765
<class,수인선,소래포구,3736,3668,7404
<class,수인선,인천논현,2608,2590,5198
<class,수인선,호구포,1646,1724,3370
<class,수인선,남동인더스파크,518,525,1043
<class,수인선,원인재,2430,2593,5023
<class,수인선,연수,2609,2527,5136
<class,수인선,송도,1310,1216,2526
<class,수인선,인하대,2787,2787,5574
<class,수인선,숭의,1619,1536,3155
<class,수인선,신포,982,968,1950
<class,수인선,인천,848,1212,2060
<class,안산선,산본,7195,7875,15070
<class,안산선,대야미,2445,2206,4651
<class,안산선,반월,2061,2068,4129
<class,안산선,상록수,7940,7855,15795
<class,안산선,한대앞,4425,4409,8834
<class,안산선,중앙,10322,10336,20658
<class,안산선,고잔,3920,3905,7825
<class,안산선,초지,1956,1872,3828
<class,안산선,안산,8374,7656,16030
<class,안산선,신길온천,957,823,1780
<class,안산선,정왕,4455,5113,9568
<class,안산선,오이도,4645,4649,9294
<class,안산선,수리산,1673,1527,3200
<class,우이신설선,북한산우이,1812,2031,3843
<class,우이신설선,성신여대입구,1911,2196,4107
<class,우이신설선,보문,804,837,1641
<class,우이신설선,신설동,880,837,1717
<class,일산선,원흥,4355,4214,8569
<class,일산선,삼송,8558,8503,17061
<class,일산선,원당,5244,5051,10295
<class,일산선,화정,8102,8201,16303
<class,일산선,대곡,898,731,1629
<class,일산선,백석,4868,4795,9663
<class,일산선,마두,2893,2861,5754
<class,일산선,정발산,4169,4139,8308
<class,일산선,주엽,3714,3551,7265
<class,일산선,대화,5686,5216,10902
<class,장항선,봉명,465,477,942
<class,장항선,쌍용,969,1125,2094
<class,장항선,아산,2681,1749,4430
<class,장항선,배방,643,781,1424
<class,장항선,온양온천,2691,2723,5414
<class,장항선,신창,785,1251,2036
<class,중앙선,회기,13088,13391,26479
<class,중앙선,중랑,2824,2744,5568
<class,중앙선,상봉,3302,3277,6579
<class,중앙선,망우,3827,3744,7571
<class,중앙선,양원,639,655,1294
<class,중앙선,구리,6266,6573,12839
<class,중앙선,도농,3981,3990,7971
<class,중앙선,양정,415,354,769
<class,중앙선,덕소,2795,2717,5512
<class,중앙선,도심,944,880,1824
<class,중앙선,팔당,796,880,1676
<class,중앙선,운길산,743,662,1405
<class,5호선,아차산,8106,8328,16434
<class,5호선,군자,5192,5808,11000
<class,5호선,장한평,6265,6322,12587
<class,5호선,답십리,6153,5838,11991
<class,5호선,마장,2369,2408,4777
<class,5호선,왕십리,1953,2268,4221
<class,5호선,행당,3384,3153,6537
<class,5호선,신금호,2461,2577,5038
<class,5호선,청구,1550,1491,3041
<class,5호선,동대문역사문화공원,647,710,1357
<class,5호선,을지로4가,1237,1339,2576
<class,5호선,종로3가,7351,6609,13960
<class,5호선,광화문,9057,8911,17968
<class,5호선,서대문,4005,3804,7809
<class,5호선,충정로,1314,1345,2659
<class,5호선,애오개,2335,2382,4717
<class,5호선,공덕,4142,4241,8383
<class,5호선,마포,4097,4167,8264
<class,5호선,여의나루,7354,9556,16910
<class,5호선,여의도,8523,8041,16564
<class,5호선,신길,1749,1905,3654
<class,5호선,영등포시장,4168,4409,8577
<class,5호선,영등포구청,1200,1139,2339
<class,5호선,양평,2313,2420,4733
<class,5호선,오목교,10225,10257,20482
<class,5호선,목동,6688,7010,13698
<class,5호선,신정,5546,4934,10480
<class,5호선,까치산,13594,13380,26974
<class,5호선,화곡,12276,11611,23887
<class,5호선,우장산,5687,5973,11660
<class,5호선,발산,7919,8037,15956
<class,5호선,마곡,2962,3049,6011
<class,5호선,송정,3248,3319,6567
<class,5호선,김포공항,6283,5854,12137
<class,5호선,개화산,2306,2364,4670
<class,5호선,방화,3122,3117,6239
<class,4호선,쌍문,13454,12373,25827
<class,4호선,창동,12595,13103,25698
<class,4호선,노원,10596,11155,21751
<class,4호선,상계,8456,8030,16486
<class,4호선,당고개,6443,6194,12637
<class,4호선,남태령,485,435,920
<class,4호선,사당,12172,11371,23543
<class,4호선,총신대입구,8632,9274,17906
<class,4호선,동작,1329,1393,2722
<class,4호선,이촌,3881,4302,8183
<class,4호선,신용산,6332,6179,12511
<class,4호선,삼각지,1764,2263,4027
<class,4호선,숙대입구,6045,5896,11941
<class,4호선,서울역,3470,7220,10690
<class,4호선,회현,6700,6782,13482
<class,4호선,명동,8077,8215,16292
<class,4호선,충무로,6906,6977,13883
<class,4호선,동대문역사문화공원,7171,6999,14170
<class,4호선,동대문,5357,5924,11281
<class,4호선,혜화,17516,18218,35734
<class,4호선,한성대입구,6409,6544,12953
<class,4호선,성신여대입구,11025,10579,21604
<class,4호선,길음,8578,8301,16879
<class,4호선,미아사거리,13670,13050,26720
<class,4호선,미아,6814,6490,13304
<class,4호선,수유,17423,16795,34218
<class,6호선,공덕,5806,5445,11251
<class,3호선,오금,2277,2300,4577
<class,3호선,경찰병원,2397,2459,4856
<class,3호선,가락시장,3165,3599,6764
<class,3호선,수서,8987,8527,17514
<class,3호선,일원,2906,3172,6078
<class,3호선,대청,3559,3527,7086
<class,3호선,학여울,723,696,1419
<class,3호선,대치,5306,4742,10048
<class,3호선,도곡,1847,2142,3989
<class,3호선,매봉,3789,3770,7559
<class,3호선,양재,11241,13180,24421
<class,3호선,남부터미널,12825,13571,26396
<class,3호선,교대,3677,2253,5930
<class,3호선,고속터미널,35179,32826,68005
<class,3호선,잠원,1865,1955,3820
<class,3호선,신사,11976,11894,23870
<class,3호선,압구정,12187,12622,24809
<class,3호선,옥수,4336,4565,8901
<class,3호선,금호,3844,3717,7561
<class,3호선,약수,5789,5580,11369
<class,3호선,동대입구,4562,4864,9426
<class,3호선,을지로3가,2479,2406,4885
<class,3호선,종로3가,3419,4286,7705
<class,3호선,안국,8180,9117,17297
<class,3호선,경복궁,7680,7763,15443
<class,3호선,독립문,3384,3712,7096
<class,3호선,무악재,1563,1673,3236
<class,3호선,홍제,7747,7456,15203
<class,3호선,녹번,5947,5404,11351
<class,3호선,불광,7850,8849,16699
<class,3호선,연신내,18180,17642,35822
<class,3호선,구파발,9260,9054,18314
<class,3호선,지축,1457,1418,2875
<class,2호선,용두,913,923,1836
<class,2호선,신정네거리,4400,4472,8872
<class,2호선,양천구청,2725,2879,5604
<class,2호선,도림천,439,461,900
<class,2호선,신설동,2105,2248,4353
<class,2호선,신답,582,605,1187
<class,2호선,용답,1344,1395,2739
<class,2호선,충정로,3351,3485,6836
<class,2호선,아현,4478,4522,9000
<class,2호선,이대,5928,6363,12291
<class,2호선,신촌,18898,18735,37633
<class,2호선,홍대입구,38782,38277,77059
<class,2호선,합정,16457,17162,33619
<class,2호선,당산,7237,7698,14935
<class,2호선,영등포구청,6842,7014,13856
<class,2호선,문래,6636,6929,13565
<class,2호선,신도림,24556,24907,49463
<class,2호선,대림,12856,12940,25796
<class,2호선,구로디지털단지,21255,20845,42100
<class,2호선,신대방,13001,13071,26072
<class,2호선,신림,32292,31927,64219
<class,2호선,봉천,10618,10503,21121
<class,2호선,서울대입구,23799,24395,48194
<class,2호선,낙성대,13785,14635,28420
<class,2호선,사당,17831,19643,37474
<class,2호선,방배,6176,6590,12766
<class,2호선,서초,9117,8526,17643
<class,2호선,교대,9282,10220,19502
<class,2호선,강남,32904,31774,64678
<class,2호선,역삼,10871,11662,22533
<class,2호선,선릉,11854,10364,22218
<class,2호선,삼성,19238,18949,38187
<class,2호선,종합운동장,3200,3525,6725
<class,2호선,잠실새내,9360,9595,18955
<class,2호선,잠실,39448,36770,76218
<class,2호선,잠실나루,4497,4592,9089
<class,2호선,강변,18476,18217,36693
<class,2호선,구의,9814,10135,19949
<class,2호선,건대입구,22538,22796,45334
<class,2호선,성수,10297,11023,21320
<class,2호선,뚝섬,7287,7790,15077
<class,2호선,한양대,2011,2353,4364
<class,2호선,왕십리,8220,7253,15473
<class,2호선,상왕십리,5992,5844,11836
<class,2호선,신당,6500,7046,13546
<class,2호선,동대문역사문화공원,6457,7684,14141
<class,2호선,을지로4가,2480,2530,5010
<class,2호선,을지로3가,6144,5560,11704
<class,2호선,을지로입구,13061,12296,25357
<class,2호선,시청,4664,3864,8528
<class,1호선,청량리,11260,10921,22181
<class,1호선,제기동,8178,8442,16620
<class,1호선,신설동,5723,5724,11447
<class,1호선,동대문,7143,7615,14758
<class,1호선,종로5가,7140,7535,14675
<class,1호선,종로3가,11977,10778,22755
<class,1호선,종각,10346,9069,19415
<class,1호선,시청,5747,5695,11442
<class,1호선,동묘앞,8121,8401,16522
<class,1호선,서울역,22213,18710,40923
<class,중앙선,양수,1128,1056,2184
<class,6호선,효창공원앞,2806,2513,5319
<class,중앙선,신원,166,144,310
<class,중앙선,국수,382,385,767
<class,중앙선,아신,407,394,801
<class,중앙선,오빈,150,125,275
<class,중앙선,양평,2114,1946,4060
<class,중앙선,원덕,299,252,551
<class,중앙선,용문,1324,1084,2408
<class,중앙선,지평,37,21,58
<class,분당선,수원시청,6529,6487,13016
<class,분당선,매탄권선,2021,2036,4057
<class,분당선,망포,5243,5684,10927
<class,분당선,영통,3939,4030,7969
<class,분당선,청명,1565,1638,3203
<class,분당선,상갈,2379,2484,4863
<class,분당선,기흥,4097,4050,8147
<class,분당선,신갈,1628,1689,3317
<class,분당선,구성,1892,2098,3990
<class,분당선,죽전,6338,7320,13658
<class,분당선,보정,927,825,1752
<class,분당선,이매,2984,2998,5982
<class,분당선,오리,4591,4077,8668
<class,분당선,미금,6193,6477,12670
<class,분당선,정자,6554,6644,13198
<class,분당선,수내,5395,5146,10541
<class,분당선,서현,11896,11884,23780
<class,분당선,야탑,10991,11348,22339
<class,분당선,모란,9448,9622,19070
<class,분당선,태평,6783,6476,13259
<class,분당선,가천대,2989,3831,6820
<class,분당선,선정릉,1755,1916,3671
<class,분당선,강남구청,2754,3395,6149
<class,분당선,압구정로데오,8943,9748,18691
<class,분당선,서울숲,3983,4021,8004
<class,분당선,수원,5291,4114,9405
<class,분당선,수서,7465,6826,14291
<class,분당선,대모산입구,1386,1295,2681
<class,분당선,개포동,1602,1597,3199
<class,분당선,구룡,1066,1120,2186
<class,분당선,도곡,2139,2020,4159
<class,분당선,한티,7214,6937,14151
<class,분당선,선릉,2594,3872,6466
<class,과천선,범계,12484,11798,24282
<class,과천선,평촌,5200,5072,10272
<class,과천선,인덕원,9010,8982,17992
<class,과천선,정부과천청사,3163,3255,6418
<class,과천선,과천,2425,2347,4772
<class,과천선,대공원,2178,2304,4482
<class,과천선,경마공원,781,814,1595
<class,과천선,선바위,2911,2848,5759
<class,공항철도 1호선,영종,1891,1813,3704
<class,공항철도 1호선,인천공항2터미널,1433,1441,2874
<class,공항철도 1호선,인천공항1터미널,2719,2671,5390
<class,공항철도 1호선,공항화물청사,844,965,1809
<class,공항철도 1호선,운서,3942,4221,8163
<class,공항철도 1호선,청라국제도시,2581,2445,5026
<class,공항철도 1호선,검암,3169,3144,6313
<class,공항철도 1호선,계양,3911,3852,7763
<class,공항철도 1호선,김포공항,10564,5473,16037
<class,공항철도 1호선,마곡나루,1758,2039,3797
<class,공항철도 1호선,디지털미디어시티,3269,3295,6564
<class,공항철도 1호선,홍대입구,7323,6745,14068
<class,공항철도 1호선,공덕,989,1214,2203
<class,공항철도 1호선,서울역,5952,5208,11160
<class,경춘선,춘천,931,1094,2025
<class,경춘선,남춘천,1715,2011,3726
<class,경춘선,김유정,257,256,513
<class,경춘선,강촌,384,340,724
<class,경춘선,백양리,63,60,123
<class,경춘선,굴봉산,105,90,195
<class,경춘선,가평,993,831,1824
<class,경춘선,상천,194,166,360
<class,경춘선,청평,1043,848,1891
<class,경춘선,대성리,390,298,688
<class,경춘선,마석,2156,2093,4249
<class,경춘선,천마산,940,815,1755
<class,경춘선,평내호평,2786,2690,5476
<class,경춘선,금곡,724,670,1394
<class,경춘선,사릉,1448,1409,2857
<class,경춘선,퇴계원,1679,1583,3262
<class,경춘선,별내,1382,1242,2624
<class,경춘선,갈매,1189,1093,2282
<class,경춘선,신내,643,694,1337
<class,경인선,도화,2006,1873,3879
<class,경인선,중동,4262,3927,8189
<class,경인선,온수,3150,2976,6126
<class,경인선,도원,1397,1461,2858
<class,경인선,간석,2746,2565,5311
<class,경인선,부개,4012,3834,7846
<class,경인선,소사,5023,4657,9680
<class,경인선,구일,2736,2782,5518
<class,경인선,인천,2439,2027,4466
<class,경인선,동인천,7810,7364,15174
<class,경인선,제물포,4784,4663,9447
<class,경인선,주안,10450,9133,19583
<class,경인선,동암,8349,8235,16584
<class,경인선,백운,3385,3350,6735
<class,경인선,부평,20588,20762,41350
<class,경인선,송내,11592,11200,22792
<class,경인선,부천,18972,18549,37521
<class,경인선,역곡,12520,12437,24957
<class,경인선,오류동,6043,5705,11748
<class,경인선,개봉,9911,10039,19950
<class,경의선,임진강,21,20,41
<class,경의선,문산,2709,2757,5466
<class,경의선,파주,533,482,1015
<class,경의선,월롱,673,1154,1827
<class,경의선,금촌,3504,3614,7118
<class,경의선,금릉,2290,2277,4567
<class,경의선,운정,2963,2813,5776
<class,경의선,야당,3280,3177,6457
<class,경의선,탄현,3503,3314,6817
<class,경의선,일산,4481,4247,8728
<class,경의선,풍산,2882,2771,5653
<class,경의선,백마,2889,2782,5671
<class,경의선,곡산,251,225,476
<class,경의선,능곡,1872,1911,3783
<class,경의선,행신,3742,3566,7308
<class,경의선,강매,1114,1049,2163
<class,경의선,화전,742,762,1504
<class,경의선,수색,764,827,1591
<class,경의선,디지털미디어시티,1101,978,2079
<class,경의선,가좌,2392,2452,4844
<class,경의선,홍대입구,1271,1461,2732
<class,경의선,서강대,1069,980,2049
<class,경의선,효창공원앞,1040,1242,2282
<class,우이신설선,가오리,2300,2251,4551
<class,우이신설선,화계,1971,1909,3880
<class,우이신설선,삼양,1250,1378,2628
<class,우이신설선,삼양사거리,1544,1498,3042
<class,우이신설선,솔샘,3080,2772,5852
<class,우이신설선,북한산보국문,3795,3436,7231
<class,우이신설선,정릉,2749,2431,5180
<class,우이신설선,성신여대입구,2343,2708,5051
<class,우이신설선,보문,971,1006,1977
<class,우이신설선,신설동,1028,1025,2053
<class,일산선,원흥,5695,5521,11216
<class,일산선,삼송,10888,10937,21825
<class,2호선,아현,6159,5975,12134
<class,2호선,충정로,4808,5041,9849
<class,일산선,원당,6505,6312,12817
<class,일산선,화정,10208,10601,20809
<class,일산선,대곡,958,759,1717
<class,일산선,백석,6163,6264,12427
<class,일산선,마두,4214,4169,8383
<class,일산선,정발산,5499,5691,11190
<class,일산선,주엽,5004,5157,10161
<class,일산선,대화,7035,6301,13336
<class,장항선,봉명,648,616,1264
<class,장항선,쌍용,1244,1146,2390
<class,장항선,아산,2193,2126,4319
<class,장항선,배방,774,747,1521
<class,장항선,온양온천,2882,2848,5730
<class,장항선,신창,1032,849,1881
<class,중앙선,회기,16528,15858,32386
<class,중앙선,중랑,3692,3586,7278
<class,중앙선,상봉,3815,3877,7692
<class,중앙선,망우,4846,4789,9635
<class,중앙선,양원,921,924,1845
<class,중앙선,구리,8287,8686,16973
<class,중앙선,도농,5308,5205,10513
<class,중앙선,양정,481,427,908
<class,2호선,방배,8290,8531,16821
<class,2호선,서초,8918,7646,16564
<class,2호선,교대,14999,16695,31694
<class,2호선,강남,53882,53109,106991
<class,2호선,역삼,17137,18146,35283
<class,2호선,선릉,20764,18606,39370
<class,2호선,삼성,27311,27421,54732
<class,2호선,신답,748,864,1612
<class,2호선,신설동,2379,2266,4645
<class,2호선,도림천,779,765,1544
<class,2호선,양천구청,3508,3707,7215
<class,2호선,신정네거리,6066,6332,12398
<class,2호선,용두,1387,1328,2715
<class,3호선,지축,2039,2025,4064
<class,3호선,구파발,11699,11523,23222
<class,3호선,연신내,23995,22878,46873
<class,3호선,불광,10295,11014,21309
<class,3호선,녹번,8242,7284,15526
<class,3호선,홍제,10529,10145,20674
<class,3호선,무악재,2222,2344,4566
<class,3호선,독립문,4427,4502,8929
<class,3호선,경복궁,9644,9263,18907
<class,3호선,안국,9871,10759,20630
<class,3호선,종로3가,4702,6401,11103
<class,3호선,을지로3가,4128,4490,8618
<class,3호선,동대입구,5036,5255,10291
<class,공항철도 1호선,김포공항,9525,5486,15011
<class,공항철도 1호선,계양,5172,4717,9889
<class,공항철도 1호선,검암,3601,3576,7177
<class,공항철도 1호선,청라국제도시,3121,3045,6166
<class,공항철도 1호선,운서,4322,4282,8604
<class,공항철도 1호선,공항화물청사,1151,1204,2355
<class,공항철도 1호선,인천공항1터미널,2276,2534,4810
<class,공항철도 1호선,인천공항2터미널,1501,1412,2913
<class,공항철도 1호선,영종,2166,2083,4249
<class,과천선,선바위,4042,3554,7596
<class,과천선,경마공원,952,960,1912
<class,과천선,대공원,2106,2184,4290
<class,과천선,과천,3499,3372,6871
<class,과천선,정부과천청사,4579,4662,9241
<class,과천선,인덕원,12278,12200,24478
<class,과천선,평촌,7492,7261,14753
<class,과천선,범계,16377,16039,32416
<class,분당선,선릉,4551,6900,11451
<class,분당선,한티,10986,10392,21378
<class,분당선,도곡,3955,3680,7635
<class,분당선,구룡,982,988,1970
<class,분당선,개포동,2333,2265,4598
<class,분당선,대모산입구,1995,1816,3811
<class,분당선,수서,8724,9315,18039
<class,분당선,수원,6224,5372,11596
<class,분당선,서울숲,5061,5211,10272
<class,분당선,압구정로데오,15790,17378,33168
<class,분당선,강남구청,4591,5566,10157
<class,분당선,선정릉,3355,3446,6801
<class,분당선,가천대,4426,4979,9405
<class,분당선,태평,9010,8680,17690
<class,분당선,모란,13402,13353,26755
<class,분당선,야탑,14743,15448,30191
<class,공항철도 1호선,디지털미디어시티,4210,4009,8219
<class,공항철도 1호선,홍대입구,8283,8082,16365
<class,공항철도 1호선,공덕,1260,1929,3189
<class,공항철도 1호선,서울역,5636,5805,11441
<class,경춘선,춘천,1107,947,2054
<class,경춘선,남춘천,1878,1819,3697
<class,경춘선,김유정,205,253,458
<class,경춘선,강촌,276,294,570
<class,경춘선,백양리,59,66,125
<class,경춘선,굴봉산,85,88,173
<class,경춘선,가평,988,1103,2091
<class,경춘선,상천,171,145,316
<class,경춘선,청평,1023,1105,2128
<class,경춘선,대성리,400,379,779
<class,경춘선,마석,2347,2370,4717
<class,경춘선,천마산,976,959,1935
<class,경춘선,평내호평,3346,3257,6603
<class,경춘선,금곡,796,740,1536
<class,경춘선,사릉,1715,1694,3409
<class,경춘선,퇴계원,2022,1842,3864
<class,경춘선,별내,1567,1524,3091
<class,경춘선,갈매,1551,1305,2856
<class,경춘선,신내,742,802,1544
<class,경인선,도화,2348,2218,4566
<class,경인선,중동,5247,5075,10322
<class,경인선,온수,3974,3798,7772
<class,경인선,도원,1609,1615,3224
<class,경인선,간석,3513,3477,6990
<class,3호선,약수,7715,7234,14949
<class,3호선,금호,5040,4671,9711
<class,3호선,옥수,5584,5701,11285
<class,3호선,압구정,21591,22240,43831
<class,3호선,신사,20240,20749,40989
<class,3호선,잠원,3210,3172,6382
<class,3호선,고속터미널,42696,42705,85401
<class,3호선,교대,5724,3416,9140
<class,3호선,남부터미널,17108,17165,34273
<class,3호선,양재,17196,18623,35819
<class,3호선,매봉,5322,5033,10355
<class,3호선,도곡,2925,2900,5825
<class,3호선,대치,8242,7405,15647
<class,3호선,학여울,1499,1547,3046
<class,3호선,대청,4944,4560,9504
<class,3호선,일원,3797,3895,7692
<class,3호선,수서,11225,11695,22920
<class,3호선,가락시장,5418,5096,10514
<class,경인선,부개,5114,4900,10014
<class,3호선,경찰병원,3665,3517,7182
<class,경인선,소사,6225,6150,12375
<class,3호선,오금,3307,3174,6481
<class,4호선,수유,22366,22108,44474
<class,4호선,미아,9184,8773,17957
<class,4호선,미아사거리,18074,17812,35886
<class,4호선,길음,11611,11225,22836
<class,4호선,성신여대입구,13902,13177,27079
<class,4호선,한성대입구,8506,8305,16811
<class,4호선,혜화,20419,20845,41264
<class,경인선,구일,4582,4562,9144
<class,경인선,인천,2038,1586,3624
<class,경인선,동인천,8462,8367,16829
<class,경인선,제물포,5763,5667,11430
<class,경인선,주안,12822,11431,24253
<class,경인선,동암,10153,10413,20566
<class,경인선,백운,4299,4319,8618
<class,경인선,부평,24350,26097,50447
<class,경인선,송내,14789,14776,29565
<class,경인선,부천,23682,24480,48162
<class,경인선,역곡,16234,16186,32420
<class,경인선,오류동,7475,7110,14585
<class,경인선,개봉,13250,13243,26493
<class,경의선,임진강,11,11,22
<class,경의선,문산,3313,3241,6554
<class,경의선,파주,672,481,1153
<class,경의선,월롱,1032,980,2012
<class,경의선,금촌,4024,4090,8114
<class,경의선,금릉,2772,2745,5517
<class,경의선,운정,3568,3509,7077
<class,경의선,야당,4165,3952,8117
<class,경의선,탄현,4208,4134,8342
<class,경의선,일산,5098,5117,10215
<class,경의선,풍산,3246,3121,6367
<class,경의선,백마,3468,3356,6824
<class,경의선,곡산,306,275,581
<class,경의선,능곡,2126,2034,4160
<class,경의선,행신,4225,4280,8505
<class,경의선,강매,1470,1422,2892
<class,경의선,화전,854,762,1616
<class,경의선,수색,1102,1116,2218
<class,경의선,디지털미디어시티,1524,1380,2904
<class,경의선,가좌,3066,2926,5992
<class,경의선,홍대입구,1236,1541,2777
<class,경의선,서강대,1369,1284,2653
<class,경의선,공덕,2388,1701,4089
<class,경의선,효창공원앞,1397,1540,2937
<class,경의선,신촌,289,296,585
<class,경의선,서울역,887,1086,1973
<class,경원선,소요산,1946,1646,3592
<class,경원선,동두천,1193,1433,2626
<class,경원선,보산,1287,1329,2616
<class,경원선,동두천중앙,1924,1987,3911
<class,경원선,지행,4137,4026,8163
<class,경원선,덕정,3317,3189,6506
<class,경원선,덕계,1711,1600,3311
<class,경원선,양주,4837,4539,9376
<class,경원선,녹양,2738,2592,5330
<class,경원선,가능,4150,4012,8162
<class,경원선,의정부,13541,14514,28055
<class,경원선,회룡,7689,7579,15268
<class,경원선,망월사,4376,4545,8921
<class,경원선,도봉산,4994,3222,8216
<class,4호선,동대문,11170,11013,22183
<class,4호선,동대문역사문화공원,8749,7531,16280
<class,4호선,충무로,11062,11271,22333
<class,4호선,명동,8993,10057,19050
<class,4호선,회현,13618,13968,27586
<class,4호선,서울역,4199,9203,13402
<class,4호선,숙대입구,7663,7500,15163
<class,4호선,삼각지,2457,3164,5621
<class,4호선,신용산,7450,8187,15637
<class,4호선,이촌,4971,5538,10509
<class,4호선,동작,1222,1338,2560
<class,4호선,총신대입구,11539,12229,23768
<class,4호선,사당,16584,14114,30698
<class,4호선,남태령,851,569,1420
<class,4호선,당고개,7686,7428,15114
<class,4호선,상계,11449,10954,22403
<class,4호선,노원,13641,14418,28059
<class,4호선,창동,16007,17062,33069
<class,4호선,쌍문,17915,16612,34527
<class,5호선,방화,3781,3632,7413
<class,5호선,개화산,2974,2940,5914
<class,5호선,김포공항,6559,6819,13378
<class,5호선,송정,4300,4221,8521
<class,5호선,마곡,4252,4210,8462
<class,5호선,발산,11152,11472,22624
<class,5호선,우장산,8103,8167,16270
<class,5호선,화곡,16519,15618,32137
<class,5호선,까치산,17539,17103,34642
<class,5호선,신정,7672,6732,14404
<class,5호선,목동,9585,9816,19401
<class,5호선,오목교,14233,14508,28741
<class,5호선,양평,3230,3051,6281
<class,5호선,영등포구청,1585,1575,3160
<class,5호선,영등포시장,5983,6159,12142
<class,5호선,신길,2172,2308,4480
<class,5호선,여의도,12645,11954,24599
<class,5호선,여의나루,5524,8114,13638
<class,5호선,마포,6419,6367,12786
<class,5호선,공덕,6322,6635,12957
<class,5호선,애오개,3256,3200,6456
<class,5호선,충정로,1775,1687,3462
<class,5호선,서대문,5706,5330,11036
<class,5호선,광화문,11074,11310,22384
<class,5호선,종로3가,9431,9263,18694
<class,공항철도 1호선,마곡나루,2104,2359,4463
<class,2호선,문래,9826,10259,20085
<class,1호선,시청,7511,7688,15199
<class,2호선,종합운동장,3889,4531,8420
<class,5호선,을지로4가,2566,2742,5308
<class,5호선,동대문역사문화공원,824,1073,1897
<class,5호선,청구,2227,2075,4302
<class,5호선,신금호,3459,3508,6967
<class,5호선,행당,5068,4510,9578
<class,5호선,왕십리,3104,3532,6636
<class,5호선,마장,3330,3225,6555
<class,5호선,답십리,8723,8185,16908
<class,5호선,장한평,9161,9200,18361
<class,5호선,군자,7111,7910,15021
<class,5호선,아차산,9800,9704,19504
<class,5호선,광나루,7496,6893,14389
<class,5호선,천호,14054,12990,27044
<class,5호선,강동,11262,10645,21907
<class,5호선,길동,5397,5576,10973
<class,5호선,굽은다리,5987,5812,11799
<class,5호선,명일,5147,5261,10408
<class,5호선,고덕,5114,5006,10120
<class,5호선,상일동,8232,7930,16162
<class,5호선,둔촌동,5281,5233,10514
<class,5호선,올림픽공원,2167,1964,4131
<class,5호선,방이,4315,4122,8437
<class,5호선,오금,2115,1918,4033
<class,5호선,개롱,4037,4252,8289
<class,5호선,거여,4578,4508,9086
<class,5호선,마천,3563,3708,7271
<class,5호선,강일,1695,1695,3390
<class,5호선,미사,9052,8909,17961
<class,5호선,하남풍산,2407,2435,4842
<class,5호선,하남시청,3498,3534,7032
<class,5호선,하남검단산,3615,3727,7342
<class,6호선,응암,10544,10745,21289
<class,6호선,역촌,2163,2594,4757
<class,6호선,불광,3264,2893,6157
<class,6호선,독바위,1631,1748,3379
<class,6호선,구산,4418,3537,7955
<class,6호선,새절,7912,7755,15667
<class,6호선,증산,6201,6285,12486
<class,6호선,디지털미디어시티,5819,5997,11816
<class,6호선,월드컵경기장,4279,4392,8671
<class,6호선,마포구청,7880,7175,15055
<class,6호선,망원,10129,10814,20943
<class,6호선,합정,10071,9276,19347
<class,6호선,상수,6831,7573,14404
<class,6호선,광흥창,4645,4392,9037
<class,6호선,대흥,4402,4562,8964
<class,6호선,공덕,8557,8181,16738
<class,6호선,효창공원앞,3661,3290,6951
<class,6호선,삼각지,3842,3035,6877
<class,6호선,녹사평,3556,3776,7332
<class,6호선,이태원,8979,9171,18150
<class,6호선,한강진,5977,7017,12994
<class,6호선,버티고개,1252,1301,2553
<class,6호선,약수,2027,2020,4047
<class,6호선,청구,2211,2188,4399
<class,6호선,신당,5599,4530,10129
<class,6호선,동묘앞,5442,4966,10408
<class,6호선,창신,1921,1627,3548
<class,6호선,보문,4228,3936,8164
<class,6호선,안암,6228,5809,12037
<class,6호선,고려대,4387,4236,8623
<class,6호선,월곡,6195,6089,12284
<class,6호선,상월곡,3641,3298,6939
<class,6호선,돌곶이,5017,4716,9733
<class,6호선,석계,7737,7726,15463
<class,6호선,태릉입구,3352,3391,6743
<class,6호선,화랑대,5840,4867,10707
<class,6호선,봉화산,4454,4332,8786
<class,7호선,장암,1059,707,1766
<class,7호선,도봉산,4574,6022,10596
<class,7호선,수락산,8265,8000,16265
<class,우이신설선,북한산우이,1781,1912,3693
<class,안산선,수리산,2159,1857,4016
<class,안산선,오이도,5544,5782,11326
<class,안산선,정왕,5097,5201,10298
<class,안산선,신길온천,1009,978,1987
<class,안산선,안산,7452,7770,15222
<class,안산선,초지,2533,2626,5159
<class,안산선,고잔,5042,4975,10017
<class,안산선,중앙,12468,12832,25300
<class,안산선,한대앞,5525,5486,11011
<class,안산선,상록수,9862,9986,19848
<class,안산선,반월,2559,2421,4980
<class,안산선,대야미,2900,2591,5491
<class,안산선,산본,9638,10329,19967
<class,수인선,인천,718,1157,1875
<class,수인선,신포,992,1080,2072
<class,수인선,숭의,2033,1938,3971
<class,수인선,인하대,3380,3206,6586
<class,수인선,송도,1432,1439,2871
<class,수인선,연수,3014,3021,6035
<class,수인선,원인재,2810,3045,5855
<class,수인선,남동인더스파크,902,823,1725
<class,수인선,호구포,2033,2008,4041
<class,수인선,인천논현,3815,3803,7618
<class,수인선,소래포구,3599,3696,7295
<class,수인선,월곶,1589,1560,3149
<class,수인선,달월,41,38,79
<class,수인선,사리,2467,2216,4683
<class,수인선,야목,145,143,288
<class,수인선,어천,487,409,896
<class,수인선,오목천,1501,1362,2863
<class,수인선,고색,1767,1795,3562
<class,분당선,매교,1630,1613,3243
<class,분당선,수원시청,9710,10276,19986
<class,분당선,매탄권선,2755,2789,5544
<class,분당선,망포,7740,7319,15059
<class,분당선,영통,5574,5555,11129
<class,분당선,청명,2376,2238,4614
<class,분당선,상갈,3117,3219,6336
<class,분당선,기흥,5746,5596,11342
<class,분당선,신갈,2391,2436,4827
<class,분당선,구성,2634,2795,5429
<class,분당선,죽전,8431,9418,17849
<class,분당선,보정,1334,1239,2573
<class,분당선,이매,3504,3278,6782
<class,분당선,오리,6491,5393,11884
<class,분당선,미금,9315,9470,18785
<class,분당선,정자,9583,9703,19286
<class,분당선,수내,7818,7421,15239
<class,분당선,서현,15786,15736,31522
<class,1호선,서울역,24119,23971,48090
<class,1호선,동묘앞,4741,5048,9789
<class,1호선,종각,14818,13694,28512
<class,1호선,종로3가,16463,16029,32492
<class,1호선,종로5가,14522,14420,28942
<class,1호선,동대문,8380,7536,15916
<class,7호선,마들,8058,7602,15660
<class,7호선,노원,13959,14093,28052
<class,7호선,중계,7527,6917,14444
<class,7호선,하계,10359,9753,20112
<class,2호선,잠실새내,15008,15207,30215
<class,7호선,공릉,7751,7483,15234
<class,7호선,태릉입구,5508,4822,10330
<class,7호선,먹골,6536,6413,12949
<class,7호선,중화,6662,6505,13167
<class,7호선,상봉,11067,10514,21581
<class,7호선,면목,9278,9107,18385
<class,7호선,사가정,10338,10241,20579
<class,7호선,용마산,3646,3529,7175
<class,7호선,중곡,5524,5352,10876
<class,7호선,군자,8974,6970,15944
<class,7호선,어린이대공원,8791,8374,17165
<class,7호선,건대입구,9620,9789,19409
<class,7호선,뚝섬유원지,4273,4292,8565
<class,7호선,청담,10427,10937,21364
<class,7호선,강남구청,8492,9325,17817
<class,7호선,학동,9214,9588,18802
<class,7호선,논현,9741,10584,20325
<class,7호선,반포,3932,3649,7581
<class,7호선,고속터미널,11820,9412,21232
<class,7호선,내방,6724,6554,13278
<class,7호선,이수,10209,9793,20002
<class,7호선,남성,6698,6205,12903
<class,7호선,숭실대입구,7062,6936,13998
<class,7호선,상도,6121,5788,11909
<class,7호선,장승배기,5862,5622,11484
<class,7호선,신대방삼거리,9451,8987,18438
<class,7호선,보라매,5109,4913,10022
<class,7호선,신풍,6923,6722,13645
<class,7호선,대림,6161,6444,12605
<class,7호선,남구로,7474,7960,15434
<class,7호선,가산디지털단지,12478,11204,23682
<class,7호선,철산,12589,12813,25402
<class,7호선,광명사거리,14010,14157,28167
<class,7호선,천왕,5887,5416,11303
<class,7호선,온수,4836,4856,9692
<class,7호선,까치울,4215,4261,8476
<class,7호선,부천종합운동장,2512,2237,4749
<class,7호선,춘의,4482,4278,8760
<class,7호선,신중동,8359,8271,16630
<class,7호선,부천시청,8132,7966,16098
<class,7호선,상동,8722,8867,17589
<class,7호선,삼산체육관,2794,2625,5419
<class,7호선,굴포천,5470,5884,11354
<class,7호선,부평구청,5769,5119,10888
<class,8호선,암사,10601,10039,20640
<class,8호선,천호,10706,12345,23051
<class,8호선,강동구청,5272,5317,10589
<class,8호선,몽촌토성,3582,3563,7145
<class,8호선,잠실,11807,13595,25402
<class,8호선,석촌,5386,6188,11574
<class,8호선,송파,4517,4744,9261
<class,8호선,가락시장,4956,4987,9943
<class,8호선,문정,7687,7879,15566
<class,8호선,장지,10903,10090,20993
<class,8호선,복정,5747,5050,10797
<class,8호선,산성,3988,3975,7963
<class,8호선,남한산성입구,7505,6835,14340
<class,8호선,단대오거리,6415,6102,12517
<class,8호선,신흥,3468,3614,7082
<class,8호선,수진,4104,3587,7691
<class,8호선,모란,3147,2641,5788
<class,9호선,개화,1062,940,2002
<class,9호선,김포공항,6953,11375,18328
<class,9호선,공항시장,1927,2092,4019
<class,9호선,신방화,4040,3914,7954
<class,9호선,마곡나루,6478,6403,12881
<class,9호선,양천향교,5041,5048,10089
<class,9호선,가양,11237,10792,22029
<class,9호선,증미,3593,3592,7185
<class,9호선,등촌,6256,6172,12428
<class,9호선,염창,9652,9108,18760
<class,9호선,신목동,1799,1577,3376
<class,9호선,선유도,3083,2998,6081
<class,9호선,당산,10780,9839,20619
<class,9호선,국회의사당,4238,4099,8337
<class,9호선,여의도,11781,10376,22157
<class,9호선,샛강,2456,2171,4627
<class,9호선,노량진,18021,17590,35611
<class,9호선,노들,2451,2238,4689
<class,9호선,흑석,4502,4538,9040
<class,9호선,동작,1087,925,2012
<class,9호선,구반포,1783,1907,3690
<class,9호선,신반포,2059,1972,4031
<class,9호선,고속터미널,9810,14377,24187
<class,9호선,사평,1877,1816,3693
<class,9호선,신논현,22297,21774,44071
<class,9호선2~3단계,언주,5670,5416,11086
<class,9호선2~3단계,선정릉,4209,4619,8828
<class,9호선2~3단계,삼성중앙,2840,2873,5713
<class,9호선2~3단계,봉은사,9401,9698,19099
<class,9호선2~3단계,종합운동장,3041,2508,5549
<class,9호선2~3단계,삼전,4214,3975,8189
<class,9호선2~3단계,석촌고분,3667,3519,7186
<class,9호선2~3단계,석촌,5363,4319,9682
<class,9호선2~3단계,송파나루,3545,3624,7169
<class,9호선2~3단계,한성백제,1450,1305,2755
<class,9호선2~3단계,올림픽공원,2973,2964,5937
<class,9호선2~3단계,둔촌오륜,521,525,1046
<class,9호선2~3단계,중앙보훈병원,3355,3026,6381
<class,경강선,판교,2404,2302,4706
<class,경강선,이매,598,541,1139
<class,경강선,삼동,1198,1113,2311
<class,경강선,경기광주,3938,3828,7766
<class,경강선,초월,1689,1541,3230
<class,경강선,곤지암,1412,1513,2925
<class,경강선,신둔도예촌,841,810,1651
<class,경강선,이천,1984,2076,4060
<class,경강선,부발,1400,1196,2596
<class,경강선,세종대왕릉,203,242,445
<class,경강선,여주,1510,1699,3209
<class,경부선,서울역,4780,1503,6283
<class,경부선,남영,5061,5078,10139
<class,경부선,용산,26783,28340,55123
<class,경부선,노량진,6286,6039,12325
<class,경부선,대방,6934,6908,13842
<class,경부선,영등포,34610,35790,70400
<class,경부선,신도림,2107,2250,4357
<class,경부선,신길,5171,4306,9477
<class,경부선,구로,10811,10983,21794
<class,경부선,가산디지털단지,4798,6669,11467
<class,경부선,금천구청,6460,6484,12944
<class,경부선,석수,5407,4940,10347
<class,경부선,관악,4284,4164,8448
<class,경부선,안양,14272,14588,28860
<class,경부선,명학,4215,4048,8263
<class,경부선,금정,14939,15026,29965
<class,경부선,군포,3646,3398,7044
<class,경부선,의왕,4609,4585,9194
<class,경부선,성균관대,8493,8231,16724
<class,경부선,화서,4101,4125,8226
<class,경부선,수원,31442,33164,64606
<class,경부선,독산,6944,7017,13961
<class,경부선,세류,1955,2004,3959
<class,경부선,병점,9599,9410,19009
<class,경부선,세마,1692,1564,3256
<class,경부선,오산대,2128,1976,4104
<class,경부선,오산,7879,7289,15168
<class,경부선,진위,886,774,1660
<class,경부선,송탄,3669,3397,7066
<class,2호선,용답,1685,1611,3296
<class,경부선,서정리,5331,4447,9778
<class,경부선,지제,2373,2066,4439
<class,경부선,평택,10551,10041,20592
<class,경부선,성환,2403,2195,4598
<class,경부선,직산,514,509,1023
<class,2호선,잠실,51663,49800,101463
<class,경부선,두정,4425,4492,8917
<class,경부선,천안,4993,4985,9978
<class,경부선,당정,3291,3139,6430
<class,경부선,서동탄,884,939,1823
<class,경부선,광명,2092,1921,4013
<class,경원선,이촌,2369,1759,4128
<class,경원선,서빙고,1071,986,2057
<class,경원선,한남,2191,2149,4340
<class,경원선,옥수,34,43,77
<class,경원선,응봉,1380,1268,2648
<class,경원선,왕십리,10558,11984,22542
<class,우이신설선,솔밭공원,1419,1396,2815
<class,우이신설선,4.19민주묘지,1747,1610,3357
<class,경원선,청량리,12586,13702,26288
<class,경원선,외대앞,5094,5026,10120
<class,경원선,신이문,4992,4828,9820
<class,경원선,석계,5421,5924,11345
<class,경원선,광운대,4819,4774,9593
<class,중앙선,덕소,3614,3560,7174
<class,중앙선,도심,1299,1119,2418
<class,경원선,월계,3756,3477,7233
<class,중앙선,팔당,770,797,1567
<class,중앙선,운길산,653,637,1290
<class,중앙선,양수,1198,1295,2493
<class,중앙선,신원,136,131,267
<class,중앙선,국수,439,468,907
<class,중앙선,아신,408,435,843
<class,중앙선,오빈,186,199,385
<class,경원선,녹천,2610,2305,4915
<class,경원선,방학,5853,5821,11674
<class,경원선,도봉,3633,3467,7100
<class,2호선,이대,8102,8245,16347
<class,2호선,신촌,25854,25894,51748
<class,2호선,홍대입구,45310,47709,93019
<class,2호선,합정,21774,23246,45020
<class,2호선,당산,9672,10880,20552
<class,2호선,잠실나루,6563,6444,13007
<class,2호선,강변,21401,21484,42885
<class,2호선,을지로4가,5798,5776,11574
<class,2호선,을지로3가,7992,8054,16046
<class,2호선,을지로입구,16449,16466,32915
<class,2호선,시청,6380,5530,11910
<class,1호선,청량리,13604,13741,27345
<class,1호선,제기동,10607,10701,21308
<class,1호선,신설동,7238,7012,14250
<class,중앙선,양평,2105,2328,4433
<class,중앙선,원덕,321,391,712
<class,중앙선,용문,1254,1442,2696
<class,중앙선,지평,32,38,70
<class,2호선,구의,13570,13444,27014
<class,2호선,건대입구,27298,28678,55976
<class,2호선,성수,13829,15073,28902
<class,2호선,뚝섬,10160,10334,20494
<class,2호선,한양대,3345,3326,6671
<class,2호선,왕십리,11775,9832,21607
<class,2호선,상왕십리,8422,7964,16386
<class,2호선,신당,8747,9285,18032
<class,2호선,동대문역사문화공원,7641,8111,15752
<class,2호선,영등포구청,10420,10440,20860
<class,2호선,신도림,34779,34918,69697
<class,2호선,대림,14806,16023,30829
<class,2호선,구로디지털단지,28844,28847,57691
<class,2호선,신대방,16424,16275,32699
<class,2호선,신림,41559,40081,81640
<class,2호선,봉천,14438,13656,28094
<class,2호선,서울대입구,31435,30109,61544
<class,2호선,낙성대,18006,16911,34917
<class,2호선,사당,24081,26316,50397
<class,경부선,금천구청,5862,5865,11727
<class,중앙선,지평,43,56,99
<class,중앙선,용문,1663,1373,3036
<class,중앙선,원덕,502,411,913
<class,중앙선,양평,1958,1863,3821
<class,중앙선,오빈,218,210,428
<class,중앙선,아신,450,473,923
<class,중앙선,국수,552,492,1044
<class,중앙선,신원,339,229,568
<class,중앙선,양수,1610,1520,3130
<class,중앙선,운길산,1360,1203,2563
<class,중앙선,팔당,1300,1381,2681
<class,중앙선,도심,1155,1050,2205
<class,중앙선,덕소,3205,3290,6495
<class,중앙선,양정,524,431,955
<class,중앙선,도농,4490,4477,8967
<class,중앙선,구리,6992,7157,14149
<class,중앙선,양원,760,880,1640
<class,중앙선,망우,4389,4483,8872
<class,중앙선,상봉,3780,3759,7539
<class,중앙선,중랑,3252,3228,6480
<class,중앙선,회기,14317,14556,28873
<class,장항선,신창,885,1268,2153
<class,장항선,온양온천,3705,3761,7466
<class,장항선,배방,706,840,1546
<class,장항선,아산,2799,1904,4703
<class,장항선,쌍용,1194,1311,2505
<class,장항선,봉명,504,547,1051
<class,일산선,대화,5724,5259,10983
<class,일산선,주엽,4058,3971,8029
<class,일산선,정발산,5238,5202,10440
<class,일산선,마두,3224,3199,6423
<class,일산선,백석,5154,5051,10205
<class,일산선,대곡,986,773,1759
<class,일산선,화정,8697,8902,17599
<class,일산선,원당,5868,5744,11612
<class,일산선,삼송,9626,9444,19070
<class,일산선,원흥,4761,4600,9361
<class,우이신설선,신설동,1122,1167,2289
<class,우이신설선,보문,862,912,1774
<class,우이신설선,성신여대입구,2062,2364,4426
<class,우이신설선,정릉,2531,2172,4703
<class,우이신설선,북한산보국문,3457,3196,6653
<class,우이신설선,솔샘,2551,2332,4883
<class,우이신설선,삼양사거리,1395,1370,2765
<class,우이신설선,삼양,1177,1222,2399
<class,우이신설선,화계,1964,1768,3732
<class,우이신설선,가오리,2328,2104,4432
<class,우이신설선,4.19민주묘지,1897,1772,3669
<class,우이신설선,솔밭공원,1321,1301,2622
<class,우이신설선,북한산우이,2631,2846,5477
<class,안산선,수리산,1884,1768,3652
<class,안산선,오이도,5267,5138,10405
<class,안산선,정왕,4836,5552,10388
<class,안산선,신길온천,994,917,1911
<class,안산선,안산,9311,8583,17894
<class,안산선,초지,2081,2098,4179
<class,안산선,고잔,4033,3779,7812
<class,안산선,중앙,10966,10909,21875
<class,안산선,한대앞,4873,4793,9666
<class,안산선,상록수,8539,8393,16932
<class,안산선,반월,2438,2418,4856
<class,안산선,대야미,2947,2703,5650
<class,안산선,산본,7987,8664,16651
<class,수인선,인천,998,1511,2509
<class,수인선,신포,1174,1054,2228
<class,수인선,숭의,1886,1702,3588
<class,수인선,인하대,3087,3075,6162
<class,수인선,송도,1540,1488,3028
<class,수인선,연수,2789,2651,5440
<class,수인선,원인재,2943,3072,6015
<class,수인선,남동인더스파크,649,658,1307
<class,수인선,호구포,2045,2093,4138
<class,수인선,인천논현,2909,3102,6011
<class,수인선,소래포구,4502,4449,8951
<class,수인선,월곶,1539,1434,2973
<class,수인선,고색,1354,1430,2784
<class,분당선,매교,1259,1336,2595
<class,분당선,수원시청,6720,6505,13225
<class,분당선,매탄권선,2259,2194,4453
<class,분당선,망포,5384,5716,11100
<class,분당선,영통,4320,4340,8660
<class,분당선,청명,1736,1767,3503
<class,분당선,상갈,2641,2779,5420
<class,분당선,기흥,4421,4298,8719
<class,분당선,신갈,1879,1963,3842
<class,분당선,구성,2170,2258,4428
<class,분당선,죽전,7421,8635,16056
<class,분당선,보정,986,948,1934
<class,분당선,이매,2973,2981,5954
<class,분당선,오리,5057,4432,9489
<class,분당선,미금,6692,7149,13841
<class,분당선,정자,7032,7269,14301
<class,분당선,수내,5740,5476,11216
<class,분당선,서현,12675,12551,25226
<class,분당선,야탑,11994,12386,24380
<class,분당선,모란,16429,17228,33657
<class,분당선,태평,7597,7264,14861
<class,분당선,가천대,3392,4145,7537
<class,분당선,선정릉,1947,2028,3975
<class,분당선,강남구청,2875,3403,6278
<class,분당선,압구정로데오,9322,10339,19661
<class,분당선,서울숲,7616,8422,16038
<class,분당선,수원,5581,4527,10108
<class,분당선,수서,7947,7245,15192
<class,분당선,대모산입구,1545,1512,3057
<class,분당선,개포동,1949,1934,3883
<class,분당선,구룡,729,817,1546
<class,분당선,도곡,2509,2423,4932
<class,분당선,한티,7415,7330,14745
<class,분당선,선릉,2605,3803,6408
<class,과천선,범계,13335,12766,26101
<class,과천선,평촌,5600,5448,11048
<class,과천선,인덕원,10190,10002,20192
<class,과천선,정부과천청사,3788,3937,7725
<class,과천선,과천,2772,2640,5412
<class,과천선,대공원,7213,7457,14670
<class,과천선,경마공원,1065,995,2060
<class,과천선,선바위,3531,3261,6792
<class,공항철도 1호선,영종,1945,1961,3906
<class,공항철도 1호선,인천공항2터미널,1367,1353,2720
<class,공항철도 1호선,인천공항1터미널,2556,2536,5092
<class,공항철도 1호선,공항화물청사,898,989,1887
<class,공항철도 1호선,운서,4325,4599,8924
<class,공항철도 1호선,청라국제도시,2745,2632,5377
<class,공항철도 1호선,검암,3366,3638,7004
<class,공항철도 1호선,계양,4332,4047,8379
<class,공항철도 1호선,김포공항,10554,5519,16073
<class,공항철도 1호선,마곡나루,2015,2273,4288
<class,공항철도 1호선,디지털미디어시티,3116,3124,6240
<class,공항철도 1호선,홍대입구,8378,7548,15926
<class,공항철도 1호선,공덕,957,1387,2344
<class,공항철도 1호선,서울역,5999,5276,11275
<class,경춘선,춘천,1148,1289,2437
<class,경춘선,남춘천,1681,2092,3773
<class,경춘선,김유정,332,327,659
<class,경춘선,강촌,534,502,1036
<class,경춘선,백양리,96,90,186
<class,경춘선,굴봉산,177,167,344
<class,경춘선,가평,1238,1030,2268
<class,경춘선,상천,427,367,794
<class,경춘선,청평,1365,1192,2557
<class,경춘선,대성리,1056,897,1953
<class,경춘선,마석,2340,2230,4570
<class,경춘선,천마산,1072,1036,2108
<class,경춘선,평내호평,3226,3168,6394
<class,경춘선,금곡,908,797,1705
<class,경춘선,사릉,1641,1611,3252
<class,경춘선,퇴계원,1843,1665,3508
<class,경춘선,별내,1506,1471,2977
<class,경춘선,갈매,1372,1188,2560
<class,경춘선,신내,781,765,1546
<class,경인선,도화,2261,2082,4343
<class,경인선,중동,4536,4248,8784
<class,경인선,온수,3533,3392,6925
<class,경인선,도원,1660,1672,3332
<class,경인선,간석,2952,2849,5801
<class,경인선,부개,4486,4209,8695
<class,경인선,소사,5341,4958,10299
<class,경인선,구일,4252,4357,8609
<class,경인선,인천,3460,2936,6396
<class,경인선,동인천,8600,8265,16865
<class,경인선,제물포,5130,5067,10197
<class,경인선,주안,10960,9550,20510
<class,경강선,이매,602,527,1129
<class,경강선,삼동,943,908,1851
<class,경강선,경기광주,3383,3332,6715
<class,경강선,초월,1423,1412,2835
<class,경강선,곤지암,1295,1517,2812
<class,경강선,신둔도예촌,728,791,1519
<class,경강선,이천,1697,1847,3544
<class,경강선,부발,1060,1607,2667
<class,경강선,세종대왕릉,279,263,542
<class,경강선,여주,1618,1623,3241
<class,경부선,서울역,5588,1176,6764
<class,경부선,남영,3808,4063,7871
<class,경부선,용산,25556,22980,48536
<class,경부선,노량진,5509,5318,10827
<class,경부선,대방,5608,5986,11594
<class,경부선,영등포,29714,28623,58337
<class,경부선,신도림,2194,2136,4330
<class,경부선,신길,4450,4043,8493
<class,경부선,구로,8659,8810,17469
<class,경부선,가산디지털단지,4450,6152,10602
<class,경부선,석수,4756,4616,9372
<class,경부선,관악,4261,3942,8203
<class,경부선,안양,12278,12089,24367
<class,경부선,명학,3219,3125,6344
<class,경부선,금정,12370,12657,25027
<class,경부선,군포,2775,2584,5359
<class,경부선,의왕,3928,4074,8002
<class,경부선,성균관대,6844,7273,14117
<class,경부선,화서,3622,3504,7126
<class,경부선,수원,30832,29356,60188
<class,경부선,독산,5425,5675,11100
<class,경부선,세류,1741,1873,3614
<class,경부선,병점,8021,8892,16913
<class,경부선,세마,1536,1436,2972
<class,경부선,오산대,1976,1873,3849
<class,경부선,오산,6828,7466,14294
<class,경부선,진위,707,714,1421
<class,경부선,송탄,3132,3562,6694
<class,경부선,서정리,3699,5177,8876
<class,경부선,지제,1987,1756,3743
<class,경부선,평택,9968,10704,20672
<class,경부선,성환,2213,2853,5066
<class,경부선,직산,495,533,1028
<class,경부선,두정,3970,4505,8475
<class,경부선,천안,5384,5051,10435
<class,경부선,당정,2725,2757,5482
<class,경부선,서동탄,743,725,1468
<class,경부선,광명,2095,1422,3517
<class,경원선,이촌,2330,1702,4032
<class,경원선,서빙고,1245,1259,2504
<class,경원선,한남,1854,1770,3624
<class,경원선,옥수,45,27,72
<class,경원선,응봉,1172,1188,2360
<class,경원선,왕십리,8255,9662,17917
<class,경원선,청량리,11736,11627,23363
<class,경원선,외대앞,4409,4410,8819
<class,경원선,신이문,4411,4096,8507
<class,경원선,석계,4659,5026,9685
<class,경원선,광운대,3973,4204,8177
<class,경원선,월계,3498,3324,6822
<class,경원선,녹천,2466,2200,4666
<class,경원선,방학,5588,5366,10954
<class,경원선,도봉,3215,2979,6194
<class,경원선,도봉산,8087,5781,13868
<class,경원선,망월사,4062,4204,8266
<class,경원선,회룡,6957,6941,13898
<class,경원선,의정부,12656,12886,25542
<class,경원선,가능,3708,3504,7212
<class,경원선,녹양,2511,2456,4967
<class,경원선,양주,4592,4541,9133
<class,경원선,덕계,1482,1434,2916
<class,경원선,덕정,3159,3204,6363
<class,경원선,지행,4033,4102,8135
<class,경원선,동두천중앙,2009,1854,3863
<class,경원선,보산,1303,1420,2723
<class,경원선,동두천,1273,1603,2876
<class,경원선,소요산,3845,3325,7170
<class,경의선,서울역,934,873,1807
<class,경의선,신촌,280,287,567
<class,경의선,효창공원앞,1246,1407,2653
<class,경의선,공덕,1452,1181,2633
<class,경의선,서강대,1172,1133,2305
<class,경의선,홍대입구,1413,1638,3051
<class,경의선,가좌,2589,2652,5241
<class,경의선,디지털미디어시티,1322,1188,2510
<class,경의선,수색,866,980,1846
<class,경의선,화전,795,820,1615
<class,경의선,강매,1384,1341,2725
<class,경의선,행신,3900,3657,7557
<class,경의선,능곡,2021,1999,4020
<class,경의선,곡산,331,341,672
<class,경의선,백마,3045,2947,5992
<class,경의선,풍산,3194,3015,6209
<class,경의선,일산,4393,4089,8482
<class,경의선,탄현,3716,3598,7314
<class,경의선,야당,3781,3560,7341
<class,경의선,운정,3076,3016,6092
<class,경의선,금릉,2653,2595,5248
<class,경의선,금촌,3970,4135,8105
<class,경의선,월롱,816,1328,2144
<class,경의선,파주,632,587,1219
<class,경의선,문산,3528,3571,7099
<class,경의선,임진강,48,38,86
<class,경인선,개봉,10854,10803,21657
<class,경인선,오류동,6714,6331,13045
<class,경인선,역곡,13544,13424,26968
<class,경인선,부천,21206,20666,41872
<class,경인선,송내,12217,11803,24020
<class,경인선,부평,21939,22181,44120
<class,경인선,백운,3670,3620,7290
<class,경인선,동암,9170,9031,18201
<class,수인선,달월,41,60,101
<class,수인선,사리,2284,1901,4185
<class,수인선,야목,165,142,307
<class,수인선,어천,472,528,1000
<class,수인선,오목천,1218,1229,2447
<class,1호선,서울역,23042,20211,43253
<class,1호선,동묘앞,12138,12799,24937
<class,1호선,시청,6446,6517,12963
<class,1호선,종각,10820,9214,20034
<class,1호선,종로3가,13292,11834,25126
<class,1호선,종로5가,8174,8531,16705
<class,1호선,동대문,9026,9555,18581
<class,1호선,신설동,6957,6929,13886
<class,1호선,제기동,9935,10484,20419
<class,1호선,청량리,12676,12597,25273
<class,2호선,시청,5240,4336,9576
<class,2호선,을지로입구,14241,13145,27386
<class,2호선,을지로3가,6613,5905,12518
<class,2호선,을지로4가,2713,2674,5387
<class,2호선,동대문역사문화공원,6347,7779,14126
<class,2호선,신당,7327,7931,15258
<class,2호선,상왕십리,6296,6316,12612
<class,2호선,왕십리,8770,7455,16225
<class,2호선,한양대,2229,2488,4717
<class,2호선,뚝섬,10154,9995,20149
<class,2호선,성수,11724,12720,24444
<class,2호선,건대입구,24271,24547,48818
<class,2호선,구의,10469,10456,20925
<class,2호선,강변,18360,18722,37082
<class,2호선,잠실나루,4945,5148,10093
<class,2호선,잠실,42672,39566,82238
<class,2호선,잠실새내,10252,10410,20662
<class,2호선,종합운동장,5061,5651,10712
<class,2호선,삼성,17502,17144,34646
<class,2호선,선릉,11447,10088,21535
<class,2호선,역삼,9914,10699,20613
<class,2호선,강남,31950,31095,63045
<class,2호선,교대,9447,10549,19996
<class,2호선,서초,9894,9099,18993
<class,2호선,방배,6496,6866,13362
<class,2호선,사당,18647,20667,39314
<class,2호선,낙성대,14905,15624,30529
<class,2호선,서울대입구,25240,26085,51325
<class,2호선,봉천,11384,11229,22613
<class,2호선,신림,33981,33471,67452
<class,2호선,신대방,14275,14336,28611
<class,2호선,구로디지털단지,22197,21999,44196
<class,2호선,대림,13920,13996,27916
<class,2호선,신도림,26488,26403,52891
<class,2호선,문래,6837,7087,13924
<class,2호선,영등포구청,7304,7655,14959
<class,2호선,당산,8455,9057,17512
<class,2호선,합정,18195,18825,37020
<class,2호선,홍대입구,42167,41757,83924
<class,2호선,신촌,19928,19835,39763
<class,2호선,이대,6172,6553,12725
<class,2호선,아현,4732,4785,9517
<class,2호선,충정로,3434,3709,7143
<class,2호선,용답,1613,1616,3229
<class,2호선,신답,676,704,1380
<class,2호선,신설동,2760,2857,5617
<class,2호선,도림천,494,578,1072
<class,2호선,양천구청,2932,3032,5964
<class,2호선,신정네거리,4722,4844,9566
<class,2호선,용두,1323,1242,2565
<class,3호선,지축,1763,1731,3494
<class,3호선,구파발,10271,10418,20689
<class,3호선,연신내,20155,19191,39346
<class,3호선,불광,8864,10147,19011
<class,3호선,녹번,6180,5670,11850
<class,3호선,홍제,8587,8329,16916
<class,3호선,무악재,1677,1789,3466
<class,3호선,독립문,3980,4458,8438
<class,3호선,경복궁,9686,9817,19503
<class,3호선,안국,9005,10065,19070
<class,3호선,종로3가,3193,4402,7595
<class,3호선,을지로3가,2655,2589,5244
<class,3호선,동대입구,5497,6425,11922
<class,3호선,약수,6083,6026,12109
<class,3호선,금호,4201,4103,8304
<class,3호선,옥수,4956,5254,10210
<class,3호선,압구정,12995,13466,26461
<class,3호선,신사,12054,11902,23956
<class,3호선,잠원,2295,2238,4533
<class,3호선,고속터미널,36416,33645,70061
<class,3호선,교대,3750,2326,6076
<class,3호선,남부터미널,11943,12713,24656
<class,3호선,양재,12009,13951,25960
<class,3호선,매봉,4128,4116,8244
<class,3호선,도곡,1866,2052,3918
<class,3호선,대치,5405,4864,10269
<class,3호선,학여울,1207,1332,2539
<class,3호선,대청,3748,3694,7442
<class,3호선,일원,3065,3308,6373
<class,3호선,수서,9320,9228,18548
<class,3호선,가락시장,3590,3803,7393
<class,3호선,경찰병원,2465,2637,5102
<class,3호선,오금,2458,2422,4880
<class,4호선,수유,18791,17828,36619
<class,4호선,미아,7449,7109,14558
<class,4호선,미아사거리,15019,14549,29568
<class,4호선,길음,9368,9044,18412
<class,4호선,성신여대입구,11509,11059,22568
<class,4호선,한성대입구,6856,6935,13791
<class,4호선,혜화,18548,19072,37620
<class,4호선,동대문,6699,7211,13910
<class,4호선,동대문역사문화공원,7796,7832,15628
<class,4호선,충무로,8386,8361,16747
<class,4호선,명동,9633,9907,19540
<class,4호선,회현,7848,7960,15808
<class,4호선,서울역,3690,7334,11024
<class,4호선,숙대입구,6075,5980,12055
<class,4호선,삼각지,1855,2367,4222
<class,4호선,신용산,6362,6422,12784
<class,4호선,이촌,4430,5059,9489
<class,4호선,동작,2003,2070,4073
<class,4호선,총신대입구,9522,10452,19974
<class,4호선,사당,13217,12287,25504
<class,4호선,남태령,629,502,1131
<class,4호선,당고개,7117,6901,14018
<class,4호선,상계,9307,8866,18173
<class,4호선,노원,11285,12016,23301
<class,4호선,창동,14088,14765,28853
<class,4호선,쌍문,14937,13768,28705
<class,5호선,방화,3354,3263,6617
<class,5호선,개화산,2623,2685,5308
<class,5호선,김포공항,6707,6335,13042
<class,5호선,송정,3521,3538,7059
<class,5호선,마곡,3264,3336,6600
<class,5호선,발산,8114,8512,16626
<class,5호선,우장산,6133,6417,12550
<class,5호선,화곡,12976,12251,25227
<class,5호선,까치산,14740,14569,29309
<class,5호선,신정,5873,5212,11085
<class,5호선,목동,7150,7295,14445
<class,5호선,오목교,10967,11484,22451
<class,5호선,양평,2450,2550,5000
<class,5호선,영등포구청,1355,1321,2676
<class,5호선,영등포시장,4312,4699,9011
<class,5호선,신길,1711,1891,3602
<class,5호선,여의도,9337,9076,18413
<class,5호선,여의나루,14424,14920,29344
<class,5호선,마포,4664,4542,9206
<class,5호선,공덕,4364,4403,8767
<class,5호선,애오개,2507,2655,5162
<class,5호선,충정로,1388,1417,2805
<class,5호선,서대문,4275,4115,8390
<class,5호선,광화문,9348,9069,18417
<class,5호선,종로3가,7810,7106,14916
<class,5호선,을지로4가,1369,1415,2784
<class,5호선,동대문역사문화공원,612,754,1366
<class,5호선,청구,1692,1507,3199
<class,5호선,신금호,2754,2972,5726
<class,5호선,행당,3579,3300,6879
<class,5호선,왕십리,2416,2629,5045
<class,5호선,마장,2635,2628,5263
<class,5호선,답십리,6649,6209,12858
<class,5호선,장한평,6721,6874,13595
<class,5호선,군자,5480,5972,11452
<class,5호선,아차산,10632,10655,21287
<class,5호선,광나루,7019,6967,13986
<class,5호선,천호,11702,10900,22602
<class,5호선,강동,7952,8116,16068
<class,5호선,길동,3886,3966,7852
<class,5호선,굽은다리,4879,4696,9575
<class,5호선,명일,4635,4651,9286
<class,5호선,고덕,4045,4038,8083
<class,5호선,상일동,6424,6308,12732
<class,5호선,둔촌동,4245,4374,8619
<class,5호선,올림픽공원,2182,2133,4315
<class,5호선,방이,3473,3392,6865
<class,5호선,오금,1520,1383,2903
<class,5호선,개롱,2829,2999,5828
<class,5호선,거여,3367,3390,6757
<class,5호선,마천,3168,3425,6593
<class,5호선,강일,1782,1729,3511
<class,5호선,미사,7591,7552,15143
<class,5호선,하남풍산,2194,2123,4317
<class,5호선,하남시청,3421,3302,6723
<class,5호선,하남검단산,4847,4952,9799
<class,6호선,응암,9128,9577,18705
<class,6호선,역촌,1771,2184,3955
<class,6호선,불광,2985,2660,5645
<class,6호선,독바위,1452,1653,3105
<class,6호선,연신내,1,0,1
<class,6호선,구산,3595,2725,6320
<class,6호선,새절,6512,6404,12916
<class,6호선,증산,5477,5644,11121
<class,6호선,디지털미디어시티,4764,4987,9751
<class,6호선,월드컵경기장,4093,3820,7913
<class,6호선,마포구청,6415,5911,12326
<class,6호선,망원,8992,9675,18667
<class,6호선,합정,8385,7594,15979
<class,6호선,상수,4880,5794,10674
<class,6호선,광흥창,4021,3772,7793
<class,6호선,대흥,3302,3387,6689
<class,6호선,공덕,6166,5796,11962
<class,6호선,효창공원앞,3086,2883,5969
<class,6호선,삼각지,3004,2267,5271
<class,6호선,녹사평,3648,3443,7091
<class,6호선,이태원,8246,7986,16232
<class,6호선,한강진,5817,6730,12547
<class,6호선,버티고개,1055,1120,2175
<class,6호선,약수,1476,1507,2983
<class,6호선,청구,1577,1545,3122
<class,6호선,신당,3444,4030,7474
<class,6호선,동묘앞,6088,5680,11768
<class,6호선,창신,1589,1498,3087
<class,6호선,보문,3883,3534,7417
<class,6호선,안암,4830,5297,10127
<class,6호선,고려대,3756,3581,7337
<class,6호선,월곡,5082,5078,10160
<class,6호선,상월곡,2951,2761,5712
<class,6호선,돌곶이,4445,4099,8544
<class,6호선,석계,5911,6020,11931
<class,6호선,태릉입구,2770,3085,5855
<class,6호선,화랑대,4509,3867,8376
<class,6호선,봉화산,3703,3586,7289
<class,7호선,장암,1263,814,2077
<class,7호선,도봉산,4991,7022,12013
<class,7호선,수락산,7539,7401,14940
<class,7호선,마들,5615,5189,10804
<class,7호선,노원,10494,10432,20926
<class,7호선,중계,6188,5757,11945
<class,7호선,하계,8446,7983,16429
<class,7호선,공릉,6045,6312,12357
<class,7호선,태릉입구,4450,4021,8471
<class,7호선,먹골,4830,4830,9660
<class,7호선,중화,5434,5233,10667
<class,7호선,상봉,8891,8281,17172
<class,7호선,면목,7192,7197,14389
<class,7호선,사가정,8507,8406,16913
<class,7호선,용마산,3097,3343,6440
<class,7호선,중곡,4677,4597,9274
<class,7호선,군자,7255,5699,12954
<class,7호선,어린이대공원,8082,8344,16426
<class,7호선,건대입구,7398,7480,14878
<class,7호선,뚝섬유원지,8020,7598,15618
<class,7호선,청담,5741,6296,12037
<class,7호선,강남구청,4809,5393,10202
<class,7호선,학동,5023,5362,10385
<class,7호선,논현,5857,6253,12110
<class,7호선,반포,2632,2742,5374
<class,7호선,고속터미널,10892,7023,17915
<class,7호선,내방,4716,4868,9584
<class,7호선,이수,7549,7079,14628
<class,7호선,남성,5063,5198,10261
<class,7호선,숭실대입구,5476,5952,11428
<class,7호선,상도,4922,4853,9775
<class,7호선,장승배기,4867,4700,9567
<class,7호선,신대방삼거리,7193,7191,14384
<class,7호선,보라매,3787,3845,7632
<class,7호선,신풍,5476,5239,10715
<class,7호선,대림,6241,5859,12100
<class,7호선,남구로,6304,6111,12415
<class,7호선,가산디지털단지,10793,9878,20671
<class,7호선,철산,9615,9751,19366
<class,7호선,광명사거리,11574,11104,22678
<class,7호선,천왕,4504,4361,8865
<class,7호선,온수,3821,3837,7658
<class,7호선,까치울,3872,3780,7652
<class,7호선,부천종합운동장,2524,2277,4801
<class,7호선,춘의,3154,3021,6175
<class,7호선,신중동,6420,6225,12645
<class,7호선,부천시청,6408,6088,12496
<class,7호선,상동,6337,6097,12434
<class,7호선,삼산체육관,2327,2234,4561
<class,7호선,굴포천,4218,4284,8502
<class,7호선,부평구청,4659,4068,8727
<class,8호선,암사,8549,7997,16546
<class,8호선,천호,8343,9678,18021
<class,8호선,강동구청,4222,4373,8595
<class,8호선,몽촌토성,3394,3398,6792
<class,8호선,잠실,9408,10098,19506
<class,8호선,석촌,3996,4946,8942
<class,8호선,송파,3371,3514,6885
<class,8호선,가락시장,3124,3898,7022
<class,8호선,문정,5057,5424,10481
<class,8호선,장지,8612,8770,17382
<class,8호선,복정,4710,4324,9034
<class,8호선,산성,3394,3549,6943
<class,8호선,남한산성입구,6518,5933,12451
<class,8호선,단대오거리,5289,5375,10664
<class,8호선,신흥,2726,2932,5658
<class,8호선,수진,2927,2598,5525
<class,8호선,모란,4383,3690,8073
<class,9호선,개화,985,894,1879
<class,9호선,김포공항,7061,10391,17452
<class,9호선,공항시장,1624,1782,3406
<class,9호선,신방화,3189,3149,6338
<class,9호선,마곡나루,5144,5171,10315
<class,9호선,양천향교,3802,4049,7851
<class,9호선,가양,9270,9502,18772
<class,9호선,증미,2995,3110,6105
<class,9호선,등촌,4822,4928,9750
<class,9호선,염창,7605,7774,15379
<class,9호선,신목동,1511,1396,2907
<class,9호선,선유도,2843,2909,5752
<class,9호선,당산,8240,8047,16287
<class,9호선,국회의사당,5506,4693,10199
<class,9호선,여의도,10081,8577,18658
<class,9호선,샛강,1922,1778,3700
<class,9호선,노량진,13663,14458,28121
<class,9호선,노들,2494,2189,4683
<class,9호선,흑석,3568,3943,7511
<class,9호선,동작,1158,1045,2203
<class,9호선,구반포,1083,1188,2271
<class,9호선,신반포,1562,1639,3201
<class,9호선,고속터미널,9115,12014,21129
<class,9호선,사평,1188,1284,2472
<class,9호선,신논현,13821,13337,27158
<class,9호선2~3단계,언주,3186,3053,6239
<class,9호선2~3단계,선정릉,2780,3040,5820
<class,9호선2~3단계,삼성중앙,1636,1734,3370
<class,9호선2~3단계,봉은사,5839,5557,11396
<class,9호선2~3단계,종합운동장,2061,1832,3893
<class,9호선2~3단계,삼전,3107,3193,6300
<class,9호선2~3단계,석촌고분,2742,2785,5527
<class,9호선2~3단계,석촌,4099,3675,7774
<class,9호선2~3단계,송파나루,2660,2892,5552
<class,9호선2~3단계,한성백제,1485,1305,2790
<class,9호선2~3단계,올림픽공원,3206,3217,6423
<class,9호선2~3단계,둔촌오륜,337,339,676
<class,9호선2~3단계,중앙보훈병원,2874,2661,5535
<class,경강선,판교,2042,1831,3873
<class,4호선,성신여대입구,17291,15950,33241
<class,4호선,한성대입구,10437,10049,20486
<class,4호선,혜화,23566,24544,48110
<class,1호선,청량리,18416,18144,36560
<class,2호선,시청,8666,7581,16247
<class,중앙선,지평,67,102,169
<class,중앙선,용문,4565,4846,9411
<class,중앙선,원덕,856,723,1579
<class,중앙선,양평,3063,3254,6317
<class,중앙선,오빈,357,379,736
<class,중앙선,아신,758,814,1572
<class,중앙선,국수,901,922,1823
<class,중앙선,신원,570,357,927
<class,중앙선,양수,2837,3021,5858
<class,중앙선,운길산,2064,1992,4056
<class,중앙선,팔당,2017,2446,4463
<class,중앙선,도심,1655,1460,3115
<class,중앙선,덕소,4819,4846,9665
<class,중앙선,양정,853,946,1799
<class,중앙선,도농,5405,3328,8733
<class,중앙선,구리,11050,13180,24230
<class,중앙선,양원,1321,1315,2636
<class,중앙선,망우,6502,6327,12829
<class,중앙선,상봉,5310,5059,10369
<class,중앙선,중랑,4433,4166,8599
<class,중앙선,회기,18908,17953,36861
<class,장항선,신창,1053,1049,2102
<class,장항선,온양온천,3605,3653,7258
<class,장항선,배방,972,970,1942
<class,장항선,아산,2771,2651,5422
<class,장항선,쌍용,1452,1249,2701
<class,장항선,봉명,690,631,1321
<class,일산선,대화,8104,7180,15284
<class,일산선,주엽,6001,6072,12073
<class,일산선,정발산,6673,6854,13527
<class,일산선,마두,5025,5001,10026
<class,일산선,백석,7324,7314,14638
<class,일산선,대곡,1331,1123,2454
<class,일산선,화정,12555,13000,25555
<class,일산선,원당,8311,7961,16272
<class,일산선,삼송,13112,12733,25845
<class,일산선,원흥,6812,6557,13369
<class,우이신설선,신설동,1370,1353,2723
<class,우이신설선,보문,1060,1035,2095
<class,우이신설선,성신여대입구,2660,3167,5827
<class,우이신설선,정릉,3506,2877,6383
<class,우이신설선,북한산보국문,5223,4533,9756
<class,우이신설선,솔샘,3627,3376,7003
<class,우이신설선,삼양사거리,1851,1784,3635
<class,우이신설선,삼양,1539,1638,3177
<class,우이신설선,화계,2449,2289,4738
<class,우이신설선,가오리,2807,2678,5485
<class,우이신설선,4.19민주묘지,2410,2131,4541
<class,우이신설선,솔밭공원,1708,1608,3316
<class,우이신설선,북한산우이,3815,3915,7730
<class,안산선,수리산,3041,2817,5858
<class,안산선,오이도,7870,8296,16166
<class,안산선,정왕,6382,6520,12902
<class,안산선,신길온천,1401,1411,2812
<class,안산선,안산,10157,10221,20378
<class,안산선,초지,3346,3383,6729
<class,안산선,고잔,6396,6501,12897
<class,안산선,중앙,15579,16074,31653
<class,안산선,한대앞,6941,6998,13939
<class,안산선,상록수,12364,12245,24609
<class,안산선,반월,3396,3131,6527
<class,안산선,대야미,4211,3697,7908
<class,안산선,산본,11888,12675,24563
<class,수인선,인천,1318,2217,3535
<class,수인선,신포,1469,1465,2934
<class,수인선,숭의,2654,2495,5149
<class,수인선,인하대,4277,3867,8144
<class,수인선,송도,1994,1948,3942
<class,수인선,연수,3673,3652,7325
<class,수인선,원인재,3395,3721,7116
<class,수인선,남동인더스파크,997,922,1919
<class,수인선,호구포,2505,2408,4913
<class,수인선,인천논현,4316,4417,8733
<class,수인선,소래포구,6230,6272,12502
<class,수인선,월곶,2110,2088,4198
<class,수인선,달월,81,90,171
<class,수인선,사리,3061,2750,5811
<class,수인선,야목,199,195,394
<class,수인선,어천,639,592,1231
<class,수인선,오목천,1814,1542,3356
<class,수인선,고색,2099,2194,4293
<class,분당선,매교,1979,2096,4075
<class,분당선,수원시청,10743,11417,22160
<class,분당선,매탄권선,3406,3202,6608
<class,분당선,망포,8843,8046,16889
<class,분당선,영통,6195,6017,12212
<class,분당선,청명,2627,2520,5147
<class,분당선,상갈,3780,3806,7586
<class,분당선,기흥,6367,6054,12421
<class,분당선,신갈,2672,2700,5372
<class,분당선,구성,2995,3168,6163
<class,분당선,죽전,9775,10854,20629
<class,분당선,보정,1517,1403,2920
<class,분당선,이매,3995,3919,7914
<class,분당선,오리,7372,6217,13589
<class,분당선,미금,10371,10678,21049
<class,분당선,정자,10609,10755,21364
<class,분당선,수내,8378,7827,16205
<class,분당선,서현,17020,17068,34088
<class,분당선,야탑,16721,17399,34120
<class,분당선,모란,15766,15358,31124
<class,분당선,태평,10429,9789,20218
<class,분당선,가천대,4811,5321,10132
<class,분당선,선정릉,3654,3778,7432
<class,분당선,강남구청,5305,6309,11614
<class,분당선,압구정로데오,17268,20106,37374
<class,분당선,서울숲,12194,14155,26349
<class,분당선,수원,7503,6252,13755
<class,분당선,수서,9521,10303,19824
<class,분당선,대모산입구,2206,2022,4228
<class,분당선,개포동,2576,2446,5022
<class,분당선,구룡,1188,1161,2349
<class,분당선,도곡,4493,4017,8510
<class,분당선,한티,10755,10647,21402
<class,분당선,선릉,4993,7500,12493
<class,과천선,범계,19310,18787,38097
<class,과천선,평촌,8923,8932,17855
<class,과천선,인덕원,15461,14894,30355
<class,과천선,정부과천청사,5873,5913,11786
<class,과천선,과천,4199,3788,7987
<class,과천선,대공원,9713,10195,19908
<class,과천선,경마공원,1252,1261,2513
<class,과천선,선바위,5538,4761,10299
<class,공항철도 1호선,영종,2766,2829,5595
<class,공항철도 1호선,인천공항2터미널,1557,1455,3012
<class,공항철도 1호선,인천공항1터미널,2812,2978,5790
<class,공항철도 1호선,공항화물청사,1294,1366,2660
<class,공항철도 1호선,운서,5691,5821,11512
<class,공항철도 1호선,청라국제도시,3817,3737,7554
<class,공항철도 1호선,검암,4828,4946,9774
<class,공항철도 1호선,계양,6508,5917,12425
<class,공항철도 1호선,김포공항,10843,6717,17560
<class,공항철도 1호선,마곡나루,3179,3547,6726
<class,공항철도 1호선,디지털미디어시티,4763,4535,9298
<class,공항철도 1호선,홍대입구,10325,10101,20426
<class,공항철도 1호선,공덕,1402,2061,3463
<class,공항철도 1호선,서울역,6442,6555,12997
<class,경춘선,춘천,2050,1715,3765
<class,경춘선,남춘천,2355,2694,5049
<class,경춘선,김유정,586,683,1269
<class,경춘선,강촌,885,894,1779
<class,경춘선,백양리,178,194,372
<class,경춘선,굴봉산,367,410,777
<class,경춘선,가평,2005,2292,4297
<class,경춘선,상천,652,536,1188
<class,경춘선,청평,1898,2006,3904
<class,경춘선,대성리,1133,1114,2247
<class,경춘선,마석,3438,3484,6922
<class,경춘선,천마산,1399,1431,2830
<class,경춘선,평내호평,4739,4728,9467
<class,경춘선,금곡,1114,1062,2176
<class,경춘선,사릉,2377,2271,4648
<class,경춘선,퇴계원,2740,2461,5201
<class,경춘선,별내,2085,2050,4135
<class,경춘선,갈매,1968,1738,3706
<class,경춘선,신내,1095,1098,2193
<class,경인선,도화,3032,2843,5875
<class,경인선,중동,6400,6098,12498
<class,경인선,온수,4724,4519,9243
<class,경인선,도원,2154,2206,4360
<class,경인선,간석,4365,4138,8503
<class,경인선,부개,6197,5821,12018
<class,경인선,소사,7644,7248,14892
<class,경인선,구일,4646,4368,9014
<class,경인선,인천,4703,3972,8675
<class,경인선,동인천,11641,11629,23270
<class,경인선,주안,15318,13612,28930
<class,경인선,동암,12277,12439,24716
<class,경인선,백운,5322,5399,10721
<class,경인선,부평,28585,30904,59489
<class,경인선,송내,17564,17460,35024
<class,경인선,부천,28172,29040,57212
<class,경인선,역곡,19712,19376,39088
<class,경인선,오류동,8933,8409,17342
<class,경인선,개봉,16060,15857,31917
<class,경의선,임진강,114,110,224
<class,경의선,문산,4447,4446,8893
<class,경의선,파주,868,718,1586
<class,경의선,월롱,1309,1307,2616
<class,경의선,금촌,5388,5210,10598
<class,경의선,금릉,3673,3506,7179
<class,경의선,운정,4550,4280,8830
<class,경의선,야당,4969,4888,9857
<class,경의선,탄현,5007,4797,9804
<class,경의선,일산,6129,5972,12101
<class,경의선,풍산,4041,3899,7940
<class,경의선,백마,4291,3992,8283
<class,경의선,곡산,446,439,885
<class,경의선,능곡,2832,2702,5534
<class,경의선,행신,5022,4970,9992
<class,경의선,강매,1875,1746,3621
<class,경의선,화전,1120,1106,2226
<class,경의선,수색,1288,1265,2553
<class,경의선,디지털미디어시티,1886,1631,3517
<class,경의선,가좌,3692,3605,7297
<class,경의선,홍대입구,1669,1878,3547
<class,경의선,서강대,1608,1549,3157
<class,경의선,공덕,2405,1839,4244
<class,경의선,효창공원앞,1701,1941,3642
<class,경의선,신촌,362,356,718
<class,경의선,서울역,1226,1389,2615
<class,경원선,소요산,4929,4216,9145
<class,경원선,동두천,1657,2248,3905
<class,경원선,보산,1808,1705,3513
<class,경원선,동두천중앙,2847,2817,5664
<class,경원선,지행,5357,5408,10765
<class,경원선,덕정,4387,4098,8485
<class,경원선,덕계,2150,1993,4143
<class,경원선,양주,6416,6121,12537
<class,경원선,녹양,3563,3350,6913
<class,경원선,가능,5093,4908,10001
<class,경원선,의정부,17018,17723,34741
<class,경원선,회룡,9665,9780,19445
<class,경원선,망월사,5569,5745,11314
<class,경원선,도봉산,10303,7237,17540
<class,경원선,도봉,4403,4184,8587
<class,경원선,방학,7418,7278,14696
<class,경원선,녹천,3434,2830,6264
<class,경원선,월계,4624,4253,8877
<class,경원선,광운대,5469,5402,10871
<class,경원선,석계,6573,7053,13626
<class,경원선,신이문,6172,5681,11853
<class,경원선,외대앞,6045,5824,11869
<class,경원선,청량리,14765,16679,31444
<class,경원선,왕십리,11359,13080,24439
<class,경원선,응봉,1704,1524,3228
<class,경원선,옥수,54,38,92
<class,경원선,한남,2846,2668,5514
<class,경원선,서빙고,1423,1276,2699
<class,경원선,이촌,3353,2296,5649
<class,경부선,광명,2387,2269,4656
<class,경부선,서동탄,1074,1108,2182
<class,경부선,당정,4129,3849,7978
<class,경부선,천안,5956,6127,12083
<class,경부선,두정,5040,5381,10421
<class,경부선,직산,667,632,1299
<class,경부선,성환,2933,2791,5724
<class,경부선,평택,13011,12287,25298
<class,경부선,지제,2546,2388,4934
<class,경부선,서정리,5810,4987,10797
<class,경부선,송탄,4536,4159,8695
<class,경부선,진위,1096,914,2010
<class,경부선,오산,8990,8295,17285
<class,경부선,오산대,2966,2621,5587
<class,경부선,세마,2068,1830,3898
<class,경부선,병점,11426,11374,22800
<class,경부선,세류,2434,2505,4939
<class,경부선,독산,8346,8324,16670
<class,경부선,수원,36307,39034,75341
<class,경부선,화서,5152,5180,10332
<class,경부선,성균관대,9979,9802,19781
<class,경부선,의왕,5907,5805,11712
<class,경부선,군포,4363,4002,8365
<class,경부선,금정,17920,17858,35778
<class,경부선,명학,5085,4921,10006
<class,경부선,안양,17579,17390,34969
<class,경부선,관악,6111,5619,11730
<class,경부선,석수,6907,6662,13569
<class,경부선,금천구청,8321,8263,16584
<class,경부선,가산디지털단지,6278,8393,14671
<class,경부선,구로,13197,13475,26672
<class,경부선,신길,6222,5251,11473
<class,경부선,신도림,2991,3039,6030
<class,경부선,영등포,36288,37613,73901
<class,경부선,대방,7943,7743,15686
<class,경부선,노량진,8387,7650,16037
<class,경부선,용산,28542,30697,59239
<class,경부선,남영,5248,5371,10619
<class,경부선,서울역,5585,1569,7154
<class,경강선,여주,2394,2591,4985
<class,경강선,세종대왕릉,321,411,732
<class,경강선,부발,1717,1527,3244
<class,경강선,이천,2467,2565,5032
<class,경강선,신둔도예촌,1013,1041,2054
<class,경강선,곤지암,1829,2010,3839
<class,경강선,초월,2151,1969,4120
<class,경강선,경기광주,4951,4450,9401
<class,경강선,삼동,1510,1363,2873
<class,경강선,이매,872,823,1695
<class,경강선,판교,2753,2572,5325
<class,9호선2~3단계,중앙보훈병원,4214,3962,8176
<class,9호선2~3단계,둔촌오륜,645,601,1246
<class,9호선2~3단계,올림픽공원,4383,4515,8898
<class,9호선2~3단계,한성백제,1875,1533,3408
<class,9호선2~3단계,송파나루,3652,3910,7562
<class,9호선2~3단계,석촌,6403,5466,11869
<class,9호선2~3단계,석촌고분,3980,3794,7774
<class,9호선2~3단계,삼전,4796,4433,9229
<class,9호선2~3단계,종합운동장,3439,2829,6268
<class,9호선2~3단계,봉은사,10050,10455,20505
<class,9호선2~3단계,삼성중앙,2918,2917,5835
<class,9호선2~3단계,선정릉,4562,5393,9955
<class,9호선2~3단계,언주,5564,5536,11100
<class,9호선,신논현,24802,24113,48915
<class,9호선,사평,1929,1788,3717
<class,9호선,고속터미널,12148,17048,29196
<class,9호선,신반포,2606,2637,5243
<class,9호선,구반포,1974,2116,4090
<class,9호선,동작,1327,1154,2481
<class,9호선,흑석,5549,5512,11061
<class,9호선,노들,3287,2852,6139
<class,9호선,노량진,19977,19829,39806
<class,9호선,샛강,2577,2374,4951
<class,9호선,여의도,12565,11670,24235
<class,9호선,국회의사당,3976,4070,8046
<class,9호선,당산,12048,11073,23121
<class,9호선,선유도,3899,4100,7999
<class,9호선,신목동,2254,1974,4228
<class,9호선,염창,11166,10498,21664
<class,9호선,등촌,6983,6782,13765
<class,9호선,증미,3959,3928,7887
<class,9호선,가양,13411,12755,26166
<class,9호선,양천향교,5667,5416,11083
<class,9호선,마곡나루,8229,8120,16349
<class,9호선,신방화,4412,4155,8567
<class,9호선,공항시장,2162,2302,4464
<class,9호선,김포공항,8027,11946,19973
<class,9호선,개화,1444,1236,2680
<class,8호선,모란,3438,3073,6511
<class,8호선,수진,4042,3600,7642
<class,8호선,신흥,3536,3750,7286
<class,8호선,단대오거리,7618,6945,14563
<class,8호선,남한산성입구,9093,8197,17290
<class,8호선,산성,5065,4997,10062
<class,8호선,복정,7086,6229,13315
<class,8호선,장지,12119,11107,23226
<class,8호선,문정,8434,8584,17018
<class,8호선,가락시장,5517,5659,11176
<class,8호선,송파,4991,4973,9964
<class,8호선,석촌,5639,6811,12450
<class,8호선,잠실,11835,13382,25217
<class,8호선,몽촌토성,4526,4607,9133
<class,8호선,강동구청,5769,5904,11673
<class,8호선,천호,11623,13633,25256
<class,8호선,암사,12390,11264,23654
<class,7호선,부평구청,6859,6073,12932
<class,7호선,굴포천,6214,6356,12570
<class,7호선,삼산체육관,3411,3324,6735
<class,7호선,상동,10064,10258,20322
<class,7호선,부천시청,9222,8939,18161
<class,7호선,신중동,9463,9415,18878
<class,7호선,춘의,5005,4749,9754
<class,7호선,부천종합운동장,3247,2955,6202
<class,7호선,까치울,5620,5575,11195
<class,7호선,온수,5678,5646,11324
<class,7호선,천왕,6780,6425,13205
<class,7호선,광명사거리,16577,16270,32847
<class,7호선,철산,14802,15131,29933
<class,7호선,가산디지털단지,15133,13831,28964
<class,7호선,남구로,8186,8805,16991
<class,7호선,대림,6670,6976,13646
<class,7호선,신풍,8279,7867,16146
<class,7호선,보라매,6883,6652,13535
<class,7호선,신대방삼거리,11133,10455,21588
<class,7호선,장승배기,6710,6436,13146
<class,7호선,상도,7110,6695,13805
<class,7호선,숭실대입구,7936,7925,15861
<class,7호선,남성,7593,7061,14654
<class,7호선,이수,11423,10736,22159
<class,7호선,내방,7594,7494,15088
<class,7호선,고속터미널,12773,10443,23216
<class,7호선,반포,4400,4174,8574
<class,7호선,논현,11622,12195,23817
<class,7호선,학동,10270,10849,21119
<class,7호선,강남구청,9746,10602,20348
<class,7호선,청담,11768,12762,24530
<class,7호선,뚝섬유원지,13195,13298,26493
<class,7호선,건대입구,10420,10787,21207
<class,7호선,어린이대공원,11551,11478,23029
<class,7호선,군자,10784,8179,18963
<class,7호선,중곡,6636,6234,12870
<class,7호선,용마산,4595,4854,9449
<class,7호선,사가정,12471,11976,24447
<class,7호선,면목,11199,10776,21975
<class,7호선,상봉,13412,12577,25989
<class,7호선,중화,7859,7542,15401
<class,7호선,먹골,7557,7387,14944
<class,7호선,태릉입구,6773,6211,12984
<class,7호선,공릉,8483,8319,16802
<class,7호선,하계,12048,11179,23227
<class,7호선,중계,9310,8160,17470
<class,7호선,노원,15581,16195,31776
<class,7호선,마들,8546,8035,16581
<class,7호선,수락산,10380,10225,20605
<class,7호선,도봉산,6995,9686,16681
<class,7호선,장암,1596,1264,2860
<class,6호선,신내,1,0,1
<class,6호선,봉화산,5183,5232,10415
<class,6호선,화랑대,7549,6241,13790
<class,6호선,태릉입구,4000,4261,8261
<class,6호선,석계,8583,8550,17133
<class,6호선,돌곶이,5777,5315,11092
<class,6호선,상월곡,4224,3666,7890
<class,6호선,월곡,7293,7137,14430
<class,6호선,고려대,5401,5104,10505
<class,6호선,안암,6631,6162,12793
<class,6호선,보문,4986,4379,9365
<class,6호선,창신,2171,1829,4000
<class,6호선,동묘앞,7868,7269,15137
<class,6호선,신당,5796,4759,10555
<class,6호선,청구,2401,2439,4840
<class,6호선,약수,2320,2323,4643
<class,6호선,버티고개,1476,1581,3057
<class,6호선,한강진,7764,9494,17258
<class,6호선,이태원,11773,12035,23808
<class,6호선,녹사평,5366,5490,10856
<class,6호선,삼각지,4674,3538,8212
<class,6호선,효창공원앞,4591,4026,8617
<class,6호선,공덕,9796,9282,19078
<class,6호선,대흥,5127,5274,10401
<class,6호선,광흥창,5213,4769,9982
<class,6호선,상수,7277,8566,15843
<class,6호선,합정,12125,11359,23484
<class,6호선,망원,12978,14381,27359
<class,6호선,마포구청,9122,8177,17299
<class,6호선,월드컵경기장,7156,7331,14487
<class,6호선,디지털미디어시티,6987,7037,14024
<class,6호선,증산,7238,7202,14440
<class,6호선,새절,8865,8310,17175
<class,6호선,구산,5266,3930,9196
<class,6호선,독바위,1963,2369,4332
<class,6호선,불광,3855,3639,7494
<class,6호선,역촌,2468,2738,5206
<class,6호선,응암,12276,12342,24618
<class,5호선,하남검단산,5851,6026,11877
<class,5호선,하남시청,4480,4254,8734
<class,5호선,하남풍산,2738,2706,5444
<class,5호선,미사,10796,10710,21506
<class,5호선,강일,2296,2141,4437
<class,5호선,마천,4472,4482,8954
<class,5호선,거여,5345,5234,10579
<class,5호선,개롱,4451,4678,9129
<class,5호선,오금,2188,2008,4196
<class,5호선,방이,5006,4874,9880
<class,5호선,올림픽공원,3115,2945,6060
<class,5호선,둔촌동,6124,6009,12133
<class,5호선,상일동,9430,8740,18170
<class,5호선,고덕,5980,5806,11786
<class,5호선,명일,6182,6105,12287
<class,5호선,굽은다리,6743,6325,13068
<class,5호선,길동,5941,6067,12008
<class,5호선,강동,12865,12445,25310
<class,5호선,천호,16332,15390,31722
<class,5호선,광나루,9874,9415,19289
<class,5호선,아차산,14168,14169,28337
<class,5호선,군자,8560,9113,17673
<class,5호선,장한평,10625,10371,20996
<class,5호선,답십리,10005,9217,19222
<class,5호선,마장,3828,3629,7457
<class,5호선,왕십리,3477,3836,7313
<class,5호선,행당,5553,4834,10387
<class,5호선,신금호,4036,3997,8033
<class,5호선,청구,2521,2269,4790
<class,5호선,동대문역사문화공원,911,1245,2156
<class,5호선,을지로4가,3295,3610,6905
<class,5호선,종로3가,11538,12031,23569
<class,5호선,광화문,13947,13909,27856
<class,5호선,서대문,6782,6645,13427
<class,5호선,충정로,1943,1845,3788
<class,5호선,애오개,3810,3581,7391
<class,5호선,공덕,6991,7351,14342
<class,5호선,마포,7065,7220,14285
<class,5호선,여의나루,18518,21278,39796
<class,5호선,여의도,12294,12552,24846
<class,5호선,신길,2470,2750,5220
<class,5호선,영등포시장,7144,7482,14626
<class,5호선,영등포구청,1976,1881,3857
<class,5호선,양평,3518,3385,6903
<class,5호선,오목교,16360,16966,33326
<class,5호선,목동,11188,11378,22566
<class,5호선,신정,8877,7604,16481
<class,5호선,까치산,21007,20215,41222
<class,5호선,화곡,19709,18186,37895
<class,5호선,우장산,9404,9385,18789
<class,5호선,발산,12719,13302,26021
<class,5호선,마곡,4930,4878,9808
<class,5호선,송정,5013,4955,9968
<class,5호선,김포공항,7028,7538,14566
<class,5호선,개화산,3642,3615,7257
<class,5호선,방화,4545,4322,8867
<class,4호선,쌍문,20878,18768,39646
<class,4호선,창동,19106,20037,39143
<class,4호선,노원,15395,16667,32062
<class,4호선,상계,13534,12509,26043
<class,4호선,당고개,9747,9209,18956
<class,4호선,남태령,1000,711,1711
<class,4호선,사당,19600,16643,36243
<class,4호선,총신대입구,14219,15086,29305
<class,4호선,동작,2520,2548,5068
<class,4호선,이촌,6198,7138,13336
<class,4호선,신용산,8494,9073,17567
<class,4호선,삼각지,2955,3726,6681
<class,4호선,숙대입구,8619,8281,16900
<class,4호선,서울역,5177,11335,16512
<class,4호선,회현,17042,18232,35274
<class,4호선,명동,12680,14673,27353
<class,4호선,충무로,12699,13340,26039
<class,4호선,동대문역사문화공원,10439,8928,19367
<class,4호선,동대문,14112,14034,28146
<class,2호선,을지로입구,19616,18927,38543
<class,2호선,을지로3가,9339,9305,18644
<class,2호선,을지로4가,6872,7032,13904
<class,2호선,동대문역사문화공원,9297,9957,19254
<class,2호선,신당,10490,10788,21278
<class,2호선,상왕십리,9114,8576,17690
<class,2호선,왕십리,12903,10596,23499
<class,2호선,한양대,3840,3858,7698
<class,2호선,뚝섬,16287,16144,32431
<class,2호선,성수,17260,19061,36321
<class,2호선,건대입구,33946,34755,68701
<class,2호선,구의,15654,15059,30713
<class,2호선,강변,24786,25902,50688
<class,2호선,잠실나루,7560,7517,15077
<class,2호선,잠실,59567,56683,116250
<class,2호선,잠실새내,15834,16444,32278
<class,2호선,종합운동장,5896,6583,12479
<class,3호선,경복궁,15612,16304,31916
<class,2호선,삼성,27101,27455,54556
<class,2호선,선릉,22748,20343,43091
<class,2호선,역삼,18211,19559,37770
<class,2호선,강남,57271,57591,114862
<class,2호선,교대,16479,18456,34935
<class,2호선,서초,10760,9337,20097
<class,2호선,방배,9508,9953,19461
<class,2호선,사당,28086,31192,59278
<class,2호선,낙성대,20886,19454,40340
<class,2호선,서울대입구,36491,35314,71805
<class,2호선,봉천,16771,15296,32067
<class,2호선,신림,48507,45796,94303
<class,2호선,신대방,19621,19013,38634
<class,2호선,구로디지털단지,33728,33076,66804
<class,2호선,대림,17957,19417,37374
<class,2호선,신도림,39154,39691,78845
<class,분당선,복정,1,0,1
<class,2호선,문래,11620,12251,23871
<class,2호선,영등포구청,12118,12556,24674
<class,2호선,당산,12832,13854,26686
<class,2호선,합정,26525,28155,54680
<class,2호선,홍대입구,55504,59588,115092
<class,2호선,신촌,27338,27597,54935
<class,2호선,이대,8976,9113,18089
<class,2호선,아현,7211,7010,14221
<class,2호선,충정로,5428,5753,11181
<class,2호선,용답,2003,1913,3916
<class,2호선,신답,1056,1080,2136
<class,2호선,신설동,3191,3162,6353
<class,2호선,도림천,804,829,1633
<class,2호선,양천구청,4287,4378,8665
<class,2호선,신정네거리,7009,7085,14094
<class,2호선,용두,1681,1638,3319
<class,3호선,지축,2695,2650,5345
<class,3호선,구파발,14726,14596,29322
<class,3호선,연신내,29209,27359,56568
<class,3호선,불광,12552,14573,27125
<class,3호선,녹번,9569,8442,18011
<class,3호선,홍제,12842,12249,25091
<class,3호선,무악재,2725,2815,5540
<class,3호선,독립문,5970,6746,12716
<class,경인선,제물포,7178,6892,14070
<class,1호선,서울역,28324,28916,57240
<class,1호선,동묘앞,11859,12320,24179
<class,1호선,시청,10255,10847,21102
<class,1호선,종각,17173,15213,32386
<class,1호선,종로3가,21610,20229,41839
<class,1호선,종로5가,17249,17214,34463
<class,1호선,동대문,10780,10153,20933
<class,1호선,신설동,9264,8702,17966
<class,1호선,제기동,15822,16390,32212
<class,3호선,안국,13073,15050,28123
<class,3호선,종로3가,5499,7700,13199
<class,3호선,을지로3가,4548,5057,9605
<class,3호선,충무로,1,0,1
<class,3호선,동대입구,6414,7616,14030
<class,3호선,약수,8767,8322,17089
<class,3호선,금호,5852,5465,11317
<class,3호선,옥수,7138,7330,14468
<class,3호선,압구정,23643,24586,48229
<class,3호선,신사,24477,25010,49487
<class,3호선,잠원,3724,3671,7395
<class,3호선,고속터미널,46911,47160,94071
<class,3호선,교대,6356,3827,10183
<class,3호선,남부터미널,19106,19531,38637
<class,3호선,양재,20198,22008,42206
<class,3호선,매봉,5855,5644,11499
<class,3호선,도곡,3522,3548,7070
<class,3호선,대치,8387,7653,16040
<class,3호선,학여울,1163,1128,2291
<class,3호선,대청,5419,5087,10506
<class,3호선,일원,4509,4455,8964
<class,3호선,수서,12261,12724,24985
<class,3호선,가락시장,6076,5877,11953
<class,3호선,경찰병원,4069,3941,8010
<class,3호선,오금,3625,3379,7004
<class,4호선,수유,25735,25128,50863
<class,4호선,미아,10704,10138,20842
<class,4호선,미아사거리,21492,20543,42035
<class,4호선,길음,14156,13757,27913
<class,5호선,발산,8576,8926,17502
<class,분당선,이매,2936,2892,5828
<class,분당선,오리,5042,4460,9502
<class,분당선,미금,6873,7305,14178
<class,분당선,정자,6863,7116,13979
<class,분당선,수내,5883,5587,11470
<class,분당선,서현,11957,11990,23947
<class,분당선,야탑,11914,12181,24095
<class,분당선,모란,10669,10722,21391
<class,분당선,태평,7549,7165,14714
<class,분당선,가천대,3575,4452,8027
<class,분당선,선정릉,2147,2134,4281
<class,분당선,강남구청,3091,3728,6819
<class,분당선,압구정로데오,9913,11073,20986
<class,분당선,서울숲,9571,10792,20363
<class,분당선,수원,5736,4743,10479
<class,분당선,수서,7989,7545,15534
<class,분당선,대모산입구,1650,1550,3200
<class,분당선,개포동,1729,1699,3428
<class,분당선,구룡,727,823,1550
<class,분당선,도곡,2377,2330,4707
<class,분당선,한티,7065,7060,14125
<class,분당선,선릉,2775,4167,6942
<class,과천선,범계,13414,12764,26178
<class,과천선,평촌,5712,5617,11329
<class,과천선,인덕원,10596,10352,20948
<class,과천선,정부과천청사,4081,4217,8298
<class,과천선,과천,2943,2725,5668
<class,과천선,대공원,7528,7659,15187
<class,과천선,경마공원,949,953,1902
<class,과천선,선바위,3644,3414,7058
<class,공항철도 1호선,영종,2198,2098,4296
<class,공항철도 1호선,인천공항2터미널,1449,1375,2824
<class,공항철도 1호선,인천공항1터미널,2906,2859,5765
<class,공항철도 1호선,공항화물청사,1015,1085,2100
<class,공항철도 1호선,운서,4718,4993,9711
<class,공항철도 1호선,청라국제도시,2958,2883,5841
<class,공항철도 1호선,검암,3538,3803,7341
<class,공항철도 1호선,계양,4646,4550,9196
<class,공항철도 1호선,김포공항,11157,5925,17082
<class,공항철도 1호선,마곡나루,2213,2530,4743
<class,공항철도 1호선,디지털미디어시티,3374,3540,6914
<class,공항철도 1호선,홍대입구,8327,7700,16027
<class,공항철도 1호선,공덕,978,1305,2283
<class,공항철도 1호선,서울역,6434,5542,11976
<class,경춘선,춘천,1905,1539,3444
<class,경춘선,남춘천,2201,2376,4577
<class,경춘선,김유정,552,599,1151
<class,경춘선,강촌,978,842,1820
<class,경춘선,백양리,185,177,362
<class,경춘선,굴봉산,367,334,701
<class,경춘선,가평,1949,1643,3592
<class,경춘선,상천,663,573,1236
<class,경춘선,청평,1946,1628,3574
<class,경춘선,대성리,1045,900,1945
<class,경춘선,마석,2754,2641,5395
<class,경춘선,천마산,1259,1295,2554
<class,경춘선,평내호평,3448,3435,6883
<class,경춘선,금곡,989,909,1898
<class,경춘선,사릉,1839,1806,3645
<class,경춘선,퇴계원,2003,1895,3898
<class,경춘선,별내,1698,1600,3298
<class,경춘선,갈매,1489,1332,2821
<class,경춘선,신내,853,851,1704
<class,경인선,도화,2224,2078,4302
<class,경인선,중동,4613,4263,8876
<class,경인선,온수,3460,3414,6874
<class,경인선,도원,1624,1637,3261
<class,경인선,간석,2993,2864,5857
<class,경인선,부개,4464,4182,8646
<class,경인선,소사,5681,5440,11121
<class,경인선,구일,3179,3180,6359
<class,경인선,인천,4153,3420,7573
<class,경인선,동인천,9203,8668,17871
<class,경인선,제물포,5403,5211,10614
<class,경인선,주안,11063,9839,20902
<class,경인선,동암,9332,9106,18438
<class,경인선,백운,3810,3766,7576
<class,경인선,부평,22127,22569,44696
<class,경인선,송내,12358,12170,24528
<class,경인선,부천,20623,20260,40883
<class,경인선,역곡,13670,13660,27330
<class,경인선,오류동,6791,6511,13302
<class,경인선,개봉,11101,11095,22196
<class,경의선,임진강,94,75,169
<class,경의선,문산,3711,3652,7363
<class,경의선,파주,743,658,1401
<class,경의선,월롱,828,1415,2243
<class,경의선,금촌,4409,4737,9146
<class,경의선,금릉,2823,2671,5494
<class,경의선,운정,3424,3285,6709
<class,경의선,야당,3865,3798,7663
<class,경의선,탄현,3817,3586,7403
<class,경의선,일산,4446,4214,8660
<class,경의선,풍산,3257,3167,6424
<class,경의선,백마,3067,2963,6030
<class,경의선,곡산,373,368,741
<class,경의선,능곡,2192,2226,4418
<class,경의선,행신,4127,3779,7906
<class,경의선,강매,1463,1434,2897
<class,경의선,화전,855,888,1743
<class,경의선,수색,839,929,1768
<class,경의선,디지털미디어시티,1229,1192,2421
<class,경의선,가좌,2702,2822,5524
<class,경의선,홍대입구,1392,1540,2932
<class,경의선,서강대,1158,1151,2309
<class,경의선,공덕,1477,1234,2711
<class,경의선,효창공원앞,1171,1420,2591
<class,경의선,신촌,246,245,491
<class,경의선,서울역,978,864,1842
<class,경원선,소요산,4868,4307,9175
<class,경원선,동두천,1447,1888,3335
<class,경원선,보산,1613,1739,3352
<class,경원선,동두천중앙,2125,2026,4151
<class,경원선,지행,4177,4126,8303
<class,경원선,덕정,3395,3438,6833
<class,경원선,덕계,1586,1533,3119
<class,경원선,양주,5165,5069,10234
<class,경원선,녹양,2677,2591,5268
<class,경원선,가능,3884,3688,7572
<class,경원선,의정부,13454,13545,26999
<class,경원선,회룡,7240,7263,14503
<class,경원선,망월사,4821,5024,9845
<class,경원선,도봉산,9782,7127,16909
<class,경원선,도봉,3529,3218,6747
<class,경원선,방학,5816,5511,11327
<class,경원선,녹천,2585,2225,4810
<class,경원선,월계,3565,3327,6892
<class,경원선,광운대,4035,4228,8263
<class,경원선,석계,4668,5260,9928
<class,경원선,신이문,4599,4334,8933
<class,경원선,외대앞,4609,4602,9211
<class,경원선,청량리,12409,11968,24377
<class,경원선,왕십리,7898,9145,17043
<class,경원선,응봉,1276,1246,2522
<class,경원선,옥수,71,30,101
<class,경원선,한남,1856,1883,3739
<class,경원선,서빙고,1233,1258,2491
<class,경원선,이촌,2419,1797,4216
<class,경부선,광명,2189,1468,3657
<class,경부선,서동탄,744,720,1464
<class,경부선,당정,2861,2947,5808
<class,경부선,천안,5972,5377,11349
<class,경부선,두정,4230,4583,8813
<class,경부선,직산,550,616,1166
<class,경부선,성환,2692,3126,5818
<class,경부선,평택,11076,11916,22992
<class,경부선,지제,2101,1858,3959
<class,경부선,서정리,4070,5445,9515
<class,경부선,송탄,3589,3962,7551
<class,경부선,진위,826,851,1677
<class,경부선,오산,7363,7960,15323
<class,경부선,오산대,2278,2191,4469
<class,경부선,세마,1570,1460,3030
<class,경부선,병점,8441,9423,17864
<class,경부선,세류,2004,1999,4003
<class,경부선,독산,5741,5845,11586
<class,경부선,수원,31899,30718,62617
<class,경부선,화서,3778,3688,7466
<class,경부선,성균관대,6945,7315,14260
<class,경부선,의왕,4087,4273,8360
<class,경부선,군포,2983,2825,5808
<class,경부선,금정,13187,13389,26576
<class,경부선,명학,3459,3483,6942
<class,경부선,안양,13288,12947,26235
<class,경부선,관악,5066,4489,9555
<class,경부선,석수,5305,5201,10506
<class,경부선,금천구청,6090,6030,12120
<class,경부선,가산디지털단지,4488,6251,10739
<class,경부선,구로,9437,9852,19289
<class,경부선,신길,4786,4310,9096
<class,경부선,신도림,2298,2293,4591
<class,경부선,영등포,28652,27722,56374
<class,경부선,대방,5535,5946,11481
<class,경부선,노량진,5638,5503,11141
<class,경부선,용산,26391,23096,49487
<class,경부선,남영,3829,4161,7990
<class,경부선,서울역,6116,1238,7354
<class,경강선,여주,2034,1887,3921
<class,경강선,세종대왕릉,316,300,616
<class,경강선,부발,1169,1782,2951
<class,경강선,이천,1946,2082,4028
<class,경강선,신둔도예촌,839,849,1688
<class,경강선,곤지암,1433,1678,3111
<class,경강선,초월,1481,1428,2909
<class,경강선,경기광주,3412,3586,6998
<class,경강선,삼동,1013,971,1984
<class,경강선,이매,683,614,1297
<class,경강선,판교,2080,1821,3901
<class,9호선2~3단계,중앙보훈병원,3362,3161,6523
<class,9호선2~3단계,둔촌오륜,341,345,686
<class,9호선2~3단계,올림픽공원,3086,3275,6361
<class,9호선2~3단계,한성백제,1394,1249,2643
<class,9호선2~3단계,송파나루,2603,2783,5386
<class,9호선2~3단계,석촌,4230,3819,8049
<class,9호선2~3단계,석촌고분,2687,2678,5365
<class,9호선2~3단계,삼전,3337,3348,6685
<class,9호선2~3단계,종합운동장,1934,1786,3720
<class,9호선2~3단계,봉은사,6915,7005,13920
<class,9호선2~3단계,삼성중앙,1667,1781,3448
<class,9호선2~3단계,선정릉,2930,3338,6268
<class,9호선2~3단계,언주,3597,3608,7205
<class,9호선,신논현,14181,13474,27655
<class,9호선,사평,1173,1228,2401
<class,9호선,고속터미널,9464,12389,21853
<class,9호선,신반포,1628,1804,3432
<class,9호선,구반포,1242,1339,2581
<class,9호선,동작,1068,881,1949
<class,9호선,흑석,3604,3732,7336
<class,9호선,노들,2464,2208,4672
<class,9호선,노량진,13540,14714,28254
<class,9호선,샛강,1652,1605,3257
<class,9호선,여의도,8813,8135,16948
<class,9호선,국회의사당,4111,3894,8005
<class,9호선,당산,8163,7978,16141
<class,9호선,선유도,2879,3016,5895
<class,9호선,신목동,1548,1390,2938
<class,9호선,염창,7876,7831,15707
<class,9호선,증미,2346,2408,4754
<class,9호선,가양,9393,9330,18723
<class,9호선,양천향교,3868,4062,7930
<class,9호선,마곡나루,5573,5670,11243
<class,9호선,신방화,3100,3124,6224
<class,9호선,공항시장,1602,1703,3305
<class,9호선,김포공항,7194,9899,17093
<class,9호선,개화,1054,929,1983
<class,8호선,모란,2587,2238,4825
<class,8호선,수진,2867,2533,5400
<class,8호선,신흥,2618,2757,5375
<class,8호선,단대오거리,5139,5262,10401
<class,8호선,남한산성입구,6618,6344,12962
<class,8호선,산성,3706,3753,7459
<class,8호선,복정,4972,4655,9627
<class,8호선,장지,8785,8653,17438
<class,8호선,문정,5149,5528,10677
<class,8호선,가락시장,2962,3610,6572
<class,8호선,송파,3502,3616,7118
<class,8호선,잠실,8325,9094,17419
<class,8호선,몽촌토성,3279,3263,6542
<class,8호선,강동구청,3971,4038,8009
<class,8호선,천호,8243,9422,17665
<class,8호선,암사,8505,8148,16653
<class,7호선,부평구청,4809,4177,8986
<class,7호선,굴포천,4170,4253,8423
<class,7호선,삼산체육관,2336,2158,4494
<class,7호선,상동,6612,6205,12817
<class,7호선,부천시청,6015,5979,11994
<class,7호선,신중동,6232,6220,12452
<class,7호선,춘의,3269,3130,6399
<class,7호선,부천종합운동장,2503,2327,4830
<class,7호선,까치울,4170,4120,8290
<class,7호선,온수,3774,3949,7723
<class,7호선,천왕,4731,4540,9271
<class,7호선,광명사거리,11728,11635,23363
<class,7호선,철산,10073,10028,20101
<class,7호선,가산디지털단지,10908,10206,21114
<class,7호선,남구로,6444,6254,12698
<class,7호선,대림,6346,5881,12227
<class,7호선,신풍,5777,5562,11339
<class,7호선,보라매,4224,4260,8484
<class,7호선,신대방삼거리,7440,7411,14851
<class,7호선,장승배기,4765,4567,9332
<class,7호선,상도,4943,4976,9919
<class,7호선,숭실대입구,5625,6114,11739
<class,7호선,남성,5137,5177,10314
<class,7호선,이수,7480,7172,14652
<class,7호선,내방,4777,4891,9668
<class,7호선,고속터미널,11559,7243,18802
<class,7호선,반포,2638,2634,5272
<class,7호선,논현,6055,6392,12447
<class,7호선,학동,5522,5943,11465
<class,7호선,강남구청,5612,6047,11659
<class,7호선,청담,6312,6822,13134
<class,7호선,뚝섬유원지,10930,10446,21376
<class,7호선,건대입구,7269,7413,14682
<class,7호선,어린이대공원,8053,8468,16521
<class,7호선,군자,7488,5718,13206
<class,7호선,중곡,4948,4749,9697
<class,7호선,용마산,3338,3861,7199
<class,7호선,사가정,8866,8681,17547
<class,7호선,면목,7883,7921,15804
<class,7호선,상봉,8912,8245,17157
<class,7호선,중화,5742,5764,11506
<class,7호선,먹골,5555,5300,10855
<class,7호선,태릉입구,4633,4455,9088
<class,7호선,공릉,6336,6418,12754
<class,7호선,하계,8753,8205,16958
<class,7호선,중계,6418,5981,12399
<class,7호선,노원,10208,10490,20698
<class,7호선,마들,5585,5247,10832
<class,7호선,수락산,8371,8393,16764
<class,7호선,도봉산,5766,8651,14417
<class,7호선,장암,1474,1105,2579
<class,6호선,봉화산,3712,3586,7298
<class,6호선,화랑대,4938,4141,9079
<class,6호선,태릉입구,2880,3004,5884
<class,6호선,석계,6263,6446,12709
<class,6호선,돌곶이,4499,4169,8668
<class,6호선,상월곡,3049,2771,5820
<class,6호선,월곡,4951,4977,9928
<class,6호선,고려대,3947,3855,7802
<class,6호선,안암,4551,5040,9591
<class,6호선,보문,3643,3439,7082
<class,6호선,창신,1538,1462,3000
<class,6호선,동묘앞,6207,5868,12075
<class,6호선,신당,3254,4216,7470
<class,6호선,청구,1544,1653,3197
<class,6호선,약수,1498,1549,3047
<class,6호선,버티고개,1075,1195,2270
<class,6호선,한강진,5754,6624,12378
<class,6호선,이태원,8567,8272,16839
<class,6호선,녹사평,3894,3828,7722
<class,6호선,삼각지,3259,2448,5707
<class,6호선,효창공원앞,3279,3058,6337
<class,6호선,공덕,6158,5789,11947
<class,6호선,대흥,3529,3726,7255
<class,6호선,광흥창,3838,3705,7543
<class,6호선,상수,4832,5671,10503
<class,6호선,합정,8520,7618,16138
<class,6호선,망원,8999,10053,19052
<class,6호선,마포구청,6817,6225,13042
<class,6호선,월드컵경기장,3637,3709,7346
<class,6호선,디지털미디어시티,4899,5006,9905
<class,6호선,증산,5291,5488,10779
<class,6호선,새절,6332,6237,12569
<class,6호선,구산,3646,2802,6448
<class,6호선,독바위,1592,1946,3538
<class,6호선,불광,3164,2863,6027
<class,6호선,역촌,1733,1987,3720
<class,6호선,응암,8739,8863,17602
<class,5호선,하남검단산,5183,5259,10442
<class,5호선,하남시청,3117,2959,6076
<class,5호선,하남풍산,2141,2132,4273
<class,5호선,미사,7776,7826,15602
<class,5호선,강일,1817,1774,3591
<class,5호선,마천,3272,3578,6850
<class,5호선,거여,3451,3389,6840
<class,5호선,개롱,2876,3128,6004
<class,5호선,오금,1597,1489,3086
<class,5호선,방이,3654,3508,7162
<class,5호선,올림픽공원,2190,2108,4298
<class,5호선,둔촌동,4404,4472,8876
<class,5호선,상일동,6422,6300,12722
<class,5호선,고덕,3888,3812,7700
<class,5호선,명일,4639,4692,9331
<class,5호선,굽은다리,4922,4580,9502
<class,5호선,길동,3920,4162,8082
<class,5호선,강동,8350,8503,16853
<class,5호선,천호,11731,11002,22733
<class,5호선,광나루,7524,7486,15010
<class,5호선,아차산,11604,11547,23151
<class,5호선,군자,5729,6318,12047
<class,5호선,장한평,6761,6761,13522
<class,5호선,답십리,6863,6526,13389
<class,5호선,마장,2695,2576,5271
<class,5호선,왕십리,2236,2527,4763
<class,5호선,행당,3805,3540,7345
<class,5호선,신금호,3034,3197,6231
<class,5호선,청구,1732,1465,3197
<class,5호선,동대문역사문화공원,649,824,1473
<class,5호선,을지로4가,1450,1430,2880
<class,5호선,종로3가,7606,7220,14826
<class,5호선,광화문,10028,9906,19934
<class,5호선,서대문,4795,4610,9405
<class,5호선,충정로,1428,1466,2894
<class,5호선,애오개,2471,2591,5062
<class,5호선,공덕,4409,4350,8759
<class,5호선,마포,4333,4287,8620
<class,5호선,여의나루,15575,16911,32486
<class,5호선,여의도,8318,8341,16659
<class,5호선,신길,1838,2020,3858
<class,5호선,영등포시장,4370,4633,9003
<class,5호선,영등포구청,1262,1254,2516
<class,5호선,양평,2433,2442,4875
<class,5호선,오목교,10878,11251,22129
<class,5호선,목동,7151,7464,14615
<class,5호선,신정,6249,5538,11787
<class,5호선,까치산,15016,15103,30119
<class,5호선,화곡,13654,12926,26580
<class,5호선,우장산,6251,6483,12734
<class,5호선,마곡,3429,3588,7017
<class,5호선,송정,3681,3729,7410
<class,5호선,김포공항,6654,5915,12569
<class,5호선,개화산,2642,2842,5484
<class,5호선,방화,3259,3247,6506
<class,4호선,쌍문,14702,13349,28051
<class,4호선,창동,13796,14570,28366
<class,4호선,노원,11112,11865,22977
<class,4호선,상계,9773,9306,19079
<class,4호선,당고개,7727,7310,15037
<class,4호선,남태령,725,657,1382
<class,4호선,사당,13382,12690,26072
<class,4호선,총신대입구,9526,10460,19986
<class,4호선,동작,1913,1995,3908
<class,4호선,이촌,4252,5072,9324
<class,4호선,신용산,6283,6167,12450
<class,4호선,삼각지,1885,2489,4374
<class,4호선,숙대입구,6275,6121,12396
<class,4호선,서울역,3792,7806,11598
<class,4호선,회현,7795,8084,15879
<class,4호선,명동,10071,10515,20586
<class,4호선,충무로,7903,8149,16052
<class,4호선,동대문역사문화공원,7964,7737,15701
<class,4호선,동대문,6872,7510,14382
<class,4호선,혜화,17812,18525,36337
<class,4호선,한성대입구,7345,7510,14855
<class,4호선,성신여대입구,11276,11065,22341
<class,4호선,길음,9625,9458,19083
<class,4호선,미아사거리,15223,14599,29822
<class,4호선,미아,7678,7393,15071
<class,4호선,수유,18849,18075,36924
<class,3호선,오금,2518,2562,5080
<class,3호선,경찰병원,2497,2562,5059
<class,3호선,가락시장,3464,3737,7201
<class,3호선,수서,9530,9289,18819
<class,3호선,일원,3156,3479,6635
<class,3호선,대청,3701,3663,7364
<class,3호선,학여울,713,694,1407
<class,3호선,대치,5466,4864,10330
<class,3호선,도곡,1828,1968,3796
<class,3호선,매봉,4094,4120,8214
<class,3호선,양재,12105,14197,26302
<class,3호선,남부터미널,13191,13593,26784
<class,3호선,교대,3791,2410,6201
<class,3호선,고속터미널,37507,33795,71302
<class,3호선,잠원,2253,2262,4515
<class,3호선,신사,13098,13062,26160
<class,3호선,압구정,12757,13109,25866
<class,3호선,옥수,5052,5309,10361
<class,3호선,금호,4169,4017,8186
<class,3호선,약수,6222,5887,12109
<class,3호선,동대입구,5289,6113,11402
<class,3호선,을지로3가,2723,2571,5294
<class,3호선,종로3가,3445,4448,7893
<class,3호선,안국,8814,9654,18468
<class,3호선,경복궁,10601,11423,22024
<class,3호선,독립문,4236,4889,9125
<class,3호선,무악재,1813,1954,3767
<class,3호선,홍제,8774,8485,17259
<class,3호선,녹번,6492,5891,12383
<class,3호선,불광,9283,11183,20466
<class,3호선,연신내,21227,19775,41002
<class,3호선,구파발,10999,10986,21985
<class,3호선,지축,1800,1769,3569
<class,2호선,용두,1076,1034,2110
<class,2호선,신정네거리,4766,4849,9615
<class,2호선,양천구청,3182,3285,6467
<class,2호선,도림천,501,515,1016
<class,2호선,신설동,2944,3008,5952
<class,2호선,신답,659,716,1375
<class,2호선,용답,1559,1544,3103
<class,2호선,충정로,3775,4115,7890
<class,2호선,아현,4825,4947,9772
<class,2호선,이대,6084,6500,12584
<class,2호선,신촌,19344,19007,38351
<class,2호선,홍대입구,40473,40225,80698
<class,2호선,합정,18132,18928,37060
<class,2호선,당산,8868,9497,18365
<class,2호선,영등포구청,7294,7574,14868
<class,2호선,문래,7017,7242,14259
<class,2호선,신도림,26705,26683,53388
<class,2호선,대림,14165,14471,28636
<class,2호선,구로디지털단지,22588,22461,45049
<class,2호선,신대방,14664,14361,29025
<class,2호선,신림,34350,34202,68552
<class,2호선,봉천,11547,11383,22930
<class,2호선,서울대입구,25590,26628,52218
<class,2호선,낙성대,14725,15330,30055
<class,2호선,사당,19479,21981,41460
<class,2호선,방배,6261,6733,12994
<class,2호선,서초,9677,9050,18727
<class,2호선,교대,9696,10649,20345
<class,2호선,강남,31961,31210,63171
<class,2호선,역삼,10392,11157,21549
<class,2호선,선릉,12248,10610,22858
<class,2호선,삼성,18146,17763,35909
<class,2호선,종합운동장,4382,4902,9284
<class,2호선,잠실새내,9770,10212,19982
<class,2호선,잠실,42232,39230,81462
<class,2호선,잠실나루,4783,4907,9690
<class,2호선,강변,20252,19350,39602
<class,2호선,구의,10728,10795,21523
<class,2호선,건대입구,24692,24787,49479
<class,2호선,성수,11590,12808,24398
<class,2호선,뚝섬,11611,11698,23309
<class,2호선,한양대,2439,2720,5159
<class,2호선,왕십리,8553,7329,15882
<class,2호선,상왕십리,6486,6342,12828
<class,2호선,신당,7684,8056,15740
<class,2호선,동대문역사문화공원,7246,8714,15960
<class,2호선,을지로4가,3094,2886,5980
<class,2호선,을지로3가,6603,5864,12467
<class,2호선,을지로입구,13969,13138,27107
<class,2호선,시청,5200,4286,9486
<class,1호선,청량리,13387,12877,26264
<class,1호선,제기동,10297,10752,21049
<class,1호선,동대문,9323,9844,19167
<class,1호선,종로5가,8363,8533,16896
<class,1호선,종로3가,13756,12123,25879
<class,1호선,종각,10815,9518,20333
<class,1호선,동묘앞,12795,13158,25953
<class,1호선,서울역,24053,20521,44574
<class,8호선,석촌,3816,4696,8512
<class,1호선,신설동,7099,6909,14008
<class,분당선,보정,954,904,1858
<class,분당선,죽전,7242,8196,15438
<class,분당선,구성,2189,2377,4566
<class,분당선,신갈,1850,1949,3799
<class,분당선,기흥,4557,4501,9058
<class,분당선,상갈,2669,2784,5453
<class,분당선,청명,1837,1937,3774
<class,분당선,영통,4173,4217,8390
<class,분당선,망포,5669,5921,11590
<class,분당선,매탄권선,2245,2233,4478
<class,분당선,수원시청,6881,6779,13660
<class,분당선,매교,1584,1667,3251
<class,수인선,고색,1451,1551,3002
<class,수인선,오목천,1353,1269,2622
<class,수인선,어천,528,612,1140
<class,수인선,야목,173,164,337
<class,수인선,사리,2416,2066,4482
<class,수인선,달월,61,80,141
<class,수인선,월곶,1671,1519,3190
<class,수인선,소래포구,5684,5515,11199
<class,수인선,인천논현,2917,2961,5878
<class,수인선,호구포,1960,1995,3955
<class,수인선,남동인더스파크,649,661,1310
<class,수인선,원인재,2635,2739,5374
<class,수인선,연수,2855,2741,5596
<class,수인선,송도,1663,1524,3187
<class,수인선,인하대,3107,2981,6088
<class,우이신설선,화계,1948,1852,3800
<class,우이신설선,삼양,1158,1166,2324
<class,우이신설선,삼양사거리,1475,1461,2936
<class,우이신설선,솔샘,2603,2418,5021
<class,우이신설선,북한산보국문,3543,3350,6893
<class,우이신설선,정릉,2467,2152,4619
<class,우이신설선,성신여대입구,1972,2199,4171
<class,우이신설선,보문,866,936,1802
<class,우이신설선,신설동,1159,1153,2312
<class,일산선,원흥,4833,4712,9545
<class,일산선,삼송,9746,9609,19355
<class,일산선,원당,6172,5883,12055
<class,일산선,화정,8910,9157,18067
<class,일산선,대곡,1082,822,1904
<class,일산선,백석,5229,5191,10420
<class,일산선,마두,3255,3309,6564
<class,일산선,정발산,5057,4989,10046
<class,일산선,주엽,4241,4098,8339
<class,일산선,대화,5888,5232,11120
<class,장항선,봉명,492,574,1066
<class,장항선,쌍용,1156,1251,2407
<class,장항선,아산,3070,2042,5112
<class,장항선,배방,772,881,1653
<class,장항선,온양온천,3155,3080,6235
<class,장항선,신창,1056,1347,2403
<class,중앙선,회기,14990,14891,29881
<class,중앙선,중랑,3401,3312,6713
<class,중앙선,상봉,4073,4029,8102
<class,중앙선,망우,4622,4724,9346
<class,중앙선,양원,923,954,1877
<class,중앙선,구리,7462,7523,14985
<class,중앙선,도농,4442,4571,9013
<class,중앙선,양정,643,505,1148
<class,중앙선,덕소,3477,3523,7000
<class,중앙선,도심,1291,1193,2484
<class,중앙선,팔당,1955,2107,4062
<class,중앙선,운길산,1943,1843,3786
<class,중앙선,양수,2490,2256,4746
<class,중앙선,신원,577,361,938
<class,중앙선,국수,848,759,1607
<class,중앙선,아신,713,525,1238
<class,중앙선,오빈,278,264,542
<class,중앙선,양평,2606,2292,4898
<class,중앙선,원덕,603,452,1055
<class,중앙선,용문,2525,2030,4555
<class,중앙선,지평,69,94,163
<class,수인선,숭의,1925,1842,3767
<class,수인선,신포,1107,1156,2263
<class,수인선,인천,1221,1714,2935
<class,안산선,산본,8269,8790,17059
<class,안산선,대야미,3267,2959,6226
<class,안산선,반월,2522,2557,5079
<class,안산선,상록수,8904,8878,17782
<class,안산선,한대앞,5204,5039,10243
<class,안산선,중앙,11542,11472,23014
<class,안산선,고잔,4484,4376,8860
<class,안산선,초지,2341,2310,4651
<class,안산선,안산,10180,9396,19576
<class,안산선,신길온천,1239,1146,2385
<class,안산선,정왕,5432,6005,11437
<class,안산선,오이도,6260,6009,12269
<class,안산선,수리산,2400,2547,4947
<class,우이신설선,북한산우이,3423,3686,7109
<class,우이신설선,솔밭공원,1346,1328,2674
<class,우이신설선,4.19민주묘지,2086,1791,3877
<class,우이신설선,가오리,2300,2095,4395
<class,9호선,등촌,4856,4979,9835
<class,1호선,시청,6741,6717,13458
<class,7호선,이수,11262,10598,21860
<class,7호선,천왕,6312,5985,12297
<class,7호선,남성,7370,6766,14136
<class,7호선,숭실대입구,7778,7907,15685
<class,7호선,상도,6984,6535,13519
<class,7호선,장승배기,6633,6340,12973
<class,7호선,신대방삼거리,10853,10093,20946
<class,7호선,보라매,6122,5859,11981
<class,7호선,신풍,7916,7611,15527
<class,7호선,대림,6611,6993,13604
<class,7호선,남구로,7909,8366,16275
<class,7호선,가산디지털단지,14009,12709,26718
<class,7호선,철산,14124,14421,28545
<class,7호선,광명사거리,15706,15701,31407
<class,7호선,온수,5245,5285,10530
<class,7호선,까치울,5023,4994,10017
<class,7호선,부천종합운동장,2990,2756,5746
<class,7호선,춘의,4898,4610,9508
<class,7호선,신중동,9036,9002,18038
<class,7호선,부천시청,8861,8596,17457
<class,7호선,상동,9315,9322,18637
<class,7호선,삼산체육관,3283,3120,6403
<class,7호선,굴포천,5821,6060,11881
<class,7호선,부평구청,6614,5961,12575
<class,8호선,암사,11825,11087,22912
<class,8호선,천호,11252,13341,24593
<class,8호선,강동구청,5535,5635,11170
<class,8호선,몽촌토성,3791,3846,7637
<class,8호선,잠실,10893,12420,23313
<class,8호선,석촌,5411,6553,11964
<class,8호선,송파,5227,5212,10439
<class,8호선,가락시장,5277,5380,10657
<class,8호선,문정,8281,8557,16838
<class,8호선,장지,11419,10727,22146
<class,8호선,복정,6511,5683,12194
<class,8호선,산성,4614,4432,9046
<class,8호선,남한산성입구,8259,7565,15824
<class,8호선,단대오거리,7096,6628,13724
<class,8호선,신흥,3396,3767,7163
<class,8호선,수진,4066,3532,7598
<class,8호선,모란,3256,2701,5957
<class,9호선,개화,1317,1087,2404
<class,9호선,김포공항,7386,11983,19369
<class,9호선,공항시장,1956,2140,4096
<class,9호선,신방화,4321,4138,8459
<class,9호선,마곡나루,7335,7234,14569
<class,9호선,양천향교,5681,5502,11183
<class,9호선,가양,13046,12307,25353
<class,9호선,증미,3784,3838,7622
<class,9호선,등촌,6770,6415,13185
<class,9호선,염창,10958,10402,21360
<class,9호선,신목동,2191,1939,4130
<class,9호선,선유도,3692,3659,7351
<class,9호선,당산,12002,10989,22991
<class,9호선,국회의사당,3779,4014,7793
<class,9호선,여의도,11867,11081,22948
<class,9호선,샛강,2554,2392,4946
<class,9호선,노량진,20274,20091,40365
<class,9호선,노들,2867,2452,5319
<class,9호선,흑석,4854,4878,9732
<class,9호선,동작,1300,1031,2331
<class,9호선,구반포,2007,2161,4168
<class,9호선,신반포,2365,2288,4653
<class,9호선,고속터미널,10795,14903,25698
<class,9호선,사평,2069,2000,4069
<class,9호선,신논현,23335,22867,46202
<class,9호선2~3단계,언주,5324,5295,10619
<class,9호선2~3단계,선정릉,4429,4914,9343
<class,9호선2~3단계,삼성중앙,2831,2833,5664
<class,9호선2~3단계,봉은사,9082,9435,18517
<class,9호선2~3단계,종합운동장,3149,2648,5797
<class,9호선2~3단계,삼전,4454,4190,8644
<class,9호선2~3단계,석촌고분,3824,3629,7453
<class,9호선2~3단계,석촌,5969,4963,10932
<class,9호선2~3단계,송파나루,3537,3660,7197
<class,9호선2~3단계,한성백제,1656,1410,3066
<class,9호선2~3단계,올림픽공원,3652,3647,7299
<class,9호선2~3단계,둔촌오륜,576,554,1130
<class,9호선2~3단계,중앙보훈병원,3961,3705,7666
<class,경강선,판교,2736,2507,5243
<class,경강선,이매,825,677,1502
<class,경강선,삼동,1420,1333,2753
<class,경강선,경기광주,4517,4314,8831
<class,경강선,초월,2004,1830,3834
<class,경강선,곤지암,1692,1801,3493
<class,경강선,신둔도예촌,945,992,1937
<class,경강선,이천,2276,2463,4739
<class,경강선,부발,1551,1399,2950
<class,경강선,세종대왕릉,290,371,661
<class,경강선,여주,1969,2174,4143
<class,경부선,서울역,4889,1494,6383
<class,경부선,남영,5626,5771,11397
<class,경부선,용산,27420,29927,57347
<class,경부선,노량진,8213,7463,15676
<class,경부선,대방,7390,7468,14858
<class,경부선,영등포,34828,36167,70995
<class,경부선,신도림,2714,2790,5504
<class,경부선,신길,6064,5063,11127
<class,경부선,구로,12587,12779,25366
<class,경부선,가산디지털단지,5702,7740,13442
<class,경부선,금천구청,7890,7814,15704
<class,경부선,석수,6463,6073,12536
<class,경부선,관악,5612,5279,10891
<class,경부선,안양,16405,16607,33012
<class,경부선,명학,4971,4856,9827
<class,경부선,금정,17522,17348,34870
<class,경부선,군포,4174,3917,8091
<class,경부선,의왕,5711,5624,11335
<class,경부선,성균관대,9553,9313,18866
<class,경부선,화서,5005,4985,9990
<class,경부선,수원,33601,36433,70034
<class,경부선,독산,8019,8093,16112
<class,경부선,세류,2273,2321,4594
<class,경부선,병점,11183,11077,22260
<class,경부선,세마,1948,1753,3701
<class,경부선,오산대,2502,2287,4789
<class,경부선,오산,8751,8011,16762
<class,경부선,진위,954,816,1770
<class,경부선,송탄,4864,4294,9158
<class,경부선,서정리,5704,4952,10656
<class,경부선,지제,2446,2392,4838
<class,경부선,평택,12779,11895,24674
<class,경부선,성환,2769,2581,5350
<class,경부선,직산,643,631,1274
<class,경부선,두정,4727,5059,9786
<class,경부선,천안,5467,5660,11127
<class,경부선,당정,3677,3594,7271
<class,경부선,서동탄,975,1062,2037
<class,경부선,광명,2160,1990,4150
<class,경원선,이촌,2792,2100,4892
<class,경원선,서빙고,1225,1070,2295
<class,경원선,한남,2642,2448,5090
<class,경원선,옥수,34,30,64
<class,경원선,응봉,1417,1350,2767
<class,경원선,왕십리,10861,12512,23373
<class,경원선,청량리,13897,15575,29472
<class,경원선,외대앞,5242,5231,10473
<class,경원선,신이문,5905,5367,11272
<class,경원선,석계,6260,6730,12990
<class,경원선,광운대,5265,5063,10328
<class,경원선,월계,4202,3887,8089
<class,경원선,녹천,3102,2698,5800
<class,경원선,방학,6897,6840,13737
<class,경원선,도봉,4230,3969,8199
<class,경원선,도봉산,8176,5563,13739
<class,경원선,망월사,5120,5234,10354
<class,경원선,회룡,8940,7947,16887
<class,경원선,의정부,15853,16580,32433
<class,경원선,가능,4600,4597,9197
<class,경원선,녹양,3235,3100,6335
<class,경원선,양주,5776,5565,11341
<class,경원선,덕계,2099,1939,4038
<class,경원선,덕정,4005,3875,7880
<class,경원선,지행,4878,4842,9720
<class,경원선,동두천중앙,2364,2388,4752
<class,경원선,보산,2097,1833,3930
<class,경원선,동두천,1534,2136,3670
<class,경원선,소요산,3531,2941,6472
<class,경의선,서울역,1113,1241,2354
<class,경의선,신촌,303,304,607
<class,경의선,효창공원앞,1560,1807,3367
<class,경의선,공덕,2056,1684,3740
<class,경의선,서강대,1530,1440,2970
<class,경의선,홍대입구,1501,1759,3260
<class,경의선,가좌,3576,3405,6981
<class,경의선,디지털미디어시티,1755,1583,3338
<class,경의선,수색,1328,1319,2647
<class,경의선,화전,1022,976,1998
<class,경의선,강매,1756,1658,3414
<class,경의선,행신,4683,4673,9356
<class,경의선,능곡,2486,2471,4957
<class,경의선,곡산,383,378,761
<class,경의선,백마,3881,3787,7668
<class,경의선,풍산,3908,3701,7609
<class,경의선,일산,5442,5264,10706
<class,경의선,탄현,4636,4555,9191
<class,경의선,야당,4750,4650,9400
<class,경의선,운정,4120,4002,8122
<class,경의선,금릉,3429,3308,6737
<class,경의선,금촌,5047,4868,9915
<class,경의선,월롱,1254,1160,2414
<class,경의선,파주,824,671,1495
<class,경의선,문산,4090,4069,8159
<class,경의선,임진강,30,41,71
<class,경인선,개봉,15126,14997,30123
<class,경인선,오류동,8554,7739,16293
<class,경인선,역곡,19088,18629,37717
<class,경인선,부천,26941,27758,54699
<class,경인선,송내,16977,16799,33776
<class,경인선,부평,27770,29933,57703
<class,경인선,백운,5174,5056,10230
<class,경인선,동암,11762,11822,23584
<class,경인선,주안,14622,13074,27696
<class,경인선,제물포,7033,6780,13813
<class,경인선,동인천,10751,10648,21399
<class,경인선,인천,3723,3093,6816
<class,경인선,구일,4435,4276,8711
<class,경인선,소사,7332,7058,14390
<class,경인선,부개,6101,5701,11802
<class,경인선,간석,4113,3959,8072
<class,경인선,도원,2437,2439,4876
<class,경인선,온수,4665,4352,9017
<class,경인선,중동,6143,5843,11986
<class,경인선,도화,2870,2650,5520
<class,경춘선,신내,1046,1014,2060
<class,경춘선,갈매,1736,1517,3253
<class,경춘선,별내,1936,1873,3809
<class,경춘선,퇴계원,2371,2227,4598
<class,경춘선,사릉,2171,2100,4271
<class,경춘선,금곡,1047,969,2016
<class,경춘선,평내호평,4141,4002,8143
<class,경춘선,천마산,1282,1290,2572
<class,경춘선,마석,2895,2916,5811
<class,경춘선,대성리,564,635,1199
<class,경춘선,청평,1544,1658,3202
<class,경춘선,상천,563,495,1058
<class,경춘선,가평,1502,1671,3173
<class,경춘선,굴봉산,287,334,621
<class,경춘선,백양리,196,155,351
<class,경춘선,강촌,723,734,1457
<class,경춘선,김유정,452,550,1002
<class,경춘선,남춘천,2795,2905,5700
<class,경춘선,춘천,1279,1228,2507
<class,공항철도 1호선,서울역,5839,6265,12104
<class,공항철도 1호선,공덕,1295,1870,3165
<class,공항철도 1호선,홍대입구,9493,9242,18735
<class,공항철도 1호선,디지털미디어시티,4883,4657,9540
<class,공항철도 1호선,마곡나루,2755,3109,5864
<class,공항철도 1호선,김포공항,10432,5833,16265
<class,공항철도 1호선,계양,5818,5366,11184
<class,공항철도 1호선,검암,4179,4321,8500
<class,공항철도 1호선,청라국제도시,3551,3472,7023
<class,공항철도 1호선,운서,5345,5290,10635
<class,공항철도 1호선,공항화물청사,1267,1326,2593
<class,7호선,고속터미널,12721,10035,22756
<class,7호선,반포,4170,4073,8243
<class,7호선,논현,10549,11486,22035
<class,7호선,학동,10060,10636,20696
<class,7호선,강남구청,9374,10287,19661
<class,7호선,청담,10779,11378,22157
<class,7호선,뚝섬유원지,6302,6119,12421
<class,7호선,건대입구,9741,9758,19499
<class,7호선,어린이대공원,8251,7853,16104
<class,7호선,군자,9864,7506,17370
<class,7호선,중곡,6739,6284,13023
<class,7호선,용마산,4138,4260,8398
<class,7호선,사가정,11757,11548,23305
<class,7호선,면목,10488,10259,20747
<class,7호선,상봉,12662,11934,24596
<class,7호선,중화,7723,7445,15168
<class,7호선,먹골,7473,7359,14832
<class,7호선,태릉입구,6035,5420,11455
<class,7호선,공릉,8419,8295,16714
<class,7호선,하계,11278,10506,21784
<class,7호선,중계,8675,7825,16500
<class,7호선,노원,14678,14961,29639
<class,7호선,마들,8277,7827,16104
<class,7호선,수락산,9474,9413,18887
<class,7호선,도봉산,5954,8328,14282
<class,7호선,장암,1414,1064,2478
<class,6호선,봉화산,4820,4673,9493
<class,6호선,화랑대,6859,5836,12695
<class,6호선,태릉입구,3827,3966,7793
<class,6호선,석계,8345,8390,16735
<class,6호선,돌곶이,5415,5202,10617
<class,6호선,상월곡,3835,3376,7211
<class,6호선,월곡,6688,6637,13325
<class,6호선,고려대,5000,4765,9765
<class,6호선,안암,5627,5431,11058
<class,6호선,보문,4799,4271,9070
<class,6호선,창신,2235,1902,4137
<class,6호선,동묘앞,7403,6795,14198
<class,6호선,신당,5832,4903,10735
<class,6호선,청구,2361,2398,4759
<class,6호선,약수,2263,2317,4580
<class,6호선,버티고개,1444,1523,2967
<class,6호선,한강진,7230,8386,15616
<class,6호선,이태원,10519,11093,21612
<class,6호선,녹사평,4763,4729,9492
<class,6호선,삼각지,4298,3354,7652
<class,6호선,효창공원앞,4274,3737,8011
<class,6호선,공덕,9179,8616,17795
<class,6호선,대흥,5150,4988,10138
<class,6호선,광흥창,4928,4613,9541
<class,6호선,상수,6577,7610,14187
<class,6호선,합정,11070,10422,21492
<class,6호선,망원,11287,12512,23799
<class,6호선,마포구청,8662,7681,16343
<class,6호선,월드컵경기장,5094,5267,10361
<class,6호선,디지털미디어시티,6663,6858,13521
<class,6호선,증산,6842,6804,13646
<class,6호선,새절,9012,8634,17646
<class,6호선,구산,5115,3951,9066
<class,6호선,연신내,1,0,1
<class,6호선,독바위,1897,2143,4040
<class,6호선,불광,3735,3437,7172
<class,6호선,역촌,2363,2719,5082
<class,6호선,응암,11552,11446,22998
<class,5호선,하남검단산,4589,4767,9356
<class,5호선,하남시청,4090,4005,8095
<class,5호선,하남풍산,2582,2634,5216
<class,5호선,미사,10503,10349,20852
<class,5호선,강일,2164,2020,4184
<class,5호선,마천,4241,4378,8619
<class,5호선,거여,5325,4990,10315
<class,5호선,개롱,4259,4538,8797
<class,5호선,오금,2557,2382,4939
<class,5호선,방이,4944,4862,9806
<class,5호선,올림픽공원,2694,2262,4956
<class,5호선,둔촌동,5897,5874,11771
<class,5호선,상일동,9058,8572,17630
<class,5호선,고덕,5728,5558,11286
<class,5호선,명일,5984,5922,11906
<class,5호선,굽은다리,6814,6442,13256
<class,5호선,길동,5568,5799,11367
<class,5호선,강동,11972,11309,23281
<class,5호선,천호,15422,14401,29823
<class,5호선,광나루,8617,8245,16862
<class,5호선,아차산,12053,11911,23964
<class,5호선,군자,8091,8799,16890
<class,5호선,장한평,10089,9958,20047
<class,5호선,답십리,9578,8963,18541
<class,5호선,마장,3990,3841,7831
<class,5호선,왕십리,3342,3738,7080
<class,5호선,행당,5571,4911,10482
<class,5호선,신금호,3762,3800,7562
<class,5호선,청구,2381,2199,4580
<class,5호선,동대문역사문화공원,844,1055,1899
<class,5호선,을지로4가,3049,3333,6382
<class,5호선,종로3가,10582,10756,21338
<class,5호선,광화문,11643,12031,23674
<class,5호선,서대문,6905,6415,13320
<class,5호선,충정로,1920,1692,3612
<class,5호선,애오개,3523,3460,6983
<class,5호선,공덕,6547,6784,13331
<class,5호선,마포,6689,6772,13461
<class,5호선,여의나루,9118,11291,20409
<class,5호선,여의도,11780,11691,23471
<class,5호선,신길,2390,2570,4960
<class,5호선,영등포시장,6533,6886,13419
<class,5호선,영등포구청,1910,1823,3733
<class,5호선,양평,3357,3197,6554
<class,5호선,오목교,15302,15584,30886
<class,5호선,목동,10642,10808,21450
<class,5호선,신정,8417,7167,15584
<class,5호선,까치산,19809,19004,38813
<class,5호선,화곡,18943,17592,36535
<class,5호선,우장산,8958,8999,17957
<class,5호선,발산,12364,12948,25312
<class,5호선,마곡,4744,4726,9470
<class,5호선,송정,4811,4704,9515
<class,5호선,김포공항,6944,7261,14205
<class,5호선,개화산,3419,3425,6844
<class,5호선,방화,4462,4181,8643
<class,4호선,쌍문,19663,17873,37536
<class,4호선,창동,17682,18800,36482
<class,4호선,노원,14562,15649,30211
<class,4호선,상계,12912,12286,25198
<class,4호선,당고개,9166,8558,17724
<class,4호선,남태령,870,658,1528
<class,4호선,사당,18056,15560,33616
<class,4호선,총신대입구,12992,14197,27189
<class,4호선,동작,1814,1985,3799
<class,4호선,이촌,5481,6153,11634
<class,4호선,신용산,8185,8778,16963
<class,4호선,삼각지,2878,3653,6531
<class,4호선,숙대입구,8356,8106,16462
<class,4호선,서울역,4846,10155,15001
<class,4호선,회현,15366,16182,31548
<class,4호선,명동,11113,12706,23819
<class,4호선,충무로,11098,11679,22777
<class,4호선,동대문역사문화공원,9739,8361,18100
<class,4호선,동대문,13206,13204,26410
<class,4호선,혜화,21917,22450,44367
<class,4호선,한성대입구,9845,9667,19512
<class,4호선,성신여대입구,14858,14042,28900
<class,4호선,길음,12833,12383,25216
<class,4호선,미아사거리,20631,20037,40668
<class,4호선,미아,10208,9635,19843
<class,4호선,수유,24549,24141,48690
<class,3호선,오금,3592,3479,7071
<class,3호선,경찰병원,3820,3770,7590
<class,3호선,가락시장,5660,5436,11096
<class,3호선,수서,11829,12134,23963
<class,3호선,일원,4506,4508,9014
<class,3호선,대청,5272,4962,10234
<class,3호선,학여울,1736,1649,3385
<class,3호선,대치,7592,6875,14467
<class,3호선,도곡,3232,3238,6470
<class,3호선,매봉,5673,5597,11270
<class,3호선,양재,18811,20507,39318
<class,3호선,남부터미널,18029,18350,36379
<class,3호선,교대,6073,3664,9737
<class,3호선,고속터미널,42377,43468,85845
<class,3호선,잠원,3254,3131,6385
<class,3호선,신사,22251,22675,44926
<class,3호선,압구정,23301,24175,47476
<class,3호선,옥수,6379,6412,12791
<class,3호선,금호,5598,5180,10778
<class,3호선,약수,8478,7890,16368
<class,3호선,동대입구,5567,6360,11927
<class,3호선,충무로,1,0,1
<class,3호선,을지로3가,4251,4812,9063
<class,3호선,종로3가,5272,7205,12477
<class,3호선,안국,11449,12856,24305
<class,3호선,경복궁,12859,13115,25974
<class,3호선,독립문,5511,5889,11400
<class,3호선,무악재,2449,2558,5007
<class,3호선,홍제,12320,11759,24079
<class,3호선,녹번,9063,7871,16934
<class,3호선,불광,11817,13158,24975
<class,3호선,연신내,27593,25983,53576
<class,3호선,구파발,13735,13827,27562
<class,3호선,지축,2368,2369,4737
<class,2호선,용두,1609,1565,3174
<class,2호선,신정네거리,6896,7023,13919
<class,2호선,양천구청,4082,4263,8345
<class,2호선,도림천,828,829,1657
<class,2호선,신설동,3023,2854,5877
<class,2호선,신답,858,989,1847
<class,2호선,용답,1891,1719,3610
<class,2호선,충정로,5660,5979,11639
<class,2호선,아현,6849,6596,13445
<class,2호선,이대,8718,8948,17666
<class,2호선,신촌,25967,26158,52125
<class,2호선,홍대입구,51111,54201,105312
<class,2호선,합정,24360,25797,50157
<class,2호선,당산,11568,12980,24548
<class,2호선,영등포구청,11884,12091,23975
<class,2호선,문래,11251,11872,23123
<class,2호선,신도림,38373,38727,77100
<class,2호선,대림,17704,18873,36577
<class,2호선,구로디지털단지,32114,31304,63418
<class,2호선,신대방,18958,18485,37443
<class,2호선,신림,46824,44792,91616
<class,2호선,봉천,16243,15104,31347
<class,2호선,서울대입구,35036,33525,68561
<class,2호선,낙성대,19940,18720,38660
<class,2호선,사당,26866,29315,56181
<class,2호선,방배,9128,9436,18564
<class,2호선,서초,10987,8669,19656
<class,2호선,교대,15786,17517,33303
<class,2호선,강남,54726,54513,109239
<class,2호선,역삼,18339,19606,37945
<class,2호선,선릉,22185,19828,42013
<class,2호선,삼성,24423,24519,48942
<class,2호선,종합운동장,5149,5769,10918
<class,2호선,잠실새내,15473,16084,31557
<class,2호선,잠실,54019,51925,105944
<class,2호선,잠실나루,6677,6552,13229
<class,2호선,강변,22726,23794,46520
<class,2호선,구의,14998,14732,29730
<class,2호선,건대입구,29756,31436,61192
<class,2호선,성수,16168,17659,33827
<class,2호선,뚝섬,13636,13696,27332
<class,2호선,왕십리,12436,10514,22950
<class,2호선,상왕십리,9039,8607,17646
<class,2호선,신당,10191,10502,20693
<class,2호선,동대문역사문화공원,8654,9239,17893
<class,2호선,을지로4가,6718,6678,13396
<class,2호선,을지로3가,8853,9049,17902
<class,2호선,을지로입구,18386,17956,36342
<class,2호선,시청,7526,6433,13959
<class,1호선,청량리,17188,17177,34365
<class,1호선,제기동,14438,14864,29302
<class,1호선,신설동,8440,8160,16600
<class,1호선,동대문,10009,9011,19020
<class,1호선,종로5가,16150,16370,32520
<class,1호선,종로3가,19564,18567,38131
<class,1호선,종각,16102,14981,31083
<class,1호선,동묘앞,10307,10800,21107
<class,1호선,서울역,26161,26600,52761
<class,공항철도 1호선,인천공항1터미널,2749,2768,5517
<class,공항철도 1호선,인천공항2터미널,1475,1439,2914
<class,공항철도 1호선,영종,2578,2755,5333
<class,과천선,선바위,4680,4223,8903
<class,과천선,경마공원,988,1001,1989
<class,과천선,대공원,4526,4714,9240
<class,과천선,과천,3815,3412,7227
<class,과천선,정부과천청사,5292,5306,10598
<class,과천선,인덕원,14141,13691,27832
<class,과천선,평촌,8539,8268,16807
<class,과천선,범계,18302,17888,36190
<class,분당선,선릉,4961,7458,12419
<class,분당선,한티,10106,9939,20045
<class,분당선,도곡,4204,3823,8027
<class,분당선,구룡,1118,1041,2159
<class,분당선,개포동,2510,2449,4959
<class,분당선,대모산입구,2455,2239,4694
<class,분당선,수서,9333,9859,19192
<class,분당선,수원,7176,5888,13064
<class,분당선,서울숲,9897,10593,20490
<class,분당선,압구정로데오,16857,19215,36072
<class,분당선,강남구청,4857,5838,10695
<class,분당선,선정릉,3347,3474,6821
<class,분당선,가천대,4581,5169,9750
<class,분당선,태평,9831,9363,19194
<class,분당선,모란,15023,14861,29884
<class,분당선,야탑,15828,16730,32558
<class,분당선,서현,16234,16439,32673
<class,분당선,수내,7997,7462,15459
<class,분당선,정자,10064,10229,20293
<class,분당선,미금,9932,10209,20141
<class,분당선,오리,7183,5918,13101
<class,분당선,이매,4104,4015,8119
<class,분당선,보정,1431,1341,2772
<class,분당선,죽전,9050,10137,19187
<class,분당선,구성,2846,3007,5853
<class,분당선,신갈,2536,2584,5120
<class,분당선,기흥,6136,5945,12081
<class,분당선,상갈,3489,3525,7014
<class,분당선,청명,2484,2491,4975
<class,분당선,영통,5640,5656,11296
<class,분당선,망포,8315,7706,16021
<class,분당선,매탄권선,3092,2974,6066
<class,분당선,수원시청,9788,10545,20333
<class,분당선,매교,1899,1917,3816
<class,수인선,고색,2013,2097,4110
<class,수인선,오목천,1795,1556,3351
<class,수인선,어천,583,527,1110
<class,수인선,야목,190,194,384
<class,수인선,사리,3037,2568,5605
<class,수인선,달월,73,82,155
<class,수인선,월곶,2035,1883,3918
<class,수인선,소래포구,5209,5370,10579
<class,수인선,인천논현,4396,4475,8871
<class,수인선,호구포,2358,2230,4588
<class,수인선,남동인더스파크,1043,954,1997
<class,수인선,원인재,3456,3658,7114
<class,수인선,연수,3560,3493,7053
<class,수인선,송도,1901,1860,3761
<class,수인선,인하대,3833,3681,7514
<class,수인선,숭의,2563,2451,5014
<class,수인선,신포,1302,1329,2631
<class,수인선,인천,993,1785,2778
<class,안산선,산본,11366,11976,23342
<class,안산선,대야미,3817,3404,7221
<class,안산선,반월,3115,2923,6038
<class,안산선,상록수,11433,11455,22888
<class,안산선,한대앞,6689,6578,13267
<class,안산선,중앙,14732,15000,29732
<class,안산선,고잔,5872,5961,11833
<class,안산선,초지,3018,3150,6168
<class,안산선,안산,9407,9857,19264
<class,안산선,신길온천,1353,1305,2658
<class,안산선,정왕,6065,6245,12310
<class,안산선,오이도,7128,7343,14471
<class,안산선,수리산,2944,2776,5720
<class,우이신설선,북한산우이,2730,2744,5474
<class,우이신설선,솔밭공원,1596,1533,3129
<class,우이신설선,4.19민주묘지,2152,1950,4102
<class,우이신설선,가오리,2713,2607,5320
<class,우이신설선,화계,2306,2179,4485
<class,우이신설선,삼양,1401,1496,2897
<class,우이신설선,삼양사거리,1740,1686,3426
<class,우이신설선,솔샘,3459,3248,6707
<class,우이신설선,북한산보국문,4356,3860,8216
<class,우이신설선,정릉,3204,2783,5987
<class,우이신설선,성신여대입구,2439,2719,5158
<class,우이신설선,보문,1041,1055,2096
<class,2호선,한양대,3646,3713,7359
<class,우이신설선,신설동,1280,1254,2534
<class,일산선,원흥,6293,6116,12409
<class,일산선,삼송,12320,11984,24304
<class,일산선,원당,7662,7366,15028
<class,일산선,화정,11522,11898,23420
<class,일산선,대곡,1199,1057,2256
<class,일산선,백석,6943,7065,14008
<class,일산선,마두,4638,4644,9282
<class,일산선,정발산,5552,5741,11293
<class,일산선,주엽,5706,5765,11471
<class,일산선,대화,7504,6822,14326
<class,장항선,봉명,643,635,1278
<class,장항선,쌍용,1340,1227,2567
<class,장항선,아산,2615,2562,5177
<class,장항선,배방,937,842,1779
<class,장항선,온양온천,3436,3416,6852
<class,장항선,신창,1034,909,1943
<class,중앙선,회기,17258,16399,33657
<class,중앙선,중랑,4063,3945,8008
<class,중앙선,상봉,4850,4689,9539
<class,중앙선,망우,6165,6166,12331
<class,중앙선,양원,1075,1134,2209
<class,중앙선,구리,9413,9611,19024
<class,중앙선,도농,6021,5747,11768
<class,중앙선,양정,674,556,1230
<class,중앙선,덕소,4305,4328,8633
<class,중앙선,도심,1592,1373,2965
<class,중앙선,팔당,1465,1578,3043
<class,중앙선,운길산,1495,1388,2883
<class,중앙선,양수,2105,2169,4274
<class,중앙선,신원,388,318,706
<class,중앙선,국수,710,737,1447
<class,중앙선,아신,659,659,1318
<class,중앙선,오빈,324,311,635
<class,중앙선,양평,2395,2594,4989
<class,중앙선,원덕,546,521,1067
<class,중앙선,용문,1993,2396,4389
<class,중앙선,지평,46,67,113
<class,7호선,내방,7388,7197,14585
<class,1호선,시청,8996,9416,18412
<class,일산선,화정,8535,8853,17388
<class,과천선,대공원,6346,6560,12906
<class,과천선,경마공원,940,919,1859
<class,과천선,선바위,3476,3237,6713
<class,공항철도 1호선,영종,2186,2145,4331
<class,공항철도 1호선,인천공항2터미널,1439,1433,2872
<class,공항철도 1호선,인천공항1터미널,2767,2786,5553
<class,공항철도 1호선,공항화물청사,968,1057,2025
<class,공항철도 1호선,운서,4453,4793,9246
<class,공항철도 1호선,청라국제도시,2663,2601,5264
<class,공항철도 1호선,검암,3378,3644,7022
<class,공항철도 1호선,계양,4361,4210,8571
<class,공항철도 1호선,김포공항,10901,5555,16456
<class,공항철도 1호선,마곡나루,2378,2553,4931
<class,공항철도 1호선,디지털미디어시티,3235,3280,6515
<class,공항철도 1호선,홍대입구,8032,7007,15039
<class,공항철도 1호선,공덕,1025,1295,2320
<class,공항철도 1호선,서울역,6236,5339,11575
<class,경춘선,춘천,1648,1388,3036
<class,경춘선,남춘천,1999,2183,4182
<class,경춘선,김유정,511,533,1044
<class,경춘선,강촌,1032,913,1945
<class,경춘선,백양리,202,207,409
<class,경춘선,굴봉산,417,429,846
<class,경춘선,가평,1802,1538,3340
<class,경춘선,상천,764,577,1341
<class,경춘선,청평,1956,1627,3583
<class,경춘선,대성리,824,692,1516
<class,경춘선,마석,3133,3234,6367
<class,경춘선,천마산,1145,1180,2325
<class,경춘선,평내호평,3457,3386,6843
<class,경춘선,금곡,902,869,1771
<class,경춘선,사릉,1680,1699,3379
<class,경춘선,퇴계원,2147,1943,4090
<class,경춘선,별내,1667,1537,3204
<class,경춘선,갈매,1405,1185,2590
<class,경춘선,신내,855,867,1722
<class,경인선,도화,2234,2008,4242
<class,경인선,중동,4512,4315,8827
<class,경인선,온수,3453,3265,6718
<class,경인선,도원,1584,1623,3207
<class,경인선,간석,2937,2830,5767
<class,경인선,부개,4370,4142,8512
<class,경인선,소사,5411,5086,10497
<class,경인선,구일,3115,3182,6297
<class,경인선,인천,3811,3092,6903
<class,경인선,동인천,8747,8365,17112
<class,경인선,제물포,5178,5118,10296
<class,경인선,주안,10618,9360,19978
<class,경인선,동암,8951,8997,17948
<class,경인선,백운,3711,3721,7432
<class,경인선,부평,20863,21158,42021
<class,경인선,송내,12016,11794,23810
<class,경인선,부천,20928,20307,41235
<class,경인선,역곡,13223,13180,26403
<class,경인선,오류동,6626,6388,13014
<class,경인선,개봉,10802,10771,21573
<class,경의선,임진강,74,56,130
<class,경의선,문산,3217,3297,6514
<class,경의선,파주,688,625,1313
<class,경의선,월롱,841,1341,2182
<class,경의선,금촌,3768,3958,7726
<class,경의선,금릉,2621,2614,5235
<class,경의선,운정,3331,3185,6516
<class,경의선,야당,3931,3734,7665
<class,경의선,탄현,3604,3411,7015
<class,경의선,일산,5347,5126,10473
<class,경의선,풍산,3239,3155,6394
<class,경의선,백마,2973,2996,5969
<class,경의선,곡산,347,323,670
<class,중앙선,지평,72,85,157
<class,중앙선,용문,2637,2160,4797
<class,중앙선,원덕,612,506,1118
<class,중앙선,양평,4366,3912,8278
<class,중앙선,오빈,308,276,584
<class,중앙선,아신,693,655,1348
<class,중앙선,국수,847,721,1568
<class,중앙선,신원,494,335,829
<class,중앙선,양수,2139,2027,4166
<class,중앙선,운길산,1895,1650,3545
<class,중앙선,팔당,1875,2049,3924
<class,중앙선,도심,1263,1178,2441
<class,중앙선,덕소,3499,3575,7074
<class,중앙선,양정,595,515,1110
<class,중앙선,도농,4575,4557,9132
<class,중앙선,구리,7211,7445,14656
<class,중앙선,양원,907,1039,1946
<class,중앙선,망우,4612,4709,9321
<class,중앙선,상봉,4060,3836,7896
<class,중앙선,중랑,3311,3251,6562
<class,중앙선,회기,13035,13267,26302
<class,장항선,신창,879,1084,1963
<class,장항선,온양온천,2869,2767,5636
<class,장항선,배방,650,812,1462
<class,장항선,아산,2629,1788,4417
<class,장항선,쌍용,1027,1101,2128
<class,장항선,봉명,434,487,921
<class,일산선,대화,5563,5081,10644
<class,일산선,주엽,4119,3935,8054
<class,일산선,정발산,4786,4554,9340
<class,일산선,마두,3093,3154,6247
<class,일산선,백석,5079,5026,10105
<class,일산선,대곡,1006,844,1850
<class,일산선,원당,5902,5747,11649
<class,일산선,삼송,9351,9018,18369
<class,일산선,원흥,4758,4600,9358
<class,우이신설선,신설동,1161,1144,2305
<class,우이신설선,보문,907,910,1817
<class,우이신설선,성신여대입구,1931,2116,4047
<class,우이신설선,정릉,2547,2214,4761
<class,우이신설선,북한산보국문,3399,3195,6594
<class,우이신설선,솔샘,2469,2369,4838
<class,우이신설선,삼양사거리,1420,1407,2827
<class,우이신설선,삼양,1180,1203,2383
<class,우이신설선,화계,1998,1878,3876
<class,우이신설선,가오리,2237,2135,4372
<class,우이신설선,4.19민주묘지,2027,1777,3804
<class,우이신설선,솔밭공원,1352,1332,2684
<class,우이신설선,북한산우이,3351,3494,6845
<class,안산선,수리산,2427,2913,5340
<class,안산선,오이도,5417,5451,10868
<class,안산선,정왕,4687,5175,9862
<class,안산선,신길온천,1131,1018,2149
<class,안산선,안산,9430,8753,18183
<class,안산선,초지,2247,2197,4444
<class,안산선,고잔,4138,4121,8259
<class,안산선,중앙,10381,10263,20644
<class,안산선,한대앞,4783,4772,9555
<class,안산선,상록수,8539,8369,16908
<class,안산선,반월,2387,2353,4740
<class,안산선,대야미,3283,2740,6023
<class,안산선,산본,8110,8556,16666
<class,수인선,인천,1132,1577,2709
<class,수인선,신포,1074,1066,2140
<class,수인선,숭의,1908,1787,3695
<class,수인선,인하대,2775,2745,5520
<class,수인선,야목,160,160,320
<class,수인선,어천,460,529,989
<class,수인선,오목천,1187,1193,2380
<class,수인선,고색,1322,1485,2807
<class,분당선,매교,1354,1415,2769
<class,분당선,수원시청,6442,6362,12804
<class,분당선,매탄권선,2139,2156,4295
<class,분당선,망포,5494,5894,11388
<class,분당선,영통,4055,4012,8067
<class,분당선,청명,1735,1774,3509
<class,분당선,상갈,2726,2712,5438
<class,분당선,기흥,4328,4198,8526
<class,분당선,신갈,1755,1814,3569
<class,분당선,구성,2091,2270,4361
<class,분당선,죽전,7008,7941,14949
<class,분당선,보정,949,912,1861
<class,분당선,이매,2742,2809,5551
<class,분당선,오리,4754,4174,8928
<class,분당선,미금,6159,6798,12957
<class,분당선,정자,6554,6872,13426
<class,분당선,수내,5283,4983,10266
<class,분당선,서현,11516,11460,22976
<class,분당선,야탑,11436,11538,22974
<class,분당선,모란,10465,10492,20957
<class,분당선,태평,7361,7019,14380
<class,분당선,가천대,3057,3836,6893
<class,경원선,창동,1,0,1
<class,수인선,사리,2166,1900,4066
<class,수인선,달월,93,100,193
<class,수인선,월곶,1604,1496,3100
<class,수인선,소래포구,5082,4945,10027
<class,수인선,인천논현,2756,2823,5579
<class,수인선,호구포,1744,1871,3615
<class,수인선,남동인더스파크,623,595,1218
<class,수인선,원인재,2530,2651,5181
<class,수인선,연수,2675,2667,5342
<class,수인선,송도,1478,1405,2883
<class,경의선,능곡,2028,2007,4035
<class,경의선,행신,3893,3718,7611
<class,경의선,강매,1302,1275,2577
<class,경의선,화전,771,765,1536
<class,경의선,수색,864,916,1780
<class,경의선,디지털미디어시티,1265,1226,2491
<class,경의선,가좌,2673,2695,5368
<class,경의선,홍대입구,1314,1489,2803
<class,경의선,서강대,1142,1105,2247
<class,경의선,공덕,1487,1173,2660
<class,경의선,효창공원앞,1201,1328,2529
<class,경의선,신촌,218,214,432
<class,경의선,서울역,922,875,1797
<class,경원선,소요산,4886,4124,9010
<class,경원선,동두천,1374,2016,3390
<class,경원선,보산,1326,1592,2918
<class,경원선,동두천중앙,1970,1873,3843
<class,경원선,지행,4009,4079,8088
<class,경원선,덕정,3203,3338,6541
<class,경원선,덕계,1613,1496,3109
<class,경원선,양주,4844,4827,9671
<class,경원선,녹양,2543,2484,5027
<class,경원선,가능,3821,3720,7541
<class,경원선,의정부,12850,12873,25723
<class,경원선,회룡,6865,5924,12789
<class,경원선,망월사,4126,4422,8548
<class,경원선,도봉산,9931,7158,17089
<class,경원선,도봉,3367,3277,6644
<class,경원선,방학,5683,5464,11147
<class,경원선,녹천,2444,2124,4568
<class,경원선,월계,3537,3390,6927
<class,경원선,광운대,3895,4096,7991
<class,경원선,석계,4637,5114,9751
<class,경원선,신이문,4577,4303,8880
<class,경원선,외대앞,4000,3901,7901
<class,경원선,청량리,12765,12085,24850
<class,경원선,왕십리,7973,9324,17297
<class,경원선,응봉,1184,1256,2440
<class,경원선,옥수,64,25,89
<class,경원선,한남,1962,1973,3935
<class,경원선,서빙고,1200,1187,2387
<class,경원선,이촌,2268,1724,3992
<class,경부선,광명,2137,1424,3561
<class,경부선,서동탄,759,785,1544
<class,경부선,당정,2706,2778,5484
<class,경부선,천안,5409,4923,10332
<class,경부선,두정,4061,4337,8398
<class,경부선,직산,522,573,1095
<class,경부선,성환,2178,2469,4647
<class,경부선,평택,10043,10782,20825
<class,경부선,지제,2101,1866,3967
<class,경부선,서정리,3707,5239,8946
<class,경부선,송탄,3358,4052,7410
<class,경부선,진위,774,810,1584
<class,경부선,오산,7346,7980,15326
<class,경부선,오산대,2024,1958,3982
<class,경부선,세마,1543,1435,2978
<class,경부선,병점,8083,8917,17000
<class,경부선,세류,1754,1853,3607
<class,경부선,독산,5534,5656,11190
<class,경부선,수원,29670,28319,57989
<class,경부선,화서,3541,3503,7044
<class,경부선,성균관대,6750,7236,13986
<class,경부선,의왕,4026,4036,8062
<class,경부선,군포,2888,2748,5636
<class,경부선,금정,12599,12867,25466
<class,경부선,명학,3256,3201,6457
<class,경부선,안양,12460,12119,24579
<class,경부선,관악,4649,4314,8963
<class,경부선,석수,5150,4930,10080
<class,경부선,금천구청,5922,5906,11828
<class,경부선,가산디지털단지,4371,5965,10336
<class,경부선,구로,8899,8869,17768
<class,경부선,신길,4496,3965,8461
<class,경부선,신도림,2134,2175,4309
<class,경부선,영등포,27761,26648,54409
<class,경부선,대방,5369,5784,11153
<class,경부선,노량진,5504,5411,10915
<class,경부선,용산,25814,22638,48452
<class,경부선,남영,3775,4002,7777
<class,경부선,서울역,5733,1145,6878
<class,경강선,여주,1952,1825,3777
<class,경강선,세종대왕릉,289,258,547
<class,경강선,부발,1086,1736,2822
<class,경강선,이천,1695,1939,3634
<class,경강선,신둔도예촌,826,776,1602
<class,경강선,곤지암,1407,1604,3011
<class,경강선,초월,1430,1415,2845
<class,경강선,경기광주,3386,3313,6699
<class,경강선,삼동,883,915,1798
<class,경강선,이매,595,550,1145
<class,경강선,판교,2043,1846,3889
<class,9호선2~3단계,중앙보훈병원,2906,2759,5665
<class,9호선2~3단계,둔촌오륜,399,424,823
<class,9호선2~3단계,올림픽공원,3081,3126,6207
<class,9호선2~3단계,한성백제,1316,1199,2515
<class,9호선2~3단계,송파나루,2494,2791,5285
<class,9호선2~3단계,석촌,4061,3620,7681
<class,9호선2~3단계,석촌고분,2730,2710,5440
<class,9호선2~3단계,삼전,3229,3153,6382
<class,9호선2~3단계,종합운동장,1929,1692,3621
<class,9호선2~3단계,봉은사,6325,6265,12590
<class,9호선2~3단계,삼성중앙,1731,1797,3528
<class,9호선2~3단계,선정릉,2956,3298,6254
<class,9호선2~3단계,언주,2872,2939,5811
<class,9호선,신논현,13421,12741,26162
<class,9호선,사평,1149,1232,2381
<class,9호선,고속터미널,8931,11722,20653
<class,9호선,신반포,1450,1535,2985
<class,9호선,구반포,1067,1199,2266
<class,9호선,동작,1072,888,1960
<class,9호선,흑석,3384,3642,7026
<class,9호선,노들,2357,2200,4557
<class,9호선,노량진,13547,14601,28148
<class,9호선,샛강,1564,1487,3051
<class,9호선,여의도,8370,7397,15767
<class,9호선,국회의사당,4059,3780,7839
<class,9호선,당산,7970,7851,15821
<class,9호선,선유도,2782,2752,5534
<class,9호선,신목동,1548,1365,2913
<class,9호선,염창,7606,7590,15196
<class,9호선,등촌,4844,4992,9836
<class,9호선,증미,2783,2876,5659
<class,9호선,가양,9171,9148,18319
<class,9호선,양천향교,3836,4127,7963
<class,9호선,마곡나루,5485,5500,10985
<class,9호선,신방화,3073,3100,6173
<class,9호선,공항시장,1522,1642,3164
<class,9호선,김포공항,7248,10175,17423
<class,9호선,개화,1055,975,2030
<class,8호선,모란,2382,2047,4429
<class,8호선,수진,2718,2483,5201
<class,8호선,신흥,2657,2730,5387
<class,8호선,단대오거리,4988,5141,10129
<class,8호선,남한산성입구,6310,5894,12204
<class,8호선,산성,3678,3708,7386
<class,8호선,복정,4655,4464,9119
<class,8호선,장지,8182,8433,16615
<class,8호선,문정,5146,5518,10664
<class,8호선,가락시장,2997,3824,6821
<class,8호선,송파,3108,3322,6430
<class,8호선,석촌,3751,4562,8313
<class,8호선,잠실,8409,8979,17388
<class,8호선,몽촌토성,3148,3120,6268
<class,8호선,강동구청,3979,4199,8178
<class,8호선,천호,8069,9203,17272
<class,8호선,암사,8471,8055,16526
<class,7호선,부평구청,4658,4016,8674
<class,7호선,굴포천,4221,4164,8385
<class,7호선,삼산체육관,2242,2190,4432
<class,7호선,상동,6330,6065,12395
<class,7호선,부천시청,6055,6097,12152
<class,7호선,신중동,6373,6151,12524
<class,7호선,춘의,3267,3106,6373
<class,7호선,부천종합운동장,2304,2140,4444
<class,7호선,까치울,3926,3882,7808
<class,7호선,온수,3648,3730,7378
<class,7호선,천왕,4611,4466,9077
<class,7호선,광명사거리,11466,11277,22743
<class,7호선,철산,9465,9531,18996
<class,7호선,가산디지털단지,10272,9413,19685
<class,7호선,남구로,6312,6173,12485
<class,7호선,대림,6193,5825,12018
<class,7호선,신풍,5574,5272,10846
<class,7호선,보라매,4600,4848,9448
<class,7호선,신대방삼거리,7304,7276,14580
<class,7호선,장승배기,4904,4933,9837
<class,7호선,상도,4751,4838,9589
<class,7호선,숭실대입구,5189,5601,10790
<class,7호선,남성,5016,5074,10090
<class,7호선,이수,7520,7133,14653
<class,7호선,내방,4709,4769,9478
<class,7호선,고속터미널,10919,6838,17757
<class,7호선,반포,2672,2659,5331
<class,7호선,논현,5783,6256,12039
<class,7호선,학동,5177,5575,10752
<class,7호선,강남구청,4985,5409,10394
<class,7호선,청담,6396,6643,13039
<class,7호선,뚝섬유원지,7845,7878,15723
<class,7호선,건대입구,7200,6908,14108
<class,7호선,어린이대공원,7308,7630,14938
<class,7호선,군자,7107,5622,12729
<class,7호선,중곡,4865,4601,9466
<class,7호선,용마산,3187,3743,6930
<class,7호선,사가정,8824,8522,17346
<class,7호선,면목,7565,7552,15117
<class,7호선,상봉,9026,8660,17686
<class,7호선,중화,5551,5416,10967
<class,7호선,먹골,5072,4970,10042
<class,7호선,태릉입구,4643,4184,8827
<class,7호선,공릉,5853,6089,11942
<class,7호선,하계,8327,8016,16343
<class,7호선,중계,6284,5761,12045
<class,7호선,노원,9889,10053,19942
<class,7호선,마들,5463,5047,10510
<class,7호선,수락산,8341,8355,16696
<class,7호선,도봉산,5587,8287,13874
<class,7호선,장암,1408,1068,2476
<class,6호선,봉화산,3665,3611,7276
<class,6호선,화랑대,4560,3972,8532
<class,6호선,태릉입구,2806,3069,5875
<class,6호선,석계,5962,6237,12199
<class,6호선,돌곶이,4348,4369,8717
<class,6호선,상월곡,2962,2745,5707
<class,6호선,월곡,5089,5009,10098
<class,6호선,고려대,3519,3468,6987
<class,6호선,안암,4062,4401,8463
<class,6호선,보문,3590,3494,7084
<class,6호선,창신,1530,1370,2900
<class,6호선,동묘앞,6046,5873,11919
<class,6호선,신당,3155,4000,7155
<class,6호선,청구,1641,1653,3294
<class,6호선,약수,1545,1539,3084
<class,6호선,버티고개,1057,1233,2290
<class,6호선,한강진,5643,6315,11958
<class,6호선,이태원,8135,7810,15945
<class,6호선,녹사평,3786,3623,7409
<class,6호선,삼각지,3029,2179,5208
<class,6호선,효창공원앞,3051,2880,5931
<class,6호선,공덕,6267,5866,12133
<class,6호선,대흥,3328,3480,6808
<class,6호선,광흥창,3806,3779,7585
<class,6호선,상수,4824,5480,10304
<class,6호선,합정,8321,7400,15721
<class,6호선,망원,9096,9751,18847
<class,6호선,마포구청,6452,6106,12558
<class,6호선,월드컵경기장,4179,4142,8321
<class,6호선,디지털미디어시티,4791,5062,9853
<class,6호선,증산,5319,5465,10784
<class,6호선,새절,6053,5964,12017
<class,6호선,구산,3524,2722,6246
<class,6호선,독바위,1578,2008,3586
<class,6호선,불광,2869,2544,5413
<class,6호선,역촌,1753,2157,3910
<class,6호선,응암,8538,9059,17597
<class,5호선,하남검단산,4911,4895,9806
<class,5호선,하남시청,3104,2999,6103
<class,5호선,하남풍산,2035,2083,4118
<class,5호선,미사,7764,7742,15506
<class,5호선,강일,1691,1593,3284
<class,5호선,마천,3235,3561,6796
<class,5호선,거여,3462,3442,6904
<class,5호선,개롱,2840,3126,5966
<class,5호선,오금,1503,1353,2856
<class,5호선,방이,3575,3525,7100
<class,5호선,올림픽공원,2182,1904,4086
<class,5호선,둔촌동,4199,4383,8582
<class,5호선,상일동,6486,6221,12707
<class,5호선,고덕,4038,4052,8090
<class,5호선,명일,4364,4409,8773
<class,5호선,굽은다리,4991,4650,9641
<class,5호선,길동,3872,4077,7949
<class,5호선,강동,8370,8385,16755
<class,분당선,선정릉,2146,2255,4401
<class,5호선,천호,11624,10718,22342
<class,5호선,광나루,7250,7068,14318
<class,5호선,아차산,11209,11395,22604
<class,5호선,군자,5527,6223,11750
<class,5호선,장한평,6683,6677,13360
<class,5호선,답십리,6769,6440,13209
<class,5호선,마장,2648,2570,5218
<class,5호선,왕십리,2379,2535,4914
<class,5호선,행당,3693,3256,6949
<class,5호선,신금호,2648,2881,5529
<class,5호선,청구,1671,1547,3218
<class,5호선,동대문역사문화공원,588,754,1342
<class,5호선,을지로4가,1421,1470,2891
<class,5호선,종로3가,7231,6745,13976
<class,5호선,광화문,9609,9364,18973
<class,5호선,서대문,4363,4267,8630
<class,5호선,충정로,1328,1410,2738
<class,5호선,애오개,2503,2621,5124
<class,5호선,공덕,4199,4220,8419
<class,5호선,마포,4470,4446,8916
<class,5호선,여의나루,10904,12481,23385
<class,5호선,여의도,8016,7648,15664
<class,5호선,신길,1771,1998,3769
<class,5호선,영등포시장,4275,4585,8860
<class,5호선,영등포구청,1246,1246,2492
<class,5호선,양평,2465,2611,5076
<class,5호선,오목교,10532,10884,21416
<class,5호선,목동,7024,7288,14312
<class,5호선,신정,5833,5299,11132
<class,5호선,까치산,14782,14634,29416
<class,5호선,화곡,13256,12424,25680
<class,5호선,우장산,6118,6383,12501
<class,5호선,발산,7822,8272,16094
<class,5호선,마곡,3208,3350,6558
<class,5호선,송정,3555,3604,7159
<class,5호선,김포공항,6738,6122,12860
<class,분당선,강남구청,2765,3396,6161
<class,5호선,개화산,2557,2694,5251
<class,5호선,방화,3304,3283,6587
<class,4호선,쌍문,14412,13284,27696
<class,4호선,창동,13558,14250,27808
<class,4호선,노원,10608,11195,21803
<class,4호선,상계,9825,9356,19181
<class,4호선,당고개,7308,6861,14169
<class,4호선,남태령,569,510,1079
<class,4호선,사당,12980,12237,25217
<class,4호선,총신대입구,9337,10308,19645
<class,4호선,동작,1841,1870,3711
<class,4호선,이촌,4338,4967,9305
<class,4호선,신용산,6484,6227,12711
<class,4호선,삼각지,1908,2404,4312
<class,4호선,숙대입구,6016,5872,11888
<class,4호선,서울역,3638,7409,11047
<class,4호선,회현,7481,7869,15350
<class,4호선,명동,9327,9653,18980
<class,4호선,충무로,7427,7640,15067
<class,4호선,동대문역사문화공원,7666,7420,15086
<class,4호선,동대문,6786,7227,14013
<class,4호선,혜화,17510,18109,35619
<class,4호선,한성대입구,6980,7092,14072
<class,4호선,성신여대입구,10987,10487,21474
<class,4호선,길음,9275,9007,18282
<class,4호선,미아사거리,15012,14584,29596
<class,4호선,미아,7617,7198,14815
<class,4호선,수유,18411,17572,35983
<class,3호선,오금,2515,2504,5019
<class,3호선,경찰병원,2515,2681,5196
<class,3호선,가락시장,3482,3741,7223
<class,3호선,수서,9619,9461,19080
<class,3호선,일원,2962,3119,6081
<class,3호선,대청,3589,3586,7175
<class,3호선,학여울,1279,1429,2708
<class,3호선,대치,4757,4328,9085
<class,3호선,도곡,1783,1942,3725
<class,3호선,매봉,3780,3918,7698
<class,3호선,양재,12331,14238,26569
<class,3호선,남부터미널,12205,12938,25143
<class,3호선,교대,3588,2213,5801
<class,3호선,고속터미널,35600,32425,68025
<class,3호선,잠원,2115,2230,4345
<class,3호선,신사,12444,12133,24577
<class,3호선,압구정,12887,13321,26208
<class,3호선,옥수,5050,5348,10398
<class,3호선,금호,4175,4004,8179
<class,3호선,약수,6162,6034,12196
<class,3호선,동대입구,4728,5420,10148
<class,3호선,을지로3가,2739,2639,5378
<class,3호선,종로3가,3343,4269,7612
<class,3호선,안국,8885,9579,18464
<class,3호선,경복궁,10340,10892,21232
<class,3호선,독립문,4136,4976,9112
<class,3호선,무악재,1807,1971,3778
<class,3호선,홍제,8492,8237,16729
<class,3호선,녹번,6529,5794,12323
<class,3호선,불광,9325,11114,20439
<class,3호선,연신내,20497,19278,39775
<class,3호선,구파발,10657,11098,21755
<class,3호선,지축,1787,1710,3497
<class,2호선,용두,1144,1129,2273
<class,2호선,신정네거리,4699,4871,9570
<class,2호선,양천구청,2918,3013,5931
<class,2호선,도림천,478,499,977
<class,2호선,신설동,2861,2957,5818
<class,2호선,신답,711,781,1492
<class,2호선,용답,1461,1487,2948
<class,2호선,충정로,3554,3795,7349
<class,2호선,아현,4872,4859,9731
<class,2호선,이대,5802,6269,12071
<class,2호선,신촌,18239,17605,35844
<class,2호선,홍대입구,37447,36959,74406
<class,2호선,합정,17821,18461,36282
<class,2호선,당산,8255,9052,17307
<class,2호선,영등포구청,7663,7898,15561
<class,2호선,문래,7077,7435,14512
<class,2호선,신도림,26473,26497,52970
<class,2호선,대림,13774,14081,27855
<class,2호선,구로디지털단지,21532,21268,42800
<class,2호선,신대방,14669,14665,29334
<class,2호선,신림,34142,33519,67661
<class,2호선,봉천,11491,11196,22687
<class,2호선,서울대입구,25088,25835,50923
<class,2호선,낙성대,14374,14883,29257
<class,2호선,사당,18773,20976,39749
<class,2호선,방배,6128,6525,12653
<class,2호선,서초,9565,9035,18600
<class,2호선,교대,9415,10396,19811
<class,2호선,강남,30176,28916,59092
<class,2호선,역삼,10342,11247,21589
<class,2호선,선릉,11856,10425,22281
<class,2호선,삼성,16773,16345,33118
<class,2호선,종합운동장,4100,4649,8749
<class,2호선,잠실새내,9739,9932,19671
<class,2호선,잠실,39482,37061,76543
<class,2호선,잠실나루,4656,4722,9378
<class,2호선,강변,18803,18379,37182
<class,2호선,구의,10604,10656,21260
<class,2호선,건대입구,22948,23224,46172
<class,2호선,성수,12200,12860,25060
<class,2호선,뚝섬,11871,11324,23195
<class,2호선,한양대,2030,2373,4403
<class,2호선,왕십리,8373,7030,15403
<class,2호선,상왕십리,6324,6345,12669
<class,2호선,신당,7390,8055,15445
<class,2호선,동대문역사문화공원,6394,7714,14108
<class,2호선,을지로4가,2818,2766,5584
<class,2호선,을지로3가,6486,5687,12173
<class,2호선,을지로입구,13761,12845,26606
<class,2호선,시청,5169,4064,9233
<class,1호선,청량리,12719,12568,25287
<class,1호선,신설동,6952,6884,13836
<class,1호선,동대문,9000,9583,18583
<class,1호선,종로5가,8127,8258,16385
<class,1호선,종로3가,12927,11380,24307
<class,1호선,종각,10912,9427,20339
<class,1호선,시청,6575,6472,13047
<class,1호선,동묘앞,12894,13358,26252
<class,1호선,서울역,23488,19721,43209
<class,1호선,제기동,9351,9849,19200
<class,분당선,압구정로데오,9343,10209,19552
<class,분당선,서울숲,10472,12207,22679
<class,분당선,수원,5511,4250,9761
<class,분당선,복정,1,0,1
<class,분당선,수서,7806,7341,15147
<class,분당선,대모산입구,1441,1388,2829
<class,분당선,개포동,1800,1793,3593
<class,분당선,구룡,634,714,1348
<class,분당선,도곡,2378,2229,4607
<class,분당선,한티,6443,6467,12910
<class,분당선,선릉,2640,3920,6560
<class,과천선,범계,12665,12229,24894
<class,과천선,평촌,5548,5414,10962
<class,과천선,인덕원,10182,10018,20200
<class,과천선,정부과천청사,3813,4152,7965
<class,과천선,과천,2907,2623,5530
<class,경부선,의왕,5809,5612,11421
<class,5호선,까치산,20738,19737,40475
<class,5호선,신정,8716,7270,15986
<class,5호선,목동,10695,10914,21609
<class,5호선,오목교,16083,16784,32867
<class,5호선,양평,3645,3511,7156
<class,5호선,영등포구청,1980,1920,3900
<class,5호선,영등포시장,6686,7040,13726
<class,5호선,신길,2539,2564,5103
<class,5호선,여의도,10828,11473,22301
<class,5호선,여의나루,15983,17906,33889
<class,5호선,마포,6882,6921,13803
<class,5호선,공덕,6730,6981,13711
<class,5호선,애오개,3486,3367,6853
<class,5호선,충정로,1966,1737,3703
<class,5호선,서대문,6647,6554,13201
<class,5호선,광화문,13010,13128,26138
<class,5호선,종로3가,10903,11399,22302
<class,5호선,을지로4가,3165,3531,6696
<class,5호선,동대문역사문화공원,919,1183,2102
<class,5호선,청구,2396,2175,4571
<class,5호선,신금호,3864,3904,7768
<class,5호선,행당,5497,4645,10142
<class,5호선,왕십리,3239,3805,7044
<class,5호선,마장,3729,3543,7272
<class,5호선,답십리,9650,8872,18522
<class,5호선,장한평,10686,10221,20907
<class,5호선,군자,8009,8495,16504
<class,5호선,아차산,12887,12901,25788
<class,5호선,광나루,9842,9209,19051
<class,5호선,천호,16002,15261,31263
<class,5호선,강동,11826,11234,23060
<class,5호선,길동,5775,5828,11603
<class,5호선,굽은다리,6724,6224,12948
<class,5호선,명일,5866,5792,11658
<class,5호선,고덕,5893,5768,11661
<class,5호선,상일동,9364,8654,18018
<class,5호선,둔촌동,5847,5850,11697
<class,5호선,올림픽공원,2893,2485,5378
<class,5호선,방이,4903,4733,9636
<class,5호선,오금,2231,2009,4240
<class,5호선,개롱,4153,4347,8500
<class,5호선,거여,5297,5055,10352
<class,5호선,마천,4417,4489,8906
<class,5호선,강일,2229,2081,4310
<class,5호선,미사,10658,10726,21384
<class,5호선,하남풍산,2664,2605,5269
<class,5호선,하남시청,4485,4428,8913
<class,5호선,하남검단산,5190,5300,10490
<class,6호선,응암,11971,11842,23813
<class,6호선,역촌,2355,2798,5153
<class,6호선,불광,3931,3598,7529
<class,6호선,독바위,1956,2368,4324
<class,6호선,연신내,2,0,2
<class,6호선,구산,5202,3869,9071
<class,6호선,새절,8805,8320,17125
<class,6호선,증산,7193,7100,14293
<class,6호선,디지털미디어시티,6856,7114,13970
<class,6호선,월드컵경기장,4852,5015,9867
<class,6호선,마포구청,8972,7801,16773
<class,6호선,망원,12486,13882,26368
<class,6호선,합정,11617,10691,22308
<class,6호선,상수,6738,7929,14667
<class,6호선,광흥창,4806,4344,9150
<class,6호선,대흥,5011,4926,9937
<class,6호선,공덕,9413,8869,18282
<class,6호선,효창공원앞,4517,3899,8416
<class,6호선,삼각지,4654,3508,8162
<class,6호선,녹사평,5313,5236,10549
<class,6호선,이태원,10955,11581,22536
<class,6호선,한강진,8484,10188,18672
<class,6호선,버티고개,1551,1592,3143
<class,6호선,약수,2271,2339,4610
<class,6호선,청구,2349,2319,4668
<class,6호선,신당,5771,4776,10547
<class,6호선,동묘앞,8130,7701,15831
<class,6호선,창신,2107,1676,3783
<class,6호선,보문,4970,4442,9412
<class,6호선,안암,6542,6076,12618
<class,6호선,고려대,5189,4938,10127
<class,6호선,월곡,7024,6898,13922
<class,6호선,상월곡,3989,3395,7384
<class,6호선,돌곶이,5895,5439,11334
<class,6호선,석계,8584,8574,17158
<class,6호선,태릉입구,3886,4226,8112
<class,6호선,화랑대,6584,5405,11989
<class,6호선,봉화산,5156,4980,10136
<class,7호선,장암,1638,1232,2870
<class,7호선,도봉산,6560,9159,15719
<class,7호선,수락산,10298,9935,20233
<class,7호선,마들,8524,8024,16548
<class,7호선,노원,14798,15254,30052
<class,7호선,중계,9118,8115,17233
<class,7호선,하계,12004,11110,23114
<class,7호선,공릉,8880,8707,17587
<class,7호선,태릉입구,6277,5762,12039
<class,7호선,먹골,7655,7423,15078
<class,7호선,중화,7681,7207,14888
<class,7호선,상봉,12892,12295,25187
<class,7호선,면목,10955,10400,21355
<class,7호선,사가정,12255,11790,24045
<class,7호선,용마산,4751,4776,9527
<class,7호선,중곡,6453,5868,12321
<class,7호선,군자,10245,7581,17826
<class,7호선,어린이대공원,9426,9494,18920
<class,7호선,건대입구,10045,10222,20267
<class,7호선,뚝섬유원지,12486,11974,24460
<class,7호선,청담,11086,11764,22850
<class,7호선,강남구청,9457,10428,19885
<class,7호선,학동,9786,10455,20241
<class,7호선,논현,10925,11900,22825
<class,7호선,반포,4428,4249,8677
<class,7호선,고속터미널,12844,10251,23095
<class,7호선,내방,7438,7327,14765
<class,7호선,이수,11328,10691,22019
<class,7호선,남성,7469,6905,14374
<class,7호선,숭실대입구,8174,8073,16247
<class,7호선,상도,7090,6710,13800
<class,경부선,군포,4178,3776,7954
<class,경부선,금정,17591,17655,35246
<class,경부선,명학,5174,5060,10234
<class,경부선,안양,17101,17173,34274
<class,경부선,관악,5978,5495,11473
<class,경부선,석수,6982,6376,13358
<class,경부선,금천구청,7997,7971,15968
<class,경부선,가산디지털단지,5985,8046,14031
<class,경부선,구로,12822,13225,26047
<class,경부선,신길,6173,5235,11408
<class,경부선,신도림,3120,3252,6372
<class,경부선,영등포,34925,36282,71207
<class,경부선,대방,7538,7478,15016
<class,경부선,노량진,8506,7605,16111
<class,경부선,용산,28293,30761,59054
<class,경부선,남영,5385,5481,10866
<class,경부선,서울역,5245,1490,6735
<class,경강선,여주,2050,2374,4424
<class,경강선,세종대왕릉,318,360,678
<class,경강선,부발,1621,1449,3070
<class,경강선,이천,2368,2518,4886
<class,경강선,신둔도예촌,982,948,1930
<class,경강선,곤지암,1726,1873,3599
<class,경강선,초월,2050,1864,3914
<class,경강선,경기광주,4739,4517,9256
<class,경강선,삼동,1425,1307,2732
<class,분당선,복정,1,0,1
<class,경강선,이매,808,790,1598
<class,경강선,판교,2746,2539,5285
<class,9호선2~3단계,중앙보훈병원,4162,3818,7980
<class,9호선2~3단계,둔촌오륜,594,544,1138
<class,9호선2~3단계,올림픽공원,3882,3960,7842
<class,9호선2~3단계,한성백제,1720,1454,3174
<class,9호선2~3단계,송파나루,3413,3720,7133
<class,9호선2~3단계,석촌,6039,4985,11024
<class,9호선2~3단계,석촌고분,3911,3609,7520
<class,9호선2~3단계,삼전,4564,4163,8727
<class,9호선2~3단계,종합운동장,2797,2543,5340
<class,9호선2~3단계,봉은사,8735,9055,17790
<class,9호선2~3단계,삼성중앙,2708,2775,5483
<class,9호선2~3단계,선정릉,4693,5204,9897
<class,9호선2~3단계,언주,5501,5390,10891
<class,9호선,신논현,23810,23559,47369
<class,9호선,사평,2291,2086,4377
<class,9호선,고속터미널,11841,16793,28634
<class,9호선,신반포,2541,2501,5042
<class,9호선,구반포,2072,2231,4303
<class,9호선,동작,1422,1194,2616
<class,9호선,흑석,5278,5334,10612
<class,9호선,노들,3096,2708,5804
<class,9호선,노량진,19971,20089,40060
<class,9호선,샛강,2410,2373,4783
<class,9호선,여의도,11395,11123,22518
<class,9호선,국회의사당,3937,4035,7972
<class,9호선,당산,12038,11278,23316
<class,9호선,선유도,3834,3829,7663
<class,9호선,신목동,2314,1932,4246
<class,9호선,염창,10989,10230,21219
<class,9호선,등촌,6891,6738,13629
<class,중앙선,지평,44,94,138
<class,중앙선,용문,2326,2554,4880
<class,중앙선,원덕,523,498,1021
<class,중앙선,양평,2633,2801,5434
<class,중앙선,오빈,297,327,624
<class,중앙선,아신,686,700,1386
<class,중앙선,국수,868,863,1731
<class,중앙선,신원,476,337,813
<class,중앙선,양수,2408,2486,4894
<class,중앙선,운길산,1813,1775,3588
<class,중앙선,팔당,1727,2019,3746
<class,중앙선,도심,1649,1482,3131
<class,중앙선,덕소,4512,4574,9086
<class,중앙선,양정,693,627,1320
<class,중앙선,도농,6475,6151,12626
<class,중앙선,구리,9987,10316,20303
<class,중앙선,양원,1182,1207,2389
<class,중앙선,망우,6238,6019,12257
<class,중앙선,상봉,5210,5010,10220
<class,중앙선,중랑,4337,4280,8617
<class,중앙선,회기,18707,17494,36201
<class,장항선,신창,1147,1020,2167
<class,장항선,온양온천,4939,4897,9836
<class,장항선,배방,935,913,1848
<class,장항선,아산,2674,2540,5214
<class,장항선,쌍용,1647,1418,3065
<class,장항선,봉명,745,747,1492
<class,일산선,대화,7733,6875,14608
<class,일산선,주엽,5936,5909,11845
<class,일산선,정발산,6425,6563,12988
<class,일산선,마두,4864,4893,9757
<class,일산선,백석,7177,7366,14543
<class,일산선,대곡,1399,1203,2602
<class,일산선,화정,12108,12440,24548
<class,일산선,원당,8083,7802,15885
<class,일산선,삼송,12641,12360,25001
<class,일산선,원흥,6545,6340,12885
<class,우이신설선,신설동,1392,1346,2738
<class,우이신설선,보문,1054,1061,2115
<class,우이신설선,성신여대입구,2552,2941,5493
<class,우이신설선,정릉,3266,2794,6060
<class,우이신설선,북한산보국문,4481,4131,8612
<class,우이신설선,솔샘,3451,3118,6569
<class,우이신설선,삼양사거리,1774,1806,3580
<class,우이신설선,삼양,1439,1568,3007
<class,우이신설선,화계,2355,2153,4508
<class,우이신설선,가오리,2714,2626,5340
<class,우이신설선,4.19민주묘지,2332,1918,4250
<class,우이신설선,솔밭공원,1678,1722,3400
<class,우이신설선,북한산우이,3388,3441,6829
<class,안산선,수리산,3267,3373,6640
<class,안산선,오이도,7528,7724,15252
<class,안산선,정왕,6319,6456,12775
<class,안산선,신길온천,1414,1348,2762
<class,안산선,안산,9464,9806,19270
<class,안산선,초지,3120,3135,6255
<class,안산선,고잔,6229,6229,12458
<class,안산선,중앙,14511,14983,29494
<class,경춘선,평내호평,4416,4437,8853
<class,경춘선,천마산,1394,1452,2846
<class,경춘선,마석,3212,3258,6470
<class,경춘선,대성리,799,827,1626
<class,경춘선,청평,1793,1898,3691
<class,경춘선,상천,630,522,1152
<class,경춘선,가평,1820,2017,3837
<class,경춘선,굴봉산,317,354,671
<class,경춘선,백양리,228,261,489
<class,경춘선,강촌,853,886,1739
<class,경춘선,김유정,550,674,1224
<class,경춘선,남춘천,2295,2461,4756
<class,2호선,뚝섬,15137,15382,30519
<class,1호선,시청,9575,9907,19482
<class,7호선,장승배기,6641,6332,12973
<class,경인선,부천,27414,28167,55581
<class,경인선,송내,17563,17225,34788
<class,경인선,부평,28151,30604,58755
<class,경인선,백운,5366,5414,10780
<class,경인선,동암,12256,12341,24597
<class,경인선,주안,15096,13151,28247
<class,경인선,제물포,7322,6995,14317
<class,경인선,동인천,11368,11180,22548
<class,경인선,인천,4442,3730,8172
<class,경인선,구일,5361,5195,10556
<class,경인선,소사,7640,7426,15066
<class,경인선,부개,6180,5749,11929
<class,경인선,간석,4233,4065,8298
<class,경인선,도원,2045,2072,4117
<class,경인선,온수,4889,4497,9386
<class,경인선,중동,6337,5971,12308
<class,경인선,도화,3103,2900,6003
<class,경춘선,신내,1092,1104,2196
<class,경춘선,갈매,1846,1689,3535
<class,경춘선,별내,2209,2043,4252
<class,경춘선,퇴계원,2690,2389,5079
<class,경춘선,사릉,2295,2237,4532
<class,경춘선,금곡,1101,1059,2160
<class,경인선,역곡,19375,18902,38277
<class,경인선,오류동,8871,8187,17058
<class,경인선,개봉,15875,15632,31507
<class,경의선,임진강,68,73,141
<class,경의선,문산,4832,4734,9566
<class,경의선,파주,836,700,1536
<class,경의선,월롱,1376,1329,2705
<class,경의선,금촌,5240,4954,10194
<class,경의선,금릉,3569,3295,6864
<class,경의선,운정,4416,4229,8645
<class,경의선,야당,5073,4911,9984
<class,경의선,탄현,4906,4743,9649
<class,경의선,일산,5896,5755,11651
<class,경의선,풍산,4006,3953,7959
<class,경의선,백마,4081,3929,8010
<class,경의선,곡산,428,408,836
<class,경의선,능곡,2706,2699,5405
<class,경의선,행신,4887,4820,9707
<class,경의선,강매,1851,1658,3509
<class,경의선,화전,1055,1040,2095
<class,경의선,수색,1297,1293,2590
<class,경의선,디지털미디어시티,1899,1592,3491
<class,경의선,가좌,3645,3403,7048
<class,경의선,홍대입구,1669,1901,3570
<class,경의선,서강대,1646,1515,3161
<class,경의선,공덕,2210,1709,3919
<class,경의선,효창공원앞,1630,1853,3483
<class,경의선,신촌,388,396,784
<class,경의선,서울역,1254,1430,2684
<class,경원선,소요산,4526,3707,8233
<class,경원선,동두천,1583,2414,3997
<class,경원선,보산,1723,1580,3303
<class,경원선,동두천중앙,2461,2548,5009
<class,경원선,지행,5229,5126,10355
<class,경원선,덕정,4207,3971,8178
<class,경원선,덕계,2134,1959,4093
<class,경원선,양주,6207,6050,12257
<class,경원선,녹양,3324,3172,6496
<class,경원선,가능,5012,4776,9788
<class,경원선,의정부,16337,17449,33786
<class,경원선,회룡,9522,9400,18922
<class,경원선,망월사,5384,5563,10947
<class,경원선,도봉산,9611,6704,16315
<class,경원선,도봉,4327,4210,8537
<class,경원선,방학,7389,7127,14516
<class,경원선,녹천,3218,2815,6033
<class,경원선,월계,4602,4262,8864
<class,경원선,광운대,5537,5386,10923
<class,경원선,석계,6524,6883,13407
<class,경원선,신이문,6028,5499,11527
<class,경원선,외대앞,5538,5218,10756
<class,경원선,청량리,14493,16508,31001
<class,경원선,왕십리,11142,12795,23937
<class,경원선,응봉,1658,1572,3230
<class,경원선,옥수,52,40,92
<class,경원선,한남,2919,2718,5637
<class,경원선,서빙고,1310,1142,2452
<class,경원선,이촌,3254,2312,5566
<class,경부선,광명,2207,2125,4332
<class,경부선,서동탄,973,1068,2041
<class,경부선,당정,3844,3671,7515
<class,경부선,천안,5835,6098,11933
<class,경부선,두정,5068,5357,10425
<class,경부선,직산,645,678,1323
<class,경부선,성환,2773,2630,5403
<class,경부선,평택,12648,12031,24679
<class,경부선,지제,2529,2512,5041
<class,경부선,서정리,5896,4920,10816
<class,경부선,송탄,4594,4114,8708
<class,경부선,진위,1005,911,1916
<class,경부선,오산,8868,8098,16966
<class,경부선,오산대,2783,2480,5263
<class,경부선,세마,2054,1878,3932
<class,경부선,병점,11341,11220,22561
<class,경부선,세류,2348,2407,4755
<class,경부선,독산,8334,8131,16465
<class,경부선,수원,34740,37242,71982
<class,경부선,화서,4986,4907,9893
<class,경부선,성균관대,9775,9615,19390
<class,안산선,한대앞,6950,6781,13731
<class,안산선,상록수,11914,11846,23760
<class,안산선,반월,3316,3087,6403
<class,안산선,대야미,4165,3563,7728
<class,안산선,산본,11544,12328,23872
<class,수인선,인천,1181,2106,3287
<class,수인선,신포,1334,1408,2742
<class,수인선,숭의,2678,2529,5207
<class,수인선,인하대,4307,3928,8235
<class,수인선,송도,1912,1909,3821
<class,수인선,연수,3577,3632,7209
<class,수인선,원인재,3555,3630,7185
<class,수인선,남동인더스파크,1108,972,2080
<class,수인선,호구포,2504,2507,5011
<class,수인선,인천논현,4220,4324,8544
<class,수인선,소래포구,5871,6045,11916
<class,수인선,월곶,2114,2010,4124
<class,수인선,달월,75,79,154
<class,수인선,사리,3061,2661,5722
<class,수인선,야목,194,202,396
<class,수인선,어천,632,545,1177
<class,수인선,오목천,1895,1558,3453
<class,수인선,고색,2193,2246,4439
<class,분당선,매교,1960,2105,4065
<class,분당선,수원시청,10410,11274,21684
<class,분당선,매탄권선,3262,3110,6372
<class,분당선,망포,8737,7908,16645
<class,분당선,영통,6029,5890,11919
<class,분당선,청명,2568,2423,4991
<class,분당선,상갈,3731,3837,7568
<class,분당선,기흥,6213,6003,12216
<class,분당선,신갈,2637,2702,5339
<class,분당선,구성,2978,3195,6173
<class,분당선,죽전,9610,10828,20438
<class,분당선,보정,1594,1416,3010
<class,분당선,이매,4011,3773,7784
<class,분당선,오리,7435,6069,13504
<class,분당선,미금,10701,10932,21633
<class,분당선,정자,9906,10144,20050
<class,분당선,수내,8206,7679,15885
<class,분당선,서현,16806,16837,33643
<class,분당선,야탑,16226,17154,33380
<class,분당선,모란,22017,22519,44536
<class,분당선,태평,10511,9878,20389
<class,분당선,가천대,4979,5379,10358
<class,분당선,선정릉,3540,3641,7181
<class,분당선,강남구청,5093,6217,11310
<class,분당선,압구정로데오,17175,19892,37067
<class,분당선,서울숲,11287,13071,24358
<class,분당선,수원,7195,6097,13292
<class,분당선,수서,9785,10023,19808
<class,분당선,대모산입구,2605,2397,5002
<class,분당선,개포동,2598,2439,5037
<class,분당선,구룡,1385,1274,2659
<class,분당선,도곡,4141,3818,7959
<class,분당선,한티,9879,9819,19698
<class,분당선,선릉,4745,7337,12082
<class,과천선,범계,18879,18295,37174
<class,과천선,평촌,8783,8592,17375
<class,과천선,인덕원,14541,14050,28591
<class,과천선,정부과천청사,5382,5512,10894
<class,과천선,과천,4142,3622,7764
<class,과천선,대공원,6765,7079,13844
<class,과천선,경마공원,1022,1078,2100
<class,과천선,선바위,4990,4272,9262
<class,공항철도 1호선,영종,2604,2678,5282
<class,공항철도 1호선,인천공항2터미널,1521,1352,2873
<class,공항철도 1호선,인천공항1터미널,2675,3005,5680
<class,공항철도 1호선,공항화물청사,1342,1367,2709
<class,공항철도 1호선,운서,5509,5633,11142
<class,공항철도 1호선,청라국제도시,3761,3654,7415
<class,공항철도 1호선,검암,4576,4640,9216
<class,공항철도 1호선,계양,6271,5638,11909
<class,공항철도 1호선,김포공항,10402,5751,16153
<class,공항철도 1호선,마곡나루,3263,3480,6743
<class,공항철도 1호선,디지털미디어시티,4918,4712,9630
<class,공항철도 1호선,홍대입구,10380,9991,20371
<class,공항철도 1호선,공덕,1296,1939,3235
<class,공항철도 1호선,서울역,6552,6530,13082
<class,경춘선,춘천,1910,1729,3639
<class,9호선,증미,3997,3956,7953
<class,9호선,가양,13256,12418,25674
<class,9호선,양천향교,5571,5395,10966
<class,9호선,마곡나루,7586,7573,15159
<class,9호선,신방화,4328,4148,8476
<class,9호선,공항시장,2231,2302,4533
<class,9호선,김포공항,7522,12225,19747
<class,9호선,개화,1425,1237,2662
<class,8호선,모란,5556,4744,10300
<class,8호선,수진,4224,3761,7985
<class,8호선,신흥,3622,3910,7532
<class,8호선,단대오거리,7612,7059,14671
<class,8호선,남한산성입구,9107,8156,17263
<class,8호선,산성,5004,5024,10028
<class,8호선,복정,6801,5825,12626
<class,8호선,장지,11791,10814,22605
<class,8호선,문정,8266,8501,16767
<class,8호선,가락시장,5305,5398,10703
<class,8호선,송파,4808,4849,9657
<class,8호선,석촌,5573,6605,12178
<class,8호선,잠실,10666,12234,22900
<class,8호선,몽촌토성,4096,4165,8261
<class,8호선,강동구청,5630,5631,11261
<class,8호선,천호,11442,13576,25018
<class,8호선,암사,11936,10908,22844
<class,7호선,부평구청,6929,5925,12854
<class,7호선,굴포천,5980,6233,12213
<class,7호선,삼산체육관,3466,3167,6633
<class,7호선,상동,9443,9607,19050
<class,7호선,부천시청,8890,8532,17422
<class,7호선,신중동,9133,8996,18129
<class,7호선,춘의,4837,4677,9514
<class,7호선,부천종합운동장,3057,2819,5876
<class,7호선,까치울,5425,5392,10817
<class,7호선,온수,5518,5545,11063
<class,7호선,천왕,6879,6451,13330
<class,7호선,광명사거리,15959,15838,31797
<class,7호선,철산,14380,14743,29123
<class,7호선,가산디지털단지,14322,13162,27484
<class,7호선,남구로,8221,8666,16887
<class,7호선,대림,6396,6842,13238
<class,7호선,신풍,7996,7400,15396
<class,7호선,보라매,5993,5943,11936
<class,7호선,신대방삼거리,10962,10008,20970
<class,1호선,서울역,27220,28071,55291
<class,1호선,동묘앞,11582,12003,23585
<class,1호선,종각,16382,15226,31608
<class,1호선,종로3가,21135,19712,40847
<class,1호선,종로5가,16991,17235,34226
<class,1호선,동대문,10584,9907,20491
<class,1호선,신설동,8908,8391,17299
<class,1호선,제기동,14568,14899,29467
<class,1호선,청량리,17702,17682,35384
<class,2호선,시청,7768,6578,14346
<class,2호선,을지로입구,18888,18649,37537
<class,2호선,을지로3가,9728,9855,19583
<class,2호선,을지로4가,6714,7003,13717
<class,2호선,동대문역사문화공원,9149,9714,18863
<class,2호선,신당,10431,10676,21107
<class,2호선,상왕십리,9159,8375,17534
<class,2호선,왕십리,12566,10338,22904
<class,2호선,한양대,4001,3978,7979
<class,2호선,성수,16320,18689,35009
<class,2호선,건대입구,31532,33334,64866
<class,2호선,구의,14941,14456,29397
<class,2호선,강변,24560,25474,50034
<class,2호선,잠실나루,7153,7092,14245
<class,2호선,잠실,54554,51944,106498
<class,2호선,잠실새내,14876,15509,30385
<class,2호선,종합운동장,5421,5896,11317
<class,2호선,삼성,23389,23510,46899
<class,2호선,선릉,22019,19593,41612
<class,2호선,역삼,17700,18999,36699
<class,2호선,강남,54441,54637,109078
<class,2호선,교대,15930,17663,33593
<class,2호선,서초,9812,8489,18301
<class,2호선,방배,8995,9292,18287
<class,2호선,사당,26945,29929,56874
<class,2호선,낙성대,20651,18892,39543
<class,2호선,서울대입구,36176,34845,71021
<class,2호선,봉천,16448,15019,31467
<class,2호선,신림,47518,45042,92560
<class,2호선,신대방,19366,18749,38115
<class,2호선,구로디지털단지,32268,31508,63776
<class,2호선,대림,17849,18923,36772
<class,2호선,신도림,39284,39477,78761
<class,2호선,문래,11582,12253,23835
<class,2호선,영등포구청,11968,12251,24219
<class,2호선,당산,12754,13550,26304
<class,2호선,합정,25233,27279,52512
<class,2호선,홍대입구,53290,57772,111062
<class,2호선,신촌,26368,26835,53203
<class,2호선,이대,9065,9252,18317
<class,2호선,아현,6993,6624,13617
<class,2호선,충정로,5566,5880,11446
<class,2호선,용답,1968,1876,3844
<class,2호선,신답,983,1027,2010
<class,2호선,신설동,3096,3009,6105
<class,2호선,도림천,797,777,1574
<class,2호선,양천구청,4386,4380,8766
<class,2호선,신정네거리,6956,6945,13901
<class,2호선,용두,1650,1619,3269
<class,3호선,지축,2478,2463,4941
<class,3호선,구파발,14317,14531,28848
<class,3호선,연신내,28498,26414,54912
<class,3호선,불광,12264,14147,26411
<class,3호선,녹번,9476,8288,17764
<class,3호선,홍제,12533,11658,24191
<class,3호선,무악재,2587,2554,5141
<class,3호선,독립문,5514,6139,11653
<class,3호선,경복궁,13573,14921,28494
<class,3호선,안국,12207,14007,26214
<class,3호선,종로3가,5187,7283,12470
<class,3호선,을지로3가,4682,5294,9976
<class,3호선,충무로,1,0,1
<class,3호선,동대입구,5871,6595,12466
<class,3호선,약수,8617,8011,16628
<class,3호선,금호,5972,5356,11328
<class,3호선,옥수,7109,7109,14218
<class,3호선,압구정,22979,24026,47005
<class,3호선,신사,23453,24261,47714
<class,3호선,잠원,3730,3562,7292
<class,3호선,고속터미널,44123,44870,88993
<class,3호선,교대,6185,3685,9870
<class,3호선,남부터미널,18051,18630,36681
<class,3호선,양재,19411,20919,40330
<class,3호선,매봉,5875,5595,11470
<class,3호선,도곡,3726,3684,7410
<class,3호선,대치,7557,6981,14538
<class,3호선,학여울,3155,3536,6691
<class,3호선,대청,5443,4908,10351
<class,3호선,일원,4530,4421,8951
<class,3호선,수서,12305,12497,24802
<class,3호선,가락시장,5919,5626,11545
<class,3호선,경찰병원,3893,3777,7670
<class,3호선,오금,3687,3542,7229
<class,4호선,수유,24987,24075,49062
<class,4호선,미아,10429,9725,20154
<class,4호선,미아사거리,20831,19853,40684
<class,4호선,길음,13346,12820,26166
<class,4호선,성신여대입구,15839,14812,30651
<class,4호선,한성대입구,10158,9859,20017
<class,4호선,혜화,23005,23625,46630
<class,4호선,동대문,13777,13672,27449
<class,4호선,동대문역사문화공원,10393,8831,19224
<class,4호선,충무로,12488,12934,25422
<class,4호선,명동,12113,13741,25854
<class,4호선,회현,16484,17953,34437
<class,4호선,서울역,5046,10867,15913
<class,4호선,숙대입구,8059,7969,16028
<class,4호선,삼각지,2689,3548,6237
<class,4호선,신용산,8221,9168,17389
<class,4호선,이촌,5851,6848,12699
<class,4호선,동작,2344,2367,4711
<class,4호선,총신대입구,13557,14795,28352
<class,4호선,사당,18477,16067,34544
<class,4호선,남태령,1119,880,1999
<class,4호선,당고개,9480,9035,18515
<class,4호선,상계,13709,13010,26719
<class,4호선,노원,15074,16398,31472
<class,4호선,창동,18279,19246,37525
<class,4호선,쌍문,20370,18461,38831
<class,5호선,방화,4795,4570,9365
<class,5호선,개화산,3622,3582,7204
<class,5호선,김포공항,6914,7406,14320
<class,5호선,송정,4949,4744,9693
<class,5호선,마곡,4823,4864,9687
<class,5호선,발산,13308,13971,27279
<class,5호선,우장산,9257,9164,18421
<class,5호선,화곡,19466,17791,37257
<class,4호선,노원,10540,11359,21899
<class,중앙선,지평,75,79,154
<class,중앙선,용문,5325,4681,10006
<class,중앙선,원덕,475,418,893
<class,중앙선,양평,2554,2289,4843
<class,중앙선,오빈,275,256,531
<class,중앙선,아신,705,585,1290
<class,중앙선,국수,839,726,1565
<class,중앙선,신원,440,267,707
<class,중앙선,양수,2117,1986,4103
<class,중앙선,운길산,1858,1689,3547
<class,중앙선,팔당,1905,1972,3877
<class,중앙선,도심,1294,1238,2532
<class,중앙선,덕소,3559,3614,7173
<class,중앙선,양정,614,520,1134
<class,중앙선,도농,4771,4768,9539
<class,중앙선,구리,7402,7579,14981
<class,중앙선,양원,920,986,1906
<class,중앙선,망우,4539,4685,9224
<class,중앙선,상봉,4160,3994,8154
<class,중앙선,중랑,3337,3270,6607
<class,중앙선,회기,13754,14065,27819
<class,장항선,신창,968,1242,2210
<class,장항선,온양온천,3100,2980,6080
<class,장항선,배방,768,829,1597
<class,안산선,초지,2403,2375,4778
<class,안산선,고잔,4339,4172,8511
<class,안산선,중앙,10812,10336,21148
<class,안산선,한대앞,5148,5069,10217
<class,안산선,상록수,8766,8647,17413
<class,안산선,반월,2402,2367,4769
<class,안산선,대야미,3311,2963,6274
<class,안산선,산본,8161,8634,16795
<class,수인선,인천,1172,1625,2797
<class,수인선,신포,1138,1069,2207
<class,수인선,숭의,2026,1897,3923
<class,수인선,인하대,3061,2957,6018
<class,수인선,송도,1560,1486,3046
<class,수인선,연수,2789,2702,5491
<class,수인선,원인재,2634,2890,5524
<class,수인선,남동인더스파크,572,596,1168
<class,수인선,호구포,1919,1924,3843
<class,수인선,인천논현,2913,3000,5913
<class,수인선,소래포구,5569,5468,11037
<class,수인선,월곶,1601,1521,3122
<class,수인선,달월,48,54,102
<class,수인선,사리,2258,2097,4355
<class,수인선,야목,179,152,331
<class,수인선,어천,501,595,1096
<class,수인선,오목천,1257,1213,2470
<class,수인선,고색,1636,1834,3470
<class,분당선,매교,1289,1379,2668
<class,분당선,수원시청,6615,6586,13201
<class,분당선,매탄권선,2219,2196,4415
<class,분당선,망포,5742,6106,11848
<class,분당선,영통,4213,4191,8404
<class,분당선,청명,1755,1795,3550
<class,분당선,상갈,2693,2755,5448
<class,분당선,기흥,4630,4422,9052
<class,분당선,신갈,1873,1874,3747
<class,분당선,구성,2178,2355,4533
<class,분당선,죽전,7016,8005,15021
<class,분당선,보정,941,976,1917
<class,분당선,이매,2829,2790,5619
<class,분당선,오리,4919,4116,9035
<class,분당선,미금,6417,6891,13308
<class,분당선,정자,6744,7098,13842
<class,분당선,수내,5630,5301,10931
<class,분당선,서현,11983,11911,23894
<class,분당선,야탑,12196,12634,24830
<class,분당선,모란,10598,10534,21132
<class,분당선,태평,7363,7007,14370
<class,분당선,가천대,3422,4094,7516
<class,분당선,선정릉,2117,2309,4426
<class,분당선,강남구청,2913,3590,6503
<class,분당선,압구정로데오,9506,10773,20279
<class,분당선,서울숲,9326,10960,20286
<class,분당선,수원,5598,4617,10215
<class,분당선,수서,7812,7492,15304
<class,분당선,대모산입구,1639,1605,3244
<class,분당선,개포동,1811,1786,3597
<class,분당선,구룡,660,763,1423
<class,분당선,도곡,2145,2087,4232
<class,분당선,한티,6306,6367,12673
<class,분당선,선릉,2735,3899,6634
<class,과천선,범계,13277,12752,26029
<class,과천선,평촌,5903,5664,11567
<class,과천선,인덕원,10243,10143,20386
<class,과천선,정부과천청사,3875,4043,7918
<class,과천선,과천,3053,2828,5881
<class,과천선,대공원,6332,6436,12768
<class,과천선,경마공원,879,877,1756
<class,과천선,선바위,3424,3296,6720
<class,공항철도 1호선,영종,2174,2088,4262
<class,공항철도 1호선,인천공항2터미널,1451,1411,2862
<class,공항철도 1호선,인천공항1터미널,2984,2921,5905
<class,공항철도 1호선,공항화물청사,1031,1095,2126
<class,공항철도 1호선,운서,4764,4957,9721
<class,공항철도 1호선,청라국제도시,2890,2805,5695
<class,공항철도 1호선,검암,3536,3675,7211
<class,공항철도 1호선,계양,4549,4364,8913
<class,공항철도 1호선,김포공항,10844,5500,16344
<class,공항철도 1호선,마곡나루,2377,2657,5034
<class,공항철도 1호선,디지털미디어시티,3127,3203,6330
<class,공항철도 1호선,홍대입구,8386,7602,15988
<class,공항철도 1호선,공덕,1016,1311,2327
<class,공항철도 1호선,서울역,6273,5497,11770
<class,경춘선,춘천,1652,1565,3217
<class,경춘선,남춘천,2142,2313,4455
<class,경춘선,김유정,641,669,1310
<class,경춘선,강촌,954,821,1775
<class,경춘선,백양리,173,184,357
<class,경춘선,굴봉산,413,434,847
<class,경춘선,가평,1969,1634,3603
<class,경춘선,상천,680,569,1249
<class,경춘선,청평,1726,1487,3213
<class,경춘선,대성리,817,577,1394
<class,경춘선,마석,2687,2627,5314
<class,경춘선,천마산,1124,1090,2214
<class,경춘선,평내호평,3366,3389,6755
<class,경춘선,금곡,920,848,1768
<class,경춘선,사릉,1718,1693,3411
<class,경춘선,퇴계원,2115,1913,4028
<class,경춘선,별내,1729,1599,3328
<class,경춘선,갈매,1491,1373,2864
<class,경춘선,신내,904,852,1756
<class,경인선,도화,2409,2248,4657
<class,경인선,중동,4384,4231,8615
<class,경인선,온수,3534,3360,6894
<class,경인선,도원,2201,2228,4429
<class,경인선,간석,3013,2901,5914
<class,경인선,부개,4627,4225,8852
<class,경인선,소사,5492,5238,10730
<class,경인선,구일,3947,4073,8020
<class,경인선,인천,4357,3812,8169
<class,경인선,동인천,9131,8735,17866
<class,경인선,제물포,5432,5425,10857
<class,경인선,주안,11352,9849,21201
<class,경인선,동암,9144,9061,18205
<class,경인선,백운,3935,3830,7765
<class,경인선,부평,21375,21605,42980
<class,경인선,송내,12587,12179,24766
<class,경인선,부천,19974,19508,39482
<class,경인선,역곡,13405,13327,26732
<class,경인선,오류동,6423,5999,12422
<class,경인선,개봉,10965,10917,21882
<class,경의선,임진강,89,65,154
<class,경의선,문산,3340,3295,6635
<class,경의선,파주,677,626,1303
<class,경의선,월롱,878,1407,2285
<class,경의선,금촌,3880,4063,7943
<class,경의선,금릉,2624,2545,5169
<class,경의선,운정,3157,2987,6144
<class,경의선,야당,3660,3602,7262
<class,경의선,탄현,3875,3625,7500
<class,경의선,일산,4408,4171,8579
<class,경의선,풍산,3221,3017,6238
<class,경의선,백마,3056,3009,6065
<class,경의선,곡산,297,313,610
<class,경의선,능곡,2140,2216,4356
<class,경의선,행신,4040,3781,7821
<class,경의선,강매,1371,1306,2677
<class,경의선,화전,837,859,1696
<class,경의선,수색,910,976,1886
<class,경의선,디지털미디어시티,1322,1186,2508
<class,경의선,가좌,2749,2760,5509
<class,경의선,홍대입구,1356,1589,2945
<class,경의선,서강대,1125,1114,2239
<class,경의선,공덕,1540,1376,2916
<class,경의선,효창공원앞,1197,1404,2601
<class,경의선,신촌,216,250,466
<class,경의선,서울역,915,875,1790
<class,경원선,소요산,4946,4153,9099
<class,경원선,동두천,1390,1893,3283
<class,경원선,보산,1266,1413,2679
<class,경원선,동두천중앙,2124,2208,4332
<class,경원선,지행,4033,4030,8063
<class,경원선,덕정,3237,3243,6480
<class,경원선,덕계,1644,1560,3204
<class,경원선,양주,4935,4804,9739
<class,경원선,녹양,2538,2505,5043
<class,경원선,가능,3933,3734,7667
<class,경원선,의정부,12580,12636,25216
<class,경원선,회룡,6975,7131,14106
<class,경원선,망월사,4589,4787,9376
<class,경원선,도봉산,9837,7120,16957
<class,경원선,도봉,3497,3279,6776
<class,경원선,방학,5420,5327,10747
<class,경원선,녹천,2713,2341,5054
<class,경원선,월계,3873,3545,7418
<class,경원선,광운대,3954,4072,8026
<class,경원선,석계,4605,5028,9633
<class,경원선,신이문,4451,4354,8805
<class,경원선,외대앞,4167,4132,8299
<class,경원선,청량리,12550,11832,24382
<class,경원선,왕십리,7576,8574,16150
<class,경원선,응봉,1157,1146,2303
<class,경원선,옥수,52,24,76
<class,경원선,한남,1993,1969,3962
<class,경원선,서빙고,1333,1305,2638
<class,경원선,이촌,2583,1824,4407
<class,경부선,광명,2187,1501,3688
<class,경원선,창동,1,0,1
<class,우이신설선,북한산보국문,3529,3212,6741
<class,우이신설선,정릉,2487,2158,4645
<class,우이신설선,성신여대입구,1880,2066,3946
<class,우이신설선,보문,891,808,1699
<class,우이신설선,신설동,1086,1086,2172
<class,일산선,원흥,4824,4553,9377
<class,일산선,삼송,9421,9321,18742
<class,일산선,원당,5836,5726,11562
<class,일산선,화정,8681,8782,17463
<class,일산선,대곡,1081,865,1946
<class,일산선,백석,5185,5153,10338
<class,일산선,마두,3133,3165,6298
<class,일산선,정발산,5152,5144,10296
<class,일산선,주엽,4103,4033,8136
<class,일산선,대화,5764,5231,10995
<class,장항선,봉명,538,561,1099
<class,장항선,쌍용,1054,1173,2227
<class,장항선,아산,2876,1968,4844
<class,안산선,안산,9618,8937,18555
<class,안산선,신길온천,1131,1030,2161
<class,안산선,정왕,4945,5500,10445
<class,안산선,오이도,5823,5726,11549
<class,안산선,수리산,2606,2973,5579
<class,우이신설선,북한산우이,3340,3456,6796
<class,우이신설선,솔밭공원,1381,1339,2720
<class,우이신설선,4.19민주묘지,1962,1731,3693
<class,우이신설선,가오리,2301,2056,4357
<class,우이신설선,화계,1954,1854,3808
<class,우이신설선,삼양,1178,1181,2359
<class,우이신설선,삼양사거리,1456,1369,2825
<class,우이신설선,솔샘,2472,2479,4951
<class,경부선,서동탄,692,735,1427
<class,경부선,당정,2979,2880,5859
<class,경부선,천안,5758,5286,11044
<class,경부선,두정,4276,4576,8852
<class,경부선,직산,521,598,1119
<class,경부선,성환,2180,2632,4812
<class,경부선,평택,10571,11504,22075
<class,경부선,지제,2095,1863,3958
<class,경부선,서정리,3716,5251,8967
<class,경부선,송탄,3258,3877,7135
<class,경부선,진위,783,798,1581
<class,경부선,오산,7108,7552,14660
<class,경부선,오산대,2258,2094,4352
<class,경부선,세마,1480,1395,2875
<class,경부선,병점,8296,9261,17557
<class,경부선,세류,1943,1953,3896
<class,경부선,독산,5514,5604,11118
<class,경부선,수원,31009,29551,60560
<class,경부선,화서,3736,3735,7471
<class,경부선,성균관대,7263,7652,14915
<class,경부선,의왕,4114,4216,8330
<class,경부선,군포,3105,2932,6037
<class,경부선,금정,13143,13303,26446
<class,경부선,명학,3254,3310,6564
<class,경부선,안양,12845,12601,25446
<class,경부선,관악,4819,4248,9067
<class,경부선,석수,4955,5107,10062
<class,경부선,금천구청,6051,5904,11955
<class,경부선,가산디지털단지,4368,6186,10554
<class,경부선,구로,9419,9676,19095
<class,경부선,신길,4708,4204,8912
<class,경부선,신도림,2286,2277,4563
<class,경부선,영등포,27648,26879,54527
<class,경부선,대방,5447,5860,11307
<class,경부선,노량진,5838,5574,11412
<class,경부선,용산,26092,23342,49434
<class,경부선,남영,3907,4266,8173
<class,경부선,서울역,6035,1281,7316
<class,경강선,여주,2025,1981,4006
<class,경강선,세종대왕릉,293,264,557
<class,경강선,부발,1150,1721,2871
<class,경강선,이천,1813,2002,3815
<class,경강선,신둔도예촌,786,762,1548
<class,경강선,곤지암,1409,1554,2963
<class,경강선,초월,1493,1491,2984
<class,경강선,경기광주,3316,3368,6684
<class,경강선,삼동,901,912,1813
<class,경강선,이매,611,539,1150
<class,경강선,판교,2078,1803,3881
<class,9호선2~3단계,중앙보훈병원,3131,2999,6130
<class,9호선2~3단계,둔촌오륜,357,389,746
<class,9호선2~3단계,올림픽공원,3091,3239,6330
<class,9호선2~3단계,한성백제,1379,1227,2606
<class,9호선2~3단계,송파나루,2543,2697,5240
<class,9호선2~3단계,석촌,4250,3700,7950
<class,9호선2~3단계,석촌고분,2723,2702,5425
<class,9호선2~3단계,삼전,3205,3192,6397
<class,9호선2~3단계,종합운동장,1932,1762,3694
<class,9호선2~3단계,봉은사,6108,6069,12177
<class,9호선2~3단계,삼성중앙,1756,1789,3545
<class,9호선2~3단계,선정릉,2964,3317,6281
<class,9호선2~3단계,언주,3055,3203,6258
<class,9호선,신논현,13555,12884,26439
<class,9호선,사평,1231,1289,2520
<class,9호선,고속터미널,9557,12314,21871
<class,9호선,신반포,1490,1612,3102
<class,9호선,구반포,1206,1300,2506
<class,9호선,동작,1150,968,2118
<class,9호선,흑석,3515,3727,7242
<class,9호선,노들,2498,2205,4703
<class,9호선,노량진,13705,14865,28570
<class,9호선,샛강,1519,1594,3113
<class,9호선,여의도,8384,7719,16103
<class,9호선,국회의사당,4000,3717,7717
<class,9호선,당산,8300,8186,16486
<class,9호선,선유도,2985,3040,6025
<class,9호선,신목동,1596,1447,3043
<class,9호선,염창,7924,7860,15784
<class,9호선,등촌,4724,4970,9694
<class,9호선,증미,2400,2429,4829
<class,9호선,가양,9066,8914,17980
<class,9호선,양천향교,3952,4206,8158
<class,9호선,마곡나루,5750,5656,11406
<class,9호선,신방화,3091,3023,6114
<class,9호선,공항시장,1591,1855,3446
<class,9호선,김포공항,7142,10418,17560
<class,9호선,개화,1054,967,2021
<class,8호선,모란,2244,1998,4242
<class,8호선,수진,2857,2540,5397
<class,8호선,신흥,2550,2784,5334
<class,8호선,단대오거리,5143,5107,10250
<class,8호선,남한산성입구,6304,6035,12339
<class,8호선,산성,3416,3468,6884
<class,8호선,복정,4816,4456,9272
<class,8호선,장지,8448,8533,16981
<class,8호선,가락시장,2881,3600,6481
<class,8호선,송파,3395,3645,7040
<class,8호선,석촌,3795,4794,8589
<class,8호선,잠실,8169,8964,17133
<class,8호선,몽촌토성,3076,3100,6176
<class,8호선,강동구청,3985,4026,8011
<class,8호선,천호,7985,9098,17083
<class,8호선,암사,8301,7889,16190
<class,7호선,부평구청,4821,4177,8998
<class,7호선,굴포천,4240,4164,8404
<class,7호선,삼산체육관,2689,2482,5171
<class,7호선,상동,6157,5989,12146
<class,7호선,부천시청,5994,5886,11880
<class,7호선,신중동,6339,6229,12568
<class,7호선,춘의,3429,3296,6725
<class,7호선,부천종합운동장,2320,2202,4522
<class,7호선,까치울,4209,4094,8303
<class,7호선,온수,3889,3995,7884
<class,7호선,천왕,4749,4667,9416
<class,7호선,광명사거리,11542,11410,22952
<class,7호선,철산,9927,9863,19790
<class,7호선,가산디지털단지,10776,9873,20649
<class,7호선,남구로,6417,6320,12737
<class,7호선,대림,6009,5767,11776
<class,7호선,신풍,5577,5322,10899
<class,7호선,보라매,4455,4524,8979
<class,7호선,신대방삼거리,7280,7195,14475
<class,7호선,장승배기,4651,4591,9242
<class,7호선,상도,4939,4985,9924
<class,7호선,숭실대입구,5385,5843,11228
<class,7호선,남성,5004,5025,10029
<class,7호선,이수,7482,7011,14493
<class,7호선,내방,4697,4754,9451
<class,7호선,고속터미널,11400,7564,18964
<class,7호선,반포,2673,2689,5362
<class,7호선,논현,5973,6318,12291
<class,7호선,학동,5469,5875,11344
<class,7호선,강남구청,5369,5911,11280
<class,7호선,청담,6022,6408,12430
<class,7호선,뚝섬유원지,11519,10746,22265
<class,7호선,건대입구,6834,6892,13726
<class,7호선,어린이대공원,7901,7987,15888
<class,7호선,군자,7219,5638,12857
<class,7호선,중곡,4892,4694,9586
<class,7호선,용마산,3426,3841,7267
<class,7호선,사가정,8754,8503,17257
<class,7호선,면목,7748,7758,15506
<class,7호선,상봉,8935,8204,17139
<class,7호선,중화,6083,5743,11826
<class,7호선,먹골,5249,5193,10442
<class,7호선,태릉입구,4602,4312,8914
<class,7호선,공릉,5994,6186,12180
<class,7호선,하계,8297,7905,16202
<class,7호선,중계,6334,5913,12247
<class,7호선,노원,10090,10249,20339
<class,7호선,마들,5697,5196,10893
<class,7호선,수락산,8191,8242,16433
<class,7호선,도봉산,5701,8460,14161
<class,7호선,장암,1561,1222,2783
<class,6호선,봉화산,3750,3587,7337
<class,6호선,화랑대,4734,4174,8908
<class,6호선,태릉입구,2802,3059,5861
<class,6호선,석계,6005,6287,12292
<class,6호선,돌곶이,4429,4152,8581
<class,6호선,상월곡,2993,2830,5823
<class,6호선,월곡,4985,4898,9883
<class,6호선,고려대,3833,3750,7583
<class,6호선,안암,4203,4476,8679
<class,6호선,보문,3698,3585,7283
<class,6호선,창신,1532,1409,2941
<class,6호선,동묘앞,6226,5966,12192
<class,6호선,신당,3677,4334,8011
<class,6호선,청구,1613,1577,3190
<class,6호선,약수,1453,1519,2972
<class,6호선,버티고개,1074,1144,2218
<class,6호선,한강진,5871,6649,12520
<class,6호선,이태원,8245,8026,16271
<class,6호선,녹사평,3915,3745,7660
<class,6호선,삼각지,3275,2381,5656
<class,6호선,효창공원앞,3173,2862,6035
<class,6호선,공덕,6144,5666,11810
<class,6호선,대흥,3450,3605,7055
<class,6호선,광흥창,3713,3559,7272
<class,6호선,상수,4793,5560,10353
<class,6호선,합정,8481,7499,15980
<class,6호선,망원,9522,10399,19921
<class,6호선,마포구청,6642,6113,12755
<class,6호선,월드컵경기장,3839,3786,7625
<class,6호선,디지털미디어시티,4802,5089,9891
<class,6호선,증산,5273,5382,10655
<class,6호선,새절,6096,6055,12151
<class,6호선,구산,3646,2722,6368
<class,6호선,연신내,1,0,1
<class,6호선,독바위,1587,2027,3614
<class,6호선,불광,3248,2971,6219
<class,6호선,역촌,1835,2206,4041
<class,6호선,응암,8783,8707,17490
<class,5호선,하남검단산,4732,4768,9500
<class,5호선,하남시청,3214,2904,6118
<class,5호선,하남풍산,2127,2145,4272
<class,5호선,미사,7681,7795,15476
<class,5호선,강일,1628,1690,3318
<class,5호선,마천,3240,3608,6848
<class,5호선,거여,3722,3668,7390
<class,5호선,개롱,2845,3148,5993
<class,5호선,오금,1596,1464,3060
<class,5호선,방이,3769,3568,7337
<class,5호선,올림픽공원,2060,2028,4088
<class,5호선,둔촌동,4185,4196,8381
<class,5호선,상일동,6445,6216,12661
<class,5호선,고덕,3967,3897,7864
<class,5호선,명일,4441,4489,8930
<class,5호선,굽은다리,4673,4434,9107
<class,5호선,길동,3951,4011,7962
<class,5호선,강동,8318,8376,16694
<class,5호선,천호,11294,10475,21769
<class,5호선,광나루,7374,7440,14814
<class,5호선,아차산,11425,11643,23068
<class,5호선,군자,5692,6071,11763
<class,5호선,장한평,6687,6695,13382
<class,5호선,답십리,6789,6406,13195
<class,5호선,마장,2767,2522,5289
<class,5호선,왕십리,2259,2514,4773
<class,5호선,행당,3814,3478,7292
<class,5호선,신금호,2781,2968,5749
<class,5호선,청구,1712,1523,3235
<class,5호선,동대문역사문화공원,655,852,1507
<class,5호선,을지로4가,1434,1558,2992
<class,5호선,종로3가,7390,7027,14417
<class,5호선,광화문,9617,9551,19168
<class,5호선,서대문,4345,4342,8687
<class,5호선,충정로,1403,1419,2822
<class,5호선,애오개,2564,2614,5178
<class,5호선,공덕,4382,4407,8789
<class,5호선,마포,4480,4552,9032
<class,5호선,여의나루,15442,16356,31798
<class,5호선,여의도,7311,7754,15065
<class,5호선,신길,1817,1948,3765
<class,5호선,영등포시장,4001,4141,8142
<class,5호선,영등포구청,1301,1271,2572
<class,5호선,양평,2505,2457,4962
<class,5호선,오목교,11011,11282,22293
<class,5호선,목동,7268,7509,14777
<class,5호선,신정,6023,5356,11379
<class,5호선,까치산,14741,14543,29284
<class,5호선,화곡,13434,12792,26226
<class,5호선,우장산,6108,6225,12333
<class,5호선,발산,8531,8830,17361
<class,5호선,마곡,3337,3491,6828
<class,5호선,송정,3612,3654,7266
<class,5호선,김포공항,6739,6151,12890
<class,5호선,개화산,2585,2842,5427
<class,5호선,방화,3662,3605,7267
<class,4호선,쌍문,14761,13230,27991
<class,4호선,창동,13527,14196,27723
<class,4호선,상계,10097,9459,19556
<class,4호선,당고개,7330,7071,14401
<class,4호선,남태령,559,470,1029
<class,4호선,사당,13172,12394,25566
<class,4호선,총신대입구,9497,10342,19839
<class,4호선,동작,2039,2079,4118
<class,4호선,이촌,4683,5300,9983
<class,4호선,신용산,6263,6418,12681
<class,4호선,삼각지,1915,2482,4397
<class,4호선,숙대입구,6091,5856,11947
<class,4호선,서울역,3700,7607,11307
<class,4호선,회현,7541,8046,15587
<class,4호선,명동,9461,9784,19245
<class,4호선,충무로,7441,7719,15160
<class,4호선,동대문역사문화공원,7892,7709,15601
<class,4호선,동대문,6769,7368,14137
<class,4호선,혜화,17634,18412,36046
<class,4호선,한성대입구,7293,7255,14548
<class,4호선,성신여대입구,10943,10542,21485
<class,4호선,길음,9372,9097,18469
<class,4호선,미아사거리,14914,14312,29226
<class,4호선,미아,7411,7063,14474
<class,4호선,수유,18248,17502,35750
<class,3호선,오금,2844,2759,5603
<class,3호선,경찰병원,2670,2782,5452
<class,3호선,가락시장,3306,3576,6882
<class,3호선,수서,9466,9255,18721
<class,3호선,일원,3231,3416,6647
<class,3호선,대청,3703,3663,7366
<class,3호선,학여울,2441,2860,5301
<class,3호선,대치,4581,4176,8757
<class,3호선,도곡,1997,2104,4101
<class,3호선,매봉,3962,3983,7945
<class,3호선,양재,12081,14205,26286
<class,3호선,남부터미널,12067,12767,24834
<class,3호선,교대,3849,2406,6255
<class,3호선,고속터미널,36816,33367,70183
<class,3호선,잠원,2199,2238,4437
<class,3호선,신사,12252,12454,24706
<class,3호선,압구정,12508,12899,25407
<class,3호선,옥수,4906,5233,10139
<class,3호선,금호,4167,3993,8160
<class,3호선,약수,6140,6073,12213
<class,3호선,동대입구,4881,5644,10525
<class,3호선,충무로,1,0,1
<class,3호선,을지로3가,2745,2593,5338
<class,3호선,종로3가,3439,4544,7983
<class,3호선,안국,8750,9840,18590
<class,3호선,경복궁,10404,11069,21473
<class,3호선,독립문,4051,4601,8652
<class,3호선,무악재,1750,1850,3600
<class,3호선,홍제,8738,8444,17182
<class,3호선,녹번,6263,5899,12162
<class,3호선,불광,9336,10997,20333
<class,3호선,연신내,20780,19133,39913
<class,3호선,구파발,11098,11382,22480
<class,3호선,지축,1746,1739,3485
<class,2호선,용두,1054,1028,2082
<class,2호선,신정네거리,4836,4840,9676
<class,2호선,양천구청,3027,3120,6147
<class,2호선,도림천,440,480,920
<class,2호선,신설동,2931,2908,5839
<class,2호선,신답,655,723,1378
<class,2호선,용답,1522,1515,3037
<class,2호선,충정로,3378,3661,7039
<class,2호선,아현,4796,4825,9621
<class,2호선,이대,6044,6531,12575
<class,2호선,신촌,18604,18478,37082
<class,2호선,홍대입구,38718,38931,77649
<class,2호선,합정,17265,18341,35606
<class,2호선,당산,8887,9384,18271
<class,2호선,영등포구청,7095,7476,14571
<class,2호선,문래,6872,7300,14172
<class,2호선,신도림,26059,26075,52134
<class,2호선,대림,14241,14280,28521
<class,2호선,구로디지털단지,21148,20937,42085
<class,2호선,신대방,14463,14312,28775
<class,2호선,신림,34319,33452,67771
<class,2호선,봉천,11708,11503,23211
<class,2호선,서울대입구,25630,26477,52107
<class,2호선,낙성대,14702,15240,29942
<class,2호선,사당,18753,21291,40044
<class,2호선,방배,6044,6434,12478
<class,2호선,서초,9674,9237,18911
<class,2호선,교대,9493,10316,19809
<class,2호선,강남,30091,29319,59410
<class,2호선,역삼,10259,11358,21617
<class,2호선,선릉,11810,10417,22227
<class,2호선,삼성,16561,16139,32700
<class,2호선,종합운동장,4561,5059,9620
<class,2호선,잠실새내,10002,10184,20186
<class,2호선,잠실,40132,37095,77227
<class,2호선,잠실나루,4728,4846,9574
<class,2호선,강변,19338,18796,38134
<class,2호선,구의,10337,10572,20909
<class,2호선,건대입구,23726,24037,47763
<class,2호선,성수,11507,12886,24393
<class,2호선,뚝섬,11619,11331,22950
<class,2호선,한양대,2501,2715,5216
<class,2호선,왕십리,8453,7259,15712
<class,2호선,상왕십리,6581,6424,13005
<class,2호선,신당,7914,8397,16311
<class,2호선,동대문역사문화공원,7318,8673,15991
<class,2호선,을지로4가,3072,2947,6019
<class,2호선,을지로3가,6673,6122,12795
<class,2호선,을지로입구,13986,12977,26963
<class,2호선,시청,5120,4119,9239
<class,1호선,청량리,12998,12521,25519
<class,1호선,제기동,9196,9829,19025
<class,1호선,신설동,6799,6945,13744
<class,1호선,동대문,9207,9803,19010
<class,1호선,종로5가,8510,8634,17144
<class,1호선,종로3가,13422,11586,25008
<class,1호선,종각,10941,9462,20403
<class,1호선,시청,6552,6487,13039
<class,1호선,동묘앞,12744,13162,25906
<class,1호선,서울역,23478,20137,43615
<class,8호선,문정,5297,5699,10996
<class,9호선,노량진,19486,19311,38797
<class,5호선,올림픽공원,2406,1953,4359
<class,5호선,방이,4454,4330,8784
<class,5호선,오금,2047,1889,3936
<class,5호선,개롱,3667,3832,7499
<class,5호선,거여,4254,4158,8412
<class,5호선,마천,3633,3768,7401
<class,5호선,강일,1847,1780,3627
<class,5호선,미사,9348,9153,18501
<class,5호선,하남풍산,2319,2417,4736
<class,5호선,하남시청,3829,3728,7557
<class,5호선,하남검단산,4032,4180,8212
<class,6호선,응암,10942,10916,21858
<class,6호선,역촌,2303,2695,4998
<class,6호선,불광,3533,3183,6716
<class,6호선,독바위,1731,1896,3627
<class,5호선,고덕,4900,4891,9791
<class,5호선,명일,5125,5212,10337
<class,5호선,굽은다리,6209,5897,12106
<class,5호선,길동,5317,5548,10865
<class,5호선,강동,10935,10470,21405
<class,5호선,천호,15026,13681,28707
<class,5호선,광나루,7991,7427,15418
<class,5호선,아차산,10476,10284,20760
<class,5호선,군자,7569,8370,15939
<class,5호선,장한평,9463,9355,18818
<class,5호선,답십리,9133,8521,17654
<class,5호선,마장,3465,3386,6851
<class,5호선,왕십리,3153,3563,6716
<class,5호선,행당,4783,4163,8946
<class,5호선,신금호,3541,3682,7223
<class,5호선,청구,2264,2072,4336
<class,5호선,동대문역사문화공원,909,1168,2077
<class,5호선,을지로4가,2973,3386,6359
<class,5호선,종로3가,11340,10915,22255
<class,5호선,광화문,12313,12388,24701
<class,5호선,서대문,5822,5670,11492
<class,5호선,충정로,1857,1761,3618
<class,5호선,애오개,3355,3289,6644
<class,5호선,공덕,6925,6898,13823
<class,5호선,마포,7045,6525,13570
<class,5호선,여의나루,7497,11165,18662
<class,5호선,여의도,12743,11626,24369
<class,5호선,신길,2253,2463,4716
<class,5호선,영등포시장,6348,6858,13206
<class,5호선,영등포구청,1682,1695,3377
<class,5호선,양평,3251,3101,6352
<class,5호선,오목교,15144,15464,30608
<class,5호선,목동,10157,10299,20456
<class,5호선,신정,7912,6836,14748
<class,5호선,까치산,18818,18198,37016
<class,5호선,화곡,17535,16511,34046
<class,5호선,우장산,8742,8555,17297
<class,5호선,발산,11932,12400,24332
<class,5호선,마곡,4703,4658,9361
<class,5호선,송정,4635,4575,9210
<class,5호선,김포공항,7260,7146,14406
<class,5호선,개화산,3231,3155,6386
<class,5호선,방화,4102,3894,7996
<class,4호선,쌍문,18513,16954,35467
<class,4호선,창동,16714,17797,34511
<class,4호선,노원,14326,15242,29568
<class,4호선,상계,12141,11395,23536
<class,4호선,당고개,8288,8106,16394
<class,4호선,남태령,830,569,1399
<class,4호선,사당,17920,15152,33072
<class,4호선,총신대입구,12643,13542,26185
<class,4호선,동작,1670,1693,3363
<class,4호선,이촌,5329,6022,11351
<class,4호선,신용산,8343,8871,17214
<class,4호선,삼각지,2744,3608,6352
<class,4호선,숙대입구,8198,8037,16235
<class,4호선,서울역,4511,10607,15118
<class,4호선,회현,16732,17026,33758
<class,4호선,명동,11152,12627,23779
<class,4호선,충무로,11007,11283,22290
<class,4호선,동대문역사문화공원,10076,8719,18795
<class,4호선,동대문,13880,13662,27542
<class,4호선,혜화,21623,21978,43601
<class,4호선,한성대입구,9241,9124,18365
<class,4호선,성신여대입구,14798,14042,28840
<class,4호선,길음,12035,11581,23616
<class,4호선,미아사거리,19651,18753,38404
<class,4호선,미아,9671,9032,18703
<class,4호선,수유,23191,22501,45692
<class,3호선,오금,3422,3305,6727
<class,3호선,경찰병원,3547,3363,6910
<class,3호선,가락시장,5485,5181,10666
<class,3호선,수서,11495,11546,23041
<class,3호선,일원,3604,3711,7315
<class,3호선,대청,4773,4480,9253
<class,3호선,학여울,2928,2971,5899
<class,3호선,대치,7053,6608,13661
<class,3호선,도곡,3345,3390,6735
<class,3호선,매봉,5103,5055,10158
<class,3호선,양재,17674,18842,36516
<class,3호선,남부터미널,19286,20221,39507
<class,3호선,교대,5729,3475,9204
<class,3호선,고속터미널,43958,45622,89580
<class,3호선,잠원,2872,2812,5684
<class,3호선,신사,22473,22832,45305
<class,3호선,압구정,21480,22247,43727
<class,3호선,옥수,6034,6291,12325
<class,3호선,금호,5279,4956,10235
<class,3호선,약수,8089,7443,15532
<class,3호선,동대입구,5275,5716,10991
<class,3호선,충무로,1,0,1
<class,3호선,을지로3가,4332,4792,9124
<class,3호선,종로3가,5556,7468,13024
<class,3호선,안국,11257,12531,23788
<class,3호선,경복궁,12030,11754,23784
<class,3호선,독립문,4691,4856,9547
<class,3호선,무악재,2329,2347,4676
<class,3호선,홍제,11067,10484,21551
<class,3호선,녹번,8506,7442,15948
<class,3호선,불광,10991,12268,23259
<class,3호선,연신내,25734,24119,49853
<class,3호선,구파발,12266,12386,24652
<class,3호선,지축,2074,2059,4133
<class,2호선,용두,1566,1527,3093
<class,2호선,신정네거리,6788,6700,13488
<class,2호선,양천구청,3902,4004,7906
<class,2호선,도림천,656,686,1342
<class,2호선,신설동,2989,2727,5716
<class,2호선,신답,862,920,1782
<class,2호선,용답,1866,1758,3624
<class,2호선,충정로,5176,5656,10832
<class,2호선,아현,6500,6272,12772
<class,2호선,이대,8526,8745,17271
<class,2호선,신촌,27123,27003,54126
<class,2호선,홍대입구,57658,59726,117384
<class,2호선,합정,24754,26036,50790
<class,2호선,당산,10871,11926,22797
<class,2호선,영등포구청,11203,11458,22661
<class,2호선,문래,10628,11187,21815
<class,2호선,신도림,37580,37900,75480
<class,2호선,대림,16474,17654,34128
<class,2호선,구로디지털단지,29607,28754,58361
<class,2호선,신대방,17657,17251,34908
<class,2호선,신림,44694,42146,86840
<class,2호선,봉천,15145,14257,29402
<class,2호선,서울대입구,33592,32178,65770
<class,2호선,낙성대,18771,17665,36436
<class,2호선,사당,25293,27730,53023
<class,2호선,방배,8794,9217,18011
<class,2호선,서초,10236,8890,19126
<class,2호선,교대,14843,16632,31475
<class,2호선,강남,51837,50791,102628
<class,2호선,역삼,16362,17570,33932
<class,2호선,선릉,20328,18438,38766
<class,2호선,삼성,29119,28967,58086
<class,2호선,종합운동장,5062,5516,10578
<class,2호선,잠실새내,15104,15715,30819
<class,2호선,잠실,55405,53059,108464
<class,2호선,잠실나루,6579,6598,13177
<class,2호선,강변,23363,24802,48165
<class,2호선,구의,14184,13855,28039
<class,2호선,건대입구,30565,31928,62493
<class,2호선,성수,15048,16651,31699
<class,2호선,뚝섬,11703,11781,23484
<class,2호선,한양대,3024,2921,5945
<class,2호선,왕십리,11695,10140,21835
<class,2호선,상왕십리,8640,8027,16667
<class,2호선,신당,9731,10064,19795
<class,2호선,동대문역사문화공원,9182,9565,18747
<class,2호선,을지로4가,6097,6223,12320
<class,2호선,을지로3가,9184,9131,18315
<class,2호선,을지로입구,18137,17849,35986
<class,2호선,시청,6905,5907,12812
<class,1호선,청량리,15950,16097,32047
<class,1호선,제기동,13612,13889,27501
<class,1호선,신설동,7777,7497,15274
<class,1호선,동대문,11032,10116,21148
<class,1호선,종로5가,18029,17366,35395
<class,1호선,종로3가,19003,18406,37409
<class,1호선,종각,16189,14738,30927
<class,1호선,시청,8253,8774,17027
<class,1호선,동묘앞,9578,9794,19372
<class,1호선,서울역,26548,27986,54534
<class,6호선,구산,4638,3511,8149
<class,6호선,새절,7755,7358,15113
<class,6호선,증산,6477,6467,12944
<class,6호선,디지털미디어시티,5935,6138,12073
<class,6호선,월드컵경기장,3735,3762,7497
<class,6호선,마포구청,8098,7380,15478
<class,6호선,망원,11624,12657,24281
<class,6호선,합정,11014,9950,20964
<class,6호선,상수,7579,8666,16245
<class,6호선,광흥창,4644,4421,9065
<class,6호선,대흥,4913,4921,9834
<class,6호선,공덕,9153,8342,17495
<class,6호선,효창공원앞,3974,3641,7615
<class,6호선,삼각지,4425,3373,7798
<class,6호선,녹사평,4616,4846,9462
<class,6호선,이태원,10768,10839,21607
<class,6호선,한강진,7201,8293,15494
<class,6호선,버티고개,1373,1411,2784
<class,6호선,약수,2046,2135,4181
<class,6호선,청구,2144,2241,4385
<class,6호선,신당,5745,4672,10417
<class,6호선,동묘앞,7680,6904,14584
<class,경의선,곡산,347,337,684
<class,6호선,창신,2003,1735,3738
<class,6호선,보문,4499,4139,8638
<class,6호선,안암,6050,5692,11742
<class,6호선,고려대,4693,4500,9193
<class,6호선,월곡,6426,6200,12626
<class,6호선,상월곡,3624,3249,6873
<class,6호선,돌곶이,5401,5017,10418
<class,6호선,석계,7693,7662,15355
<class,6호선,태릉입구,3650,3913,7563
<class,6호선,화랑대,6127,5114,11241
<class,6호선,봉화산,4647,4519,9166
<class,7호선,장암,1220,935,2155
<class,7호선,도봉산,5198,7206,12404
<class,7호선,수락산,8708,8528,17236
<class,7호선,마들,7597,7140,14737
<class,7호선,노원,13952,14244,28196
<class,7호선,중계,7978,7056,15034
<class,7호선,하계,10737,10094,20831
<class,7호선,공릉,7922,7618,15540
<class,7호선,태릉입구,5548,5033,10581
<class,7호선,먹골,7306,7074,14380
<class,7호선,중화,6970,6684,13654
<class,7호선,상봉,11505,10756,22261
<class,7호선,면목,9696,9460,19156
<class,7호선,사가정,10906,10553,21459
<class,7호선,용마산,3832,3647,7479
<class,7호선,중곡,5982,5593,11575
<class,7호선,군자,9283,7202,16485
<class,7호선,어린이대공원,7579,7125,14704
<class,7호선,건대입구,9769,9858,19627
<class,7호선,뚝섬유원지,5392,5260,10652
<class,7호선,청담,9741,10548,20289
<class,7호선,강남구청,9064,10007,19071
<class,7호선,학동,8982,9628,18610
<class,7호선,논현,9820,10704,20524
<class,7호선,반포,3789,3527,7316
<class,7호선,고속터미널,12226,9514,21740
<class,7호선,내방,7021,6898,13919
<class,7호선,이수,10377,9687,20064
<class,7호선,남성,6670,6295,12965
<class,7호선,숭실대입구,7264,7381,14645
<class,7호선,상도,6546,6198,12744
<class,7호선,장승배기,6132,5738,11870
<class,경의선,계양,1,0,1
<class,7호선,신대방삼거리,9782,9325,19107
<class,7호선,보라매,5179,4945,10124
<class,7호선,신풍,7270,7049,14319
<class,7호선,대림,7220,7235,14455
<class,7호선,남구로,7952,8037,15989
<class,7호선,가산디지털단지,13779,12664,26443
<class,7호선,철산,13522,13581,27103
<class,7호선,광명사거리,15068,14954,30022
<class,7호선,천왕,5878,5575,11453
<class,7호선,온수,4961,4853,9814
<class,7호선,까치울,4825,4695,9520
<class,7호선,부천종합운동장,2648,2527,5175
<class,7호선,춘의,4331,4171,8502
<class,7호선,신중동,8580,8322,16902
<class,7호선,부천시청,8603,8433,17036
<class,7호선,상동,9204,9225,18429
<class,7호선,삼산체육관,2960,2836,5796
<class,7호선,굴포천,5739,6021,11760
<class,7호선,부평구청,6196,5516,11712
<class,8호선,암사,10837,10270,21107
<class,8호선,천호,10736,12825,23561
<class,8호선,강동구청,5319,5309,10628
<class,8호선,몽촌토성,3344,3325,6669
<class,8호선,잠실,12089,13600,25689
<class,8호선,석촌,5233,6281,11514
<class,8호선,송파,4889,4884,9773
<class,8호선,가락시장,5236,5152,10388
<class,8호선,문정,7782,7978,15760
<class,8호선,장지,11150,10197,21347
<class,8호선,복정,6012,5160,11172
<class,8호선,산성,4047,4210,8257
<class,8호선,남한산성입구,7665,6994,14659
<class,8호선,단대오거리,6550,6126,12676
<class,8호선,신흥,3350,3535,6885
<class,8호선,수진,3451,3146,6597
<class,8호선,모란,3020,2726,5746
<class,9호선,개화,1288,1077,2365
<class,9호선,김포공항,7751,11500,19251
<class,9호선,공항시장,2098,2187,4285
<class,9호선,신방화,4103,4065,8168
<class,9호선,마곡나루,7236,7108,14344
<class,9호선,양천향교,5204,5097,10301
<class,9호선,가양,12301,11673,23974
<class,9호선,증미,3690,3607,7297
<class,9호선,등촌,6385,6302,12687
<class,9호선,염창,10277,9441,19718
<class,9호선,신목동,2054,1733,3787
<class,9호선,선유도,3408,3357,6765
<class,9호선,당산,11175,10484,21659
<class,9호선,국회의사당,4086,4386,8472
<class,9호선,여의도,12402,10917,23319
<class,9호선,샛강,2390,2291,4681
<class,5호선,둔촌동,5156,5188,10344
<class,9호선,노들,2849,2431,5280
<class,9호선,흑석,4591,4725,9316
<class,9호선,동작,1205,998,2203
<class,9호선,구반포,1954,2088,4042
<class,9호선,신반포,1889,1784,3673
<class,9호선,고속터미널,11244,16329,27573
<class,9호선,사평,1828,1711,3539
<class,9호선,신논현,22747,22080,44827
<class,9호선2~3단계,언주,5248,5258,10506
<class,9호선2~3단계,선정릉,4366,4930,9296
<class,9호선2~3단계,삼성중앙,2754,2782,5536
<class,9호선2~3단계,봉은사,10199,10736,20935
<class,9호선2~3단계,종합운동장,3011,2657,5668
<class,9호선2~3단계,삼전,4199,4035,8234
<class,9호선2~3단계,석촌고분,3627,3588,7215
<class,9호선2~3단계,석촌,5515,4623,10138
<class,9호선2~3단계,송파나루,3654,3745,7399
<class,9호선2~3단계,한성백제,1461,1241,2702
<class,9호선2~3단계,올림픽공원,3200,3267,6467
<class,9호선2~3단계,둔촌오륜,508,485,993
<class,9호선2~3단계,중앙보훈병원,3600,3386,6986
<class,경강선,판교,2568,2314,4882
<class,경강선,이매,706,579,1285
<class,경강선,삼동,1285,1162,2447
<class,경강선,경기광주,4341,4123,8464
<class,경강선,초월,1896,1753,3649
<class,경강선,곤지암,1484,1685,3169
<class,경강선,신둔도예촌,835,886,1721
<class,경강선,이천,2245,2459,4704
<class,경강선,부발,1406,1303,2709
<class,경강선,세종대왕릉,241,276,517
<class,경강선,여주,1729,2067,3796
<class,경부선,서울역,5011,1588,6599
<class,경부선,남영,4910,5197,10107
<class,경부선,용산,29764,32555,62319
<class,경부선,노량진,7681,7173,14854
<class,경부선,대방,6944,7122,14066
<class,경부선,영등포,36895,38077,74972
<class,경부선,신도림,2600,2722,5322
<class,경부선,신길,5591,4669,10260
<class,경부선,구로,11880,12428,24308
<class,경부선,가산디지털단지,5335,7374,12709
<class,경부선,금천구청,7234,7230,14464
<class,경부선,석수,5897,5387,11284
<class,경부선,관악,5105,4771,9876
<class,경부선,안양,16350,16210,32560
<class,경부선,명학,4425,4278,8703
<class,경부선,금정,16305,16203,32508
<class,경부선,군포,3740,3430,7170
<class,경부선,의왕,5181,5014,10195
<class,경부선,성균관대,8978,9023,18001
<class,경부선,화서,4568,4413,8981
<class,경부선,수원,35438,38282,73720
<class,경부선,독산,7526,7443,14969
<class,경부선,세류,2113,2223,4336
<class,경부선,병점,10494,10630,21124
<class,경부선,세마,1907,1693,3600
<class,경부선,오산대,2439,2239,4678
<class,경부선,오산,8381,7972,16353
<class,경부선,진위,916,815,1731
<class,경부선,송탄,4151,3761,7912
<class,경부선,서정리,4846,4393,9239
<class,경부선,지제,2035,2028,4063
<class,경부선,평택,12024,11431,23455
<class,경부선,성환,2762,2539,5301
<class,경부선,직산,526,525,1051
<class,경부선,두정,4831,4861,9692
<class,경부선,천안,5567,5835,11402
<class,경부선,당정,3599,3392,6991
<class,경부선,서동탄,958,975,1933
<class,경부선,광명,2157,2037,4194
<class,경원선,이촌,2552,1829,4381
<class,경원선,서빙고,1085,989,2074
<class,경원선,한남,2433,2342,4775
<class,경원선,옥수,26,38,64
<class,경원선,응봉,1249,1067,2316
<class,경원선,왕십리,10831,12175,23006
<class,경원선,청량리,13618,15187,28805
<class,경원선,외대앞,5265,5154,10419
<class,경원선,신이문,5520,5057,10577
<class,경원선,석계,5729,6108,11837
<class,경원선,광운대,5271,5048,10319
<class,경원선,월계,3989,3721,7710
<class,경원선,녹천,2993,2554,5547
<class,경원선,방학,6203,6124,12327
<class,경원선,도봉,3758,3568,7326
<class,경원선,도봉산,6844,4659,11503
<class,경원선,망월사,4714,4830,9544
<class,경원선,회룡,8088,8098,16186
<class,경원선,의정부,15558,16291,31849
<class,경원선,가능,4462,4265,8727
<class,경원선,녹양,2886,2853,5739
<class,경원선,양주,5338,5183,10521
<class,경원선,덕계,1776,1618,3394
<class,경원선,덕정,3485,3281,6766
<class,경원선,지행,4672,4622,9294
<class,경원선,동두천중앙,2123,2162,4285
<class,경원선,보산,1803,1718,3521
<class,경원선,동두천,1349,1715,3064
<class,경원선,소요산,2796,2464,5260
<class,경의선,서울역,1052,1237,2289
<class,경의선,신촌,332,336,668
<class,경의선,효창공원앞,1545,1755,3300
<class,경의선,공덕,2369,1758,4127
<class,경의선,서강대,1493,1470,2963
<class,경의선,홍대입구,1680,2146,3826
<class,경의선,가좌,3468,3302,6770
<class,경의선,디지털미디어시티,1519,1448,2967
<class,경의선,수색,1018,1022,2040
<class,경의선,화전,1006,933,1939
<class,경의선,강매,1714,1595,3309
<class,경의선,행신,4484,4592,9076
<class,경의선,능곡,2502,2429,4931
<class,경의선,백마,3899,3661,7560
<class,경의선,풍산,3797,3566,7363
<class,경의선,일산,5307,5171,10478
<class,경의선,탄현,4611,4413,9024
<class,경의선,야당,4839,4617,9456
<class,경의선,운정,4093,3872,7965
<class,경의선,금릉,3193,3040,6233
<class,경의선,금촌,4902,4938,9840
<class,경의선,월롱,1105,1073,2178
<class,경의선,파주,704,575,1279
<class,경의선,문산,3866,3788,7654
<class,경의선,임진강,33,27,60
<class,경인선,개봉,14394,14139,28533
<class,경인선,오류동,8060,7441,15501
<class,경인선,역곡,17957,17479,35436
<class,경인선,부천,26633,27124,53757
<class,경인선,송내,16264,15941,32205
<class,경인선,부평,27725,30120,57845
<class,경인선,백운,4947,4921,9868
<class,경인선,동암,11203,11221,22424
<class,경인선,주안,14368,12701,27069
<class,경인선,제물포,6609,6289,12898
<class,경인선,동인천,10490,10349,20839
<class,경인선,인천,3752,3207,6959
<class,경인선,구일,4077,3757,7834
<class,경인선,소사,6954,6751,13705
<class,경인선,부개,5570,5212,10782
<class,경인선,간석,3878,3897,7775
<class,경인선,도원,1819,1826,3645
<class,경인선,온수,4501,4156,8657
<class,경인선,중동,5758,5448,11206
<class,경인선,도화,2759,2617,5376
<class,경춘선,신내,842,854,1696
<class,경춘선,갈매,1615,1412,3027
<class,경춘선,별내,1809,1748,3557
<class,경춘선,퇴계원,2194,2036,4230
<class,경춘선,사릉,1890,1877,3767
<class,경춘선,금곡,899,865,1764
<class,경춘선,평내호평,3720,3671,7391
<class,경춘선,천마산,1110,1101,2211
<class,경춘선,마석,2742,2596,5338
<class,경춘선,대성리,445,475,920
<class,경춘선,청평,1265,1405,2670
<class,경춘선,상천,266,286,552
<class,경춘선,가평,1412,1612,3024
<class,경춘선,굴봉산,200,208,408
<class,경춘선,백양리,105,103,208
<class,경춘선,강촌,461,519,980
<class,경춘선,김유정,419,537,956
<class,경춘선,남춘천,1949,2178,4127
<class,경춘선,춘천,1303,1282,2585
<class,공항철도 1호선,서울역,6245,6707,12952
<class,공항철도 1호선,공덕,1348,2099,3447
<class,공항철도 1호선,홍대입구,11150,11187,22337
<class,공항철도 1호선,디지털미디어시티,4503,4312,8815
<class,공항철도 1호선,마곡나루,2534,2763,5297
<class,공항철도 1호선,김포공항,10076,5468,15544
<class,공항철도 1호선,계양,5719,5308,11027
<class,공항철도 1호선,검암,4122,4184,8306
<class,공항철도 1호선,청라국제도시,3583,3444,7027
<class,공항철도 1호선,운서,4945,5180,10125
<class,공항철도 1호선,공항화물청사,1188,1236,2424
<class,공항철도 1호선,인천공항1터미널,2625,2895,5520
<class,공항철도 1호선,인천공항2터미널,1492,1399,2891
<class,공항철도 1호선,영종,2439,2580,5019
<class,과천선,선바위,4410,3851,8261
<class,과천선,경마공원,901,928,1829
<class,과천선,대공원,3633,3780,7413
<class,과천선,과천,3456,3246,6702
<class,과천선,정부과천청사,4711,4802,9513
<class,과천선,인덕원,13705,13395,27100
<class,과천선,평촌,8168,7946,16114
<class,과천선,범계,18607,17867,36474
<class,분당선,선릉,4454,6955,11409
<class,분당선,한티,9336,9234,18570
<class,분당선,도곡,3832,3567,7399
<class,분당선,구룡,862,826,1688
<class,분당선,개포동,2026,2027,4053
<class,분당선,대모산입구,1617,1474,3091
<class,분당선,수서,8889,9390,18279
<class,분당선,수원,7061,5805,12866
<class,분당선,서울숲,6550,6890,13440
<class,분당선,압구정로데오,16826,18565,35391
<class,분당선,강남구청,4797,5815,10612
<class,분당선,선정릉,3456,3495,6951
<class,분당선,가천대,4444,5012,9456
<class,분당선,태평,9437,8837,18274
<class,분당선,모란,14171,14032,28203
<class,분당선,야탑,15167,16085,31252
<class,분당선,서현,16881,16827,33708
<class,분당선,수내,7429,7136,14565
<class,분당선,정자,9284,9561,18845
<class,분당선,미금,9404,9836,19240
<class,분당선,오리,6923,5622,12545
<class,분당선,이매,3852,3761,7613
<class,분당선,보정,1459,1316,2775
<class,분당선,죽전,9175,10065,19240
<class,분당선,구성,2632,2882,5514
<class,분당선,신갈,2349,2440,4789
<class,분당선,기흥,5919,5689,11608
<class,분당선,상갈,3474,3580,7054
<class,분당선,청명,2305,2257,4562
<class,분당선,영통,5780,5608,11388
<class,분당선,망포,8114,7487,15601
<class,분당선,매탄권선,2950,2758,5708
<class,분당선,수원시청,9971,10784,20755
<class,분당선,매교,1611,1717,3328
<class,수인선,고색,1978,2003,3981
<class,수인선,오목천,1701,1376,3077
<class,수인선,어천,593,553,1146
<class,수인선,야목,167,167,334
<class,수인선,사리,2902,2469,5371
<class,수인선,달월,64,79,143
<class,수인선,월곶,1897,1818,3715
<class,수인선,소래포구,5378,5538,10916
<class,수인선,인천논현,3950,3999,7949
<class,수인선,호구포,2090,2088,4178
<class,수인선,남동인더스파크,845,726,1571
<class,수인선,원인재,3273,3481,6754
<class,안산선,오이도,6639,7034,13673
<class,안산선,수리산,2681,2366,5047
<class,우이신설선,북한산우이,2281,2162,4443
<class,우이신설선,솔밭공원,1526,1470,2996
<class,우이신설선,4.19민주묘지,1966,1852,3818
<class,우이신설선,가오리,2392,2365,4757
<class,우이신설선,화계,2123,1962,4085
<class,우이신설선,삼양,1349,1351,2700
<class,우이신설선,삼양사거리,1622,1556,3178
<class,우이신설선,솔샘,3190,2795,5985
<class,우이신설선,북한산보국문,4132,3705,7837
<class,우이신설선,정릉,3033,2586,5619
<class,우이신설선,성신여대입구,2419,2816,5235
<class,우이신설선,보문,1013,1002,2015
<class,우이신설선,신설동,1103,1103,2206
<class,일산선,원흥,6077,5912,11989
<class,일산선,삼송,12064,11997,24061
<class,일산선,원당,7177,6981,14158
<class,일산선,화정,11042,11490,22532
<class,일산선,대곡,1233,988,2221
<class,일산선,백석,6864,6899,13763
<class,일산선,마두,4341,4451,8792
<class,일산선,정발산,6059,6342,12401
<class,일산선,주엽,5506,5408,10914
<class,일산선,대화,7377,6735,14112
<class,장항선,봉명,577,533,1110
<class,장항선,쌍용,1361,1196,2557
<class,장항선,아산,2491,2444,4935
<class,장항선,배방,832,840,1672
<class,장항선,온양온천,3151,3323,6474
<class,장항선,신창,1102,981,2083
<class,중앙선,회기,17453,16770,34223
<class,중앙선,중랑,3920,3793,7713
<class,중앙선,상봉,4355,4326,8681
<class,중앙선,망우,5447,5338,10785
<class,중앙선,양원,901,879,1780
<class,중앙선,구리,9022,9251,18273
<class,중앙선,도농,5595,5408,11003
<class,중앙선,양정,526,450,976
<class,중앙선,덕소,3832,3858,7690
<class,중앙선,도심,1361,1223,2584
<class,중앙선,팔당,1045,1169,2214
<class,중앙선,운길산,957,954,1911
<class,중앙선,양수,1716,1772,3488
<class,중앙선,신원,188,155,343
<class,중앙선,국수,502,560,1062
<class,중앙선,아신,504,587,1091
<class,중앙선,오빈,243,285,528
<class,중앙선,양평,2155,2396,4551
<class,중앙선,원덕,359,407,766
<class,중앙선,용문,1849,2220,4069
<class,중앙선,지평,46,74,120
<class,5호선,상일동,8508,8000,16508
<class,안산선,정왕,5887,5859,11746
<class,안산선,신길온천,1327,1268,2595
<class,안산선,안산,9375,9784,19159
<class,안산선,초지,2961,2930,5891
<class,안산선,고잔,5545,5820,11365
<class,안산선,중앙,14597,14933,29530
<class,안산선,한대앞,6323,6343,12666
<class,안산선,상록수,10869,10850,21719
<class,안산선,반월,2890,2782,5672
<class,안산선,대야미,3549,3139,6688
<class,안산선,산본,10865,11558,22423
<class,수인선,인천,1000,1822,2822
<class,수인선,신포,1257,1272,2529
<class,수인선,숭의,2360,2243,4603
<class,수인선,인하대,3791,3479,7270
<class,수인선,송도,1804,1821,3625
<class,수인선,연수,3423,3356,6779
<class,중앙선,아신,638,586,1224
<class,중앙선,오빈,289,261,550
<class,중앙선,양평,2545,2158,4703
<class,중앙선,원덕,524,423,947
<class,중앙선,용문,2694,2150,4844
<class,1호선,서울역,25058,21978,47036
<class,1호선,동묘앞,13040,13363,26403
<class,1호선,종각,11439,9876,21315
<class,1호선,종로3가,13429,11906,25335
<class,1호선,종로5가,8205,8249,16454
<class,1호선,동대문,9510,10299,19809
<class,1호선,신설동,7127,7096,14223
<class,중앙선,지평,64,72,136
<class,1호선,제기동,9487,9963,19450
<class,1호선,청량리,12911,12671,25582
<class,2호선,시청,5143,4300,9443
<class,2호선,을지로입구,14496,13480,27976
<class,2호선,을지로3가,7201,6455,13656
<class,2호선,을지로4가,2973,2950,5923
<class,2호선,동대문역사문화공원,6778,8042,14820
<class,2호선,신당,7772,8452,16224
<class,2호선,상왕십리,6471,6504,12975
<class,2호선,왕십리,8994,7746,16740
<class,2호선,한양대,2295,2493,4788
<class,2호선,뚝섬,11482,11378,22860
<class,2호선,성수,12179,13705,25884
<class,2호선,건대입구,26225,26290,52515
<class,2호선,구의,10732,10698,21430
<class,2호선,강변,20625,20031,40656
<class,2호선,잠실나루,4814,4904,9718
<class,2호선,잠실,44466,41505,85971
<class,2호선,잠실새내,10855,11119,21974
<class,2호선,종합운동장,4855,5392,10247
<class,2호선,삼성,17751,17318,35069
<class,2호선,선릉,11931,10446,22377
<class,2호선,역삼,10552,11291,21843
<class,2호선,강남,32515,31048,63563
<class,2호선,교대,9765,10672,20437
<class,2호선,서초,9870,9276,19146
<class,2호선,방배,6451,6996,13447
<class,2호선,사당,19060,21504,40564
<class,2호선,낙성대,14984,15306,30290
<class,2호선,서울대입구,25640,26189,51829
<class,2호선,봉천,11534,11317,22851
<class,2호선,신림,34610,34314,68924
<class,2호선,신대방,14526,14257,28783
<class,2호선,구로디지털단지,22087,21642,43729
<class,2호선,대림,14416,14636,29052
<class,2호선,신도림,26520,26734,53254
<class,2호선,문래,7216,7627,14843
<class,2호선,영등포구청,7489,7839,15328
<class,2호선,당산,8902,9446,18348
<class,2호선,합정,18739,19810,38549
<class,2호선,홍대입구,45763,45830,91593
<class,2호선,신촌,20080,19708,39788
<class,2호선,이대,6517,6966,13483
<class,2호선,아현,4993,4991,9984
<class,2호선,충정로,3407,3585,6992
<class,2호선,용답,1664,1715,3379
<class,2호선,신답,712,819,1531
<class,2호선,신설동,3030,3034,6064
<class,2호선,도림천,490,492,982
<class,2호선,양천구청,3277,3402,6679
<class,2호선,신정네거리,5183,5265,10448
<class,2호선,용두,1243,1227,2470
<class,3호선,지축,1893,1743,3636
<class,3호선,구파발,10981,11440,22421
<class,3호선,연신내,20958,19584,40542
<class,3호선,불광,9583,11264,20847
<class,3호선,녹번,6439,5933,12372
<class,3호선,홍제,8762,8210,16972
<class,3호선,무악재,1720,1852,3572
<class,3호선,독립문,4235,4899,9134
<class,3호선,경복궁,11179,11867,23046
<class,3호선,안국,9256,10336,19592
<class,3호선,종로3가,3586,4901,8487
<class,3호선,을지로3가,2891,2788,5679
<class,3호선,동대입구,5087,5629,10716
<class,3호선,약수,6389,6217,12606
<class,3호선,금호,4324,4148,8472
<class,3호선,옥수,5183,5434,10617
<class,3호선,압구정,13301,13611,26912
<class,3호선,신사,13868,13659,27527
<class,3호선,잠원,2530,2547,5077
<class,3호선,고속터미널,38639,35327,73966
<class,3호선,교대,3898,2439,6337
<class,3호선,남부터미널,13588,14266,27854
<class,3호선,양재,12297,14344,26641
<class,3호선,매봉,4004,3903,7907
<class,3호선,도곡,2009,2244,4253
<class,3호선,대치,4573,4223,8796
<class,3호선,학여울,2246,2432,4678
<class,3호선,대청,3716,3630,7346
<class,3호선,일원,2926,3097,6023
<class,3호선,수서,9556,9524,19080
<class,3호선,가락시장,3574,3879,7453
<class,3호선,경찰병원,2675,2729,5404
<class,3호선,오금,2649,2514,5163
<class,4호선,수유,18652,18119,36771
<class,4호선,미아,7543,7155,14698
<class,4호선,미아사거리,15227,14611,29838
<class,4호선,길음,9269,9057,18326
<class,4호선,성신여대입구,11721,11393,23114
<class,4호선,한성대입구,7443,7577,15020
<class,4호선,혜화,19556,20006,39562
<class,4호선,동대문,6965,7312,14277
<class,4호선,동대문역사문화공원,7936,7757,15693
<class,4호선,충무로,8171,8292,16463
<class,4호선,명동,9788,10164,19952
<class,4호선,회현,7720,8144,15864
<class,4호선,서울역,3735,8023,11758
<class,4호선,숙대입구,6465,6182,12647
<class,4호선,삼각지,1868,2577,4445
<class,4호선,신용산,6891,6941,13832
<class,4호선,이촌,4648,5313,9961
<class,4호선,동작,2070,2036,4106
<class,4호선,총신대입구,9643,10574,20217
<class,4호선,사당,13468,12683,26151
<class,4호선,남태령,571,477,1048
<class,4호선,당고개,7434,7065,14499
<class,4호선,상계,9795,9289,19084
<class,4호선,노원,10811,11682,22493
<class,4호선,창동,14016,14647,28663
<class,4호선,쌍문,14796,13392,28188
<class,5호선,방화,3501,3446,6947
<class,5호선,개화산,2694,2785,5479
<class,5호선,김포공항,6900,6400,13300
<class,5호선,송정,3644,3761,7405
<class,5호선,마곡,3304,3500,6804
<class,5호선,발산,8345,8832,17177
<class,5호선,우장산,6282,6543,12825
<class,5호선,화곡,13651,12961,26612
<class,5호선,까치산,14990,14800,29790
<class,5호선,신정,6018,5509,11527
<class,5호선,목동,7586,7728,15314
<class,5호선,오목교,11730,12005,23735
<class,5호선,양평,2503,2525,5028
<class,5호선,영등포구청,1313,1280,2593
<class,5호선,영등포시장,4155,4580,8735
<class,5호선,신길,1783,1988,3771
<class,5호선,여의도,8459,8204,16663
<class,5호선,여의나루,17438,18527,35965
<class,5호선,마포,4624,4530,9154
<class,5호선,공덕,4380,4405,8785
<class,5호선,애오개,2577,2523,5100
<class,5호선,충정로,1407,1355,2762
<class,5호선,서대문,4527,4471,8998
<class,5호선,광화문,10483,10315,20798
<class,5호선,종로3가,8286,7529,15815
<class,5호선,을지로4가,1396,1480,2876
<class,5호선,동대문역사문화공원,633,714,1347
<class,5호선,청구,1699,1517,3216
<class,5호선,신금호,2837,3078,5915
<class,5호선,행당,3785,3462,7247
<class,5호선,왕십리,2377,2680,5057
<class,5호선,마장,2677,2557,5234
<class,5호선,답십리,6913,6481,13394
<class,5호선,장한평,7043,6978,14021
<class,5호선,군자,5680,6224,11904
<class,5호선,아차산,11102,11168,22270
<class,5호선,광나루,7438,7319,14757
<class,5호선,천호,12153,11336,23489
<class,5호선,강동,8024,7903,15927
<class,5호선,길동,4022,4182,8204
<class,5호선,굽은다리,5014,4743,9757
<class,5호선,명일,4465,4524,8989
<class,5호선,고덕,4078,4170,8248
<class,5호선,상일동,6783,6607,13390
<class,5호선,둔촌동,4340,4519,8859
<class,5호선,올림픽공원,2226,2046,4272
<class,5호선,방이,3556,3423,6979
<class,5호선,오금,1449,1357,2806
<class,5호선,개롱,2956,3274,6230
<class,5호선,거여,3484,3462,6946
<class,5호선,마천,3266,3541,6807
<class,5호선,강일,1748,1697,3445
<class,5호선,미사,7878,7895,15773
<class,5호선,하남풍산,2033,1978,4011
<class,5호선,하남시청,3182,3074,6256
<class,5호선,하남검단산,4766,4824,9590
<class,6호선,응암,8944,9112,18056
<class,6호선,역촌,1809,2178,3987
<class,6호선,불광,3066,2842,5908
<class,6호선,독바위,1521,1928,3449
<class,6호선,구산,3654,2786,6440
<class,6호선,새절,6264,6208,12472
<class,6호선,증산,5366,5537,10903
<class,6호선,디지털미디어시티,4875,5197,10072
<class,6호선,월드컵경기장,4421,4365,8786
<class,6호선,마포구청,6619,6196,12815
<class,6호선,망원,9315,10289,19604
<class,6호선,합정,8971,7743,16714
<class,6호선,상수,5353,6054,11407
<class,6호선,광흥창,3900,3814,7714
<class,6호선,대흥,3406,3415,6821
<class,6호선,공덕,6432,6219,12651
<class,6호선,효창공원앞,3059,2876,5935
<class,6호선,삼각지,3327,2383,5710
<class,6호선,녹사평,4139,3994,8133
<class,6호선,이태원,8640,8254,16894
<class,6호선,한강진,6168,7278,13446
<class,6호선,버티고개,1116,1230,2346
<class,6호선,약수,1499,1633,3132
<class,6호선,청구,1603,1603,3206
<class,6호선,신당,3782,4339,8121
<class,6호선,동묘앞,6630,6448,13078
<class,6호선,창신,1644,1449,3093
<class,6호선,보문,3863,3687,7550
<class,6호선,안암,4851,5220,10071
<class,6호선,고려대,3865,3935,7800
<class,6호선,월곡,5212,5273,10485
<class,6호선,상월곡,3095,2846,5941
<class,6호선,돌곶이,4599,4334,8933
<class,6호선,석계,6166,6307,12473
<class,6호선,태릉입구,2822,3108,5930
<class,6호선,화랑대,4665,4146,8811
<class,6호선,봉화산,3635,3498,7133
<class,7호선,장암,1484,1048,2532
<class,7호선,도봉산,5918,8537,14455
<class,7호선,수락산,8402,8270,16672
<class,7호선,마들,5629,5276,10905
<class,7호선,노원,10323,10557,20880
<class,7호선,중계,6454,6024,12478
<class,7호선,하계,8472,8129,16601
<class,7호선,공릉,6285,6437,12722
<class,7호선,태릉입구,4819,4575,9394
<class,7호선,먹골,5093,4960,10053
<class,7호선,중화,5554,5469,11023
<class,7호선,상봉,9351,8830,18181
<class,7호선,면목,7739,7645,15384
<class,7호선,사가정,8911,8749,17660
<class,7호선,용마산,3180,3584,6764
<class,7호선,중곡,4855,4654,9509
<class,7호선,군자,7234,5751,12985
<class,7호선,어린이대공원,7937,8143,16080
<class,7호선,건대입구,7644,8123,15767
<class,7호선,뚝섬유원지,12145,11386,23531
<class,7호선,청담,6225,6694,12919
<class,7호선,강남구청,5175,5578,10753
<class,7호선,학동,4967,5463,10430
<class,7호선,논현,6054,6511,12565
<class,7호선,반포,2827,2917,5744
<class,7호선,고속터미널,12260,7709,19969
<class,7호선,내방,4742,4852,9594
<class,7호선,이수,7641,7275,14916
<class,7호선,춘의,3285,3015,6300
<class,7호선,남성,5039,5028,10067
<class,7호선,숭실대입구,5454,5734,11188
<class,7호선,상도,5042,5132,10174
<class,7호선,장승배기,4433,4499,8932
<class,7호선,신대방삼거리,7450,7369,14819
<class,7호선,보라매,4757,4631,9388
<class,7호선,신풍,5896,5663,11559
<class,7호선,대림,6461,5824,12285
<class,7호선,남구로,6470,6075,12545
<class,7호선,가산디지털단지,10803,9926,20729
<class,7호선,철산,9980,10150,20130
<class,7호선,광명사거리,11609,11406,23015
<class,7호선,천왕,4647,4488,9135
<class,7호선,온수,3710,3757,7467
<class,7호선,까치울,4178,4081,8259
<class,7호선,부천종합운동장,2437,2291,4728
<class,7호선,신중동,6270,6115,12385
<class,7호선,부천시청,6323,6043,12366
<class,7호선,상동,6512,6162,12674
<class,7호선,삼산체육관,2383,2238,4621
<class,7호선,굴포천,4374,4260,8634
<class,7호선,부평구청,4755,4232,8987
<class,8호선,암사,8438,7927,16365
<class,8호선,천호,8391,9633,18024
<class,8호선,강동구청,4136,4305,8441
<class,8호선,몽촌토성,3171,3227,6398
<class,8호선,잠실,9006,9935,18941
<class,8호선,석촌,3856,4769,8625
<class,8호선,송파,3303,3492,6795
<class,8호선,가락시장,2999,3819,6818
<class,8호선,문정,5135,5324,10459
<class,8호선,장지,8525,8549,17074
<class,8호선,복정,4754,4549,9303
<class,8호선,산성,3617,3664,7281
<class,8호선,남한산성입구,6417,6094,12511
<class,8호선,단대오거리,5040,5134,10174
<class,8호선,신흥,2569,2806,5375
<class,8호선,수진,2714,2477,5191
<class,8호선,모란,2445,2098,4543
<class,9호선,개화,1205,997,2202
<class,9호선,김포공항,7279,10645,17924
<class,9호선,공항시장,1593,1705,3298
<class,9호선,신방화,3083,3154,6237
<class,9호선,마곡나루,5635,5749,11384
<class,9호선,양천향교,3919,4066,7985
<class,9호선,가양,9320,9472,18792
<class,9호선,증미,2937,2929,5866
<class,9호선,염창,7871,7932,15803
<class,9호선,신목동,1809,1594,3403
<class,9호선,선유도,2951,3080,6031
<class,9호선,당산,8141,7958,16099
<class,9호선,국회의사당,4418,4259,8677
<class,9호선,여의도,9228,8331,17559
<class,9호선,샛강,1721,1685,3406
<class,9호선,노량진,13564,14536,28100
<class,9호선,노들,2468,2214,4682
<class,9호선,흑석,3784,4008,7792
<class,9호선,동작,1159,1000,2159
<class,9호선,구반포,1203,1217,2420
<class,9호선,신반포,1659,1749,3408
<class,9호선,고속터미널,10100,13399,23499
<class,9호선,사평,1207,1218,2425
<class,9호선,신논현,14592,14175,28767
<class,9호선2~3단계,언주,2982,2840,5822
<class,9호선2~3단계,선정릉,2810,3166,5976
<class,9호선2~3단계,삼성중앙,1678,1826,3504
<class,9호선2~3단계,봉은사,6625,6678,13303
<class,9호선2~3단계,종합운동장,2071,1883,3954
<class,9호선2~3단계,삼전,3244,3122,6366
<class,9호선2~3단계,석촌고분,2845,2788,5633
<class,9호선2~3단계,석촌,4251,3803,8054
<class,9호선2~3단계,송파나루,2792,2961,5753
<class,9호선2~3단계,한성백제,1427,1207,2634
<class,9호선2~3단계,올림픽공원,3228,3299,6527
<class,9호선2~3단계,둔촌오륜,422,469,891
<class,9호선2~3단계,중앙보훈병원,3227,3023,6250
<class,경강선,판교,2171,2003,4174
<class,경강선,이매,612,624,1236
<class,경강선,삼동,957,978,1935
<class,경강선,경기광주,3504,3502,7006
<class,경강선,초월,1569,1510,3079
<class,경강선,곤지암,1418,1648,3066
<class,경강선,신둔도예촌,833,761,1594
<class,경강선,이천,1957,2034,3991
<class,경강선,부발,1230,1765,2995
<class,경강선,세종대왕릉,282,245,527
<class,경강선,여주,2040,1912,3952
<class,경부선,서울역,6636,1332,7968
<class,경부선,남영,4206,4488,8694
<class,경부선,용산,28520,25557,54077
<class,경부선,노량진,5637,5408,11045
<class,경부선,대방,5625,6021,11646
<class,경부선,영등포,29346,28259,57605
<class,경부선,신도림,2210,2309,4519
<class,경부선,신길,4686,4111,8797
<class,경부선,구로,9102,9375,18477
<class,경부선,가산디지털단지,4378,6108,10486
<class,경부선,금천구청,6029,5852,11881
<class,경부선,석수,5055,4974,10029
<class,경부선,관악,4705,4305,9010
<class,경부선,안양,13166,12753,25919
<class,경부선,명학,3333,3396,6729
<class,경부선,금정,13016,13262,26278
<class,경부선,군포,2953,2742,5695
<class,경부선,의왕,4166,4165,8331
<class,경부선,성균관대,7222,7681,14903
<class,경부선,화서,3702,3545,7247
<class,경부선,수원,32562,31524,64086
<class,경부선,독산,5671,5782,11453
<class,경부선,세류,1833,1879,3712
<class,경부선,병점,8622,9535,18157
<class,경부선,세마,1547,1411,2958
<class,경부선,오산대,2143,2125,4268
<class,경부선,오산,7222,7815,15037
<class,경부선,진위,762,805,1567
<class,경부선,송탄,3316,3865,7181
<class,경부선,서정리,3967,5651,9618
<class,경부선,지제,2187,2004,4191
<class,경부선,평택,10529,11624,22153
<class,경부선,성환,2236,2740,4976
<class,경부선,직산,523,601,1124
<class,경부선,두정,4254,4649,8903
<class,경부선,천안,5831,5433,11264
<class,경부선,당정,2880,2915,5795
<class,경부선,서동탄,757,774,1531
<class,경부선,광명,2398,1659,4057
<class,경원선,이촌,2483,1874,4357
<class,경원선,서빙고,1287,1242,2529
<class,경원선,한남,1984,1904,3888
<class,경원선,옥수,58,30,88
<class,경원선,응봉,1283,1194,2477
<class,경원선,왕십리,8606,10048,18654
<class,경원선,청량리,13184,12667,25851
<class,경원선,외대앞,4497,4509,9006
<class,경원선,신이문,4698,4388,9086
<class,경원선,석계,4636,5085,9721
<class,경원선,광운대,4192,4485,8677
<class,경원선,월계,3573,3455,7028
<class,경원선,녹천,2587,2248,4835
<class,경원선,방학,5648,5511,11159
<class,경원선,도봉,3424,3168,6592
<class,경원선,도봉산,9595,6999,16594
<class,경원선,망월사,4193,4339,8532
<class,경원선,회룡,7180,7173,14353
<class,경원선,의정부,13017,13057,26074
<class,경원선,가능,3751,3476,7227
<class,경원선,녹양,2613,2475,5088
<class,경원선,양주,4921,4898,9819
<class,경원선,덕계,1630,1675,3305
<class,경원선,덕정,3327,3567,6894
<class,경원선,지행,4173,4164,8337
<class,경원선,동두천중앙,2031,1924,3955
<class,경원선,보산,1314,1535,2849
<class,경원선,동두천,1386,2013,3399
<class,경원선,소요산,4670,3857,8527
<class,경의선,서울역,970,990,1960
<class,경의선,신촌,276,294,570
<class,경의선,효창공원앞,1227,1427,2654
<class,경의선,공덕,1572,1359,2931
<class,경의선,서강대,1212,1236,2448
<class,경의선,홍대입구,1468,1747,3215
<class,경의선,가좌,2752,2760,5512
<class,경의선,디지털미디어시티,1349,1196,2545
<class,경의선,수색,861,973,1834
<class,경의선,화전,823,897,1720
<class,경의선,강매,1566,1488,3054
<class,경의선,행신,4167,3993,8160
<class,경의선,능곡,2224,2245,4469
<class,경의선,곡산,325,328,653
<class,경의선,백마,3311,3164,6475
<class,경의선,풍산,3418,3167,6585
<class,경의선,일산,4441,4361,8802
<class,경의선,탄현,3976,3831,7807
<class,경의선,야당,3935,3623,7558
<class,경의선,운정,3390,3300,6690
<class,경의선,금릉,2699,2660,5359
<class,경의선,금촌,4060,4329,8389
<class,경의선,월롱,789,1371,2160
<class,경의선,파주,701,642,1343
<class,경의선,문산,3424,3491,6915
<class,경의선,임진강,70,59,129
<class,경인선,개봉,11203,11173,22376
<class,경인선,오류동,6855,6561,13416
<class,경인선,역곡,13853,13763,27616
<class,경인선,부천,21883,21326,43209
<class,경인선,송내,12734,12480,25214
<class,경인선,부평,23207,23188,46395
<class,경인선,백운,3964,3941,7905
<class,경인선,동암,9394,9223,18617
<class,경인선,주안,11197,9856,21053
<class,경인선,제물포,5180,5135,10315
<class,경인선,동인천,9102,8826,17928
<class,경인선,인천,4585,3554,8139
<class,경인선,구일,3479,3387,6866
<class,경인선,소사,5582,5363,10945
<class,경인선,부개,4559,4244,8803
<class,경인선,간석,3154,2972,6126
<class,경인선,도원,2189,2192,4381
<class,경인선,온수,3483,3423,6906
<class,경인선,중동,4546,4305,8851
<class,경인선,도화,2317,2201,4518
<class,경춘선,신내,821,916,1737
<class,경춘선,갈매,1438,1243,2681
<class,경춘선,별내,1728,1640,3368
<class,경춘선,퇴계원,2051,2011,4062
<class,경춘선,사릉,1842,1808,3650
<class,경춘선,금곡,936,924,1860
<class,경춘선,평내호평,3651,3535,7186
<class,경춘선,천마산,1182,1130,2312
<class,경춘선,마석,2987,2892,5879
<class,경춘선,대성리,765,658,1423
<class,경춘선,청평,1821,1574,3395
<class,경춘선,상천,661,481,1142
<class,경춘선,가평,2201,1811,4012
<class,경춘선,굴봉산,396,366,762
<class,경춘선,백양리,140,182,322
<class,경춘선,강촌,968,758,1726
<class,경춘선,김유정,629,630,1259
<class,경춘선,남춘천,2721,3096,5817
<class,경춘선,춘천,1865,1620,3485
<class,공항철도 1호선,서울역,6575,5974,12549
<class,공항철도 1호선,공덕,1072,1412,2484
<class,공항철도 1호선,홍대입구,9543,8682,18225
<class,공항철도 1호선,디지털미디어시티,3293,3295,6588
<class,공항철도 1호선,마곡나루,2391,2551,4942
<class,공항철도 1호선,김포공항,10870,5329,16199
<class,공항철도 1호선,계양,4704,4467,9171
<class,공항철도 1호선,검암,3474,3665,7139
<class,공항철도 1호선,청라국제도시,3069,2940,6009
<class,공항철도 1호선,운서,4669,5079,9748
<class,공항철도 1호선,공항화물청사,1010,1073,2083
<class,공항철도 1호선,인천공항1터미널,2796,2861,5657
<class,공항철도 1호선,인천공항2터미널,1463,1452,2915
<class,공항철도 1호선,영종,2299,2202,4501
<class,과천선,선바위,3453,3307,6760
<class,과천선,경마공원,899,887,1786
<class,과천선,대공원,6549,6631,13180
<class,과천선,과천,3064,2900,5964
<class,과천선,정부과천청사,3968,4071,8039
<class,과천선,인덕원,10498,10314,20812
<class,과천선,평촌,5710,5630,11340
<class,과천선,범계,13827,13439,27266
<class,분당선,선릉,2656,3884,6540
<class,분당선,한티,6580,6644,13224
<class,분당선,도곡,2285,2277,4562
<class,분당선,구룡,741,828,1569
<class,분당선,개포동,1733,1749,3482
<class,분당선,대모산입구,1605,1530,3135
<class,분당선,수서,7972,7505,15477
<class,분당선,수원,5854,4806,10660
<class,분당선,서울숲,8391,9127,17518
<class,분당선,압구정로데오,10071,11143,21214
<class,분당선,강남구청,2821,3412,6233
<class,분당선,선정릉,2073,2226,4299
<class,분당선,가천대,3656,4469,8125
<class,분당선,태평,7515,7126,14641
<class,분당선,모란,10656,10477,21133
<class,분당선,야탑,12007,12406,24413
<class,분당선,서현,12846,12884,25730
<class,분당선,수내,5370,5258,10628
<class,분당선,정자,7073,7267,14340
<class,분당선,미금,6479,7039,13518
<class,분당선,오리,5093,4393,9486
<class,분당선,이매,2958,2915,5873
<class,분당선,보정,1036,985,2021
<class,분당선,죽전,7735,8724,16459
<class,분당선,구성,2349,2376,4725
<class,분당선,신갈,1830,1894,3724
<class,분당선,기흥,4620,4555,9175
<class,분당선,상갈,2804,2826,5630
<class,분당선,청명,1866,1931,3797
<class,분당선,영통,4300,4471,8771
<class,분당선,망포,5862,6087,11949
<class,분당선,매탄권선,2336,2362,4698
<class,분당선,수원시청,6914,6861,13775
<class,분당선,매교,1406,1418,2824
<class,수인선,고색,1361,1489,2850
<class,수인선,오목천,1281,1212,2493
<class,수인선,어천,498,574,1072
<class,수인선,야목,157,141,298
<class,수인선,사리,2349,2062,4411
<class,수인선,달월,57,77,134
<class,수인선,월곶,1618,1593,3211
<class,수인선,소래포구,5101,5013,10114
<class,수인선,인천논현,3003,3085,6088
<class,수인선,호구포,1799,1875,3674
<class,수인선,남동인더스파크,563,620,1183
<class,수인선,원인재,2817,2952,5769
<class,수인선,연수,2829,2748,5577
<class,수인선,송도,1594,1532,3126
<class,수인선,인하대,3130,3139,6269
<class,수인선,숭의,2097,1871,3968
<class,수인선,신포,1156,1118,2274
<class,수인선,인천,1205,1853,3058
<class,안산선,산본,8193,8643,16836
<class,안산선,대야미,3203,2816,6019
<class,안산선,반월,2411,2374,4785
<class,안산선,상록수,8729,8609,17338
<class,안산선,한대앞,5147,5091,10238
<class,안산선,중앙,11240,11073,22313
<class,안산선,고잔,4166,3984,8150
<class,안산선,초지,2171,2167,4338
<class,안산선,안산,9781,8663,18444
<class,안산선,신길온천,1127,1051,2178
<class,안산선,정왕,4892,5637,10529
<class,안산선,수리산,2164,2425,4589
<class,우이신설선,북한산우이,3321,3389,6710
<class,우이신설선,솔밭공원,1399,1309,2708
<class,우이신설선,4.19민주묘지,2049,1805,3854
<class,우이신설선,가오리,2194,2060,4254
<class,우이신설선,화계,2056,1799,3855
<class,우이신설선,삼양,1230,1276,2506
<class,우이신설선,삼양사거리,1415,1391,2806
<class,우이신설선,솔샘,2534,2431,4965
<class,우이신설선,북한산보국문,3594,3342,6936
<class,우이신설선,정릉,2588,2268,4856
<class,우이신설선,성신여대입구,1969,2417,4386
<class,우이신설선,보문,850,878,1728
<class,우이신설선,신설동,1166,1156,2322
<class,일산선,원흥,4990,4739,9729
<class,일산선,지축,1,0,1
<class,일산선,삼송,10133,10009,20142
<class,일산선,원당,6101,5843,11944
<class,일산선,화정,9170,9448,18618
<class,일산선,대곡,1107,892,1999
<class,일산선,백석,5348,5378,10726
<class,일산선,마두,3344,3287,6631
<class,일산선,정발산,5575,5404,10979
<class,일산선,주엽,4286,4127,8413
<class,일산선,대화,5984,5397,11381
<class,장항선,봉명,496,520,1016
<class,장항선,쌍용,1113,1217,2330
<class,장항선,아산,2968,2058,5026
<class,장항선,배방,716,887,1603
<class,장항선,온양온천,3203,3079,6282
<class,장항선,신창,962,1337,2299
<class,중앙선,회기,14700,14941,29641
<class,중앙선,중랑,3266,3264,6530
<class,1호선,시청,6893,6599,13492
<class,9호선,등촌,4927,5056,9983
<class,안산선,오이도,6042,6069,12111
<class,중앙선,상봉,4265,4067,8332
<class,중앙선,망우,4690,4805,9495
<class,중앙선,양원,811,882,1693
<class,중앙선,구리,7614,7990,15604
<class,중앙선,도농,4879,4886,9765
<class,중앙선,양정,565,473,1038
<class,중앙선,덕소,3505,3474,6979
<class,중앙선,도심,1259,1084,2343
<class,중앙선,팔당,1668,2013,3681
<class,중앙선,운길산,1851,1612,3463
<class,중앙선,양수,2142,1974,4116
<class,중앙선,신원,383,232,615
<class,중앙선,국수,739,647,1386
<class,분당선,이매,3534,3440,6974
<class,분당선,보정,1391,1239,2630
<class,분당선,죽전,8535,9589,18124
<class,분당선,구성,2597,2782,5379
<class,분당선,신갈,2324,2388,4712
<class,분당선,기흥,5623,5355,10978
<class,분당선,상갈,3487,3529,7016
<class,분당선,청명,2293,2176,4469
<class,분당선,영통,5625,5410,11035
<class,분당선,망포,7694,7093,14787
<class,분당선,매탄권선,3001,2927,5928
<class,분당선,수원시청,9027,9410,18437
<class,분당선,매교,1841,1840,3681
<class,수인선,고색,1924,1950,3874
<class,수인선,오목천,1617,1422,3039
<class,수인선,어천,598,497,1095
<class,수인선,야목,199,177,376
<class,수인선,사리,2906,2541,5447
<class,수인선,달월,57,58,115
<class,수인선,월곶,1908,1848,3756
<class,수인선,소래포구,4639,4716,9355
<class,수인선,인천논현,3856,4001,7857
<class,수인선,호구포,2330,2217,4547
<class,수인선,남동인더스파크,953,869,1822
<class,수인선,원인재,3140,3348,6488
<class,수인선,연수,3178,3285,6463
<class,수인선,송도,1791,1831,3622
<class,수인선,인하대,3726,3508,7234
<class,수인선,숭의,2383,2243,4626
<class,수인선,신포,1131,1203,2334
<class,수인선,인천,1133,1875,3008
<class,안산선,산본,10335,11358,21693
<class,안산선,대야미,3403,2974,6377
<class,안산선,반월,3002,2883,5885
<class,안산선,상록수,11163,11277,22440
<class,안산선,한대앞,6219,6285,12504
<class,안산선,중앙,12876,13794,26670
<class,안산선,고잔,5264,5289,10553
<class,안산선,초지,2632,2819,5451
<class,안산선,안산,9137,9290,18427
<class,안산선,신길온천,1254,1260,2514
<class,안산선,정왕,5951,5970,11921
<class,안산선,오이도,6483,6553,13036
<class,안산선,수리산,2541,2258,4799
<class,우이신설선,북한산우이,2775,2831,5606
<class,우이신설선,솔밭공원,1575,1539,3114
<class,우이신설선,4.19민주묘지,2063,1913,3976
<class,우이신설선,가오리,2639,2613,5252
<class,우이신설선,화계,2154,2051,4205
<class,우이신설선,삼양,1443,1498,2941
<class,우이신설선,삼양사거리,1684,1661,3345
<class,우이신설선,솔샘,3196,2999,6195
<class,우이신설선,북한산보국문,4351,3782,8133
<class,우이신설선,정릉,3229,2771,6000
<class,우이신설선,성신여대입구,2404,2766,5170
<class,우이신설선,보문,1005,1054,2059
<class,우이신설선,신설동,1322,1214,2536
<class,일산선,원흥,6319,5964,12283
<class,일산선,삼송,12308,12120,24428
<class,일산선,원당,7360,7177,14537
<class,일산선,화정,10939,11463,22402
<class,일산선,대곡,1177,973,2150
<class,일산선,백석,6369,6562,12931
<class,일산선,마두,4271,4287,8558
<class,일산선,정발산,5406,5494,10900
<class,일산선,주엽,5445,5589,11034
<class,일산선,대화,8323,7551,15874
<class,장항선,봉명,713,672,1385
<class,장항선,쌍용,1418,1260,2678
<class,장항선,아산,2384,2304,4688
<class,장항선,배방,793,765,1558
<class,장항선,온양온천,3151,3348,6499
<class,장항선,신창,1150,1032,2182
<class,중앙선,회기,17613,16353,33966
<class,중앙선,중랑,4085,3966,8051
<class,중앙선,상봉,4621,4659,9280
<class,중앙선,망우,5617,5608,11225
<class,중앙선,양원,1041,1051,2092
<class,중앙선,구리,8996,9349,18345
<class,중앙선,도농,5628,5613,11241
<class,중앙선,양정,580,522,1102
<class,중앙선,덕소,3836,4039,7875
<class,중앙선,도심,1380,1262,2642
<class,중앙선,팔당,1243,1283,2526
<class,중앙선,운길산,1015,1022,2037
<class,중앙선,양수,1899,2013,3912
<class,중앙선,신원,271,205,476
<class,중앙선,국수,613,710,1323
<class,중앙선,아신,608,635,1243
<class,중앙선,오빈,260,313,573
<class,중앙선,양평,3329,3652,6981
<class,중앙선,원덕,404,471,875
<class,중앙선,용문,1924,2431,4355
<class,중앙선,지평,55,85,140
<class,5호선,신길,2105,2110,4215
<class,과천선,선바위,4312,3981,8293
<class,1호선,서울역,24691,26067,50758
<class,1호선,동묘앞,10080,10197,20277
<class,1호선,시청,8022,8383,16405
<class,1호선,종각,14115,13164,27279
<class,1호선,종로3가,16577,15871,32448
<class,1호선,종로5가,13783,13619,27402
<class,1호선,동대문,9730,8876,18606
<class,1호선,신설동,8313,7849,16162
<class,1호선,제기동,12614,12608,25222
<class,1호선,청량리,15889,16151,32040
<class,2호선,시청,6343,5138,11481
<class,2호선,을지로입구,15586,15525,31111
<class,2호선,을지로3가,7646,7680,15326
<class,2호선,을지로4가,5526,5587,11113
<class,2호선,동대문역사문화공원,8367,8483,16850
<class,2호선,신당,9388,9545,18933
<class,2호선,상왕십리,8300,7719,16019
<class,2호선,왕십리,11096,8932,20028
<class,2호선,한양대,4239,3956,8195
<class,2호선,뚝섬,11069,11108,22177
<class,2호선,성수,13643,15297,28940
<class,2호선,건대입구,28033,28751,56784
<class,2호선,구의,13839,13427,27266
<class,2호선,강변,21478,24254,45732
<class,2호선,잠실나루,6138,6104,12242
<class,2호선,잠실,49192,47232,96424
<class,2호선,잠실새내,13665,14061,27726
<class,2호선,종합운동장,4782,5243,10025
<class,2호선,삼성,21454,21502,42956
<class,2호선,선릉,19438,17034,36472
<class,2호선,역삼,16180,16850,33030
<class,2호선,강남,48809,47951,96760
<class,2호선,교대,14488,16249,30737
<class,2호선,서초,8609,7193,15802
<class,2호선,방배,8499,8811,17310
<class,2호선,사당,22669,25095,47764
<class,2호선,낙성대,18260,16344,34604
<class,2호선,서울대입구,31789,29556,61345
<class,2호선,봉천,14901,13768,28669
<class,2호선,신림,43343,40596,83939
<class,2호선,신대방,17666,16951,34617
<class,2호선,구로디지털단지,29413,28452,57865
<class,2호선,대림,16284,17742,34026
<class,2호선,신도림,33033,32696,65729
<class,2호선,문래,9664,9970,19634
<class,2호선,영등포구청,10017,10170,20187
<class,2호선,당산,10158,11028,21186
<class,2호선,합정,21199,22626,43825
<class,2호선,홍대입구,47947,50371,98318
<class,2호선,신촌,24080,23949,48029
<class,2호선,이대,8432,8288,16720
<class,2호선,아현,6534,6212,12746
<class,2호선,충정로,4608,4670,9278
<class,2호선,용답,1898,1754,3652
<class,2호선,신답,780,840,1620
<class,2호선,신설동,2629,2570,5199
<class,2호선,도림천,695,763,1458
<class,2호선,양천구청,3981,4152,8133
<class,2호선,신정네거리,6318,6478,12796
<class,2호선,용두,1473,1415,2888
<class,3호선,지축,2304,2216,4520
<class,3호선,구파발,12792,12893,25685
<class,3호선,연신내,26340,24868,51208
<class,3호선,불광,11030,12168,23198
<class,3호선,녹번,8872,7836,16708
<class,3호선,홍제,11469,10715,22184
<class,3호선,무악재,2331,2291,4622
<class,3호선,독립문,4864,4964,9828
<class,3호선,경복궁,11086,11120,22206
<class,3호선,안국,10244,11357,21601
<class,3호선,종로3가,4595,6238,10833
<class,3호선,을지로3가,3780,4039,7819
<class,3호선,충무로,1,0,1
<class,3호선,동대입구,4429,4664,9093
<class,3호선,약수,7931,7443,15374
<class,3호선,금호,5406,5068,10474
<class,3호선,옥수,6090,6225,12315
<class,3호선,압구정,21850,22445,44295
<class,3호선,신사,20056,20188,40244
<class,3호선,잠원,2897,2784,5681
<class,3호선,고속터미널,40874,45879,86753
<class,3호선,교대,5633,3357,8990
<class,3호선,남부터미널,17897,19471,37368
<class,3호선,양재,17106,18157,35263
<class,3호선,매봉,5006,4873,9879
<class,3호선,도곡,2875,2939,5814
<class,3호선,대치,8491,7533,16024
<class,3호선,학여울,2994,3182,6176
<class,3호선,대청,5013,4503,9516
<class,3호선,일원,4077,4071,8148
<class,3호선,수서,10889,11415,22304
<class,3호선,가락시장,5146,4762,9908
<class,3호선,경찰병원,3245,3142,6387
<class,3호선,오금,3190,3022,6212
<class,4호선,수유,23346,23270,46616
<class,4호선,미아,9864,9360,19224
<class,4호선,미아사거리,19834,19242,39076
<class,4호선,길음,12478,11711,24189
<class,4호선,성신여대입구,14544,13588,28132
<class,4호선,한성대입구,9080,8725,17805
<class,4호선,혜화,20744,20965,41709
<class,4호선,동대문,12093,11718,23811
<class,4호선,동대문역사문화공원,8834,7408,16242
<class,4호선,충무로,10341,10278,20619
<class,4호선,명동,9320,10177,19497
<class,4호선,회현,13733,14714,28447
<class,4호선,서울역,4390,9689,14079
<class,4호선,숙대입구,7248,6842,14090
<class,4호선,삼각지,2322,2811,5133
<class,4호선,신용산,7636,8318,15954
<class,4호선,이촌,4843,5511,10354
<class,4호선,동작,1618,1734,3352
<class,4호선,총신대입구,11974,12978,24952
<class,4호선,사당,15911,13893,29804
<class,4호선,남태령,882,626,1508
<class,4호선,당고개,9051,8525,17576
<class,4호선,상계,12443,11905,24348
<class,4호선,노원,14041,15364,29405
<class,4호선,창동,17084,18083,35167
<class,4호선,쌍문,19323,18025,37348
<class,5호선,방화,4201,4019,8220
<class,5호선,개화산,3296,3319,6615
<class,5호선,김포공항,6862,6939,13801
<class,5호선,송정,4571,4450,9021
<class,5호선,마곡,4458,4438,8896
<class,5호선,발산,11390,11964,23354
<class,5호선,우장산,8519,8667,17186
<class,5호선,화곡,17856,16462,34318
<class,5호선,까치산,19247,18224,37471
<class,5호선,신정,7935,6929,14864
<class,5호선,목동,9950,10124,20074
<class,5호선,오목교,14670,15320,29990
<class,5호선,양평,3175,2959,6134
<class,5호선,영등포구청,1743,1672,3415
<class,5호선,영등포시장,5767,5945,11712
<class,5호선,여의도,9535,9674,19209
<class,5호선,여의나루,10717,12218,22935
<class,5호선,마포,6208,6294,12502
<class,5호선,공덕,5866,5711,11577
<class,5호선,애오개,3208,3066,6274
<class,5호선,충정로,1728,1599,3327
<class,5호선,서대문,5654,5427,11081
<class,5호선,광화문,10727,11015,21742
<class,5호선,종로3가,8663,9048,17711
<class,5호선,을지로4가,2580,2821,5401
<class,5호선,동대문역사문화공원,763,970,1733
<class,5호선,청구,2259,1963,4222
<class,5호선,신금호,3629,3746,7375
<class,5호선,행당,4834,4352,9186
<class,5호선,왕십리,2955,3249,6204
<class,5호선,마장,3316,3296,6612
<class,5호선,답십리,9234,8420,17654
<class,5호선,장한평,9538,9393,18931
<class,5호선,군자,7295,7825,15120
<class,5호선,아차산,11090,11093,22183
<class,5호선,광나루,7879,7536,15415
<class,5호선,천호,14178,13062,27240
<class,5호선,강동,10434,9664,20098
<class,5호선,길동,5253,5394,10647
<class,5호선,굽은다리,6059,5797,11856
<class,5호선,명일,5132,5148,10280
<class,5호선,고덕,5351,5335,10686
<class,5호선,상일동,8232,7803,16035
<class,5호선,둔촌동,5416,5434,10850
<class,5호선,올림픽공원,2442,2120,4562
<class,5호선,방이,4375,4463,8838
<class,5호선,오금,1914,1796,3710
<class,5호선,개롱,3656,3904,7560
<class,5호선,거여,4620,4558,9178
<class,5호선,마천,3972,4013,7985
<class,5호선,강일,1914,1878,3792
<class,5호선,미사,9299,9066,18365
<class,5호선,하남풍산,2262,2306,4568
<class,5호선,하남시청,3671,3656,7327
<class,5호선,하남검단산,3929,4080,8009
<class,6호선,응암,11165,11183,22348
<class,6호선,역촌,2247,2671,4918
<class,6호선,불광,3272,3054,6326
<class,6호선,독바위,1784,1837,3621
<class,6호선,구산,4802,3597,8399
<class,6호선,새절,7902,7411,15313
<class,6호선,증산,6520,6575,13095
<class,6호선,디지털미디어시티,6258,6410,12668
<class,6호선,월드컵경기장,3684,3789,7473
<class,6호선,마포구청,8482,7287,15769
<class,6호선,망원,10624,11426,22050
<class,6호선,합정,9577,8952,18529
<class,6호선,상수,6059,6899,12958
<class,6호선,광흥창,4469,4191,8660
<class,6호선,대흥,4716,4563,9279
<class,6호선,공덕,8153,7831,15984
<class,6호선,효창공원앞,4235,3741,7976
<class,6호선,삼각지,3581,2768,6349
<class,6호선,녹사평,4055,4112,8167
<class,6호선,이태원,9074,9635,18709
<class,6호선,한강진,4869,6036,10905
<class,6호선,버티고개,1363,1346,2709
<class,6호선,약수,2094,2091,4185
<class,6호선,청구,2203,2203,4406
<class,6호선,신당,5365,4391,9756
<class,6호선,동묘앞,7191,6551,13742
<class,6호선,창신,1964,1592,3556
<class,6호선,보문,4658,4033,8691
<class,6호선,안암,5966,5413,11379
<class,6호선,고려대,4911,4542,9453
<class,6호선,월곡,6448,6412,12860
<class,6호선,상월곡,3772,3246,7018
<class,6호선,돌곶이,5437,5219,10656
<class,6호선,석계,7807,7774,15581
<class,6호선,태릉입구,3469,3728,7197
<class,6호선,화랑대,5785,4767,10552
<class,6호선,봉화산,4648,4518,9166
<class,7호선,장암,1331,888,2219
<class,7호선,도봉산,5410,7588,12998
<class,7호선,수락산,8805,8717,17522
<class,7호선,마들,8102,7553,15655
<class,7호선,노원,13877,14545,28422
<class,7호선,중계,8372,7494,15866
<class,7호선,하계,10973,10362,21335
<class,7호선,공릉,7836,7677,15513
<class,7호선,태릉입구,5739,5190,10929
<class,7호선,먹골,6904,6761,13665
<class,7호선,중화,7095,6708,13803
<class,7호선,상봉,11731,11207,22938
<class,7호선,면목,10208,10166,20374
<class,7호선,사가정,11398,11200,22598
<class,7호선,용마산,3896,3876,7772
<class,7호선,중곡,6044,5790,11834
<class,7호선,군자,9600,7191,16791
<class,7호선,어린이대공원,8903,8190,17093
<class,7호선,건대입구,8892,9266,18158
<class,7호선,뚝섬유원지,7607,7629,15236
<class,7호선,청담,10073,10471,20544
<class,7호선,강남구청,8293,8935,17228
<class,7호선,학동,8607,8660,17267
<class,7호선,논현,10372,10722,21094
<class,7호선,반포,3993,3928,7921
<class,7호선,고속터미널,11934,9782,21716
<class,7호선,내방,7070,6980,14050
<class,7호선,이수,10125,9103,19228
<class,7호선,남성,7007,6542,13549
<class,7호선,숭실대입구,7295,7229,14524
<class,7호선,상도,6607,6092,12699
<class,7호선,장승배기,6170,5897,12067
<class,7호선,신대방삼거리,10193,9526,19719
<class,7호선,보라매,5711,5337,11048
<class,7호선,신풍,7441,7233,14674
<class,7호선,대림,6412,6913,13325
<class,7호선,남구로,7938,8491,16429
<class,7호선,가산디지털단지,13281,11922,25203
<class,7호선,철산,13311,13642,26953
<class,7호선,광명사거리,15162,15404,30566
<class,7호선,천왕,6106,5736,11842
<class,7호선,온수,5154,5092,10246
<class,7호선,까치울,4889,4926,9815
<class,7호선,부천종합운동장,3021,2722,5743
<class,7호선,춘의,4662,4388,9050
<class,7호선,신중동,8362,8323,16685
<class,7호선,부천시청,8290,8220,16510
<class,7호선,상동,8607,8811,17418
<class,7호선,삼산체육관,2993,2807,5800
<class,7호선,굴포천,5775,6049,11824
<class,7호선,부평구청,6317,5750,12067
<class,8호선,암사,10819,10199,21018
<class,8호선,천호,10091,12006,22097
<class,8호선,강동구청,5113,5229,10342
<class,8호선,몽촌토성,3339,3366,6705
<class,8호선,잠실,10023,11566,21589
<class,8호선,석촌,4880,5728,10608
<class,8호선,송파,4305,4313,8618
<class,8호선,가락시장,4969,4873,9842
<class,8호선,문정,7145,7171,14316
<class,8호선,장지,10235,9515,19750
<class,8호선,복정,5660,4937,10597
<class,8호선,산성,3984,4028,8012
<class,8호선,남한산성입구,8105,7373,15478
<class,8호선,단대오거리,6749,6374,13123
<class,8호선,신흥,3259,3388,6647
<class,8호선,수진,3588,3245,6833
<class,8호선,모란,3023,2533,5556
<class,9호선,개화,1280,1054,2334
<class,9호선,김포공항,7171,11597,18768
<class,9호선,공항시장,1878,2062,3940
<class,9호선,신방화,4111,3912,8023
<class,9호선,마곡나루,6387,6196,12583
<class,9호선,양천향교,5063,4827,9890
<class,9호선,가양,12360,11685,24045
<class,9호선,증미,3606,3617,7223
<class,9호선,등촌,6368,5986,12354
<class,9호선,염창,9964,9311,19275
<class,9호선,신목동,2068,1730,3798
<class,9호선,선유도,3279,3121,6400
<class,9호선,당산,10119,9353,19472
<class,9호선,국회의사당,3126,3190,6316
<class,9호선,여의도,9743,9084,18827
<class,9호선,샛강,2202,2284,4486
<class,9호선,노량진,18187,17586,35773
<class,9호선,노들,2749,2354,5103
<class,9호선,흑석,4835,4697,9532
<class,9호선,동작,1402,1120,2522
<class,9호선,구반포,1674,1759,3433
<class,9호선,신반포,2107,1941,4048
<class,9호선,고속터미널,10543,15869,26412
<class,9호선,사평,1844,1742,3586
<class,9호선,신논현,20246,19588,39834
<class,9호선2~3단계,언주,4626,4606,9232
<class,9호선2~3단계,선정릉,4158,4385,8543
<class,9호선2~3단계,삼성중앙,2495,2491,4986
<class,9호선2~3단계,봉은사,7598,7583,15181
<class,9호선2~3단계,종합운동장,2772,2407,5179
<class,9호선2~3단계,삼전,4157,3779,7936
<class,9호선2~3단계,석촌고분,3566,3352,6918
<class,9호선2~3단계,석촌,5425,4560,9985
<class,9호선2~3단계,송파나루,3160,3240,6400
<class,9호선2~3단계,한성백제,1386,1213,2599
<class,9호선2~3단계,올림픽공원,3358,3479,6837
<class,9호선2~3단계,둔촌오륜,548,532,1080
<class,9호선2~3단계,중앙보훈병원,3639,3507,7146
<class,경강선,판교,2524,2366,4890
<class,경강선,이매,728,546,1274
<class,경강선,삼동,1314,1251,2565
<class,경강선,경기광주,4260,4342,8602
<class,경강선,초월,1864,1689,3553
<class,경강선,곤지암,1696,1919,3615
<class,경강선,신둔도예촌,864,968,1832
<class,경강선,이천,2243,2519,4762
<class,경강선,부발,1400,1341,2741
<class,경강선,세종대왕릉,239,311,550
<class,경강선,여주,1833,2206,4039
<class,경부선,서울역,4620,1497,6117
<class,경부선,남영,4823,4844,9667
<class,경부선,용산,26750,29444,56194
<class,경부선,노량진,7134,6406,13540
<class,경부선,대방,6909,6795,13704
<class,경부선,영등포,31509,32741,64250
<class,경부선,신도림,2608,2674,5282
<class,경부선,신길,5723,4744,10467
<class,경부선,구로,11781,11913,23694
<class,경부선,가산디지털단지,5462,7251,12713
<class,경부선,금천구청,7366,7370,14736
<class,경부선,석수,5926,5490,11416
<class,경부선,관악,4916,4728,9644
<class,경부선,안양,14973,15396,30369
<class,경부선,명학,4415,4156,8571
<class,경부선,금정,15630,15704,31334
<class,경부선,군포,3925,3699,7624
<class,경부선,의왕,5092,4997,10089
<class,경부선,성균관대,8690,8509,17199
<class,경부선,화서,4335,4476,8811
<class,경부선,수원,31630,33937,65567
<class,경부선,독산,7370,7348,14718
<class,경부선,세류,2209,2152,4361
<class,경부선,병점,10163,10036,20199
<class,경부선,세마,1890,1703,3593
<class,경부선,오산대,2385,2068,4453
<class,경부선,오산,8290,7837,16127
<class,경부선,진위,907,827,1734
<class,경부선,송탄,4409,3911,8320
<class,경부선,서정리,5385,4638,10023
<class,경부선,평택지제,2370,2198,4568
<class,경부선,평택,11411,11258,22669
<class,경부선,성환,2694,2572,5266
<class,경부선,직산,583,594,1177
<class,경부선,두정,4640,4661,9301
<class,경부선,천안,5466,5785,11251
<class,경부선,당정,3542,3464,7006
<class,경부선,서동탄,905,924,1829
<class,경부선,광명,1947,1937,3884
<class,경원선,이촌,2604,1951,4555
<class,경원선,서빙고,1171,1003,2174
<class,경원선,한남,2592,2357,4949
<class,경원선,옥수,33,38,71
<class,경원선,응봉,1204,1018,2222
<class,경원선,왕십리,10013,11266,21279
<class,경원선,청량리,13152,15098,28250
<class,경원선,외대앞,5851,5616,11467
<class,경원선,신이문,5696,5309,11005
<class,경원선,석계,5668,6098,11766
<class,경원선,광운대,5274,5008,10282
<class,경원선,월계,4283,3936,8219
<class,경원선,녹천,3234,2676,5910
<class,경원선,창동,3,0,3
<class,경원선,방학,6692,6573,13265
<class,경원선,도봉,3808,3756,7564
<class,경원선,도봉산,7245,4924,12169
<class,경원선,망월사,4973,5090,10063
<class,경원선,회룡,8173,8234,16407
<class,경원선,의정부,15085,15705,30790
<class,경원선,가능,4632,4490,9122
<class,경원선,녹양,3107,3025,6132
<class,경원선,양주,5437,5590,11027
<class,경원선,덕계,1885,1789,3674
<class,경원선,덕정,3909,3780,7689
<class,경원선,지행,4736,4923,9659
<class,경원선,동두천중앙,2344,2452,4796
<class,경원선,보산,1741,1631,3372
<class,경원선,동두천,1417,1964,3381
<class,경원선,소요산,3308,2908,6216
<class,경의선,서울역,1082,1201,2283
<class,경의선,신촌,299,319,618
<class,경의선,효창공원앞,1551,1655,3206
<class,경의선,공덕,1813,1540,3353
<class,경의선,서강대,1445,1360,2805
<class,경의선,홍대입구,1568,1811,3379
<class,경의선,가좌,3262,3185,6447
<class,경의선,디지털미디어시티,1665,1449,3114
<class,경의선,수색,1219,1204,2423
<class,경의선,화전,988,887,1875
<class,경의선,강매,1711,1561,3272
<class,경의선,행신,4491,4532,9023
<class,경의선,능곡,2453,2373,4826
<class,경의선,곡산,325,371,696
<class,경의선,백마,3921,3698,7619
<class,경의선,풍산,3580,3573,7153
<class,경의선,일산,5741,5774,11515
<class,경의선,탄현,4518,4525,9043
<class,경의선,야당,4573,4506,9079
<class,경의선,운정,4035,4015,8050
<class,경의선,금릉,3171,3123,6294
<class,경의선,금촌,4895,4801,9696
<class,경의선,월롱,1168,1159,2327
<class,경의선,파주,814,655,1469
<class,경의선,문산,3990,4208,8198
<class,경의선,임진강,48,41,89
<class,경인선,개봉,14678,14599,29277
<class,경인선,오류동,8176,7494,15670
<class,경인선,역곡,17829,18067,35896
<class,경인선,부천,25263,26215,51478
<class,경인선,송내,15445,15626,31071
<class,경인선,부평,26057,28207,54264
<class,경인선,백운,5091,5008,10099
<class,경인선,동암,11218,11730,22948
<class,경인선,주안,13994,12476,26470
<class,경인선,제물포,6719,6569,13288
<class,경인선,동인천,9971,9938,19909
<class,경인선,인천,3601,2994,6595
<class,경인선,구일,3797,3688,7485
<class,경인선,소사,6773,6667,13440
<class,경인선,부개,5767,5548,11315
<class,경인선,간석,3898,3828,7726
<class,경인선,도원,1882,1908,3790
<class,경인선,온수,4433,4114,8547
<class,경인선,중동,5815,5652,11467
<class,경인선,도화,2794,2600,5394
<class,경춘선,신내,972,1027,1999
<class,경춘선,갈매,1812,1537,3349
<class,경춘선,별내,2036,1895,3931
<class,경춘선,퇴계원,2347,2269,4616
<class,경춘선,사릉,2072,1983,4055
<class,경춘선,금곡,1033,954,1987
<class,경춘선,평내호평,4069,4107,8176
<class,경춘선,천마산,1207,1227,2434
<class,경춘선,마석,3238,3375,6613
<class,경춘선,대성리,557,517,1074
<class,경춘선,청평,1546,1700,3246
<class,경춘선,상천,313,313,626
<class,경춘선,가평,1594,1888,3482
<class,경춘선,굴봉산,220,242,462
<class,경춘선,백양리,126,111,237
<class,경춘선,강촌,646,669,1315
<class,경춘선,김유정,443,546,989
<class,경춘선,남춘천,2141,2287,4428
<class,경춘선,춘천,1515,1372,2887
<class,공항철도 1호선,서울역,5969,6415,12384
<class,공항철도 1호선,공덕,1211,1594,2805
<class,공항철도 1호선,홍대입구,9165,8679,17844
<class,공항철도 1호선,디지털미디어시티,4468,4103,8571
<class,공항철도 1호선,마곡나루,2649,2785,5434
<class,공항철도 1호선,김포공항,10056,5768,15824
<class,공항철도 1호선,계양,5554,5271,10825
<class,공항철도 1호선,검암,4065,4109,8174
<class,공항철도 1호선,청라국제도시,3251,3282,6533
<class,공항철도 1호선,운서,4908,4771,9679
<class,공항철도 1호선,공항화물청사,1249,1272,2521
<class,공항철도 1호선,인천공항1터미널,2423,2627,5050
<class,공항철도 1호선,인천공항2터미널,1449,1410,2859
<class,공항철도 1호선,영종,2415,2527,4942
<class,과천선,경마공원,974,968,1942
<class,과천선,대공원,3790,3851,7641
<class,과천선,과천,3333,3154,6487
<class,과천선,정부과천청사,4470,4620,9090
<class,과천선,인덕원,12271,12294,24565
<class,과천선,평촌,7253,7209,14462
<class,과천선,범계,16513,16073,32586
<class,분당선,선릉,4292,6312,10604
<class,분당선,한티,10677,10229,20906
<class,분당선,도곡,3287,3062,6349
<class,분당선,구룡,1041,988,2029
<class,분당선,개포동,2200,2210,4410
<class,분당선,대모산입구,2137,1982,4119
<class,분당선,수서,8578,9245,17823
<class,분당선,수원,6413,5337,11750
<class,분당선,서울숲,6317,6413,12730
<class,분당선,압구정로데오,14906,16315,31221
<class,분당선,강남구청,4384,5044,9428
<class,분당선,선정릉,2999,2981,5980
<class,분당선,가천대,4172,4453,8625
<class,분당선,태평,9496,9020,18516
<class,분당선,모란,13621,13361,26982
<class,분당선,야탑,13991,15378,29369
<class,분당선,서현,15338,15370,30708
<class,분당선,수내,7450,7091,14541
<class,분당선,정자,9049,9203,18252
<class,분당선,미금,9306,9662,18968
<class,분당선,오리,6209,5115,11324
<class,1호선,동묘앞,12483,12531,25014
<class,1호선,시청,6548,6877,13425
<class,1호선,종각,11210,9986,21196
<class,1호선,종로3가,12861,11660,24521
<class,1호선,종로5가,8081,8251,16332
<class,1호선,동대문,8922,9653,18575
<class,1호선,신설동,6692,6864,13556
<class,1호선,제기동,8908,9480,18388
<class,1호선,청량리,12620,12275,24895
<class,2호선,시청,5037,4014,9051
<class,2호선,을지로입구,13043,12356,25399
<class,2호선,을지로3가,6617,6283,12900
<class,2호선,을지로4가,2843,2772,5615
<class,2호선,동대문역사문화공원,6706,8135,14841
<class,2호선,신당,7419,7905,15324
<class,2호선,상왕십리,6396,6579,12975
<class,2호선,왕십리,8546,7706,16252
<class,2호선,한양대,2109,2392,4501
<class,2호선,뚝섬,10346,11002,21348
<class,2호선,성수,11546,13223,24769
<class,2호선,건대입구,25773,26377,52150
<class,2호선,구의,10353,10909,21262
<class,2호선,강변,23069,19333,42402
<class,2호선,잠실나루,5019,5162,10181
<class,2호선,잠실,43228,39519,82747
<class,2호선,잠실새내,10404,10886,21290
<class,2호선,종합운동장,5154,5599,10753
<class,2호선,삼성,16159,16091,32250
<class,2호선,선릉,11721,10465,22186
<class,2호선,역삼,10116,11298,21414
<class,2호선,강남,32612,31654,64266
<class,2호선,교대,9968,10994,20962
<class,2호선,서초,9790,9137,18927
<class,중앙선,지평,73,57,130
<class,중앙선,용문,2737,1907,4644
<class,중앙선,원덕,525,381,906
<class,중앙선,양평,2616,1972,4588
<class,중앙선,오빈,244,221,465
<class,중앙선,아신,666,539,1205
<class,중앙선,국수,754,619,1373
<class,중앙선,신원,425,259,684
<class,중앙선,양수,2208,1928,4136
<class,중앙선,운길산,1654,1473,3127
<class,중앙선,팔당,1665,1789,3454
<class,중앙선,도심,1259,1111,2370
<class,중앙선,덕소,3642,3591,7233
<class,중앙선,양정,524,471,995
<class,중앙선,도농,4888,4612,9500
<class,중앙선,구리,7631,7890,15521
<class,중앙선,양원,879,984,1863
<class,중앙선,망우,4686,4595,9281
<class,중앙선,상봉,4240,4135,8375
<class,중앙선,중랑,3321,3357,6678
<class,중앙선,회기,14102,15055,29157
<class,장항선,신창,1124,1407,2531
<class,2호선,방배,6299,6877,13176
<class,2호선,사당,19094,21734,40828
<class,2호선,낙성대,14034,15732,29766
<class,2호선,서울대입구,24911,27517,52428
<class,2호선,봉천,11220,11548,22768
<class,2호선,신림,33222,34750,67972
<class,2호선,신대방,14118,14486,28604
<class,2호선,구로디지털단지,21471,21719,43190
<class,2호선,대림,14153,14470,28623
<class,2호선,신도림,26089,26219,52308
<class,2호선,문래,6896,7401,14297
<class,2호선,영등포구청,7033,7377,14410
<class,2호선,당산,8655,9350,18005
<class,2호선,합정,17873,19468,37341
<class,2호선,홍대입구,44273,45515,89788
<class,2호선,신촌,19402,19935,39337
<class,2호선,이대,6107,7028,13135
<class,2호선,아현,4863,4935,9798
<class,장항선,배방,806,953,1759
<class,장항선,아산,3306,2045,5351
<class,장항선,쌍용,1249,1368,2617
<class,장항선,봉명,542,584,1126
<class,일산선,대화,7441,6826,14267
<class,일산선,주엽,4275,4137,8412
<class,일산선,정발산,5255,5068,10323
<class,일산선,마두,3367,3181,6548
<class,일산선,백석,5409,5278,10687
<class,일산선,대곡,1127,884,2011
<class,일산선,화정,9172,9354,18526
<class,일산선,원당,6208,5873,12081
<class,일산선,삼송,9991,9752,19743
<class,일산선,원흥,5029,4874,9903
<class,우이신설선,신설동,1147,1135,2282
<class,우이신설선,보문,920,975,1895
<class,우이신설선,성신여대입구,2001,2310,4311
<class,우이신설선,정릉,2561,2322,4883
<class,우이신설선,북한산보국문,3649,3455,7104
<class,우이신설선,솔샘,2665,2536,5201
<class,우이신설선,삼양사거리,1492,1452,2944
<class,우이신설선,삼양,1216,1210,2426
<class,우이신설선,화계,2069,1920,3989
<class,우이신설선,가오리,2335,2138,4473
<class,우이신설선,4.19민주묘지,2077,1721,3798
<class,우이신설선,솔밭공원,1360,1293,2653
<class,우이신설선,북한산우이,3387,3721,7108
<class,안산선,수리산,2136,2275,4411
<class,안산선,오이도,6137,5910,12047
<class,안산선,정왕,4639,5576,10215
<class,안산선,신길온천,1121,1015,2136
<class,안산선,안산,9261,8501,17762
<class,안산선,초지,2399,2188,4587
<class,안산선,고잔,4419,4095,8514
<class,안산선,중앙,11386,11237,22623
<class,안산선,한대앞,5317,5071,10388
<class,안산선,상록수,8900,8627,17527
<class,안산선,반월,2578,2454,5032
<class,안산선,대야미,3180,2829,6009
<class,안산선,산본,8362,8854,17216
<class,수인선,인천,1292,1851,3143
<class,수인선,신포,1140,1109,2249
<class,수인선,숭의,1937,1825,3762
<class,수인선,인하대,3150,3210,6360
<class,수인선,송도,1678,1627,3305
<class,수인선,연수,2907,2828,5735
<class,수인선,원인재,2885,2927,5812
<class,수인선,남동인더스파크,583,628,1211
<class,수인선,호구포,1810,1902,3712
<class,수인선,인천논현,2974,3116,6090
<class,수인선,소래포구,5031,4904,9935
<class,수인선,월곶,1604,1531,3135
<class,수인선,달월,65,62,127
<class,수인선,사리,2401,2029,4430
<class,수인선,야목,148,121,269
<class,수인선,어천,524,586,1110
<class,수인선,오목천,1331,1300,2631
<class,수인선,고색,1531,1592,3123
<class,분당선,매교,1374,1382,2756
<class,분당선,수원시청,6734,6952,13686
<class,분당선,매탄권선,2361,2374,4735
<class,분당선,망포,5710,6211,11921
<class,분당선,영통,4082,4412,8494
<class,분당선,청명,1838,1871,3709
<class,분당선,상갈,2903,2884,5787
<class,분당선,기흥,4786,4575,9361
<class,분당선,신갈,1913,1967,3880
<class,분당선,구성,2342,2409,4751
<class,분당선,죽전,7442,8587,16029
<class,분당선,보정,1099,1054,2153
<class,분당선,이매,3088,3205,6293
<class,분당선,오리,5163,4478,9641
<class,분당선,미금,6941,7445,14386
<class,분당선,정자,7023,7390,14413
<class,분당선,수내,5585,5477,11062
<class,분당선,서현,13272,13122,26394
<class,분당선,야탑,12703,12687,25390
<class,분당선,모란,17431,17954,35385
<class,분당선,태평,7731,7656,15387
<class,분당선,가천대,3469,4368,7837
<class,분당선,선정릉,1937,2111,4048
<class,분당선,강남구청,2805,3294,6099
<class,분당선,압구정로데오,9722,10956,20678
<class,분당선,서울숲,7476,8065,15541
<class,분당선,수원,5643,4448,10091
<class,분당선,수서,8931,7712,16643
<class,분당선,대모산입구,1683,1698,3381
<class,분당선,개포동,1990,1952,3942
<class,분당선,구룡,609,740,1349
<class,분당선,도곡,2227,2178,4405
<class,분당선,한티,7608,7474,15082
<class,분당선,선릉,2702,4011,6713
<class,과천선,범계,14093,13344,27437
<class,과천선,평촌,5716,5682,11398
<class,과천선,인덕원,10577,10342,20919
<class,과천선,정부과천청사,4050,4262,8312
<class,과천선,과천,3159,2802,5961
<class,과천선,대공원,5831,5935,11766
<class,과천선,경마공원,889,856,1745
<class,과천선,선바위,3647,3367,7014
<class,공항철도 1호선,영종,2292,2154,4446
<class,공항철도 1호선,인천공항2터미널,1523,1434,2957
<class,공항철도 1호선,인천공항1터미널,2845,2770,5615
<class,공항철도 1호선,공항화물청사,914,1058,1972
<class,공항철도 1호선,운서,4249,4900,9149
<class,공항철도 1호선,청라국제도시,3225,3037,6262
<class,2호선,충정로,3166,3429,6595
<class,공항철도 1호선,검암,3498,3749,7247
<class,공항철도 1호선,계양,4842,4469,9311
<class,공항철도 1호선,김포공항,11828,5531,17359
<class,공항철도 1호선,마곡나루,2376,2711,5087
<class,공항철도 1호선,디지털미디어시티,3209,3268,6477
<class,공항철도 1호선,홍대입구,9324,8928,18252
<class,공항철도 1호선,공덕,1008,1421,2429
<class,공항철도 1호선,서울역,7295,5679,12974
<class,경춘선,춘천,1976,1617,3593
<class,경춘선,남춘천,2277,2414,4691
<class,경춘선,김유정,630,611,1241
<class,경춘선,강촌,912,702,1614
<class,경춘선,백양리,177,160,337
<class,경춘선,굴봉산,267,272,539
<class,경춘선,가평,2132,1613,3745
<class,경춘선,상천,611,421,1032
<class,경춘선,청평,1836,1412,3248
<class,경춘선,대성리,685,593,1278
<class,경춘선,마석,2872,2620,5492
<class,경춘선,천마산,1257,1177,2434
<class,경춘선,평내호평,3622,3535,7157
<class,경춘선,금곡,943,855,1798
<class,경춘선,사릉,1801,1751,3552
<class,경춘선,퇴계원,2094,1988,4082
<class,경춘선,별내,1734,1663,3397
<class,경춘선,갈매,1471,1298,2769
<class,경춘선,신내,879,923,1802
<class,경인선,도화,2339,2165,4504
<class,경인선,중동,4732,4449,9181
<class,경인선,온수,3666,3368,7034
<class,경인선,도원,1686,1713,3399
<class,경인선,간석,3204,2910,6114
<class,경인선,부개,4682,4240,8922
<class,경인선,소사,5711,5333,11044
<class,경인선,구일,3289,3398,6687
<class,경인선,인천,4512,3696,8208
<class,경인선,동인천,9183,8983,18166
<class,경인선,제물포,5581,5357,10938
<class,경인선,주안,11393,10168,21561
<class,경인선,동암,9618,9259,18877
<class,경인선,백운,3920,3804,7724
<class,경인선,부평,22374,22515,44889
<class,경인선,송내,13025,12423,25448
<class,경인선,부천,20588,20360,40948
<class,경인선,역곡,13924,13769,27693
<class,경인선,오류동,6655,6650,13305
<class,경인선,개봉,11350,11167,22517
<class,경의선,임진강,80,83,163
<class,경의선,문산,4148,3902,8050
<class,경의선,파주,731,643,1374
<class,경의선,월롱,834,1442,2276
<class,경의선,금촌,4141,4310,8451
<class,경의선,금릉,2744,2576,5320
<class,경의선,운정,3581,3307,6888
<class,경의선,야당,4122,3924,8046
<class,경의선,탄현,4119,3749,7868
<class,경의선,일산,4793,4333,9126
<class,경의선,풍산,3518,3240,6758
<class,경의선,백마,3381,3188,6569
<class,경의선,곡산,361,370,731
<class,경의선,능곡,2188,2156,4344
<class,경의선,행신,4187,3894,8081
<class,경의선,강매,1493,1325,2818
<class,경의선,화전,810,843,1653
<class,경의선,수색,848,972,1820
<class,경의선,디지털미디어시티,1336,1295,2631
<class,경의선,가좌,2790,2931,5721
<class,경의선,홍대입구,1559,1973,3532
<class,경의선,서강대,1181,1206,2387
<class,경의선,공덕,1425,1350,2775
<class,경의선,효창공원앞,1244,1456,2700
<class,경의선,신촌,233,278,511
<class,경의선,서울역,1020,957,1977
<class,경원선,소요산,4646,3770,8416
<class,2호선,용답,1532,1611,3143
<class,경원선,동두천,1372,1756,3128
<class,경원선,보산,1261,1508,2769
<class,경원선,동두천중앙,2155,1963,4118
<class,경원선,지행,4319,4120,8439
<class,경원선,덕정,3198,3362,6560
<class,경원선,덕계,1693,1512,3205
<class,경원선,양주,4980,4642,9622
<class,경원선,녹양,2788,2612,5400
<class,경원선,가능,3946,3582,7528
<class,경원선,의정부,12993,13233,26226
<class,경원선,회룡,7253,7160,14413
<class,경원선,망월사,4175,4396,8571
<class,경원선,도봉산,9712,6962,16674
<class,경원선,도봉,3477,3233,6710
<class,경원선,방학,5535,5304,10839
<class,경원선,창동,1,0,1
<class,경원선,녹천,2541,2274,4815
<class,경원선,월계,3618,3314,6932
<class,경원선,광운대,4144,4423,8567
<class,경원선,석계,4625,5188,9813
<class,경원선,신이문,4608,4292,8900
<class,경원선,외대앞,4344,4504,8848
<class,경원선,청량리,13153,11925,25078
<class,경원선,왕십리,8131,9508,17639
<class,경원선,응봉,1235,1151,2386
<class,경원선,옥수,91,31,122
<class,경원선,한남,1957,1963,3920
<class,경원선,서빙고,1316,1335,2651
<class,경원선,이촌,2472,1799,4271
<class,경부선,광명,2478,1463,3941
<class,경부선,서동탄,740,725,1465
<class,경부선,당정,3054,2948,6002
<class,경부선,천안,6351,5638,11989
<class,경부선,두정,4562,4908,9470
<class,경부선,직산,565,600,1165
<class,경부선,성환,2274,2818,5092
<class,경부선,평택,11193,11495,22688
<class,경부선,평택지제,2093,1813,3906
<class,경부선,서정리,3907,5361,9268
<class,경부선,송탄,3433,3888,7321
<class,경부선,진위,788,762,1550
<class,경부선,오산,7390,7823,15213
<class,경부선,오산대,2241,2128,4369
<class,경부선,세마,1632,1550,3182
<class,경부선,병점,8744,9789,18533
<class,경부선,세류,1948,1936,3884
<class,경부선,독산,5543,5809,11352
<class,경부선,수원,32101,30891,62992
<class,경부선,화서,3876,3769,7645
<class,경부선,성균관대,7231,8022,15253
<class,경부선,의왕,4301,4215,8516
<class,경부선,군포,2986,2801,5787
<class,경부선,금정,13062,13442,26504
<class,경부선,명학,3260,3307,6567
<class,경부선,안양,13545,12727,26272
<class,경부선,관악,4966,4338,9304
<class,경부선,석수,5301,5264,10565
<class,경부선,금천구청,6082,6090,12172
<class,경부선,가산디지털단지,4232,6147,10379
<class,경부선,구로,9251,9597,18848
<class,경부선,신길,4546,4161,8707
<class,경부선,신도림,2215,2290,4505
<class,경부선,영등포,28283,27290,55573
<class,경부선,대방,5426,5978,11404
<class,경부선,노량진,5179,5041,10220
<class,경부선,용산,29375,24075,53450
<class,경부선,남영,3692,4219,7911
<class,경부선,서울역,7143,1282,8425
<class,경강선,여주,2291,1864,4155
<class,경강선,세종대왕릉,326,269,595
<class,경강선,부발,1291,1732,3023
<class,경강선,이천,2241,2122,4363
<class,경강선,신둔도예촌,939,833,1772
<class,경강선,곤지암,1672,1618,3290
<class,경강선,초월,1598,1558,3156
<class,경강선,경기광주,3608,3550,7158
<class,경강선,삼동,1035,1011,2046
<class,경강선,이매,710,575,1285
<class,경강선,판교,2167,2098,4265
<class,9호선2~3단계,중앙보훈병원,3255,3010,6265
<class,9호선2~3단계,둔촌오륜,419,446,865
<class,9호선2~3단계,올림픽공원,3203,3257,6460
<class,9호선2~3단계,한성백제,1277,1154,2431
<class,9호선2~3단계,송파나루,2608,2985,5593
<class,2호선,신답,668,727,1395
<class,9호선2~3단계,석촌,4231,3885,8116
<class,9호선2~3단계,석촌고분,2621,2835,5456
<class,9호선2~3단계,삼전,3067,3267,6334
<class,9호선2~3단계,종합운동장,2087,1933,4020
<class,9호선2~3단계,봉은사,5958,5995,11953
<class,9호선2~3단계,삼성중앙,1667,1757,3424
<class,9호선2~3단계,선정릉,2673,3204,5877
<class,9호선2~3단계,언주,3022,3126,6148
<class,9호선,신논현,14022,13738,27760
<class,9호선,사평,1226,1322,2548
<class,9호선,고속터미널,11071,12707,23778
<class,9호선,신반포,1518,1655,3173
<class,9호선,구반포,1179,1219,2398
<class,9호선,동작,1206,1038,2244
<class,9호선,흑석,3596,3859,7455
<class,9호선,노들,2459,2205,4664
<class,9호선,노량진,13152,14633,27785
<class,9호선,샛강,1586,1645,3231
<class,9호선,여의도,8202,7579,15781
<class,9호선,국회의사당,3886,3643,7529
<class,9호선,당산,8141,8172,16313
<class,9호선,선유도,2866,3075,5941
<class,9호선,신목동,1768,1512,3280
<class,9호선,염창,7822,8126,15948
<class,9호선,등촌,4659,5029,9688
<class,9호선,증미,2358,2501,4859
<class,9호선,가양,9149,9433,18582
<class,9호선,양천향교,3729,4279,8008
<class,9호선,마곡나루,5081,5343,10424
<class,9호선,신방화,3121,3220,6341
<class,9호선,공항시장,1618,1860,3478
<class,9호선,김포공항,7350,10832,18182
<class,9호선,개화,1102,1044,2146
<class,8호선,모란,4396,3715,8111
<class,8호선,수진,2722,2676,5398
<class,8호선,신흥,2829,2975,5804
<class,8호선,단대오거리,5481,5396,10877
<class,8호선,남한산성입구,6892,6473,13365
<class,8호선,산성,3612,3718,7330
<class,8호선,복정,4851,4632,9483
<class,8호선,장지,8579,8564,17143
<class,8호선,문정,4995,5565,10560
<class,8호선,가락시장,2916,3702,6618
<class,8호선,송파,3252,3411,6663
<class,8호선,석촌,3884,5016,8900
<class,8호선,잠실,8367,9245,17612
<class,8호선,몽촌토성,3005,3063,6068
<class,8호선,강동구청,4096,4325,8421
<class,8호선,천호,8192,9419,17611
<class,8호선,암사,8551,8105,16656
<class,7호선,부평구청,4981,4192,9173
<class,7호선,굴포천,4434,4305,8739
<class,7호선,삼산체육관,2459,2190,4649
<class,7호선,상동,6349,6165,12514
<class,7호선,부천시청,6390,6102,12492
<class,7호선,신중동,6483,6298,12781
<class,7호선,춘의,3317,3066,6383
<class,7호선,부천종합운동장,2371,2106,4477
<class,7호선,까치울,4253,4047,8300
<class,7호선,온수,3866,3932,7798
<class,7호선,천왕,4739,4533,9272
<class,7호선,광명사거리,11779,11572,23351
<class,7호선,철산,10059,10050,20109
<class,7호선,가산디지털단지,10123,9860,19983
<class,7호선,남구로,6602,6469,13071
<class,7호선,대림,6521,6094,12615
<class,7호선,신풍,5702,5518,11220
<class,7호선,보라매,3866,4031,7897
<class,7호선,신대방삼거리,7268,7693,14961
<class,7호선,장승배기,4492,4540,9032
<class,7호선,상도,4870,5227,10097
<class,7호선,숭실대입구,5417,6079,11496
<class,7호선,남성,4976,5228,10204
<class,7호선,이수,7470,7220,14690
<class,7호선,내방,4931,5210,10141
<class,7호선,고속터미널,14915,7546,22461
<class,7호선,반포,2816,2778,5594
<class,7호선,논현,6076,6761,12837
<class,7호선,학동,4926,5328,10254
<class,7호선,강남구청,4986,5473,10459
<class,7호선,청담,5961,6303,12264
<class,7호선,뚝섬유원지,12192,11743,23935
<class,7호선,건대입구,7099,7969,15068
<class,7호선,어린이대공원,8165,8583,16748
<class,7호선,군자,7250,6013,13263
<class,7호선,중곡,4964,4899,9863
<class,7호선,용마산,3319,3669,6988
<class,7호선,사가정,8998,8940,17938
<class,7호선,면목,7750,7644,15394
<class,7호선,상봉,8763,8500,17263
<class,7호선,중화,5755,5567,11322
<class,7호선,먹골,5181,5086,10267
<class,7호선,태릉입구,4803,4625,9428
<class,7호선,공릉,6022,6398,12420
<class,7호선,하계,8792,8261,17053
<class,7호선,중계,6525,6078,12603
<class,7호선,노원,10725,10997,21722
<class,7호선,마들,5793,5430,11223
<class,7호선,수락산,8609,8306,16915
<class,7호선,도봉산,5731,8441,14172
<class,7호선,장암,1524,1078,2602
<class,6호선,봉화산,3888,3653,7541
<class,6호선,화랑대,5163,4469,9632
<class,6호선,태릉입구,2937,3148,6085
<class,6호선,석계,6196,6358,12554
<class,6호선,돌곶이,4368,4378,8746
<class,6호선,상월곡,3074,2912,5986
<class,6호선,월곡,5037,5178,10215
<class,6호선,고려대,3745,3775,7520
<class,6호선,안암,4554,5378,9932
<class,6호선,보문,3673,3700,7373
<class,6호선,창신,1645,1501,3146
<class,6호선,동묘앞,6029,6019,12048
<class,6호선,신당,3202,4026,7228
<class,6호선,청구,1581,1639,3220
<class,6호선,약수,1546,1629,3175
<class,6호선,버티고개,1067,1233,2300
<class,6호선,한강진,4521,5555,10076
<class,6호선,이태원,8576,8334,16910
<class,6호선,녹사평,3928,3847,7775
<class,6호선,삼각지,3151,2336,5487
<class,6호선,효창공원앞,3243,2867,6110
<class,6호선,공덕,6035,5919,11954
<class,6호선,대흥,3382,3742,7124
<class,6호선,광흥창,3829,3696,7525
<class,6호선,상수,5094,5892,10986
<class,6호선,합정,8641,7676,16317
<class,6호선,망원,9261,10491,19752
<class,6호선,마포구청,6767,6428,13195
<class,6호선,월드컵경기장,3560,3561,7121
<class,6호선,디지털미디어시티,4808,5158,9966
<class,6호선,증산,5416,5455,10871
<class,6호선,새절,6195,6050,12245
<class,6호선,구산,3684,2865,6549
<class,6호선,독바위,1628,2039,3667
<class,6호선,불광,3055,2790,5845
<class,6호선,역촌,1827,2144,3971
<class,6호선,응암,8808,8977,17785
<class,5호선,하남검단산,4581,4569,9150
<class,5호선,하남시청,3555,3338,6893
<class,5호선,하남풍산,2127,2026,4153
<class,5호선,미사,7684,7963,15647
<class,5호선,강일,1769,1702,3471
<class,5호선,마천,3360,3545,6905
<class,5호선,거여,3483,3422,6905
<class,5호선,개롱,2859,3130,5989
<class,5호선,오금,1461,1395,2856
<class,5호선,방이,3536,3399,6935
<class,5호선,올림픽공원,2263,1935,4198
<class,5호선,둔촌동,4190,4337,8527
<class,5호선,상일동,6754,6525,13279
<class,5호선,고덕,3919,3937,7856
<class,5호선,명일,4465,4494,8959
<class,5호선,굽은다리,4702,4490,9192
<class,5호선,길동,3770,3837,7607
<class,5호선,강동,8075,8256,16331
<class,5호선,천호,11292,10837,22129
<class,5호선,광나루,7765,7688,15453
<class,5호선,아차산,11156,11039,22195
<class,5호선,군자,5661,6314,11975
<class,5호선,장한평,7033,7090,14123
<class,5호선,답십리,6763,6444,13207
<class,5호선,마장,2798,2711,5509
<class,5호선,왕십리,2122,2457,4579
<class,5호선,행당,3880,3551,7431
<class,5호선,신금호,2778,3026,5804
<class,5호선,청구,1682,1510,3192
<class,5호선,동대문역사문화공원,570,771,1341
<class,5호선,을지로4가,1271,1327,2598
<class,5호선,종로3가,7942,7549,15491
<class,5호선,광화문,9777,9786,19563
<class,2호선,신설동,2715,2807,5522
<class,2호선,도림천,471,523,994
<class,2호선,양천구청,3196,3250,6446
<class,2호선,신정네거리,4982,5029,10011
<class,2호선,용두,955,973,1928
<class,3호선,지축,1911,1745,3656
<class,3호선,구파발,11200,11547,22747
<class,3호선,연신내,21375,20274,41649
<class,3호선,불광,9414,11294,20708
<class,3호선,녹번,6647,6139,12786
<class,3호선,홍제,8916,8566,17482
<class,3호선,무악재,1820,1999,3819
<class,3호선,독립문,4322,5095,9417
<class,3호선,경복궁,10798,11804,22602
<class,3호선,안국,8932,10339,19271
<class,3호선,종로3가,3556,4807,8363
<class,3호선,을지로3가,2740,2674,5414
<class,3호선,동대입구,4572,5272,9844
<class,3호선,약수,6176,6128,12304
<class,3호선,금호,4212,4089,8301
<class,3호선,옥수,5044,5345,10389
<class,3호선,압구정,13013,13448,26461
<class,3호선,신사,12394,12876,25270
<class,3호선,잠원,2350,2399,4749
<class,3호선,고속터미널,42650,33485,76135
<class,3호선,교대,3966,2428,6394
<class,3호선,남부터미널,16049,15325,31374
<class,3호선,양재,11994,14340,26334
<class,3호선,매봉,3990,3994,7984
<class,3호선,도곡,2033,2049,4082
<class,3호선,대치,5573,5039,10612
<class,3호선,학여울,2526,2861,5387
<class,3호선,대청,3759,3753,7512
<class,3호선,일원,3206,3294,6500
<class,3호선,수서,10347,9505,19852
<class,3호선,가락시장,3380,3672,7052
<class,3호선,경찰병원,2507,2637,5144
<class,3호선,오금,2600,2565,5165
<class,4호선,수유,18964,18281,37245
<class,4호선,미아,7717,7389,15106
<class,4호선,미아사거리,15295,14633,29928
<class,4호선,길음,9648,9531,19179
<class,4호선,성신여대입구,11784,11874,23658
<class,4호선,한성대입구,7287,7559,14846
<class,4호선,혜화,19550,20797,40347
<class,4호선,동대문,6475,7030,13505
<class,4호선,동대문역사문화공원,7499,7431,14930
<class,4호선,충무로,7906,8122,16028
<class,4호선,명동,8823,9157,17980
<class,4호선,회현,7409,7935,15344
<class,4호선,서울역,3639,7510,11149
<class,4호선,숙대입구,6179,6151,12330
<class,4호선,삼각지,1871,2509,4380
<class,장항선,온양온천,4223,3980,8203
<class,4호선,신용산,6714,6413,13127
<class,4호선,이촌,4657,5495,10152
<class,4호선,동작,1945,2037,3982
<class,4호선,총신대입구,9617,10355,19972
<class,4호선,사당,13490,12685,26175
<class,4호선,남태령,592,506,1098
<class,4호선,당고개,8042,7547,15589
<class,4호선,상계,10045,9456,19501
<class,4호선,노원,11540,12239,23779
<class,4호선,창동,13867,14322,28189
<class,4호선,쌍문,15180,13966,29146
<class,5호선,방화,3511,3401,6912
<class,5호선,개화산,2756,2799,5555
<class,5호선,김포공항,6840,5975,12815
<class,5호선,송정,3472,3583,7055
<class,5호선,마곡,3244,3516,6760
<class,5호선,발산,8310,8698,17008
<class,5호선,우장산,6293,6500,12793
<class,5호선,화곡,13498,13079,26577
<class,5호선,까치산,14756,14891,29647
<class,5호선,신정,6102,5523,11625
<class,5호선,목동,7274,7495,14769
<class,5호선,오목교,11104,11365,22469
<class,5호선,양평,2255,2561,4816
<class,5호선,영등포구청,1250,1269,2519
<class,5호선,영등포시장,3959,4416,8375
<class,5호선,신길,1664,1973,3637
<class,5호선,여의도,7577,7620,15197
<class,5호선,여의나루,16640,17929,34569
<class,5호선,마포,4557,4492,9049
<class,5호선,공덕,4175,4275,8450
<class,5호선,애오개,2389,2539,4928
<class,5호선,충정로,1302,1363,2665
<class,5호선,서대문,4379,4338,8717
<class,1호선,서울역,25486,20629,46115
<class,2호선,문래,11647,12105,23752
<class,2호선,신당,10183,10600,20783
<class,2호선,당산,11215,12627,23842
<class,2호선,합정,25024,26779,51803
<class,2호선,홍대입구,56950,59996,116946
<class,2호선,신촌,28882,28997,57879
<class,2호선,이대,9647,9985,19632
<class,2호선,아현,6985,6771,13756
<class,2호선,충정로,5132,5559,10691
<class,2호선,용답,1956,1851,3807
<class,2호선,신답,873,954,1827
<class,2호선,신설동,2750,2653,5403
<class,2호선,도림천,903,853,1756
<class,2호선,양천구청,4519,4699,9218
<class,2호선,신정네거리,7027,7164,14191
<class,2호선,용두,1489,1571,3060
<class,3호선,지축,2460,2410,4870
<class,3호선,구파발,13729,13543,27272
<class,3호선,연신내,27830,26268,54098
<class,3호선,불광,11802,13299,25101
<class,3호선,녹번,9457,8266,17723
<class,3호선,홍제,12207,11717,23924
<class,3호선,무악재,2522,2643,5165
<class,3호선,독립문,5389,5637,11026
<class,3호선,경복궁,12936,12632,25568
<class,3호선,안국,11797,13242,25039
<class,3호선,종로3가,5795,7641,13436
<class,3호선,을지로3가,4772,5092,9864
<class,3호선,충무로,1,0,1
<class,3호선,동대입구,5222,5622,10844
<class,3호선,약수,8583,7932,16515
<class,3호선,금호,5492,5016,10508
<class,3호선,옥수,6507,6761,13268
<class,3호선,압구정,23579,24677,48256
<class,3호선,신사,23138,23870,47008
<class,3호선,잠원,3216,3128,6344
<class,3호선,고속터미널,45608,45516,91124
<class,3호선,교대,6413,3907,10320
<class,3호선,남부터미널,20717,21173,41890
<class,3호선,양재,19666,20984,40650
<class,3호선,매봉,6127,5900,12027
<class,3호선,도곡,3758,3857,7615
<class,3호선,학여울,1114,1075,2189
<class,3호선,대청,5459,5147,10606
<class,3호선,일원,4694,4793,9487
<class,3호선,수서,12194,12607,24801
<class,3호선,가락시장,5775,5461,11236
<class,3호선,경찰병원,3973,3927,7900
<class,3호선,오금,3765,3578,7343
<class,4호선,수유,24319,24017,48336
<class,4호선,미아,10118,9579,19697
<class,4호선,미아사거리,20537,20014,40551
<class,4호선,길음,13189,12505,25694
<class,4호선,성신여대입구,15968,15282,31250
<class,4호선,한성대입구,9970,9593,19563
<class,4호선,혜화,23395,23971,47366
<class,4호선,동대문,13587,13184,26771
<class,4호선,동대문역사문화공원,9799,8545,18344
<class,4호선,충무로,11862,12293,24155
<class,4호선,명동,10504,12111,22615
<class,4호선,회현,16163,16731,32894
<class,4호선,서울역,4700,10722,15422
<class,4호선,숙대입구,8202,7730,15932
<class,4호선,삼각지,2827,3561,6388
<class,4호선,신용산,8580,9526,18106
<class,4호선,이촌,5698,6376,12074
<class,4호선,동작,1692,1708,3400
<class,4호선,총신대입구,13576,14457,28033
<class,4호선,사당,18925,16050,34975
<class,4호선,남태령,951,778,1729
<class,4호선,당고개,9315,8784,18099
<class,4호선,상계,13365,12762,26127
<class,4호선,노원,15433,16434,31867
<class,4호선,창동,18181,19082,37263
<class,4호선,쌍문,20284,18280,38564
<class,5호선,방화,4575,4384,8959
<class,5호선,개화산,3407,3324,6731
<class,5호선,김포공항,6976,6992,13968
<class,5호선,송정,4775,4752,9527
<class,5호선,마곡,5003,5018,10021
<class,5호선,발산,12596,13166,25762
<class,5호선,우장산,9005,9167,18172
<class,5호선,화곡,18430,17200,35630
<class,5호선,까치산,19414,18885,38299
<class,5호선,신정,8426,7446,15872
<class,5호선,목동,10665,10997,21662
<class,5호선,오목교,16020,16161,32181
<class,5호선,양평,3465,3363,6828
<class,5호선,영등포구청,1712,1765,3477
<class,5호선,영등포시장,6621,7021,13642
<class,5호선,신길,2318,2494,4812
<class,5호선,여의도,12610,11868,24478
<class,5호선,여의나루,5764,9046,14810
<class,5호선,마포,6774,6932,13706
<class,5호선,공덕,6726,6969,13695
<class,5호선,애오개,3572,3574,7146
<class,5호선,충정로,1867,1748,3615
<class,5호선,서대문,6970,6752,13722
<class,5호선,광화문,12739,13022,25761
<class,5호선,종로3가,11313,11221,22534
<class,5호선,을지로4가,3042,3392,6434
<class,5호선,동대문역사문화공원,979,1266,2245
<class,5호선,청구,2416,2205,4621
<class,5호선,신금호,3831,3894,7725
<class,5호선,행당,5473,4943,10416
<class,5호선,왕십리,3226,3679,6905
<class,5호선,마장,3532,3480,7012
<class,5호선,답십리,9716,8857,18573
<class,5호선,장한평,10357,10324,20681
<class,5호선,군자,7861,8716,16577
<class,5호선,아차산,11976,11672,23648
<class,5호선,광나루,9463,8771,18234
<class,5호선,천호,15631,14557,30188
<class,5호선,강동,12128,11746,23874
<class,5호선,길동,5673,5828,11501
<class,5호선,굽은다리,6715,6390,13105
<class,5호선,명일,6066,6115,12181
<class,5호선,고덕,5850,5612,11462
<class,5호선,상일동,9127,8720,17847
<class,5호선,둔촌동,6019,6026,12045
<class,5호선,올림픽공원,2741,2336,5077
<class,5호선,방이,5300,5124,10424
<class,5호선,오금,2522,2364,4886
<class,5호선,개롱,4182,4359,8541
<class,5호선,거여,5361,5151,10512
<class,5호선,마천,4281,4330,8611
<class,5호선,강일,2165,2078,4243
<class,5호선,미사,10307,10200,20507
<class,5호선,하남풍산,2473,2512,4985
<class,5호선,하남시청,3898,3852,7750
<class,5호선,하남검단산,4432,4486,8918
<class,6호선,응암,11636,11663,23299
<class,6호선,역촌,2528,2958,5486
<class,6호선,불광,3744,3293,7037
<class,6호선,독바위,1909,2172,4081
<class,6호선,구산,5219,4133,9352
<class,6호선,새절,8445,8114,16559
<class,6호선,증산,6977,7181,14158
<class,6호선,디지털미디어시티,6641,6825,13466
<class,6호선,월드컵경기장,3710,3750,7460
<class,6호선,마포구청,8808,8086,16894
<class,6호선,망원,11616,12636,24252
<class,6호선,합정,11458,10419,21877
<class,6호선,상수,7791,8382,16173
<class,6호선,광흥창,4858,4670,9528
<class,6호선,대흥,5133,5202,10335
<class,6호선,공덕,9514,8855,18369
<class,6호선,효창공원앞,4329,3843,8172
<class,6호선,삼각지,4457,3562,8019
<class,6호선,녹사평,4503,4694,9197
<class,6호선,이태원,10632,11094,21726
<class,6호선,한강진,5842,7050,12892
<class,6호선,버티고개,1474,1584,3058
<class,6호선,약수,2167,2323,4490
<class,6호선,청구,2327,2494,4821
<class,6호선,신당,6219,5123,11342
<class,6호선,동묘앞,7010,6540,13550
<class,6호선,창신,2031,1760,3791
<class,6호선,보문,4713,4354,9067
<class,6호선,안암,7121,6677,13798
<class,6호선,고려대,5560,5449,11009
<class,6호선,월곡,6950,6795,13745
<class,6호선,상월곡,3997,3603,7600
<class,6호선,돌곶이,5681,5297,10978
<class,6호선,석계,8685,8793,17478
<class,6호선,태릉입구,4151,4396,8547
<class,6호선,화랑대,6909,5823,12732
<class,6호선,봉화산,5079,4921,10000
<class,7호선,장암,1422,989,2411
<class,7호선,도봉산,5953,8207,14160
<class,7호선,수락산,9777,9597,19374
<class,7호선,마들,8352,8000,16352
<class,7호선,노원,15475,15565,31040
<class,7호선,중계,9002,8310,17312
<class,7호선,하계,11806,10987,22793
<class,7호선,공릉,8817,8646,17463
<class,7호선,태릉입구,6396,5970,12366
<class,7호선,먹골,7591,7384,14975
<class,7호선,중화,8052,7788,15840
<class,7호선,상봉,12535,12035,24570
<class,7호선,면목,10529,10160,20689
<class,7호선,사가정,11753,11494,23247
<class,7호선,용마산,4382,4419,8801
<class,7호선,중곡,6664,6325,12989
<class,7호선,군자,10037,7823,17860
<class,7호선,어린이대공원,8465,8132,16597
<class,7호선,건대입구,10398,10434,20832
<class,7호선,뚝섬유원지,5685,5555,11240
<class,7호선,청담,10964,11578,22542
<class,7호선,강남구청,9098,10160,19258
<class,7호선,학동,10128,10574,20702
<class,7호선,논현,10934,11844,22778
<class,7호선,반포,4304,4163,8467
<class,7호선,고속터미널,13224,10300,23524
<class,7호선,내방,7693,7731,15424
<class,7호선,이수,11392,10597,21989
<class,7호선,남성,7565,7109,14674
<class,7호선,숭실대입구,7577,7658,15235
<class,7호선,상도,7169,6823,13992
<class,7호선,장승배기,6341,6297,12638
<class,7호선,신대방삼거리,10815,10105,20920
<class,7호선,보라매,5932,5705,11637
<class,7호선,신풍,7713,7578,15291
<class,7호선,대림,6852,7355,14207
<class,7호선,남구로,8162,8727,16889
<class,7호선,가산디지털단지,14034,12744,26778
<class,7호선,철산,14582,14763,29345
<class,7호선,광명사거리,15642,15892,31534
<class,7호선,천왕,6344,6054,12398
<class,7호선,온수,5385,5260,10645
<class,7호선,까치울,5100,5007,10107
<class,7호선,부천종합운동장,2895,2595,5490
<class,7호선,춘의,4888,4695,9583
<class,7호선,신중동,9245,8935,18180
<class,7호선,부천시청,9068,8863,17931
<class,7호선,상동,9714,9906,19620
<class,7호선,삼산체육관,3190,3047,6237
<class,7호선,굴포천,6118,6433,12551
<class,7호선,부평구청,6563,5779,12342
<class,8호선,암사,11866,11104,22970
<class,8호선,천호,11144,13244,24388
<class,8호선,강동구청,5678,5860,11538
<class,8호선,몽촌토성,3714,3830,7544
<class,8호선,잠실,11751,13592,25343
<class,8호선,석촌,5630,6461,12091
<class,8호선,송파,5288,5457,10745
<class,8호선,가락시장,5253,5215,10468
<class,8호선,문정,8377,8627,17004
<class,8호선,장지,12067,11138,23205
<class,8호선,복정,6901,5937,12838
<class,8호선,산성,4450,4288,8738
<class,8호선,남한산성입구,8197,7509,15706
<class,8호선,단대오거리,7091,6703,13794
<class,8호선,신흥,3676,3871,7547
<class,8호선,수진,4128,3788,7916
<class,8호선,모란,3317,2830,6147
<class,9호선,개화,1307,1083,2390
<class,9호선,김포공항,7806,11974,19780
<class,9호선,공항시장,2220,2345,4565
<class,9호선,신방화,4449,4267,8716
<class,9호선,마곡나루,7424,7428,14852
<class,9호선,양천향교,5718,5574,11292
<class,9호선,가양,13156,12507,25663
<class,9호선,증미,3970,3960,7930
<class,9호선,등촌,6704,6576,13280
<class,9호선,염창,10882,10092,20974
<class,9호선,신목동,2230,1973,4203
<class,9호선,선유도,3710,3635,7345
<class,9호선,당산,11906,11166,23072
<class,9호선,국회의사당,3978,4219,8197
<class,9호선,여의도,12454,10934,23388
<class,9호선,샛강,2566,2544,5110
<class,9호선,노량진,19530,19016,38546
<class,9호선,노들,2911,2580,5491
<class,9호선,흑석,5189,5265,10454
<class,9호선,동작,1280,1084,2364
<class,9호선,구반포,2197,2288,4485
<class,9호선,신반포,2262,2187,4449
<class,9호선,고속터미널,11436,16598,28034
<class,9호선,사평,2278,2145,4423
<class,9호선,신논현,24542,23925,48467
<class,9호선2~3단계,언주,5677,5751,11428
<class,9호선2~3단계,선정릉,4645,5129,9774
<class,9호선2~3단계,삼성중앙,2897,2948,5845
<class,9호선2~3단계,봉은사,9731,9935,19666
<class,9호선2~3단계,종합운동장,3221,2652,5873
<class,9호선2~3단계,삼전,4477,4419,8896
<class,9호선2~3단계,석촌고분,3766,3770,7536
<class,9호선2~3단계,석촌,5854,4966,10820
<class,9호선2~3단계,송파나루,3836,4075,7911
<class,9호선2~3단계,한성백제,1581,1414,2995
<class,9호선2~3단계,올림픽공원,3614,3550,7164
<class,9호선2~3단계,둔촌오륜,636,576,1212
<class,9호선2~3단계,중앙보훈병원,4341,4023,8364
<class,경강선,판교,2703,2512,5215
<class,경강선,이매,687,556,1243
<class,경강선,삼동,1424,1340,2764
<class,경강선,경기광주,4610,4332,8942
<class,경강선,초월,1918,1806,3724
<class,경강선,곤지암,1613,1759,3372
<class,경강선,신둔도예촌,1019,996,2015
<class,경강선,이천,2400,2404,4804
<class,경강선,부발,1605,1381,2986
<class,경강선,세종대왕릉,248,299,547
<class,경강선,여주,2009,2250,4259
<class,경부선,서울역,5392,1702,7094
<class,경부선,남영,5239,5307,10546
<class,경부선,용산,30877,32829,63706
<class,경부선,노량진,7347,6747,14094
<class,경부선,대방,7422,7527,14949
<class,경부선,영등포,36784,37517,74301
<class,경부선,신도림,2473,2773,5246
<class,경부선,신길,5888,4949,10837
<class,경부선,구로,12437,12793,25230
<class,경부선,가산디지털단지,5607,7807,13414
<class,경부선,금천구청,7726,7606,15332
<class,경부선,석수,6732,6145,12877
<class,경부선,관악,5390,5280,10670
<class,경부선,안양,16845,16972,33817
<class,경부선,명학,5211,5072,10283
<class,경부선,금정,16972,17103,34075
<class,경부선,군포,4148,3837,7985
<class,경부선,의왕,5578,5369,10947
<class,경부선,성균관대,9840,9626,19466
<class,경부선,화서,4748,4742,9490
<class,경부선,수원,36310,39245,75555
<class,경부선,독산,8250,8149,16399
<class,경부선,세류,2386,2352,4738
<class,경부선,병점,11433,11400,22833
<class,경부선,세마,1993,1800,3793
<class,경부선,오산대,2542,2311,4853
<class,경부선,오산,8705,8159,16864
<class,경부선,진위,942,809,1751
<class,경부선,송탄,4394,4019,8413
<class,경부선,서정리,5809,4806,10615
<class,경부선,평택지제,2510,2336,4846
<class,경부선,평택,12492,11682,24174
<class,경부선,성환,2919,2632,5551
<class,경부선,직산,573,577,1150
<class,경부선,두정,5086,5152,10238
<class,경부선,천안,5912,5958,11870
<class,경부선,당정,3944,3775,7719
<class,경부선,서동탄,1005,1008,2013
<class,경부선,광명,2361,2217,4578
<class,경원선,이촌,2678,1967,4645
<class,경원선,서빙고,1223,1105,2328
<class,경원선,한남,2658,2483,5141
<class,경원선,옥수,30,31,61
<class,경원선,응봉,1490,1430,2920
<class,경원선,왕십리,11414,13171,24585
<class,경원선,청량리,14556,15903,30459
<class,경원선,외대앞,5594,5482,11076
<class,경원선,신이문,5738,5364,11102
<class,경원선,석계,6168,6647,12815
<class,경원선,광운대,5614,5428,11042
<class,경원선,월계,4832,4433,9265
<class,경원선,녹천,3171,2760,5931
<class,경원선,방학,6976,6760,13736
<class,경원선,도봉,4199,4099,8298
<class,경원선,도봉산,7750,5210,12960
<class,경원선,망월사,5317,5447,10764
<class,경원선,회룡,9219,9184,18403
<class,경원선,의정부,16230,17001,33231
<class,경원선,가능,4815,4624,9439
<class,경원선,녹양,3246,3179,6425
<class,경원선,양주,6009,5620,11629
<class,경원선,덕계,2206,2025,4231
<class,경원선,덕정,4148,3930,8078
<class,경원선,지행,5119,5059,10178
<class,경원선,동두천중앙,2490,2536,5026
<class,경원선,보산,1617,1613,3230
<class,경원선,동두천,1471,1893,3364
<class,경원선,소요산,3471,2891,6362
<class,경의선,서울역,1136,1338,2474
<class,경의선,신촌,361,363,724
<class,경의선,효창공원앞,1599,1777,3376
<class,경의선,공덕,2374,1856,4230
<class,경의선,서강대,1599,1500,3099
<class,경의선,홍대입구,1728,2091,3819
<class,경의선,가좌,3647,3500,7147
<class,경의선,디지털미디어시티,1786,1650,3436
<class,경의선,수색,1258,1264,2522
<class,경의선,화전,1052,1015,2067
<class,경의선,강매,1840,1766,3606
<class,경의선,행신,4758,4845,9603
<class,경의선,능곡,2549,2528,5077
<class,경의선,곡산,369,374,743
<class,경의선,백마,4178,3965,8143
<class,경의선,풍산,3927,3817,7744
<class,경의선,일산,5828,5590,11418
<class,경의선,탄현,5092,5021,10113
<class,경의선,야당,4877,4714,9591
<class,경의선,운정,4390,4268,8658
<class,경의선,금릉,3291,3233,6524
<class,경의선,금촌,4963,4776,9739
<class,경의선,월롱,1238,1189,2427
<class,경의선,파주,847,663,1510
<class,경의선,문산,4179,3982,8161
<class,경의선,임진강,48,38,86
<class,경인선,개봉,15515,15576,31091
<class,경인선,오류동,8473,7864,16337
<class,경인선,역곡,18609,18424,37033
<class,경인선,부천,26464,27161,53625
<class,경인선,송내,16702,16837,33539
<class,경인선,부평,28207,30107,58314
<class,경인선,백운,5147,5253,10400
<class,경인선,동암,11614,11862,23476
<class,경인선,주안,14626,12936,27562
<class,경인선,제물포,6905,6687,13592
<class,경인선,동인천,10424,10262,20686
<class,경인선,인천,3244,2667,5911
<class,경인선,구일,5288,5012,10300
<class,경인선,소사,6928,6707,13635
<class,경인선,부개,6085,5664,11749
<class,경인선,간석,4068,4019,8087
<class,경인선,도원,2481,2453,4934
<class,경인선,온수,4734,4424,9158
<class,경인선,중동,6283,5902,12185
<class,경인선,도화,2906,2713,5619
<class,경춘선,신내,991,976,1967
<class,경춘선,갈매,1876,1670,3546
<class,경춘선,별내,2116,2069,4185
<class,경춘선,퇴계원,2498,2342,4840
<class,경춘선,사릉,2195,2114,4309
<class,경춘선,금곡,1050,966,2016
<class,경춘선,평내호평,4219,4194,8413
<class,경춘선,천마산,1207,1143,2350
<class,경춘선,마석,3076,3004,6080
<class,경춘선,대성리,519,542,1061
<class,경춘선,청평,1501,1591,3092
<class,경춘선,상천,346,301,647
<class,경춘선,가평,1544,1726,3270
<class,경춘선,굴봉산,162,179,341
<class,경춘선,백양리,127,169,296
<class,경춘선,강촌,507,594,1101
<class,경춘선,김유정,469,565,1034
<class,경춘선,남춘천,2278,2335,4613
<class,경춘선,춘천,1534,1356,2890
<class,공항철도 1호선,서울역,6247,6587,12834
<class,공항철도 1호선,공덕,1397,2084,3481
<class,공항철도 1호선,홍대입구,10993,11007,22000
<class,공항철도 1호선,디지털미디어시티,4854,4562,9416
<class,공항철도 1호선,마곡나루,2648,2835,5483
<class,공항철도 1호선,김포공항,10333,5613,15946
<class,공항철도 1호선,계양,6096,5548,11644
<class,공항철도 1호선,검암,4274,4312,8586
<class,공항철도 1호선,청라국제도시,3639,3617,7256
<class,공항철도 1호선,운서,5163,5301,10464
<class,공항철도 1호선,공항화물청사,1233,1288,2521
<class,공항철도 1호선,인천공항1터미널,2728,2812,5540
<class,공항철도 1호선,인천공항2터미널,1444,1403,2847
<class,공항철도 1호선,영종,2562,2597,5159
<class,과천선,선바위,4793,4169,8962
<class,과천선,경마공원,981,954,1935
<class,과천선,대공원,3262,3561,6823
<class,과천선,과천,3843,3603,7446
<class,과천선,정부과천청사,5251,5327,10578
<class,과천선,인덕원,14118,13680,27798
<class,과천선,평촌,8528,8561,17089
<class,과천선,범계,18816,18199,37015
<class,분당선,선릉,5094,7858,12952
<class,분당선,한티,11768,11348,23116
<class,분당선,도곡,4725,4169,8894
<class,분당선,구룡,1857,1745,3602
<class,분당선,개포동,2580,2518,5098
<class,분당선,대모산입구,2245,2032,4277
<class,분당선,수서,9761,10243,20004
<class,분당선,수원,7232,6100,13332
<class,분당선,서울숲,6493,6686,13179
<class,분당선,압구정로데오,18393,20099,38492
<class,분당선,강남구청,5281,6205,11486
<class,분당선,선정릉,3745,3792,7537
<class,분당선,가천대,5093,5563,10656
<class,분당선,태평,9910,9509,19419
<class,분당선,모란,14671,14770,29441
<class,분당선,야탑,16091,16926,33017
<class,분당선,서현,17456,17371,34827
<class,분당선,수내,8374,8000,16374
<class,분당선,정자,10311,10610,20921
<class,분당선,미금,10287,10781,21068
<class,분당선,오리,7259,5933,13192
<class,분당선,이매,3774,3741,7515
<class,분당선,보정,1496,1391,2887
<class,분당선,죽전,10063,11152,21215
<class,분당선,구성,2918,3152,6070
<class,분당선,신갈,2620,2680,5300
<class,분당선,기흥,6274,5994,12268
<class,분당선,상갈,3706,3696,7402
<class,분당선,청명,2575,2501,5076
<class,분당선,영통,6141,6217,12358
<class,분당선,망포,8860,8096,16956
<class,분당선,매탄권선,3263,3145,6408
<class,분당선,수원시청,10405,11110,21515
<class,분당선,매교,1938,1965,3903
<class,수인선,고색,2229,2261,4490
<class,수인선,오목천,1846,1635,3481
<class,수인선,어천,660,534,1194
<class,수인선,야목,199,192,391
<class,수인선,사리,2894,2572,5466
<class,수인선,달월,45,51,96
<class,수인선,월곶,1994,1894,3888
<class,수인선,소래포구,5193,5457,10650
<class,수인선,인천논현,4133,4293,8426
<class,수인선,호구포,2427,2324,4751
<class,수인선,남동인더스파크,1092,1010,2102
<class,수인선,원인재,3257,3401,6658
<class,수인선,연수,3677,3678,7355
<class,수인선,송도,1971,1901,3872
<class,수인선,인하대,4103,3904,8007
<class,수인선,숭의,2536,2454,4990
<class,수인선,신포,1180,1245,2425
<class,수인선,인천,973,1651,2624
<class,안산선,산본,10808,11544,22352
<class,안산선,대야미,3645,3177,6822
<class,안산선,반월,3102,2879,5981
<class,안산선,상록수,11408,11403,22811
<class,안산선,한대앞,6521,6503,13024
<class,안산선,중앙,14456,14665,29121
<class,안산선,고잔,5662,5614,11276
<class,안산선,초지,3151,3181,6332
<class,안산선,안산,9042,9634,18676
<class,안산선,신길온천,1266,1220,2486
<class,안산선,정왕,5736,6021,11757
<class,안산선,오이도,6650,6904,13554
<class,안산선,수리산,2589,2256,4845
<class,우이신설선,북한산우이,2861,2926,5787
<class,우이신설선,솔밭공원,1651,1637,3288
<class,우이신설선,4.19민주묘지,2066,1889,3955
<class,우이신설선,가오리,2589,2555,5144
<class,우이신설선,화계,2279,2193,4472
<class,우이신설선,삼양,1372,1435,2807
<class,우이신설선,삼양사거리,1592,1609,3201
<class,우이신설선,솔샘,3368,3144,6512
<class,우이신설선,북한산보국문,4350,4046,8396
<class,우이신설선,정릉,3367,2847,6214
<class,우이신설선,성신여대입구,2649,3085,5734
<class,우이신설선,보문,1139,1099,2238
<class,우이신설선,신설동,1239,1148,2387
<class,일산선,원흥,6786,6495,13281
<class,일산선,삼송,12641,12445,25086
<class,일산선,원당,7776,7437,15213
<class,일산선,화정,11645,12111,23756
<class,일산선,대곡,1272,1068,2340
<class,일산선,백석,7035,7332,14367
<class,일산선,마두,4764,4823,9587
<class,일산선,정발산,5863,6076,11939
<class,일산선,주엽,6056,5865,11921
<class,일산선,대화,8102,7301,15403
<class,장항선,봉명,654,658,1312
<class,장항선,쌍용,1476,1286,2762
<class,장항선,아산,2565,2567,5132
<class,장항선,배방,903,797,1700
<class,장항선,온양온천,3334,3284,6618
<class,장항선,신창,1224,1108,2332
<class,중앙선,회기,18615,17778,36393
<class,중앙선,중랑,4248,4118,8366
<class,중앙선,상봉,4816,4712,9528
<class,중앙선,망우,5949,5935,11884
<class,중앙선,양원,1155,1193,2348
<class,중앙선,구리,9930,10374,20304
<class,중앙선,도농,6410,6128,12538
<class,중앙선,양정,551,482,1033
<class,중앙선,덕소,4285,4343,8628
<class,중앙선,도심,1575,1416,2991
<class,중앙선,팔당,1135,1312,2447
<class,중앙선,운길산,1257,1147,2404
<class,중앙선,양수,1836,1925,3761
<class,중앙선,신원,240,209,449
<class,중앙선,국수,672,689,1361
<class,중앙선,아신,579,578,1157
<class,중앙선,오빈,264,276,540
<class,중앙선,양평,2425,2536,4961
<class,중앙선,원덕,428,504,932
<class,중앙선,용문,3477,3623,7100
<class,중앙선,지평,44,72,116
<class,1호선,시청,8799,9626,18425
<class,3호선,대치,9063,8096,17159
<class,분당선,복정,2,0,2
<class,1호선,서울역,27247,27632,54879
<class,1호선,동묘앞,8564,8575,17139
<class,1호선,종각,17252,15941,33193
<class,1호선,종로3가,19300,18816,38116
<class,1호선,종로5가,17172,16857,34029
<class,1호선,동대문,9882,9078,18960
<class,1호선,신설동,8099,8028,16127
<class,1호선,제기동,12957,13029,25986
<class,1호선,청량리,16352,16876,33228
<class,2호선,시청,7735,6390,14125
<class,2호선,을지로입구,18206,17800,36006
<class,2호선,을지로3가,9712,9595,19307
<class,2호선,을지로4가,6508,6723,13231
<class,2호선,동대문역사문화공원,8744,9520,18264
<class,2호선,영등포구청,11809,11884,23693
<class,2호선,상왕십리,9250,8797,18047
<class,2호선,왕십리,12837,10617,23454
<class,2호선,한양대,3430,3389,6819
<class,2호선,뚝섬,12724,12885,25609
<class,2호선,성수,16629,17973,34602
<class,2호선,건대입구,31600,33488,65088
<class,2호선,구의,15320,15204,30524
<class,2호선,강변,24377,24643,49020
<class,2호선,잠실나루,7209,7014,14223
<class,2호선,잠실,56906,54351,111257
<class,2호선,잠실새내,15937,16346,32283
<class,2호선,종합운동장,5238,6042,11280
<class,2호선,삼성,27479,27584,55063
<class,2호선,선릉,22703,20230,42933
<class,2호선,역삼,18092,19630,37722
<class,2호선,강남,59335,58005,117340
<class,2호선,교대,16776,18686,35462
<class,2호선,서초,10984,9176,20160
<class,2호선,방배,9632,9983,19615
<class,2호선,사당,27190,29903,57093
<class,2호선,낙성대,19895,18728,38623
<class,2호선,서울대입구,35192,33950,69142
<class,2호선,봉천,16045,14932,30977
<class,2호선,신림,47057,44697,91754
<class,2호선,신대방,18274,18179,36453
<class,2호선,구로디지털단지,31471,31394,62865
<class,2호선,대림,17118,18247,35365
<class,2호선,신도림,38278,37846,76124
<class,안산선,반월,1871,1936,3807
<class,중앙선,회기,12761,12955,25716
<class,중앙선,중랑,2620,2624,5244
<class,중앙선,상봉,2989,2911,5900
<class,중앙선,망우,3583,3639,7222
<class,중앙선,양원,568,624,1192
<class,중앙선,구리,5740,5962,11702
<class,중앙선,도농,3462,3531,6993
<class,중앙선,양정,320,263,583
<class,중앙선,덕소,2535,2571,5106
<class,중앙선,도심,860,752,1612
<class,중앙선,팔당,731,772,1503
<class,중앙선,운길산,544,508,1052
<class,중앙선,양수,1113,1019,2132
<class,중앙선,신원,100,65,165
<class,중앙선,국수,355,314,669
<class,중앙선,아신,316,319,635
<class,중앙선,오빈,142,142,284
<class,중앙선,양평,1468,1323,2791
<class,중앙선,원덕,238,174,412
<class,중앙선,용문,1421,1124,2545
<class,중앙선,지평,29,28,57
<class,장항선,아산,2513,1765,4278
<class,장항선,배방,616,717,1333
<class,장항선,온양온천,2627,2512,5139
<class,장항선,신창,772,1111,1883
<class,6호선,버티고개,932,943,1875
<class,1호선,서울역,22698,19370,42068
<class,1호선,동묘앞,4306,4664,8970
<class,1호선,시청,5477,5417,10894
<class,1호선,종각,9553,8588,18141
<class,1호선,종로3가,9851,8938,18789
<class,1호선,종로5가,6814,6863,13677
<class,1호선,동대문,6075,6234,12309
<class,1호선,신설동,4608,4616,9224
<class,1호선,제기동,5893,6069,11962
<class,1호선,청량리,9098,9158,18256
<class,2호선,시청,4601,3555,8156
<class,2호선,을지로입구,12069,11322,23391
<class,2호선,을지로3가,5903,5256,11159
<class,2호선,을지로4가,2420,2276,4696
<class,2호선,동대문역사문화공원,4922,5822,10744
<class,2호선,신당,5930,6416,12346
<class,2호선,상왕십리,5743,5594,11337
<class,2호선,왕십리,8015,6991,15006
<class,2호선,한양대,2109,2269,4378
<class,2호선,뚝섬,6768,7142,13910
<class,2호선,성수,9648,10161,19809
<class,2호선,건대입구,20516,21046,41562
<class,2호선,구의,9055,9271,18326
<class,2호선,강변,17135,16583,33718
<class,2호선,잠실나루,3888,4067,7955
<class,2호선,잠실,35222,33535,68757
<class,2호선,잠실새내,9109,9244,18353
<class,2호선,종합운동장,2851,3141,5992
<class,2호선,삼성,18975,18015,36990
<class,2호선,선릉,10453,9291,19744
<class,2호선,역삼,10318,10798,21116
<class,2호선,강남,29519,27966,57485
<class,2호선,교대,8785,9756,18541
<class,2호선,서초,9749,8968,18717
<class,2호선,방배,5587,5973,11560
<class,2호선,사당,15913,17722,33635
<class,2호선,낙성대,12502,13225,25727
<class,2호선,서울대입구,21994,22361,44355
<class,2호선,봉천,10024,9914,19938
<class,2호선,신림,29546,29549,59095
<class,2호선,신대방,12020,11978,23998
<class,2호선,구로디지털단지,18922,18550,37472
<class,2호선,대림,11563,11752,23315
<class,2호선,신도림,23526,23347,46873
<class,2호선,문래,6364,6665,13029
<class,2호선,영등포구청,6661,6854,13515
<class,2호선,당산,6082,7035,13117
<class,2호선,합정,15345,15791,31136
<class,2호선,홍대입구,35735,34676,70411
<class,2호선,신촌,19060,18381,37441
<class,2호선,이대,5745,6170,11915
<class,2호선,아현,4106,4241,8347
<class,2호선,충정로,3046,3355,6401
<class,2호선,용답,1372,1396,2768
<class,2호선,신답,508,605,1113
<class,2호선,신설동,1632,1580,3212
<class,2호선,도림천,340,359,699
<class,2호선,양천구청,2595,2735,5330
<class,2호선,신정네거리,3942,4048,7990
<class,2호선,용두,892,956,1848
<class,3호선,지축,1378,1325,2703
<class,3호선,구파발,8203,8289,16492
<class,3호선,연신내,16384,15962,32346
<class,3호선,불광,7040,7883,14923
<class,3호선,녹번,5505,5082,10587
<class,3호선,홍제,6915,6849,13764
<class,3호선,무악재,1453,1486,2939
<class,3호선,독립문,2839,2950,5789
<class,3호선,경복궁,6878,6789,13667
<class,3호선,안국,6628,6735,13363
<class,3호선,종로3가,3194,3709,6903
<class,3호선,을지로3가,2475,2316,4791
<class,3호선,충무로,1,0,1
<class,3호선,동대입구,3696,3787,7483
<class,3호선,약수,5218,5075,10293
<class,3호선,금호,3362,3287,6649
<class,3호선,옥수,3704,3969,7673
<class,3호선,압구정,11285,11707,22992
<class,3호선,신사,10573,10495,21068
<class,3호선,잠원,1606,1647,3253
<class,3호선,고속터미널,34301,32132,66433
<class,3호선,교대,3526,2233,5759
<class,3호선,남부터미널,12210,13072,25282
<class,3호선,양재,10958,12620,23578
<class,3호선,매봉,3515,3515,7030
<class,3호선,도곡,1541,1627,3168
<class,3호선,대치,4831,4360,9191
<class,3호선,학여울,1091,1126,2217
<class,3호선,대청,3291,3190,6481
<class,3호선,일원,2642,2819,5461
<class,3호선,수서,9006,8696,17702
<class,3호선,가락시장,2956,3336,6292
<class,3호선,경찰병원,2214,2283,4497
<class,3호선,오금,2419,2392,4811
<class,4호선,수유,15490,15088,30578
<class,4호선,미아,6312,6116,12428
<class,4호선,미아사거리,12883,12483,25366
<class,4호선,길음,7873,7812,15685
<class,4호선,성신여대입구,10266,9930,20196
<class,4호선,한성대입구,5926,6084,12010
<class,4호선,혜화,16445,16846,33291
<class,4호선,동대문,4164,4849,9013
<class,4호선,동대문역사문화공원,5994,5773,11767
<class,4호선,충무로,6452,6542,12994
<class,4호선,명동,7055,6842,13897
<class,4호선,회현,6315,6230,12545
<class,4호선,서울역,3097,7099,10196
<class,4호선,숙대입구,5710,5483,11193
<class,4호선,삼각지,1680,2127,3807
<class,4호선,신용산,5806,5984,11790
<class,4호선,이촌,3525,3917,7442
<class,4호선,동작,867,908,1775
<class,4호선,총신대입구,7919,8628,16547
<class,4호선,사당,11422,10431,21853
<class,4호선,남태령,440,407,847
<class,4호선,당고개,5641,5556,11197
<class,4호선,상계,7801,7404,15205
<class,4호선,노원,9528,10053,19581
<class,4호선,창동,10926,11633,22559
<class,4호선,쌍문,12484,11462,23946
<class,5호선,방화,2791,2876,5667
<class,5호선,개화산,2096,2167,4263
<class,5호선,김포공항,6231,5595,11826
<class,5호선,송정,3028,3021,6049
<class,5호선,마곡,2917,3050,5967
<class,5호선,발산,7347,7802,15149
<class,5호선,우장산,5204,5342,10546
<class,5호선,화곡,11022,10517,21539
<class,5호선,까치산,12310,12113,24423
<class,5호선,신정,5157,4805,9962
<class,5호선,목동,6087,6347,12434
<class,5호선,오목교,9483,9696,19179
<class,5호선,양평,2167,2265,4432
<class,5호선,영등포구청,1022,976,1998
<class,5호선,영등포시장,3609,3812,7421
<class,5호선,신길,1497,1756,3253
<class,5호선,여의도,7589,7023,14612
<class,5호선,여의나루,3672,5756,9428
<class,5호선,마포,3915,4033,7948
<class,5호선,공덕,3613,3786,7399
<class,5호선,애오개,2300,2290,4590
<class,5호선,충정로,1169,1181,2350
<class,5호선,서대문,3823,3838,7661
<class,5호선,광화문,7876,7929,15805
<class,5호선,종로3가,6377,5601,11978
<class,5호선,을지로4가,1079,1133,2212
<class,5호선,동대문역사문화공원,564,618,1182
<class,5호선,청구,1474,1360,2834
<class,5호선,신금호,2206,2451,4657
<class,5호선,행당,2969,2783,5752
<class,5호선,왕십리,1975,2234,4209
<class,5호선,마장,2416,2344,4760
<class,5호선,답십리,5740,5540,11280
<class,5호선,장한평,5843,5902,11745
<class,5호선,군자,4717,5348,10065
<class,5호선,아차산,6992,6981,13973
<class,5호선,광나루,5123,4646,9769
<class,5호선,천호,9994,8936,18930
<class,5호선,강동,7313,7418,14731
<class,5호선,길동,3366,3509,6875
<class,5호선,굽은다리,4337,4116,8453
<class,5호선,명일,3764,3765,7529
<class,5호선,고덕,3449,3438,6887
<class,5호선,상일동,5524,5346,10870
<class,5호선,둔촌동,3797,3852,7649
<class,5호선,올림픽공원,1435,1293,2728
<class,5호선,방이,3443,3307,6750
<class,5호선,오금,1381,1216,2597
<class,5호선,개롱,2244,2553,4797
<class,5호선,거여,2937,2930,5867
<class,5호선,마천,2470,2727,5197
<class,5호선,강일,1176,1241,2417
<class,5호선,미사,6084,6014,12098
<class,5호선,하남풍산,1682,1721,3403
<class,5호선,하남시청,2343,2406,4749
<class,5호선,하남검단산,2557,2632,5189
<class,6호선,응암,7222,7400,14622
<class,6호선,역촌,1621,1881,3502
<class,6호선,불광,2330,2029,4359
<class,6호선,독바위,1144,1233,2377
<class,6호선,구산,3026,2446,5472
<class,6호선,새절,4969,5037,10006
<class,6호선,증산,4358,4589,8947
<class,6호선,디지털미디어시티,3932,4164,8096
<class,6호선,월드컵경기장,2119,2205,4324
<class,6호선,마포구청,5424,5270,10694
<class,6호선,망원,7029,7497,14526
<class,6호선,합정,7162,6222,13384
<class,6호선,상수,4885,5411,10296
<class,6호선,광흥창,3376,3172,6548
<class,6호선,대흥,2906,3026,5932
<class,6호선,공덕,5356,5037,10393
<class,6호선,효창공원앞,2551,2428,4979
<class,6호선,삼각지,2578,2092,4670
<class,6호선,녹사평,2741,2725,5466
<class,6호선,이태원,6622,6175,12797
<class,6호선,한강진,3645,4214,7859
<class,6호선,약수,1379,1355,2734
<class,6호선,청구,1295,1337,2632
<class,6호선,신당,3116,3895,7011
<class,6호선,동묘앞,3391,3631,7022
<class,6호선,창신,1439,1303,2742
<class,6호선,보문,3291,2980,6271
<class,6호선,안암,4522,4876,9398
<class,6호선,고려대,3397,3327,6724
<class,6호선,월곡,4180,4339,8519
<class,6호선,상월곡,2539,2325,4864
<class,6호선,돌곶이,3908,3788,7696
<class,6호선,석계,5139,5252,10391
<class,6호선,태릉입구,2487,2653,5140
<class,6호선,화랑대,4008,3464,7472
<class,6호선,봉화산,3070,2961,6031
<class,7호선,장암,776,458,1234
<class,7호선,도봉산,3317,4465,7782
<class,7호선,수락산,5644,5576,11220
<class,7호선,마들,4804,4582,9386
<class,7호선,노원,8652,8587,17239
<class,7호선,중계,5330,5108,10438
<class,7호선,하계,7149,6780,13929
<class,7호선,공릉,5220,5398,10618
<class,7호선,태릉입구,3868,3660,7528
<class,7호선,먹골,4297,4240,8537
<class,7호선,중화,4661,4537,9198
<class,7호선,상봉,7622,7164,14786
<class,7호선,면목,6288,6384,12672
<class,7호선,사가정,7039,7105,14144
<class,7호선,용마산,2702,2803,5505
<class,7호선,중곡,4019,3951,7970
<class,7호선,군자,6097,4988,11085
<class,7호선,어린이대공원,6077,5943,12020
<class,7호선,건대입구,6619,6910,13529
<class,7호선,뚝섬유원지,3230,3238,6468
<class,7호선,청담,5666,5963,11629
<class,7호선,강남구청,4551,4887,9438
<class,7호선,학동,4477,4827,9304
<class,7호선,논현,5234,5646,10880
<class,7호선,반포,2419,2488,4907
<class,7호선,고속터미널,10365,6643,17008
<class,7호선,내방,4186,4476,8662
<class,7호선,이수,6623,6409,13032
<class,7호선,남성,4282,4305,8587
<class,7호선,숭실대입구,4573,4797,9370
<class,7호선,상도,4428,4369,8797
<class,7호선,장승배기,3950,3866,7816
<class,7호선,신대방삼거리,6272,6148,12420
<class,7호선,보라매,3335,3353,6688
<class,7호선,신풍,5016,4896,9912
<class,7호선,대림,5880,5453,11333
<class,7호선,남구로,5914,5732,11646
<class,7호선,가산디지털단지,8391,7547,15938
<class,7호선,철산,8358,8240,16598
<class,7호선,광명사거리,9939,9692,19631
<class,7호선,천왕,3822,3747,7569
<class,7호선,온수,3027,3054,6081
<class,7호선,까치울,3076,3115,6191
<class,7호선,부천종합운동장,1724,1508,3232
<class,7호선,춘의,2701,2606,5307
<class,7호선,신중동,5332,5357,10689
<class,7호선,부천시청,5367,5222,10589
<class,7호선,상동,5620,5391,11011
<class,7호선,삼산체육관,1808,1775,3583
<class,7호선,굴포천,3746,3826,7572
<class,7호선,부평구청,4104,3666,7770
<class,8호선,암사,7177,6950,14127
<class,8호선,천호,7268,8413,15681
<class,8호선,강동구청,3562,3752,7314
<class,8호선,몽촌토성,2298,2387,4685
<class,8호선,잠실,8155,8910,17065
<class,8호선,석촌,3407,4098,7505
<class,8호선,송파,2914,3087,6001
<class,8호선,가락시장,2659,3356,6015
<class,8호선,문정,4594,4892,9486
<class,8호선,장지,7539,7639,15178
<class,8호선,복정,3925,3741,7666
<class,8호선,산성,2511,2675,5186
<class,8호선,남한산성입구,4954,4741,9695
<class,8호선,단대오거리,4239,4225,8464
<class,8호선,신흥,2274,2525,4799
<class,8호선,수진,2453,2311,4764
<class,8호선,모란,1980,1699,3679
<class,9호선,개화,794,734,1528
<class,9호선,김포공항,6814,10084,16898
<class,9호선,공항시장,1442,1595,3037
<class,9호선,신방화,2948,2899,5847
<class,9호선,마곡나루,4122,4085,8207
<class,9호선,양천향교,3430,3761,7191
<class,9호선,가양,7833,7913,15746
<class,9호선,증미,2416,2525,4941
<class,9호선,등촌,4054,4150,8204
<class,9호선,염창,6536,6629,13165
<class,9호선,신목동,1263,1197,2460
<class,9호선,선유도,2211,2233,4444
<class,9호선,당산,7258,7045,14303
<class,9호선,국회의사당,3773,3439,7212
<class,9호선,여의도,8185,6644,14829
<class,9호선,샛강,1356,1375,2731
<class,9호선,노량진,11789,12315,24104
<class,9호선,노들,1863,1646,3509
<class,9호선,흑석,3105,3350,6455
<class,9호선,동작,832,614,1446
<class,9호선,구반포,1093,1208,2301
<class,9호선,신반포,1134,1254,2388
<class,9호선,고속터미널,7970,11277,19247
<class,9호선,사평,1123,1261,2384
<class,9호선,신논현,12667,12113,24780
<class,9호선2~3단계,언주,3009,3020,6029
<class,9호선2~3단계,선정릉,2414,2692,5106
<class,9호선2~3단계,삼성중앙,1620,1718,3338
<class,9호선2~3단계,봉은사,7061,6988,14049
<class,9호선2~3단계,종합운동장,1629,1449,3078
<class,9호선2~3단계,삼전,2763,2911,5674
<class,9호선2~3단계,석촌고분,2485,2511,4996
<class,9호선2~3단계,석촌,3400,3016,6416
<class,9호선2~3단계,송파나루,2474,2535,5009
<class,9호선2~3단계,한성백제,1067,955,2022
<class,9호선2~3단계,올림픽공원,2021,2011,4032
<class,9호선2~3단계,둔촌오륜,345,361,706
<class,9호선2~3단계,중앙보훈병원,2599,2518,5117
<class,경강선,판교,1808,1619,3427
<class,경강선,이매,480,353,833
<class,경강선,삼동,776,782,1558
<class,경강선,경기광주,2786,2854,5640
<class,경강선,초월,1190,1243,2433
<class,경강선,곤지암,1103,1207,2310
<class,경강선,신둔도예촌,673,699,1372
<class,경강선,이천,1561,1709,3270
<class,경강선,부발,904,1460,2364
<class,경강선,세종대왕릉,157,144,301
<class,경강선,여주,1481,1409,2890
<class,경부선,서울역,6182,1333,7515
<class,경부선,남영,3321,3654,6975
<class,경부선,용산,26320,23044,49364
<class,경부선,노량진,4001,4104,8105
<class,경부선,대방,4541,5133,9674
<class,경부선,영등포,26785,25218,52003
<class,경부선,신도림,1427,1708,3135
<class,경부선,신길,4114,3679,7793
<class,경부선,구로,7983,8016,15999
<class,경부선,가산디지털단지,3380,4919,8299
<class,경부선,금천구청,4487,4670,9157
<class,경부선,석수,3838,3365,7203
<class,경부선,관악,3131,3047,6178
<class,경부선,안양,10758,10471,21229
<class,경부선,명학,2806,2707,5513
<class,경부선,금정,10428,10898,21326
<class,경부선,군포,2343,2271,4614
<class,경부선,의왕,3228,3249,6477
<class,경부선,성균관대,5898,6422,12320
<class,경부선,화서,2828,2837,5665
<class,경부선,수원,27897,26509,54406
<class,경부선,독산,4705,4881,9586
<class,경부선,세류,1607,1651,3258
<class,경부선,병점,7256,8149,15405
<class,경부선,세마,1304,1250,2554
<class,경부선,오산대,1542,1507,3049
<class,경부선,오산,6087,6640,12727
<class,경부선,진위,599,590,1189
<class,경부선,송탄,2758,3201,5959
<class,경부선,서정리,3133,4527,7660
<class,경부선,평택지제,1856,1649,3505
<class,경부선,평택,8954,9735,18689
<class,경부선,성환,1964,2471,4435
<class,경부선,직산,408,458,866
<class,경부선,두정,3713,4111,7824
<class,경부선,천안,4935,4642,9577
<class,경부선,당정,2309,2359,4668
<class,경부선,서동탄,628,637,1265
<class,경부선,광명,2174,1441,3615
<class,경원선,이촌,1576,1280,2856
<class,경원선,서빙고,1076,1075,2151
<class,경원선,한남,1461,1457,2918
<class,경원선,옥수,45,20,65
<class,경원선,응봉,702,689,1391
<class,경원선,왕십리,7505,8650,16155
<class,경원선,청량리,11216,10154,21370
<class,경원선,외대앞,3950,3868,7818
<class,경원선,신이문,3746,3526,7272
<class,경원선,석계,3559,3997,7556
<class,경원선,광운대,3536,3588,7124
<class,경원선,월계,2680,2626,5306
<class,경원선,녹천,2022,1693,3715
<class,경원선,방학,4360,4321,8681
<class,경원선,도봉,2553,2450,5003
<class,경원선,도봉산,3880,2681,6561
<class,경원선,망월사,3662,3668,7330
<class,경원선,회룡,5334,5225,10559
<class,경원선,의정부,10353,10410,20763
<class,경원선,가능,2948,2847,5795
<class,경원선,녹양,1971,1936,3907
<class,경원선,양주,3536,3512,7048
<class,경원선,덕계,1221,1158,2379
<class,경원선,덕정,2372,2572,4944
<class,경원선,지행,3062,3078,6140
<class,경원선,동두천중앙,1412,1397,2809
<class,경원선,보산,949,1115,2064
<class,경원선,동두천,934,1161,2095
<class,경원선,소요산,1832,1496,3328
<class,경의선,서울역,856,742,1598
<class,경의선,신촌,225,197,422
<class,경의선,효창공원앞,1022,1217,2239
<class,경의선,공덕,1506,1154,2660
<class,경의선,서강대,958,938,1896
<class,경의선,홍대입구,1128,1462,2590
<class,경의선,가좌,2094,2274,4368
<class,경의선,디지털미디어시티,989,1024,2013
<class,경의선,수색,684,745,1429
<class,경의선,화전,578,666,1244
<class,경의선,강매,1055,996,2051
<class,경의선,행신,3379,3260,6639
<class,경의선,능곡,1661,1640,3301
<class,경의선,곡산,224,207,431
<class,경의선,백마,2640,2579,5219
<class,경의선,풍산,2676,2457,5133
<class,경의선,일산,3530,3382,6912
<class,경의선,탄현,3332,3112,6444
<class,경의선,야당,3181,2968,6149
<class,경의선,운정,2664,2643,5307
<class,경의선,금릉,2000,2005,4005
<class,경의선,금촌,3126,3362,6488
<class,경의선,월롱,604,1191,1795
<class,경의선,파주,437,397,834
<class,경의선,문산,2383,2504,4887
<class,경의선,임진강,5,5,10
<class,경인선,개봉,9081,9281,18362
<class,경인선,오류동,5703,5396,11099
<class,경인선,역곡,11318,11458,22776
<class,경인선,부천,17976,17415,35391
<class,경인선,송내,10388,10277,20665
<class,경인선,부평,18486,18320,36806
<class,경인선,백운,3199,3160,6359
<class,경인선,동암,7605,7560,15165
<class,경인선,주안,9627,8544,18171
<class,경인선,제물포,4289,4190,8479
<class,경인선,동인천,6795,6545,13340
<class,경인선,인천,1958,1462,3420
<class,경인선,구일,3127,3172,6299
<class,경인선,소사,4568,4377,8945
<class,경인선,부개,3703,3565,7268
<class,경인선,간석,2571,2444,5015
<class,경인선,도원,1294,1359,2653
<class,경인선,온수,2958,2759,5717
<class,경인선,중동,3956,3776,7732
<class,경인선,도화,1879,1767,3646
<class,경춘선,신내,559,596,1155
<class,경춘선,갈매,1086,937,2023
<class,경춘선,별내,1257,1212,2469
<class,경춘선,퇴계원,1561,1432,2993
<class,경춘선,사릉,1298,1254,2552
<class,경춘선,금곡,633,596,1229
<class,경춘선,평내호평,2338,2347,4685
<class,경춘선,천마산,784,711,1495
<class,경춘선,마석,1849,1774,3623
<class,경춘선,대성리,356,262,618
<class,경춘선,청평,1064,791,1855
<class,경춘선,상천,151,111,262
<class,경춘선,가평,1181,861,2042
<class,경춘선,굴봉산,90,66,156
<class,경춘선,백양리,55,43,98
<class,경춘선,강촌,330,227,557
<class,경춘선,김유정,209,204,413
<class,경춘선,남춘천,1716,1898,3614
<class,경춘선,춘천,1067,1005,2072
<class,공항철도 1호선,서울역,6406,5566,11972
<class,공항철도 1호선,공덕,1006,1317,2323
<class,공항철도 1호선,홍대입구,7225,6754,13979
<class,공항철도 1호선,디지털미디어시티,2741,2862,5603
<class,공항철도 1호선,마곡나루,1431,1624,3055
<class,공항철도 1호선,김포공항,10173,5269,15442
<class,공항철도 1호선,계양,3571,3695,7266
<class,공항철도 1호선,검암,2649,2697,5346
<class,공항철도 1호선,청라국제도시,2453,2328,4781
<class,공항철도 1호선,운서,3847,4075,7922
<class,공항철도 1호선,공항화물청사,850,945,1795
<class,공항철도 1호선,인천공항1터미널,2501,2469,4970
<class,공항철도 1호선,인천공항2터미널,1395,1367,2762
<class,공항철도 1호선,영종,1777,1683,3460
<class,과천선,선바위,2667,2567,5234
<class,과천선,경마공원,644,637,1281
<class,과천선,대공원,1311,1287,2598
<class,과천선,과천,2219,2193,4412
<class,과천선,정부과천청사,2749,2914,5663
<class,과천선,인덕원,8150,8357,16507
<class,과천선,평촌,4919,4758,9677
<class,과천선,범계,11311,10872,22183
<class,분당선,선릉,2441,3498,5939
<class,분당선,한티,7064,6633,13697
<class,분당선,도곡,2055,2106,4161
<class,분당선,구룡,506,592,1098
<class,분당선,개포동,1528,1556,3084
<class,분당선,대모산입구,1131,1107,2238
<class,분당선,수서,7296,7015,14311
<class,분당선,수원,4706,3957,8663
<class,분당선,서울숲,3310,3469,6779
<class,분당선,압구정로데오,8997,9585,18582
<class,분당선,강남구청,2585,3108,5693
<class,분당선,선정릉,1907,1919,3826
<class,분당선,가천대,3293,3950,7243
<class,분당선,태평,6575,6151,12726
<class,분당선,모란,8768,8951,17719
<class,분당선,야탑,10538,10658,21196
<class,분당선,서현,11028,10824,21852
<class,분당선,수내,4894,4883,9777
<class,분당선,정자,6042,6169,12211
<class,분당선,미금,5817,6289,12106
<class,분당선,오리,4199,3583,7782
<class,분당선,이매,2407,2551,4958
<class,분당선,보정,862,844,1706
<class,분당선,죽전,6302,7315,13617
<class,분당선,구성,1874,2013,3887
<class,분당선,신갈,1556,1597,3153
<class,분당선,기흥,4059,3889,7948
<class,분당선,상갈,2150,2310,4460
<class,분당선,청명,1534,1590,3124
<class,분당선,영통,3918,3944,7862
<class,분당선,망포,4969,5285,10254
<class,분당선,매탄권선,1898,1906,3804
<class,분당선,수원시청,6152,6143,12295
<class,분당선,매교,1255,1180,2435
<class,수인선,고색,1263,1285,2548
<class,수인선,오목천,1032,1032,2064
<class,수인선,어천,346,428,774
<class,수인선,야목,117,100,217
<class,수인선,사리,1840,1666,3506
<class,수인선,달월,34,35,69
<class,수인선,월곶,1175,1067,2242
<class,수인선,소래포구,3041,3046,6087
<class,수인선,인천논현,2297,2423,4720
<class,수인선,호구포,1467,1531,2998
<class,수인선,남동인더스파크,581,560,1141
<class,수인선,원인재,2128,2274,4402
<class,수인선,연수,2338,2246,4584
<class,수인선,송도,1062,1026,2088
<class,수인선,인하대,2554,2426,4980
<class,수인선,숭의,1421,1369,2790
<class,수인선,신포,833,738,1571
<class,수인선,인천,689,979,1668
<class,안산선,산본,6386,6749,13135
<class,안산선,대야미,1957,1907,3864
<class,안산선,상록수,7117,7032,14149
<class,안산선,한대앞,4087,4046,8133
<class,안산선,중앙,9084,8920,18004
<class,안산선,고잔,3201,3129,6330
<class,안산선,초지,1796,1742,3538
<class,안산선,안산,8031,7063,15094
<class,안산선,신길온천,790,729,1519
<class,안산선,정왕,3898,4602,8500
<class,안산선,오이도,4112,4101,8213
<class,안산선,수리산,1551,1332,2883
<class,우이신설선,북한산우이,1392,1421,2813
<class,우이신설선,솔밭공원,1008,961,1969
<class,우이신설선,4.19민주묘지,1360,1286,2646
<class,우이신설선,가오리,1740,1723,3463
<class,우이신설선,화계,1484,1383,2867
<class,우이신설선,삼양,907,963,1870
<class,우이신설선,삼양사거리,1074,1081,2155
<class,우이신설선,솔샘,2061,1915,3976
<class,우이신설선,북한산보국문,2800,2610,5410
<class,우이신설선,정릉,1961,1773,3734
<class,우이신설선,성신여대입구,1677,1990,3667
<class,우이신설선,보문,693,773,1466
<class,우이신설선,신설동,655,671,1326
<class,일산선,원흥,3930,3881,7811
<class,일산선,삼송,7998,7947,15945
<class,일산선,원당,4563,4510,9073
<class,일산선,화정,7194,7407,14601
<class,일산선,대곡,789,589,1378
<class,일산선,백석,4524,4472,8996
<class,일산선,마두,2704,2677,5381
<class,일산선,정발산,3715,3617,7332
<class,일산선,주엽,3343,3246,6589
<class,일산선,대화,4959,4481,9440
<class,장항선,봉명,394,446,840
<class,장항선,쌍용,884,1048,1932
<class,경부선,노량진,8503,7485,15988
<class,중앙선,지평,47,89,136
<class,중앙선,용문,2381,2648,5029
<class,중앙선,원덕,477,533,1010
<class,중앙선,양평,2894,3093,5987
<class,중앙선,오빈,300,322,622
<class,중앙선,아신,747,804,1551
<class,중앙선,국수,721,737,1458
<class,중앙선,신원,372,312,684
<class,중앙선,양수,2576,2574,5150
<class,중앙선,운길산,1838,1752,3590
<class,중앙선,팔당,1906,2145,4051
<class,중앙선,도심,1672,1491,3163
<class,중앙선,덕소,4781,4756,9537
<class,중앙선,양정,692,655,1347
<class,중앙선,도농,6763,6428,13191
<class,중앙선,구리,10728,11113,21841
<class,중앙선,양원,1257,1311,2568
<class,중앙선,망우,6495,6445,12940
<class,중앙선,상봉,5330,5161,10491
<class,중앙선,중랑,4824,4474,9298
<class,중앙선,회기,20019,18927,38946
<class,장항선,신창,1176,1092,2268
<class,장항선,온양온천,3427,3404,6831
<class,장항선,배방,974,917,1891
<class,장항선,아산,2679,2594,5273
<class,장항선,쌍용,1516,1410,2926
<class,장항선,봉명,737,643,1380
<class,일산선,대화,8399,7409,15808
<class,일산선,주엽,6578,6338,12916
<class,일산선,정발산,6987,7387,14374
<class,일산선,마두,5090,5145,10235
<class,일산선,백석,7382,7492,14874
<class,일산선,대곡,1363,1173,2536
<class,일산선,화정,12814,13207,26021
<class,일산선,원당,8509,8082,16591
<class,일산선,삼송,13334,13161,26495
<class,일산선,원흥,7134,6930,14064
<class,우이신설선,신설동,1514,1354,2868
<class,우이신설선,보문,1061,1069,2130
<class,우이신설선,성신여대입구,2744,3207,5951
<class,우이신설선,정릉,3538,2973,6511
<class,우이신설선,북한산보국문,4876,4318,9194
<class,우이신설선,솔샘,3774,3403,7177
<class,우이신설선,삼양사거리,1860,1892,3752
<class,우이신설선,삼양,1556,1562,3118
<class,우이신설선,화계,2534,2347,4881
<class,우이신설선,가오리,2959,2811,5770
<class,우이신설선,4.19민주묘지,2547,2173,4720
<class,우이신설선,솔밭공원,1830,1753,3583
<class,우이신설선,북한산우이,3704,3822,7526
<class,안산선,수리산,2891,2739,5630
<class,안산선,오이도,7925,8194,16119
<class,안산선,정왕,6398,6347,12745
<class,안산선,신길온천,1430,1413,2843
<class,안산선,안산,9982,10328,20310
<class,안산선,초지,3256,3291,6547
<class,안산선,고잔,6731,6617,13348
<class,안산선,중앙,15843,16432,32275
<class,안산선,한대앞,7197,7134,14331
<class,안산선,상록수,12560,12541,25101
<class,안산선,반월,3528,3225,6753
<class,안산선,대야미,4311,3712,8023
<class,안산선,산본,12305,13321,25626
<class,수인선,인천,1528,2468,3996
<class,수인선,신포,1368,1478,2846
<class,수인선,숭의,2773,2590,5363
<class,수인선,인하대,4419,4056,8475
<class,수인선,송도,2271,2217,4488
<class,수인선,연수,3881,3874,7755
<class,수인선,원인재,3725,4032,7757
<class,수인선,남동인더스파크,1069,978,2047
<class,수인선,호구포,2592,2490,5082
<class,수인선,인천논현,4475,4582,9057
<class,수인선,소래포구,6498,6542,13040
<class,수인선,월곶,2114,2045,4159
<class,수인선,달월,75,83,158
<class,수인선,사리,3267,2770,6037
<class,수인선,야목,194,189,383
<class,수인선,어천,675,643,1318
<class,수인선,오목천,1950,1680,3630
<class,수인선,고색,2388,2373,4761
<class,분당선,매교,2099,2170,4269
<class,분당선,수원시청,10941,11873,22814
<class,분당선,매탄권선,3505,3231,6736
<class,분당선,망포,9068,8351,17419
<class,분당선,영통,6520,6396,12916
<class,분당선,청명,2724,2674,5398
<class,분당선,상갈,3941,3927,7868
<class,분당선,기흥,6558,6382,12940
<class,분당선,신갈,2806,2852,5658
<class,분당선,구성,3236,3341,6577
<class,분당선,죽전,10310,11445,21755
<class,분당선,보정,1685,1531,3216
<class,분당선,이매,4061,3957,8018
<class,분당선,오리,7545,6342,13887
<class,분당선,미금,10620,11005,21625
<class,분당선,정자,10721,10998,21719
<class,분당선,수내,8455,7831,16286
<class,분당선,서현,17996,18026,36022
<class,분당선,야탑,16927,17643,34570
<class,분당선,모란,15612,15467,31079
<class,분당선,태평,10452,9829,20281
<class,분당선,가천대,5039,5575,10614
<class,분당선,선정릉,3823,3993,7816
<class,분당선,강남구청,5328,6565,11893
<class,분당선,압구정로데오,18296,20823,39119
<class,분당선,서울숲,10456,11425,21881
<class,분당선,수원,7600,6333,13933
<class,분당선,복정,1,0,1
<class,분당선,수서,9880,10152,20032
<class,분당선,대모산입구,2531,2345,4876
<class,분당선,개포동,2671,2611,5282
<class,분당선,구룡,1270,1177,2447
<class,분당선,도곡,4426,4022,8448
<class,분당선,한티,11273,11060,22333
<class,분당선,선릉,5080,7782,12862
<class,과천선,범계,19993,19523,39516
<class,과천선,평촌,9302,9060,18362
<class,과천선,인덕원,15305,14921,30226
<class,과천선,정부과천청사,6024,5948,11972
<class,과천선,과천,4507,3874,8381
<class,과천선,대공원,8600,8978,17578
<class,과천선,경마공원,1147,1084,2231
<class,과천선,선바위,5456,4700,10156
<class,공항철도 1호선,영종,2884,2930,5814
<class,공항철도 1호선,인천공항2터미널,1553,1458,3011
<class,공항철도 1호선,인천공항1터미널,2961,3196,6157
<class,공항철도 1호선,공항화물청사,1345,1403,2748
<class,공항철도 1호선,운서,5533,5773,11306
<class,공항철도 1호선,청라국제도시,4099,4045,8144
<class,공항철도 1호선,검암,4669,4820,9489
<class,공항철도 1호선,계양,6718,6081,12799
<class,공항철도 1호선,김포공항,11009,5766,16775
<class,공항철도 1호선,마곡나루,3447,3833,7280
<class,공항철도 1호선,디지털미디어시티,5373,4942,10315
<class,공항철도 1호선,홍대입구,12003,11680,23683
<class,공항철도 1호선,공덕,1496,2210,3706
<class,공항철도 1호선,서울역,6680,6884,13564
<class,경춘선,춘천,2054,1875,3929
<class,경춘선,남춘천,3178,3452,6630
<class,경춘선,김유정,680,704,1384
<class,경춘선,강촌,817,846,1663
<class,경춘선,백양리,170,171,341
<class,경춘선,굴봉산,253,285,538
<class,경춘선,가평,1966,2378,4344
<class,경춘선,상천,475,393,868
<class,경춘선,청평,1869,2053,3922
<class,경춘선,대성리,790,765,1555
<class,경춘선,마석,3301,3250,6551
<class,경춘선,천마산,1460,1477,2937
<class,경춘선,평내호평,4846,4769,9615
<class,경춘선,금곡,1209,1131,2340
<class,경춘선,사릉,2449,2394,4843
<class,경춘선,퇴계원,2817,2558,5375
<class,경춘선,별내,2352,2298,4650
<class,경춘선,갈매,1951,1739,3690
<class,경춘선,신내,1243,1192,2435
<class,경인선,도화,3380,3121,6501
<class,경인선,중동,6718,6375,13093
<class,경인선,온수,5176,4735,9911
<class,경인선,도원,2230,2241,4471
<class,경인선,간석,4455,4276,8731
<class,경인선,부개,6286,5857,12143
<class,경인선,소사,7971,7830,15801
<class,경인선,구일,5442,5152,10594
<class,경인선,인천,5319,4710,10029
<class,경인선,동인천,12026,11923,23949
<class,경인선,제물포,7852,7445,15297
<class,경인선,주안,15714,13764,29478
<class,경인선,동암,12647,12857,25504
<class,경인선,백운,5494,5446,10940
<class,경인선,부평,30177,32286,62463
<class,경인선,송내,18280,17960,36240
<class,경인선,부천,28885,29627,58512
<class,경인선,역곡,20388,19922,40310
<class,경인선,오류동,9305,8501,17806
<class,경인선,개봉,16651,16336,32987
<class,경의선,임진강,133,116,249
<class,경의선,문산,4535,4474,9009
<class,경의선,파주,924,735,1659
<class,경의선,월롱,1312,1266,2578
<class,경의선,금촌,5420,5083,10503
<class,경의선,금릉,3737,3606,7343
<class,경의선,운정,4830,4610,9440
<class,경의선,야당,5298,5210,10508
<class,경의선,탄현,5333,5195,10528
<class,경의선,일산,6213,5981,12194
<class,경의선,풍산,4339,4085,8424
<class,경의선,백마,4529,4336,8865
<class,경의선,곡산,400,439,839
<class,경의선,능곡,2856,2815,5671
<class,경의선,행신,5171,5224,10395
<class,경의선,강매,2090,1894,3984
<class,경의선,화전,1238,1139,2377
<class,경의선,수색,1455,1411,2866
<class,경의선,디지털미디어시티,1909,1717,3626
<class,경의선,가좌,4100,3717,7817
<class,경의선,홍대입구,2011,2353,4364
<class,경의선,서강대,1703,1621,3324
<class,경의선,공덕,2546,2037,4583
<class,경의선,효창공원앞,1770,1890,3660
<class,경의선,신촌,348,346,694
<class,경의선,서울역,1308,1446,2754
<class,경원선,소요산,4654,4078,8732
<class,경원선,동두천,1641,2121,3762
<class,경원선,보산,1823,1696,3519
<class,경원선,동두천중앙,2492,2516,5008
<class,경원선,지행,5407,5382,10789
<class,경원선,덕정,4576,4313,8889
<class,경원선,덕계,2331,2054,4385
<class,경원선,양주,6440,6293,12733
<class,경원선,녹양,3535,3360,6895
<class,경원선,가능,5266,4932,10198
<class,경원선,의정부,16808,17888,34696
<class,경원선,회룡,9776,9673,19449
<class,경원선,망월사,5644,5830,11474
<class,경원선,도봉산,10485,7485,17970
<class,경원선,도봉,4623,4373,8996
<class,경원선,방학,7462,7156,14618
<class,경원선,녹천,3480,2833,6313
<class,경원선,월계,4827,4411,9238
<class,경원선,광운대,5876,5837,11713
<class,경원선,석계,6733,7208,13941
<class,경원선,신이문,6200,5681,11881
<class,경원선,외대앞,6427,6125,12552
<class,경원선,청량리,15426,16939,32365
<class,경원선,왕십리,12008,13519,25527
<class,경원선,응봉,1552,1341,2893
<class,경원선,옥수,38,29,67
<class,경원선,한남,2948,2752,5700
<class,경원선,서빙고,1426,1316,2742
<class,경원선,이촌,3542,2380,5922
<class,경부선,광명,2662,2494,5156
<class,경부선,서동탄,1074,1117,2191
<class,경부선,당정,4072,3854,7926
<class,경부선,천안,6347,6397,12744
<class,경부선,두정,5330,5537,10867
<class,경부선,직산,666,647,1313
<class,경부선,성환,2853,2658,5511
<class,경부선,평택,13225,12499,25724
<class,경부선,평택지제,2634,2458,5092
<class,경부선,서정리,6090,5320,11410
<class,경부선,송탄,4647,4314,8961
<class,경부선,진위,979,918,1897
<class,경부선,오산,9168,8598,17766
<class,경부선,오산대,3039,2742,5781
<class,경부선,세마,2218,1922,4140
<class,경부선,병점,11936,11954,23890
<class,경부선,세류,2437,2473,4910
<class,경부선,독산,8635,8581,17216
<class,경부선,수원,37235,39792,77027
<class,경부선,화서,5263,5242,10505
<class,경부선,성균관대,10294,10355,20649
<class,경부선,의왕,6093,5857,11950
<class,경부선,군포,4418,4127,8545
<class,경부선,금정,18453,18060,36513
<class,경부선,명학,5458,5234,10692
<class,경부선,안양,17905,18024,35929
<class,경부선,관악,6257,5896,12153
<class,경부선,석수,7318,7042,14360
<class,경부선,금천구청,8496,8430,16926
<class,경부선,가산디지털단지,6137,8217,14354
<class,경부선,구로,13141,13564,26705
<class,경부선,신길,6308,5315,11623
<class,경부선,신도림,3135,3201,6336
<class,경부선,영등포,36368,37825,74193
<class,경부선,대방,7816,7774,15590
<class,경부선,용산,31549,34026,65575
<class,경부선,남영,5806,5944,11750
<class,경부선,서울역,5776,1550,7326
<class,경강선,여주,2242,2530,4772
<class,경강선,세종대왕릉,262,381,643
<class,경강선,부발,1712,1534,3246
<class,경강선,이천,2585,2768,5353
<class,경강선,신둔도예촌,1052,1043,2095
<class,경강선,곤지암,1916,2054,3970
<class,경강선,초월,2083,1970,4053
<class,경강선,경기광주,5059,4740,9799
<class,경강선,삼동,1466,1334,2800
<class,경강선,이매,908,647,1555
<class,경강선,판교,2878,2627,5505
<class,9호선2~3단계,중앙보훈병원,4551,4299,8850
<class,9호선2~3단계,둔촌오륜,716,647,1363
<class,9호선2~3단계,올림픽공원,4794,4980,9774
<class,9호선2~3단계,한성백제,1942,1699,3641
<class,9호선2~3단계,송파나루,3794,4292,8086
<class,9호선2~3단계,석촌,6358,5526,11884
<class,9호선2~3단계,석촌고분,4008,3756,7764
<class,9호선2~3단계,삼전,4749,4377,9126
<class,9호선2~3단계,종합운동장,3324,2923,6247
<class,9호선2~3단계,봉은사,9187,9495,18682
<class,9호선2~3단계,삼성중앙,3020,3069,6089
<class,9호선2~3단계,선정릉,5204,5712,10916
<class,9호선2~3단계,언주,6002,6069,12071
<class,9호선,신논현,25075,24921,49996
<class,9호선,사평,2052,1994,4046
<class,9호선,고속터미널,12453,17656,30109
<class,9호선,신반포,2704,2653,5357
<class,9호선,구반포,2089,2191,4280
<class,9호선,동작,1831,1481,3312
<class,9호선,흑석,5747,5525,11272
<class,9호선,노들,3381,2959,6340
<class,9호선,노량진,20556,19962,40518
<class,9호선,샛강,2628,2535,5163
<class,9호선,여의도,12291,11690,23981
<class,9호선,국회의사당,4135,4437,8572
<class,9호선,당산,12360,11579,23939
<class,9호선,선유도,4388,4372,8760
<class,9호선,신목동,2520,2107,4627
<class,9호선,염창,11604,10704,22308
<class,9호선,등촌,7323,6864,14187
<class,9호선,증미,4160,4016,8176
<class,9호선,가양,14097,13620,27717
<class,9호선,양천향교,5887,5656,11543
<class,9호선,마곡나루,8137,8085,16222
<class,9호선,신방화,4574,4376,8950
<class,9호선,공항시장,2158,2268,4426
<class,9호선,김포공항,8660,12264,20924
<class,9호선,개화,1398,1287,2685
<class,8호선,모란,3534,3036,6570
<class,8호선,수진,4008,3659,7667
<class,8호선,신흥,3646,3904,7550
<class,8호선,단대오거리,7468,6838,14306
<class,8호선,남한산성입구,9173,8330,17503
<class,8호선,산성,4825,4843,9668
<class,8호선,복정,7151,6190,13341
<class,8호선,장지,12354,11391,23745
<class,8호선,문정,8394,8628,17022
<class,8호선,가락시장,5383,5420,10803
<class,8호선,송파,5254,5209,10463
<class,8호선,석촌,5553,6931,12484
<class,8호선,잠실,12045,13838,25883
<class,8호선,몽촌토성,4623,4552,9175
<class,8호선,강동구청,5915,6109,12024
<class,8호선,천호,11798,13882,25680
<class,8호선,암사,12339,11267,23606
<class,7호선,부평구청,6135,4887,11022
<class,7호선,굴포천,6747,6806,13553
<class,7호선,삼산체육관,3768,3520,7288
<class,7호선,상동,10527,10781,21308
<class,7호선,부천시청,9773,9587,19360
<class,7호선,신중동,9747,9673,19420
<class,7호선,춘의,5292,5155,10447
<class,7호선,부천종합운동장,3322,3064,6386
<class,7호선,까치울,5747,5692,11439
<class,7호선,온수,5758,5625,11383
<class,7호선,천왕,7020,6726,13746
<class,7호선,광명사거리,16815,16556,33371
<class,7호선,철산,15556,15577,31133
<class,7호선,가산디지털단지,14899,13774,28673
<class,7호선,남구로,8505,8821,17326
<class,7호선,대림,6930,7465,14395
<class,7호선,신풍,8232,7947,16179
<class,7호선,보라매,5857,5738,11595
<class,7호선,신대방삼거리,11028,10163,21191
<class,7호선,장승배기,6992,6571,13563
<class,7호선,상도,7357,7045,14402
<class,7호선,숭실대입구,8063,8215,16278
<class,7호선,이수,11724,11058,22782
<class,7호선,내방,7933,7982,15915
<class,7호선,고속터미널,13406,10713,24119
<class,7호선,반포,4425,4161,8586
<class,7호선,논현,11535,12298,23833
<class,7호선,학동,11007,11676,22683
<class,7호선,강남구청,9940,10749,20689
<class,7호선,청담,11267,12087,23354
<class,7호선,뚝섬유원지,12770,12383,25153
<class,7호선,건대입구,10646,11042,21688
<class,7호선,어린이대공원,10303,10011,20314
<class,7호선,군자,10734,7941,18675
<class,7호선,중곡,6691,6455,13146
<class,7호선,용마산,4985,5157,10142
<class,7호선,사가정,12679,12203,24882
<class,7호선,면목,11206,10869,22075
<class,7호선,상봉,13375,12761,26136
<class,7호선,중화,8529,7996,16525
<class,7호선,먹골,8413,7944,16357
<class,7호선,태릉입구,8906,8866,17772
<class,7호선,공릉,8877,8823,17700
<class,7호선,하계,12446,11691,24137
<class,7호선,중계,9560,8556,18116
<class,7호선,노원,15681,16268,31949
<class,7호선,마들,8917,8348,17265
<class,7호선,수락산,10781,10541,21322
<class,7호선,도봉산,7336,10081,17417
<class,7호선,장암,1747,1349,3096
<class,6호선,신내,1,0,1
<class,6호선,봉화산,5398,5198,10596
<class,6호선,화랑대,6952,5851,12803
<class,6호선,태릉입구,5755,6779,12534
<class,6호선,석계,8959,8877,17836
<class,6호선,돌곶이,6128,5683,11811
<class,6호선,상월곡,4274,3639,7913
<class,6호선,월곡,7531,7407,14938
<class,6호선,고려대,5864,5437,11301
<class,6호선,안암,6990,6672,13662
<class,6호선,보문,5148,4525,9673
<class,6호선,창신,2175,1822,3997
<class,6호선,동묘앞,8260,7764,16024
<class,6호선,신당,5292,4475,9767
<class,6호선,청구,2383,2479,4862
<class,6호선,약수,2390,2370,4760
<class,6호선,버티고개,1570,1686,3256
<class,6호선,한강진,7998,9617,17615
<class,6호선,이태원,11904,12697,24601
<class,6호선,녹사평,5821,6045,11866
<class,6호선,삼각지,5125,3890,9015
<class,6호선,효창공원앞,4718,4055,8773
<class,6호선,공덕,10021,9331,19352
<class,6호선,대흥,5369,5305,10674
<class,6호선,광흥창,5272,4836,10108
<class,6호선,상수,7467,8777,16244
<class,6호선,합정,12170,11110,23280
<class,6호선,망원,13271,15098,28369
<class,6호선,마포구청,9466,8345,17811
<class,6호선,월드컵경기장,5309,5456,10765
<class,6호선,디지털미디어시티,7172,7499,14671
<class,6호선,증산,7417,7303,14720
<class,6호선,새절,8774,8359,17133
<class,6호선,구산,5539,4101,9640
<class,6호선,독바위,2109,2507,4616
<class,6호선,불광,3916,3720,7636
<class,6호선,역촌,2531,3005,5536
<class,6호선,응암,12710,12318,25028
<class,5호선,하남검단산,5383,5330,10713
<class,5호선,하남시청,4373,4320,8693
<class,5호선,하남풍산,2782,2781,5563
<class,5호선,미사,11102,10967,22069
<class,5호선,강일,2453,2301,4754
<class,5호선,마천,4631,4747,9378
<class,5호선,거여,5383,5071,10454
<class,5호선,개롱,4499,4731,9230
<class,5호선,오금,2244,2055,4299
<class,5호선,방이,5247,5023,10270
<class,5호선,올림픽공원,3286,3063,6349
<class,5호선,둔촌동,6168,6143,12311
<class,5호선,상일동,9920,9195,19115
<class,5호선,고덕,6352,6313,12665
<class,5호선,명일,6063,6091,12154
<class,5호선,굽은다리,7191,6631,13822
<class,5호선,길동,5940,6040,11980
<class,5호선,강동,12588,11888,24476
<class,5호선,천호,16640,15860,32500
<class,5호선,광나루,10289,9990,20279
<class,5호선,아차산,14066,13813,27879
<class,5호선,군자,8404,9034,17438
<class,5호선,장한평,10955,10672,21627
<class,5호선,답십리,10169,9212,19381
<class,5호선,마장,3773,3564,7337
<class,5호선,왕십리,3358,3917,7275
<class,5호선,행당,5868,5183,11051
<class,5호선,신금호,4246,4177,8423
<class,5호선,청구,2460,2157,4617
<class,5호선,동대문역사문화공원,988,1326,2314
<class,5호선,을지로4가,3415,3733,7148
<class,5호선,종로3가,12269,12577,24846
<class,5호선,광화문,14814,15360,30174
<class,5호선,서대문,7316,7117,14433
<class,5호선,충정로,2083,1877,3960
<class,5호선,애오개,3758,3702,7460
<class,5호선,공덕,7375,7425,14800
<class,5호선,마포,7388,7297,14685
<class,5호선,여의나루,16383,18123,34506
<class,5호선,여의도,11609,12241,23850
<class,5호선,신길,2490,2613,5103
<class,5호선,영등포시장,6872,7390,14262
<class,5호선,영등포구청,2014,1939,3953
<class,5호선,양평,3813,3569,7382
<class,5호선,오목교,16810,17327,34137
<class,5호선,목동,11461,11671,23132
<class,5호선,신정,8989,7516,16505
<class,5호선,까치산,20971,20002,40973
<class,5호선,화곡,20218,18435,38653
<class,5호선,우장산,9888,9767,19655
<class,5호선,발산,13580,14516,28096
<class,5호선,마곡,5229,5307,10536
<class,5호선,송정,5129,4912,10041
<class,5호선,김포공항,7369,7294,14663
<class,5호선,개화산,3738,3790,7528
<class,5호선,방화,4800,4555,9355
<class,4호선,쌍문,21215,19116,40331
<class,4호선,창동,19355,20387,39742
<class,4호선,노원,15647,17175,32822
<class,4호선,상계,13815,12820,26635
<class,4호선,당고개,10054,9388,19442
<class,4호선,남태령,928,675,1603
<class,4호선,사당,20189,16923,37112
<class,4호선,총신대입구,14312,15435,29747
<class,4호선,동작,2779,2829,5608
<class,4호선,이촌,6680,7796,14476
<class,4호선,신용산,9390,10342,19732
<class,4호선,삼각지,2905,3889,6794
<class,4호선,숙대입구,8891,8402,17293
<class,4호선,서울역,4882,11370,16252
<class,4호선,회현,17221,18720,35941
<class,4호선,명동,12765,14621,27386
<class,4호선,충무로,13645,14242,27887
<class,4호선,동대문역사문화공원,10838,9117,19955
<class,4호선,동대문,14785,14779,29564
<class,4호선,혜화,25545,26587,52132
<class,4호선,한성대입구,10542,10291,20833
<class,4호선,성신여대입구,16407,15320,31727
<class,4호선,길음,14142,13207,27349
<class,4호선,미아사거리,21703,20710,42413
<class,4호선,미아,10817,10153,20970
<class,4호선,수유,25859,25144,51003
<class,3호선,오금,3821,3622,7443
<class,3호선,경찰병원,3953,3864,7817
<class,3호선,가락시장,5795,5567,11362
<class,3호선,수서,12649,13162,25811
<class,3호선,일원,4551,4473,9024
<class,3호선,대청,5771,5358,11129
<class,3호선,학여울,1509,1518,3027
<class,3호선,대치,9226,8303,17529
<class,3호선,도곡,3572,3593,7165
<class,3호선,매봉,6280,5988,12268
<class,3호선,양재,19637,21268,40905
<class,3호선,남부터미널,21171,21894,43065
<class,3호선,교대,6670,4058,10728
<class,3호선,고속터미널,46561,46326,92887
<class,3호선,잠원,3810,3589,7399
<class,3호선,신사,23980,25117,49097
<class,3호선,압구정,24826,26093,50919
<class,3호선,옥수,7236,7235,14471
<class,3호선,금호,6007,5509,11516
<class,3호선,약수,9059,8500,17559
<class,3호선,동대입구,6313,7116,13429
<class,3호선,충무로,1,0,1
<class,3호선,을지로3가,5365,5880,11245
<class,3호선,종로3가,5806,8046,13852
<class,3호선,안국,13829,16367,30196
<class,3호선,경복궁,16061,17436,33497
<class,3호선,독립문,5923,6525,12448
<class,3호선,무악재,2681,2781,5462
<class,3호선,홍제,13182,12317,25499
<class,3호선,녹번,10065,8636,18701
<class,3호선,불광,12984,14691,27675
<class,3호선,연신내,29889,27931,57820
<class,3호선,구파발,15198,15288,30486
<class,3호선,지축,2715,2665,5380
<class,2호선,용두,1767,1709,3476
<class,2호선,신정네거리,7173,7319,14492
<class,2호선,양천구청,4838,4883,9721
<class,2호선,도림천,826,826,1652
<class,2호선,신설동,3254,3206,6460
<class,2호선,신답,1065,1064,2129
<class,2호선,용답,2109,1954,4063
<class,2호선,충정로,5738,6206,11944
<class,2호선,아현,7480,7005,14485
<class,2호선,이대,9929,10348,20277
<class,2호선,신촌,28809,29040,57849
<class,2호선,홍대입구,59823,65000,124823
<class,2호선,합정,27087,28934,56021
<class,2호선,당산,13372,14647,28019
<class,2호선,영등포구청,12175,12603,24778
<class,2호선,문래,12418,13482,25900
<class,2호선,신도림,40133,40205,80338
<class,2호선,대림,18561,19678,38239
<class,2호선,구로디지털단지,33083,31922,65005
<class,2호선,신대방,19899,19196,39095
<class,2호선,신림,48497,46410,94907
<class,2호선,봉천,17041,15470,32511
<class,2호선,서울대입구,37261,36296,73557
<class,2호선,낙성대,21243,19628,40871
<class,2호선,사당,28353,32078,60431
<class,2호선,방배,9835,10158,19993
<class,2호선,서초,10501,8970,19471
<class,2호선,교대,16880,19070,35950
<class,2호선,강남,59531,58745,118276
<class,2호선,역삼,17713,19478,37191
<class,2호선,선릉,23163,20691,43854
<class,2호선,삼성,24719,25095,49814
<class,2호선,종합운동장,5976,6435,12411
<class,2호선,잠실새내,16232,17006,33238
<class,2호선,잠실,60196,57466,117662
<class,2호선,잠실나루,7353,7293,14646
<class,2호선,강변,25788,26345,52133
<class,2호선,구의,15916,15443,31359
<class,2호선,건대입구,34315,36168,70483
<class,2호선,성수,17944,20555,38499
<class,2호선,뚝섬,15432,15554,30986
<class,2호선,한양대,4087,4156,8243
<class,2호선,왕십리,12881,10740,23621
<class,2호선,상왕십리,9460,8828,18288
<class,2호선,신당,10621,10690,21311
<class,2호선,동대문역사문화공원,9173,9995,19168
<class,2호선,을지로4가,6984,7414,14398
<class,2호선,을지로3가,10815,11050,21865
<class,2호선,을지로입구,19188,19095,38283
<class,2호선,시청,8585,6979,15564
<class,1호선,청량리,18121,18710,36831
<class,1호선,제기동,15095,15440,30535
<class,1호선,동대문,11330,10625,21955
<class,1호선,종로5가,17761,17812,35573
<class,1호선,종로3가,22137,20869,43006
<class,1호선,종각,18603,16805,35408
<class,1호선,시청,10193,11218,21411
<class,1호선,동묘앞,12241,12613,24854
<class,1호선,서울역,29441,29577,59018
<class,7호선,남성,7843,7231,15074
<class,1호선,신설동,9346,8866,18212
<class,7호선,뚝섬유원지,9446,8785,18231
<class,중앙선,지평,71,44,115
<class,중앙선,용문,2440,1988,4428
<class,중앙선,원덕,485,416,901
<class,중앙선,양평,4285,3842,8127
<class,중앙선,오빈,258,245,503
<class,중앙선,아신,578,519,1097
<class,중앙선,국수,760,666,1426
<class,중앙선,신원,400,237,637
<class,중앙선,양수,2065,1990,4055
<class,중앙선,운길산,1740,1525,3265
<class,중앙선,팔당,1650,1832,3482
<class,중앙선,도심,1350,1217,2567
<class,중앙선,덕소,3438,3418,6856
<class,중앙선,양정,537,483,1020
<class,중앙선,도농,4711,4821,9532
<class,중앙선,구리,7681,8002,15683
<class,중앙선,양원,884,976,1860
<class,중앙선,망우,4567,4534,9101
<class,중앙선,상봉,4155,4047,8202
<class,중앙선,중랑,3484,3376,6860
<class,중앙선,회기,14588,14986,29574
<class,장항선,신창,987,1273,2260
<class,장항선,온양온천,2763,2696,5459
<class,장항선,배방,768,888,1656
<class,장항선,아산,2905,1989,4894
<class,장항선,쌍용,1149,1198,2347
<class,장항선,봉명,461,524,985
<class,일산선,대화,5837,5296,11133
<class,일산선,주엽,4160,4110,8270
<class,일산선,정발산,4962,4941,9903
<class,일산선,마두,3265,3247,6512
<class,일산선,백석,5305,5243,10548
<class,일산선,대곡,1062,902,1964
<class,일산선,화정,9077,9171,18248
<class,일산선,원당,6014,5847,11861
<class,일산선,삼송,9795,9675,19470
<class,일산선,원흥,5133,4910,10043
<class,우이신설선,신설동,1193,1115,2308
<class,우이신설선,보문,854,902,1756
<class,우이신설선,성신여대입구,2048,2367,4415
<class,1호선,서울역,25007,21402,46409
<class,1호선,동묘앞,12712,12977,25689
<class,1호선,시청,6858,7017,13875
<class,1호선,종각,12073,10436,22509
<class,1호선,종로3가,13297,11892,25189
<class,1호선,종로5가,8315,8399,16714
<class,1호선,동대문,9501,9989,19490
<class,1호선,신설동,6876,6842,13718
<class,1호선,제기동,9310,9676,18986
<class,1호선,청량리,12607,12384,24991
<class,2호선,시청,5321,4063,9384
<class,2호선,을지로입구,13635,12887,26522
<class,2호선,을지로3가,7149,6647,13796
<class,2호선,을지로4가,3009,3013,6022
<class,2호선,동대문역사문화공원,6916,8121,15037
<class,2호선,신당,7689,8073,15762
<class,2호선,상왕십리,6467,6343,12810
<class,2호선,왕십리,8664,7524,16188
<class,2호선,한양대,2428,2617,5045
<class,2호선,뚝섬,10003,10236,20239
<class,2호선,성수,11485,13244,24729
<class,2호선,건대입구,24472,25116,49588
<class,2호선,구의,10568,10812,21380
<class,2호선,강변,20865,19722,40587
<class,2호선,잠실나루,4841,4919,9760
<class,2호선,잠실,41307,38772,80079
<class,2호선,잠실새내,10166,10349,20515
<class,2호선,종합운동장,4734,5269,10003
<class,2호선,삼성,17458,17088,34546
<class,2호선,선릉,11925,10463,22388
<class,2호선,역삼,10537,11509,22046
<class,2호선,강남,32650,31681,64331
<class,2호선,교대,9737,10587,20324
<class,2호선,서초,9749,9365,19114
<class,2호선,방배,6483,6929,13412
<class,2호선,사당,19393,21717,41110
<class,2호선,낙성대,15009,15507,30516
<class,2호선,서울대입구,25525,26425,51950
<class,2호선,봉천,11460,11146,22606
<class,2호선,신림,34021,33763,67784
<class,2호선,신대방,14438,14074,28512
<class,2호선,구로디지털단지,21841,21377,43218
<class,2호선,대림,14218,14378,28596
<class,2호선,신도림,26689,26658,53347
<class,2호선,문래,7284,7910,15194
<class,2호선,영등포구청,7136,7316,14452
<class,2호선,당산,8616,9142,17758
<class,2호선,합정,18645,19417,38062
<class,2호선,홍대입구,43695,43553,87248
<class,2호선,신촌,19915,19653,39568
<class,2호선,이대,6354,6808,13162
<class,2호선,아현,4838,4888,9726
<class,2호선,충정로,3619,3839,7458
<class,2호선,용답,1737,1654,3391
<class,2호선,신답,703,721,1424
<class,2호선,신설동,2746,2879,5625
<class,2호선,도림천,481,523,1004
<class,2호선,양천구청,3090,3140,6230
<class,2호선,신정네거리,4836,4906,9742
<class,2호선,용두,972,968,1940
<class,3호선,지축,1791,1718,3509
<class,3호선,구파발,11134,11450,22584
<class,3호선,연신내,20814,19736,40550
<class,3호선,불광,9477,10933,20410
<class,3호선,녹번,6670,6149,12819
<class,3호선,홍제,8748,8273,17021
<class,3호선,무악재,1786,1927,3713
<class,3호선,독립문,4278,4793,9071
<class,3호선,경복궁,10905,11836,22741
<class,3호선,안국,9075,10315,19390
<class,3호선,종로3가,3569,4672,8241
<class,3호선,을지로3가,2888,2848,5736
<class,3호선,충무로,1,0,1
<class,3호선,동대입구,4583,5201,9784
<class,3호선,약수,6081,5891,11972
<class,3호선,금호,4210,3977,8187
<class,3호선,옥수,4907,5320,10227
<class,3호선,압구정,13161,13501,26662
<class,3호선,신사,12623,12723,25346
<class,3호선,잠원,2236,2197,4433
<class,3호선,고속터미널,37673,34530,72203
<class,3호선,교대,3909,2500,6409
<class,3호선,남부터미널,14364,14922,29286
<class,3호선,양재,12335,14446,26781
<class,3호선,매봉,4015,3996,8011
<class,3호선,도곡,1807,2036,3843
<class,3호선,대치,5814,5057,10871
<class,3호선,학여울,1003,1068,2071
<class,3호선,대청,3792,3692,7484
<class,3호선,일원,3178,3294,6472
<class,3호선,수서,9904,9702,19606
<class,3호선,가락시장,3282,3602,6884
<class,3호선,경찰병원,2491,2594,5085
<class,3호선,오금,2507,2413,4920
<class,4호선,수유,18605,17865,36470
<class,4호선,미아,7434,7124,14558
<class,4호선,미아사거리,14851,14327,29178
<class,4호선,길음,9483,9280,18763
<class,4호선,성신여대입구,11504,11323,22827
<class,4호선,한성대입구,7181,7284,14465
<class,4호선,혜화,18883,19762,38645
<class,4호선,동대문,6886,7354,14240
<class,4호선,동대문역사문화공원,7755,7632,15387
<class,4호선,충무로,8038,8002,16040
<class,4호선,명동,9247,9575,18822
<class,4호선,회현,7680,8050,15730
<class,4호선,서울역,3779,8188,11967
<class,4호선,숙대입구,6337,6076,12413
<class,4호선,삼각지,2020,2605,4625
<class,4호선,신용산,7005,7124,14129
<class,4호선,이촌,4530,5298,9828
<class,4호선,동작,2009,2053,4062
<class,4호선,총신대입구,9863,10542,20405
<class,4호선,사당,13480,13041,26521
<class,4호선,남태령,600,502,1102
<class,4호선,당고개,7502,7093,14595
<class,4호선,상계,9928,9437,19365
<class,4호선,노원,10878,11746,22624
<class,4호선,창동,13439,14023,27462
<class,4호선,쌍문,15089,13652,28741
<class,5호선,방화,3686,3629,7315
<class,5호선,개화산,2622,2798,5420
<class,5호선,김포공항,6627,5958,12585
<class,5호선,송정,3588,3701,7289
<class,5호선,마곡,3536,3696,7232
<class,5호선,발산,8347,8879,17226
<class,5호선,우장산,6306,6544,12850
<class,5호선,화곡,13216,12670,25886
<class,5호선,까치산,14802,14596,29398
<class,5호선,신정,6032,5432,11464
<class,5호선,목동,7236,7462,14698
<class,5호선,오목교,10490,10873,21363
<class,5호선,양평,2342,2403,4745
<class,5호선,영등포구청,1299,1343,2642
<class,5호선,영등포시장,4302,4402,8704
<class,5호선,신길,1738,1833,3571
<class,5호선,여의도,7436,7722,15158
<class,5호선,여의나루,12054,13201,25255
<class,5호선,마포,4389,4358,8747
<class,5호선,공덕,4132,4166,8298
<class,5호선,애오개,2535,2621,5156
<class,5호선,충정로,1324,1340,2664
<class,5호선,서대문,5293,5195,10488
<class,5호선,광화문,11224,11380,22604
<class,5호선,종로3가,8070,7574,15644
<class,5호선,을지로4가,1443,1459,2902
<class,5호선,동대문역사문화공원,673,828,1501
<class,5호선,청구,1655,1447,3102
<class,5호선,신금호,2812,3050,5862
<class,5호선,행당,3879,3586,7465
<class,5호선,왕십리,2243,2618,4861
<class,5호선,마장,2816,2648,5464
<class,5호선,답십리,6871,6521,13392
<class,5호선,장한평,7105,7022,14127
<class,5호선,군자,5615,6248,11863
<class,5호선,아차산,11160,11142,22302
<class,5호선,광나루,7511,7675,15186
<class,5호선,천호,11599,10950,22549
<class,5호선,강동,8319,8298,16617
<class,5호선,길동,3936,3947,7883
<class,5호선,굽은다리,4939,4589,9528
<class,5호선,명일,4543,4602,9145
<class,5호선,고덕,4078,4018,8096
<class,5호선,상일동,6663,6526,13189
<class,5호선,둔촌동,4568,4678,9246
<class,5호선,올림픽공원,2357,2114,4471
<class,5호선,방이,3672,3627,7299
<class,5호선,오금,1396,1334,2730
<class,5호선,개롱,2818,3208,6026
<class,5호선,거여,3702,3548,7250
<class,5호선,마천,3469,3715,7184
<class,5호선,강일,1730,1693,3423
<class,5호선,미사,7809,7693,15502
<class,5호선,하남풍산,1997,2062,4059
<class,5호선,하남시청,3139,2989,6128
<class,5호선,하남검단산,4452,4598,9050
<class,6호선,응암,8731,8879,17610
<class,6호선,역촌,1838,2120,3958
<class,6호선,불광,3056,2722,5778
<class,6호선,독바위,1550,2031,3581
<class,6호선,구산,3611,2819,6430
<class,6호선,새절,6369,6254,12623
<class,6호선,증산,5436,5501,10937
<class,6호선,디지털미디어시티,4816,5082,9898
<class,6호선,월드컵경기장,3713,3625,7338
<class,6호선,마포구청,6697,6169,12866
<class,6호선,망원,9425,10236,19661
<class,6호선,합정,8411,7657,16068
<class,6호선,상수,5072,5844,10916
<class,6호선,광흥창,3909,3771,7680
<class,6호선,대흥,3519,3559,7078
<class,6호선,공덕,6160,5695,11855
<class,6호선,효창공원앞,3334,2867,6201
<class,6호선,삼각지,3333,2480,5813
<class,6호선,녹사평,3932,3865,7797
<class,6호선,이태원,8440,8099,16539
<class,6호선,한강진,5763,6750,12513
<class,6호선,버티고개,1105,1248,2353
<class,6호선,약수,1583,1539,3122
<class,6호선,청구,1635,1680,3315
<class,6호선,신당,3186,4105,7291
<class,6호선,동묘앞,6411,6177,12588
<class,6호선,창신,1585,1426,3011
<class,6호선,보문,3900,3626,7526
<class,6호선,안암,4755,5216,9971
<class,6호선,고려대,4003,3906,7909
<class,6호선,월곡,5335,5366,10701
<class,6호선,상월곡,3054,2872,5926
<class,6호선,돌곶이,4704,4594,9298
<class,6호선,석계,6309,6371,12680
<class,6호선,태릉입구,4461,5375,9836
<class,6호선,화랑대,5032,4302,9334
<class,6호선,봉화산,3764,3700,7464
<class,7호선,장암,1572,1179,2751
<class,7호선,도봉산,5860,8812,14672
<class,7호선,수락산,8727,8559,17286
<class,7호선,마들,5784,5403,11187
<class,7호선,노원,10439,10574,21013
<class,7호선,중계,6629,6167,12796
<class,7호선,하계,8695,8284,16979
<class,7호선,공릉,6265,6391,12656
<class,7호선,태릉입구,7182,7212,14394
<class,7호선,먹골,5793,5270,11063
<class,7호선,중화,6265,5967,12232
<class,7호선,상봉,8815,8193,17008
<class,7호선,면목,7864,7616,15480
<class,7호선,사가정,9067,8747,17814
<class,7호선,용마산,3257,3591,6848
<class,7호선,중곡,4906,4745,9651
<class,7호선,군자,7477,5615,13092
<class,7호선,어린이대공원,7616,7661,15277
<class,7호선,건대입구,7091,7257,14348
<class,7호선,청담,6491,6870,13361
<class,7호선,강남구청,5287,5729,11016
<class,7호선,학동,5557,6045,11602
<class,7호선,논현,6290,6499,12789
<class,7호선,반포,2705,2750,5455
<class,7호선,고속터미널,12010,7870,19880
<class,7호선,내방,4980,5108,10088
<class,7호선,이수,7884,7527,15411
<class,7호선,남성,5186,5261,10447
<class,7호선,숭실대입구,5378,5817,11195
<class,7호선,상도,5209,5094,10303
<class,7호선,장승배기,4564,4544,9108
<class,7호선,신대방삼거리,7514,7472,14986
<class,7호선,보라매,4246,4321,8567
<class,7호선,신풍,5845,5466,11311
<class,7호선,대림,6689,6437,13126
<class,7호선,남구로,6524,6343,12867
<class,7호선,가산디지털단지,10495,9908,20403
<class,7호선,철산,10081,10060,20141
<class,7호선,광명사거리,11786,11811,23597
<class,7호선,천왕,4736,4620,9356
<class,7호선,온수,3677,3935,7612
<class,7호선,까치울,4246,4183,8429
<class,7호선,부천종합운동장,2394,2227,4621
<class,7호선,춘의,3486,3420,6906
<class,7호선,신중동,6669,6397,13066
<class,7호선,부천시청,6455,6281,12736
<class,7호선,상동,6913,6701,13614
<class,7호선,삼산체육관,2695,2495,5190
<class,7호선,굴포천,4525,4452,8977
<class,7호선,부평구청,3834,3292,7126
<class,8호선,암사,8349,7936,16285
<class,8호선,천호,8006,9274,17280
<class,8호선,강동구청,4233,4193,8426
<class,8호선,몽촌토성,3273,3314,6587
<class,8호선,잠실,8510,9583,18093
<class,8호선,석촌,3927,4824,8751
<class,8호선,송파,3530,3582,7112
<class,8호선,가락시장,3007,3751,6758
<class,8호선,문정,5312,5624,10936
<class,8호선,장지,8650,8765,17415
<class,8호선,복정,4890,4658,9548
<class,8호선,산성,3511,3590,7101
<class,8호선,남한산성입구,6446,6132,12578
<class,8호선,단대오거리,5218,5125,10343
<class,8호선,신흥,2660,2795,5455
<class,8호선,수진,2696,2444,5140
<class,8호선,모란,2416,2100,4516
<class,9호선,개화,1076,1011,2087
<class,9호선,김포공항,7377,10695,18072
<class,9호선,공항시장,1572,1796,3368
<class,9호선,신방화,3155,3069,6224
<class,9호선,마곡나루,5542,5609,11151
<class,9호선,양천향교,3885,4015,7900
<class,9호선,가양,9858,9600,19458
<class,9호선,증미,2372,2461,4833
<class,9호선,등촌,4911,5042,9953
<class,9호선,염창,7932,7856,15788
<class,9호선,신목동,1640,1487,3127
<class,9호선,선유도,2977,2936,5913
<class,9호선,당산,8083,8032,16115
<class,9호선,국회의사당,4166,3973,8139
<class,9호선,여의도,8443,7657,16100
<class,9호선,노량진,13316,14281,27597
<class,9호선,노들,2402,2238,4640
<class,9호선,흑석,3776,4024,7800
<class,9호선,동작,1213,1032,2245
<class,9호선,구반포,1184,1336,2520
<class,9호선,신반포,1629,1748,3377
<class,9호선,고속터미널,9951,13008,22959
<class,9호선,사평,1207,1324,2531
<class,9호선,신논현,14309,13838,28147
<class,9호선2~3단계,언주,3337,3323,6660
<class,9호선2~3단계,선정릉,3140,3501,6641
<class,9호선2~3단계,삼성중앙,1814,1856,3670
<class,9호선2~3단계,봉은사,6337,6317,12654
<class,9호선2~3단계,종합운동장,2016,1841,3857
<class,9호선2~3단계,삼전,3183,3216,6399
<class,9호선2~3단계,석촌고분,2787,2732,5519
<class,9호선2~3단계,석촌,4269,3805,8074
<class,9호선2~3단계,송파나루,2612,2908,5520
<class,9호선2~3단계,한성백제,1443,1315,2758
<class,9호선2~3단계,올림픽공원,3504,3683,7187
<class,9호선2~3단계,둔촌오륜,405,415,820
<class,9호선2~3단계,중앙보훈병원,3096,3048,6144
<class,경강선,판교,2152,2028,4180
<class,경강선,이매,660,503,1163
<class,경강선,삼동,1004,1015,2019
<class,경강선,경기광주,3595,3507,7102
<class,경강선,초월,1504,1489,2993
<class,경강선,곤지암,1481,1670,3151
<class,경강선,신둔도예촌,867,857,1724
<class,경강선,이천,1913,2086,3999
<class,경강선,부발,1169,1765,2934
<class,경강선,세종대왕릉,289,261,550
<class,경강선,여주,2026,1890,3916
<class,경부선,서울역,6594,1287,7881
<class,경부선,남영,3910,4349,8259
<class,경부선,용산,28393,25460,53853
<class,경부선,노량진,5656,5372,11028
<class,경부선,대방,5584,6054,11638
<class,경부선,영등포,28268,27265,55533
<class,경부선,신도림,2333,2411,4744
<class,경부선,신길,4777,4220,8997
<class,경부선,구로,9290,9559,18849
<class,경부선,가산디지털단지,4441,6083,10524
<class,경부선,금천구청,6097,6004,12101
<class,경부선,석수,5394,5380,10774
<class,경부선,관악,5036,4389,9425
<class,경부선,안양,13226,12762,25988
<class,경부선,명학,3336,3329,6665
<class,경부선,금정,12901,13445,26346
<class,경부선,군포,2902,2889,5791
<class,경부선,의왕,4211,4303,8514
<class,경부선,성균관대,7117,7571,14688
<class,경부선,화서,3661,3583,7244
<class,경부선,수원,31959,30764,62723
<class,경부선,독산,5711,5844,11555
<class,경부선,세류,1917,1974,3891
<class,경부선,병점,8849,9579,18428
<class,경부선,세마,1709,1559,3268
<class,경부선,오산대,2282,2238,4520
<class,경부선,오산,7484,8050,15534
<class,경부선,진위,703,718,1421
<class,경부선,송탄,3287,3718,7005
<class,경부선,서정리,3871,5433,9304
<class,경부선,평택지제,2125,1892,4017
<class,경부선,평택,10632,11601,22233
<class,경부선,성환,2165,2742,4907
<class,경부선,직산,560,581,1141
<class,경부선,두정,4420,4744,9164
<class,경부선,천안,6009,5537,11546
<class,경부선,당정,2869,2862,5731
<class,경부선,서동탄,759,762,1521
<class,경부선,광명,2403,1546,3949
<class,경원선,이촌,2400,1726,4126
<class,경원선,서빙고,1315,1325,2640
<class,경원선,한남,2000,1917,3917
<class,경원선,옥수,47,42,89
<class,경원선,응봉,1130,1062,2192
<class,경원선,왕십리,7953,9056,17009
<class,분당선,복정,1,0,1
<class,9호선,샛강,1728,1763,3491
<class,경원선,청량리,12922,12055,24977
<class,경원선,외대앞,4583,4527,9110
<class,경원선,신이문,4681,4319,9000
<class,경원선,석계,4645,5242,9887
<class,경원선,광운대,4259,4274,8533
<class,경원선,월계,3577,3268,6845
<class,경원선,녹천,2512,2244,4756
<class,경원선,방학,5599,5362,10961
<class,경원선,도봉,3524,3255,6779
<class,경원선,도봉산,10053,7244,17297
<class,경원선,망월사,4267,4488,8755
<class,경원선,회룡,7379,7342,14721
<class,경원선,의정부,12833,13023,25856
<class,경원선,가능,3891,3746,7637
<class,경원선,녹양,2714,2573,5287
<class,경원선,양주,5091,4929,10020
<class,경원선,덕계,1670,1656,3326
<class,경원선,덕정,3323,3479,6802
<class,경원선,지행,4153,4128,8281
<class,경원선,동두천중앙,2034,1961,3995
<class,경원선,보산,1247,1438,2685
<class,경원선,동두천,1370,1823,3193
<class,경원선,소요산,4732,4052,8784
<class,경의선,서울역,1058,907,1965
<class,경의선,신촌,258,283,541
<class,경의선,효창공원앞,1220,1424,2644
<class,경의선,공덕,1575,1372,2947
<class,경의선,서강대,1277,1238,2515
<class,경의선,홍대입구,1580,1812,3392
<class,경의선,가좌,2773,2918,5691
<class,경의선,디지털미디어시티,1244,1167,2411
<class,경의선,수색,944,1045,1989
<class,경의선,화전,900,930,1830
<class,경의선,강매,1478,1370,2848
<class,경의선,행신,4090,3862,7952
<class,경의선,능곡,2196,2143,4339
<class,경의선,곡산,311,339,650
<class,경의선,백마,3425,3233,6658
<class,경의선,풍산,3363,3349,6712
<class,경의선,일산,5553,5278,10831
<class,경의선,탄현,3882,3652,7534
<class,경의선,야당,4151,3997,8148
<class,경의선,운정,3575,3427,7002
<class,경의선,금릉,2729,2661,5390
<class,경의선,금촌,3979,4186,8165
<class,경의선,월롱,842,1417,2259
<class,경의선,파주,647,600,1247
<class,경의선,문산,3343,3354,6697
<class,경의선,임진강,97,70,167
<class,경인선,개봉,11374,11326,22700
<class,경인선,오류동,6864,6601,13465
<class,경인선,역곡,13836,13557,27393
<class,경인선,부천,20351,20045,40396
<class,경인선,송내,12793,12611,25404
<class,경인선,부평,21827,21875,43702
<class,경인선,백운,3889,3865,7754
<class,경인선,동암,9068,9054,18122
<class,경인선,주안,11381,10125,21506
<class,경인선,제물포,5389,5299,10688
<class,경인선,동인천,9185,8759,17944
<class,경인선,인천,4425,3491,7916
<class,경인선,구일,3980,4002,7982
<class,경인선,소사,5502,5336,10838
<class,경인선,부개,4520,4264,8784
<class,경인선,간석,3189,2994,6183
<class,경인선,도원,1656,1608,3264
<class,경인선,온수,3696,3518,7214
<class,경인선,중동,4694,4288,8982
<class,경인선,도화,2390,2270,4660
<class,경춘선,신내,862,866,1728
<class,경춘선,갈매,1557,1346,2903
<class,경춘선,별내,1863,1720,3583
<class,경춘선,퇴계원,2181,2084,4265
<class,경춘선,사릉,1785,1759,3544
<class,경춘선,금곡,960,938,1898
<class,경춘선,평내호평,3519,3447,6966
<class,경춘선,천마산,1241,1291,2532
<class,경춘선,마석,3080,2994,6074
<class,경춘선,대성리,782,578,1360
<class,경춘선,청평,1846,1456,3302
<class,경춘선,상천,530,391,921
<class,경춘선,가평,2150,1736,3886
<class,경춘선,굴봉산,321,258,579
<class,경춘선,백양리,132,151,283
<class,경춘선,강촌,955,770,1725
<class,경춘선,김유정,542,608,1150
<class,경춘선,남춘천,2298,2465,4763
<class,경춘선,춘천,1800,1542,3342
<class,공항철도 1호선,서울역,6921,5684,12605
<class,공항철도 1호선,공덕,1068,1454,2522
<class,공항철도 1호선,홍대입구,9373,8523,17896
<class,공항철도 1호선,디지털미디어시티,3358,3373,6731
<class,공항철도 1호선,마곡나루,2354,2637,4991
<class,공항철도 1호선,김포공항,11413,5790,17203
<class,공항철도 1호선,계양,4638,4467,9105
<class,공항철도 1호선,검암,3319,3597,6916
<class,공항철도 1호선,청라국제도시,3057,2957,6014
<class,공항철도 1호선,운서,4682,4895,9577
<class,공항철도 1호선,공항화물청사,1054,1097,2151
<class,공항철도 1호선,인천공항1터미널,2896,2796,5692
<class,공항철도 1호선,인천공항2터미널,1424,1356,2780
<class,공항철도 1호선,영종,2290,2193,4483
<class,과천선,선바위,3472,3189,6661
<class,과천선,경마공원,878,862,1740
<class,과천선,대공원,6826,6985,13811
<class,과천선,과천,3108,2853,5961
<class,과천선,정부과천청사,4128,4476,8604
<class,과천선,인덕원,10501,10242,20743
<class,과천선,평촌,5998,5873,11871
<class,과천선,범계,13787,13280,27067
<class,분당선,선릉,2754,3937,6691
<class,분당선,한티,7650,7527,15177
<class,분당선,도곡,2382,2243,4625
<class,분당선,구룡,750,848,1598
<class,분당선,개포동,1913,1900,3813
<class,분당선,대모산입구,1644,1592,3236
<class,분당선,수서,8216,7660,15876
<class,분당선,수원,5756,4632,10388
<class,분당선,서울숲,7074,7341,14415
<class,분당선,압구정로데오,9895,11048,20943
<class,분당선,강남구청,2906,3522,6428
<class,분당선,선정릉,2297,2497,4794
<class,분당선,가천대,3584,4311,7895
<class,분당선,태평,7411,7088,14499
<class,분당선,모란,10402,10506,20908
<class,분당선,야탑,11945,12349,24294
<class,분당선,서현,12259,12291,24550
<class,분당선,수내,5793,5672,11465
<class,분당선,정자,6908,7208,14116
<class,분당선,미금,6697,7196,13893
<class,분당선,오리,5142,4484,9626
<class,분당선,이매,2848,2905,5753
<class,분당선,보정,1047,1042,2089
<class,분당선,죽전,7272,8289,15561
<class,분당선,구성,2253,2403,4656
<class,분당선,신갈,1854,1847,3701
<class,분당선,기흥,4744,4567,9311
<class,분당선,상갈,2749,2782,5531
<class,분당선,청명,1796,1902,3698
<class,분당선,영통,4244,4456,8700
<class,분당선,망포,5639,6040,11679
<class,분당선,매탄권선,2412,2312,4724
<class,분당선,수원시청,6861,7040,13901
<class,분당선,매교,1336,1403,2739
<class,수인선,고색,1437,1569,3006
<class,수인선,오목천,1364,1321,2685
<class,수인선,어천,563,652,1215
<class,수인선,야목,158,130,288
<class,수인선,사리,2356,2127,4483
<class,수인선,달월,69,71,140
<class,수인선,월곶,1716,1577,3293
<class,수인선,소래포구,5629,5578,11207
<class,수인선,인천논현,2997,3082,6079
<class,수인선,호구포,1922,1916,3838
<class,수인선,남동인더스파크,710,702,1412
<class,수인선,원인재,2923,2932,5855
<class,수인선,연수,2885,2836,5721
<class,수인선,송도,1638,1592,3230
<class,수인선,인하대,3146,3014,6160
<class,수인선,숭의,1923,1823,3746
<class,수인선,신포,1117,1055,2172
<class,수인선,인천,1109,1826,2935
<class,안산선,산본,8055,8554,16609
<class,안산선,대야미,3186,2763,5949
<class,안산선,반월,2438,2451,4889
<class,안산선,상록수,8877,8698,17575
<class,안산선,한대앞,5313,5175,10488
<class,안산선,중앙,11384,11366,22750
<class,안산선,고잔,4243,4295,8538
<class,안산선,초지,2341,2210,4551
<class,안산선,안산,9906,8845,18751
<class,안산선,신길온천,1090,981,2071
<class,안산선,정왕,4990,5696,10686
<class,안산선,오이도,6085,5968,12053
<class,안산선,수리산,2181,2275,4456
<class,우이신설선,북한산우이,3275,3444,6719
<class,우이신설선,솔밭공원,1411,1336,2747
<class,우이신설선,4.19민주묘지,2001,1772,3773
<class,우이신설선,가오리,2280,2162,4442
<class,우이신설선,화계,1979,1832,3811
<class,우이신설선,삼양,1151,1145,2296
<class,우이신설선,삼양사거리,1465,1465,2930
<class,우이신설선,솔샘,2599,2475,5074
<class,우이신설선,북한산보국문,3608,3355,6963
<class,우이신설선,정릉,2653,2293,4946
<class,2호선,신림,47217,45201,92418
<class,2호선,봉천,16757,15229,31986
<class,2호선,서울대입구,36480,35248,71728
<class,2호선,낙성대,20279,18968,39247
<class,2호선,사당,27615,30668,58283
<class,2호선,방배,9850,10296,20146
<class,2호선,서초,10091,8826,18917
<class,2호선,교대,16501,18593,35094
<class,2호선,강남,57397,57335,114732
<class,2호선,역삼,17482,18973,36455
<class,2호선,선릉,23361,20634,43995
<class,2호선,삼성,30386,30390,60776
<class,2호선,종합운동장,5655,6157,11812
<class,2호선,잠실새내,15610,16148,31758
<class,2호선,잠실,56884,54710,111594
<class,2호선,잠실나루,7372,7270,14642
<class,2호선,강변,24565,25483,50048
<class,2호선,구의,15541,15143,30684
<class,2호선,건대입구,32197,34318,66515
<class,2호선,성수,17561,19378,36939
<class,2호선,뚝섬,13782,14083,27865
<class,2호선,한양대,3823,3813,7636
<class,2호선,왕십리,12626,10655,23281
<class,2호선,상왕십리,9450,8769,18219
<class,2호선,신당,9862,10309,20171
<class,2호선,동대문역사문화공원,9014,9611,18625
<class,2호선,을지로4가,6827,7023,13850
<class,2호선,을지로3가,10253,10407,20660
<class,2호선,을지로입구,18589,18299,36888
<class,2호선,시청,8178,6577,14755
<class,1호선,청량리,17209,17359,34568
<class,1호선,제기동,14345,14439,28784
<class,1호선,신설동,8699,8237,16936
<class,1호선,동대문,10494,9811,20305
<class,1호선,종로5가,18034,17796,35830
<class,1호선,종로3가,20756,19671,40427
<class,1호선,종각,17239,15798,33037
<class,1호선,시청,9533,10675,20208
<class,1호선,동묘앞,10046,10122,20168
<class,1호선,서울역,28044,28464,56508
<class,과천선,선바위,5194,4474,9668
<class,경원선,석계,6334,6718,13052
<class,2호선,신대방,19306,18552,37858
<class,2호선,구로디지털단지,32501,31706,64207
<class,2호선,대림,17195,18427,35622
<class,2호선,신도림,39210,39238,78448
<class,2호선,문래,11814,12496,24310
<class,2호선,영등포구청,11951,12217,24168
<class,2호선,당산,12044,13239,25283
<class,2호선,합정,26043,28170,54213
<class,2호선,홍대입구,57601,61707,119308
<class,2호선,신촌,27482,27706,55188
<class,2호선,이대,9597,10247,19844
<class,2호선,아현,7051,6674,13725
<class,2호선,충정로,5690,6149,11839
<class,2호선,용답,2009,1873,3882
<class,2호선,신답,913,984,1897
<class,2호선,신설동,2948,2748,5696
<class,2호선,도림천,820,824,1644
<class,2호선,양천구청,4214,4334,8548
<class,2호선,신정네거리,6896,7062,13958
<class,2호선,용두,1576,1614,3190
<class,3호선,지축,2501,2496,4997
<class,3호선,구파발,14293,14555,28848
<class,3호선,연신내,28876,26790,55666
<class,3호선,불광,12432,14020,26452
<class,3호선,녹번,9690,8448,18138
<class,3호선,홍제,12670,11845,24515
<class,3호선,무악재,2603,2690,5293
<class,3호선,독립문,5571,6000,11571
<class,3호선,경복궁,14363,15119,29482
<class,3호선,안국,12980,14851,27831
<class,3호선,종로3가,5450,7615,13065
<class,3호선,을지로3가,5031,5570,10601
<class,3호선,동대입구,5422,6030,11452
<class,3호선,약수,8667,8164,16831
<class,3호선,금호,5797,5177,10974
<class,3호선,옥수,6765,6925,13690
<class,3호선,압구정,23398,24746,48144
<class,3호선,신사,23884,24642,48526
<class,3호선,잠원,3386,3340,6726
<class,3호선,고속터미널,44400,44967,89367
<class,3호선,교대,6439,3862,10301
<class,3호선,남부터미널,20853,21450,42303
<class,3호선,양재,20087,21523,41610
<class,3호선,매봉,5904,5649,11553
<class,3호선,도곡,3388,3453,6841
<class,3호선,대치,9095,8253,17348
<class,3호선,학여울,1214,1236,2450
<class,3호선,대청,5508,5147,10655
<class,3호선,일원,4402,4462,8864
<class,3호선,수서,12397,12397,24794
<class,3호선,가락시장,5775,5496,11271
<class,3호선,경찰병원,3918,3722,7640
<class,3호선,오금,3616,3460,7076
<class,4호선,수유,24829,24122,48951
<class,4호선,미아,10343,9757,20100
<class,4호선,미아사거리,20759,19905,40664
<class,4호선,길음,13375,12700,26075
<class,4호선,성신여대입구,15885,15122,31007
<class,4호선,한성대입구,9963,9593,19556
<class,4호선,혜화,23961,24888,48849
<class,4호선,동대문,13630,14040,27670
<class,4호선,동대문역사문화공원,9850,8462,18312
<class,4호선,충무로,12636,13244,25880
<class,4호선,명동,11255,12750,24005
<class,4호선,회현,16337,17549,33886
<class,4호선,서울역,4761,10810,15571
<class,4호선,숙대입구,8523,8092,16615
<class,4호선,삼각지,2905,3848,6753
<class,4호선,신용산,8987,9980,18967
<class,4호선,이촌,6159,6750,12909
<class,4호선,동작,2018,2175,4193
<class,4호선,총신대입구,13610,14704,28314
<class,4호선,사당,19265,16284,35549
<class,4호선,남태령,938,707,1645
<class,4호선,당고개,9540,9080,18620
<class,4호선,상계,13078,12289,25367
<class,4호선,노원,15002,16329,31331
<class,4호선,창동,18240,19122,37362
<class,4호선,쌍문,20210,18248,38458
<class,5호선,방화,4576,4326,8902
<class,5호선,개화산,3639,3479,7118
<class,5호선,김포공항,7149,7299,14448
<class,5호선,송정,4832,4690,9522
<class,5호선,마곡,5017,5000,10017
<class,5호선,발산,12832,13723,26555
<class,5호선,우장산,9312,9237,18549
<class,5호선,화곡,19306,17751,37057
<class,5호선,까치산,20404,19445,39849
<class,5호선,신정,8672,7417,16089
<class,5호선,목동,10841,11081,21922
<class,5호선,오목교,16008,16459,32467
<class,5호선,양평,3694,3535,7229
<class,5호선,영등포구청,1996,1872,3868
<class,5호선,영등포시장,6677,6998,13675
<class,5호선,신길,2418,2531,4949
<class,5호선,여의도,11845,11822,23667
<class,5호선,여의나루,8127,10987,19114
<class,5호선,마포,6894,6882,13776
<class,5호선,공덕,6551,6791,13342
<class,5호선,애오개,3562,3523,7085
<class,5호선,충정로,1952,1820,3772
<class,5호선,서대문,6921,6653,13574
<class,5호선,광화문,13247,13466,26713
<class,5호선,종로3가,11522,11527,23049
<class,5호선,을지로4가,3194,3779,6973
<class,5호선,동대문역사문화공원,897,1108,2005
<class,5호선,청구,2417,2210,4627
<class,5호선,신금호,4014,4002,8016
<class,5호선,행당,5566,4784,10350
<class,5호선,왕십리,3264,3868,7132
<class,5호선,마장,3619,3491,7110
<class,5호선,답십리,10046,9024,19070
<class,5호선,장한평,10415,10192,20607
<class,5호선,군자,8182,8851,17033
<class,5호선,아차산,12637,12344,24981
<class,5호선,광나루,9640,9255,18895
<class,5호선,천호,16079,15084,31163
<class,5호선,강동,12166,11464,23630
<class,5호선,길동,5750,5717,11467
<class,5호선,굽은다리,6705,6440,13145
<class,5호선,명일,6027,5994,12021
<class,5호선,고덕,5818,5652,11470
<class,5호선,상일동,9330,8619,17949
<class,5호선,둔촌동,6888,6873,13761
<class,5호선,올림픽공원,3038,2748,5786
<class,5호선,방이,5233,5036,10269
<class,5호선,오금,2085,1884,3969
<class,5호선,개롱,4357,4485,8842
<class,5호선,거여,5191,4970,10161
<class,5호선,마천,4446,4470,8916
<class,5호선,강일,2225,2145,4370
<class,5호선,미사,10582,10443,21025
<class,5호선,하남풍산,2597,2679,5276
<class,5호선,하남시청,4338,4276,8614
<class,5호선,하남검단산,4668,4717,9385
<class,6호선,응암,12120,11686,23806
<class,6호선,역촌,2553,2925,5478
<class,6호선,불광,3950,3582,7532
<class,6호선,독바위,2005,2235,4240
<class,6호선,연신내,1,0,1
<class,6호선,구산,5129,3901,9030
<class,6호선,새절,8363,7908,16271
<class,6호선,증산,7202,7041,14243
<class,6호선,디지털미디어시티,6935,7089,14024
<class,6호선,월드컵경기장,6591,6714,13305
<class,6호선,마포구청,9326,8278,17604
<class,6호선,망원,12607,14024,26631
<class,6호선,합정,11935,11217,23152
<class,6호선,상수,7176,8521,15697
<class,6호선,광흥창,5031,4646,9677
<class,6호선,대흥,4958,4917,9875
<class,6호선,공덕,9486,8881,18367
<class,6호선,효창공원앞,4687,4101,8788
<class,6호선,삼각지,4758,3792,8550
<class,6호선,녹사평,4909,5197,10106
<class,6호선,이태원,11131,11996,23127
<class,6호선,한강진,7589,9006,16595
<class,6호선,버티고개,1507,1570,3077
<class,6호선,약수,2267,2241,4508
<class,6호선,청구,2360,2388,4748
<class,6호선,신당,5356,4497,9853
<class,6호선,동묘앞,7123,6723,13846
<class,6호선,창신,2118,1748,3866
<class,6호선,보문,4840,4368,9208
<class,6호선,안암,6499,6175,12674
<class,6호선,고려대,5152,4886,10038
<class,6호선,월곡,7186,7061,14247
<class,6호선,상월곡,4023,3441,7464
<class,6호선,돌곶이,5765,5288,11053
<class,6호선,석계,8409,8530,16939
<class,6호선,태릉입구,4440,4838,9278
<class,6호선,화랑대,6861,5842,12703
<class,6호선,봉화산,5139,4915,10054
<class,7호선,장암,1593,1216,2809
<class,7호선,도봉산,6303,8805,15108
<class,7호선,수락산,10079,9618,19697
<class,7호선,마들,8524,8004,16528
<class,7호선,노원,15123,15368,30491
<class,7호선,중계,9121,8066,17187
<class,7호선,하계,11795,11051,22846
<class,7호선,공릉,8354,8271,16625
<class,7호선,태릉입구,7020,6773,13793
<class,7호선,먹골,7877,7569,15446
<class,7호선,중화,7533,7267,14800
<class,7호선,상봉,12572,12040,24612
<class,7호선,면목,10715,10209,20924
<class,7호선,사가정,12335,11677,24012
<class,7호선,용마산,4256,4345,8601
<class,7호선,중곡,6449,5993,12442
<class,7호선,군자,10305,7792,18097
<class,7호선,어린이대공원,9312,8913,18225
<class,7호선,건대입구,10380,10434,20814
<class,7호선,뚝섬유원지,7032,6952,13984
<class,7호선,청담,11271,12449,23720
<class,7호선,강남구청,9788,10791,20579
<class,7호선,학동,10539,11134,21673
<class,7호선,논현,10954,12103,23057
<class,7호선,반포,4196,4018,8214
<class,7호선,고속터미널,13148,10588,23736
<class,7호선,내방,7883,7738,15621
<class,7호선,이수,11846,11076,22922
<class,7호선,남성,7517,7044,14561
<class,7호선,숭실대입구,7947,7941,15888
<class,7호선,장승배기,6554,6221,12775
<class,7호선,신대방삼거리,10744,9876,20620
<class,7호선,보라매,6456,6259,12715
<class,7호선,신풍,7982,7645,15627
<class,7호선,대림,6768,7133,13901
<class,7호선,남구로,8242,8719,16961
<class,7호선,가산디지털단지,14424,13241,27665
<class,7호선,철산,14825,14978,29803
<class,7호선,광명사거리,16389,16305,32694
<class,7호선,천왕,6569,6320,12889
<class,7호선,온수,5476,5463,10939
<class,7호선,까치울,5428,5375,10803
<class,7호선,부천종합운동장,3059,2760,5819
<class,7호선,춘의,5041,4808,9849
<class,7호선,신중동,9320,9240,18560
<class,7호선,부천시청,9360,9368,18728
<class,7호선,상동,10132,10232,20364
<class,7호선,삼산체육관,3543,3318,6861
<class,7호선,굴포천,6489,6682,13171
<class,7호선,부평구청,5061,4372,9433
<class,8호선,암사,11981,11154,23135
<class,8호선,천호,11444,13551,24995
<class,8호선,강동구청,5772,5786,11558
<class,8호선,몽촌토성,4173,4183,8356
<class,8호선,잠실,11684,13454,25138
<class,8호선,석촌,5655,6937,12592
<class,8호선,송파,5243,5280,10523
<class,8호선,가락시장,5350,5288,10638
<class,8호선,문정,8492,8564,17056
<class,8호선,장지,11984,11066,23050
<class,8호선,복정,7007,5996,13003
<class,8호선,산성,4712,4563,9275
<class,8호선,남한산성입구,8873,7944,16817
<class,8호선,단대오거리,7598,6999,14597
<class,8호선,신흥,3700,4023,7723
<class,8호선,수진,4046,3706,7752
<class,8호선,모란,5011,4377,9388
<class,9호선,개화,1348,1160,2508
<class,9호선,김포공항,8029,13433,21462
<class,9호선,공항시장,2196,2290,4486
<class,9호선,신방화,4437,4201,8638
<class,9호선,마곡나루,7699,7573,15272
<class,9호선,양천향교,5823,5663,11486
<class,9호선,가양,13544,12636,26180
<class,9호선,증미,3968,3942,7910
<class,9호선,등촌,7154,6762,13916
<class,9호선,염창,11051,10254,21305
<class,9호선,신목동,2258,1838,4096
<class,9호선,선유도,3790,3770,7560
<class,9호선,당산,12031,11208,23239
<class,9호선,국회의사당,4050,4190,8240
<class,9호선,여의도,12229,11295,23524
<class,9호선,노량진,19547,19288,38835
<class,9호선,노들,3113,2597,5710
<class,9호선,흑석,5216,5326,10542
<class,9호선,동작,1672,1364,3036
<class,9호선,구반포,2036,2250,4286
<class,9호선,신반포,2354,2356,4710
<class,9호선,고속터미널,11766,16748,28514
<class,9호선,사평,2076,1947,4023
<class,9호선,신논현,24533,24214,48747
<class,9호선2~3단계,언주,5899,5954,11853
<class,9호선2~3단계,선정릉,4964,5550,10514
<class,9호선2~3단계,삼성중앙,2927,2968,5895
<class,9호선2~3단계,봉은사,11497,12281,23778
<class,9호선2~3단계,종합운동장,2848,2691,5539
<class,9호선2~3단계,삼전,4651,4309,8960
<class,9호선2~3단계,석촌고분,4004,3852,7856
<class,9호선2~3단계,석촌,5993,4995,10988
<class,9호선2~3단계,송파나루,3790,3962,7752
<class,9호선2~3단계,한성백제,1801,1520,3321
<class,9호선2~3단계,올림픽공원,5159,5122,10281
<class,9호선2~3단계,둔촌오륜,741,667,1408
<class,9호선2~3단계,중앙보훈병원,4173,3789,7962
<class,경강선,판교,2788,2625,5413
<class,경강선,이매,786,617,1403
<class,경강선,삼동,1428,1324,2752
<class,경강선,경기광주,4922,4579,9501
<class,경강선,초월,2100,1942,4042
<class,경강선,곤지암,1783,1936,3719
<class,경강선,신둔도예촌,1015,1027,2042
<class,경강선,이천,2303,2507,4810
<class,경강선,부발,1649,1514,3163
<class,경강선,세종대왕릉,255,308,563
<class,경강선,여주,2111,2307,4418
<class,경부선,서울역,5228,1630,6858
<class,경부선,남영,5601,5811,11412
<class,경부선,용산,30940,33218,64158
<class,경부선,노량진,7953,7071,15024
<class,경부선,대방,7926,7893,15819
<class,경부선,영등포,35516,36834,72350
<class,경부선,신도림,2851,3023,5874
<class,경부선,신길,6106,5053,11159
<class,경부선,구로,13143,13650,26793
<class,경부선,가산디지털단지,6003,7965,13968
<class,경부선,금천구청,8246,8068,16314
<class,경부선,석수,6970,6588,13558
<class,경부선,관악,5976,5613,11589
<class,경부선,안양,17328,17272,34600
<class,경부선,명학,5482,5307,10789
<class,경부선,금정,17891,17749,35640
<class,경부선,군포,4135,3807,7942
<class,경부선,의왕,5834,5797,11631
<class,경부선,성균관대,9798,9831,19629
<class,경부선,화서,5087,5100,10187
<class,경부선,수원,36279,39046,75325
<class,경부선,독산,8325,8354,16679
<class,경부선,세류,2507,2485,4992
<class,경부선,병점,11740,11669,23409
<class,경부선,세마,2153,1955,4108
<class,경부선,오산대,2935,2658,5593
<class,경부선,오산,9060,8492,17552
<class,경부선,진위,1011,916,1927
<class,경부선,송탄,4827,4324,9151
<class,경부선,서정리,5983,5111,11094
<class,경부선,평택지제,2601,2502,5103
<class,경부선,평택,12903,12380,25283
<class,경부선,성환,2786,2617,5403
<class,경부선,직산,624,623,1247
<class,경부선,두정,5256,5466,10722
<class,경부선,천안,6095,6264,12359
<class,경부선,당정,3951,3650,7601
<class,경부선,서동탄,1070,1073,2143
<class,경부선,광명,2450,2208,4658
<class,경원선,이촌,2921,2166,5087
<class,경원선,서빙고,1291,1161,2452
<class,경원선,한남,2761,2731,5492
<class,경원선,옥수,37,48,85
<class,경원선,응봉,1556,1387,2943
<class,경원선,왕십리,11634,13224,24858
<class,경원선,청량리,14845,16429,31274
<class,경원선,외대앞,6150,6009,12159
<class,경원선,신이문,5947,5429,11376
<class,경원선,광운대,5612,5420,11032
<class,경원선,월계,4448,4079,8527
<class,경원선,녹천,3070,2633,5703
<class,경원선,방학,7009,6986,13995
<class,경원선,도봉,4239,3996,8235
<class,경원선,도봉산,8908,6155,15063
<class,경원선,망월사,5518,5630,11148
<class,경원선,회룡,9310,9390,18700
<class,경원선,의정부,16038,16706,32744
<class,경원선,가능,4751,4607,9358
<class,경원선,녹양,3347,3251,6598
<class,경원선,양주,6105,5860,11965
<class,경원선,덕계,2107,1940,4047
<class,경원선,덕정,4184,4058,8242
<class,경원선,지행,5175,4974,10149
<class,경원선,동두천중앙,2361,2362,4723
<class,경원선,보산,1693,1604,3297
<class,경원선,동두천,1564,2063,3627
<class,경원선,소요산,3882,3232,7114
<class,경의선,서울역,1218,1391,2609
<class,경의선,신촌,306,345,651
<class,경의선,효창공원앞,1629,1836,3465
<class,경의선,공덕,2342,1825,4167
<class,경의선,서강대,1695,1541,3236
<class,경의선,홍대입구,1810,2094,3904
<class,경의선,가좌,3683,3453,7136
<class,경의선,디지털미디어시티,1846,1744,3590
<class,경의선,수색,1342,1378,2720
<class,경의선,화전,1080,1078,2158
<class,경의선,강매,1924,1721,3645
<class,경의선,행신,5034,5010,10044
<class,경의선,능곡,2625,2565,5190
<class,경의선,곡산,358,412,770
<class,경의선,백마,4054,3941,7995
<class,경의선,풍산,4094,3915,8009
<class,경의선,일산,5820,5497,11317
<class,경의선,탄현,5004,4900,9904
<class,경의선,야당,4973,4919,9892
<class,경의선,운정,4525,4376,8901
<class,경의선,금릉,3441,3213,6654
<class,경의선,금촌,5008,4960,9968
<class,경의선,월롱,1124,1162,2286
<class,경의선,파주,827,622,1449
<class,경의선,문산,4707,4564,9271
<class,경의선,임진강,76,87,163
<class,경인선,개봉,15705,15478,31183
<class,경인선,오류동,8855,8147,17002
<class,경인선,역곡,19280,18946,38226
<class,경인선,부천,27299,27923,55222
<class,경인선,송내,17570,17385,34955
<class,경인선,부평,28315,30627,58942
<class,경인선,백운,5301,5285,10586
<class,경인선,동암,11941,12029,23970
<class,경인선,주안,14985,13216,28201
<class,경인선,제물포,7330,6950,14280
<class,경인선,동인천,11375,11165,22540
<class,경인선,인천,4263,3513,7776
<class,경인선,구일,4260,3987,8247
<class,경인선,소사,7570,7333,14903
<class,경인선,부개,6160,5609,11769
<class,경인선,간석,4314,4157,8471
<class,경인선,도원,2685,2730,5415
<class,경인선,온수,4826,4438,9264
<class,경인선,중동,6416,5991,12407
<class,경인선,도화,3062,2755,5817
<class,경춘선,신내,1087,1099,2186
<class,경춘선,갈매,1839,1602,3441
<class,경춘선,별내,2261,2160,4421
<class,경춘선,퇴계원,2491,2283,4774
<class,경춘선,사릉,2220,2203,4423
<class,경춘선,금곡,1045,967,2012
<class,경춘선,평내호평,4226,4272,8498
<class,경춘선,천마산,1266,1259,2525
<class,경춘선,마석,3080,3035,6115
<class,경춘선,대성리,629,634,1263
<class,경춘선,청평,1665,1814,3479
<class,경춘선,상천,478,447,925
<class,경춘선,가평,1775,2145,3920
<class,경춘선,굴봉산,204,230,434
<class,경춘선,백양리,207,179,386
<class,경춘선,강촌,692,741,1433
<class,경춘선,김유정,533,627,1160
<class,경춘선,남춘천,2426,2836,5262
<class,경춘선,춘천,1841,1568,3409
<class,공항철도 1호선,서울역,6390,6518,12908
<class,공항철도 1호선,공덕,1404,2024,3428
<class,공항철도 1호선,홍대입구,10969,10827,21796
<class,공항철도 1호선,디지털미디어시티,5178,4787,9965
<class,공항철도 1호선,마곡나루,2911,3129,6040
<class,공항철도 1호선,김포공항,10944,5020,15964
<class,공항철도 1호선,계양,6346,5678,12024
<class,공항철도 1호선,검암,4332,4463,8795
<class,공항철도 1호선,청라국제도시,3967,3966,7933
<class,공항철도 1호선,운서,5531,5472,11003
<class,공항철도 1호선,공항화물청사,1364,1373,2737
<class,공항철도 1호선,인천공항1터미널,2856,3093,5949
<class,공항철도 1호선,인천공항2터미널,1590,1475,3065
<class,공항철도 1호선,영종,2755,2825,5580
<class,과천선,경마공원,1050,1053,2103
<class,과천선,대공원,6532,6935,13467
<class,과천선,과천,4280,3843,8123
<class,과천선,정부과천청사,5438,5567,11005
<class,과천선,인덕원,14630,14107,28737
<class,과천선,평촌,9187,8983,18170
<class,과천선,범계,19277,18667,37944
<class,분당선,선릉,5034,7769,12803
<class,분당선,한티,11411,11009,22420
<class,분당선,도곡,4493,4033,8526
<class,분당선,구룡,1839,1714,3553
<class,분당선,개포동,2421,2307,4728
<class,분당선,대모산입구,2636,2370,5006
<class,분당선,수서,9959,10378,20337
<class,분당선,수원,7195,6180,13375
<class,분당선,서울숲,7958,8697,16655
<class,분당선,압구정로데오,17882,19796,37678
<class,분당선,강남구청,5152,6373,11525
<class,분당선,선정릉,3664,3892,7556
<class,분당선,가천대,5017,5597,10614
<class,분당선,태평,10479,9875,20354
<class,분당선,모란,21280,21777,43057
<class,분당선,야탑,16397,17124,33521
<class,분당선,서현,17380,17531,34911
<class,분당선,수내,8412,8096,16508
<class,분당선,정자,10595,10846,21441
<class,분당선,미금,10628,10948,21576
<class,분당선,오리,7576,6380,13956
<class,분당선,이매,4036,3933,7969
<class,분당선,보정,1630,1454,3084
<class,분당선,죽전,9927,11004,20931
<class,분당선,구성,3150,3359,6509
<class,분당선,신갈,2753,2769,5522
<class,분당선,기흥,6682,6379,13061
<class,분당선,상갈,3868,3768,7636
<class,분당선,청명,2698,2568,5266
<class,분당선,영통,6361,6307,12668
<class,분당선,망포,8938,8032,16970
<class,분당선,매탄권선,3300,3082,6382
<class,분당선,수원시청,10880,11927,22807
<class,분당선,매교,2110,2162,4272
<class,수인선,고색,2157,2192,4349
<class,수인선,오목천,1893,1680,3573
<class,수인선,어천,682,592,1274
<class,수인선,야목,189,177,366
<class,수인선,사리,3226,2812,6038
<class,수인선,달월,59,63,122
<class,수인선,월곶,2040,2028,4068
<class,수인선,소래포구,5979,6077,12056
<class,수인선,인천논현,4277,4335,8612
<class,수인선,호구포,2459,2447,4906
<class,수인선,남동인더스파크,968,875,1843
<class,수인선,원인재,3463,3605,7068
<class,수인선,연수,3687,3723,7410
<class,수인선,송도,2084,2025,4109
<class,수인선,인하대,3950,3730,7680
<class,수인선,숭의,2693,2571,5264
<class,수인선,신포,1380,1357,2737
<class,수인선,인천,1215,2182,3397
<class,안산선,산본,11739,12583,24322
<class,안산선,대야미,4154,3534,7688
<class,안산선,반월,3442,3188,6630
<class,안산선,상록수,12146,12016,24162
<class,안산선,한대앞,7127,7058,14185
<class,안산선,중앙,15226,15712,30938
<class,안산선,고잔,6351,6465,12816
<class,안산선,초지,3098,3175,6273
<class,안산선,안산,9563,9940,19503
<class,안산선,신길온천,1421,1324,2745
<class,안산선,정왕,6216,6281,12497
<class,안산선,오이도,7421,7699,15120
<class,안산선,수리산,2858,2623,5481
<class,우이신설선,북한산우이,3278,3335,6613
<class,우이신설선,솔밭공원,1721,1582,3303
<class,우이신설선,4.19민주묘지,2304,2067,4371
<class,우이신설선,가오리,2814,2691,5505
<class,우이신설선,화계,2356,2237,4593
<class,우이신설선,삼양,1437,1496,2933
<class,우이신설선,삼양사거리,1773,1756,3529
<class,우이신설선,솔샘,3556,3167,6723
<class,우이신설선,북한산보국문,4368,3940,8308
<class,우이신설선,정릉,3315,2850,6165
<class,우이신설선,성신여대입구,2684,3088,5772
<class,우이신설선,보문,1012,1068,2080
<class,우이신설선,신설동,1302,1307,2609
<class,일산선,원흥,6746,6402,13148
<class,일산선,삼송,12628,12212,24840
<class,일산선,원당,7966,7675,15641
<class,일산선,화정,11705,12117,23822
<class,일산선,대곡,1382,1156,2538
<class,일산선,백석,7255,7410,14665
<class,일산선,마두,4889,4928,9817
<class,일산선,정발산,6037,6225,12262
<class,일산선,주엽,6255,6075,12330
<class,일산선,대화,8472,7698,16170
<class,장항선,봉명,765,726,1491
<class,장항선,쌍용,1536,1403,2939
<class,장항선,아산,2713,2740,5453
<class,장항선,배방,962,871,1833
<class,장항선,온양온천,4216,4323,8539
<class,장항선,신창,1219,1032,2251
<class,중앙선,회기,18583,17708,36291
<class,중앙선,중랑,4457,4181,8638
<class,중앙선,상봉,4865,4794,9659
<class,중앙선,망우,6166,5980,12146
<class,중앙선,양원,1202,1169,2371
<class,중앙선,구리,10207,10426,20633
<class,중앙선,도농,6339,6085,12424
<class,9호선,샛강,2566,2533,5099
<class,중앙선,지평,55,74,129
<class,중앙선,용문,2032,2412,4444
<class,중앙선,원덕,421,491,912
<class,중앙선,양평,2636,2763,5399
<class,중앙선,오빈,282,301,583
<class,중앙선,아신,678,688,1366
<class,중앙선,국수,706,718,1424
<class,중앙선,신원,346,251,597
<class,중앙선,양수,2373,2298,4671
<class,중앙선,운길산,1571,1487,3058
<class,중앙선,팔당,1519,1682,3201
<class,중앙선,도심,1541,1351,2892
<class,중앙선,덕소,4320,4315,8635
<class,중앙선,양정,631,623,1254
<class,7호선,상도,7338,6738,14076
<class,6호선,공덕,6497,6173,12670
<class,5호선,명일,4641,4630,9271
<class,중앙선,국수,653,612,1265
<class,중앙선,아신,587,527,1114
<class,중앙선,오빈,274,250,524
<class,중앙선,양평,2382,2106,4488
<class,중앙선,원덕,445,432,877
<class,중앙선,용문,4431,3801,8232
<class,중앙선,지평,71,46,117
<class,중앙선,신원,352,228,580
<class,중앙선,양수,2116,1979,4095
<class,중앙선,운길산,1665,1563,3228
<class,중앙선,팔당,1600,1750,3350
<class,중앙선,도심,1307,1189,2496
<class,중앙선,덕소,3498,3507,7005
<class,중앙선,양정,585,438,1023
<class,중앙선,도농,4742,4814,9556
<class,중앙선,구리,7475,7927,15402
<class,중앙선,양원,973,969,1942
<class,중앙선,망우,4740,4917,9657
<class,중앙선,상봉,4026,3915,7941
<class,중앙선,중랑,3590,3478,7068
<class,중앙선,회기,14586,14755,29341
<class,장항선,신창,885,1167,2052
<class,장항선,온양온천,2819,2793,5612
<class,장항선,배방,719,838,1557
<class,장항선,아산,2985,1916,4901
<class,장항선,쌍용,1087,1211,2298
<class,장항선,봉명,492,464,956
<class,일산선,대화,6276,5899,12175
<class,일산선,주엽,4265,4244,8509
<class,일산선,정발산,5118,4939,10057
<class,일산선,마두,3174,3276,6450
<class,일산선,백석,5513,5468,10981
<class,일산선,대곡,1063,831,1894
<class,일산선,화정,8759,8930,17689
<class,일산선,원당,5990,5757,11747
<class,일산선,삼송,9638,9556,19194
<class,일산선,원흥,5112,4901,10013
<class,우이신설선,신설동,1198,1165,2363
<class,우이신설선,보문,911,946,1857
<class,우이신설선,성신여대입구,2133,2370,4503
<class,우이신설선,정릉,2627,2321,4948
<class,우이신설선,북한산보국문,3593,3316,6909
<class,우이신설선,솔샘,2665,2489,5154
<class,우이신설선,삼양사거리,1511,1434,2945
<class,우이신설선,삼양,1213,1281,2494
<class,우이신설선,화계,2082,1919,4001
<class,우이신설선,가오리,2301,2208,4509
<class,우이신설선,4.19민주묘지,2099,1835,3934
<class,우이신설선,솔밭공원,1387,1422,2809
<class,우이신설선,북한산우이,3260,3401,6661
<class,안산선,수리산,2147,2192,4339
<class,안산선,오이도,5801,5703,11504
<class,안산선,정왕,4728,5415,10143
<class,안산선,신길온천,1152,1064,2216
<class,안산선,안산,9512,8825,18337
<class,안산선,초지,2339,2190,4529
<class,안산선,고잔,4410,4346,8756
<class,안산선,중앙,10904,10761,21665
<class,안산선,한대앞,5130,5046,10176
<class,안산선,상록수,8677,8632,17309
<class,안산선,반월,2447,2339,4786
<class,안산선,대야미,3011,2757,5768
<class,안산선,산본,8220,8684,16904
<class,수인선,인천,1119,1692,2811
<class,수인선,신포,1147,1100,2247
<class,수인선,숭의,1994,1832,3826
<class,수인선,인하대,2983,2850,5833
<class,수인선,송도,1547,1503,3050
<class,수인선,연수,2834,2831,5665
<class,수인선,원인재,2553,2750,5303
<class,수인선,남동인더스파크,659,658,1317
<class,수인선,호구포,1705,1732,3437
<class,수인선,인천논현,2840,3009,5849
<class,수인선,소래포구,5482,5415,10897
<class,수인선,월곶,1608,1491,3099
<class,수인선,달월,33,38,71
<class,수인선,사리,2337,2103,4440
<class,수인선,야목,153,134,287
<class,수인선,어천,511,638,1149
<class,수인선,오목천,1336,1275,2611
<class,수인선,고색,1472,1580,3052
<class,분당선,매교,1437,1486,2923
<class,분당선,수원시청,7175,7136,14311
<class,분당선,매탄권선,2270,2282,4552
<class,분당선,망포,5780,6206,11986
<class,분당선,영통,4318,4432,8750
<class,분당선,청명,1820,1862,3682
<class,분당선,상갈,2863,2920,5783
<class,분당선,기흥,4570,4503,9073
<class,분당선,신갈,1925,1950,3875
<class,분당선,구성,2314,2554,4868
<class,분당선,죽전,7364,8459,15823
<class,분당선,보정,1015,1007,2022
<class,분당선,이매,2791,3031,5822
<class,분당선,오리,5104,4480,9584
<class,분당선,미금,6585,7107,13692
<class,분당선,정자,6935,7313,14248
<class,분당선,수내,5727,5524,11251
<class,분당선,서현,12550,12563,25113
<class,분당선,야탑,12094,12333,24427
<class,분당선,모란,10354,10588,20942
<class,분당선,태평,7428,7035,14463
<class,분당선,가천대,3506,4282,7788
<class,분당선,선정릉,2216,2331,4547
<class,분당선,강남구청,3001,3712,6713
<class,분당선,압구정로데오,9787,10705,20492
<class,분당선,서울숲,7046,7344,14390
<class,분당선,수원,5445,4634,10079
<class,분당선,수서,8131,7597,15728
<class,분당선,대모산입구,1858,1826,3684
<class,분당선,개포동,1931,1927,3858
<class,분당선,구룡,710,812,1522
<class,분당선,도곡,2365,2364,4729
<class,분당선,한티,7780,7428,15208
<class,분당선,선릉,2703,3983,6686
<class,과천선,범계,13457,12924,26381
<class,과천선,평촌,5933,5894,11827
<class,과천선,인덕원,10617,10615,21232
<class,과천선,정부과천청사,4035,4131,8166
<class,과천선,과천,3095,2849,5944
<class,과천선,대공원,6858,7013,13871
<class,과천선,경마공원,849,877,1726
<class,과천선,선바위,3574,3331,6905
<class,공항철도 1호선,영종,2217,2252,4469
<class,공항철도 1호선,인천공항2터미널,1406,1364,2770
<class,공항철도 1호선,인천공항1터미널,2843,2874,5717
<class,공항철도 1호선,공항화물청사,972,1055,2027
<class,공항철도 1호선,운서,4487,4686,9173
<class,공항철도 1호선,청라국제도시,2937,2896,5833
<class,공항철도 1호선,검암,3392,3567,6959
<class,공항철도 1호선,계양,4511,4440,8951
<class,공항철도 1호선,김포공항,10977,4646,15623
<class,공항철도 1호선,마곡나루,2180,2371,4551
<class,공항철도 1호선,디지털미디어시티,3358,3355,6713
<class,공항철도 1호선,홍대입구,8892,8269,17161
<class,공항철도 1호선,공덕,1053,1444,2497
<class,공항철도 1호선,서울역,6799,5634,12433
<class,경춘선,춘천,1690,1482,3172
<class,경춘선,남춘천,2083,2187,4270
<class,경춘선,김유정,530,522,1052
<class,경춘선,강촌,724,610,1334
<class,경춘선,백양리,126,128,254
<class,경춘선,굴봉산,266,261,527
<class,경춘선,가평,2085,1660,3745
<class,경춘선,상천,447,346,793
<class,경춘선,청평,1798,1430,3228
<class,경춘선,대성리,803,512,1315
<class,경춘선,마석,2546,2433,4979
<class,경춘선,천마산,1145,1118,2263
<class,경춘선,평내호평,3358,3176,6534
<class,경춘선,금곡,893,869,1762
<class,경춘선,사릉,1766,1703,3469
<class,경춘선,퇴계원,2097,1929,4026
<class,경춘선,별내,1729,1695,3424
<class,경춘선,갈매,1492,1329,2821
<class,경춘선,신내,898,828,1726
<class,경인선,도화,2389,2194,4583
<class,경인선,중동,4681,4469,9150
<class,경인선,온수,3597,3532,7129
<class,경인선,도원,1595,1718,3313
<class,경인선,간석,3076,2991,6067
<class,경인선,부개,4497,4277,8774
<class,경인선,소사,5633,5521,11154
<class,경인선,구일,3362,3351,6713
<class,경인선,인천,4217,3518,7735
<class,경인선,동인천,8978,8530,17508
<class,경인선,제물포,5361,5298,10659
<class,경인선,주안,10878,9544,20422
<class,경인선,동암,8992,8861,17853
<class,경인선,백운,3836,3838,7674
<class,경인선,부평,21694,21462,43156
<class,경인선,송내,12461,12229,24690
<class,경인선,부천,21158,20809,41967
<class,경인선,역곡,13706,13561,27267
<class,경인선,오류동,6764,6452,13216
<class,경인선,개봉,11351,11648,22999
<class,경의선,김포공항,1,0,1
<class,경의선,임진강,79,64,143
<class,경의선,문산,3471,3309,6780
<class,경의선,파주,638,603,1241
<class,경의선,월롱,755,1421,2176
<class,경의선,금촌,3755,3895,7650
<class,경의선,금릉,2562,2459,5021
<class,경의선,운정,3318,3344,6662
<class,경의선,야당,3983,3763,7746
<class,경의선,탄현,3932,3798,7730
<class,경의선,일산,4365,4248,8613
<class,경의선,풍산,3217,3130,6347
<class,경의선,백마,3100,3062,6162
<class,경의선,곡산,356,337,693
<class,경의선,능곡,2005,1964,3969
<class,경의선,행신,4123,3932,8055
<class,경의선,강매,1416,1324,2740
<class,경의선,화전,860,871,1731
<class,경의선,수색,966,1027,1993
<class,경의선,디지털미디어시티,1276,1285,2561
<class,경의선,가좌,2685,2666,5351
<class,경의선,홍대입구,1436,1652,3088
<class,경의선,서강대,1189,1242,2431
<class,경의선,공덕,1538,1355,2893
<class,경의선,효창공원앞,1299,1513,2812
<class,경의선,신촌,277,258,535
<class,경의선,서울역,969,935,1904
<class,경원선,소요산,4596,3993,8589
<class,경원선,동두천,1349,1734,3083
<class,경원선,보산,1454,1513,2967
<class,경원선,동두천중앙,2164,2122,4286
<class,경원선,지행,4203,3993,8196
<class,경원선,덕정,3097,3246,6343
<class,경원선,덕계,1611,1543,3154
<class,경원선,양주,4849,4799,9648
<class,경원선,녹양,2628,2652,5280
<class,경원선,가능,3910,3810,7720
<class,경원선,의정부,12976,13022,25998
<class,경원선,회룡,7104,7145,14249
<class,경원선,망월사,4240,4433,8673
<class,경원선,도봉산,9667,7138,16805
<class,경원선,도봉,3576,3286,6862
<class,경원선,방학,5752,5545,11297
<class,경원선,녹천,2748,2434,5182
<class,경원선,월계,3598,3461,7059
<class,경원선,광운대,4177,4334,8511
<class,경원선,석계,4658,5259,9917
<class,경원선,신이문,4574,4348,8922
<class,경원선,외대앞,5133,5048,10181
<class,경원선,청량리,13391,12456,25847
<class,경원선,왕십리,8723,10076,18799
<class,경원선,응봉,1170,1099,2269
<class,경원선,옥수,61,25,86
<class,경원선,한남,2143,2115,4258
<class,경원선,서빙고,1250,1300,2550
<class,경원선,이촌,2275,1778,4053
<class,경부선,광명,2428,1651,4079
<class,경부선,서동탄,865,826,1691
<class,경부선,당정,2861,2954,5815
<class,경부선,천안,5604,5258,10862
<class,경부선,두정,4422,4696,9118
<class,경부선,직산,508,589,1097
<class,경부선,성환,2141,2543,4684
<class,경부선,평택,10550,10981,21531
<class,경부선,평택지제,2134,1996,4130
<class,경부선,서정리,3758,5162,8920
<class,경부선,송탄,3451,3888,7339
<class,경부선,진위,713,694,1407
<class,경부선,오산,7052,7706,14758
<class,경부선,오산대,2283,2174,4457
<class,경부선,세마,1663,1532,3195
<class,경부선,병점,8412,9473,17885
<class,경부선,세류,1880,1927,3807
<class,경부선,독산,5559,5798,11357
<class,경부선,수원,31558,29984,61542
<class,경부선,화서,3871,3783,7654
<class,경부선,성균관대,6746,7045,13791
<class,경부선,의왕,4207,4278,8485
<class,경부선,군포,2987,2864,5851
<class,경부선,금정,12983,13374,26357
<class,경부선,명학,3225,3288,6513
<class,경부선,안양,12856,12694,25550
<class,경부선,관악,4934,4428,9362
<class,경부선,석수,5232,5205,10437
<class,경부선,금천구청,6231,6116,12347
<class,경부선,가산디지털단지,4504,6342,10846
<class,경부선,구로,9408,9532,18940
<class,경부선,신길,4528,4093,8621
<class,경부선,신도림,2259,2241,4500
<class,경부선,영등포,29200,27653,56853
<class,경부선,대방,5555,5971,11526
<class,경부선,노량진,5621,5325,10946
<class,경부선,용산,28779,25253,54032
<class,경부선,남영,4129,4507,8636
<class,경부선,서울역,6497,1302,7799
<class,경강선,여주,2004,2021,4025
<class,경강선,세종대왕릉,272,280,552
<class,경강선,부발,1192,1716,2908
<class,경강선,이천,1878,2001,3879
<class,경강선,신둔도예촌,831,842,1673
<class,경강선,곤지암,1434,1665,3099
<class,경강선,초월,1541,1431,2972
<class,경강선,경기광주,3471,3507,6978
<class,경강선,삼동,995,997,1992
<class,경강선,이매,627,481,1108
<class,경강선,판교,2189,2043,4232
<class,9호선2~3단계,중앙보훈병원,3193,3212,6405
<class,9호선2~3단계,둔촌오륜,455,491,946
<class,9호선2~3단계,올림픽공원,4649,4733,9382
<class,9호선2~3단계,한성백제,1585,1331,2916
<class,9호선2~3단계,송파나루,2783,2994,5777
<class,9호선2~3단계,석촌,4358,3916,8274
<class,9호선2~3단계,석촌고분,2846,2889,5735
<class,9호선2~3단계,삼전,3265,3330,6595
<class,9호선2~3단계,종합운동장,1988,1843,3831
<class,9호선2~3단계,봉은사,8287,8894,17181
<class,9호선2~3단계,삼성중앙,1821,1821,3642
<class,9호선2~3단계,선정릉,2935,3399,6334
<class,9호선2~3단계,언주,3482,3560,7042
<class,9호선,신논현,14517,13755,28272
<class,9호선,사평,1222,1454,2676
<class,9호선,고속터미널,9611,12566,22177
<class,9호선,신반포,1536,1620,3156
<class,9호선,구반포,1153,1308,2461
<class,9호선,동작,1419,1186,2605
<class,9호선,흑석,3795,4032,7827
<class,9호선,노들,2483,2279,4762
<class,9호선,노량진,13902,14541,28443
<class,9호선,샛강,1774,1717,3491
<class,9호선,여의도,8578,7566,16144
<class,9호선,국회의사당,4158,3962,8120
<class,9호선,당산,8358,8343,16701
<class,9호선,선유도,3131,3142,6273
<class,9호선,신목동,1644,1551,3195
<class,9호선,염창,7969,7819,15788
<class,9호선,등촌,5014,5236,10250
<class,9호선,증미,3036,3079,6115
<class,9호선,가양,9649,9837,19486
<class,9호선,양천향교,3996,4246,8242
<class,9호선,마곡나루,5928,5676,11604
<class,9호선,신방화,3185,3301,6486
<class,9호선,공항시장,1682,1820,3502
<class,9호선,김포공항,7707,11208,18915
<class,9호선,개화,1045,986,2031
<class,8호선,모란,2399,2053,4452
<class,8호선,수진,2692,2562,5254
<class,8호선,신흥,2678,2848,5526
<class,8호선,단대오거리,5225,5055,10280
<class,8호선,남한산성입구,6353,6203,12556
<class,8호선,산성,3419,3553,6972
<class,8호선,복정,4878,4575,9453
<class,8호선,장지,8714,8709,17423
<class,8호선,문정,5319,5750,11069
<class,8호선,가락시장,3014,3751,6765
<class,8호선,송파,3447,3728,7175
<class,8호선,석촌,4056,5071,9127
<class,8호선,잠실,9258,9880,19138
<class,8호선,몽촌토성,3365,3384,6749
<class,8호선,강동구청,4247,4434,8681
<class,8호선,천호,8462,9578,18040
<class,8호선,암사,8649,8261,16910
<class,7호선,부평구청,3698,3213,6911
<class,7호선,굴포천,4519,4589,9108
<class,7호선,삼산체육관,2518,2472,4990
<class,7호선,상동,6890,6855,13745
<class,7호선,부천시청,6820,6575,13395
<class,7호선,신중동,6507,6445,12952
<class,7호선,춘의,3381,3275,6656
<class,7호선,부천종합운동장,2364,2141,4505
<class,7호선,까치울,4157,4113,8270
<class,7호선,온수,3727,3888,7615
<class,7호선,천왕,4707,4544,9251
<class,7호선,광명사거리,12002,11771,23773
<class,7호선,철산,10046,10202,20248
<class,7호선,가산디지털단지,10671,9749,20420
<class,7호선,남구로,6445,6540,12985
<class,7호선,대림,6780,6249,13029
<class,7호선,신풍,5821,5657,11478
<class,7호선,보라매,4382,4393,8775
<class,7호선,신대방삼거리,7530,7495,15025
<class,7호선,장승배기,4678,4686,9364
<class,7호선,상도,5211,5225,10436
<class,7호선,숭실대입구,5491,5900,11391
<class,7호선,남성,5103,5109,10212
<class,7호선,이수,7892,7696,15588
<class,7호선,내방,5094,5212,10306
<class,7호선,고속터미널,11566,7531,19097
<class,7호선,반포,2785,2868,5653
<class,7호선,논현,6159,6522,12681
<class,7호선,학동,6055,6513,12568
<class,7호선,강남구청,5362,5933,11295
<class,7호선,청담,6508,6973,13481
<class,7호선,뚝섬유원지,8134,7878,16012
<class,7호선,건대입구,7492,7565,15057
<class,7호선,어린이대공원,7711,7970,15681
<class,7호선,군자,7483,6017,13500
<class,7호선,중곡,4827,4726,9553
<class,7호선,용마산,3233,3637,6870
<class,7호선,사가정,9054,8760,17814
<class,7호선,면목,7657,7650,15307
<class,7호선,상봉,9152,8625,17777
<class,7호선,중화,6024,5638,11662
<class,7호선,먹골,5569,5463,11032
<class,7호선,태릉입구,5881,5854,11735
<class,7호선,공릉,6501,6498,12999
<class,7호선,하계,8770,8438,17208
<class,7호선,중계,6573,6034,12607
<class,7호선,노원,10406,10500,20906
<class,7호선,마들,5705,5494,11199
<class,7호선,수락산,8420,8307,16727
<class,7호선,도봉산,5746,8398,14144
<class,7호선,장암,1577,1096,2673
<class,6호선,봉화산,3822,3861,7683
<class,6호선,화랑대,4888,4365,9253
<class,6호선,태릉입구,3826,4381,8207
<class,6호선,석계,6421,6403,12824
<class,6호선,돌곶이,4733,4409,9142
<class,6호선,상월곡,3202,2948,6150
<class,6호선,월곡,5384,5414,10798
<class,6호선,고려대,3997,3874,7871
<class,6호선,안암,4747,5020,9767
<class,6호선,보문,3712,3592,7304
<class,6호선,창신,1607,1512,3119
<class,6호선,동묘앞,6502,6499,13001
<class,6호선,신당,3604,4298,7902
<class,6호선,청구,1504,1637,3141
<class,6호선,약수,1529,1512,3041
<class,6호선,버티고개,1126,1256,2382
<class,6호선,한강진,5659,6510,12169
<class,6호선,이태원,9062,8733,17795
<class,6호선,녹사평,3988,3746,7734
<class,6호선,삼각지,3578,2668,6246
<class,6호선,효창공원앞,3324,3060,6384
<class,6호선,대흥,3567,3792,7359
<class,6호선,광흥창,3982,3881,7863
<class,6호선,상수,5678,5967,11645
<class,6호선,합정,8575,7779,16354
<class,6호선,망원,9643,10395,20038
<class,6호선,마포구청,6738,6430,13168
<class,6호선,월드컵경기장,4622,4598,9220
<class,6호선,디지털미디어시티,4912,5219,10131
<class,6호선,증산,5320,5709,11029
<class,6호선,새절,6421,6306,12727
<class,6호선,구산,3750,2901,6651
<class,6호선,독바위,1601,2093,3694
<class,6호선,불광,3025,2694,5719
<class,6호선,역촌,1960,2327,4287
<class,6호선,응암,9026,9188,18214
<class,5호선,하남검단산,4187,4262,8449
<class,5호선,하남시청,3192,3105,6297
<class,5호선,하남풍산,2076,2028,4104
<class,5호선,미사,7673,7686,15359
<class,5호선,강일,1748,1611,3359
<class,5호선,마천,3319,3693,7012
<class,5호선,거여,3722,3620,7342
<class,5호선,개롱,2946,3198,6144
<class,5호선,오금,1527,1511,3038
<class,5호선,방이,3775,3704,7479
<class,5호선,올림픽공원,2390,2417,4807
<class,5호선,둔촌동,4300,4432,8732
<class,5호선,상일동,6686,6606,13292
<class,5호선,고덕,4077,4101,8178
<class,5호선,굽은다리,5185,4894,10079
<class,5호선,길동,4038,4176,8214
<class,5호선,강동,8488,8542,17030
<class,5호선,천호,12017,11060,23077
<class,5호선,광나루,7749,7778,15527
<class,5호선,아차산,11952,11994,23946
<class,5호선,군자,5662,6315,11977
<class,5호선,장한평,6963,7010,13973
<class,5호선,답십리,6960,6567,13527
<class,5호선,마장,2764,2635,5399
<class,5호선,왕십리,2529,2797,5326
<class,5호선,행당,3799,3496,7295
<class,5호선,신금호,2866,3141,6007
<class,5호선,청구,1714,1490,3204
<class,5호선,동대문역사문화공원,649,680,1329
<class,5호선,을지로4가,1380,1494,2874
<class,5호선,종로3가,8360,7322,15682
<class,5호선,광화문,10489,10554,21043
<class,5호선,서대문,5243,5121,10364
<class,5호선,충정로,1334,1434,2768
<class,5호선,애오개,2582,2725,5307
<class,5호선,마포,4736,4779,9515
<class,5호선,여의나루,10186,11504,21690
<class,5호선,여의도,8146,7504,15650
<class,5호선,신길,1739,2057,3796
<class,5호선,영등포시장,4206,4599,8805
<class,5호선,영등포구청,1398,1353,2751
<class,5호선,양평,2545,2612,5157
<class,5호선,오목교,11466,11798,23264
<class,5호선,목동,7309,7744,15053
<class,5호선,신정,6104,5634,11738
<class,5호선,까치산,15160,14853,30013
<class,5호선,화곡,13461,12712,26173
<class,5호선,우장산,6245,6636,12881
<class,5호선,발산,8698,8897,17595
<class,5호선,마곡,3382,3535,6917
<class,5호선,송정,3638,3703,7341
<class,5호선,김포공항,6847,6049,12896
<class,5호선,개화산,2592,2814,5406
<class,5호선,방화,3673,3541,7214
<class,4호선,쌍문,14921,13801,28722
<class,4호선,창동,13934,14538,28472
<class,4호선,노원,11177,11847,23024
<class,4호선,상계,9883,9512,19395
<class,4호선,당고개,7744,7299,15043
<class,4호선,남태령,677,556,1233
<class,4호선,사당,13325,12503,25828
<class,4호선,총신대입구,9858,10652,20510
<class,4호선,동작,1914,1957,3871
<class,4호선,이촌,4557,5294,9851
<class,4호선,신용산,7014,7149,14163
<class,4호선,삼각지,2130,2896,5026
<class,4호선,숙대입구,6374,6110,12484
<class,4호선,서울역,3599,8141,11740
<class,4호선,회현,7962,8290,16252
<class,4호선,명동,9687,9808,19495
<class,4호선,충무로,8324,8326,16650
<class,4호선,동대문역사문화공원,7937,7520,15457
<class,4호선,동대문,6741,7213,13954
<class,4호선,혜화,19124,19881,39005
<class,4호선,한성대입구,7385,7523,14908
<class,4호선,성신여대입구,11537,11075,22612
<class,4호선,길음,9460,9264,18724
<class,4호선,미아사거리,15326,14766,30092
<class,4호선,미아,7636,7362,14998
<class,4호선,수유,18513,17790,36303
<class,3호선,오금,2482,2519,5001
<class,3호선,경찰병원,2571,2672,5243
<class,3호선,가락시장,3616,3829,7445
<class,3호선,수서,9893,9694,19587
<class,3호선,일원,2995,3215,6210
<class,3호선,대청,3862,3774,7636
<class,3호선,학여울,995,1020,2015
<class,3호선,대치,5575,5025,10600
<class,3호선,도곡,1822,1898,3720
<class,3호선,매봉,3699,3799,7498
<class,3호선,양재,12419,14414,26833
<class,3호선,남부터미널,14457,15160,29617
<class,3호선,교대,3959,2371,6330
<class,3호선,고속터미널,37634,33773,71407
<class,3호선,잠원,2155,2227,4382
<class,3호선,신사,13287,13015,26302
<class,3호선,압구정,13188,13741,26929
<class,3호선,옥수,4904,5235,10139
<class,3호선,금호,4151,3998,8149
<class,3호선,약수,6304,6120,12424
<class,3호선,동대입구,4643,5225,9868
<class,3호선,을지로3가,3034,2873,5907
<class,3호선,종로3가,3623,4769,8392
<class,3호선,안국,9409,10171,19580
<class,3호선,경복궁,11521,11979,23500
<class,3호선,독립문,4180,4710,8890
<class,3호선,무악재,1820,1929,3749
<class,3호선,홍제,8870,8691,17561
<class,3호선,녹번,6766,6283,13049
<class,3호선,불광,9530,11329,20859
<class,3호선,연신내,21620,20116,41736
<class,3호선,구파발,11172,11468,22640
<class,3호선,지축,1852,1758,3610
<class,2호선,용두,1189,1213,2402
<class,2호선,신정네거리,4915,5034,9949
<class,2호선,양천구청,3096,3365,6461
<class,2호선,도림천,515,516,1031
<class,2호선,신설동,3054,2981,6035
<class,2호선,신답,732,799,1531
<class,2호선,용답,1636,1659,3295
<class,2호선,충정로,3486,3858,7344
<class,2호선,아현,4904,5048,9952
<class,2호선,이대,6555,7252,13807
<class,2호선,신촌,20340,19507,39847
<class,2호선,홍대입구,44553,43056,87609
<class,2호선,합정,19001,19798,38799
<class,2호선,당산,8485,9107,17592
<class,2호선,영등포구청,7744,8116,15860
<class,2호선,문래,7900,8333,16233
<class,2호선,신도림,26834,27361,54195
<class,2호선,대림,14319,14520,28839
<class,2호선,구로디지털단지,22173,21592,43765
<class,2호선,신대방,14398,14594,28992
<class,2호선,신림,35093,34563,69656
<class,2호선,봉천,11733,11544,23277
<class,2호선,서울대입구,26035,26745,52780
<class,2호선,낙성대,14990,15486,30476
<class,2호선,사당,19215,21445,40660
<class,2호선,방배,6630,7040,13670
<class,2호선,서초,10080,9450,19530
<class,2호선,교대,9689,10872,20561
<class,2호선,강남,33132,31630,64762
<class,2호선,역삼,10937,11934,22871
<class,2호선,선릉,12336,10827,23163
<class,2호선,삼성,22168,21678,43846
<class,2호선,종합운동장,4338,5040,9378
<class,2호선,잠실새내,10433,10533,20966
<class,2호선,잠실,41905,39050,80955
<class,2호선,잠실나루,5067,5282,10349
<class,2호선,강변,20559,19494,40053
<class,2호선,구의,10769,10984,21753
<class,2호선,건대입구,24870,25081,49951
<class,2호선,성수,11883,13318,25201
<class,2호선,뚝섬,10121,10566,20687
<class,2호선,한양대,2403,2734,5137
<class,2호선,왕십리,8994,7635,16629
<class,2호선,상왕십리,6686,6712,13398
<class,2호선,신당,7827,8426,16253
<class,2호선,동대문역사문화공원,7105,8140,15245
<class,2호선,을지로4가,3067,2951,6018
<class,2호선,을지로3가,7376,6625,14001
<class,2호선,을지로입구,14270,13165,27435
<class,2호선,시청,5484,4155,9639
<class,1호선,청량리,12797,12912,25709
<class,1호선,제기동,9577,10288,19865
<class,1호선,신설동,7086,7189,14275
<class,1호선,동대문,9543,9908,19451
<class,1호선,종로5가,9215,9128,18343
<class,1호선,종로3가,13349,11955,25304
<class,1호선,종각,11806,10359,22165
<class,1호선,시청,6899,7012,13911
<class,1호선,동묘앞,13374,13468,26842
<class,1호선,서울역,25130,21420,46550
<class,5호선,공덕,4420,4496,8916
<class,공항철도 1호선,영종,2720,2789,5509
<class,7호선,굴포천,6656,6783,13439
<class,7호선,삼산체육관,3665,3414,7079
<class,7호선,상동,10181,10296,20477
<class,7호선,부천시청,9650,9290,18940
<class,7호선,신중동,9698,9620,19318
<class,7호선,춘의,5147,4850,9997
<class,7호선,부천종합운동장,3394,3086,6480
<class,7호선,까치울,5650,5582,11232
<class,7호선,온수,5531,5551,11082
<class,7호선,천왕,6819,6410,13229
<class,7호선,광명사거리,16829,16670,33499
<class,7호선,철산,15139,15164,30303
<class,7호선,가산디지털단지,15056,14040,29096
<class,7호선,남구로,8299,8789,17088
<class,7호선,대림,7092,7419,14511
<class,7호선,신풍,8055,7747,15802
<class,7호선,보라매,6974,6733,13707
<class,7호선,신대방삼거리,11377,10460,21837
<class,7호선,장승배기,6949,6762,13711
<class,7호선,상도,7398,6885,14283
<class,7호선,숭실대입구,8138,8077,16215
<class,7호선,이수,11626,11004,22630
<class,7호선,내방,7769,7649,15418
<class,7호선,고속터미널,13105,10753,23858
<class,7호선,부평구청,5095,4439,9534
<class,8호선,암사,12193,11208,23401
<class,8호선,천호,11382,13692,25074
<class,8호선,강동구청,5993,5989,11982
<class,8호선,몽촌토성,4311,4410,8721
<class,8호선,잠실,11217,13241,24458
<class,8호선,석촌,5526,6695,12221
<class,8호선,송파,5281,5104,10385
<class,8호선,가락시장,5316,5508,10824
<class,8호선,문정,8414,8476,16890
<class,8호선,장지,12019,10821,22840
<class,8호선,복정,6899,5981,12880
<class,8호선,산성,4537,4595,9132
<class,8호선,남한산성입구,8846,8010,16856
<class,8호선,단대오거리,7296,6935,14231
<class,8호선,신흥,3674,3826,7500
<class,8호선,수진,4355,3771,8126
<class,8호선,모란,3398,2883,6281
<class,9호선,개화,1426,1274,2700
<class,9호선,김포공항,7690,12651,20341
<class,9호선,공항시장,2174,2282,4456
<class,9호선,신방화,4471,4271,8742
<class,9호선,마곡나루,7679,7657,15336
<class,9호선,양천향교,5789,5545,11334
<class,9호선,가양,13836,13199,27035
<class,9호선,증미,4169,4064,8233
<class,9호선,등촌,7183,6759,13942
<class,9호선,염창,11376,10737,22113
<class,9호선,신목동,2240,1972,4212
<class,9호선,선유도,4037,4093,8130
<class,9호선,당산,12336,11626,23962
<class,9호선,국회의사당,4007,4283,8290
<class,9호선,여의도,11501,11059,22560
<class,9호선,샛강,2574,2617,5191
<class,9호선,노량진,19962,19603,39565
<class,9호선,노들,3490,2831,6321
<class,중앙선,도농,6751,6455,13206
<class,중앙선,양정,675,585,1260
<class,중앙선,덕소,4688,4667,9355
<class,중앙선,도심,1679,1485,3164
<class,중앙선,팔당,1722,1923,3645
<class,중앙선,운길산,1811,1811,3622
<class,중앙선,양수,2483,2630,5113
<class,중앙선,신원,327,259,586
<class,중앙선,국수,759,759,1518
<class,중앙선,아신,648,689,1337
<class,중앙선,오빈,292,292,584
<class,중앙선,양평,2989,3023,6012
<class,중앙선,원덕,472,541,1013
<class,중앙선,용문,4166,4406,8572
<class,중앙선,지평,60,86,146
<class,7호선,반포,4341,4122,8463
<class,7호선,논현,11317,12190,23507
<class,7호선,학동,10356,11046,21402
<class,7호선,강남구청,9810,10840,20650
<class,7호선,청담,11070,11920,22990
<class,7호선,뚝섬유원지,11019,10627,21646
<class,7호선,건대입구,10650,10595,21245
<class,7호선,어린이대공원,9474,9284,18758
<class,7호선,군자,10537,8003,18540
<class,7호선,중곡,6800,6320,13120
<class,7호선,용마산,4428,4548,8976
<class,7호선,사가정,12477,11879,24356
<class,7호선,면목,11262,10703,21965
<class,7호선,상봉,13064,12488,25552
<class,7호선,중화,8130,7578,15708
<class,7호선,먹골,8134,7929,16063
<class,7호선,태릉입구,6682,6280,12962
<class,7호선,공릉,8991,8980,17971
<class,7호선,하계,12080,11227,23307
<class,7호선,중계,9255,8236,17491
<class,7호선,노원,15603,16259,31862
<class,7호선,마들,8882,8326,17208
<class,7호선,수락산,10542,10221,20763
<class,1호선,서울역,28250,28352,56602
<class,7호선,도봉산,6765,9572,16337
<class,7호선,장암,1820,1199,3019
<class,6호선,봉화산,5101,5033,10134
<class,6호선,화랑대,6827,5782,12609
<class,6호선,태릉입구,4106,4324,8430
<class,6호선,석계,8811,8551,17362
<class,6호선,돌곶이,5890,5559,11449
<class,6호선,상월곡,4241,3682,7923
<class,6호선,월곡,7156,6955,14111
<class,6호선,고려대,5255,4735,9990
<class,6호선,안암,6026,5975,12001
<class,6호선,보문,5135,4561,9696
<class,6호선,창신,2165,1810,3975
<class,6호선,동묘앞,7717,7110,14827
<class,6호선,신당,5526,4681,10207
<class,6호선,청구,2374,2405,4779
<class,6호선,약수,2373,2486,4859
<class,6호선,버티고개,1516,1525,3041
<class,6호선,한강진,7309,9192,16501
<class,6호선,이태원,11329,12202,23531
<class,6호선,녹사평,5175,5420,10595
<class,6호선,삼각지,5260,3967,9227
<class,6호선,효창공원앞,4633,4095,8728
<class,6호선,공덕,9583,9176,18759
<class,6호선,대흥,5275,5190,10465
<class,6호선,광흥창,5025,4716,9741
<class,6호선,상수,7645,9021,16666
<class,6호선,합정,12039,11247,23286
<class,6호선,망원,12908,14459,27367
<class,6호선,마포구청,9452,8229,17681
<class,6호선,월드컵경기장,4720,4945,9665
<class,6호선,디지털미디어시티,7135,7116,14251
<class,6호선,증산,7288,7169,14457
<class,6호선,새절,9031,8549,17580
<class,6호선,구산,5269,3999,9268
<class,6호선,연신내,2,0,2
<class,6호선,독바위,2014,2331,4345
<class,6호선,불광,3902,3639,7541
<class,6호선,역촌,2547,2917,5464
<class,6호선,응암,12480,12289,24769
<class,5호선,하남검단산,4943,4962,9905
<class,5호선,하남시청,4398,4243,8641
<class,5호선,하남풍산,2733,2714,5447
<class,5호선,미사,11160,10991,22151
<class,5호선,강일,2415,2224,4639
<class,5호선,마천,4551,4603,9154
<class,5호선,거여,5165,5032,10197
<class,5호선,개롱,4464,4728,9192
<class,5호선,오금,2155,1983,4138
<class,5호선,방이,5191,5011,10202
<class,5호선,올림픽공원,3077,3078,6155
<class,5호선,둔촌동,6241,6100,12341
<class,5호선,상일동,9548,8757,18305
<class,5호선,고덕,6025,5886,11911
<class,5호선,명일,5979,6061,12040
<class,5호선,굽은다리,7063,6563,13626
<class,5호선,길동,5857,5926,11783
<class,5호선,강동,12112,11338,23450
<class,5호선,천호,16071,15298,31369
<class,5호선,광나루,10372,10004,20376
<class,5호선,아차산,12900,12342,25242
<class,5호선,군자,8169,8805,16974
<class,5호선,장한평,10997,10441,21438
<class,5호선,답십리,10064,9006,19070
<class,5호선,마장,3984,3737,7721
<class,5호선,왕십리,3603,4161,7764
<class,5호선,행당,5601,4896,10497
<class,5호선,신금호,4132,4116,8248
<class,5호선,청구,2507,2240,4747
<class,5호선,동대문역사문화공원,891,1187,2078
<class,5호선,을지로4가,3345,3761,7106
<class,5호선,종로3가,11506,12171,23677
<class,5호선,광화문,13491,14078,27569
<class,5호선,서대문,6707,6590,13297
<class,5호선,충정로,1969,1846,3815
<class,5호선,애오개,3699,3553,7252
<class,5호선,공덕,6736,6963,13699
<class,5호선,마포,6854,6787,13641
<class,5호선,여의나루,14222,15665,29887
<class,5호선,여의도,11105,11963,23068
<class,5호선,신길,2481,2528,5009
<class,5호선,영등포시장,6649,7025,13674
<class,5호선,영등포구청,2008,1848,3856
<class,5호선,양평,3582,3396,6978
<class,5호선,오목교,16410,17018,33428
<class,5호선,목동,11496,11424,22920
<class,5호선,신정,8732,7544,16276
<class,5호선,까치산,20789,19605,40394
<class,5호선,화곡,19577,18039,37616
<class,5호선,우장산,9740,9543,19283
<class,5호선,발산,12786,13815,26601
<class,5호선,마곡,5253,5178,10431
<class,5호선,송정,5028,4850,9878
<class,5호선,김포공항,7159,7330,14489
<class,5호선,개화산,3687,3605,7292
<class,5호선,방화,4664,4372,9036
<class,4호선,쌍문,21087,19065,40152
<class,4호선,창동,19224,20157,39381
<class,4호선,노원,15771,17270,33041
<class,4호선,상계,13468,12642,26110
<class,4호선,당고개,9612,9133,18745
<class,4호선,남태령,976,777,1753
<class,4호선,사당,19553,16367,35920
<class,4호선,총신대입구,14456,15420,29876
<class,4호선,동작,3115,3343,6458
<class,4호선,이촌,6225,7091,13316
<class,4호선,신용산,9186,10196,19382
<class,4호선,삼각지,2973,3858,6831
<class,4호선,숙대입구,8909,8439,17348
<class,4호선,서울역,4873,11058,15931
<class,4호선,회현,16800,18125,34925
<class,4호선,명동,12391,14128,26519
<class,4호선,충무로,12581,13041,25622
<class,4호선,동대문역사문화공원,10400,8879,19279
<class,4호선,동대문,14139,14231,28370
<class,4호선,혜화,23890,24967,48857
<class,4호선,한성대입구,10524,10094,20618
<class,4호선,성신여대입구,15850,15034,30884
<class,4호선,길음,13604,12922,26526
<class,4호선,미아사거리,21269,20440,41709
<class,4호선,미아,10603,9876,20479
<class,4호선,수유,25648,24805,50453
<class,3호선,오금,3663,3354,7017
<class,3호선,경찰병원,3934,3777,7711
<class,3호선,가락시장,5989,5696,11685
<class,3호선,수서,12445,12676,25121
<class,3호선,일원,4883,4651,9534
<class,3호선,대청,5688,5261,10949
<class,3호선,학여울,1700,1778,3478
<class,3호선,대치,8980,8084,17064
<class,3호선,도곡,3267,3143,6410
<class,3호선,매봉,6033,5843,11876
<class,3호선,양재,19675,21258,40933
<class,3호선,남부터미널,20668,21522,42190
<class,3호선,교대,6179,3725,9904
<class,3호선,고속터미널,44730,45180,89910
<class,3호선,잠원,3475,3365,6840
<class,3호선,신사,23730,24547,48277
<class,3호선,압구정,24345,25316,49661
<class,3호선,옥수,7438,7313,14751
<class,3호선,금호,5735,5211,10946
<class,3호선,약수,9007,8284,17291
<class,3호선,동대입구,5657,6222,11879
<class,3호선,을지로3가,5106,5909,11015
<class,3호선,종로3가,5547,7999,13546
<class,3호선,안국,12883,14764,27647
<class,3호선,경복궁,14076,15505,29581
<class,3호선,독립문,5919,6292,12211
<class,3호선,무악재,2590,2585,5175
<class,3호선,홍제,12845,12018,24863
<class,3호선,녹번,9976,8542,18518
<class,3호선,불광,12791,14380,27171
<class,3호선,연신내,29593,27567,57160
<class,3호선,구파발,15126,15435,30561
<class,3호선,지축,2694,2588,5282
<class,2호선,용두,1659,1631,3290
<class,2호선,신정네거리,7377,7425,14802
<class,2호선,양천구청,4431,4497,8928
<class,2호선,도림천,823,821,1644
<class,2호선,신설동,3181,3110,6291
<class,2호선,신답,966,1004,1970
<class,2호선,용답,1977,1934,3911
<class,2호선,충정로,5509,5683,11192
<class,2호선,아현,7471,7206,14677
<class,2호선,이대,9152,9201,18353
<class,2호선,신촌,27392,27820,55212
<class,2호선,홍대입구,58931,63687,122618
<class,2호선,합정,26757,29099,55856
<class,2호선,당산,13066,14018,27084
<class,2호선,영등포구청,12229,12492,24721
<class,2호선,문래,12057,13066,25123
<class,2호선,신도림,39208,39413,78621
<class,2호선,대림,17800,18842,36642
<class,2호선,구로디지털단지,33148,32157,65305
<class,2호선,신대방,19516,18892,38408
<class,2호선,신림,48665,46427,95092
<class,2호선,봉천,16670,15301,31971
<class,2호선,서울대입구,36461,35293,71754
<class,2호선,낙성대,20728,18832,39560
<class,2호선,사당,28289,31610,59899
<class,2호선,방배,9621,10086,19707
<class,2호선,서초,9739,8044,17783
<class,2호선,교대,16354,18257,34611
<class,2호선,강남,56876,56592,113468
<class,2호선,역삼,17740,19349,37089
<class,2호선,선릉,23331,20690,44021
<class,2호선,삼성,26592,27259,53851
<class,2호선,종합운동장,5527,5822,11349
<class,2호선,잠실새내,15581,16094,31675
<class,2호선,잠실,56063,53851,109914
<class,2호선,잠실나루,7560,7314,14874
<class,2호선,강변,24790,25474,50264
<class,2호선,구의,15881,15104,30985
<class,2호선,건대입구,32169,34628,66797
<class,2호선,성수,16602,19074,35676
<class,2호선,뚝섬,15672,16182,31854
<class,2호선,한양대,4273,4275,8548
<class,2호선,왕십리,12920,10869,23789
<class,2호선,상왕십리,9478,8947,18425
<class,2호선,신당,10174,10569,20743
<class,2호선,동대문역사문화공원,9185,9715,18900
<class,2호선,을지로4가,6996,7429,14425
<class,2호선,을지로3가,10666,10703,21369
<class,2호선,을지로입구,19129,18968,38097
<class,2호선,시청,7726,6127,13853
<class,1호선,청량리,18294,18460,36754
<class,1호선,제기동,14669,15098,29767
<class,1호선,신설동,9040,8438,17478
<class,1호선,동대문,10867,10148,21015
<class,1호선,종로5가,17857,17904,35761
<class,1호선,종로3가,22078,20479,42557
<class,1호선,종각,17102,16012,33114
<class,1호선,동묘앞,11510,11932,23442
<class,9호선,흑석,5327,5287,10614
<class,9호선,동작,3903,3686,7589
<class,9호선,구반포,1980,2095,4075
<class,9호선,신반포,2569,2514,5083
<class,9호선,고속터미널,12398,17344,29742
<class,9호선,사평,2032,1892,3924
<class,9호선,신논현,24486,24181,48667
<class,9호선2~3단계,언주,5993,5930,11923
<class,9호선2~3단계,선정릉,4744,5395,10139
<class,9호선2~3단계,삼성중앙,2941,2843,5784
<class,9호선2~3단계,봉은사,10407,10940,21347
<class,9호선2~3단계,종합운동장,3300,2975,6275
<class,9호선2~3단계,삼전,4622,4273,8895
<class,9호선2~3단계,석촌고분,4004,3832,7836
<class,9호선2~3단계,석촌,6360,5280,11640
<class,9호선2~3단계,송파나루,3757,4204,7961
<class,9호선2~3단계,한성백제,1898,1571,3469
<class,9호선2~3단계,올림픽공원,6741,6812,13553
<class,9호선2~3단계,둔촌오륜,840,796,1636
<class,9호선2~3단계,중앙보훈병원,4574,4289,8863
<class,경강선,판교,2853,2637,5490
<class,경강선,이매,863,639,1502
<class,경강선,삼동,1489,1394,2883
<class,경강선,경기광주,4981,4674,9655
<class,경강선,초월,2285,2113,4398
<class,경강선,곤지암,1698,1907,3605
<class,경강선,신둔도예촌,1024,1043,2067
<class,경강선,이천,2535,2763,5298
<class,경강선,부발,1717,1496,3213
<class,경강선,세종대왕릉,289,332,621
<class,경강선,여주,2322,2613,4935
<class,경부선,서울역,5413,1625,7038
<class,경부선,남영,5763,5945,11708
<class,경부선,용산,30324,33049,63373
<class,경부선,노량진,8373,7650,16023
<class,경부선,대방,7793,7805,15598
<class,경부선,영등포,35646,37281,72927
<class,경부선,신도림,3163,3256,6419
<class,경부선,신길,6354,5296,11650
<class,경부선,구로,13049,13565,26614
<class,경부선,가산디지털단지,6141,8248,14389
<class,경부선,금천구청,8824,8645,17469
<class,경부선,석수,7276,6754,14030
<class,경부선,관악,6087,5694,11781
<class,경부선,안양,17492,17463,34955
<class,경부선,명학,5032,4887,9919
<class,경부선,금정,18106,17779,35885
<class,경부선,군포,4465,4001,8466
<class,경부선,의왕,6024,5797,11821
<class,경부선,성균관대,10391,9985,20376
<class,경부선,화서,5546,5424,10970
<class,경부선,수원,36010,39115,75125
<class,경부선,독산,8326,8290,16616
<class,경부선,세류,2525,2433,4958
<class,경부선,병점,11945,11903,23848
<class,경부선,세마,2148,1855,4003
<class,경부선,오산대,2914,2561,5475
<class,경부선,오산,9192,8531,17723
<class,경부선,진위,1000,872,1872
<class,경부선,송탄,4520,4148,8668
<class,경부선,서정리,5775,5172,10947
<class,경부선,평택지제,2570,2474,5044
<class,경부선,평택,13323,12631,25954
<class,경부선,성환,2903,2676,5579
<class,경부선,직산,653,697,1350
<class,경부선,두정,5188,5330,10518
<class,경부선,천안,5780,6126,11906
<class,경부선,당정,4148,3893,8041
<class,경부선,서동탄,989,1047,2036
<class,경부선,광명,2543,2191,4734
<class,경원선,이촌,3207,2284,5491
<class,경원선,서빙고,1334,1188,2522
<class,경원선,한남,2794,2609,5403
<class,경원선,옥수,32,40,72
<class,경원선,응봉,1741,1581,3322
<class,경원선,왕십리,11831,13531,25362
<class,경원선,청량리,15259,16906,32165
<class,경원선,외대앞,6053,5949,12002
<class,경원선,신이문,6181,5531,11712
<class,경원선,석계,6298,6961,13259
<class,경원선,광운대,5570,5370,10940
<class,경원선,월계,4698,4351,9049
<class,경원선,녹천,3468,2854,6322
<class,경원선,방학,7457,7346,14803
<class,경원선,도봉,4386,4199,8585
<class,경원선,도봉산,9623,6551,16174
<class,경원선,망월사,6021,6134,12155
<class,경원선,회룡,9527,9540,19067
<class,경원선,의정부,17162,18121,35283
<class,경원선,가능,5008,4797,9805
<class,경원선,녹양,3644,3584,7228
<class,경원선,양주,6102,5887,11989
<class,경원선,덕계,2326,2122,4448
<class,경원선,덕정,4345,4078,8423
<class,경원선,지행,5354,5334,10688
<class,경원선,동두천중앙,2892,2914,5806
<class,경원선,보산,1793,1722,3515
<class,경원선,동두천,1713,2144,3857
<class,경원선,소요산,4238,3739,7977
<class,경의선,서울역,1237,1372,2609
<class,경의선,신촌,358,401,759
<class,경의선,효창공원앞,1799,1872,3671
<class,경의선,공덕,2409,1994,4403
<class,경의선,서강대,1684,1471,3155
<class,경의선,홍대입구,2001,2350,4351
<class,경의선,가좌,3964,3684,7648
<class,경의선,디지털미디어시티,1972,1815,3787
<class,경의선,수색,1445,1433,2878
<class,경의선,화전,1010,1024,2034
<class,경의선,강매,1989,1845,3834
<class,경의선,행신,5066,5219,10285
<class,경의선,능곡,2806,2730,5536
<class,경의선,곡산,443,451,894
<class,경의선,백마,4431,4156,8587
<class,경의선,풍산,4149,4087,8236
<class,경의선,일산,6063,5754,11817
<class,경의선,탄현,5188,5007,10195
<class,경의선,야당,5334,5351,10685
<class,경의선,운정,4751,4543,9294
<class,경의선,금릉,3747,3542,7289
<class,경의선,금촌,5606,5484,11090
<class,경의선,월롱,1341,1272,2613
<class,경의선,파주,891,737,1628
<class,1호선,시청,9418,10352,19770
<class,과천선,선바위,5181,4525,9706
<class,과천선,경마공원,1205,1166,2371
<class,과천선,대공원,7244,7621,14865
<class,과천선,과천,4371,3821,8192
<class,과천선,정부과천청사,6108,5962,12070
<class,과천선,인덕원,15048,14458,29506
<class,과천선,평촌,8802,8751,17553
<class,과천선,범계,19554,19115,38669
<class,분당선,선릉,5105,7685,12790
<class,분당선,한티,11514,11091,22605
<class,분당선,도곡,4285,3840,8125
<class,분당선,구룡,1530,1395,2925
<class,분당선,개포동,2695,2610,5305
<class,분당선,대모산입구,2421,2190,4611
<class,장항선,봉명,793,710,1503
<class,분당선,수서,9459,10205,19664
<class,분당선,수원,7371,6187,13558
<class,분당선,서울숲,10134,10743,20877
<class,분당선,압구정로데오,18267,20479,38746
<class,분당선,강남구청,5391,6623,12014
<class,분당선,선정릉,3632,3773,7405
<class,분당선,가천대,4973,5490,10463
<class,분당선,태평,10284,9621,19905
<class,분당선,모란,15540,15306,30846
<class,분당선,야탑,16541,17457,33998
<class,분당선,서현,17573,17878,35451
<class,분당선,수내,8480,7909,16389
<class,분당선,정자,10654,11000,21654
<class,분당선,미금,10735,11186,21921
<class,분당선,오리,7522,6307,13829
<class,분당선,이매,3953,3818,7771
<class,분당선,보정,1546,1406,2952
<class,분당선,죽전,9832,10947,20779
<class,분당선,구성,3111,3171,6282
<class,분당선,신갈,2862,2783,5645
<class,분당선,기흥,6494,6450,12944
<class,분당선,상갈,3747,3763,7510
<class,분당선,청명,2886,2694,5580
<class,분당선,영통,6437,6312,12749
<class,분당선,망포,9197,8288,17485
<class,분당선,매탄권선,3444,3220,6664
<class,분당선,수원시청,10375,11216,21591
<class,분당선,매교,2109,2120,4229
<class,수인선,고색,2347,2312,4659
<class,수인선,오목천,2007,1732,3739
<class,수인선,어천,668,578,1246
<class,수인선,야목,180,210,390
<class,수인선,사리,3170,2809,5979
<class,수인선,달월,56,56,112
<class,수인선,월곶,2169,2017,4186
<class,수인선,소래포구,5813,5902,11715
<class,수인선,인천논현,4706,4858,9564
<class,수인선,호구포,2515,2437,4952
<class,수인선,남동인더스파크,1072,1008,2080
<class,수인선,원인재,3688,3884,7572
<class,수인선,연수,3790,3820,7610
<class,수인선,송도,2253,2173,4426
<class,수인선,인하대,4056,3897,7953
<class,수인선,숭의,2748,2484,5232
<class,수인선,신포,1489,1539,3028
<class,수인선,인천,1320,2071,3391
<class,안산선,산본,12246,12965,25211
<class,안산선,대야미,4100,3615,7715
<class,안산선,반월,3471,3313,6784
<class,안산선,상록수,12213,12143,24356
<class,안산선,한대앞,7184,7150,14334
<class,안산선,중앙,15569,16178,31747
<class,안산선,고잔,6380,6212,12592
<class,안산선,초지,3256,3343,6599
<class,안산선,안산,9858,10168,20026
<class,안산선,신길온천,1409,1384,2793
<class,안산선,정왕,6194,6375,12569
<class,안산선,오이도,7477,7836,15313
<class,안산선,수리산,2930,2580,5510
<class,우이신설선,북한산우이,3445,3608,7053
<class,우이신설선,솔밭공원,1798,1718,3516
<class,우이신설선,4.19민주묘지,2404,2005,4409
<class,우이신설선,가오리,2874,2776,5650
<class,우이신설선,화계,2399,2181,4580
<class,우이신설선,삼양,1459,1508,2967
<class,우이신설선,삼양사거리,1872,1901,3773
<class,우이신설선,솔샘,3616,3214,6830
<class,우이신설선,북한산보국문,4453,4021,8474
<class,우이신설선,정릉,3456,2895,6351
<class,우이신설선,성신여대입구,2661,3118,5779
<class,우이신설선,보문,1127,1130,2257
<class,우이신설선,신설동,1432,1362,2794
<class,일산선,원흥,7288,7040,14328
<class,일산선,지축,1,0,1
<class,일산선,삼송,13120,12903,26023
<class,일산선,원당,8357,7948,16305
<class,일산선,화정,12674,13038,25712
<class,일산선,대곡,1448,1255,2703
<class,일산선,백석,7684,7746,15430
<class,일산선,마두,5111,5062,10173
<class,일산선,정발산,6515,6833,13348
<class,일산선,주엽,6485,6342,12827
<class,일산선,대화,9257,8589,17846
<class,중앙선,구리,10388,10550,20938
<class,중앙선,양원,1330,1380,2710
<class,중앙선,망우,6537,6302,12839
<class,중앙선,상봉,5215,4899,10114
<class,중앙선,중랑,4488,4275,8763
<class,중앙선,회기,18963,17863,36826
<class,장항선,신창,1065,1011,2076
<class,장항선,온양온천,3414,3453,6867
<class,장항선,배방,1018,976,1994
<class,장항선,아산,2679,2673,5352
<class,장항선,쌍용,1491,1353,2844
<class,7호선,남성,7637,7136,14773
<class,경의선,문산,4570,4486,9056
<class,경의선,임진강,114,88,202
<class,경인선,개봉,16144,15736,31880
<class,경인선,오류동,9124,8464,17588
<class,경인선,역곡,19846,19509,39355
<class,경인선,부천,28334,26615,54949
<class,경인선,송내,17908,17830,35738
<class,경인선,부평,28739,31308,60047
<class,경인선,백운,5377,5334,10711
<class,경인선,동암,12438,12599,25037
<class,경인선,주안,15026,13431,28457
<class,경인선,제물포,7562,7468,15030
<class,경인선,동인천,11838,11911,23749
<class,경인선,인천,4533,3929,8462
<class,경인선,구일,5496,5166,10662
<class,경인선,소사,7074,7131,14205
<class,경인선,부개,6297,5777,12074
<class,경인선,간석,4654,4325,8979
<class,경인선,도원,2251,2260,4511
<class,경인선,온수,5080,4573,9653
<class,경인선,중동,6632,6247,12879
<class,경인선,도화,3224,2888,6112
<class,경춘선,신내,1127,1123,2250
<class,경춘선,갈매,1996,1766,3762
<class,경춘선,별내,2369,2288,4657
<class,경춘선,퇴계원,2677,2466,5143
<class,경춘선,사릉,2374,2287,4661
<class,경춘선,금곡,1195,1070,2265
<class,경춘선,평내호평,4847,4698,9545
<class,경춘선,천마산,1378,1469,2847
<class,경춘선,마석,3208,3287,6495
<class,경춘선,대성리,675,790,1465
<class,경춘선,청평,1672,1947,3619
<class,경춘선,상천,470,429,899
<class,경춘선,가평,2292,2377,4669
<class,경춘선,굴봉산,210,274,484
<class,경춘선,백양리,140,181,321
<class,경춘선,강촌,872,892,1764
<class,경춘선,김유정,569,708,1277
<class,경춘선,남춘천,2419,2564,4983
<class,경춘선,춘천,1972,1663,3635
<class,공항철도 1호선,서울역,6465,6593,13058
<class,공항철도 1호선,공덕,1438,2135,3573
<class,공항철도 1호선,홍대입구,11634,11207,22841
<class,공항철도 1호선,디지털미디어시티,4909,4395,9304
<class,공항철도 1호선,마곡나루,3207,3368,6575
<class,공항철도 1호선,김포공항,11019,5842,16861
<class,공항철도 1호선,계양,6420,5868,12288
<class,공항철도 1호선,검암,4494,4640,9134
<class,공항철도 1호선,청라국제도시,3976,3786,7762
<class,공항철도 1호선,운서,5598,5765,11363
<class,공항철도 1호선,공항화물청사,1341,1367,2708
<class,공항철도 1호선,인천공항1터미널,2882,3132,6014
<class,공항철도 1호선,인천공항2터미널,1588,1481,3069
<class,9호선,당산,8171,8011,16182
<class,9호선,샛강,1689,1629,3318
<class,1호선,서울역,23747,20893,44640
<class,1호선,동묘앞,12501,12489,24990
<class,1호선,시청,6610,6440,13050
<class,1호선,종각,11063,9746,20809
<class,1호선,종로3가,13179,11591,24770
<class,1호선,종로5가,8312,8413,16725
<class,1호선,동대문,9010,9615,18625
<class,1호선,신설동,6453,6672,13125
<class,1호선,제기동,9088,9534,18622
<class,1호선,청량리,12563,12431,24994
<class,2호선,시청,4798,3847,8645
<class,2호선,을지로입구,13798,13181,26979
<class,2호선,을지로3가,7196,6535,13731
<class,2호선,을지로4가,2801,2750,5551
<class,2호선,동대문역사문화공원,6392,7685,14077
<class,2호선,신당,7563,7959,15522
<class,2호선,상왕십리,6511,6388,12899
<class,2호선,왕십리,8357,7055,15412
<class,2호선,한양대,2106,2365,4471
<class,2호선,뚝섬,11034,11454,22488
<class,2호선,성수,11307,12847,24154
<class,2호선,건대입구,22825,24093,46918
<class,2호선,구의,10607,10453,21060
<class,2호선,강변,19483,19045,38528
<class,2호선,잠실나루,4805,4978,9783
<class,2호선,잠실,39359,37109,76468
<class,2호선,잠실새내,9801,10074,19875
<class,2호선,종합운동장,4368,4837,9205
<class,2호선,삼성,18270,18107,36377
<class,2호선,선릉,11776,10188,21964
<class,2호선,역삼,10005,10703,20708
<class,2호선,강남,31080,29926,61006
<class,2호선,교대,9218,10389,19607
<class,2호선,서초,9690,9148,18838
<class,2호선,방배,6598,7039,13637
<class,2호선,사당,19377,21625,41002
<class,2호선,낙성대,14435,14997,29432
<class,2호선,서울대입구,24989,25650,50639
<class,2호선,봉천,11362,11212,22574
<class,2호선,신림,34304,33768,68072
<class,2호선,신대방,14283,14274,28557
<class,2호선,구로디지털단지,21734,21525,43259
<class,2호선,대림,14413,14576,28989
<class,2호선,신도림,26563,26898,53461
<class,2호선,문래,7395,7962,15357
<class,2호선,영등포구청,7162,7439,14601
<class,2호선,당산,8395,9124,17519
<class,2호선,합정,18446,19069,37515
<class,2호선,홍대입구,43137,42995,86132
<class,2호선,신촌,18961,18516,37477
<class,2호선,이대,5875,6371,12246
<class,2호선,아현,4831,4668,9499
<class,2호선,충정로,3604,3867,7471
<class,2호선,용답,1582,1587,3169
<class,2호선,신답,694,763,1457
<class,2호선,신설동,2732,2808,5540
<class,2호선,도림천,512,510,1022
<class,2호선,양천구청,3025,3201,6226
<class,2호선,신정네거리,4769,4809,9578
<class,2호선,용두,1130,1105,2235
<class,3호선,지축,1816,1719,3535
<class,3호선,구파발,10978,11314,22292
<class,3호선,연신내,20757,19719,40476
<class,3호선,불광,9237,10978,20215
<class,3호선,녹번,6638,6038,12676
<class,3호선,홍제,8522,8111,16633
<class,3호선,무악재,1737,1850,3587
<class,3호선,독립문,3939,4392,8331
<class,3호선,경복궁,9883,10546,20429
<class,3호선,안국,8239,9282,17521
<class,3호선,종로3가,3386,4534,7920
<class,3호선,을지로3가,2927,2826,5753
<class,3호선,충무로,1,0,1
<class,3호선,동대입구,4172,4808,8980
<class,3호선,약수,6231,6054,12285
<class,3호선,금호,4055,3913,7968
<class,3호선,옥수,4825,5015,9840
<class,3호선,압구정,12826,13199,26025
<class,3호선,신사,11635,12028,23663
<class,3호선,잠원,2106,2054,4160
<class,3호선,고속터미널,36585,33197,69782
<class,3호선,교대,3780,2355,6135
<class,3호선,남부터미널,13218,14203,27421
<class,3호선,양재,11852,13880,25732
<class,3호선,매봉,3828,3850,7678
<class,3호선,도곡,2025,2080,4105
<class,3호선,대치,5548,4820,10368
<class,3호선,학여울,1101,1213,2314
<class,3호선,대청,3832,3756,7588
<class,3호선,일원,2977,3229,6206
<class,3호선,수서,9752,9439,19191
<class,3호선,가락시장,3535,3819,7354
<class,3호선,경찰병원,2654,2707,5361
<class,3호선,오금,2349,2315,4664
<class,4호선,수유,18577,17562,36139
<class,4호선,미아,7410,7092,14502
<class,4호선,미아사거리,15195,14473,29668
<class,4호선,길음,9027,8772,17799
<class,4호선,성신여대입구,11174,10917,22091
<class,4호선,한성대입구,7294,7335,14629
<class,4호선,혜화,18200,19019,37219
<class,4호선,동대문,6557,7136,13693
<class,4호선,동대문역사문화공원,7451,7416,14867
<class,4호선,충무로,7470,7492,14962
<class,4호선,명동,9712,10176,19888
<class,4호선,회현,7489,7826,15315
<class,4호선,서울역,3616,7867,11483
<class,4호선,숙대입구,6154,5875,12029
<class,4호선,삼각지,1978,2633,4611
<class,4호선,신용산,6929,7199,14128
<class,4호선,이촌,4543,5211,9754
<class,4호선,동작,3795,3495,7290
<class,4호선,총신대입구,9520,10307,19827
<class,4호선,사당,13340,12465,25805
<class,4호선,남태령,560,480,1040
<class,4호선,당고개,7495,7179,14674
<class,4호선,상계,9836,9139,18975
<class,4호선,노원,10936,11844,22780
<class,4호선,창동,13762,14367,28129
<class,4호선,쌍문,14676,13358,28034
<class,5호선,방화,3379,3419,6798
<class,5호선,개화산,2623,2642,5265
<class,5호선,김포공항,6830,6126,12956
<class,5호선,송정,3409,3498,6907
<class,5호선,마곡,3142,3305,6447
<class,5호선,발산,8012,8486,16498
<class,5호선,우장산,6100,6305,12405
<class,5호선,화곡,13114,12521,25635
<class,5호선,까치산,14794,14463,29257
<class,5호선,신정,5858,5240,11098
<class,5호선,목동,7530,7755,15285
<class,5호선,오목교,10706,11206,21912
<class,5호선,양평,2372,2449,4821
<class,5호선,영등포구청,1252,1252,2504
<class,5호선,영등포시장,3996,4323,8319
<class,5호선,신길,1665,1866,3531
<class,5호선,여의도,6967,7450,14417
<class,5호선,여의나루,10469,11281,21750
<class,5호선,마포,4195,4291,8486
<class,5호선,공덕,3927,4107,8034
<class,5호선,애오개,2421,2460,4881
<class,5호선,충정로,1339,1414,2753
<class,5호선,서대문,4744,4742,9486
<class,5호선,광화문,9521,9466,18987
<class,5호선,종로3가,7530,6909,14439
<class,5호선,을지로4가,1451,1496,2947
<class,5호선,동대문역사문화공원,655,722,1377
<class,5호선,청구,1717,1597,3314
<class,5호선,신금호,2834,3051,5885
<class,5호선,행당,3681,3421,7102
<class,5호선,왕십리,2241,2565,4806
<class,5호선,마장,2656,2583,5239
<class,5호선,답십리,6673,6258,12931
<class,5호선,장한평,6841,6748,13589
<class,5호선,군자,5560,6037,11597
<class,5호선,아차산,10250,9988,20238
<class,5호선,광나루,7243,7175,14418
<class,5호선,천호,11586,10859,22445
<class,5호선,강동,7977,7969,15946
<class,5호선,길동,3717,3923,7640
<class,5호선,굽은다리,5028,4762,9790
<class,5호선,명일,4190,4296,8486
<class,5호선,고덕,4041,4042,8083
<class,5호선,상일동,6343,6043,12386
<class,5호선,둔촌동,4313,4515,8828
<class,5호선,올림픽공원,2260,2284,4544
<class,5호선,방이,3665,3455,7120
<class,5호선,오금,1420,1325,2745
<class,5호선,개롱,2755,2980,5735
<class,5호선,거여,3618,3440,7058
<class,5호선,마천,3252,3679,6931
<class,5호선,강일,1712,1641,3353
<class,5호선,미사,7627,7710,15337
<class,5호선,하남풍산,1934,1994,3928
<class,5호선,하남시청,3187,3116,6303
<class,5호선,하남검단산,4326,4421,8747
<class,6호선,응암,8950,8982,17932
<class,6호선,역촌,1939,2113,4052
<class,6호선,불광,3102,2619,5721
<class,6호선,독바위,1555,1934,3489
<class,6호선,연신내,1,0,1
<class,6호선,구산,3712,2688,6400
<class,6호선,새절,6288,6163,12451
<class,6호선,증산,5322,5414,10736
<class,6호선,디지털미디어시티,4740,4957,9697
<class,6호선,월드컵경기장,4009,4039,8048
<class,6호선,마포구청,6607,6043,12650
<class,6호선,망원,8938,9763,18701
<class,6호선,합정,8670,7688,16358
<class,6호선,상수,5239,6383,11622
<class,6호선,광흥창,3792,3597,7389
<class,6호선,대흥,3378,3610,6988
<class,6호선,공덕,6128,5661,11789
<class,6호선,효창공원앞,3224,2748,5972
<class,6호선,삼각지,3250,2504,5754
<class,6호선,녹사평,3727,3701,7428
<class,6호선,이태원,8742,8491,17233
<class,6호선,한강진,5689,6663,12352
<class,6호선,버티고개,1073,1207,2280
<class,6호선,약수,1574,1486,3060
<class,6호선,청구,1591,1559,3150
<class,6호선,신당,3318,4076,7394
<class,6호선,동묘앞,6001,5778,11779
<class,6호선,창신,1540,1414,2954
<class,6호선,보문,3638,3375,7013
<class,6호선,안암,4137,4379,8516
<class,6호선,고려대,3707,3557,7264
<class,6호선,월곡,5139,5087,10226
<class,6호선,상월곡,2959,2770,5729
<class,6호선,돌곶이,4756,4439,9195
<class,6호선,석계,6038,6195,12233
<class,6호선,태릉입구,2934,3281,6215
<class,6호선,화랑대,4733,4118,8851
<class,6호선,봉화산,3685,3675,7360
<class,6호선,신내,1,0,1
<class,7호선,장암,1613,1124,2737
<class,7호선,도봉산,5498,8164,13662
<class,7호선,수락산,8299,8327,16626
<class,7호선,마들,5620,5195,10815
<class,7호선,노원,10108,10438,20546
<class,7호선,중계,6257,5699,11956
<class,7호선,하계,8415,8049,16464
<class,7호선,공릉,5834,5968,11802
<class,7호선,태릉입구,4729,4339,9068
<class,7호선,먹골,5142,4977,10119
<class,7호선,중화,5463,5239,10702
<class,7호선,상봉,8820,8435,17255
<class,7호선,면목,7629,7538,15167
<class,7호선,사가정,8938,8599,17537
<class,7호선,용마산,3154,3578,6732
<class,7호선,중곡,4677,4634,9311
<class,7호선,군자,7081,5527,12608
<class,7호선,어린이대공원,6925,7087,14012
<class,7호선,건대입구,7295,7117,14412
<class,7호선,뚝섬유원지,8174,7716,15890
<class,7호선,청담,6427,6739,13166
<class,7호선,강남구청,5391,5765,11156
<class,7호선,학동,5620,6100,11720
<class,7호선,논현,5790,6222,12012
<class,7호선,반포,2792,2764,5556
<class,7호선,고속터미널,11085,7218,18303
<class,7호선,내방,4919,5003,9922
<class,7호선,이수,7646,7350,14996
<class,7호선,남성,4945,5068,10013
<class,7호선,숭실대입구,5354,5615,10969
<class,7호선,상도,4930,4883,9813
<class,7호선,장승배기,4477,4422,8899
<class,7호선,신대방삼거리,7590,7592,15182
<class,7호선,보라매,4358,4296,8654
<class,7호선,신풍,5695,5526,11221
<class,7호선,대림,6875,6512,13387
<class,7호선,남구로,6496,6442,12938
<class,7호선,가산디지털단지,10486,9866,20352
<class,7호선,철산,9756,9795,19551
<class,7호선,광명사거리,11851,11579,23430
<class,7호선,천왕,4595,4527,9122
<class,7호선,온수,3823,3841,7664
<class,7호선,까치울,4129,4096,8225
<class,7호선,부천종합운동장,2283,2100,4383
<class,7호선,춘의,3280,3157,6437
<class,7호선,신중동,6360,6246,12606
<class,7호선,부천시청,6413,6276,12689
<class,7호선,상동,6888,6877,13765
<class,7호선,삼산체육관,2521,2257,4778
<class,7호선,굴포천,4557,4649,9206
<class,7호선,부평구청,3567,3081,6648
<class,8호선,암사,8316,7942,16258
<class,8호선,천호,8089,9342,17431
<class,8호선,강동구청,4211,4390,8601
<class,8호선,몽촌토성,2980,2995,5975
<class,8호선,잠실,8428,9354,17782
<class,8호선,석촌,3704,4560,8264
<class,8호선,송파,3228,3281,6509
<class,8호선,가락시장,3158,3651,6809
<class,8호선,문정,4823,5157,9980
<class,8호선,장지,8359,8502,16861
<class,8호선,복정,4743,4462,9205
<class,8호선,산성,3309,3269,6578
<class,8호선,남한산성입구,6399,6142,12541
<class,8호선,단대오거리,4942,5074,10016
<class,8호선,신흥,2574,2768,5342
<class,8호선,수진,2753,2413,5166
<class,8호선,모란,2221,1923,4144
<class,9호선,개화,1065,984,2049
<class,9호선,김포공항,7202,10629,17831
<class,9호선,공항시장,1573,1756,3329
<class,9호선,신방화,3116,3199,6315
<class,9호선,마곡나루,5243,5320,10563
<class,9호선,양천향교,3853,4080,7933
<class,9호선,가양,9720,9669,19389
<class,9호선,증미,3009,2974,5983
<class,9호선,등촌,4852,4993,9845
<class,9호선,염창,7875,7912,15787
<class,9호선,신목동,1587,1426,3013
<class,9호선,선유도,2822,2807,5629
<class,9호선,국회의사당,4660,4485,9145
<class,9호선,여의도,7677,7279,14956
<class,9호선,노량진,13313,13964,27277
<class,9호선,노들,2531,2304,4835
<class,9호선,흑석,3795,3858,7653
<class,9호선,동작,7885,7786,15671
<class,9호선,구반포,1135,1229,2364
<class,9호선,신반포,1591,1697,3288
<class,9호선,고속터미널,9763,12687,22450
<class,9호선,사평,1317,1326,2643
<class,9호선,신논현,13815,12979,26794
<class,9호선2~3단계,언주,3557,3572,7129
<class,9호선2~3단계,선정릉,2977,3256,6233
<class,9호선2~3단계,삼성중앙,1751,1843,3594
<class,9호선2~3단계,봉은사,7443,7424,14867
<class,9호선2~3단계,종합운동장,2001,1805,3806
<class,9호선2~3단계,삼전,3139,3142,6281
<class,9호선2~3단계,석촌고분,2818,2813,5631
<class,9호선2~3단계,석촌,4229,3673,7902
<class,9호선2~3단계,송파나루,2439,2848,5287
<class,9호선2~3단계,한성백제,1471,1199,2670
<class,9호선2~3단계,올림픽공원,5175,5111,10286
<class,9호선2~3단계,둔촌오륜,391,451,842
<class,9호선2~3단계,중앙보훈병원,3081,2984,6065
<class,경강선,판교,2249,2089,4338
<class,경강선,이매,628,501,1129
<class,경강선,삼동,1047,1029,2076
<class,경강선,경기광주,3352,3365,6717
<class,경강선,초월,1447,1401,2848
<class,경강선,곤지암,1453,1647,3100
<class,경강선,신둔도예촌,815,809,1624
<class,경강선,이천,1884,2113,3997
<class,경강선,부발,1134,1762,2896
<class,경강선,세종대왕릉,253,230,483
<class,경강선,여주,1978,1859,3837
<class,경부선,서울역,6223,1255,7478
<class,경부선,남영,3754,4086,7840
<class,경부선,용산,28287,24846,53133
<class,경부선,노량진,5523,5332,10855
<class,경부선,대방,5508,5913,11421
<class,경부선,영등포,28739,27813,56552
<class,경부선,신도림,2213,2147,4360
<class,경부선,신길,4561,4023,8584
<class,경부선,구로,9111,9282,18393
<class,경부선,가산디지털단지,4405,6091,10496
<class,경부선,금천구청,5855,5834,11689
<class,경부선,석수,5113,5156,10269
<class,경부선,관악,4780,4353,9133
<class,경부선,안양,12759,12301,25060
<class,경부선,명학,3311,3255,6566
<class,경부선,금정,12984,13312,26296
<class,경부선,군포,2984,2828,5812
<class,경부선,의왕,4110,4196,8306
<class,경부선,성균관대,6952,7316,14268
<class,경부선,화서,3656,3527,7183
<class,경부선,수원,30695,29564,60259
<class,경부선,독산,5511,5750,11261
<class,경부선,세류,1917,1951,3868
<class,경부선,병점,8548,9462,18010
<class,경부선,세마,1514,1453,2967
<class,경부선,오산대,2083,2081,4164
<class,경부선,오산,7162,7627,14789
<class,경부선,진위,698,756,1454
<class,경부선,송탄,3281,3631,6912
<class,경부선,서정리,3847,5195,9042
<class,경부선,평택지제,2115,1940,4055
<class,경부선,평택,10482,11329,21811
<class,경부선,성환,2245,2755,5000
<class,경부선,직산,523,553,1076
<class,경부선,두정,4197,4397,8594
<class,경부선,천안,5703,5279,10982
<class,경부선,당정,2903,3024,5927
<class,경부선,서동탄,828,830,1658
<class,경부선,광명,2221,1646,3867
<class,경원선,이촌,2431,1776,4207
<class,경원선,서빙고,1267,1252,2519
<class,경원선,한남,1926,1928,3854
<class,경원선,옥수,66,17,83
<class,경원선,응봉,1085,959,2044
<class,경원선,왕십리,8283,9575,17858
<class,경원선,청량리,13189,11989,25178
<class,경원선,외대앞,4141,4103,8244
<class,경원선,신이문,4476,4202,8678
<class,경원선,석계,4409,4906,9315
<class,경원선,광운대,3960,4143,8103
<class,경원선,월계,3530,3349,6879
<class,경원선,녹천,2490,2170,4660
<class,경원선,방학,5472,5378,10850
<class,경원선,도봉,3264,3156,6420
<class,경원선,도봉산,9373,6727,16100
<class,경원선,망월사,4146,4363,8509
<class,경원선,회룡,7042,7131,14173
<class,경원선,의정부,12728,12817,25545
<class,경원선,가능,3832,3574,7406
<class,경원선,녹양,2785,2662,5447
<class,경원선,양주,4796,4592,9388
<class,경원선,덕계,1639,1560,3199
<class,경원선,덕정,3111,3387,6498
<class,경원선,지행,4031,4010,8041
<class,경원선,동두천중앙,2032,1914,3946
<class,경원선,보산,1350,1552,2902
<class,경원선,동두천,1328,1664,2992
<class,경원선,소요산,4457,3837,8294
<class,경의선,서울역,985,900,1885
<class,경의선,신촌,259,288,547
<class,경의선,효창공원앞,1192,1375,2567
<class,경의선,공덕,1531,1333,2864
<class,경의선,서강대,1199,1155,2354
<class,경의선,홍대입구,1472,1718,3190
<class,경의선,가좌,2701,2694,5395
<class,경의선,디지털미디어시티,1360,1290,2650
<class,경의선,수색,924,1016,1940
<class,경의선,화전,831,840,1671
<class,경의선,강매,1381,1333,2714
<class,경의선,행신,4001,3814,7815
<class,경의선,능곡,2083,2104,4187
<class,경의선,곡산,309,310,619
<class,경의선,백마,3111,3029,6140
<class,경의선,풍산,3222,3144,6366
<class,경의선,일산,4252,4027,8279
<class,경의선,탄현,4054,3773,7827
<class,경의선,야당,4006,3837,7843
<class,경의선,운정,3483,3256,6739
<class,경의선,금릉,2591,2575,5166
<class,경의선,금촌,4462,4585,9047
<class,경의선,월롱,786,1394,2180
<class,경의선,파주,663,590,1253
<class,경의선,문산,3503,3446,6949
<class,경의선,임진강,94,87,181
<class,경인선,개봉,11190,10975,22165
<class,경인선,오류동,6785,6506,13291
<class,경인선,역곡,13488,13427,26915
<class,경인선,부천,21143,20517,41660
<class,경인선,송내,12372,11900,24272
<class,경인선,부평,21456,21710,43166
<class,경인선,백운,3759,3736,7495
<class,경인선,동암,8942,8802,17744
<class,경인선,주안,10476,9520,19996
<class,경인선,제물포,5224,5091,10315
<class,경인선,동인천,9074,8640,17714
<class,경인선,인천,4058,3384,7442
<class,경인선,구일,3860,3923,7783
<class,경인선,소사,5174,4915,10089
<class,경인선,부개,4478,4184,8662
<class,경인선,간석,3077,2845,5922
<class,경인선,도원,1636,1675,3311
<class,경인선,온수,3634,3426,7060
<class,경인선,중동,4689,4486,9175
<class,경인선,도화,2291,2123,4414
<class,경춘선,신내,847,837,1684
<class,경춘선,갈매,1355,1201,2556
<class,경춘선,별내,1673,1556,3229
<class,경춘선,퇴계원,1971,1863,3834
<class,경춘선,사릉,1725,1744,3469
<class,경춘선,금곡,876,849,1725
<class,경춘선,평내호평,3399,3250,6649
<class,경춘선,천마산,1210,1108,2318
<class,경춘선,마석,2505,2460,4965
<class,경춘선,대성리,764,591,1355
<class,경춘선,청평,1751,1516,3267
<class,경춘선,상천,566,433,999
<class,경춘선,가평,2165,1643,3808
<class,경춘선,굴봉산,271,228,499
<class,경춘선,백양리,145,129,274
<class,경춘선,강촌,762,636,1398
<class,경춘선,김유정,436,484,920
<class,경춘선,남춘천,2061,2180,4241
<class,경춘선,춘천,1771,1448,3219
<class,공항철도 1호선,서울역,6422,5496,11918
<class,공항철도 1호선,공덕,1066,1359,2425
<class,공항철도 1호선,홍대입구,9056,8343,17399
<class,공항철도 1호선,디지털미디어시티,3248,3327,6575
<class,공항철도 1호선,마곡나루,2104,2308,4412
<class,공항철도 1호선,김포공항,10703,5752,16455
<class,공항철도 1호선,계양,4682,4408,9090
<class,공항철도 1호선,검암,3319,3485,6804
<class,공항철도 1호선,청라국제도시,2881,2785,5666
<class,공항철도 1호선,운서,4593,5013,9606
<class,공항철도 1호선,공항화물청사,1017,1085,2102
<class,공항철도 1호선,인천공항1터미널,2771,2823,5594
<class,공항철도 1호선,인천공항2터미널,1513,1464,2977
<class,공항철도 1호선,영종,2265,2174,4439
<class,과천선,선바위,3506,3280,6786
<class,과천선,경마공원,856,849,1705
<class,과천선,대공원,5702,5871,11573
<class,과천선,과천,3089,2735,5824
<class,과천선,정부과천청사,3965,4024,7989
<class,과천선,인덕원,10399,10129,20528
<class,과천선,평촌,5788,5589,11377
<class,과천선,범계,13260,12836,26096
<class,분당선,선릉,2649,3889,6538
<class,분당선,한티,7558,7382,14940
<class,분당선,도곡,2617,2456,5073
<class,분당선,구룡,676,705,1381
<class,분당선,개포동,1747,1754,3501
<class,분당선,대모산입구,1622,1557,3179
<class,분당선,수서,7840,7309,15149
<class,분당선,수원,5359,4377,9736
<class,분당선,서울숲,6924,7101,14025
<class,분당선,압구정로데오,9577,10695,20272
<class,분당선,강남구청,3031,3699,6730
<class,분당선,선정릉,2053,2261,4314
<class,분당선,가천대,3109,3861,6970
<class,분당선,태평,7479,7064,14543
<class,분당선,모란,10162,10275,20437
<class,분당선,야탑,11983,12318,24301
<class,분당선,서현,11955,12054,24009
<class,분당선,수내,5647,5452,11099
<class,분당선,정자,6791,7191,13982
<class,분당선,미금,6745,6981,13726
<class,분당선,오리,4838,4334,9172
<class,분당선,이매,2829,2941,5770
<class,분당선,보정,986,936,1922
<class,분당선,죽전,7141,8010,15151
<class,분당선,구성,2231,2273,4504
<class,분당선,신갈,1809,1859,3668
<class,분당선,기흥,4549,4489,9038
<class,분당선,상갈,2734,2802,5536
<class,분당선,청명,1806,1834,3640
<class,분당선,영통,4267,4421,8688
<class,분당선,망포,5531,5954,11485
<class,분당선,매탄권선,2287,2284,4571
<class,분당선,수원시청,6651,6666,13317
<class,분당선,매교,1344,1424,2768
<class,수인선,고색,1442,1573,3015
<class,수인선,오목천,1335,1361,2696
<class,수인선,어천,446,571,1017
<class,수인선,야목,144,140,284
<class,수인선,사리,2384,2110,4494
<class,수인선,달월,54,63,117
<class,수인선,월곶,1652,1491,3143
<class,수인선,소래포구,5111,4959,10070
<class,수인선,인천논현,2898,3020,5918
<class,수인선,호구포,1720,1777,3497
<class,수인선,남동인더스파크,575,559,1134
<class,수인선,원인재,2711,2802,5513
<class,수인선,연수,2828,2769,5597
<class,수인선,송도,1590,1506,3096
<class,수인선,인하대,2856,2760,5616
<class,수인선,숭의,1926,1776,3702
<class,수인선,신포,1121,1081,2202
<class,수인선,인천,1123,1616,2739
<class,안산선,산본,8006,8461,16467
<class,안산선,대야미,2959,2729,5688
<class,안산선,반월,2473,2475,4948
<class,안산선,상록수,8838,8631,17469
<class,안산선,한대앞,5011,4872,9883
<class,안산선,중앙,10800,10738,21538
<class,안산선,고잔,4317,4334,8651
<class,안산선,초지,2156,2165,4321
<class,안산선,안산,9749,8759,18508
<class,안산선,신길온천,1142,1059,2201
<class,안산선,정왕,4726,5238,9964
<class,안산선,오이도,5725,5754,11479
<class,안산선,수리산,1985,2073,4058
<class,우이신설선,북한산우이,3133,3412,6545
<class,우이신설선,솔밭공원,1412,1363,2775
<class,우이신설선,4.19민주묘지,1900,1718,3618
<class,우이신설선,가오리,2241,2072,4313
<class,우이신설선,화계,1990,1823,3813
<class,우이신설선,삼양,1176,1176,2352
<class,우이신설선,삼양사거리,1480,1390,2870
<class,우이신설선,솔샘,2522,2436,4958
<class,우이신설선,북한산보국문,3570,3266,6836
<class,우이신설선,정릉,2550,2178,4728
<class,우이신설선,성신여대입구,1936,2292,4228
<class,우이신설선,보문,856,907,1763
<class,우이신설선,신설동,1150,1075,2225
<class,일산선,원흥,5208,5025,10233
<class,일산선,삼송,9551,9403,18954
<class,일산선,원당,6080,5705,11785
<class,일산선,화정,8619,8733,17352
<class,일산선,대곡,1047,859,1906
<class,일산선,백석,5397,5333,10730
<class,일산선,마두,3208,3176,6384
<class,일산선,정발산,4769,4632,9401
<class,일산선,주엽,4101,4069,8170
<class,일산선,대화,5847,5428,11275
<class,장항선,봉명,506,506,1012
<class,장항선,쌍용,1064,1139,2203
<class,장항선,아산,2635,1790,4425
<class,장항선,배방,684,823,1507
<class,장항선,온양온천,2871,2774,5645
<class,장항선,신창,816,1010,1826
<class,중앙선,회기,13306,13368,26674
<class,중앙선,중랑,3281,3187,6468
<class,중앙선,상봉,3980,3876,7856
<class,중앙선,망우,4580,4711,9291
<class,중앙선,양원,875,913,1788
<class,중앙선,구리,7311,7588,14899
<class,중앙선,도농,4653,4603,9256
<class,중앙선,양정,536,437,973
<class,중앙선,덕소,3314,3412,6726
<class,중앙선,도심,1237,1108,2345
<class,중앙선,팔당,1584,1610,3194
<class,중앙선,운길산,1795,1644,3439
<class,중앙선,양수,2066,1977,4043
<class,중앙선,신원,403,198,601
<class,중앙선,국수,637,586,1223
<class,중앙선,아신,629,553,1182
<class,중앙선,오빈,270,231,501
<class,중앙선,양평,2260,1895,4155
<class,중앙선,원덕,434,363,797
<class,중앙선,용문,2242,1822,4064
<class,중앙선,지평,64,62,126
<class,수인선,송도,2002,1980,3982
<class,수인선,인하대,4122,3833,7955
<class,수인선,숭의,2670,2459,5129
<class,수인선,신포,1387,1410,2797
<class,수인선,인천,1348,2156,3504
<class,안산선,산본,11469,12329,23798
<class,안산선,대야미,3826,3371,7197
<class,안산선,반월,3320,3060,6380
<class,안산선,상록수,11888,11644,23532
<class,안산선,한대앞,6864,6852,13716
<class,안산선,중앙,14853,15344,30197
<class,안산선,고잔,5988,5803,11791
<class,안산선,초지,3048,3069,6117
<class,안산선,안산,10029,10332,20361
<class,안산선,신길온천,1444,1340,2784
<class,장항선,온양온천,3336,3395,6731
<class,장항선,신창,1260,1019,2279
<class,중앙선,회기,17616,16565,34181
<class,중앙선,중랑,4283,4061,8344
<class,중앙선,상봉,5107,5009,10116
<class,중앙선,망우,6209,5998,12207
<class,중앙선,양원,1241,1245,2486
<class,중앙선,국수,630,614,1244
<class,중앙선,아신,628,625,1253
<class,중앙선,오빈,272,296,568
<class,중앙선,양평,2453,2713,5166
<class,중앙선,원덕,429,453,882
<class,중앙선,용문,2051,2358,4409
<class,중앙선,지평,40,61,101
<class,중앙선,구리,9996,10164,20160
<class,중앙선,도농,6214,6046,12260
<class,중앙선,양정,589,515,1104
<class,중앙선,덕소,4387,4427,8814
<class,중앙선,도심,1601,1345,2946
<class,중앙선,팔당,1491,1612,3103
<class,중앙선,운길산,1579,1499,3078
<class,중앙선,양수,2212,2392,4604
<class,중앙선,신원,295,240,535
<class,분당선,매교,1953,1945,3898
<class,수인선,고색,2238,2217,4455
<class,수인선,오목천,1942,1694,3636
<class,수인선,어천,690,599,1289
<class,수인선,야목,187,193,380
<class,수인선,사리,3162,2760,5922
<class,5호선,김포공항,7178,7442,14620
<class,5호선,송정,4917,4817,9734
<class,5호선,마곡,4830,4947,9777
<class,5호선,발산,12378,13305,25683
<class,5호선,우장산,9340,9146,18486
<class,5호선,화곡,19210,17627,36837
<class,5호선,까치산,20086,19070,39156
<class,5호선,신정,8487,7280,15767
<class,5호선,목동,11286,11376,22662
<class,우이신설선,북한산보국문,4386,3854,8240
<class,우이신설선,솔샘,3528,3184,6712
<class,우이신설선,삼양사거리,1788,1836,3624
<class,우이신설선,삼양,1499,1547,3046
<class,우이신설선,화계,2325,2159,4484
<class,우이신설선,가오리,2729,2631,5360
<class,우이신설선,4.19민주묘지,2317,2119,4436
<class,우이신설선,솔밭공원,1735,1601,3336
<class,우이신설선,북한산우이,3353,3514,6867
<class,안산선,수리산,2814,2457,5271
<class,안산선,오이도,7341,7759,15100
<class,안산선,정왕,6369,6412,12781
<class,5호선,오목교,15558,15982,31540
<class,5호선,양평,3607,3365,6972
<class,5호선,영등포구청,1859,1754,3613
<class,5호선,영등포시장,6591,6978,13569
<class,5호선,신길,2405,2509,4914
<class,5호선,여의도,10979,11643,22622
<class,5호선,여의나루,11860,13818,25678
<class,5호선,마포,6503,6637,13140
<class,5호선,공덕,6593,6642,13235
<class,5호선,애오개,3611,3429,7040
<class,5호선,충정로,1888,1777,3665
<class,5호선,서대문,6697,6439,13136
<class,장항선,배방,864,910,1774
<class,장항선,아산,2539,2580,5119
<class,장항선,쌍용,1425,1344,2769
<class,장항선,봉명,704,595,1299
<class,일산선,대화,8443,7675,16118
<class,일산선,주엽,6218,6125,12343
<class,일산선,정발산,6122,6296,12418
<class,일산선,마두,4795,4828,9623
<class,일산선,백석,7186,7336,14522
<class,일산선,대곡,1289,1155,2444
<class,일산선,화정,11832,12140,23972
<class,일산선,원당,7895,7477,15372
<class,일산선,삼송,12656,12433,25089
<class,일산선,지축,1,0,1
<class,일산선,원흥,7016,6752,13768
<class,우이신설선,신설동,1265,1271,2536
<class,우이신설선,보문,1101,1044,2145
<class,우이신설선,성신여대입구,2547,2959,5506
<class,우이신설선,정릉,3262,2805,6067
<class,분당선,복정,1,0,1
<class,5호선,광화문,12539,12967,25506
<class,5호선,종로3가,10889,11409,22298
<class,5호선,을지로4가,3203,3584,6787
<class,5호선,동대문역사문화공원,887,1231,2118
<class,5호선,청구,2449,2177,4626
<class,5호선,신금호,3876,3923,7799
<class,5호선,행당,5457,4794,10251
<class,5호선,왕십리,3324,3753,7077
<class,5호선,마장,3570,3257,6827
<class,5호선,답십리,9662,8745,18407
<class,5호선,장한평,10438,10114,20552
<class,5호선,군자,7830,8390,16220
<class,5호선,아차산,11982,11507,23489
<class,5호선,광나루,9004,8647,17651
<class,5호선,천호,15775,15068,30843
<class,5호선,강동,11715,11129,22844
<class,5호선,길동,5755,5794,11549
<class,5호선,굽은다리,6731,6412,13143
<class,5호선,명일,5702,5675,11377
<class,5호선,고덕,5918,5871,11789
<class,5호선,상일동,9166,8412,17578
<class,5호선,둔촌동,5974,5974,11948
<class,5호선,올림픽공원,2873,2560,5433
<class,5호선,방이,4986,4750,9736
<class,5호선,오금,2048,1897,3945
<class,5호선,개롱,4041,4336,8377
<class,5호선,거여,5208,5000,10208
<class,5호선,마천,4323,4445,8768
<class,5호선,강일,2318,2217,4535
<class,5호선,미사,10804,10672,21476
<class,5호선,하남풍산,2526,2622,5148
<class,5호선,하남시청,4178,4109,8287
<class,5호선,하남검단산,4746,4865,9611
<class,6호선,응암,12166,11995,24161
<class,6호선,역촌,2580,2997,5577
<class,6호선,불광,3874,3541,7415
<class,6호선,독바위,2053,2193,4246
<class,6호선,연신내,2,0,2
<class,6호선,구산,5250,3974,9224
<class,6호선,새절,8423,7914,16337
<class,6호선,증산,7206,7014,14220
<class,6호선,디지털미디어시티,6833,7001,13834
<class,6호선,월드컵경기장,4755,4990,9745
<class,6호선,마포구청,9215,7919,17134
<class,6호선,망원,12115,13520,25635
<class,6호선,합정,11954,11043,22997
<class,6호선,상수,7412,8774,16186
<class,6호선,광흥창,5065,4585,9650
<class,6호선,대흥,5153,5182,10335
<class,6호선,공덕,9537,8900,18437
<class,6호선,효창공원앞,4619,4112,8731
<class,6호선,삼각지,4899,3669,8568
<class,6호선,녹사평,4910,5120,10030
<class,6호선,이태원,11228,12019,23247
<class,6호선,한강진,8084,9766,17850
<class,6호선,버티고개,1275,1434,2709
<class,6호선,약수,2266,2218,4484
<class,6호선,청구,2333,2243,4576
<class,6호선,신당,5342,4574,9916
<class,6호선,동묘앞,7552,7104,14656
<class,6호선,창신,2071,1732,3803
<class,6호선,보문,4793,4224,9017
<class,6호선,안암,5881,5784,11665
<class,6호선,고려대,5111,4834,9945
<class,6호선,월곡,6711,6689,13400
<class,6호선,상월곡,4001,3502,7503
<class,6호선,돌곶이,5807,5220,11027
<class,6호선,석계,8505,8384,16889
<class,6호선,태릉입구,3907,4227,8134
<class,6호선,화랑대,6379,5422,11801
<class,6호선,봉화산,5012,4839,9851
<class,6호선,신내,1,0,1
<class,7호선,장암,1589,1235,2824
<class,7호선,도봉산,6630,9383,16013
<class,7호선,수락산,10223,9870,20093
<class,7호선,마들,8486,7921,16407
<class,7호선,노원,15059,15657,30716
<class,7호선,중계,8872,7785,16657
<class,7호선,하계,11663,10856,22519
<class,7호선,공릉,8857,8699,17556
<class,7호선,태릉입구,6276,5766,12042
<class,7호선,먹골,7841,7645,15486
<class,7호선,중화,7691,7280,14971
<class,7호선,상봉,12527,11800,24327
<class,7호선,면목,10847,10392,21239
<class,7호선,사가정,12200,11647,23847
<class,7호선,용마산,4353,4414,8767
<class,7호선,중곡,6386,5932,12318
<class,7호선,군자,9923,7565,17488
<class,7호선,어린이대공원,8980,8341,17321
<class,7호선,건대입구,9837,9925,19762
<class,7호선,뚝섬유원지,9469,9089,18558
<class,7호선,청담,11169,12069,23238
<class,7호선,강남구청,9449,10329,19778
<class,7호선,학동,10049,10565,20614
<class,7호선,논현,10922,11899,22821
<class,7호선,반포,4247,3991,8238
<class,7호선,고속터미널,12592,10388,22980
<class,7호선,내방,7576,7478,15054
<class,7호선,이수,11576,10906,22482
<class,7호선,남성,7457,6899,14356
<class,7호선,숭실대입구,8155,8032,16187
<class,7호선,상도,7024,6541,13565
<class,7호선,장승배기,6754,6528,13282
<class,7호선,신대방삼거리,10632,9845,20477
<class,7호선,보라매,5828,5547,11375
<class,7호선,신풍,7865,7538,15403
<class,7호선,대림,7218,7670,14888
<class,7호선,남구로,8404,8727,17131
<class,7호선,가산디지털단지,14606,13336,27942
<class,7호선,철산,14468,14698,29166
<class,7호선,광명사거리,16027,15982,32009
<class,7호선,천왕,6934,6549,13483
<class,7호선,온수,5574,5399,10973
<class,7호선,까치울,5445,5410,10855
<class,7호선,부천종합운동장,3195,2848,6043
<class,7호선,춘의,5032,4775,9807
<class,7호선,신중동,9551,9413,18964
<class,7호선,부천시청,9480,9439,18919
<class,7호선,상동,10184,10311,20495
<class,7호선,삼산체육관,3471,3230,6701
<class,7호선,굴포천,6630,6713,13343
<class,7호선,부평구청,5133,4394,9527
<class,8호선,암사,12131,10964,23095
<class,8호선,천호,11499,13568,25067
<class,8호선,강동구청,5846,5760,11606
<class,8호선,몽촌토성,3932,3817,7749
<class,8호선,잠실,11420,13068,24488
<class,8호선,석촌,5495,6547,12042
<class,8호선,송파,4724,4845,9569
<class,8호선,가락시장,5009,5106,10115
<class,8호선,문정,7935,7987,15922
<class,8호선,장지,11593,10602,22195
<class,8호선,복정,6744,5766,12510
<class,8호선,산성,4544,4453,8997
<class,8호선,남한산성입구,8731,7783,16514
<class,8호선,단대오거리,7186,6856,14042
<class,8호선,신흥,3490,3767,7257
<class,8호선,수진,3910,3490,7400
<class,8호선,모란,3334,2960,6294
<class,9호선,개화,1371,1240,2611
<class,9호선,김포공항,7570,12334,19904
<class,9호선,공항시장,2170,2266,4436
<class,9호선,신방화,4486,4304,8790
<class,9호선,마곡나루,7478,7474,14952
<class,9호선,양천향교,5792,5566,11358
<class,9호선,가양,13673,12787,26460
<class,9호선,증미,4062,3921,7983
<class,9호선,등촌,7105,6756,13861
<class,9호선,염창,11014,10052,21066
<class,9호선,신목동,2253,1992,4245
<class,9호선,선유도,3838,3850,7688
<class,9호선,당산,11640,10940,22580
<class,9호선,국회의사당,3709,3970,7679
<class,9호선,여의도,11597,11115,22712
<class,9호선,샛강,2396,2492,4888
<class,9호선,노량진,19669,18963,38632
<class,9호선,노들,3166,2673,5839
<class,9호선,흑석,5106,5110,10216
<class,9호선,동작,1734,1499,3233
<class,9호선,구반포,1995,2107,4102
<class,9호선,신반포,2447,2390,4837
<class,9호선,고속터미널,11848,16851,28699
<class,9호선,사평,1948,1830,3778
<class,9호선,신논현,23940,23684,47624
<class,9호선2~3단계,언주,5722,5870,11592
<class,9호선2~3단계,선정릉,4666,5246,9912
<class,9호선2~3단계,삼성중앙,2852,2807,5659
<class,9호선2~3단계,봉은사,10590,11184,21774
<class,9호선2~3단계,종합운동장,3091,2788,5879
<class,9호선2~3단계,삼전,4662,4285,8947
<class,9호선2~3단계,석촌고분,3998,3847,7845
<class,9호선2~3단계,석촌,5918,4913,10831
<class,9호선2~3단계,송파나루,3673,4130,7803
<class,9호선2~3단계,한성백제,1741,1442,3183
<class,9호선2~3단계,올림픽공원,4130,4174,8304
<class,9호선2~3단계,둔촌오륜,593,575,1168
<class,9호선2~3단계,중앙보훈병원,4208,3954,8162
<class,경강선,판교,2828,2654,5482
<class,경강선,이매,819,664,1483
<class,경강선,삼동,1471,1370,2841
<class,경강선,경기광주,4827,4600,9427
<class,경강선,초월,2083,1933,4016
<class,경강선,곤지암,1841,1983,3824
<class,경강선,신둔도예촌,1089,1100,2189
<class,경강선,이천,2520,2648,5168
<class,경강선,부발,1632,1516,3148
<class,경강선,세종대왕릉,280,342,622
<class,경강선,여주,2089,2329,4418
<class,경부선,서울역,5256,1554,6810
<class,경부선,남영,5545,5543,11088
<class,경부선,용산,29525,32284,61809
<class,경부선,노량진,7955,7181,15136
<class,경부선,대방,7571,7425,14996
<class,경부선,영등포,35189,36672,71861
<class,경부선,신도림,2917,2975,5892
<class,경부선,신길,5968,4924,10892
<class,경부선,구로,12620,12957,25577
<class,경부선,가산디지털단지,5963,8004,13967
<class,경부선,금천구청,7927,7815,15742
<class,경부선,석수,6792,6315,13107
<class,경부선,관악,5743,5267,11010
<class,경부선,안양,16950,17071,34021
<class,경부선,명학,4745,4597,9342
<class,경부선,금정,17790,17365,35155
<class,경부선,군포,4198,3907,8105
<class,경부선,의왕,5505,5414,10919
<class,경부선,성균관대,9797,9757,19554
<class,경부선,화서,5144,5053,10197
<class,경부선,수원,35617,38375,73992
<class,경부선,독산,8081,8025,16106
<class,경부선,세류,2347,2428,4775
<class,경부선,병점,11546,11359,22905
<class,경부선,세마,2023,1849,3872
<class,경부선,오산대,2839,2547,5386
<class,경부선,오산,8814,8166,16980
<class,경부선,진위,981,899,1880
<class,경부선,송탄,4571,4165,8736
<class,경부선,서정리,5987,5352,11339
<class,경부선,평택지제,2495,2499,4994
<class,경부선,평택,12949,12254,25203
<class,경부선,성환,2865,2623,5488
<class,경부선,직산,586,589,1175
<class,경부선,두정,4983,5241,10224
<class,경부선,천안,5787,5981,11768
<class,경부선,당정,3802,3560,7362
<class,경부선,서동탄,1028,1002,2030
<class,경부선,광명,2411,2250,4661
<class,경원선,이촌,3150,2258,5408
<class,경원선,서빙고,1355,1244,2599
<class,경원선,한남,2774,2610,5384
<class,경원선,옥수,35,32,67
<class,경원선,응봉,1366,1180,2546
<class,경원선,왕십리,11151,12872,24023
<class,경원선,청량리,14749,16648,31397
<class,경원선,외대앞,5328,5213,10541
<class,경원선,신이문,5874,5287,11161
<class,경원선,석계,6214,6601,12815
<class,경원선,광운대,5507,5500,11007
<class,경원선,월계,4422,4027,8449
<class,경원선,녹천,3282,2711,5993
<class,경원선,방학,7043,6889,13932
<class,경원선,도봉,4384,4111,8495
<class,경원선,도봉산,9171,6415,15586
<class,경원선,망월사,5551,5731,11282
<class,경원선,회룡,9366,9403,18769
<class,경원선,의정부,16515,17342,33857
<class,경원선,가능,5029,4679,9708
<class,경원선,녹양,3432,3357,6789
<class,경원선,양주,5959,5926,11885
<class,경원선,덕계,2137,2050,4187
<class,경원선,덕정,4524,4220,8744
<class,경원선,지행,5098,5118,10216
<class,경원선,동두천중앙,2421,2536,4957
<class,경원선,보산,1631,1528,3159
<class,경원선,동두천,1576,1982,3558
<class,경원선,소요산,4460,3976,8436
<class,경의선,서울역,1188,1367,2555
<class,경의선,신촌,346,339,685
<class,경의선,효창공원앞,1569,1807,3376
<class,경의선,공덕,2528,1977,4505
<class,경의선,서강대,1546,1398,2944
<class,경의선,홍대입구,1793,1989,3782
<class,경의선,가좌,3877,3690,7567
<class,경의선,디지털미디어시티,1868,1725,3593
<class,경의선,수색,1479,1447,2926
<class,경의선,화전,989,896,1885
<class,경의선,강매,1924,1750,3674
<class,경의선,행신,4947,4945,9892
<class,경의선,능곡,2750,2777,5527
<class,경의선,곡산,414,429,843
<class,경의선,백마,4158,3941,8099
<class,경의선,풍산,4096,4030,8126
<class,경의선,일산,5735,5510,11245
<class,경의선,탄현,5109,4808,9917
<class,경의선,야당,5064,5309,10373
<class,경의선,운정,4567,4223,8790
<class,경의선,금릉,3487,3354,6841
<class,경의선,금촌,5134,4984,10118
<class,경의선,월롱,1260,1160,2420
<class,경의선,파주,915,715,1630
<class,경의선,문산,4396,4214,8610
<class,경의선,임진강,70,103,173
<class,경의선,홍대입구,127,133,260
<class,경인선,개봉,15760,15322,31082
<class,경인선,오류동,8721,8004,16725
<class,경인선,역곡,19038,18664,37702
<class,경인선,부천,27501,28289,55790
<class,경인선,송내,16969,16874,33843
<class,경인선,부평,28677,31279,59956
<class,경인선,백운,5337,5356,10693
<class,경인선,동암,11947,12087,24034
<class,경인선,주안,14747,13072,27819
<class,경인선,제물포,7323,6940,14263
<class,경인선,동인천,11467,11365,22832
<class,경인선,인천,4589,3945,8534
<class,경인선,구일,4269,4181,8450
<class,경인선,소사,6938,6907,13845
<class,경인선,부개,6161,5771,11932
<class,경인선,간석,4137,4051,8188
<class,경인선,도원,2068,2077,4145
<class,경인선,온수,4853,4469,9322
<class,경인선,중동,6419,6004,12423
<class,경인선,도화,3061,2810,5871
<class,경춘선,신내,1135,1109,2244
<class,경춘선,갈매,1901,1672,3573
<class,경춘선,별내,2255,2210,4465
<class,경춘선,퇴계원,2510,2383,4893
<class,경춘선,사릉,2288,2248,4536
<class,경춘선,금곡,1164,1064,2228
<class,경춘선,평내호평,4475,4333,8808
<class,경춘선,천마산,1350,1347,2697
<class,경춘선,마석,3095,3113,6208
<class,경춘선,대성리,611,753,1364
<class,경춘선,청평,1758,1931,3689
<class,경춘선,상천,426,340,766
<class,경춘선,가평,1847,2279,4126
<class,경춘선,굴봉산,234,270,504
<class,경춘선,백양리,150,178,328
<class,경춘선,강촌,719,801,1520
<class,경춘선,김유정,496,638,1134
<class,경춘선,남춘천,2891,3012,5903
<class,경춘선,춘천,1690,1514,3204
<class,공항철도 1호선,서울역,6216,6617,12833
<class,공항철도 1호선,공덕,1484,2090,3574
<class,공항철도 1호선,홍대입구,11153,10989,22142
<class,공항철도 1호선,디지털미디어시티,4906,4816,9722
<class,공항철도 1호선,마곡나루,3035,3189,6224
<class,공항철도 1호선,김포공항,10587,5860,16447
<class,공항철도 1호선,계양,6391,5806,12197
<class,공항철도 1호선,검암,4438,4497,8935
<class,공항철도 1호선,청라국제도시,4026,3819,7845
<class,공항철도 1호선,운서,5510,5681,11191
<class,공항철도 1호선,공항화물청사,1405,1378,2783
<class,공항철도 1호선,인천공항1터미널,2830,3107,5937
<class,공항철도 1호선,인천공항2터미널,1522,1497,3019
<class,공항철도 1호선,영종,2791,2881,5672
<class,과천선,선바위,4935,4356,9291
<class,과천선,경마공원,966,1003,1969
<class,과천선,대공원,5888,6188,12076
<class,과천선,과천,4137,3602,7739
<class,과천선,정부과천청사,5425,5451,10876
<class,과천선,인덕원,14501,13928,28429
<class,과천선,평촌,8962,8606,17568
<class,과천선,범계,18907,18614,37521
<class,분당선,선릉,4868,7346,12214
<class,분당선,한티,10789,10595,21384
<class,분당선,도곡,4139,3666,7805
<class,분당선,구룡,1645,1496,3141
<class,분당선,개포동,2529,2495,5024
<class,분당선,대모산입구,2551,2419,4970
<class,분당선,수서,9334,9915,19249
<class,분당선,수원,7283,5947,13230
<class,분당선,서울숲,8329,8399,16728
<class,분당선,압구정로데오,17324,19567,36891
<class,수인선,달월,75,74,149
<class,5호선,개화산,3631,3598,7229
<class,5호선,방화,4585,4361,8946
<class,4호선,쌍문,20481,18197,38678
<class,4호선,창동,18233,19108,37341
<class,4호선,노원,14944,16330,31274
<class,4호선,상계,13368,12437,25805
<class,4호선,당고개,9716,9236,18952
<class,4호선,남태령,917,667,1584
<class,4호선,사당,18960,16055,35015
<class,4호선,총신대입구,13679,14605,28284
<class,4호선,동작,2083,2192,4275
<class,4호선,이촌,6296,7075,13371
<class,4호선,신용산,8835,9953,18788
<class,4호선,삼각지,2832,3625,6457
<class,4호선,숙대입구,8287,8192,16479
<class,4호선,서울역,4855,10442,15297
<class,4호선,회현,16813,17789,34602
<class,4호선,명동,13117,15479,28596
<class,4호선,충무로,12046,12409,24455
<class,4호선,동대문역사문화공원,10364,8926,19290
<class,4호선,동대문,14008,13849,27857
<class,4호선,혜화,22816,23879,46695
<class,4호선,한성대입구,9984,9621,19605
<class,4호선,성신여대입구,15379,14231,29610
<class,4호선,길음,13328,12501,25829
<class,4호선,미아사거리,20368,19632,40000
<class,4호선,미아,10313,9618,19931
<class,4호선,수유,25257,24153,49410
<class,3호선,오금,3439,3251,6690
<class,3호선,경찰병원,3715,3647,7362
<class,3호선,가락시장,5736,5500,11236
<class,3호선,수서,12123,12307,24430
<class,3호선,일원,4373,4382,8755
<class,3호선,대청,5653,5110,10763
<class,3호선,학여울,1744,1829,3573
<class,3호선,대치,8572,7774,16346
<class,3호선,도곡,3012,3096,6108
<class,3호선,매봉,5767,5627,11394
<class,3호선,양재,19127,20543,39670
<class,3호선,남부터미널,19594,20156,39750
<class,3호선,교대,6302,3755,10057
<class,3호선,고속터미널,44929,45085,90014
<class,3호선,잠원,3452,3250,6702
<class,3호선,신사,23021,24130,47151
<class,3호선,압구정,23596,24576,48172
<class,3호선,옥수,6733,6782,13515
<class,3호선,금호,5725,5120,10845
<class,3호선,약수,8728,8284,17012
<class,3호선,동대입구,5394,6095,11489
<class,3호선,충무로,1,0,1
<class,3호선,을지로3가,4744,5628,10372
<class,3호선,종로3가,5432,7808,13240
<class,3호선,안국,12121,13984,26105
<class,3호선,경복궁,13041,13901,26942
<class,3호선,독립문,5455,5869,11324
<class,3호선,무악재,2507,2558,5065
<class,3호선,홍제,12402,11531,23933
<class,3호선,녹번,9933,8605,18538
<class,3호선,불광,12422,14094,26516
<class,3호선,연신내,28632,26541,55173
<class,3호선,구파발,14676,14791,29467
<class,3호선,지축,2527,2505,5032
<class,2호선,용두,1679,1594,3273
<class,2호선,신정네거리,6940,6994,13934
<class,2호선,양천구청,4573,4678,9251
<class,2호선,도림천,754,770,1524
<class,2호선,신설동,2875,2881,5756
<class,2호선,신답,889,976,1865
<class,2호선,용답,1968,1827,3795
<class,2호선,충정로,5301,5638,10939
<class,2호선,아현,7089,6727,13816
<class,2호선,이대,9316,9686,19002
<class,2호선,신촌,26301,26551,52852
<class,2호선,홍대입구,57136,60844,117980
<class,2호선,합정,26243,28581,54824
<class,2호선,당산,11955,13000,24955
<class,2호선,영등포구청,11715,11931,23646
<class,2호선,문래,11612,12372,23984
<class,2호선,신도림,37816,38144,75960
<class,2호선,대림,17814,18830,36644
<class,2호선,구로디지털단지,32570,31533,64103
<class,2호선,신대방,19106,18254,37360
<class,2호선,신림,47447,45141,92588
<class,2호선,봉천,16314,15012,31326
<class,2호선,서울대입구,35650,34086,69736
<class,2호선,낙성대,20113,18563,38676
<class,2호선,사당,27258,29970,57228
<class,2호선,방배,9547,9812,19359
<class,2호선,서초,9556,8243,17799
<class,2호선,교대,16116,17964,34080
<class,2호선,강남,56795,56496,113291
<class,2호선,역삼,17727,19623,37350
<class,2호선,선릉,22137,19704,41841
<class,2호선,삼성,27997,28087,56084
<class,2호선,종합운동장,5705,6226,11931
<class,2호선,잠실새내,15236,16096,31332
<class,2호선,잠실,55843,53320,109163
<class,2호선,잠실나루,7251,7075,14326
<class,2호선,강변,23780,25081,48861
<class,2호선,구의,15199,14783,29982
<class,2호선,건대입구,30375,33111,63486
<class,2호선,성수,16295,18821,35116
<class,2호선,뚝섬,14447,15297,29744
<class,2호선,한양대,4162,4316,8478
<class,2호선,왕십리,12073,10065,22138
<class,2호선,상왕십리,9267,8635,17902
<class,2호선,신당,10059,10233,20292
<class,2호선,동대문역사문화공원,8950,9344,18294
<class,2호선,을지로4가,6614,7064,13678
<class,2호선,을지로3가,10256,10473,20729
<class,2호선,을지로입구,18942,18907,37849
<class,2호선,시청,7681,6278,13959
<class,1호선,청량리,17168,17545,34713
<class,1호선,제기동,14058,14418,28476
<class,1호선,신설동,8730,8215,16945
<class,1호선,동대문,10589,9917,20506
<class,1호선,종로5가,17287,17311,34598
<class,1호선,종로3가,20641,19176,39817
<class,1호선,종각,16883,15548,32431
<class,1호선,시청,9078,9496,18574
<class,1호선,동묘앞,10738,11159,21897
<class,1호선,서울역,27023,27278,54301
<class,분당선,강남구청,5031,6033,11064
<class,분당선,선정릉,3646,3761,7407
<class,분당선,가천대,4766,5356,10122
<class,분당선,태평,10381,9631,20012
<class,분당선,모란,15033,14656,29689
<class,분당선,야탑,16099,16806,32905
<class,분당선,서현,16979,17412,34391
<class,분당선,수내,8514,8032,16546
<class,분당선,정자,10293,10330,20623
<class,분당선,미금,10541,10788,21329
<class,분당선,오리,7330,6258,13588
<class,분당선,이매,3825,3762,7587
<class,분당선,보정,1557,1386,2943
<class,분당선,죽전,9295,10515,19810
<class,분당선,구성,2982,3176,6158
<class,분당선,신갈,2631,2662,5293
<class,분당선,기흥,6286,5947,12233
<class,분당선,상갈,3714,3686,7400
<class,분당선,청명,2570,2450,5020
<class,분당선,영통,6090,5952,12042
<class,분당선,망포,8818,8033,16851
<class,분당선,매탄권선,3293,3124,6417
<class,분당선,수원시청,10345,11371,21716
<class,수인선,월곶,2059,1950,4009
<class,수인선,소래포구,5896,6030,11926
<class,수인선,인천논현,4350,4482,8832
<class,수인선,호구포,2504,2499,5003
<class,수인선,남동인더스파크,930,814,1744
<class,수인선,원인재,3514,3700,7214
<class,수인선,연수,3711,3744,7455
<class,2호선,상왕십리,6482,6413,12895
<class,중앙선,도농,4458,4415,8873
<class,중앙선,양정,515,445,960
<class,중앙선,덕소,3317,3274,6591
<class,중앙선,도심,1204,1106,2310
<class,중앙선,팔당,1400,1540,2940
<class,중앙선,운길산,1504,1321,2825
<class,중앙선,양수,1850,1668,3518
<class,중앙선,신원,308,188,496
<class,중앙선,국수,645,598,1243
<class,중앙선,아신,633,549,1182
<class,중앙선,오빈,278,232,510
<class,중앙선,양평,3451,3114,6565
<class,중앙선,원덕,450,377,827
<class,중앙선,용문,2215,1850,4065
<class,중앙선,지평,56,65,121
<class,일산선,마두,3239,3229,6468
<class,일산선,정발산,4708,4678,9386
<class,일산선,주엽,4102,4033,8135
<class,일산선,대화,6748,6383,13131
<class,장항선,봉명,499,460,959
<class,장항선,쌍용,1023,1078,2101
<class,장항선,아산,2649,1896,4545
<class,장항선,배방,659,876,1535
<class,장항선,온양온천,2900,2870,5770
<class,장항선,신창,983,1063,2046
<class,중앙선,회기,13008,13107,26115
<class,중앙선,중랑,3170,3149,6319
<class,중앙선,상봉,3946,3784,7730
<class,중앙선,망우,4421,4410,8831
<class,중앙선,양원,840,914,1754
<class,중앙선,구리,6858,7323,14181
<class,1호선,서울역,23497,20550,44047
<class,1호선,동묘앞,11331,11328,22659
<class,1호선,시청,6316,6216,12532
<class,1호선,종각,10829,9599,20428
<class,1호선,종로3가,12425,10820,23245
<class,1호선,종로5가,8209,8299,16508
<class,1호선,동대문,8830,9682,18512
<class,1호선,신설동,6560,6385,12945
<class,1호선,제기동,8578,8966,17544
<class,1호선,청량리,12157,12083,24240
<class,2호선,시청,4924,3882,8806
<class,2호선,을지로입구,13741,12969,26710
<class,2호선,을지로3가,7090,6590,13680
<class,2호선,을지로4가,3040,2916,5956
<class,2호선,동대문역사문화공원,6789,7971,14760
<class,2호선,신당,7102,7729,14831
<class,2호선,왕십리,8078,6715,14793
<class,2호선,한양대,2457,2738,5195
<class,2호선,뚝섬,10363,10848,21211
<class,2호선,성수,10758,12051,22809
<class,2호선,건대입구,22074,23031,45105
<class,2호선,구의,10234,10467,20701
<class,2호선,강변,19665,19013,38678
<class,2호선,잠실나루,4973,4920,9893
<class,2호선,잠실,40920,38358,79278
<class,2호선,잠실새내,9620,10021,19641
<class,2호선,종합운동장,4821,5082,9903
<class,2호선,삼성,19296,19003,38299
<class,2호선,선릉,11788,10272,22060
<class,2호선,역삼,10331,11325,21656
<class,2호선,강남,31573,30315,61888
<class,2호선,교대,9496,10372,19868
<class,2호선,서초,9811,9236,19047
<class,2호선,방배,6127,6465,12592
<class,2호선,사당,18685,21031,39716
<class,2호선,낙성대,14382,14748,29130
<class,2호선,서울대입구,24717,25541,50258
<class,2호선,봉천,11264,11034,22298
<class,2호선,신림,33721,33124,66845
<class,2호선,신대방,13989,13877,27866
<class,2호선,구로디지털단지,21218,20769,41987
<class,2호선,대림,14075,14441,28516
<class,2호선,신도림,26675,27082,53757
<class,2호선,문래,7125,7486,14611
<class,2호선,영등포구청,7060,7290,14350
<class,2호선,당산,7991,8631,16622
<class,2호선,합정,18621,19550,38171
<class,2호선,홍대입구,40715,40697,81412
<class,2호선,신촌,18448,18111,36559
<class,2호선,이대,6095,6503,12598
<class,2호선,아현,4684,4578,9262
<class,2호선,충정로,3456,3642,7098
<class,2호선,용답,1431,1492,2923
<class,2호선,신답,643,670,1313
<class,2호선,신설동,2595,2664,5259
<class,2호선,도림천,474,449,923
<class,2호선,양천구청,3544,3528,7072
<class,2호선,신정네거리,4617,4797,9414
<class,2호선,용두,959,917,1876
<class,3호선,지축,1797,1642,3439
<class,3호선,구파발,10588,10644,21232
<class,3호선,연신내,20143,18741,38884
<class,3호선,불광,8825,10634,19459
<class,3호선,녹번,6554,6013,12567
<class,3호선,홍제,8226,7937,16163
<class,3호선,무악재,1642,1773,3415
<class,3호선,독립문,3769,4181,7950
<class,3호선,경복궁,9163,9575,18738
<class,3호선,안국,8238,9073,17311
<class,3호선,종로3가,3341,4393,7734
<class,3호선,을지로3가,2834,2752,5586
<class,3호선,동대입구,4051,4655,8706
<class,3호선,약수,6089,5947,12036
<class,3호선,금호,3961,3780,7741
<class,3호선,옥수,4894,5079,9973
<class,3호선,압구정,12714,13240,25954
<class,3호선,신사,11916,12073,23989
<class,3호선,잠원,1978,1928,3906
<class,3호선,고속터미널,36825,33269,70094
<class,3호선,교대,3920,2374,6294
<class,3호선,남부터미널,13439,14072,27511
<class,3호선,양재,11704,13782,25486
<class,3호선,매봉,3901,3842,7743
<class,3호선,도곡,1695,1775,3470
<class,3호선,대치,5369,4821,10190
<class,3호선,학여울,678,685,1363
<class,3호선,대청,3742,3603,7345
<class,3호선,일원,3169,3286,6455
<class,3호선,수서,9430,9230,18660
<class,3호선,가락시장,3222,3398,6620
<class,3호선,경찰병원,2563,2563,5126
<class,3호선,오금,2546,2499,5045
<class,4호선,수유,17875,17364,35239
<class,4호선,미아,7435,7152,14587
<class,4호선,미아사거리,14162,13661,27823
<class,4호선,길음,9247,9010,18257
<class,4호선,성신여대입구,10961,10380,21341
<class,4호선,한성대입구,7073,6898,13971
<class,4호선,혜화,18811,19814,38625
<class,4호선,동대문,6108,6521,12629
<class,4호선,동대문역사문화공원,7594,7253,14847
<class,4호선,충무로,7292,7335,14627
<class,4호선,명동,10042,10432,20474
<class,4호선,회현,7809,8124,15933
<class,4호선,서울역,3528,7748,11276
<class,4호선,숙대입구,6163,6224,12387
<class,4호선,삼각지,1887,2524,4411
<class,4호선,신용산,6868,7000,13868
<class,4호선,이촌,4457,4991,9448
<class,4호선,동작,1599,1601,3200
<class,4호선,총신대입구,9194,9820,19014
<class,4호선,사당,13058,12126,25184
<class,4호선,남태령,581,480,1061
<class,4호선,당고개,7422,6891,14313
<class,4호선,상계,9523,8959,18482
<class,4호선,노원,10469,11569,22038
<class,4호선,창동,12779,13321,26100
<class,4호선,쌍문,14493,13136,27629
<class,5호선,방화,3328,3288,6616
<class,5호선,개화산,2540,2719,5259
<class,5호선,김포공항,6454,5998,12452
<class,5호선,송정,3397,3468,6865
<class,5호선,마곡,3173,3293,6466
<class,5호선,발산,8141,8497,16638
<class,5호선,우장산,6126,6300,12426
<class,5호선,화곡,12903,12407,25310
<class,5호선,까치산,14296,14001,28297
<class,5호선,신정,5951,5358,11309
<class,5호선,목동,7468,7595,15063
<class,5호선,오목교,10684,10892,21576
<class,5호선,양평,2416,2451,4867
<class,5호선,영등포구청,1236,1168,2404
<class,5호선,영등포시장,4086,4315,8401
<class,5호선,신길,1722,1825,3547
<class,5호선,여의도,7637,7972,15609
<class,5호선,여의나루,9429,10268,19697
<class,5호선,마포,4246,4181,8427
<class,5호선,공덕,4056,4116,8172
<class,5호선,애오개,2478,2467,4945
<class,5호선,충정로,1355,1359,2714
<class,5호선,서대문,4780,4760,9540
<class,5호선,광화문,8851,9262,18113
<class,5호선,종로3가,7535,6932,14467
<class,5호선,을지로4가,1370,1507,2877
<class,5호선,동대문역사문화공원,650,776,1426
<class,5호선,청구,1601,1443,3044
<class,5호선,신금호,2653,2962,5615
<class,5호선,행당,3698,3366,7064
<class,5호선,왕십리,2114,2304,4418
<class,5호선,마장,2612,2502,5114
<class,5호선,답십리,6422,6028,12450
<class,5호선,장한평,6671,6645,13316
<class,5호선,군자,5442,6047,11489
<class,5호선,아차산,9195,8994,18189
<class,5호선,광나루,6976,6907,13883
<class,5호선,천호,11089,10407,21496
<class,5호선,강동,7857,7883,15740
<class,5호선,길동,3820,3827,7647
<class,5호선,굽은다리,4785,4474,9259
<class,5호선,명일,4430,4407,8837
<class,5호선,고덕,3748,3725,7473
<class,5호선,상일동,6321,6122,12443
<class,5호선,둔촌동,4181,4342,8523
<class,5호선,올림픽공원,1928,1736,3664
<class,5호선,방이,3662,3403,7065
<class,5호선,오금,1487,1394,2881
<class,5호선,개롱,2719,2993,5712
<class,5호선,거여,3493,3387,6880
<class,5호선,마천,3383,3520,6903
<class,5호선,강일,1591,1557,3148
<class,5호선,미사,7404,7487,14891
<class,5호선,하남풍산,1968,2082,4050
<class,5호선,하남시청,3127,2995,6122
<class,5호선,하남검단산,4217,4328,8545
<class,6호선,응암,8525,8646,17171
<class,6호선,역촌,1857,2089,3946
<class,6호선,불광,3058,2708,5766
<class,6호선,독바위,1462,1785,3247
<class,6호선,구산,3627,2760,6387
<class,6호선,새절,6130,6006,12136
<class,6호선,증산,5163,5296,10459
<class,6호선,디지털미디어시티,4664,4956,9620
<class,6호선,월드컵경기장,3090,3277,6367
<class,6호선,마포구청,6500,6022,12522
<class,6호선,망원,8528,9452,17980
<class,6호선,합정,8767,7718,16485
<class,6호선,상수,5054,5865,10919
<class,6호선,광흥창,3732,3493,7225
<class,6호선,대흥,3526,3616,7142
<class,6호선,공덕,5941,5482,11423
<class,6호선,효창공원앞,3110,2815,5925
<class,6호선,삼각지,3146,2421,5567
<class,6호선,녹사평,3678,3513,7191
<class,6호선,이태원,7836,7738,15574
<class,6호선,한강진,6451,7195,13646
<class,6호선,버티고개,967,1029,1996
<class,6호선,약수,1547,1583,3130
<class,6호선,청구,1537,1473,3010
<class,6호선,신당,3404,4221,7625
<class,6호선,동묘앞,5610,5572,11182
<class,6호선,창신,1588,1447,3035
<class,6호선,보문,3544,3304,6848
<class,6호선,안암,3724,4064,7788
<class,6호선,고려대,3581,3507,7088
<class,6호선,월곡,4716,4708,9424
<class,6호선,상월곡,2961,2680,5641
<class,6호선,돌곶이,4514,4302,8816
<class,6호선,석계,5805,5962,11767
<class,6호선,태릉입구,2845,2925,5770
<class,6호선,화랑대,4527,4026,8553
<class,6호선,봉화산,3521,3505,7026
<class,7호선,장암,1568,1232,2800
<class,7호선,도봉산,5386,7924,13310
<class,7호선,수락산,8256,8214,16470
<class,7호선,마들,5449,5236,10685
<class,7호선,노원,10105,10235,20340
<class,7호선,중계,6069,5664,11733
<class,7호선,하계,8338,7866,16204
<class,7호선,공릉,5758,5840,11598
<class,7호선,태릉입구,4352,4074,8426
<class,7호선,먹골,4929,4871,9800
<class,7호선,중화,5217,5118,10335
<class,7호선,상봉,8588,7865,16453
<class,7호선,면목,7446,7376,14822
<class,7호선,사가정,8445,8282,16727
<class,7호선,용마산,3101,3392,6493
<class,7호선,중곡,4681,4657,9338
<class,7호선,군자,7026,5673,12699
<class,7호선,어린이대공원,6987,7079,14066
<class,7호선,건대입구,6685,6687,13372
<class,7호선,뚝섬유원지,6954,6592,13546
<class,7호선,청담,6231,6583,12814
<class,7호선,강남구청,5028,5608,10636
<class,7호선,학동,5552,5918,11470
<class,7호선,논현,5909,6271,12180
<class,7호선,반포,2712,2719,5431
<class,7호선,고속터미널,11050,7268,18318
<class,7호선,내방,4801,4905,9706
<class,7호선,이수,7320,7124,14444
<class,7호선,남성,4853,4911,9764
<class,7호선,숭실대입구,5171,5572,10743
<class,7호선,상도,4789,4759,9548
<class,7호선,장승배기,4421,4409,8830
<class,7호선,신대방삼거리,7417,7346,14763
<class,7호선,보라매,4059,4127,8186
<class,7호선,신풍,5676,5287,10963
<class,7호선,대림,7089,6631,13720
<class,7호선,남구로,6477,6364,12841
<class,7호선,가산디지털단지,10386,9671,20057
<class,7호선,철산,9685,9737,19422
<class,7호선,광명사거리,11422,11266,22688
<class,7호선,천왕,4435,4281,8716
<class,7호선,온수,3630,3696,7326
<class,7호선,까치울,3922,3925,7847
<class,7호선,부천종합운동장,2276,2066,4342
<class,7호선,춘의,3307,3090,6397
<class,7호선,신중동,6506,6364,12870
<class,7호선,부천시청,6126,6060,12186
<class,7호선,상동,6471,6485,12956
<class,7호선,삼산체육관,2384,2140,4524
<class,7호선,굴포천,4372,4413,8785
<class,7호선,부평구청,3493,3061,6554
<class,8호선,암사,8071,7704,15775
<class,8호선,천호,7792,9053,16845
<class,8호선,강동구청,4026,4220,8246
<class,8호선,몽촌토성,2857,2898,5755
<class,8호선,잠실,8574,9494,18068
<class,8호선,석촌,3672,4507,8179
<class,8호선,송파,3239,3377,6616
<class,8호선,가락시장,2677,3497,6174
<class,8호선,문정,5206,5553,10759
<class,8호선,장지,8056,8245,16301
<class,8호선,복정,4542,4201,8743
<class,8호선,산성,3107,3239,6346
<class,8호선,남한산성입구,6071,5822,11893
<class,8호선,단대오거리,4922,4863,9785
<class,8호선,신흥,2638,2702,5340
<class,8호선,수진,2766,2496,5262
<class,8호선,모란,2292,1935,4227
<class,9호선,개화,1002,950,1952
<class,9호선,김포공항,7193,10806,17999
<class,9호선,공항시장,1561,1740,3301
<class,9호선,신방화,3125,3077,6202
<class,9호선,마곡나루,5075,5130,10205
<class,9호선,양천향교,3778,4019,7797
<class,9호선,가양,9237,9323,18560
<class,9호선,증미,2471,2440,4911
<class,9호선,등촌,4799,4789,9588
<class,9호선,염창,7672,7685,15357
<class,9호선,신목동,1496,1369,2865
<class,9호선,선유도,2887,2892,5779
<class,9호선,당산,7946,7778,15724
<class,9호선,국회의사당,4050,3774,7824
<class,9호선,여의도,8623,7736,16359
<class,9호선,샛강,1537,1589,3126
<class,9호선,노량진,12832,13724,26556
<class,9호선,노들,2290,2077,4367
<class,9호선,흑석,3495,3655,7150
<class,9호선,동작,1159,953,2112
<class,9호선,구반포,1074,1113,2187
<class,9호선,신반포,1437,1472,2909
<class,9호선,고속터미널,9446,12169,21615
<class,9호선,사평,1287,1384,2671
<class,9호선,신논현,13729,13276,27005
<class,9호선2~3단계,언주,3483,3569,7052
<class,9호선2~3단계,선정릉,2723,3107,5830
<class,9호선2~3단계,삼성중앙,1778,1946,3724
<class,9호선2~3단계,봉은사,7138,7356,14494
<class,9호선2~3단계,종합운동장,2015,1789,3804
<class,9호선2~3단계,삼전,3205,3087,6292
<class,9호선2~3단계,석촌고분,2734,2796,5530
<class,9호선2~3단계,석촌,4066,3721,7787
<class,9호선2~3단계,송파나루,2674,2992,5666
<class,9호선2~3단계,한성백제,1372,1201,2573
<class,9호선2~3단계,올림픽공원,3009,3058,6067
<class,9호선2~3단계,둔촌오륜,418,476,894
<class,9호선2~3단계,중앙보훈병원,2996,2979,5975
<class,경강선,판교,2216,2062,4278
<class,경강선,이매,621,442,1063
<class,경강선,삼동,951,952,1903
<class,경강선,경기광주,3343,3394,6737
<class,경강선,초월,1503,1488,2991
<class,경강선,곤지암,1416,1691,3107
<class,경강선,신둔도예촌,825,800,1625
<class,경강선,이천,1807,1992,3799
<class,경강선,부발,1087,1729,2816
<class,경강선,세종대왕릉,246,217,463
<class,경강선,여주,1917,1833,3750
<class,경부선,서울역,6068,1394,7462
<class,경부선,남영,3851,4187,8038
<class,경부선,용산,27123,23894,51017
<class,경부선,노량진,5374,5049,10423
<class,경부선,대방,5321,5703,11024
<class,경부선,영등포,28729,28021,56750
<class,경부선,신도림,2150,2317,4467
<class,경부선,신길,4546,3972,8518
<class,경부선,구로,9162,9249,18411
<class,경부선,가산디지털단지,4274,6098,10372
<class,경부선,금천구청,5675,5576,11251
<class,경부선,석수,4972,4919,9891
<class,경부선,관악,4560,4131,8691
<class,경부선,안양,12380,12141,24521
<class,경부선,명학,3189,3080,6269
<class,경부선,금정,12519,12940,25459
<class,경부선,군포,2870,2867,5737
<class,경부선,의왕,3929,4021,7950
<class,경부선,성균관대,6864,7210,14074
<class,경부선,화서,3497,3414,6911
<class,경부선,수원,30938,29843,60781
<class,경부선,독산,5403,5494,10897
<class,경부선,세류,1894,1933,3827
<class,경부선,병점,8436,9422,17858
<class,경부선,세마,1557,1436,2993
<class,경부선,오산대,2020,1997,4017
<class,경부선,오산,7466,8034,15500
<class,경부선,진위,742,780,1522
<class,경부선,송탄,3418,3782,7200
<class,경부선,서정리,3765,5230,8995
<class,경부선,평택지제,2075,1906,3981
<class,경부선,평택,10565,11384,21949
<class,경부선,성환,2197,2640,4837
<class,경부선,직산,492,574,1066
<class,경부선,두정,4077,4322,8399
<class,경부선,천안,5936,5364,11300
<class,경부선,당정,2737,2716,5453
<class,경부선,서동탄,716,745,1461
<class,경부선,광명,2259,1485,3744
<class,경원선,이촌,2179,1695,3874
<class,경원선,서빙고,1246,1281,2527
<class,경원선,한남,1807,1783,3590
<class,경원선,옥수,67,29,96
<class,경원선,응봉,997,902,1899
<class,경원선,왕십리,7392,8568,15960
<class,경원선,청량리,12729,11780,24509
<class,경원선,외대앞,3856,3739,7595
<class,경원선,신이문,4358,4136,8494
<class,경원선,석계,4397,4866,9263
<class,경원선,광운대,3906,3896,7802
<class,경원선,월계,3148,2935,6083
<class,경원선,녹천,2357,2003,4360
<class,경원선,방학,5182,5030,10212
<class,경원선,도봉,3190,2976,6166
<class,경원선,도봉산,8778,6247,15025
<class,경원선,망월사,4137,4375,8512
<class,경원선,회룡,6793,6754,13547
<class,경원선,의정부,12319,12668,24987
<class,경원선,가능,3801,3510,7311
<class,경원선,녹양,2510,2353,4863
<class,경원선,양주,4610,4618,9228
<class,경원선,덕계,1564,1542,3106
<class,경원선,덕정,3073,3216,6289
<class,경원선,지행,4023,3977,8000
<class,경원선,동두천중앙,1974,1907,3881
<class,경원선,보산,1231,1315,2546
<class,경원선,동두천,1301,1718,3019
<class,경원선,소요산,4418,3762,8180
<class,경의선,서울역,981,836,1817
<class,경의선,신촌,245,228,473
<class,경의선,효창공원앞,1154,1350,2504
<class,경의선,공덕,1480,1148,2628
<class,경의선,서강대,1154,1171,2325
<class,경의선,홍대입구,1384,1576,2960
<class,경의선,가좌,2609,2619,5228
<class,경의선,디지털미디어시티,1270,1248,2518
<class,경의선,수색,962,1031,1993
<class,경의선,화전,752,750,1502
<class,경의선,강매,1312,1249,2561
<class,경의선,행신,4020,3803,7823
<class,경의선,능곡,2077,2016,4093
<class,경의선,곡산,314,314,628
<class,경의선,백마,3079,3014,6093
<class,경의선,풍산,3258,3088,6346
<class,경의선,일산,5058,4895,9953
<class,경의선,탄현,3927,3658,7585
<class,경의선,야당,3835,3791,7626
<class,경의선,운정,3384,3273,6657
<class,경의선,금릉,2534,2471,5005
<class,경의선,금촌,3855,4069,7924
<class,경의선,월롱,729,1368,2097
<class,경의선,파주,655,596,1251
<class,경의선,문산,3323,3304,6627
<class,경의선,임진강,94,74,168
<class,경인선,개봉,10923,10825,21748
<class,경인선,오류동,6647,6314,12961
<class,경인선,역곡,13130,13057,26187
<class,경인선,부천,19899,19369,39268
<class,경인선,송내,11929,11663,23592
<class,경인선,부평,21481,21716,43197
<class,경인선,백운,3821,3729,7550
<class,경인선,동암,9004,9019,18023
<class,경인선,주안,10905,9483,20388
<class,경인선,제물포,5243,5193,10436
<class,경인선,동인천,8996,8437,17433
<class,경인선,인천,4131,3368,7499
<class,경인선,구일,3205,3128,6333
<class,경인선,소사,5211,5172,10383
<class,경인선,부개,4379,4187,8566
<class,경인선,간석,3076,2884,5960
<class,경인선,도원,1526,1544,3070
<class,경인선,온수,3619,3416,7035
<class,경인선,중동,4515,4208,8723
<class,경인선,도화,2347,2105,4452
<class,경춘선,신내,865,890,1755
<class,경춘선,갈매,1355,1238,2593
<class,경춘선,별내,1609,1579,3188
<class,경춘선,퇴계원,2022,1891,3913
<class,경춘선,사릉,1615,1662,3277
<class,경춘선,금곡,859,854,1713
<class,경춘선,평내호평,3157,3092,6249
<class,경춘선,천마산,1101,1051,2152
<class,경춘선,마석,2824,2743,5567
<class,경춘선,대성리,687,499,1186
<class,경춘선,청평,1702,1305,3007
<class,경춘선,상천,498,406,904
<class,경춘선,가평,2051,1610,3661
<class,경춘선,굴봉산,245,223,468
<class,경춘선,백양리,153,124,277
<class,경춘선,강촌,844,680,1524
<class,경춘선,김유정,455,445,900
<class,경춘선,남춘천,1988,2055,4043
<class,경춘선,춘천,1577,1343,2920
<class,공항철도 1호선,서울역,6638,5356,11994
<class,공항철도 1호선,공덕,1039,1400,2439
<class,공항철도 1호선,홍대입구,8359,7878,16237
<class,공항철도 1호선,디지털미디어시티,3350,3365,6715
<class,공항철도 1호선,마곡나루,1875,2184,4059
<class,공항철도 1호선,김포공항,11084,5733,16817
<class,공항철도 1호선,계양,4551,4412,8963
<class,공항철도 1호선,검암,3347,3531,6878
<class,공항철도 1호선,청라국제도시,2939,2781,5720
<class,공항철도 1호선,운서,4474,4797,9271
<class,공항철도 1호선,공항화물청사,1006,1074,2080
<class,공항철도 1호선,인천공항1터미널,2976,3059,6035
<class,공항철도 1호선,인천공항2터미널,1498,1509,3007
<class,공항철도 1호선,영종,2198,2131,4329
<class,과천선,선바위,3292,3019,6311
<class,과천선,경마공원,816,816,1632
<class,과천선,대공원,4380,4519,8899
<class,과천선,과천,2868,2762,5630
<class,과천선,정부과천청사,3861,4048,7909
<class,과천선,인덕원,9951,9849,19800
<class,과천선,평촌,5554,5457,11011
<class,과천선,범계,12951,12587,25538
<class,분당선,선릉,2570,3800,6370
<class,분당선,한티,7246,7080,14326
<class,분당선,도곡,2191,2158,4349
<class,분당선,구룡,677,780,1457
<class,분당선,개포동,1924,1897,3821
<class,분당선,대모산입구,1946,1874,3820
<class,분당선,수서,7701,7309,15010
<class,분당선,수원,5607,4590,10197
<class,분당선,서울숲,5682,5779,11461
<class,분당선,압구정로데오,9561,10598,20159
<class,분당선,강남구청,2914,3441,6355
<class,분당선,선정릉,1939,2046,3985
<class,분당선,가천대,3277,4002,7279
<class,분당선,태평,7410,6976,14386
<class,분당선,모란,10163,10176,20339
<class,분당선,야탑,11518,11905,23423
<class,분당선,서현,11731,11841,23572
<class,분당선,수내,5682,5487,11169
<class,분당선,정자,6675,6977,13652
<class,분당선,미금,6491,6956,13447
<class,분당선,오리,4588,4174,8762
<class,분당선,이매,2857,2900,5757
<class,분당선,보정,973,947,1920
<class,분당선,죽전,6760,7634,14394
<class,분당선,구성,2181,2221,4402
<class,분당선,신갈,1792,1824,3616
<class,분당선,기흥,4464,4305,8769
<class,분당선,상갈,2569,2670,5239
<class,분당선,청명,1694,1827,3521
<class,분당선,영통,3800,3886,7686
<class,분당선,망포,5492,5792,11284
<class,분당선,매탄권선,2168,2219,4387
<class,분당선,수원시청,6817,6823,13640
<class,분당선,매교,1252,1348,2600
<class,수인선,고색,1433,1534,2967
<class,수인선,오목천,1350,1309,2659
<class,수인선,어천,485,627,1112
<class,수인선,야목,150,118,268
<class,수인선,사리,2378,2015,4393
<class,수인선,달월,54,56,110
<class,수인선,월곶,1591,1534,3125
<class,수인선,소래포구,4851,4693,9544
<class,수인선,인천논현,2728,2886,5614
<class,수인선,호구포,1984,2003,3987
<class,수인선,남동인더스파크,602,600,1202
<class,수인선,원인재,2559,2749,5308
<class,수인선,연수,2815,2734,5549
<class,수인선,송도,1527,1487,3014
<class,수인선,인하대,2906,2725,5631
<class,수인선,숭의,1899,1690,3589
<class,수인선,신포,1040,1042,2082
<class,수인선,인천,1098,1682,2780
<class,안산선,산본,7780,8191,15971
<class,안산선,대야미,2824,2624,5448
<class,안산선,반월,2431,2412,4843
<class,안산선,상록수,8563,8475,17038
<class,안산선,한대앞,4956,4879,9835
<class,안산선,중앙,10655,10332,20987
<class,안산선,고잔,4287,4122,8409
<class,안산선,초지,2195,2189,4384
<class,안산선,안산,9797,9056,18853
<class,안산선,신길온천,1077,1026,2103
<class,안산선,정왕,4887,5208,10095
<class,안산선,오이도,5786,5675,11461
<class,안산선,수리산,2008,2046,4054
<class,우이신설선,북한산우이,2916,3165,6081
<class,우이신설선,솔밭공원,1278,1276,2554
<class,우이신설선,4.19민주묘지,1880,1626,3506
<class,우이신설선,가오리,2130,2052,4182
<class,우이신설선,화계,1894,1741,3635
<class,우이신설선,삼양,1035,1111,2146
<class,우이신설선,삼양사거리,1465,1414,2879
<class,우이신설선,솔샘,2469,2367,4836
<class,우이신설선,북한산보국문,3254,3050,6304
<class,우이신설선,정릉,2396,2103,4499
<class,우이신설선,성신여대입구,1897,2155,4052
<class,우이신설선,보문,860,915,1775
<class,우이신설선,신설동,1113,1040,2153
<class,일산선,원흥,5076,4931,10007
<class,일산선,삼송,9572,9447,19019
<class,일산선,원당,5610,5480,11090
<class,일산선,화정,8586,8668,17254
<class,일산선,대곡,993,851,1844
<class,일산선,백석,5139,5053,10192
<class,3호선,남부터미널,21310,21996,43306
<class,3호선,교대,6533,4045,10578
<class,3호선,고속터미널,47769,48093,95862
<class,3호선,잠원,3610,3500,7110
<class,3호선,신사,24352,25631,49983
<class,3호선,압구정,24858,25505,50363
<class,3호선,옥수,7175,7136,14311
<class,3호선,금호,5995,5497,11492
<class,3호선,약수,8894,8372,17266
<class,3호선,동대입구,5447,6079,11526
<class,3호선,충무로,2,0,2
<class,3호선,을지로3가,5403,6131,11534
<class,3호선,종로3가,5646,8154,13800
<class,3호선,안국,13263,15491,28754
<class,3호선,경복궁,13747,14925,28672
<class,3호선,독립문,5734,6086,11820
<class,3호선,무악재,2724,2628,5352
<class,3호선,홍제,12674,11836,24510
<class,3호선,녹번,10092,8649,18741
<class,3호선,불광,12746,14372,27118
<class,3호선,연신내,29594,27242,56836
<class,3호선,구파발,14939,15217,30156
<class,3호선,지축,2684,2637,5321
<class,2호선,용두,1757,1685,3442
<class,2호선,신정네거리,7055,7095,14150
<class,2호선,양천구청,4450,4423,8873
<class,2호선,도림천,792,798,1590
<class,2호선,신설동,3147,3079,6226
<class,2호선,신답,997,1047,2044
<class,2호선,용답,2138,1924,4062
<class,2호선,충정로,5755,6221,11976
<class,2호선,아현,7391,6782,14173
<class,2호선,이대,10022,10422,20444
<class,2호선,신촌,29440,29681,59121
<class,2호선,홍대입구,60826,66128,126954
<class,2호선,합정,28028,30154,58182
<class,2호선,당산,12901,13897,26798
<class,2호선,영등포구청,12124,12336,24460
<class,2호선,문래,11983,12627,24610
<class,2호선,신도림,40142,40516,80658
<class,2호선,대림,17973,19355,37328
<class,2호선,구로디지털단지,33556,32737,66293
<class,2호선,신대방,19712,18796,38508
<class,2호선,신림,49051,46302,95353
<class,2호선,봉천,17023,15482,32505
<class,2호선,서울대입구,37350,35853,73203
<class,2호선,낙성대,20964,19150,40114
<class,2호선,사당,28726,31747,60473
<class,2호선,방배,9559,10111,19670
<class,2호선,서초,10844,8983,19827
<class,2호선,교대,16744,18657,35401
<class,2호선,강남,60951,60877,121828
<class,2호선,역삼,17852,19796,37648
<class,2호선,선릉,23123,20470,43593
<class,2호선,삼성,28675,29348,58023
<class,2호선,종합운동장,7096,7982,15078
<class,2호선,잠실새내,16381,16919,33300
<class,2호선,잠실,60164,58033,118197
<class,2호선,잠실나루,7626,7449,15075
<class,2호선,강변,26100,27278,53378
<class,2호선,구의,15478,15143,30621
<class,2호선,건대입구,33217,36395,69612
<class,2호선,성수,17916,20664,38580
<class,2호선,뚝섬,17135,18142,35277
<class,2호선,한양대,4137,4235,8372
<class,2호선,왕십리,12991,10768,23759
<class,2호선,상왕십리,9661,9102,18763
<class,2호선,신당,10341,10677,21018
<class,2호선,동대문역사문화공원,9832,10742,20574
<class,2호선,을지로4가,7146,7631,14777
<class,2호선,을지로3가,11067,11415,22482
<class,2호선,을지로입구,20437,20149,40586
<class,2호선,시청,8818,7291,16109
<class,1호선,청량리,18455,18675,37130
<class,1호선,제기동,14880,15214,30094
<class,1호선,신설동,9114,8425,17539
<class,1호선,동대문,11113,10533,21646
<class,1호선,종로5가,18205,18521,36726
<class,1호선,종로3가,22361,20566,42927
<class,1호선,종각,18084,16808,34892
<class,1호선,시청,9919,10785,20704
<class,1호선,동묘앞,11412,11818,23230
<class,1호선,서울역,29249,29408,58657
<class,안산선,중앙,15887,16340,32227
<class,안산선,한대앞,7341,7302,14643
<class,안산선,상록수,12307,12108,24415
<class,안산선,반월,3372,3223,6595
<class,안산선,대야미,3997,3466,7463
<class,안산선,산본,12161,12940,25101
<class,수인선,인천,1363,2319,3682
<class,수인선,신포,1436,1480,2916
<class,수인선,숭의,2818,2548,5366
<class,수인선,인하대,4217,3993,8210
<class,수인선,송도,2012,2057,4069
<class,수인선,연수,3744,3648,7392
<class,수인선,원인재,3607,3780,7387
<class,수인선,남동인더스파크,998,927,1925
<class,수인선,호구포,2510,2463,4973
<class,수인선,인천논현,4417,4519,8936
<class,수인선,소래포구,5764,5885,11649
<class,수인선,월곶,2018,2013,4031
<class,수인선,달월,72,62,134
<class,수인선,사리,3258,2790,6048
<class,수인선,야목,218,196,414
<class,수인선,어천,711,606,1317
<class,수인선,오목천,2066,1788,3854
<class,수인선,고색,2231,2245,4476
<class,분당선,매교,1977,2035,4012
<class,분당선,수원시청,10807,11659,22466
<class,분당선,매탄권선,3311,3070,6381
<class,분당선,망포,8896,8024,16920
<class,분당선,영통,6570,6396,12966
<class,분당선,청명,2678,2625,5303
<class,5호선,답십리,9854,8977,18831
<class,5호선,마장,3836,3488,7324
<class,5호선,왕십리,3443,3977,7420
<class,5호선,행당,5765,4895,10660
<class,5호선,신금호,3994,4038,8032
<class,5호선,청구,2452,2225,4677
<class,5호선,동대문역사문화공원,938,1307,2245
<class,5호선,을지로4가,3380,3677,7057
<class,5호선,종로3가,12005,12079,24084
<class,5호선,군자,8051,8762,16813
<class,5호선,아차산,12374,11885,24259
<class,5호선,광나루,9626,9244,18870
<class,5호선,천호,16194,15430,31624
<class,5호선,강동,12900,12254,25154
<class,5호선,길동,5718,5710,11428
<class,5호선,굽은다리,6966,6476,13442
<class,5호선,명일,6032,5913,11945
<class,5호선,고덕,6133,6066,12199
<class,5호선,상일동,9564,8806,18370
<class,5호선,둔촌동,6281,6060,12341
<class,5호선,올림픽공원,3158,2895,6053
<class,5호선,방이,5309,4957,10266
<class,5호선,오금,2109,1984,4093
<class,5호선,개롱,4360,4510,8870
<class,5호선,거여,5458,5167,10625
<class,5호선,마천,4494,4633,9127
<class,5호선,강일,2334,2121,4455
<class,5호선,미사,10915,10794,21709
<class,5호선,하남풍산,2666,2693,5359
<class,5호선,하남시청,4473,4360,8833
<class,5호선,하남검단산,5144,5153,10297
<class,6호선,응암,12618,12208,24826
<class,6호선,역촌,2606,3013,5619
<class,6호선,불광,4018,3631,7649
<class,6호선,독바위,2075,2272,4347
<class,6호선,구산,5316,3993,9309
<class,6호선,새절,8680,8218,16898
<class,6호선,증산,7411,7286,14697
<class,6호선,디지털미디어시티,7090,7093,14183
<class,6호선,월드컵경기장,4578,4892,9470
<class,6호선,마포구청,9389,8131,17520
<class,6호선,망원,12957,14544,27501
<class,6호선,합정,12780,11521,24301
<class,6호선,상수,7550,8826,16376
<class,6호선,광흥창,5185,4578,9763
<class,6호선,대흥,5388,5440,10828
<class,6호선,공덕,9653,9039,18692
<class,6호선,효창공원앞,4521,4103,8624
<class,6호선,삼각지,5033,3792,8825
<class,6호선,녹사평,5522,5959,11481
<class,6호선,이태원,12256,13152,25408
<class,6호선,한강진,9171,11029,20200
<class,6호선,버티고개,1367,1505,2872
<class,6호선,약수,2463,2431,4894
<class,6호선,청구,2356,2353,4709
<class,6호선,신당,5569,4657,10226
<class,6호선,동묘앞,8036,7535,15571
<class,6호선,창신,2026,1704,3730
<class,6호선,보문,5025,4382,9407
<class,6호선,안암,7003,6486,13489
<class,6호선,고려대,5612,5197,10809
<class,6호선,월곡,7233,6979,14212
<class,6호선,상월곡,4124,3594,7718
<class,6호선,돌곶이,5819,5522,11341
<class,6호선,석계,8647,8549,17196
<class,6호선,태릉입구,4080,4389,8469
<class,6호선,화랑대,6976,5817,12793
<class,6호선,봉화산,5222,5105,10327
<class,7호선,장암,1661,1210,2871
<class,7호선,도봉산,6702,9347,16049
<class,7호선,수락산,10456,10290,20746
<class,7호선,마들,8747,8100,16847
<class,7호선,노원,15374,16074,31448
<class,7호선,중계,9116,8219,17335
<class,7호선,하계,12115,11152,23267
<class,7호선,공릉,8401,8396,16797
<class,7호선,태릉입구,6499,5903,12402
<class,7호선,먹골,8218,8080,16298
<class,7호선,중화,7722,7156,14878
<class,7호선,상봉,13118,12616,25734
<class,7호선,면목,11065,10841,21906
<class,7호선,사가정,12508,12101,24609
<class,7호선,용마산,4447,4318,8765
<class,7호선,중곡,6581,6132,12713
<class,7호선,군자,10321,7854,18175
<class,7호선,어린이대공원,9757,9232,18989
<class,7호선,건대입구,11122,10998,22120
<class,7호선,뚝섬유원지,11818,11252,23070
<class,7호선,청담,10967,11918,22885
<class,7호선,강남구청,9699,10540,20239
<class,7호선,학동,10250,10852,21102
<class,7호선,논현,11208,12000,23208
<class,7호선,반포,4324,4179,8503
<class,7호선,고속터미널,13765,11310,25075
<class,7호선,내방,7585,7591,15176
<class,7호선,이수,11915,11044,22959
<class,7호선,남성,7478,7028,14506
<class,7호선,숭실대입구,7950,7776,15726
<class,7호선,상도,7142,6703,13845
<class,7호선,장승배기,6695,6386,13081
<class,7호선,신대방삼거리,11039,10172,21211
<class,7호선,보라매,6223,5933,12156
<class,7호선,신풍,8206,7853,16059
<class,7호선,대림,7231,7610,14841
<class,7호선,남구로,8451,8775,17226
<class,7호선,가산디지털단지,14823,13611,28434
<class,7호선,철산,15108,15045,30153
<class,7호선,광명사거리,16678,16473,33151
<class,7호선,천왕,6700,6264,12964
<class,7호선,온수,5610,5557,11167
<class,7호선,까치울,5656,5520,11176
<class,7호선,부천종합운동장,3141,2855,5996
<class,7호선,춘의,5097,4883,9980
<class,7호선,신중동,9740,9649,19389
<class,7호선,부천시청,9707,9587,19294
<class,7호선,상동,10684,10772,21456
<class,7호선,삼산체육관,3645,3391,7036
<class,7호선,굴포천,6704,6798,13502
<class,7호선,부평구청,5146,4349,9495
<class,8호선,암사,12074,11012,23086
<class,8호선,천호,11570,13876,25446
<class,8호선,강동구청,5919,5937,11856
<class,8호선,몽촌토성,4191,4108,8299
<class,8호선,잠실,11789,13912,25701
<class,8호선,석촌,5819,7060,12879
<class,8호선,송파,4921,4882,9803
<class,8호선,가락시장,5307,5374,10681
<class,8호선,문정,8511,8708,17219
<class,8호선,장지,12024,11023,23047
<class,8호선,복정,7063,6063,13126
<class,8호선,산성,4776,4740,9516
<class,8호선,남한산성입구,9187,8183,17370
<class,8호선,단대오거리,7542,7042,14584
<class,8호선,신흥,3932,4064,7996
<class,8호선,수진,4109,3698,7807
<class,8호선,모란,5420,4656,10076
<class,9호선,개화,1430,1234,2664
<class,9호선,김포공항,8036,13736,21772
<class,9호선,공항시장,2123,2251,4374
<class,9호선,신방화,4555,4355,8910
<class,9호선,마곡나루,7792,7694,15486
<class,9호선,양천향교,5891,5576,11467
<class,9호선,가양,14097,13401,27498
<class,9호선,증미,4261,3986,8247
<class,9호선,등촌,7131,6829,13960
<class,9호선,염창,11220,10346,21566
<class,9호선,신목동,2374,2104,4478
<class,9호선,선유도,3995,3848,7843
<class,9호선,당산,12363,11525,23888
<class,9호선,국회의사당,3998,4215,8213
<class,9호선,여의도,12263,11856,24119
<class,9호선,샛강,2570,2583,5153
<class,9호선,노량진,20064,19786,39850
<class,9호선,노들,3351,2795,6146
<class,9호선,흑석,5268,5159,10427
<class,9호선,동작,1582,1275,2857
<class,9호선,구반포,1853,1900,3753
<class,9호선,신반포,2600,2505,5105
<class,9호선,고속터미널,12524,17807,30331
<class,9호선,사평,2055,1924,3979
<class,9호선,신논현,26104,25694,51798
<class,9호선2~3단계,언주,5893,5847,11740
<class,9호선2~3단계,선정릉,4985,5515,10500
<class,9호선2~3단계,삼성중앙,2946,2967,5913
<class,9호선2~3단계,봉은사,10519,11101,21620
<class,9호선2~3단계,종합운동장,3087,2841,5928
<class,9호선2~3단계,삼전,4649,4249,8898
<class,9호선2~3단계,석촌고분,4093,3893,7986
<class,9호선2~3단계,석촌,6299,5276,11575
<class,9호선2~3단계,송파나루,3801,4226,8027
<class,9호선2~3단계,한성백제,1806,1605,3411
<class,9호선2~3단계,올림픽공원,5335,5370,10705
<class,9호선2~3단계,둔촌오륜,647,624,1271
<class,9호선2~3단계,중앙보훈병원,4429,4109,8538
<class,경강선,판교,2839,2786,5625
<class,경강선,이매,814,621,1435
<class,경강선,삼동,1526,1350,2876
<class,경강선,경기광주,5106,4855,9961
<class,경강선,초월,2163,1977,4140
<class,경강선,곤지암,1763,1954,3717
<class,경강선,신둔도예촌,1042,1048,2090
<class,경강선,이천,2501,2700,5201
<class,경강선,부발,1740,1574,3314
<class,경강선,세종대왕릉,289,319,608
<class,경강선,여주,2085,2302,4387
<class,경부선,서울역,5673,1661,7334
<class,경부선,남영,5693,5820,11513
<class,경부선,용산,31602,34735,66337
<class,경부선,노량진,8286,7363,15649
<class,경부선,대방,7946,7851,15797
<class,경부선,영등포,37564,39315,76879
<class,경부선,신도림,3001,3156,6157
<class,경부선,신길,6259,5107,11366
<class,경부선,구로,13471,13856,27327
<class,경부선,가산디지털단지,6177,8224,14401
<class,경부선,금천구청,8231,8221,16452
<class,경부선,석수,7175,6737,13912
<class,경부선,관악,5972,5581,11553
<class,경부선,안양,17838,17869,35707
<class,경부선,명학,5104,4878,9982
<class,경부선,금정,17963,17940,35903
<class,경부선,군포,4314,3840,8154
<class,경부선,의왕,5937,5643,11580
<class,경부선,성균관대,10197,10134,20331
<class,경부선,화서,5270,5337,10607
<class,경부선,수원,37150,39938,77088
<class,경부선,독산,8445,8527,16972
<class,경부선,세류,2485,2495,4980
<class,경부선,병점,12128,11802,23930
<class,경부선,세마,2153,1903,4056
<class,경부선,오산대,2819,2594,5413
<class,경부선,오산,9519,8776,18295
<class,경부선,진위,1046,965,2011
<class,경부선,송탄,4510,4089,8599
<class,경부선,서정리,6078,5151,11229
<class,경부선,평택지제,2600,2556,5156
<class,경부선,평택,13347,12864,26211
<class,경부선,성환,2910,2595,5505
<class,경부선,직산,658,674,1332
<class,경부선,두정,5291,5702,10993
<class,경부선,천안,6579,6602,13181
<class,경부선,당정,4012,3864,7876
<class,경부선,서동탄,1073,1116,2189
<class,경부선,광명,2505,2374,4879
<class,경원선,이촌,3275,2277,5552
<class,경원선,서빙고,1396,1177,2573
<class,경원선,한남,2732,2640,5372
<class,경원선,옥수,36,41,77
<class,경원선,응봉,1395,1243,2638
<class,경원선,왕십리,11958,13652,25610
<class,경원선,청량리,15625,17425,33050
<class,경원선,외대앞,5975,5555,11530
<class,경원선,신이문,6179,5511,11690
<class,경원선,석계,6484,7052,13536
<class,경원선,광운대,5805,5580,11385
<class,5호선,광화문,13825,14320,28145
<class,5호선,서대문,7262,7196,14458
<class,5호선,충정로,2091,1889,3980
<class,5호선,애오개,3603,3409,7012
<class,5호선,공덕,6780,7052,13832
<class,5호선,마포,6987,6935,13922
<class,5호선,여의나루,14261,16331,30592
<class,5호선,여의도,11652,12587,24239
<class,5호선,신길,2465,2591,5056
<class,5호선,영등포시장,7031,7461,14492
<class,5호선,영등포구청,1913,1878,3791
<class,5호선,양평,3680,3441,7121
<class,5호선,오목교,15802,16458,32260
<class,5호선,목동,11796,11901,23697
<class,5호선,신정,8881,7360,16241
<class,5호선,까치산,20633,19462,40095
<class,5호선,화곡,19961,18317,38278
<class,5호선,우장산,9548,9468,19016
<class,5호선,발산,13136,14165,27301
<class,5호선,마곡,5120,4964,10084
<class,5호선,송정,4905,4665,9570
<class,5호선,김포공항,7656,7623,15279
<class,5호선,개화산,3658,3666,7324
<class,5호선,방화,4682,4375,9057
<class,4호선,쌍문,21359,18864,40223
<class,4호선,창동,18941,19764,38705
<class,4호선,노원,15675,17079,32754
<class,4호선,상계,13677,12849,26526
<class,4호선,당고개,9896,9407,19303
<class,4호선,남태령,982,695,1677
<class,4호선,사당,19598,16830,36428
<class,4호선,총신대입구,14223,15126,29349
<class,4호선,동작,2246,2285,4531
<class,4호선,이촌,6700,7453,14153
<class,4호선,신용산,9706,10654,20360
<class,4호선,삼각지,3005,4060,7065
<class,4호선,숙대입구,8633,8360,16993
<class,4호선,서울역,5190,11784,16974
<class,4호선,회현,17605,18909,36514
<class,4호선,명동,13967,16342,30309
<class,4호선,충무로,12523,12856,25379
<class,4호선,동대문역사문화공원,10860,9267,20127
<class,4호선,동대문,14874,14784,29658
<class,4호선,혜화,25487,26710,52197
<class,4호선,한성대입구,10674,10074,20748
<class,4호선,성신여대입구,16212,15020,31232
<class,4호선,길음,13846,13038,26884
<class,4호선,미아사거리,21580,20363,41943
<class,4호선,미아,10754,9940,20694
<class,4호선,수유,25801,24880,50681
<class,3호선,오금,3743,3411,7154
<class,3호선,경찰병원,3747,3621,7368
<class,3호선,가락시장,5927,5677,11604
<class,3호선,수서,12827,13120,25947
<class,3호선,일원,4781,4733,9514
<class,3호선,대청,5798,5190,10988
<class,분당선,상갈,3858,3867,7725
<class,분당선,기흥,6689,6475,13164
<class,분당선,신갈,2702,2748,5450
<class,분당선,구성,3241,3269,6510
<class,분당선,죽전,9923,11121,21044
<class,분당선,보정,1607,1445,3052
<class,분당선,이매,3986,3855,7841
<class,분당선,오리,7688,6408,14096
<class,분당선,미금,11246,11625,22871
<class,분당선,정자,10475,10774,21249
<class,분당선,수내,8616,8119,16735
<class,분당선,서현,18057,18143,36200
<class,분당선,야탑,16932,17914,34846
<class,분당선,모란,21720,22386,44106
<class,분당선,태평,10597,9870,20467
<class,분당선,가천대,4852,5124,9976
<class,분당선,선정릉,3591,3736,7327
<class,분당선,강남구청,5428,6576,12004
<class,분당선,압구정로데오,18377,21035,39412
<class,분당선,서울숲,9448,9773,19221
<class,분당선,수원,7399,6334,13733
<class,분당선,수서,9882,10546,20428
<class,분당선,대모산입구,2497,2274,4771
<class,분당선,개포동,2639,2570,5209
<class,경원선,월계,4680,4340,9020
<class,경원선,녹천,3421,2862,6283
<class,중앙선,팔당,1552,1831,3383
<class,중앙선,운길산,1467,1483,2950
<class,중앙선,양수,2419,2418,4837
<class,중앙선,신원,291,210,501
<class,중앙선,국수,724,789,1513
<class,중앙선,아신,636,661,1297
<class,중앙선,오빈,274,333,607
<class,중앙선,양평,2595,2946,5541
<class,중앙선,원덕,415,414,829
<class,중앙선,용문,2265,2595,4860
<class,중앙선,지평,33,55,88
<class,경원선,방학,7431,7258,14689
<class,분당선,구룡,1365,1191,2556
<class,분당선,도곡,4353,3927,8280
<class,분당선,한티,10817,10489,21306
<class,분당선,선릉,5000,7784,12784
<class,과천선,범계,19940,19629,39569
<class,과천선,평촌,9134,8929,18063
<class,과천선,인덕원,15475,14820,30295
<class,과천선,정부과천청사,5807,5922,11729
<class,과천선,과천,4178,3745,7923
<class,과천선,대공원,5966,6274,12240
<class,과천선,경마공원,1167,1132,2299
<class,과천선,선바위,5138,4513,9651
<class,공항철도 1호선,영종,2804,2895,5699
<class,공항철도 1호선,인천공항2터미널,1731,1695,3426
<class,공항철도 1호선,인천공항1터미널,3106,3471,6577
<class,공항철도 1호선,공항화물청사,1421,1386,2807
<class,공항철도 1호선,운서,5788,6036,11824
<class,공항철도 1호선,청라국제도시,4093,4052,8145
<class,공항철도 1호선,검암,4494,4600,9094
<class,공항철도 1호선,계양,6603,6029,12632
<class,공항철도 1호선,김포공항,11407,6274,17681
<class,공항철도 1호선,마곡나루,3125,3263,6388
<class,공항철도 1호선,디지털미디어시티,5231,4811,10042
<class,공항철도 1호선,홍대입구,12042,11766,23808
<class,공항철도 1호선,공덕,1486,2140,3626
<class,공항철도 1호선,서울역,6862,6963,13825
<class,경춘선,춘천,1993,1748,3741
<class,경춘선,남춘천,2535,2734,5269
<class,경춘선,김유정,632,729,1361
<class,경춘선,강촌,752,832,1584
<class,경춘선,백양리,151,173,324
<class,우이신설선,삼양사거리,1907,1815,3722
<class,우이신설선,솔샘,3743,3282,7025
<class,우이신설선,북한산보국문,4567,4129,8696
<class,우이신설선,정릉,3417,2922,6339
<class,우이신설선,성신여대입구,2636,2971,5607
<class,우이신설선,보문,1100,1085,2185
<class,우이신설선,신설동,1388,1283,2671
<class,일산선,원흥,7450,7218,14668
<class,일산선,삼송,13236,12941,26177
<class,일산선,원당,8227,7949,16176
<class,일산선,화정,12596,12964,25560
<class,일산선,대곡,1409,1244,2653
<class,일산선,백석,7478,7407,14885
<class,경춘선,굴봉산,217,238,455
<class,경춘선,가평,2070,2791,4861
<class,경춘선,상천,467,373,840
<class,경춘선,청평,1755,2019,3774
<class,경춘선,대성리,738,785,1523
<class,경춘선,마석,3239,3169,6408
<class,경춘선,천마산,1417,1402,2819
<class,경춘선,평내호평,4508,4500,9008
<class,경원선,도봉,4436,4143,8579
<class,3호선,학여울,1228,1204,2432
<class,경원선,도봉산,9612,6734,16346
<class,경원선,망월사,5519,5678,11197
<class,경원선,회룡,9529,9388,18917
<class,경원선,의정부,17084,18021,35105
<class,경원선,가능,5196,4972,10168
<class,경원선,녹양,3595,3451,7046
<class,경원선,양주,6296,6018,12314
<class,경원선,덕계,2236,2113,4349
<class,경원선,덕정,4378,4027,8405
<class,경원선,지행,5480,5522,11002
<class,경원선,동두천중앙,2570,2558,5128
<class,경원선,보산,1587,1560,3147
<class,경원선,동두천,1612,2090,3702
<class,경원선,소요산,4507,4050,8557
<class,경의선,서울역,1247,1428,2675
<class,경의선,신촌,357,360,717
<class,경의선,효창공원앞,1680,1842,3522
<class,경의선,공덕,2599,1996,4595
<class,경의선,서강대,1726,1575,3301
<class,경의선,홍대입구,2074,2261,4335
<class,경의선,가좌,3920,3713,7633
<class,경의선,디지털미디어시티,1915,1774,3689
<class,경의선,수색,1460,1428,2888
<class,경의선,화전,1027,1004,2031
<class,경의선,강매,1952,1783,3735
<class,경의선,행신,5045,5073,10118
<class,경의선,능곡,2872,2712,5584
<class,경의선,곡산,422,437,859
<class,경의선,백마,4347,4147,8494
<class,안산선,고잔,6297,6435,12732
<class,5호선,장한평,10891,10519,21410
<class,안산선,초지,3220,3268,6488
<class,안산선,안산,9907,10528,20435
<class,안산선,신길온천,1498,1381,2879
<class,안산선,정왕,6450,6545,12995
<class,안산선,오이도,7881,8151,16032
<class,안산선,수리산,2927,2568,5495
<class,우이신설선,북한산우이,3360,3619,6979
<class,우이신설선,솔밭공원,1857,1762,3619
<class,우이신설선,4.19민주묘지,2476,2149,4625
<class,우이신설선,가오리,2894,2751,5645
<class,우이신설선,화계,2482,2301,4783
<class,우이신설선,삼양,1566,1597,3163
<class,3호선,대치,8504,7703,16207
<class,3호선,도곡,3443,3354,6797
<class,3호선,매봉,6031,5857,11888
<class,일산선,마두,5039,5066,10105
<class,일산선,정발산,6176,6374,12550
<class,일산선,주엽,6452,6275,12727
<class,일산선,대화,8796,8050,16846
<class,장항선,봉명,793,711,1504
<class,장항선,쌍용,1644,1455,3099
<class,장항선,아산,2784,2731,5515
<class,장항선,배방,999,1031,2030
<class,장항선,온양온천,4693,4757,9450
<class,장항선,신창,1191,1038,2229
<class,중앙선,회기,19532,18088,37620
<class,중앙선,중랑,4509,4352,8861
<class,중앙선,상봉,5294,5041,10335
<class,중앙선,망우,6346,6123,12469
<class,중앙선,양원,1183,1230,2413
<class,중앙선,도심,1713,1536,3249
<class,중앙선,덕소,4619,4633,9252
<class,중앙선,양정,657,598,1255
<class,중앙선,도농,6720,6192,12912
<class,중앙선,구리,10470,10712,21182
<class,경의선,풍산,4176,4033,8209
<class,경의선,일산,6003,5764,11767
<class,경의선,탄현,5226,5040,10266
<class,경의선,야당,5178,5240,10418
<class,경의선,운정,4747,4464,9211
<class,경의선,금릉,3595,3494,7089
<class,경의선,금촌,5305,5172,10477
<class,경의선,월롱,1264,1177,2441
<class,경의선,파주,906,688,1594
<class,경의선,문산,4984,4954,9938
<class,경의선,임진강,104,82,186
<class,경춘선,금곡,1147,1074,2221
<class,경춘선,사릉,2399,2405,4804
<class,경춘선,퇴계원,2704,2512,5216
<class,경춘선,별내,2296,2199,4495
<class,경춘선,갈매,1977,1655,3632
<class,경춘선,신내,1120,1078,2198
<class,경인선,도화,3244,3025,6269
<class,경인선,중동,6354,6101,12455
<class,경인선,온수,5055,4673,9728
<class,경인선,도원,2011,2112,4123
<class,경인선,간석,4418,4267,8685
<class,경인선,부개,6437,5948,12385
<class,경인선,소사,7098,7044,14142
<class,경인선,구일,4376,4077,8453
<class,경인선,인천,5025,4171,9196
<class,경인선,동인천,11718,11389,23107
<class,경인선,제물포,7560,7275,14835
<class,경인선,주안,15952,13586,29538
<class,경인선,동암,12266,12417,24683
<class,경인선,백운,5541,5346,10887
<class,경인선,부평,29628,32390,62018
<class,경인선,송내,17755,17477,35232
<class,경인선,부천,28217,28896,57113
<class,경인선,역곡,19887,19350,39237
<class,경인선,오류동,9158,8291,17449
<class,경인선,개봉,16248,15813,32061
<class,3호선,양재,19772,21411,41183
<class,3호선,남부터미널,14100,14527,28627
<class,1호선,서울역,25575,22481,48056
<class,1호선,동묘앞,11990,11968,23958
<class,1호선,시청,6851,6777,13628
<class,1호선,종각,11504,10096,21600
<class,1호선,종로3가,13228,11470,24698
<class,1호선,종로5가,8508,8626,17134
<class,1호선,동대문,9094,9690,18784
<class,1호선,신설동,6623,6802,13425
<class,1호선,제기동,9096,9373,18469
<class,1호선,청량리,12598,12567,25165
<class,2호선,시청,5670,4521,10191
<class,2호선,을지로입구,14377,13591,27968
<class,2호선,을지로3가,7631,6976,14607
<class,2호선,을지로4가,3256,3064,6320
<class,2호선,동대문역사문화공원,6794,8035,14829
<class,2호선,신당,7636,8029,15665
<class,2호선,상왕십리,6571,6316,12887
<class,2호선,왕십리,8451,7521,15972
<class,2호선,한양대,2149,2324,4473
<class,2호선,뚝섬,12609,13158,25767
<class,2호선,성수,11746,13625,25371
<class,2호선,건대입구,24600,26186,50786
<class,2호선,구의,10697,10678,21375
<class,2호선,강변,21269,19860,41129
<class,2호선,잠실나루,5139,5110,10249
<class,2호선,잠실,43987,41299,85286
<class,2호선,잠실새내,10413,10695,21108
<class,2호선,종합운동장,5721,6321,12042
<class,2호선,삼성,18848,18491,37339
<class,2호선,선릉,11993,10424,22417
<class,2호선,역삼,10961,12068,23029
<class,2호선,강남,34348,33419,67767
<class,2호선,교대,9842,10831,20673
<class,2호선,서초,10273,9673,19946
<class,2호선,방배,6378,6886,13264
<class,2호선,사당,19308,21589,40897
<class,2호선,낙성대,14786,15190,29976
<class,2호선,서울대입구,25778,26846,52624
<class,2호선,봉천,11697,11163,22860
<class,2호선,신림,34705,34630,69335
<class,2호선,신대방,14620,14202,28822
<class,2호선,구로디지털단지,22269,21813,44082
<class,2호선,대림,14405,14684,29089
<class,2호선,신도림,27799,28559,56358
<class,2호선,문래,7403,7788,15191
<class,2호선,영등포구청,7286,7545,14831
<class,2호선,당산,8487,9169,17656
<class,2호선,합정,19072,20593,39665
<class,2호선,홍대입구,44599,44549,89148
<class,2호선,신촌,20493,19897,40390
<class,2호선,이대,6685,7026,13711
<class,2호선,아현,5026,5017,10043
<class,2호선,충정로,3575,3737,7312
<class,2호선,용답,1600,1535,3135
<class,2호선,신답,707,766,1473
<class,2호선,신설동,2770,2799,5569
<class,2호선,도림천,510,544,1054
<class,2호선,양천구청,3538,3645,7183
<class,2호선,신정네거리,4918,4905,9823
<class,2호선,용두,1185,1208,2393
<class,3호선,지축,1907,1843,3750
<class,3호선,구파발,11030,11534,22564
<class,3호선,연신내,20710,19441,40151
<class,3호선,불광,9341,10901,20242
<class,3호선,녹번,6852,6158,13010
<class,3호선,홍제,8825,8554,17379
<class,중앙선,지평,76,54,130
<class,중앙선,용문,4470,3919,8389
<class,중앙선,원덕,438,366,804
<class,중앙선,양평,2431,2067,4498
<class,중앙선,오빈,262,219,481
<class,중앙선,아신,544,478,1022
<class,중앙선,국수,607,513,1120
<class,중앙선,신원,292,221,513
<class,중앙선,양수,2105,1891,3996
<class,중앙선,운길산,1311,1181,2492
<class,중앙선,팔당,1501,1528,3029
<class,중앙선,도심,1274,1218,2492
<class,중앙선,덕소,3447,3533,6980
<class,중앙선,양정,561,508,1069
<class,중앙선,도농,4840,4742,9582
<class,중앙선,구리,7332,7659,14991
<class,중앙선,양원,873,883,1756
<class,중앙선,망우,4785,4868,9653
<class,중앙선,상봉,4135,4160,8295
<class,중앙선,중랑,3365,3282,6647
<class,중앙선,회기,14321,14015,28336
<class,장항선,신창,936,1053,1989
<class,장항선,온양온천,2970,2899,5869
<class,장항선,배방,737,853,1590
<class,장항선,아산,2891,1973,4864
<class,장항선,쌍용,1052,1049,2101
<class,장항선,봉명,489,479,968
<class,일산선,대화,6321,5981,12302
<class,일산선,주엽,4188,4155,8343
<class,일산선,정발산,4592,4517,9109
<class,일산선,마두,3357,3336,6693
<class,일산선,백석,5282,5208,10490
<class,일산선,대곡,996,822,1818
<class,일산선,화정,8688,8955,17643
<class,일산선,원당,5876,5613,11489
<class,일산선,삼송,9901,9566,19467
<class,일산선,원흥,5350,5126,10476
<class,우이신설선,신설동,1133,1090,2223
<class,우이신설선,보문,884,893,1777
<class,우이신설선,성신여대입구,1987,2198,4185
<class,우이신설선,정릉,2550,2184,4734
<class,우이신설선,북한산보국문,3516,3240,6756
<class,우이신설선,솔샘,2532,2440,4972
<class,우이신설선,삼양사거리,1462,1387,2849
<class,우이신설선,삼양,1178,1196,2374
<class,우이신설선,화계,1991,1868,3859
<class,우이신설선,가오리,2263,2100,4363
<class,우이신설선,4.19민주묘지,1999,1699,3698
<class,우이신설선,솔밭공원,1391,1392,2783
<class,우이신설선,북한산우이,3072,3416,6488
<class,안산선,수리산,2092,2102,4194
<class,안산선,오이도,6088,6034,12122
<class,안산선,정왕,5067,5472,10539
<class,안산선,신길온천,1156,1127,2283
<class,안산선,안산,9926,8954,18880
<class,안산선,초지,2223,2226,4449
<class,안산선,고잔,4379,4231,8610
<class,안산선,중앙,11011,11189,22200
<class,안산선,한대앞,5137,4946,10083
<class,안산선,상록수,8652,8413,17065
<class,안산선,반월,2424,2377,4801
<class,안산선,대야미,3055,2817,5872
<class,안산선,산본,8267,8969,17236
<class,수인선,인천,1177,1783,2960
<class,수인선,신포,1132,1058,2190
<class,수인선,숭의,1964,1844,3808
<class,수인선,인하대,3155,3095,6250
<class,수인선,송도,1534,1616,3150
<class,수인선,연수,2943,2716,5659
<class,수인선,원인재,2739,2853,5592
<class,수인선,남동인더스파크,545,560,1105
<class,수인선,호구포,2017,1988,4005
<class,수인선,인천논현,2995,3116,6111
<class,수인선,소래포구,5051,4930,9981
<class,수인선,월곶,1589,1509,3098
<class,수인선,달월,40,49,89
<class,수인선,사리,2406,2108,4514
<class,수인선,야목,183,151,334
<class,수인선,어천,474,608,1082
<class,수인선,오목천,1402,1460,2862
<class,수인선,고색,1441,1557,2998
<class,분당선,매교,1340,1422,2762
<class,분당선,수원시청,7082,7079,14161
<class,분당선,매탄권선,2298,2253,4551
<class,분당선,망포,5817,6275,12092
<class,분당선,영통,4396,4503,8899
<class,분당선,청명,1773,1878,3651
<class,분당선,상갈,2771,2897,5668
<class,분당선,기흥,4829,4543,9372
<class,분당선,신갈,1952,1959,3911
<class,분당선,구성,2307,2461,4768
<class,분당선,죽전,7488,8530,16018
<class,분당선,보정,1072,933,2005
<class,분당선,이매,3114,3225,6339
<class,분당선,오리,4942,4380,9322
<class,분당선,미금,7078,7458,14536
<class,분당선,정자,6920,7312,14232
<class,분당선,수내,5935,5767,11702
<class,분당선,서현,12185,12314,24499
<class,분당선,야탑,12170,12409,24579
<class,분당선,모란,10244,10390,20634
<class,분당선,태평,7510,7074,14584
<class,분당선,가천대,3306,4015,7321
<class,분당선,선정릉,2059,2180,4239
<class,분당선,강남구청,2853,3439,6292
<class,분당선,압구정로데오,10220,11392,21612
<class,분당선,서울숲,6516,6451,12967
<class,분당선,수원,5698,4630,10328
<class,분당선,수서,8223,7747,15970
<class,분당선,대모산입구,1450,1477,2927
<class,분당선,개포동,1746,1741,3487
<class,분당선,구룡,755,825,1580
<class,분당선,도곡,2565,2470,5035
<class,분당선,한티,7090,7113,14203
<class,분당선,선릉,2621,3853,6474
<class,과천선,범계,13812,13147,26959
<class,과천선,평촌,5701,5431,11132
<class,과천선,인덕원,10341,10290,20631
<class,과천선,정부과천청사,4034,4125,8159
<class,과천선,과천,3039,2862,5901
<class,과천선,대공원,4969,5156,10125
<class,과천선,경마공원,948,913,1861
<class,과천선,선바위,3542,3285,6827
<class,공항철도 1호선,영종,2198,2194,4392
<class,공항철도 1호선,인천공항2터미널,1529,1500,3029
<class,공항철도 1호선,인천공항1터미널,3006,3121,6127
<class,공항철도 1호선,공항화물청사,1035,1123,2158
<class,공항철도 1호선,운서,4729,5110,9839
<class,공항철도 1호선,청라국제도시,3041,2923,5964
<class,공항철도 1호선,검암,3221,3557,6778
<class,공항철도 1호선,계양,4714,4614,9328
<class,공항철도 1호선,김포공항,11281,6306,17587
<class,공항철도 1호선,마곡나루,2083,2344,4427
<class,공항철도 1호선,디지털미디어시티,3327,3363,6690
<class,공항철도 1호선,홍대입구,9327,8519,17846
<class,공항철도 1호선,공덕,1145,1460,2605
<class,공항철도 1호선,서울역,6932,5819,12751
<class,경춘선,춘천,1870,1300,3170
<class,경춘선,남춘천,2286,2300,4586
<class,경춘선,김유정,530,551,1081
<class,경춘선,강촌,784,696,1480
<class,경춘선,백양리,161,110,271
<class,경춘선,굴봉산,334,292,626
<class,경춘선,가평,2557,2056,4613
<class,경춘선,상천,514,355,869
<class,경춘선,청평,1869,1622,3491
<class,경춘선,대성리,765,578,1343
<class,경춘선,마석,2576,2408,4984
<class,경춘선,천마산,1156,1120,2276
<class,경춘선,평내호평,3317,3284,6601
<class,경춘선,금곡,969,944,1913
<class,경춘선,사릉,1727,1772,3499
<class,경춘선,퇴계원,2093,2058,4151
<class,경춘선,별내,1749,1627,3376
<class,경춘선,갈매,1410,1320,2730
<class,경춘선,신내,814,886,1700
<class,경인선,도화,2305,2233,4538
<class,경인선,중동,4783,4478,9261
<class,경인선,온수,3578,3597,7175
<class,경인선,도원,1638,1692,3330
<class,경인선,간석,3025,2921,5946
<class,경인선,부개,4633,4463,9096
<class,경인선,소사,5029,4985,10014
<class,경인선,구일,3059,3128,6187
<class,경인선,인천,4300,3392,7692
<class,경인선,동인천,9000,8694,17694
<class,경인선,제물포,5518,5287,10805
<class,경인선,주안,11141,9605,20746
<class,경인선,동암,8937,8852,17789
<class,경인선,백운,3807,3879,7686
<class,경인선,부평,21985,21957,43942
<class,경인선,송내,12593,12188,24781
<class,경인선,부천,21070,20077,41147
<class,경인선,역곡,13767,13304,27071
<class,경인선,오류동,6757,6550,13307
<class,경인선,개봉,11025,11503,22528
<class,경의선,임진강,76,72,148
<class,경의선,문산,3397,3391,6788
<class,경의선,파주,628,562,1190
<class,경의선,월롱,834,1512,2346
<class,경의선,금촌,3783,4025,7808
<class,경의선,금릉,2551,2529,5080
<class,경의선,운정,3414,3367,6781
<class,경의선,야당,3886,3817,7703
<class,경의선,탄현,3848,3611,7459
<class,경의선,일산,4396,4236,8632
<class,경의선,풍산,3259,3144,6403
<class,경의선,백마,3194,3139,6333
<class,경의선,곡산,320,320,640
<class,경의선,능곡,2032,2071,4103
<class,경의선,행신,4059,3826,7885
<class,경의선,강매,1373,1323,2696
<class,경의선,화전,730,750,1480
<class,경의선,수색,974,1021,1995
<class,경의선,디지털미디어시티,1349,1203,2552
<class,경의선,가좌,2801,2792,5593
<class,경의선,홍대입구,1421,1603,3024
<class,경의선,서강대,1260,1179,2439
<class,경의선,공덕,1639,1432,3071
<class,경의선,효창공원앞,1196,1346,2542
<class,경의선,신촌,231,258,489
<class,경의선,서울역,1036,924,1960
<class,경원선,소요산,4523,3921,8444
<class,경원선,동두천,1258,1588,2846
<class,경원선,보산,1283,1275,2558
<class,경원선,동두천중앙,2186,2166,4352
<class,경원선,지행,4050,3886,7936
<class,경원선,덕정,3174,3184,6358
<class,경원선,덕계,1642,1541,3183
<class,경원선,양주,4934,4872,9806
<class,경원선,녹양,2727,2655,5382
<class,경원선,가능,3824,3776,7600
<class,경원선,의정부,12818,13054,25872
<class,경원선,회룡,6985,7150,14135
<class,경원선,망월사,4244,4402,8646
<class,경원선,도봉산,9181,6580,15761
<class,경원선,도봉,3393,3290,6683
<class,경원선,방학,5607,5380,10987
<class,경원선,녹천,2489,2214,4703
<class,경원선,월계,3578,3302,6880
<class,경원선,광운대,4208,4298,8506
<class,경원선,석계,4611,5037,9648
<class,경원선,신이문,4450,4196,8646
<class,경원선,외대앞,4232,4149,8381
<class,경원선,청량리,13839,12741,26580
<class,경원선,왕십리,8697,9980,18677
<class,경원선,응봉,1041,998,2039
<class,경원선,옥수,62,26,88
<class,경원선,한남,1880,1804,3684
<class,경원선,서빙고,1274,1261,2535
<class,경원선,이촌,2500,1842,4342
<class,경부선,광명,2048,1442,3490
<class,경부선,서동탄,759,770,1529
<class,경부선,당정,2935,2860,5795
<class,경부선,천안,6061,5499,11560
<class,경부선,두정,4342,4448,8790
<class,경부선,직산,541,596,1137
<class,경부선,성환,2268,2609,4877
<class,경부선,평택,10962,11200,22162
<class,경부선,평택지제,2098,2001,4099
<class,경부선,서정리,3919,5262,9181
<class,경부선,송탄,3332,3785,7117
<class,경부선,진위,737,749,1486
<class,경부선,오산,7235,7769,15004
<class,경부선,오산대,2071,2089,4160
<class,경부선,세마,1552,1439,2991
<class,경부선,병점,8639,9632,18271
<class,경부선,세류,1971,1978,3949
<class,경부선,독산,5656,5885,11541
<class,경부선,수원,32302,31106,63408
<class,경부선,화서,3643,3606,7249
<class,경부선,성균관대,7163,7554,14717
<class,경부선,의왕,4100,4210,8310
<class,경부선,군포,2920,2822,5742
<class,경부선,금정,12919,13327,26246
<class,경부선,명학,3332,3240,6572
<class,경부선,안양,13180,12818,25998
<class,경부선,관악,4674,4486,9160
<class,경부선,석수,5040,4873,9913
<class,경부선,금천구청,6071,5808,11879
<class,경부선,가산디지털단지,4459,6301,10760
<class,경부선,구로,9093,9388,18481
<class,경부선,신길,4531,4003,8534
<class,경부선,신도림,2190,2518,4708
<class,경부선,영등포,29367,28274,57641
<class,경부선,대방,5494,5911,11405
<class,경부선,노량진,5424,5083,10507
<class,경부선,용산,29824,26768,56592
<class,경부선,남영,4339,4555,8894
<class,경부선,서울역,6605,1380,7985
<class,경강선,여주,2014,2006,4020
<class,경강선,세종대왕릉,283,242,525
<class,경강선,부발,1127,1766,2893
<class,경강선,이천,1853,2089,3942
<class,경강선,신둔도예촌,788,786,1574
<class,경강선,곤지암,1435,1686,3121
<class,경강선,초월,1596,1514,3110
<class,경강선,경기광주,3500,3546,7046
<class,경강선,삼동,983,1024,2007
<class,경강선,이매,691,506,1197
<class,경강선,판교,2304,2025,4329
<class,9호선2~3단계,중앙보훈병원,3072,3063,6135
<class,9호선2~3단계,둔촌오륜,429,494,923
<class,9호선2~3단계,올림픽공원,4090,4242,8332
<class,9호선2~3단계,한성백제,1415,1291,2706
<class,9호선2~3단계,송파나루,2623,2963,5586
<class,9호선2~3단계,석촌,4313,3766,8079
<class,9호선2~3단계,석촌고분,2755,2783,5538
<class,9호선2~3단계,삼전,3418,3288,6706
<class,9호선2~3단계,종합운동장,2101,1914,4015
<class,9호선2~3단계,봉은사,6724,6841,13565
<class,9호선2~3단계,삼성중앙,1674,1824,3498
<class,9호선2~3단계,선정릉,2993,3326,6319
<class,9호선2~3단계,언주,3383,3324,6707
<class,9호선,신논현,14693,14044,28737
<class,9호선,사평,1281,1383,2664
<class,9호선,고속터미널,10234,12890,23124
<class,9호선,신반포,1546,1630,3176
<class,9호선,구반포,1106,1146,2252
<class,9호선,동작,1193,990,2183
<class,9호선,흑석,3655,3873,7528
<class,9호선,노들,2549,2173,4722
<class,9호선,노량진,13963,14717,28680
<class,9호선,샛강,1601,1773,3374
<class,9호선,여의도,8568,7640,16208
<class,9호선,국회의사당,4146,3926,8072
<class,9호선,당산,8330,8117,16447
<class,9호선,선유도,2861,2757,5618
<class,9호선,신목동,1657,1531,3188
<class,9호선,염창,7847,7930,15777
<class,9호선,등촌,4908,5000,9908
<class,9호선,증미,2929,2941,5870
<class,9호선,가양,9733,9698,19431
<class,9호선,양천향교,3857,4091,7948
<class,9호선,마곡나루,4977,5110,10087
<class,9호선,신방화,3203,3217,6420
<class,9호선,공항시장,1635,1744,3379
<class,9호선,김포공항,7797,11972,19769
<class,9호선,개화,989,953,1942
<class,8호선,모란,2300,1992,4292
<class,8호선,수진,2780,2504,5284
<class,8호선,신흥,2595,2766,5361
<class,8호선,단대오거리,5043,4988,10031
<class,8호선,남한산성입구,6313,5988,12301
<class,8호선,산성,3429,3480,6909
<class,8호선,복정,4999,4616,9615
<class,8호선,장지,8560,8721,17281
<class,8호선,문정,5007,5339,10346
<class,8호선,가락시장,2830,3643,6473
<class,8호선,송파,3484,3496,6980
<class,8호선,석촌,3886,4764,8650
<class,8호선,잠실,9096,10330,19426
<class,8호선,몽촌토성,3111,3047,6158
<class,8호선,강동구청,4135,4270,8405
<class,8호선,천호,8410,9654,18064
<class,8호선,암사,8402,8018,16420
<class,7호선,부평구청,3532,3190,6722
<class,7호선,굴포천,4430,4580,9010
<class,7호선,삼산체육관,2551,2392,4943
<class,7호선,상동,6741,6638,13379
<class,7호선,부천시청,6532,6528,13060
<class,7호선,신중동,6396,6440,12836
<class,7호선,춘의,3463,3211,6674
<class,7호선,부천종합운동장,2435,2334,4769
<class,7호선,까치울,4112,4166,8278
<class,7호선,온수,3757,3884,7641
<class,7호선,천왕,4664,4573,9237
<class,7호선,광명사거리,11872,11676,23548
<class,7호선,철산,9850,9885,19735
<class,7호선,가산디지털단지,10394,9698,20092
<class,7호선,남구로,6658,6467,13125
<class,7호선,대림,6647,6430,13077
<class,7호선,신풍,5815,5625,11440
<class,7호선,보라매,3832,3913,7745
<class,7호선,신대방삼거리,7428,7461,14889
<class,7호선,장승배기,4965,4951,9916
<class,7호선,상도,5023,4874,9897
<class,7호선,숭실대입구,5423,5781,11204
<class,7호선,남성,5140,5100,10240
<class,7호선,이수,7739,7638,15377
<class,7호선,내방,4773,5075,9848
<class,7호선,고속터미널,12087,7587,19674
<class,7호선,반포,2875,2796,5671
<class,7호선,논현,5982,6450,12432
<class,7호선,학동,5462,5813,11275
<class,7호선,강남구청,5160,5593,10753
<class,7호선,청담,6562,6871,13433
<class,7호선,뚝섬유원지,8501,7741,16242
<class,7호선,건대입구,7646,7527,15173
<class,7호선,어린이대공원,6902,6694,13596
<class,7호선,군자,7354,5849,13203
<class,7호선,중곡,4609,4482,9091
<class,7호선,용마산,3173,3463,6636
<class,7호선,사가정,8839,8719,17558
<class,7호선,면목,7642,7542,15184
<class,7호선,상봉,9364,8787,18151
<class,7호선,중화,5514,5222,10736
<class,7호선,먹골,5225,5183,10408
<class,7호선,태릉입구,4755,4385,9140
<class,7호선,공릉,6056,6111,12167
<class,7호선,하계,8292,7927,16219
<class,7호선,중계,6436,5934,12370
<class,7호선,노원,10246,10480,20726
<class,7호선,마들,5597,5332,10929
<class,7호선,수락산,8566,8508,17074
<class,7호선,도봉산,5492,8106,13598
<class,7호선,장암,1573,1309,2882
<class,6호선,봉화산,3693,3630,7323
<class,6호선,화랑대,4780,4139,8919
<class,6호선,태릉입구,2852,3067,5919
<class,6호선,석계,6214,6247,12461
<class,6호선,돌곶이,4715,4456,9171
<class,6호선,상월곡,3006,2760,5766
<class,6호선,월곡,5192,5144,10336
<class,6호선,고려대,3771,3529,7300
<class,6호선,안암,4358,4519,8877
<class,6호선,보문,3650,3532,7182
<class,6호선,창신,1628,1451,3079
<class,6호선,동묘앞,6050,5884,11934
<class,6호선,신당,3506,4239,7745
<class,6호선,청구,1588,1525,3113
<class,6호선,약수,1579,1588,3167
<class,6호선,버티고개,922,1088,2010
<class,6호선,한강진,6032,7042,13074
<class,6호선,이태원,8705,8363,17068
<class,6호선,녹사평,4138,3843,7981
<class,6호선,삼각지,3332,2560,5892
<class,6호선,효창공원앞,3177,2763,5940
<class,6호선,공덕,6352,6030,12382
<class,6호선,대흥,3431,3647,7078
<class,6호선,광흥창,3737,3574,7311
<class,6호선,상수,5400,6172,11572
<class,6호선,합정,9053,8033,17086
<class,6호선,망원,9291,10176,19467
<class,6호선,마포구청,6743,6221,12964
<class,6호선,월드컵경기장,3923,4033,7956
<class,6호선,디지털미디어시티,4879,5201,10080
<class,6호선,증산,5294,5411,10705
<class,6호선,새절,6170,6161,12331
<class,6호선,구산,3753,2883,6636
<class,6호선,독바위,1497,1814,3311
<class,6호선,불광,3035,2832,5867
<class,6호선,역촌,1940,2283,4223
<class,6호선,응암,8904,9013,17917
<class,5호선,하남검단산,4146,4216,8362
<class,5호선,하남시청,3137,3057,6194
<class,5호선,하남풍산,2035,2009,4044
<class,5호선,미사,7539,7569,15108
<class,5호선,강일,1679,1653,3332
<class,5호선,마천,3256,3642,6898
<class,5호선,거여,3623,3686,7309
<class,5호선,개롱,2937,3244,6181
<class,5호선,오금,1464,1347,2811
<class,5호선,방이,3905,3704,7609
<class,5호선,올림픽공원,2266,2008,4274
<class,5호선,둔촌동,4326,4514,8840
<class,5호선,상일동,6485,6251,12736
<class,5호선,고덕,4040,4063,8103
<class,5호선,명일,4408,4454,8862
<class,5호선,굽은다리,5074,4870,9944
<class,5호선,길동,3924,3865,7789
<class,5호선,강동,8174,8175,16349
<class,5호선,천호,11717,10889,22606
<class,5호선,광나루,7222,7246,14468
<class,5호선,아차산,9592,9391,18983
<class,5호선,군자,5691,6198,11889
<class,5호선,장한평,6993,6942,13935
<class,5호선,답십리,6953,6463,13416
<class,5호선,마장,2773,2552,5325
<class,5호선,왕십리,2403,2585,4988
<class,5호선,행당,3741,3469,7210
<class,5호선,신금호,2746,2955,5701
<class,5호선,청구,1694,1546,3240
<class,5호선,동대문역사문화공원,607,697,1304
<class,5호선,을지로4가,1474,1532,3006
<class,5호선,종로3가,8147,7604,15751
<class,5호선,광화문,9570,9824,19394
<class,5호선,서대문,6130,5803,11933
<class,5호선,충정로,1398,1478,2876
<class,5호선,애오개,2442,2582,5024
<class,5호선,공덕,4348,4336,8684
<class,5호선,마포,4359,4310,8669
<class,5호선,여의나루,10818,11658,22476
<class,5호선,여의도,7663,7976,15639
<class,5호선,신길,1757,1968,3725
<class,5호선,영등포시장,4132,4434,8566
<class,5호선,영등포구청,1258,1308,2566
<class,5호선,양평,2445,2493,4938
<class,5호선,오목교,10788,11267,22055
<class,5호선,목동,7924,8142,16066
<class,5호선,신정,5910,5393,11303
<class,5호선,까치산,14912,14639,29551
<class,5호선,화곡,13620,12798,26418
<class,5호선,우장산,6268,6387,12655
<class,5호선,발산,8313,8741,17054
<class,5호선,마곡,3235,3491,6726
<class,5호선,송정,3525,3541,7066
<class,5호선,김포공항,7006,6729,13735
<class,5호선,개화산,2730,2792,5522
<class,5호선,방화,3448,3361,6809
<class,4호선,쌍문,15170,13848,29018
<class,4호선,창동,13726,14468,28194
<class,4호선,노원,11031,11874,22905
<class,4호선,상계,9831,9251,19082
<class,4호선,당고개,7640,7326,14966
<class,4호선,남태령,615,488,1103
<class,4호선,사당,13369,12700,26069
<class,4호선,총신대입구,9610,10207,19817
<class,4호선,동작,1629,1689,3318
<class,4호선,이촌,4761,5468,10229
<class,4호선,신용산,7469,7635,15104
<class,4호선,삼각지,2004,2620,4624
<class,4호선,숙대입구,6710,6518,13228
<class,4호선,서울역,3648,8548,12196
<class,4호선,회현,7730,8057,15787
<class,4호선,명동,10363,10746,21109
<class,4호선,충무로,7953,8048,16001
<class,4호선,동대문역사문화공원,7784,7477,15261
<class,4호선,동대문,6363,6958,13321
<class,4호선,혜화,19744,20948,40692
<class,4호선,한성대입구,7190,7155,14345
<class,4호선,성신여대입구,11322,10947,22269
<class,4호선,길음,9547,9227,18774
<class,4호선,미아사거리,15259,14650,29909
<class,4호선,미아,7525,7248,14773
<class,4호선,수유,18850,17982,36832
<class,3호선,오금,2445,2522,4967
<class,3호선,경찰병원,2717,2765,5482
<class,3호선,가락시장,3623,3759,7382
<class,3호선,수서,10027,9739,19766
<class,3호선,일원,3130,3450,6580
<class,3호선,대청,3947,3837,7784
<class,3호선,학여울,881,907,1788
<class,3호선,대치,5085,4650,9735
<class,3호선,도곡,1863,2012,3875
<class,3호선,매봉,4004,4167,8171
<class,3호선,양재,12285,14191,26476
<class,3호선,교대,4133,2521,6654
<class,3호선,고속터미널,39515,35509,75024
<class,3호선,잠원,2141,2055,4196
<class,3호선,신사,12575,12899,25474
<class,3호선,압구정,13423,13924,27347
<class,3호선,옥수,5006,5208,10214
<class,3호선,금호,3997,4017,8014
<class,3호선,약수,6189,6030,12219
<class,3호선,동대입구,4220,4652,8872
<class,3호선,을지로3가,3136,2945,6081
<class,3호선,종로3가,3662,4802,8464
<class,3호선,안국,8798,9934,18732
<class,3호선,경복궁,9711,10155,19866
<class,3호선,독립문,3879,4394,8273
<class,3호선,무악재,1834,1969,3803
<class,2호선,건대입구,31892,34948,66840
<class,2호선,구의,15335,14791,30126
<class,2호선,강변,25463,26605,52068
<class,2호선,잠실나루,7150,6955,14105
<class,2호선,잠실,59144,57223,116367
<class,2호선,잠실새내,15873,16303,32176
<class,2호선,종합운동장,6554,7312,13866
<class,2호선,삼성,26873,27462,54335
<class,2호선,선릉,22663,20034,42697
<class,2호선,역삼,17158,18476,35634
<class,2호선,강남,59659,59498,119157
<class,2호선,교대,16719,18738,35457
<class,2호선,서초,10018,8458,18476
<class,2호선,방배,9322,9768,19090
<class,2호선,사당,27529,30253,57782
<class,2호선,낙성대,20504,18817,39321
<class,2호선,서울대입구,36681,35069,71750
<class,2호선,봉천,16638,15221,31859
<class,2호선,신림,48005,45297,93302
<class,2호선,신대방,19491,18666,38157
<class,2호선,구로디지털단지,32893,32024,64917
<class,2호선,대림,17739,18793,36532
<class,2호선,신도림,38474,38649,77123
<class,2호선,문래,11503,12062,23565
<class,2호선,영등포구청,11817,11903,23720
<class,2호선,당산,12400,13345,25745
<class,2호선,합정,26798,28799,55597
<class,2호선,홍대입구,58916,63384,122300
<class,2호선,신촌,28377,28272,56649
<class,2호선,이대,9691,10073,19764
<class,2호선,아현,7241,6889,14130
<class,2호선,충정로,5373,5585,10958
<class,2호선,용답,2071,1876,3947
<class,2호선,신답,997,1010,2007
<class,2호선,신설동,2802,2678,5480
<class,2호선,도림천,801,822,1623
<class,2호선,양천구청,4375,4287,8662
<class,2호선,신정네거리,7052,6966,14018
<class,2호선,용두,1648,1587,3235
<class,3호선,지축,2572,2483,5055
<class,3호선,구파발,14432,14623,29055
<class,3호선,연신내,28521,26546,55067
<class,3호선,불광,12114,13656,25770
<class,3호선,녹번,9755,8421,18176
<class,3호선,홍제,12255,11420,23675
<class,3호선,무악재,2535,2521,5056
<class,3호선,독립문,5303,5457,10760
<class,3호선,경복궁,13771,15391,29162
<class,3호선,안국,12596,13961,26557
<class,3호선,종로3가,5407,7786,13193
<class,우이신설선,4.19민주묘지,2258,2064,4322
<class,우이신설선,솔밭공원,1769,1651,3420
<class,우이신설선,북한산우이,2789,2935,5724
<class,안산선,수리산,2845,2536,5381
<class,안산선,오이도,7691,7735,15426
<class,안산선,정왕,6227,6316,12543
<class,안산선,신길온천,1343,1390,2733
<class,안산선,안산,9665,10166,19831
<class,경원선,양주,5754,5458,11212
<class,공항철도 1호선,영종,2700,2806,5506
<class,우이신설선,성신여대입구,2519,3005,5524
<class,우이신설선,보문,1079,1012,2091
<class,우이신설선,신설동,1339,1199,2538
<class,일산선,원흥,6879,6514,13393
<class,일산선,삼송,12779,12621,25400
<class,일산선,원당,7915,7566,15481
<class,일산선,화정,11859,12165,24024
<class,일산선,대곡,1371,1180,2551
<class,일산선,백석,6970,7037,14007
<class,일산선,마두,4849,4811,9660
<class,일산선,정발산,5938,6210,12148
<class,일산선,주엽,6289,6044,12333
<class,일산선,대화,8141,7167,15308
<class,장항선,봉명,668,603,1271
<class,장항선,쌍용,1476,1325,2801
<class,장항선,아산,2512,2501,5013
<class,장항선,배방,962,949,1911
<class,장항선,온양온천,3332,3353,6685
<class,장항선,신창,966,898,1864
<class,중앙선,회기,18612,17126,35738
<class,중앙선,중랑,4384,4090,8474
<class,중앙선,상봉,5052,4856,9908
<class,중앙선,망우,6152,5958,12110
<class,중앙선,양원,1169,1120,2289
<class,중앙선,구리,9765,9874,19639
<class,중앙선,도농,6099,5918,12017
<class,중앙선,양정,630,536,1166
<class,중앙선,덕소,4252,4240,8492
<class,중앙선,도심,1544,1346,2890
<class,중앙선,팔당,1215,1265,2480
<class,중앙선,운길산,1201,1244,2445
<class,중앙선,양수,2150,2328,4478
<class,중앙선,신원,222,207,429
<class,중앙선,국수,628,671,1299
<class,중앙선,아신,514,598,1112
<class,중앙선,오빈,260,274,534
<class,중앙선,양평,2539,2766,5305
<class,중앙선,원덕,383,416,799
<class,중앙선,용문,1864,2304,4168
<class,중앙선,지평,46,74,120
<class,안산선,초지,2952,2985,5937
<class,안산선,고잔,5964,5876,11840
<class,안산선,중앙,15097,15762,30859
<class,3호선,을지로3가,5148,5666,10814
<class,3호선,동대입구,5318,5974,11292
<class,3호선,약수,8831,8172,17003
<class,7호선,남성,7425,6931,14356
<class,과천선,선바위,4976,4361,9337
<class,3호선,금호,5768,5232,11000
<class,3호선,옥수,6786,6938,13724
<class,3호선,압구정,24484,25385,49869
<class,3호선,신사,23253,24756,48009
<class,3호선,잠원,3697,3503,7200
<class,3호선,고속터미널,45937,47364,93301
<class,3호선,교대,6483,3907,10390
<class,3호선,남부터미널,20181,20807,40988
<class,3호선,양재,19799,21402,41201
<class,3호선,매봉,6120,5905,12025
<class,3호선,도곡,3101,3130,6231
<class,3호선,대치,8027,7286,15313
<class,3호선,학여울,2921,3247,6168
<class,3호선,대청,5536,5108,10644
<class,3호선,일원,4434,4560,8994
<class,3호선,수서,12503,12766,25269
<class,3호선,가락시장,5962,5564,11526
<class,3호선,경찰병원,3854,3723,7577
<class,3호선,오금,3630,3402,7032
<class,4호선,수유,24917,24074,48991
<class,4호선,미아,10370,9582,19952
<class,4호선,미아사거리,21113,20102,41215
<class,4호선,길음,13455,12860,26315
<class,4호선,성신여대입구,15874,14685,30559
<class,4호선,한성대입구,10121,9606,19727
<class,4호선,혜화,24327,25559,49886
<class,4호선,동대문,13944,13865,27809
<class,4호선,동대문역사문화공원,11270,9852,21122
<class,4호선,충무로,12268,12818,25086
<class,4호선,명동,11915,14068,25983
<class,4호선,회현,16903,18321,35224
<class,4호선,서울역,4874,11733,16607
<class,4호선,숙대입구,8458,8200,16658
<class,4호선,삼각지,3143,4082,7225
<class,4호선,신용산,9610,10696,20306
<class,4호선,이촌,6332,7131,13463
<class,4호선,동작,1968,2053,4021
<class,4호선,총신대입구,13738,14837,28575
<class,4호선,사당,19110,16367,35477
<class,4호선,남태령,950,682,1632
<class,4호선,당고개,9416,8905,18321
<class,4호선,상계,13201,12301,25502
<class,4호선,노원,15080,16770,31850
<class,4호선,창동,18362,19046,37408
<class,4호선,쌍문,20181,18180,38361
<class,5호선,방화,4366,4167,8533
<class,5호선,개화산,3535,3449,6984
<class,5호선,김포공항,7458,7552,15010
<class,5호선,송정,4852,4666,9518
<class,5호선,마곡,4871,4922,9793
<class,5호선,발산,12682,13635,26317
<class,5호선,우장산,9035,8799,17834
<class,5호선,화곡,19409,17773,37182
<class,5호선,까치산,20083,19237,39320
<class,5호선,신정,8484,7126,15610
<class,5호선,목동,11080,11047,22127
<class,5호선,오목교,15930,16457,32387
<class,5호선,양평,3594,3467,7061
<class,5호선,영등포구청,1963,1927,3890
<class,5호선,영등포시장,6633,6815,13448
<class,5호선,신길,2470,2504,4974
<class,5호선,여의도,10985,11994,22979
<class,5호선,여의나루,11879,13711,25590
<class,5호선,마포,6775,6866,13641
<class,5호선,공덕,6813,7044,13857
<class,5호선,애오개,3655,3476,7131
<class,5호선,충정로,1827,1727,3554
<class,5호선,서대문,6843,6763,13606
<class,5호선,광화문,13553,14049,27602
<class,5호선,종로3가,11696,12460,24156
<class,5호선,을지로4가,3245,3762,7007
<class,5호선,동대문역사문화공원,930,1345,2275
<class,5호선,청구,2476,2406,4882
<class,5호선,신금호,4001,3986,7987
<class,5호선,행당,5678,4900,10578
<class,5호선,왕십리,3284,3873,7157
<class,5호선,마장,3666,3484,7150
<class,5호선,답십리,9789,8808,18597
<class,5호선,장한평,10654,10439,21093
<class,5호선,군자,8189,8880,17069
<class,5호선,아차산,11249,10856,22105
<class,5호선,광나루,9447,8845,18292
<class,5호선,천호,15438,14778,30216
<class,5호선,강동,11987,11186,23173
<class,5호선,길동,5650,5703,11353
<class,5호선,굽은다리,6983,6692,13675
<class,5호선,명일,5847,5716,11563
<class,5호선,고덕,5850,5880,11730
<class,5호선,상일동,9556,8784,18340
<class,5호선,둔촌동,6106,6161,12267
<class,5호선,올림픽공원,3177,3097,6274
<class,5호선,방이,5162,4975,10137
<class,5호선,오금,2108,1983,4091
<class,5호선,개롱,4351,4590,8941
<class,5호선,거여,5495,5096,10591
<class,5호선,마천,4242,4404,8646
<class,5호선,강일,2289,2150,4439
<class,5호선,미사,10857,10545,21402
<class,5호선,하남풍산,2537,2716,5253
<class,5호선,하남시청,4214,4101,8315
<class,5호선,하남검단산,4451,4568,9019
<class,6호선,응암,12175,11901,24076
<class,6호선,역촌,2619,2927,5546
<class,6호선,불광,3690,3398,7088
<class,6호선,독바위,1998,2064,4062
<class,6호선,연신내,2,0,2
<class,6호선,구산,5162,3869,9031
<class,6호선,새절,8749,8059,16808
<class,6호선,증산,7064,7012,14076
<class,6호선,디지털미디어시티,6915,7147,14062
<class,6호선,월드컵경기장,4516,4790,9306
<class,6호선,마포구청,9315,8153,17468
<class,6호선,망원,12188,13636,25824
<class,6호선,합정,12112,11050,23162
<class,6호선,상수,7535,9136,16671
<class,6호선,광흥창,5059,4575,9634
<class,6호선,대흥,5188,5248,10436
<class,6호선,공덕,9902,9318,19220
<class,6호선,효창공원앞,4371,3817,8188
<class,6호선,삼각지,5332,4201,9533
<class,6호선,녹사평,5181,5478,10659
<class,6호선,이태원,11614,12503,24117
<class,6호선,한강진,7463,9146,16609
<class,6호선,버티고개,1304,1396,2700
<class,6호선,약수,2358,2392,4750
<class,6호선,청구,2414,2291,4705
<class,6호선,신당,6032,5144,11176
<class,6호선,동묘앞,7478,6681,14159
<class,6호선,창신,2132,1678,3810
<class,6호선,보문,5016,4456,9472
<class,6호선,안암,6101,5674,11775
<class,6호선,고려대,5272,4826,10098
<class,6호선,월곡,7018,6843,13861
<class,6호선,상월곡,3957,3470,7427
<class,6호선,돌곶이,5748,5322,11070
<class,6호선,석계,8402,8359,16761
<class,6호선,태릉입구,4066,4291,8357
<class,6호선,화랑대,6958,5857,12815
<class,6호선,봉화산,5015,4908,9923
<class,7호선,장암,1454,1054,2508
<class,7호선,도봉산,6016,8110,14126
<class,7호선,수락산,9580,9290,18870
<class,7호선,마들,8454,7832,16286
<class,7호선,노원,15222,15814,31036
<class,7호선,중계,8852,7849,16701
<class,7호선,하계,11973,10989,22962
<class,7호선,공릉,8267,8171,16438
<class,7호선,태릉입구,6366,5823,12189
<class,7호선,먹골,7590,7305,14895
<class,7호선,중화,7548,7113,14661
<class,7호선,상봉,12813,12368,25181
<class,7호선,면목,10732,10211,20943
<class,7호선,사가정,12258,11827,24085
<class,7호선,용마산,4381,4299,8680
<class,7호선,중곡,6375,5859,12234
<class,7호선,군자,10091,7673,17764
<class,7호선,어린이대공원,8694,8382,17076
<class,7호선,건대입구,10098,10265,20363
<class,7호선,뚝섬유원지,9338,8590,17928
<class,7호선,청담,10520,11300,21820
<class,7호선,강남구청,9352,10334,19686
<class,7호선,학동,10164,10798,20962
<class,7호선,논현,11000,11853,22853
<class,7호선,반포,4467,4197,8664
<class,7호선,고속터미널,13555,10671,24226
<class,7호선,내방,7433,7426,14859
<class,7호선,이수,11660,10842,22502
<class,7호선,숭실대입구,7718,7443,15161
<class,7호선,상도,7330,6807,14137
<class,7호선,장승배기,6533,6237,12770
<class,7호선,신대방삼거리,10951,9980,20931
<class,7호선,보라매,5894,5689,11583
<class,7호선,신풍,8108,7602,15710
<class,7호선,대림,7148,7641,14789
<class,7호선,남구로,8458,8709,17167
<class,7호선,가산디지털단지,14605,13536,28141
<class,7호선,철산,14696,15022,29718
<class,7호선,광명사거리,16375,16151,32526
<class,7호선,천왕,6558,6150,12708
<class,7호선,온수,5663,5362,11025
<class,7호선,까치울,5454,5439,10893
<class,7호선,부천종합운동장,3075,2858,5933
<class,7호선,춘의,5078,4704,9782
<class,7호선,신중동,9494,9391,18885
<class,7호선,부천시청,9284,9279,18563
<class,7호선,상동,9888,10179,20067
<class,7호선,삼산체육관,3473,3205,6678
<class,7호선,굴포천,6402,6542,12944
<class,7호선,부평구청,4813,4307,9120
<class,8호선,암사,12058,10995,23053
<class,8호선,천호,11383,13303,24686
<class,8호선,강동구청,5802,5800,11602
<class,8호선,몽촌토성,3975,3970,7945
<class,8호선,잠실,11884,13869,25753
<class,8호선,석촌,5609,6706,12315
<class,8호선,송파,4692,4614,9306
<class,8호선,가락시장,5271,5288,10559
<class,8호선,문정,8075,8076,16151
<class,8호선,장지,11584,10731,22315
<class,8호선,복정,7030,6175,13205
<class,8호선,산성,4269,4211,8480
<class,8호선,남한산성입구,8528,7578,16106
<class,8호선,단대오거리,7083,6711,13794
<class,8호선,신흥,3507,3726,7233
<class,8호선,수진,3857,3466,7323
<class,8호선,모란,3437,2840,6277
<class,9호선,개화,1257,1197,2454
<class,9호선,김포공항,8282,13151,21433
<class,9호선,공항시장,2185,2171,4356
<class,9호선,신방화,4482,4291,8773
<class,9호선,마곡나루,7538,7540,15078
<class,9호선,양천향교,5695,5344,11039
<class,9호선,가양,13508,12696,26204
<class,9호선,증미,4192,4086,8278
<class,9호선,등촌,7112,6768,13880
<class,9호선,염창,11045,10152,21197
<class,9호선,신목동,2308,1965,4273
<class,9호선,선유도,3821,3633,7454
<class,9호선,당산,12187,11230,23417
<class,9호선,국회의사당,3901,4198,8099
<class,9호선,여의도,11904,11478,23382
<class,9호선,샛강,2486,2596,5082
<class,9호선,노량진,20884,20404,41288
<class,9호선,노들,3287,2725,6012
<class,9호선,흑석,5513,5367,10880
<class,9호선,동작,1630,1273,2903
<class,9호선,구반포,1858,1968,3826
<class,9호선,신반포,2132,2191,4323
<class,9호선,고속터미널,12575,17809,30384
<class,9호선,사평,2104,1877,3981
<class,9호선,신논현,25421,25401,50822
<class,9호선2~3단계,언주,5633,5738,11371
<class,9호선2~3단계,선정릉,4473,5051,9524
<class,9호선2~3단계,삼성중앙,2936,3002,5938
<class,9호선2~3단계,봉은사,10083,10417,20500
<class,9호선2~3단계,종합운동장,3330,2929,6259
<class,9호선2~3단계,삼전,4583,4286,8869
<class,9호선2~3단계,석촌고분,4043,3818,7861
<class,9호선2~3단계,석촌,6240,5193,11433
<class,9호선2~3단계,송파나루,3707,4313,8020
<class,9호선2~3단계,한성백제,1815,1599,3414
<class,9호선2~3단계,올림픽공원,7228,6848,14076
<class,9호선2~3단계,둔촌오륜,593,599,1192
<class,9호선2~3단계,중앙보훈병원,4181,3871,8052
<class,경강선,판교,2798,2663,5461
<class,경강선,이매,746,555,1301
<class,경강선,삼동,1395,1344,2739
<class,경강선,경기광주,4670,4614,9284
<class,경강선,초월,2057,1995,4052
<class,경강선,곤지암,1802,1903,3705
<class,경강선,신둔도예촌,1020,996,2016
<class,경강선,이천,2450,2468,4918
<class,경강선,부발,1598,1468,3066
<class,경강선,세종대왕릉,298,339,637
<class,경강선,여주,2002,2366,4368
<class,경부선,서울역,5973,1752,7725
<class,경부선,남영,5809,5995,11804
<class,경부선,용산,32065,34950,67015
<class,경부선,노량진,8391,7564,15955
<class,경부선,대방,7578,7358,14936
<class,경부선,영등포,37888,38901,76789
<class,경부선,신도림,2852,3019,5871
<class,경부선,신길,6057,5011,11068
<class,경부선,구로,12607,12998,25605
<class,경부선,가산디지털단지,5991,8025,14016
<class,경부선,금천구청,8117,8092,16209
<class,경부선,석수,6600,5966,12566
<class,경부선,관악,5478,5302,10780
<class,경부선,안양,17261,17336,34597
<class,경부선,명학,4795,4659,9454
<class,경부선,금정,17727,17595,35322
<class,경부선,군포,4329,3998,8327
<class,경부선,의왕,5678,5531,11209
<class,경부선,성균관대,10107,9923,20030
<class,경부선,화서,5018,5075,10093
<class,경부선,수원,36249,39073,75322
<class,경부선,독산,8332,8416,16748
<class,경부선,세류,2346,2448,4794
<class,경부선,병점,11546,11282,22828
<class,경부선,세마,2175,1945,4120
<class,경부선,오산대,2743,2517,5260
<class,경부선,오산,9174,8491,17665
<class,경부선,진위,1003,888,1891
<class,경부선,송탄,4668,4187,8855
<class,경부선,서정리,5863,5067,10930
<class,경부선,평택지제,2627,2463,5090
<class,경부선,평택,12659,12125,24784
<class,경부선,성환,2786,2616,5402
<class,경부선,직산,628,623,1251
<class,경부선,두정,5047,5349,10396
<class,경부선,천안,6027,6161,12188
<class,경부선,당정,3974,3702,7676
<class,경부선,서동탄,1033,1050,2083
<class,경부선,광명,2411,2287,4698
<class,경원선,이촌,3095,2173,5268
<class,경원선,서빙고,1371,1231,2602
<class,경원선,한남,2829,2568,5397
<class,경원선,옥수,32,31,63
<class,경원선,응봉,1358,1094,2452
<class,경원선,왕십리,11714,13318,25032
<class,경원선,청량리,15334,17046,32380
<class,경원선,외대앞,5835,5352,11187
<class,경원선,신이문,6038,5419,11457
<class,경원선,석계,6516,6794,13310
<class,경원선,광운대,5598,5379,10977
<class,경원선,월계,4457,4100,8557
<class,경원선,녹천,3189,2612,5801
<class,경원선,방학,7226,7019,14245
<class,경원선,도봉,4263,3954,8217
<class,경원선,도봉산,7557,5213,12770
<class,경원선,망월사,5111,5252,10363
<class,경원선,회룡,8957,8880,17837
<class,경원선,의정부,15995,16879,32874
<class,경원선,가능,4762,4599,9361
<class,경원선,녹양,3360,3341,6701
<class,경원선,덕계,2089,1921,4010
<class,경원선,덕정,4105,3829,7934
<class,경원선,지행,4967,5029,9996
<class,경원선,동두천중앙,2354,2387,4741
<class,경원선,보산,1389,1361,2750
<class,경원선,동두천,1495,1792,3287
<class,경원선,소요산,3214,2840,6054
<class,경의선,서울역,1238,1372,2610
<class,경의선,신촌,330,358,688
<class,경의선,효창공원앞,1616,1811,3427
<class,경의선,공덕,2603,1981,4584
<class,경의선,서강대,1672,1509,3181
<class,경의선,홍대입구,1857,2125,3982
<class,경의선,가좌,3854,3625,7479
<class,경의선,디지털미디어시티,1811,1671,3482
<class,경의선,수색,1438,1432,2870
<class,경의선,화전,1028,996,2024
<class,경의선,강매,1953,1803,3756
<class,경의선,행신,5040,5044,10084
<class,경의선,능곡,2588,2570,5158
<class,경의선,곡산,368,391,759
<class,경의선,백마,4132,3923,8055
<class,경의선,풍산,4103,3961,8064
<class,경의선,일산,5955,5639,11594
<class,경의선,탄현,5121,4836,9957
<class,경의선,야당,5113,4990,10103
<class,경의선,운정,4674,4427,9101
<class,경의선,금릉,3647,3393,7040
<class,경의선,금촌,5388,5371,10759
<class,경의선,월롱,1245,1153,2398
<class,경의선,파주,775,649,1424
<class,경의선,문산,4201,4272,8473
<class,경의선,임진강,64,62,126
<class,경인선,개봉,15909,15447,31356
<class,경인선,오류동,9058,8150,17208
<class,경인선,역곡,19276,18948,38224
<class,경인선,부천,27847,28679,56526
<class,경인선,송내,17497,17454,34951
<class,경인선,부평,28855,31304,60159
<class,경인선,백운,5320,5173,10493
<class,경인선,동암,12141,12336,24477
<class,경인선,주안,14704,13044,27748
<class,경인선,제물포,6984,6752,13736
<class,경인선,동인천,11321,11127,22448
<class,경인선,인천,4243,3601,7844
<class,경인선,구일,5795,5578,11373
<class,경인선,소사,6766,6640,13406
<class,경인선,부개,6145,5739,11884
<class,경인선,간석,4261,4094,8355
<class,경인선,도원,1959,2020,3979
<class,경인선,온수,4787,4437,9224
<class,경인선,도화,3037,2869,5906
<class,경춘선,신내,986,983,1969
<class,경춘선,갈매,1839,1634,3473
<class,경춘선,별내,2177,2102,4279
<class,경춘선,퇴계원,2404,2190,4594
<class,경춘선,사릉,2185,2095,4280
<class,경춘선,금곡,1052,943,1995
<class,경춘선,평내호평,4279,4273,8552
<class,경춘선,천마산,1286,1271,2557
<class,경춘선,마석,2861,2957,5818
<class,경춘선,대성리,599,593,1192
<class,경춘선,청평,1633,1871,3504
<class,경춘선,상천,274,296,570
<class,경춘선,가평,1854,2267,4121
<class,경춘선,굴봉산,168,217,385
<class,경춘선,백양리,100,95,195
<class,경춘선,강촌,516,632,1148
<class,경춘선,김유정,418,538,956
<class,경춘선,남춘천,2106,2262,4368
<class,경춘선,춘천,1390,1327,2717
<class,공항철도 1호선,서울역,6664,7033,13697
<class,공항철도 1호선,공덕,1476,2193,3669
<class,공항철도 1호선,홍대입구,11610,11511,23121
<class,공항철도 1호선,디지털미디어시티,5013,4705,9718
<class,공항철도 1호선,마곡나루,3011,3166,6177
<class,공항철도 1호선,김포공항,12092,5821,17913
<class,공항철도 1호선,계양,6396,5832,12228
<class,공항철도 1호선,검암,4288,4304,8592
<class,공항철도 1호선,청라국제도시,3964,3846,7810
<class,공항철도 1호선,운서,5468,5668,11136
<class,공항철도 1호선,공항화물청사,1273,1340,2613
<class,공항철도 1호선,인천공항1터미널,2938,3400,6338
<class,공항철도 1호선,인천공항2터미널,1587,1612,3199
<class,과천선,경마공원,1195,1129,2324
<class,과천선,대공원,4594,4930,9524
<class,과천선,과천,4006,3635,7641
<class,과천선,정부과천청사,5524,5508,11032
<class,과천선,인덕원,14976,14183,29159
<class,과천선,평촌,9047,9000,18047
<class,과천선,범계,19388,19027,38415
<class,분당선,선릉,4940,7474,12414
<class,분당선,한티,10264,10188,20452
<class,분당선,도곡,4128,3697,7825
<class,분당선,구룡,1185,1117,2302
<class,분당선,개포동,2517,2457,4974
<class,분당선,대모산입구,2331,2125,4456
<class,분당선,수서,9786,10361,20147
<class,분당선,수원,7207,6094,13301
<class,분당선,서울숲,8106,8231,16337
<class,분당선,압구정로데오,18099,21037,39136
<class,분당선,강남구청,5137,6129,11266
<class,분당선,선정릉,3361,3567,6928
<class,분당선,가천대,4388,4867,9255
<class,분당선,태평,10312,9564,19876
<class,분당선,모란,15098,15070,30168
<class,분당선,야탑,16652,17287,33939
<class,분당선,서현,17216,17352,34568
<class,분당선,수내,8434,7813,16247
<class,분당선,정자,10295,10601,20896
<class,분당선,미금,10355,10738,21093
<class,분당선,오리,7283,6134,13417
<class,분당선,이매,3950,3895,7845
<class,분당선,보정,1589,1474,3063
<class,분당선,죽전,9607,10911,20518
<class,분당선,구성,3085,3072,6157
<class,분당선,신갈,2687,2605,5292
<class,분당선,기흥,6491,6203,12694
<class,분당선,상갈,3736,3785,7521
<class,분당선,청명,2626,2492,5118
<class,분당선,영통,6123,6116,12239
<class,분당선,망포,8934,7999,16933
<class,분당선,매탄권선,3243,3022,6265
<class,분당선,수원시청,10293,11185,21478
<class,분당선,매교,1903,1962,3865
<class,수인선,고색,2200,2222,4422
<class,수인선,오목천,1952,1613,3565
<class,수인선,어천,623,589,1212
<class,수인선,야목,175,178,353
<class,수인선,사리,3022,2736,5758
<class,수인선,달월,59,65,124
<class,수인선,월곶,1966,1903,3869
<class,수인선,소래포구,5490,5603,11093
<class,수인선,인천논현,4247,4344,8591
<class,수인선,호구포,2456,2308,4764
<class,수인선,남동인더스파크,1037,947,1984
<class,수인선,원인재,3579,3595,7174
<class,수인선,연수,3590,3645,7235
<class,수인선,송도,1804,1811,3615
<class,수인선,인하대,3975,3681,7656
<class,수인선,숭의,2698,2397,5095
<class,수인선,신포,1372,1429,2801
<class,수인선,인천,1135,2027,3162
<class,안산선,산본,11543,12317,23860
<class,안산선,대야미,3781,3359,7140
<class,안산선,반월,3342,3130,6472
<class,안산선,상록수,11852,11877,23729
<class,안산선,한대앞,6792,6727,13519
<class,우이신설선,북한산보국문,4410,3898,8308
<class,우이신설선,솔샘,3660,3173,6833
<class,우이신설선,삼양사거리,1736,1697,3433
<class,우이신설선,삼양,1466,1523,2989
<class,우이신설선,화계,2290,2145,4435
<class,우이신설선,가오리,2880,2706,5586
<class,경인선,중동,6375,5973,12348
<class,우이신설선,정릉,3456,2896,6352
<class,1호선,서울역,29396,29838,59234
<class,1호선,동묘앞,9715,10332,20047
<class,1호선,시청,9706,9835,19541
<class,1호선,종각,17840,16629,34469
<class,1호선,종로3가,21646,20297,41943
<class,1호선,종로5가,17741,18121,35862
<class,1호선,동대문,10311,9827,20138
<class,1호선,신설동,8650,7969,16619
<class,1호선,제기동,14507,14832,29339
<class,1호선,청량리,17375,17343,34718
<class,2호선,시청,8165,7484,15649
<class,2호선,을지로입구,19531,19625,39156
<class,2호선,을지로3가,10977,11370,22347
<class,2호선,을지로4가,6874,7107,13981
<class,2호선,동대문역사문화공원,9779,10461,20240
<class,2호선,신당,10356,10864,21220
<class,2호선,상왕십리,9539,8954,18493
<class,2호선,왕십리,12969,10826,23795
<class,2호선,한양대,3221,3143,6364
<class,2호선,뚝섬,13780,14514,28294
<class,2호선,성수,17190,19695,36885
<class,경강선,삼동,933,937,1870
<class,2호선,선릉,11828,10233,22061
<class,2호선,삼성,20055,19317,39372
<class,2호선,종합운동장,6132,6319,12451
<class,2호선,잠실새내,10612,11195,21807
<class,2호선,잠실,45419,42382,87801
<class,2호선,잠실나루,4845,5016,9861
<class,2호선,강변,22030,20096,42126
<class,2호선,구의,10834,10976,21810
<class,2호선,건대입구,25104,26025,51129
<class,2호선,성수,12455,14132,26587
<class,2호선,뚝섬,10312,10998,21310
<class,2호선,한양대,2116,2301,4417
<class,2호선,왕십리,8811,7761,16572
<class,2호선,상왕십리,6588,6733,13321
<class,2호선,신당,7811,8568,16379
<class,2호선,동대문역사문화공원,6926,8411,15337
<class,2호선,을지로4가,3314,3147,6461
<class,2호선,을지로3가,7886,7323,15209
<class,2호선,을지로입구,15221,13821,29042
<class,2호선,시청,5729,4509,10238
<class,1호선,청량리,12648,12715,25363
<class,1호선,제기동,9214,9710,18924
<class,1호선,신설동,7006,7077,14083
<class,1호선,동대문,9267,9797,19064
<class,1호선,종로5가,9058,9022,18080
<class,1호선,종로3가,13290,12006,25296
<class,1호선,종각,12572,10981,23553
<class,1호선,시청,6845,6498,13343
<class,1호선,동묘앞,12238,11938,24176
<class,1호선,서울역,26146,22815,48961
<class,2호선,도림천,498,533,1031
<class,2호선,역삼,10560,11517,22077
<class,2호선,강남,35402,33909,69311
<class,2호선,교대,10022,11174,21196
<class,2호선,서초,10387,9609,19996
<class,2호선,방배,6302,7107,13409
<class,2호선,사당,19582,21961,41543
<class,2호선,낙성대,15045,15543,30588
<class,2호선,서울대입구,26451,27528,53979
<class,2호선,봉천,11843,11464,23307
<class,2호선,신림,35086,34885,69971
<class,2호선,신대방,14758,14422,29180
<class,2호선,구로디지털단지,22161,22028,44189
<class,2호선,대림,14343,14624,28967
<class,2호선,신도림,27041,27426,54467
<class,2호선,문래,7167,7697,14864
<class,2호선,영등포구청,7252,7541,14793
<class,2호선,당산,8387,9357,17744
<class,2호선,합정,19581,20567,40148
<class,2호선,홍대입구,45607,45149,90756
<class,2호선,신촌,21594,20791,42385
<class,2호선,이대,6688,7139,13827
<class,2호선,아현,4939,5147,10086
<class,2호선,충정로,3389,3642,7031
<class,2호선,용답,1496,1609,3105
<class,2호선,신답,659,783,1442
<class,2호선,신설동,2788,2935,5723
<class,2호선,양천구청,3128,3261,6389
<class,2호선,신정네거리,4867,5086,9953
<class,2호선,용두,1101,1054,2155
<class,3호선,지축,1875,1810,3685
<class,3호선,구파발,11390,11761,23151
<class,3호선,연신내,21244,20080,41324
<class,3호선,불광,9489,11064,20553
<class,3호선,녹번,6875,6383,13258
<class,3호선,홍제,8591,8450,17041
<class,3호선,무악재,1799,1974,3773
<class,3호선,독립문,4213,4613,8826
<class,3호선,경복궁,11062,11609,22671
<class,3호선,안국,9516,10163,19679
<class,3호선,종로3가,3763,4734,8497
<class,3호선,을지로3가,3176,3071,6247
<class,3호선,동대입구,4473,4817,9290
<class,3호선,약수,6405,6327,12732
<class,3호선,금호,4186,4066,8252
<class,3호선,옥수,5122,5380,10502
<class,3호선,압구정,13550,14031,27581
<class,3호선,신사,13014,13422,26436
<class,3호선,잠원,2165,2175,4340
<class,3호선,고속터미널,41173,36249,77422
<class,3호선,교대,4188,2498,6686
<class,3호선,남부터미널,14819,15125,29944
<class,3호선,양재,12669,14341,27010
<class,3호선,매봉,4132,4038,8170
<class,3호선,도곡,1798,1925,3723
<class,3호선,대치,5210,4858,10068
<class,3호선,학여울,2265,2558,4823
<class,3호선,대청,3883,3764,7647
<class,3호선,일원,3304,3554,6858
<class,3호선,수서,10084,9945,20029
<class,3호선,가락시장,3435,3760,7195
<class,3호선,경찰병원,2484,2587,5071
<class,3호선,오금,2561,2563,5124
<class,4호선,수유,18821,18067,36888
<class,4호선,미아,7707,7374,15081
<class,4호선,미아사거리,15389,14632,30021
<class,4호선,길음,9665,9500,19165
<class,4호선,성신여대입구,11650,11283,22933
<class,4호선,한성대입구,7358,7487,14845
<class,4호선,혜화,19680,20440,40120
<class,4호선,동대문,6350,6992,13342
<class,4호선,동대문역사문화공원,8278,7737,16015
<class,4호선,충무로,7889,8138,16027
<class,4호선,명동,10242,10282,20524
<class,우이신설선,성신여대입구,1972,2214,4186
<class,우이신설선,보문,865,933,1798
<class,우이신설선,신설동,1025,1084,2109
<class,일산선,정발산,4894,4705,9599
<class,일산선,주엽,4186,4313,8499
<class,일산선,대화,5931,5473,11404
<class,장항선,봉명,457,523,980
<class,장항선,쌍용,1043,1076,2119
<class,장항선,아산,2889,1906,4795
<class,장항선,배방,714,790,1504
<class,장항선,온양온천,2931,2873,5804
<class,장항선,신창,900,933,1833
<class,중앙선,회기,14544,14766,29310
<class,중앙선,중랑,3434,3375,6809
<class,중앙선,상봉,4150,4047,8197
<class,중앙선,망우,4493,4670,9163
<class,중앙선,양원,824,925,1749
<class,중앙선,구리,7342,7739,15081
<class,중앙선,도농,4603,4630,9233
<class,중앙선,양정,572,472,1044
<class,중앙선,덕소,3393,3403,6796
<class,중앙선,도심,1230,1108,2338
<class,중앙선,팔당,1527,1509,3036
<class,중앙선,운길산,1419,1331,2750
<class,중앙선,양수,2247,2068,4315
<class,중앙선,신원,322,198,520
<class,중앙선,국수,705,597,1302
<class,중앙선,아신,623,513,1136
<class,중앙선,오빈,265,234,499
<class,중앙선,양평,2417,2082,4499
<class,중앙선,원덕,445,321,766
<class,중앙선,용문,2655,2049,4704
<class,중앙선,지평,64,50,114
<class,일산선,삼송,9819,9738,19557
<class,일산선,원당,6096,5775,11871
<class,일산선,화정,8624,8792,17416
<class,일산선,대곡,1025,849,1874
<class,일산선,백석,5184,5230,10414
<class,일산선,마두,3345,3330,6675
<class,일산선,원흥,4953,4870,9823
<class,안산선,신길온천,1114,1038,2152
<class,안산선,안산,9503,8679,18182
<class,안산선,초지,2244,2189,4433
<class,안산선,고잔,4334,4221,8555
<class,안산선,중앙,11113,11001,22114
<class,안산선,한대앞,5057,4996,10053
<class,안산선,상록수,8785,8525,17310
<class,안산선,반월,2382,2385,4767
<class,안산선,대야미,3046,2818,5864
<class,안산선,산본,8261,8817,17078
<class,수인선,인천,1111,1751,2862
<class,수인선,신포,1101,1115,2216
<class,수인선,숭의,1902,1783,3685
<class,수인선,인하대,2943,2782,5725
<class,수인선,송도,1553,1482,3035
<class,수인선,연수,2803,2744,5547
<class,수인선,원인재,2690,2805,5495
<class,수인선,남동인더스파크,628,606,1234
<class,수인선,호구포,1804,1928,3732
<class,수인선,인천논현,2834,2994,5828
<class,수인선,소래포구,5100,5055,10155
<class,안산선,오이도,6265,6005,12270
<class,안산선,수리산,2129,2170,4299
<class,우이신설선,북한산우이,3279,3494,6773
<class,우이신설선,솔밭공원,1468,1527,2995
<class,우이신설선,4.19민주묘지,2004,1664,3668
<class,우이신설선,가오리,2348,2187,4535
<class,우이신설선,화계,2005,1847,3852
<class,우이신설선,삼양,1126,1138,2264
<class,우이신설선,삼양사거리,1480,1460,2940
<class,우이신설선,솔샘,2594,2527,5121
<class,우이신설선,북한산보국문,3559,3371,6930
<class,우이신설선,정릉,2537,2200,4737
<class,수인선,월곶,1620,1515,3135
<class,수인선,달월,60,48,108
<class,수인선,사리,2335,2018,4353
<class,수인선,야목,150,130,280
<class,수인선,어천,467,550,1017
<class,수인선,오목천,1287,1262,2549
<class,수인선,고색,1501,1552,3053
<class,분당선,매교,1308,1370,2678
<class,분당선,수원시청,7053,7030,14083
<class,분당선,매탄권선,2327,2435,4762
<class,분당선,망포,6054,6357,12411
<class,분당선,영통,4204,4319,8523
<class,분당선,청명,1876,1910,3786
<class,분당선,상갈,2721,2795,5516
<class,분당선,기흥,4852,4670,9522
<class,분당선,신갈,1874,1923,3797
<class,분당선,구성,2234,2358,4592
<class,분당선,죽전,7176,8227,15403
<class,분당선,보정,1028,1012,2040
<class,분당선,이매,2876,2972,5848
<class,분당선,오리,5099,4579,9678
<class,분당선,미금,6737,7301,14038
<class,분당선,정자,7107,7415,14522
<class,분당선,수내,6051,5952,12003
<class,분당선,서현,12743,12779,25522
<class,분당선,야탑,12346,12474,24820
<class,분당선,모란,10538,10706,21244
<class,분당선,태평,7732,7115,14847
<class,분당선,가천대,3214,3928,7142
<class,분당선,선정릉,2245,2397,4642
<class,분당선,강남구청,3024,3625,6649
<class,분당선,압구정로데오,10571,11604,22175
<class,분당선,서울숲,6455,6425,12880
<class,분당선,수원,5479,4530,10009
<class,분당선,수서,8284,7625,15909
<class,분당선,대모산입구,1509,1476,2985
<class,분당선,개포동,1958,1982,3940
<class,분당선,구룡,793,861,1654
<class,분당선,도곡,2380,2381,4761
<class,분당선,한티,7159,7153,14312
<class,분당선,선릉,2607,3852,6459
<class,과천선,범계,13970,13527,27497
<class,과천선,평촌,5750,5733,11483
<class,과천선,인덕원,10629,10620,21249
<class,과천선,정부과천청사,4103,4310,8413
<class,과천선,과천,3100,2966,6066
<class,과천선,대공원,4835,4998,9833
<class,과천선,경마공원,929,918,1847
<class,과천선,선바위,3644,3273,6917
<class,공항철도 1호선,영종,2376,2265,4641
<class,공항철도 1호선,인천공항2터미널,1614,1684,3298
<class,공항철도 1호선,인천공항1터미널,3203,3432,6635
<class,공항철도 1호선,공항화물청사,1071,1129,2200
<class,공항철도 1호선,운서,4878,5314,10192
<class,공항철도 1호선,청라국제도시,3124,3001,6125
<class,공항철도 1호선,검암,3342,3525,6867
<class,공항철도 1호선,계양,4791,4654,9445
<class,공항철도 1호선,김포공항,11525,6001,17526
<class,공항철도 1호선,마곡나루,2135,2309,4444
<class,공항철도 1호선,디지털미디어시티,3469,3519,6988
<class,공항철도 1호선,홍대입구,9238,8906,18144
<class,공항철도 1호선,공덕,1068,1434,2502
<class,공항철도 1호선,서울역,7202,6095,13297
<class,경춘선,춘천,1773,1341,3114
<class,경춘선,남춘천,2739,2794,5533
<class,경춘선,김유정,545,526,1071
<class,경춘선,강촌,906,708,1614
<class,경춘선,백양리,181,137,318
<class,경춘선,굴봉산,298,254,552
<class,경춘선,가평,2555,2026,4581
<class,경춘선,상천,489,384,873
<class,경춘선,청평,1973,1604,3577
<class,경춘선,대성리,738,557,1295
<class,경춘선,마석,2684,2662,5346
<class,경춘선,천마산,1089,1100,2189
<class,경춘선,평내호평,3470,3438,6908
<class,경춘선,금곡,881,868,1749
<class,경춘선,사릉,1708,1715,3423
<class,경춘선,퇴계원,2071,1962,4033
<class,경춘선,별내,1805,1762,3567
<class,경춘선,갈매,1412,1301,2713
<class,경춘선,신내,847,850,1697
<class,경인선,도화,2290,2096,4386
<class,경인선,중동,4705,4217,8922
<class,경인선,온수,3668,3411,7079
<class,경인선,도원,1610,1623,3233
<class,경인선,간석,3130,2920,6050
<class,경인선,부개,4554,4213,8767
<class,경인선,소사,5309,5099,10408
<class,경인선,구일,4342,4188,8530
<class,경인선,인천,4499,3486,7985
<class,경인선,동인천,9151,8771,17922
<class,경인선,제물포,5439,5317,10756
<class,경인선,주안,11361,10013,21374
<class,경인선,동암,9344,9266,18610
<class,경인선,백운,3805,3826,7631
<class,경인선,부평,22165,22271,44436
<class,경인선,송내,12960,12888,25848
<class,경인선,부천,20440,20160,40600
<class,경인선,역곡,13674,13672,27346
<class,경인선,오류동,6825,6549,13374
<class,경인선,개봉,11063,11287,22350
<class,경의선,임진강,113,111,224
<class,경의선,문산,3563,3540,7103
<class,경의선,파주,664,582,1246
<class,경의선,월롱,796,1457,2253
<class,경의선,금촌,3875,4155,8030
<class,경의선,금릉,2595,2639,5234
<class,경의선,운정,3507,3412,6919
<class,경의선,야당,3977,3886,7863
<class,경의선,탄현,3873,3754,7627
<class,경의선,일산,4406,4274,8680
<class,경의선,풍산,3309,3147,6456
<class,경의선,백마,3061,3010,6071
<class,경의선,곡산,320,299,619
<class,경의선,능곡,2097,2141,4238
<class,경의선,행신,4079,3948,8027
<class,경의선,강매,1385,1341,2726
<class,경의선,화전,818,854,1672
<class,경의선,수색,932,998,1930
<class,경의선,디지털미디어시티,1263,1196,2459
<class,경의선,가좌,2797,2858,5655
<class,경의선,홍대입구,1399,1632,3031
<class,경의선,서강대,1275,1258,2533
<class,경의선,공덕,1570,1317,2887
<class,경의선,효창공원앞,1173,1391,2564
<class,경의선,신촌,253,261,514
<class,경의선,서울역,1026,933,1959
<class,경원선,소요산,4787,4232,9019
<class,경원선,동두천,1380,1729,3109
<class,경원선,보산,1224,1363,2587
<class,경원선,동두천중앙,2051,1966,4017
<class,경원선,지행,4127,4154,8281
<class,경원선,덕정,3243,3305,6548
<class,경원선,덕계,1617,1533,3150
<class,경원선,양주,4761,4769,9530
<class,경원선,녹양,2697,2631,5328
<class,경원선,가능,3957,3827,7784
<class,경원선,의정부,13234,13176,26410
<class,경원선,회룡,7179,7061,14240
<class,경원선,망월사,4299,4417,8716
<class,경원선,도봉산,9715,6966,16681
<class,경원선,도봉,3443,3231,6674
<class,경원선,방학,5608,5525,11133
<class,경원선,녹천,2788,2501,5289
<class,경원선,월계,3575,3236,6811
<class,경원선,광운대,4197,4271,8468
<class,경원선,석계,4623,5026,9649
<class,경원선,신이문,4571,4295,8866
<class,경원선,외대앞,4707,4689,9396
<class,경원선,청량리,13691,12728,26419
<class,경원선,왕십리,8189,9152,17341
<class,경원선,응봉,1021,1009,2030
<class,경원선,옥수,51,24,75
<class,경원선,한남,1903,1858,3761
<class,경원선,서빙고,1309,1339,2648
<class,경원선,이촌,2239,1747,3986
<class,경부선,광명,2402,1610,4012
<class,경부선,서동탄,753,810,1563
<class,경부선,당정,2808,2905,5713
<class,경부선,천안,6271,5655,11926
<class,경부선,두정,4427,4534,8961
<class,경부선,직산,522,536,1058
<class,경부선,성환,2181,2545,4726
<class,경부선,평택,10751,11437,22188
<class,경부선,평택지제,2081,1913,3994
<class,경부선,서정리,3918,5329,9247
<class,경부선,송탄,3273,3685,6958
<class,경부선,진위,728,774,1502
<class,경부선,오산,7311,7656,14967
<class,경부선,오산대,2223,2206,4429
<class,경부선,세마,1617,1519,3136
<class,경부선,병점,8599,9687,18286
<class,경부선,세류,2063,2034,4097
<class,경부선,독산,5652,5878,11530
<class,경부선,수원,32148,31157,63305
<class,경부선,화서,3753,3779,7532
<class,경부선,성균관대,7470,7830,15300
<class,경부선,의왕,4228,4273,8501
<class,경부선,군포,2860,2811,5671
<class,경부선,금정,13137,13565,26702
<class,경부선,명학,3231,3270,6501
<class,경부선,안양,13033,12684,25717
<class,경부선,관악,5032,4446,9478
<class,경부선,석수,5248,5288,10536
<class,경부선,금천구청,6040,5860,11900
<class,경부선,가산디지털단지,4387,6143,10530
<class,경부선,구로,9502,9767,19269
<class,경부선,신길,4649,4118,8767
<class,경부선,신도림,2152,2365,4517
<class,경부선,영등포,31177,29577,60754
<class,경부선,대방,5462,5889,11351
<class,경부선,노량진,5777,5446,11223
<class,경부선,용산,30669,27090,57759
<class,경부선,남영,4290,4734,9024
<class,경부선,서울역,7092,1489,8581
<class,경강선,여주,2070,1944,4014
<class,경강선,세종대왕릉,260,236,496
<class,경강선,부발,1213,1829,3042
<class,경강선,이천,1887,2047,3934
<class,경강선,신둔도예촌,824,775,1599
<class,경강선,곤지암,1484,1675,3159
<class,경강선,초월,1460,1429,2889
<class,안산선,정왕,5020,5442,10462
<class,4호선,회현,8091,8357,16448
<class,4호선,서울역,3751,8847,12598
<class,4호선,숙대입구,6752,6469,13221
<class,4호선,삼각지,2219,2854,5073
<class,4호선,신용산,7274,7506,14780
<class,4호선,이촌,4936,5543,10479
<class,4호선,동작,1443,1463,2906
<class,4호선,총신대입구,9557,10451,20008
<class,4호선,사당,14001,12866,26867
<class,4호선,남태령,590,554,1144
<class,4호선,당고개,7817,7511,15328
<class,4호선,상계,9924,9313,19237
<class,4호선,노원,11423,12196,23619
<class,4호선,창동,13582,14250,27832
<class,4호선,쌍문,15180,14016,29196
<class,5호선,방화,3605,3451,7056
<class,5호선,개화산,2550,2724,5274
<class,5호선,김포공항,6872,6357,13229
<class,5호선,송정,3529,3528,7057
<class,5호선,마곡,3284,3329,6613
<class,5호선,발산,8204,8653,16857
<class,5호선,우장산,6332,6579,12911
<class,5호선,화곡,13260,12765,26025
<class,5호선,까치산,14836,14465,29301
<class,5호선,신정,6073,5546,11619
<class,5호선,목동,7124,7559,14683
<class,5호선,오목교,10810,10976,21786
<class,5호선,양평,2458,2585,5043
<class,5호선,영등포구청,1280,1223,2503
<class,5호선,영등포시장,4153,4416,8569
<class,5호선,신길,1720,1948,3668
<class,5호선,여의도,8082,8174,16256
<class,5호선,여의나루,9370,10804,20174
<class,5호선,마포,4463,4531,8994
<class,5호선,공덕,4006,4193,8199
<class,5호선,애오개,2571,2655,5226
<class,5호선,충정로,1462,1488,2950
<class,5호선,서대문,5619,5675,11294
<class,5호선,광화문,10320,10227,20547
<class,5호선,종로3가,8666,7546,16212
<class,5호선,을지로4가,1497,1635,3132
<class,5호선,동대문역사문화공원,761,857,1618
<class,5호선,청구,1745,1732,3477
<class,5호선,신금호,2790,2955,5745
<class,5호선,행당,3854,3587,7441
<class,5호선,왕십리,2295,2564,4859
<class,5호선,마장,2767,2716,5483
<class,5호선,답십리,7035,6570,13605
<class,5호선,장한평,7084,7116,14200
<class,5호선,군자,5632,6368,12000
<class,5호선,아차산,9912,9677,19589
<class,5호선,광나루,7339,7228,14567
<class,5호선,천호,11804,10881,22685
<class,5호선,강동,8346,8159,16505
<class,5호선,길동,4001,4115,8116
<class,5호선,굽은다리,5087,4741,9828
<class,5호선,명일,4562,4588,9150
<class,5호선,고덕,3981,4013,7994
<class,5호선,상일동,6646,6481,13127
<class,5호선,둔촌동,4350,4548,8898
<class,5호선,올림픽공원,2737,2743,5480
<class,5호선,방이,3989,3788,7777
<class,5호선,오금,1567,1484,3051
<class,5호선,개롱,3035,3333,6368
<class,5호선,거여,3804,3702,7506
<class,5호선,마천,3388,3621,7009
<class,5호선,강일,1646,1697,3343
<class,5호선,미사,7744,7812,15556
<class,5호선,하남풍산,2033,2060,4093
<class,5호선,하남시청,3183,3105,6288
<class,5호선,하남검단산,4385,4441,8826
<class,6호선,응암,8653,8840,17493
<class,6호선,역촌,1996,2366,4362
<class,6호선,불광,3100,2679,5779
<class,6호선,독바위,1639,2026,3665
<class,6호선,연신내,1,0,1
<class,6호선,구산,3653,2812,6465
<class,6호선,새절,6116,6172,12288
<class,6호선,증산,5262,5515,10777
<class,6호선,디지털미디어시티,4812,5147,9959
<class,6호선,월드컵경기장,3344,3347,6691
<class,6호선,마포구청,6815,6404,13219
<class,6호선,망원,9331,10195,19526
<class,6호선,합정,9103,8019,17122
<class,6호선,상수,5853,6310,12163
<class,6호선,광흥창,3942,3869,7811
<class,6호선,대흥,3591,3734,7325
<class,6호선,공덕,6213,5883,12096
<class,6호선,효창공원앞,3185,2843,6028
<class,6호선,삼각지,3906,3099,7005
<class,6호선,녹사평,3806,3781,7587
<class,6호선,이태원,9014,8735,17749
<class,6호선,한강진,5958,7000,12958
<class,6호선,버티고개,928,1057,1985
<class,6호선,약수,1706,1665,3371
<class,6호선,청구,1727,1612,3339
<class,6호선,신당,4380,4863,9243
<class,6호선,동묘앞,6100,5949,12049
<class,6호선,창신,1627,1568,3195
<class,6호선,보문,3956,3684,7640
<class,6호선,안암,4552,4783,9335
<class,6호선,고려대,3848,3743,7591
<class,6호선,월곡,5073,5048,10121
<class,6호선,상월곡,3069,2835,5904
<class,6호선,돌곶이,4740,4566,9306
<class,6호선,석계,6231,6390,12621
<class,6호선,태릉입구,2882,3193,6075
<class,6호선,화랑대,4812,4338,9150
<class,6호선,봉화산,3794,3681,7475
<class,7호선,장암,1789,1338,3127
<class,7호선,도봉산,5523,8460,13983
<class,7호선,수락산,8718,8653,17371
<class,7호선,마들,5730,5396,11126
<class,7호선,노원,11070,11114,22184
<class,7호선,중계,6466,5959,12425
<class,7호선,하계,8512,8270,16782
<class,7호선,공릉,6263,6300,12563
<class,7호선,태릉입구,4656,4392,9048
<class,7호선,먹골,5269,5288,10557
<class,7호선,중화,5662,5392,11054
<class,7호선,상봉,9004,8447,17451
<class,7호선,면목,7656,7671,15327
<class,7호선,사가정,9142,8916,18058
<class,7호선,용마산,3412,3666,7078
<class,7호선,중곡,4878,4756,9634
<class,7호선,군자,7361,5895,13256
<class,7호선,어린이대공원,6788,7058,13846
<class,7호선,건대입구,7512,7480,14992
<class,7호선,뚝섬유원지,7595,6926,14521
<class,7호선,청담,6115,6575,12690
<class,7호선,강남구청,5276,5862,11138
<class,7호선,학동,5476,6039,11515
<class,7호선,논현,6025,6465,12490
<class,7호선,반포,2744,2725,5469
<class,7호선,고속터미널,12496,7632,20128
<class,7호선,내방,4970,5200,10170
<class,7호선,이수,7814,7821,15635
<class,7호선,남성,5076,5171,10247
<class,7호선,숭실대입구,5345,5843,11188
<class,7호선,상도,5106,5197,10303
<class,7호선,장승배기,4636,4657,9293
<class,7호선,신대방삼거리,7491,7464,14955
<class,7호선,보라매,4163,4198,8361
<class,7호선,신풍,6072,5820,11892
<class,7호선,대림,7143,6762,13905
<class,7호선,남구로,6661,6556,13217
<class,7호선,가산디지털단지,10606,9775,20381
<class,7호선,철산,10144,10221,20365
<class,7호선,광명사거리,11962,11957,23919
<class,7호선,천왕,4807,4603,9410
<class,7호선,온수,3775,3780,7555
<class,7호선,까치울,4066,4138,8204
<class,7호선,부천종합운동장,2349,2117,4466
<class,7호선,춘의,3222,3169,6391
<class,7호선,신중동,6628,6494,13122
<class,7호선,부천시청,6437,6401,12838
<class,7호선,상동,6682,6502,13184
<class,7호선,삼산체육관,2507,2378,4885
<class,7호선,굴포천,4427,4365,8792
<class,7호선,부평구청,3519,3114,6633
<class,8호선,암사,8702,8275,16977
<class,8호선,천호,8020,9418,17438
<class,8호선,강동구청,4183,4405,8588
<class,8호선,몽촌토성,3140,3189,6329
<class,8호선,잠실,9728,10657,20385
<class,8호선,석촌,3955,4891,8846
<class,8호선,송파,3184,3485,6669
<class,8호선,가락시장,2834,3569,6403
<class,8호선,문정,4753,5087,9840
<class,8호선,장지,8784,8711,17495
<class,8호선,복정,4972,4733,9705
<class,8호선,산성,3537,3543,7080
<class,8호선,남한산성입구,6238,6022,12260
<class,8호선,단대오거리,5136,5117,10253
<class,8호선,신흥,2596,2752,5348
<class,8호선,수진,2689,2503,5192
<class,8호선,모란,2427,2088,4515
<class,9호선,개화,1064,979,2043
<class,9호선,김포공항,7735,12157,19892
<class,9호선,공항시장,1648,1838,3486
<class,9호선,신방화,3209,3265,6474
<class,9호선,마곡나루,5243,5308,10551
<class,9호선,양천향교,3902,4137,8039
<class,9호선,가양,9671,9578,19249
<class,9호선,증미,2457,2570,5027
<class,9호선,등촌,4762,4946,9708
<class,9호선,염창,7973,7925,15898
<class,9호선,신목동,1698,1595,3293
<class,9호선,선유도,2790,2814,5604
<class,9호선,당산,8297,8211,16508
<class,9호선,국회의사당,4052,3793,7845
<class,9호선,여의도,9038,7865,16903
<class,9호선,샛강,1604,1694,3298
<class,9호선,노량진,14328,15192,29520
<class,9호선,노들,2530,2262,4792
<class,9호선,흑석,3763,3944,7707
<class,9호선,동작,1255,995,2250
<class,9호선,구반포,1120,1146,2266
<class,9호선,신반포,1570,1756,3326
<class,9호선,고속터미널,10102,13476,23578
<class,9호선,사평,1367,1420,2787
<class,9호선,신논현,15257,14360,29617
<class,9호선2~3단계,언주,3336,3348,6684
<class,9호선2~3단계,선정릉,3053,3391,6444
<class,9호선2~3단계,삼성중앙,1869,1916,3785
<class,9호선2~3단계,봉은사,7493,7543,15036
<class,9호선2~3단계,종합운동장,2066,2061,4127
<class,9호선2~3단계,삼전,3363,3399,6762
<class,9호선2~3단계,석촌고분,2785,2842,5627
<class,9호선2~3단계,석촌,4404,3878,8282
<class,9호선2~3단계,송파나루,2980,3317,6297
<class,9호선2~3단계,한성백제,1525,1426,2951
<class,9호선2~3단계,올림픽공원,6384,5949,12333
<class,9호선2~3단계,둔촌오륜,480,523,1003
<class,9호선2~3단계,중앙보훈병원,3274,3146,6420
<class,경강선,판교,2349,2137,4486
<class,경강선,이매,618,476,1094
<class,경강선,경기광주,3556,3547,7103
<class,경의선,임진강,63,46,109
<class,경인선,개봉,14543,14812,29355
<class,경인선,오류동,8107,7739,15846
<class,경인선,역곡,17806,17509,35315
<class,경인선,부천,25558,26253,51811
<class,경인선,송내,16145,16401,32546
<class,경인선,부평,26955,28777,55732
<class,경인선,백운,4857,4907,9764
<class,경인선,동암,10985,11307,22292
<class,경인선,주안,13698,11977,25675
<class,경인선,제물포,6339,6240,12579
<class,경인선,동인천,9908,9788,19696
<class,경인선,인천,3101,2530,5631
<class,경인선,구일,3819,3626,7445
<class,경의선,곡산,400,422,822
<class,경의선,백마,3924,3767,7691
<class,경의선,풍산,3800,3748,7548
<class,안산선,한대앞,6153,6109,12262
<class,안산선,상록수,10557,10792,21349
<class,안산선,반월,3034,2809,5843
<class,안산선,대야미,3485,3134,6619
<class,안산선,산본,10770,11516,22286
<class,수인선,인천,949,1478,2427
<class,수인선,신포,1058,1119,2177
<class,수인선,숭의,2370,2163,4533
<class,수인선,인하대,3594,3361,6955
<class,수인선,송도,1686,1636,3322
<class,수인선,연수,3171,3210,6381
<class,수인선,원인재,3154,3358,6512
<class,수인선,남동인더스파크,900,843,1743
<class,수인선,호구포,2279,2169,4448
<class,수인선,인천논현,3778,3956,7734
<class,수인선,소래포구,4231,4262,8493
<class,수인선,월곶,1798,1772,3570
<class,수인선,달월,51,50,101
<class,수인선,사리,2813,2496,5309
<class,수인선,야목,167,148,315
<class,수인선,어천,596,533,1129
<class,수인선,오목천,1790,1494,3284
<class,수인선,고색,2007,1840,3847
<class,분당선,매교,1819,1829,3648
<class,분당선,수원시청,10123,10940,21063
<class,분당선,매탄권선,2993,2844,5837
<class,분당선,망포,8395,7740,16135
<class,분당선,영통,5601,5755,11356
<class,분당선,청명,2520,2462,4982
<class,분당선,상갈,3479,3478,6957
<class,분당선,기흥,6204,6008,12212
<class,분당선,신갈,2638,2590,5228
<class,분당선,구성,2890,3080,5970
<class,분당선,죽전,9249,10568,19817
<class,분당선,보정,1491,1366,2857
<class,분당선,이매,3722,3712,7434
<class,분당선,오리,6956,5726,12682
<class,분당선,미금,10008,10275,20283
<class,분당선,정자,9808,10112,19920
<class,분당선,수내,7854,7678,15532
<class,분당선,서현,16858,17165,34023
<class,분당선,야탑,15657,16365,32022
<class,분당선,모란,14592,14573,29165
<class,분당선,태평,9857,9446,19303
<class,분당선,가천대,4266,4859,9125
<class,분당선,선정릉,3689,3691,7380
<class,분당선,강남구청,5026,6067,11093
<class,분당선,압구정로데오,17327,18557,35884
<class,분당선,서울숲,6035,6134,12169
<class,분당선,수원,6403,5347,11750
<class,분당선,수서,9399,9968,19367
<class,분당선,대모산입구,2097,1885,3982
<class,분당선,개포동,2459,2395,4854
<class,분당선,구룡,1463,1335,2798
<class,분당선,도곡,4461,4065,8526
<class,분당선,한티,9999,9833,19832
<class,분당선,선릉,4943,7773,12716
<class,과천선,범계,18017,17589,35606
<class,과천선,평촌,8289,8259,16548
<class,과천선,인덕원,13637,12490,26127
<class,과천선,정부과천청사,5147,5188,10335
<class,과천선,과천,3904,3764,7668
<class,과천선,대공원,3430,3563,6993
<class,과천선,경마공원,1020,1010,2030
<class,과천선,선바위,4741,4027,8768
<class,공항철도 1호선,영종,2497,2552,5049
<class,공항철도 1호선,인천공항2터미널,1579,1595,3174
<class,공항철도 1호선,인천공항1터미널,2748,2946,5694
<class,공항철도 1호선,공항화물청사,1204,1266,2470
<class,공항철도 1호선,운서,4908,4946,9854
<class,공항철도 1호선,청라국제도시,3471,3434,6905
<class,공항철도 1호선,검암,3967,3867,7834
<class,공항철도 1호선,계양,5720,5224,10944
<class,공항철도 1호선,김포공항,10725,5686,16411
<class,공항철도 1호선,마곡나루,2413,2620,5033
<class,공항철도 1호선,디지털미디어시티,4727,4514,9241
<class,경춘선,가평,2052,2621,4673
<class,경춘선,상천,311,281,592
<class,경춘선,청평,1614,1752,3366
<class,경춘선,대성리,570,594,1164
<class,경춘선,마석,3103,3086,6189
<class,경춘선,천마산,1257,1226,2483
<class,경춘선,평내호평,3999,3944,7943
<class,경춘선,금곡,1038,1023,2061
<class,경춘선,사릉,2090,2097,4187
<class,경춘선,퇴계원,2450,2304,4754
<class,경춘선,별내,2022,2018,4040
<class,경춘선,갈매,1754,1507,3261
<class,경춘선,신내,1003,966,1969
<class,경인선,도화,2835,2661,5496
<class,경인선,중동,5756,5623,11379
<class,경인선,온수,4432,4190,8622
<class,경인선,도원,1814,1893,3707
<class,경인선,간석,3905,3912,7817
<class,경인선,부개,5661,5513,11174
<class,경인선,소사,6681,6838,13519
<class,경원선,광운대,5140,4988,10128
<class,경원선,석계,6009,6350,12359
<class,경원선,신이문,5553,5239,10792
<class,경원선,외대앞,5327,5186,10513
<class,경원선,청량리,14466,16028,30494
<class,경원선,왕십리,10935,12689,23624
<class,경원선,응봉,1155,1017,2172
<class,경원선,옥수,46,39,85
<class,경원선,한남,2511,2445,4956
<class,경원선,서빙고,1157,1128,2285
<class,경원선,이촌,2748,2101,4849
<class,경부선,광명,2278,2092,4370
<class,경부선,서동탄,918,978,1896
<class,경부선,당정,3604,3462,7066
<class,경부선,천안,5489,6066,11555
<class,경부선,두정,5116,5439,10555
<class,경부선,직산,558,549,1107
<class,경부선,성환,2431,2279,4710
<class,경부선,평택,11423,11335,22758
<class,경부선,평택지제,2482,2333,4815
<class,경부선,서정리,5083,4471,9554
<class,경부선,송탄,4117,3666,7783
<class,경부선,진위,944,899,1843
<class,경부선,오산,8468,8074,16542
<class,경부선,오산대,2450,2225,4675
<class,경부선,세마,1914,1771,3685
<class,경부선,병점,10646,10512,21158
<class,경부선,세류,2257,2258,4515
<class,경부선,독산,7707,7743,15450
<class,경부선,수원,33601,35621,69222
<class,경부선,화서,4601,4509,9110
<class,경부선,성균관대,9054,9090,18144
<class,경부선,의왕,5117,5049,10166
<class,경부선,군포,3892,3567,7459
<class,경부선,금정,16446,16474,32920
<class,경부선,명학,4399,4224,8623
<class,경부선,안양,15997,16094,32091
<class,경부선,관악,5227,4988,10215
<class,경부선,석수,6243,5889,12132
<class,경부선,금천구청,7461,7541,15002
<class,경부선,가산디지털단지,5386,7407,12793
<class,경부선,구로,12244,12516,24760
<class,경부선,신길,6363,4899,11262
<class,경부선,신도림,2499,2757,5256
<class,경부선,영등포,38445,37530,75975
<class,경부선,대방,7570,7559,15129
<class,경부선,노량진,7323,6628,13951
<class,경부선,용산,31056,31827,62883
<class,경부선,남영,5160,5333,10493
<class,경부선,서울역,5229,1477,6706
<class,경강선,여주,1862,2089,3951
<class,경강선,세종대왕릉,256,280,536
<class,경강선,부발,1612,1404,3016
<class,경강선,이천,2231,2263,4494
<class,경강선,신둔도예촌,910,944,1854
<class,경강선,곤지암,1632,1723,3355
<class,경강선,초월,1909,1778,3687
<class,경강선,경기광주,4473,4342,8815
<class,경강선,삼동,1338,1219,2557
<class,경강선,이매,752,537,1289
<class,9호선2~3단계,중앙보훈병원,4075,3786,7861
<class,9호선2~3단계,둔촌오륜,557,602,1159
<class,9호선2~3단계,올림픽공원,8847,8652,17499
<class,9호선2~3단계,한성백제,1681,1543,3224
<class,9호선2~3단계,송파나루,3968,4284,8252
<class,9호선2~3단계,석촌,5643,4748,10391
<class,9호선2~3단계,석촌고분,3814,3849,7663
<class,9호선2~3단계,삼전,4620,4388,9008
<class,9호선2~3단계,종합운동장,3279,2813,6092
<class,9호선2~3단계,봉은사,12877,13542,26419
<class,9호선2~3단계,삼성중앙,2981,3064,6045
<class,9호선2~3단계,선정릉,4724,5437,10161
<class,9호선2~3단계,언주,5962,5937,11899
<class,9호선,신논현,23908,23609,47517
<class,9호선,사평,2138,2024,4162
<class,9호선,고속터미널,10833,15908,26741
<class,9호선,신반포,2083,2170,4253
<class,9호선,구반포,1895,2039,3934
<class,9호선,동작,1294,1089,2383
<class,9호선,흑석,5044,5113,10157
<class,9호선,노들,2821,2554,5375
<class,9호선,노량진,19143,18674,37817
<class,9호선,샛강,2842,2685,5527
<class,9호선,여의도,12483,10585,23068
<class,9호선,국회의사당,4583,4836,9419
<class,9호선,당산,12378,11136,23514
<class,9호선,선유도,3599,3532,7131
<class,9호선,신목동,2171,1872,4043
<class,9호선,염창,10377,9654,20031
<class,9호선,등촌,6674,6870,13544
<class,9호선,증미,3877,3928,7805
<class,9호선,가양,12477,12048,24525
<class,9호선,양천향교,5273,5191,10464
<class,9호선,마곡나루,7270,6666,13936
<class,9호선,신방화,4261,4224,8485
<class,9호선,공항시장,2077,2238,4315
<class,9호선,김포공항,8208,11990,20198
<class,9호선,개화,1405,1127,2532
<class,8호선,모란,3428,2902,6330
<class,8호선,수진,3818,3535,7353
<class,8호선,신흥,3443,3634,7077
<class,8호선,단대오거리,6850,6507,13357
<class,8호선,남한산성입구,8299,7457,15756
<class,8호선,산성,4064,4177,8241
<class,8호선,복정,6563,5496,12059
<class,8호선,장지,11242,10192,21434
<class,8호선,문정,7793,7979,15772
<class,8호선,가락시장,5082,5078,10160
<class,8호선,송파,4567,4841,9408
<class,8호선,석촌,5321,6450,11771
<class,8호선,잠실,12519,13681,26200
<class,8호선,몽촌토성,3706,3691,7397
<class,8호선,강동구청,5578,5774,11352
<class,8호선,천호,10686,12537,23223
<class,8호선,암사,11198,10740,21938
<class,7호선,부평구청,4488,4000,8488
<class,7호선,굴포천,6294,6564,12858
<class,7호선,삼산체육관,3158,3091,6249
<class,7호선,상동,9543,9555,19098
<class,7호선,부천시청,9219,8950,18169
<class,7호선,신중동,8963,8907,17870
<class,7호선,춘의,4602,4511,9113
<class,7호선,부천종합운동장,2914,2563,5477
<class,7호선,까치울,4880,4919,9799
<class,7호선,온수,5059,5012,10071
<class,7호선,천왕,6040,5723,11763
<class,7호선,광명사거리,15437,15468,30905
<class,7호선,철산,13649,14114,27763
<class,7호선,가산디지털단지,13406,12116,25522
<class,7호선,남구로,8015,8730,16745
<class,7호선,대림,6477,6936,13413
<class,7호선,신풍,7460,7413,14873
<class,7호선,보라매,5942,5136,11078
<class,7호선,신대방삼거리,10339,9679,20018
<class,7호선,장승배기,6172,5994,12166
<class,7호선,상도,6741,6405,13146
<class,7호선,숭실대입구,7043,7014,14057
<class,7호선,남성,7032,6714,13746
<class,7호선,이수,10858,10295,21153
<class,7호선,내방,7036,6980,14016
<class,7호선,고속터미널,13134,10206,23340
<class,7호선,반포,4020,3767,7787
<class,7호선,논현,10096,11224,21320
<class,7호선,학동,9588,10112,19700
<class,7호선,강남구청,8996,10080,19076
<class,7호선,청담,10671,11682,22353
<class,7호선,뚝섬유원지,5182,5178,10360
<class,7호선,건대입구,9694,9620,19314
<class,7호선,어린이대공원,7962,7625,15587
<class,7호선,군자,9724,7620,17344
<class,7호선,중곡,5933,5721,11654
<class,7호선,용마산,3874,3997,7871
<class,7호선,사가정,11232,10886,22118
<class,7호선,면목,10180,10059,20239
<class,7호선,상봉,11860,11165,23025
<class,7호선,중화,7088,6812,13900
<class,7호선,먹골,7118,6964,14082
<class,7호선,태릉입구,5986,5506,11492
<class,7호선,공릉,7706,7623,15329
<class,7호선,하계,10776,10406,21182
<class,7호선,중계,8319,7594,15913
<class,7호선,노원,14647,14847,29494
<class,7호선,마들,7907,7722,15629
<class,7호선,수락산,9429,9304,18733
<class,7호선,도봉산,5616,7911,13527
<class,7호선,장암,1423,1041,2464
<class,6호선,봉화산,4831,4755,9586
<class,6호선,화랑대,6076,5106,11182
<class,6호선,태릉입구,3762,3875,7637
<class,6호선,석계,8017,8098,16115
<class,6호선,돌곶이,5495,5096,10591
<class,6호선,상월곡,3722,3313,7035
<class,6호선,월곡,6743,6694,13437
<class,6호선,고려대,4680,4365,9045
<class,6호선,안암,5535,5302,10837
<class,6호선,보문,4644,4278,8922
<class,6호선,창신,2029,1727,3756
<class,6호선,동묘앞,6557,6261,12818
<class,6호선,신당,5923,4547,10470
<class,6호선,청구,2304,2238,4542
<class,6호선,약수,2404,2258,4662
<class,6호선,버티고개,1249,1344,2593
<class,6호선,한강진,6847,7852,14699
<class,6호선,이태원,9275,9872,19147
<class,6호선,녹사평,3932,4161,8093
<class,6호선,삼각지,4535,3573,8108
<class,6호선,효창공원앞,4154,3790,7944
<class,6호선,공덕,8869,8630,17499
<class,6호선,대흥,5034,5046,10080
<class,6호선,광흥창,4989,4512,9501
<class,6호선,상수,6631,7558,14189
<class,6호선,합정,10557,9500,20057
<class,6호선,망원,11428,12033,23461
<class,6호선,마포구청,8460,7790,16250
<class,6호선,월드컵경기장,3665,3738,7403
<class,6호선,디지털미디어시티,6273,6572,12845
<class,6호선,증산,6639,6656,13295
<class,6호선,새절,7862,7773,15635
<class,6호선,구산,4619,3803,8422
<class,6호선,연신내,1,0,1
<class,6호선,독바위,1870,2204,4074
<class,6호선,불광,3895,3237,7132
<class,6호선,역촌,2512,2909,5421
<class,6호선,응암,11203,11262,22465
<class,5호선,하남검단산,4066,4221,8287
<class,5호선,하남시청,4024,3918,7942
<class,5호선,하남풍산,2494,2565,5059
<class,5호선,미사,9866,9846,19712
<class,5호선,강일,2072,1958,4030
<class,5호선,마천,4137,4224,8361
<class,5호선,거여,4916,4768,9684
<class,5호선,개롱,3986,4124,8110
<class,5호선,오금,1991,1893,3884
<class,5호선,방이,4454,4505,8959
<class,5호선,올림픽공원,4512,4080,8592
<class,5호선,둔촌동,5841,5792,11633
<class,5호선,상일동,8783,8544,17327
<class,5호선,고덕,5661,5557,11218
<class,5호선,명일,5490,5411,10901
<class,5호선,굽은다리,6571,6262,12833
<class,5호선,길동,5592,5733,11325
<class,5호선,강동,11245,10823,22068
<class,5호선,천호,14934,13898,28832
<class,5호선,광나루,8547,8384,16931
<class,5호선,아차산,10588,10213,20801
<class,5호선,군자,7722,8502,16224
<class,5호선,장한평,10095,10034,20129
<class,5호선,답십리,9409,8739,18148
<class,5호선,마장,3534,3478,7012
<class,5호선,왕십리,3234,3640,6874
<class,5호선,행당,5016,4437,9453
<class,5호선,신금호,3542,3745,7287
<class,5호선,청구,2292,2246,4538
<class,5호선,동대문역사문화공원,933,1163,2096
<class,5호선,을지로4가,3587,3955,7542
<class,5호선,종로3가,9371,9355,18726
<class,5호선,광화문,13099,13885,26984
<class,5호선,서대문,6734,6467,13201
<class,5호선,충정로,2061,1912,3973
<class,5호선,애오개,3622,3554,7176
<class,5호선,공덕,7308,7366,14674
<class,5호선,마포,7573,7100,14673
<class,5호선,여의나루,5190,8390,13580
<class,5호선,여의도,14019,12739,26758
<class,5호선,신길,2563,2550,5113
<class,5호선,영등포시장,6741,6726,13467
<class,5호선,영등포구청,1951,1794,3745
<class,5호선,양평,3451,3306,6757
<class,5호선,오목교,14932,15209,30141
<class,5호선,목동,10210,10410,20620
<class,5호선,신정,8133,7302,15435
<class,5호선,까치산,18924,18455,37379
<class,5호선,화곡,17964,16659,34623
<class,5호선,우장산,8371,8611,16982
<class,5호선,발산,12137,12670,24807
<class,5호선,마곡,4705,4760,9465
<class,5호선,송정,4568,4516,9084
<class,5호선,김포공항,7285,7218,14503
<class,5호선,개화산,3337,3259,6596
<class,5호선,방화,4182,4011,8193
<class,4호선,쌍문,19013,17438,36451
<class,4호선,창동,17045,18277,35322
<class,4호선,노원,14767,15595,30362
<class,4호선,상계,12400,11756,24156
<class,4호선,당고개,9038,8613,17651
<class,4호선,남태령,1003,685,1688
<class,4호선,사당,18344,15313,33657
<class,4호선,총신대입구,13055,14072,27127
<class,4호선,동작,1443,1506,2949
<class,4호선,이촌,5935,6434,12369
<class,4호선,신용산,8521,9482,18003
<class,4호선,삼각지,2859,3640,6499
<class,4호선,숙대입구,7842,7620,15462
<class,4호선,서울역,4692,10254,14946
<class,4호선,회현,16357,16422,32779
<class,4호선,명동,10773,12428,23201
<class,4호선,충무로,11350,11604,22954
<class,4호선,동대문역사문화공원,10278,8803,19081
<class,4호선,동대문,13055,12730,25785
<class,4호선,혜화,24036,24220,48256
<class,4호선,한성대입구,9435,9194,18629
<class,4호선,성신여대입구,14686,14202,28888
<class,4호선,길음,12352,12050,24402
<class,4호선,미아사거리,19737,19277,39014
<class,4호선,미아,9775,9375,19150
<class,4호선,수유,23476,23136,46612
<class,3호선,오금,3311,3014,6325
<class,3호선,경찰병원,3699,3594,7293
<class,3호선,가락시장,5521,5239,10760
<class,3호선,수서,11900,12263,24163
<class,3호선,일원,4297,4399,8696
<class,3호선,학여울,1751,1733,3484
<class,3호선,대치,7491,6930,14421
<class,3호선,도곡,3227,3193,6420
<class,3호선,매봉,5691,5471,11162
<class,3호선,양재,19498,20584,40082
<class,3호선,남부터미널,18164,18480,36644
<class,3호선,교대,6235,3739,9974
<class,3호선,고속터미널,44159,45040,89199
<class,3호선,잠원,2988,2993,5981
<class,3호선,신사,22009,22038,44047
<class,3호선,압구정,24090,24681,48771
<class,3호선,옥수,6282,6538,12820
<class,3호선,금호,5330,4940,10270
<class,3호선,약수,8361,8035,16396
<class,3호선,동대입구,4763,5107,9870
<class,3호선,을지로3가,6030,6088,12118
<class,3호선,종로3가,4775,7246,12021
<class,3호선,안국,12556,12904,25460
<class,3호선,경복궁,13491,13114,26605
<class,3호선,독립문,4880,5267,10147
<class,3호선,무악재,2387,2431,4818
<class,3호선,홍제,11899,11430,23329
<class,3호선,녹번,9259,8310,17569
<class,3호선,불광,11765,13207,24972
<class,3호선,연신내,26811,24925,51736
<class,3호선,구파발,13396,13515,26911
<class,3호선,지축,2527,2401,4928
<class,2호선,용두,1617,1621,3238
<class,2호선,신정네거리,6572,6771,13343
<class,2호선,양천구청,4001,4161,8162
<class,2호선,도림천,776,841,1617
<class,2호선,신설동,2799,2584,5383
<class,2호선,신답,891,951,1842
<class,2호선,용답,1843,1891,3734
<class,2호선,충정로,5377,5761,11138
<class,2호선,아현,6876,6749,13625
<class,2호선,이대,8985,9687,18672
<class,2호선,신촌,27477,27650,55127
<class,2호선,홍대입구,45187,45330,90517
<class,2호선,합정,23263,24901,48164
<class,2호선,당산,11041,12051,23092
<class,2호선,영등포구청,11411,11851,23262
<class,2호선,문래,10878,11533,22411
<class,2호선,신도림,36956,36789,73745
<class,2호선,대림,16211,17306,33517
<class,2호선,구로디지털단지,30190,30140,60330
<class,2호선,신대방,17904,17745,35649
<class,2호선,신림,44788,43185,87973
<class,2호선,봉천,15326,14389,29715
<class,2호선,서울대입구,34603,32914,67517
<class,2호선,낙성대,19118,17917,37035
<class,2호선,사당,25634,28121,53755
<class,2호선,방배,8614,8954,17568
<class,2호선,서초,9028,7448,16476
<class,2호선,교대,15555,17585,33140
<class,2호선,강남,55661,54163,109824
<class,2호선,역삼,16790,17932,34722
<class,2호선,선릉,22319,19997,42316
<class,2호선,삼성,32266,31844,64110
<class,2호선,종합운동장,4706,5350,10056
<class,2호선,잠실새내,15776,16214,31990
<class,2호선,잠실,55559,52978,108537
<class,2호선,잠실나루,6579,6550,13129
<class,2호선,강변,23487,23930,47417
<class,2호선,구의,14649,14572,29221
<class,2호선,건대입구,29728,30857,60585
<class,2호선,성수,16274,17469,33743
<class,2호선,뚝섬,11250,11605,22855
<class,2호선,한양대,3732,3754,7486
<class,2호선,왕십리,12064,10221,22285
<class,2호선,상왕십리,8716,8413,17129
<class,2호선,신당,9586,10286,19872
<class,2호선,동대문역사문화공원,9090,9893,18983
<class,2호선,을지로4가,6881,6436,13317
<class,2호선,을지로3가,10914,10338,21252
<class,2호선,을지로입구,18841,18362,37203
<class,2호선,시청,7643,6711,14354
<class,1호선,청량리,16378,16707,33085
<class,1호선,제기동,13458,13922,27380
<class,1호선,신설동,8496,8155,16651
<class,1호선,동대문,10108,9211,19319
<class,1호선,종로5가,20945,17892,38837
<class,1호선,종로3가,17048,17680,34728
<class,1호선,종각,18584,18138,36722
<class,1호선,시청,8587,8957,17544
<class,1호선,동묘앞,8612,8737,17349
<class,경강선,판교,2776,2539,5315
<class,1호선,서울역,26929,27300,54229
<class,경의선,일산,5996,6016,12012
<class,경의선,탄현,4897,4723,9620
<class,경의선,야당,4769,4712,9481
<class,경의선,운정,4328,4180,8508
<class,경의선,금릉,3256,3048,6304
<class,경의선,금촌,4713,4606,9319
<class,우이신설선,성신여대입구,2467,2757,5224
<class,우이신설선,보문,1091,1153,2244
<class,우이신설선,신설동,1169,1195,2364
<class,일산선,원흥,6376,6048,12424
<class,일산선,삼송,12059,11884,23943
<class,일산선,원당,7319,7113,14432
<class,일산선,화정,11432,11807,23239
<class,일산선,대곡,1321,1102,2423
<class,일산선,백석,6773,6985,13758
<class,일산선,마두,4551,4579,9130
<class,일산선,정발산,5657,5586,11243
<class,일산선,주엽,5881,5763,11644
<class,일산선,대화,7899,7375,15274
<class,장항선,봉명,660,597,1257
<class,장항선,쌍용,1292,1145,2437
<class,장항선,아산,2300,2283,4583
<class,장항선,배방,802,777,1579
<class,장항선,온양온천,2890,3016,5906
<class,장항선,신창,859,852,1711
<class,중앙선,회기,17045,16360,33405
<class,중앙선,중랑,4090,4037,8127
<class,중앙선,상봉,4665,4556,9221
<class,중앙선,망우,5635,5569,11204
<class,중앙선,양원,1013,1039,2052
<class,중앙선,구리,9566,9714,19280
<class,중앙선,도농,6000,5854,11854
<class,중앙선,양정,616,560,1176
<class,중앙선,오빈,259,266,525
<class,중앙선,양평,3284,3442,6726
<class,중앙선,원덕,384,424,808
<class,공항철도 1호선,홍대입구,8291,8404,16695
<class,공항철도 1호선,공덕,1275,1924,3199
<class,공항철도 1호선,서울역,6113,6343,12456
<class,경춘선,춘천,1472,1323,2795
<class,경춘선,남춘천,2123,2214,4337
<class,경춘선,김유정,404,494,898
<class,경춘선,강촌,529,630,1159
<class,경춘선,백양리,106,104,210
<class,경춘선,굴봉산,169,191,360
<class,중앙선,용문,1859,2087,3946
<class,중앙선,지평,52,61,113
<class,3호선,대청,5212,4862,10074
<class,경의선,능곡,2533,2453,4986
<class,경의선,행신,4660,4702,9362
<class,경의선,강매,1766,1697,3463
<class,경의선,화전,894,868,1762
<class,경의선,수색,1330,1286,2616
<class,경의선,디지털미디어시티,1762,1655,3417
<class,경의선,가좌,3423,3409,6832
<class,경의선,홍대입구,1248,1556,2804
<class,경의선,서강대,1418,1441,2859
<class,경의선,공덕,2358,1841,4199
<class,경의선,효창공원앞,1523,1785,3308
<class,경의선,신촌,305,348,653
<class,안산선,중앙,13621,14116,27737
<class,경의선,서울역,1007,787,1794
<class,경원선,소요산,3148,2848,5996
<class,경원선,동두천,1381,1740,3121
<class,경원선,보산,1285,1337,2622
<class,경원선,동두천중앙,2296,2315,4611
<class,경원선,지행,4750,4705,9455
<class,경원선,덕정,3673,3430,7103
<class,경원선,덕계,2060,1896,3956
<class,경원선,양주,5329,5130,10459
<class,경원선,녹양,3124,3068,6192
<class,경원선,가능,4582,4487,9069
<class,경원선,의정부,15350,15858,31208
<class,경원선,회룡,8546,8462,17008
<class,경원선,망월사,5073,5263,10336
<class,경원선,도봉산,7650,5164,12814
<class,경원선,도봉,4003,3857,7860
<class,경원선,방학,6586,6526,13112
<class,경원선,녹천,3130,2727,5857
<class,경원선,월계,3973,3840,7813
<class,안산선,고잔,5579,5553,11132
<class,중앙선,덕소,4135,4180,8315
<class,중앙선,도심,1488,1374,2862
<class,중앙선,팔당,1233,1290,2523
<class,중앙선,운길산,1100,1003,2103
<class,중앙선,양수,2104,2260,4364
<class,중앙선,신원,230,176,406
<class,안산선,초지,2778,2773,5551
<class,중앙선,국수,630,654,1284
<class,중앙선,아신,497,557,1054
<class,안산선,안산,8321,8983,17304
<class,안산선,신길온천,1202,1139,2341
<class,안산선,정왕,5366,5670,11036
<class,안산선,오이도,6484,6530,13014
<class,안산선,수리산,2534,2247,4781
<class,우이신설선,북한산우이,2718,2827,5545
<class,우이신설선,솔밭공원,1684,1606,3290
<class,우이신설선,4.19민주묘지,1972,1903,3875
<class,우이신설선,가오리,2682,2556,5238
<class,우이신설선,화계,2271,2165,4436
<class,우이신설선,삼양,1388,1424,2812
<class,우이신설선,삼양사거리,1724,1753,3477
<class,우이신설선,솔샘,3318,3007,6325
<class,우이신설선,북한산보국문,4107,3839,7946
<class,우이신설선,정릉,3129,2736,5865
<class,경의선,월롱,1132,1070,2202
<class,경의선,파주,761,612,1373
<class,경의선,문산,3873,3778,7651
<class,2호선,신대방,12861,12706,25567
<class,2호선,구로디지털단지,19456,19449,38905
<class,2호선,대림,12689,12792,25481
<class,2호선,신도림,24109,23946,48055
<class,2호선,문래,6202,6592,12794
<class,2호선,영등포구청,6633,6881,13514
<class,2호선,당산,6699,7546,14245
<class,2호선,합정,15481,16251,31732
<class,2호선,홍대입구,30461,30337,60798
<class,2호선,신촌,17814,17851,35665
<class,2호선,이대,5665,6089,11754
<class,2호선,아현,4294,4280,8574
<class,2호선,충정로,3182,3313,6495
<class,2호선,용답,1318,1314,2632
<class,2호선,신답,578,640,1218
<class,2호선,신설동,1569,1638,3207
<class,2호선,도림천,347,394,741
<class,2호선,양천구청,2615,2692,5307
<class,2호선,신정네거리,4132,4214,8346
<class,2호선,용두,944,921,1865
<class,3호선,지축,1495,1406,2901
<class,3호선,구파발,8621,8887,17508
<class,3호선,연신내,17106,16499,33605
<class,3호선,불광,7526,8388,15914
<class,3호선,녹번,5751,5369,11120
<class,3호선,홍제,7537,7185,14722
<class,3호선,무악재,1492,1556,3048
<class,3호선,독립문,2987,3003,5990
<class,3호선,경복궁,7723,7877,15600
<class,3호선,안국,6419,6966,13385
<class,3호선,종로3가,2761,3637,6398
<class,3호선,을지로3가,2691,2378,5069
<class,3호선,충무로,1,0,1
<class,3호선,동대입구,3518,3699,7217
<class,3호선,약수,5592,5392,10984
<class,3호선,금호,3554,3448,7002
<class,3호선,옥수,4013,4341,8354
<class,3호선,압구정,11931,12495,24426
<class,3호선,신사,10251,10582,20833
<class,3호선,잠원,2021,1982,4003
<class,3호선,고속터미널,34209,31554,65763
<class,3호선,교대,3699,2252,5951
<class,3호선,남부터미널,12308,12484,24792
<class,3호선,양재,10600,12496,23096
<class,3호선,매봉,3564,3683,7247
<class,3호선,도곡,1710,1822,3532
<class,3호선,대치,4226,4027,8253
<class,3호선,학여울,760,764,1524
<class,3호선,대청,3362,3407,6769
<class,3호선,일원,2949,3203,6152
<class,3호선,수서,8892,8416,17308
<class,3호선,가락시장,3145,3383,6528
<class,3호선,경찰병원,2376,2401,4777
<class,3호선,오금,2329,2261,4590
<class,4호선,수유,16112,15801,31913
<class,4호선,미아,6425,6259,12684
<class,4호선,미아사거리,12986,12443,25429
<class,4호선,길음,7864,7611,15475
<class,4호선,성신여대입구,10023,9763,19786
<class,4호선,한성대입구,6280,6211,12491
<class,4호선,혜화,16629,17427,34056
<class,4호선,동대문,4310,4910,9220
<class,4호선,동대문역사문화공원,6678,6388,13066
<class,4호선,충무로,6443,6507,12950
<class,4호선,명동,8089,8148,16237
<class,4호선,회현,6417,6462,12879
<class,4호선,서울역,3249,7140,10389
<class,4호선,숙대입구,5944,5852,11796
<class,4호선,삼각지,1791,2278,4069
<class,4호선,신용산,6508,6555,13063
<class,4호선,이촌,4051,4488,8539
<class,4호선,동작,1018,1046,2064
<class,4호선,총신대입구,8433,9178,17611
<class,4호선,사당,11353,10791,22144
<class,4호선,남태령,515,417,932
<class,4호선,당고개,6146,5847,11993
<class,4호선,상계,8043,7612,15655
<class,4호선,노원,9629,10483,20112
<class,4호선,창동,11444,11975,23419
<class,4호선,쌍문,12652,11534,24186
<class,5호선,방화,2842,2865,5707
<class,5호선,개화산,2256,2287,4543
<class,5호선,김포공항,6380,5984,12364
<class,5호선,송정,3039,3109,6148
<class,5호선,마곡,2814,3028,5842
<class,5호선,발산,6921,7344,14265
<class,5호선,우장산,5392,5386,10778
<class,5호선,화곡,11623,11188,22811
<class,5호선,까치산,13031,12760,25791
<class,5호선,신정,5405,4849,10254
<class,5호선,목동,6371,6343,12714
<class,5호선,오목교,9684,10230,19914
<class,5호선,양평,2252,2355,4607
<class,5호선,영등포구청,1142,1113,2255
<class,5호선,영등포시장,3714,3950,7664
<class,5호선,신길,1559,1758,3317
<class,5호선,여의도,6837,6824,13661
<class,5호선,여의나루,4830,6035,10865
<class,5호선,마포,3990,3941,7931
<class,5호선,공덕,3658,3696,7354
<class,5호선,애오개,2258,2358,4616
<class,5호선,충정로,1206,1185,2391
<class,5호선,서대문,4055,4087,8142
<class,5호선,광화문,8109,8265,16374
<class,5호선,종로3가,6434,5779,12213
<class,5호선,을지로4가,1151,1234,2385
<class,5호선,동대문역사문화공원,620,640,1260
<class,5호선,청구,1376,1338,2714
<class,5호선,신금호,2419,2601,5020
<class,5호선,행당,3328,3011,6339
<class,5호선,왕십리,2036,2309,4345
<class,5호선,마장,2504,2362,4866
<class,5호선,답십리,6087,5712,11799
<class,5호선,장한평,6224,6102,12326
<class,5호선,군자,5130,5827,10957
<class,5호선,아차산,6854,6783,13637
<class,5호선,광나루,5818,5447,11265
<class,5호선,천호,10132,9602,19734
<class,5호선,강동,7409,7480,14889
<class,5호선,길동,3444,3545,6989
<class,5호선,굽은다리,4574,4322,8896
<class,5호선,명일,3951,3970,7921
<class,5호선,고덕,3436,3458,6894
<class,5호선,상일동,5730,5645,11375
<class,5호선,둔촌동,3766,3813,7579
<class,5호선,올림픽공원,3687,3145,6832
<class,5호선,방이,3326,3140,6466
<class,5호선,오금,1370,1307,2677
<class,5호선,개롱,2584,2794,5378
<class,5호선,거여,3216,3137,6353
<class,5호선,마천,2660,2878,5538
<class,5호선,강일,1326,1332,2658
<class,5호선,미사,6639,6705,13344
<class,5호선,하남풍산,1692,1737,3429
<class,5호선,하남시청,2802,2743,5545
<class,5호선,하남검단산,2939,2944,5883
<class,6호선,응암,7551,7661,15212
<class,6호선,역촌,1650,1883,3533
<class,6호선,불광,2469,2132,4601
<class,6호선,독바위,1181,1325,2506
<class,6호선,연신내,1,0,1
<class,6호선,구산,3193,2464,5657
<class,6호선,새절,5338,5312,10650
<class,6호선,증산,4566,4678,9244
<class,6호선,디지털미디어시티,4069,4279,8348
<class,6호선,월드컵경기장,2472,2592,5064
<class,6호선,마포구청,5833,5425,11258
<class,6호선,망원,7055,7756,14811
<class,6호선,합정,7134,6550,13684
<class,6호선,상수,4250,4999,9249
<class,6호선,광흥창,3328,3217,6545
<class,6호선,대흥,3017,3113,6130
<class,6호선,공덕,5557,5243,10800
<class,6호선,효창공원앞,2708,2378,5086
<class,6호선,삼각지,2923,2222,5145
<class,6호선,녹사평,2961,2792,5753
<class,6호선,이태원,6505,6354,12859
<class,6호선,한강진,4832,5491,10323
<class,6호선,버티고개,765,817,1582
<class,6호선,약수,1420,1452,2872
<class,6호선,청구,1415,1381,2796
<class,6호선,신당,3449,4142,7591
<class,6호선,동묘앞,3707,3842,7549
<class,6호선,창신,1395,1220,2615
<class,6호선,보문,3219,3035,6254
<class,6호선,안암,3973,4314,8287
<class,6호선,고려대,3338,3145,6483
<class,6호선,월곡,4508,4562,9070
<class,6호선,상월곡,2577,2365,4942
<class,6호선,돌곶이,3920,3707,7627
<class,6호선,석계,5259,5320,10579
<class,6호선,태릉입구,2436,2615,5051
<class,6호선,화랑대,4162,3509,7671
<class,6호선,봉화산,3168,3175,6343
<class,7호선,장암,926,563,1489
<class,7호선,도봉산,3493,4763,8256
<class,7호선,수락산,6007,5925,11932
<class,7호선,마들,4899,4527,9426
<class,7호선,노원,8901,9287,18188
<class,7호선,중계,5399,4977,10376
<class,7호선,하계,7255,6850,14105
<class,7호선,공릉,5123,5219,10342
<class,7호선,태릉입구,3827,3594,7421
<class,7호선,먹골,4559,4520,9079
<class,7호선,중화,4793,4723,9516
<class,7호선,상봉,8061,7634,15695
<class,7호선,면목,6547,6600,13147
<class,7호선,사가정,7414,7302,14716
<class,7호선,용마산,2778,2782,5560
<class,7호선,중곡,4315,4170,8485
<class,7호선,군자,6214,4936,11150
<class,7호선,어린이대공원,6037,5562,11599
<class,7호선,건대입구,6430,6588,13018
<class,7호선,뚝섬유원지,4050,3876,7926
<class,7호선,청담,5734,6167,11901
<class,7호선,강남구청,4768,5072,9840
<class,7호선,학동,4687,5065,9752
<class,7호선,논현,5410,5748,11158
<class,7호선,반포,2628,2681,5309
<class,7호선,고속터미널,10650,6713,17363
<class,7호선,내방,4343,4597,8940
<class,7호선,이수,7038,6767,13805
<class,7호선,남성,4452,4395,8847
<class,7호선,숭실대입구,4483,4994,9477
<class,7호선,상도,4488,4441,8929
<class,7호선,장승배기,4161,4148,8309
<class,7호선,신대방삼거리,6820,6822,13642
<class,7호선,보라매,3749,3767,7516
<class,7호선,신풍,5236,5003,10239
<class,7호선,대림,5993,5616,11609
<class,7호선,남구로,6113,5822,11935
<class,7호선,가산디지털단지,8626,8029,16655
<class,7호선,철산,8719,8807,17526
<class,7호선,광명사거리,10486,10332,20818
<class,7호선,천왕,4212,3992,8204
<class,7호선,온수,3146,3312,6458
<class,7호선,까치울,3243,3378,6621
<class,7호선,부천종합운동장,1973,1733,3706
<class,7호선,춘의,2929,2682,5611
<class,7호선,신중동,5668,5688,11356
<class,7호선,부천시청,5676,5761,11437
<class,7호선,상동,6037,5831,11868
<class,7호선,삼산체육관,2132,1976,4108
<class,7호선,굴포천,4018,4016,8034
<class,7호선,부평구청,2955,2717,5672
<class,8호선,암사,7297,7042,14339
<class,8호선,천호,7473,8517,15990
<class,8호선,강동구청,3738,3870,7608
<class,8호선,몽촌토성,2601,2728,5329
<class,8호선,잠실,8222,9343,17565
<class,8호선,석촌,3442,4256,7698
<class,8호선,송파,3133,3230,6363
<class,8호선,가락시장,2731,3433,6164
<class,8호선,문정,4696,4959,9655
<class,8호선,장지,7743,8057,15800
<class,8호선,복정,4324,4132,8456
<class,8호선,산성,2601,2609,5210
<class,8호선,남한산성입구,5558,5280,10838
<class,8호선,단대오거리,4653,4637,9290
<class,8호선,신흥,2445,2600,5045
<class,8호선,수진,2618,2354,4972
<class,8호선,모란,3141,2757,5898
<class,9호선,개화,785,791,1576
<class,9호선,김포공항,7279,10397,17676
<class,9호선,공항시장,1487,1635,3122
<class,9호선,신방화,2969,2968,5937
<class,9호선,마곡나루,4514,4532,9046
<class,9호선,양천향교,3373,3735,7108
<class,9호선,가양,8330,8529,16859
<class,9호선,증미,2541,2703,5244
<class,9호선,등촌,4288,4288,8576
<class,9호선,염창,6986,6981,13967
<class,9호선,신목동,1346,1247,2593
<class,9호선,선유도,2326,2217,4543
<class,9호선,당산,7387,7334,14721
<class,9호선,국회의사당,4027,3542,7569
<class,9호선,여의도,7545,6603,14148
<class,9호선,샛강,1488,1525,3013
<class,9호선,노량진,12458,12981,25439
<class,9호선,노들,2099,1840,3939
<class,9호선,흑석,3176,3364,6540
<class,9호선,동작,887,736,1623
<class,9호선,구반포,923,976,1899
<class,9호선,신반포,1338,1360,2698
<class,9호선,고속터미널,8578,11127,19705
<class,9호선,사평,1352,1333,2685
<class,9호선,신논현,13603,13172,26775
<class,9호선2~3단계,언주,3232,3166,6398
<class,9호선2~3단계,선정릉,2744,2969,5713
<class,9호선2~3단계,삼성중앙,1722,1749,3471
<class,9호선2~3단계,봉은사,7741,8030,15771
<class,9호선2~3단계,종합운동장,2068,1776,3844
<class,9호선2~3단계,삼전,2988,2944,5932
<class,9호선2~3단계,석촌고분,2550,2644,5194
<class,9호선2~3단계,석촌,3851,3348,7199
<class,9호선2~3단계,송파나루,2431,2667,5098
<class,9호선2~3단계,한성백제,1195,1100,2295
<class,9호선2~3단계,올림픽공원,6872,7096,13968
<class,9호선2~3단계,둔촌오륜,387,388,775
<class,9호선2~3단계,중앙보훈병원,2897,2755,5652
<class,경강선,판교,1982,1864,3846
<class,경강선,이매,567,410,977
<class,경강선,삼동,862,814,1676
<class,경강선,경기광주,2962,3023,5985
<class,경강선,초월,1366,1308,2674
<class,경강선,곤지암,1168,1280,2448
<class,경강선,신둔도예촌,742,663,1405
<class,경강선,이천,1643,1790,3433
<class,경강선,부발,1042,1696,2738
<class,경강선,세종대왕릉,204,196,400
<class,경강선,여주,1515,1646,3161
<class,경부선,서울역,6213,1339,7552
<class,경부선,남영,3728,3918,7646
<class,경부선,용산,27155,23956,51111
<class,경부선,노량진,4571,4524,9095
<class,경부선,대방,4904,5298,10202
<class,경부선,영등포,27096,26338,53434
<class,경부선,신도림,1718,1936,3654
<class,경부선,신길,4203,3715,7918
<class,경부선,구로,8039,8044,16083
<class,경부선,가산디지털단지,3824,5283,9107
<class,경부선,금천구청,4959,5040,9999
<class,경부선,석수,4066,3697,7763
<class,경부선,관악,3410,3198,6608
<class,경부선,안양,10871,10727,21598
<class,경부선,명학,2632,2566,5198
<class,경부선,금정,10983,11477,22460
<class,경부선,군포,2549,2418,4967
<class,경부선,의왕,3446,3542,6988
<class,경부선,성균관대,6212,6719,12931
<class,경부선,화서,3185,3225,6410
<class,경부선,수원,27794,26758,54552
<class,경부선,독산,4911,5159,10070
<class,경부선,세류,1703,1743,3446
<class,경부선,병점,7469,8398,15867
<class,경부선,세마,1425,1344,2769
<class,경부선,오산대,1649,1605,3254
<class,경부선,오산,6429,6995,13424
<class,경부선,진위,725,786,1511
<class,경부선,송탄,3085,3453,6538
<class,경부선,서정리,3368,4742,8110
<class,경부선,평택지제,1852,1752,3604
<class,경부선,평택,9592,9770,19362
<class,경부선,성환,2034,2292,4326
<class,경부선,직산,439,507,946
<class,경부선,두정,4437,4477,8914
<class,경부선,천안,5472,4998,10470
<class,경부선,당정,2460,2527,4987
<class,경부선,서동탄,696,742,1438
<class,경부선,광명,2061,1431,3492
<class,경원선,이촌,1785,1415,3200
<class,경원선,서빙고,1131,1081,2212
<class,경원선,한남,1545,1605,3150
<class,경원선,옥수,47,22,69
<class,경원선,응봉,981,868,1849
<class,경원선,왕십리,7526,8530,16056
<class,경원선,청량리,11997,10451,22448
<class,경원선,외대앞,3692,3657,7349
<class,경원선,신이문,3762,3575,7337
<class,경원선,석계,3800,4228,8028
<class,경원선,광운대,3470,3604,7074
<class,경원선,월계,3192,2929,6121
<class,경원선,녹천,2045,1806,3851
<class,경원선,방학,4678,4580,9258
<class,경원선,도봉,2783,2579,5362
<class,경원선,도봉산,4489,3059,7548
<class,경원선,망월사,3430,3510,6940
<class,경원선,회룡,5641,5614,11255
<class,경원선,의정부,10668,10782,21450
<class,경원선,가능,3181,3005,6186
<class,경원선,녹양,2178,2125,4303
<class,경원선,양주,3597,3668,7265
<class,경원선,덕계,1292,1235,2527
<class,경원선,덕정,2500,2617,5117
<class,경원선,지행,3406,3431,6837
<class,경원선,동두천중앙,1685,1597,3282
<class,경원선,보산,1057,1023,2080
<class,경원선,동두천,1183,1279,2462
<class,경원선,소요산,2406,1945,4351
<class,경의선,서울역,890,749,1639
<class,경의선,신촌,195,224,419
<class,경의선,효창공원앞,978,1156,2134
<class,경의선,공덕,1355,1085,2440
<class,경의선,서강대,997,1028,2025
<class,경의선,홍대입구,1126,1153,2279
<class,경의선,가좌,2215,2219,4434
<class,경의선,디지털미디어시티,1106,1051,2157
<class,경의선,수색,750,872,1622
<class,경의선,화전,587,597,1184
<class,경의선,강매,1097,1043,2140
<class,경의선,행신,3460,3222,6682
<class,경의선,능곡,1685,1673,3358
<class,경의선,곡산,253,230,483
<class,경의선,백마,2519,2479,4998
<class,경의선,풍산,2762,2600,5362
<class,경의선,일산,3674,3484,7158
<class,경의선,탄현,3456,3132,6588
<class,경의선,야당,3279,3173,6452
<class,경의선,운정,2711,2727,5438
<class,경의선,금릉,2055,2133,4188
<class,경의선,금촌,3224,3417,6641
<class,경의선,월롱,609,1382,1991
<class,경의선,파주,483,481,964
<class,경의선,문산,2726,2828,5554
<class,경의선,임진강,20,28,48
<class,경인선,개봉,9533,9619,19152
<class,경인선,오류동,6044,5710,11754
<class,경인선,역곡,11655,11713,23368
<class,경인선,부천,18541,18087,36628
<class,경인선,송내,10852,10483,21335
<class,경인선,부평,19159,19501,38660
<class,경인선,백운,3273,3254,6527
<class,경인선,동암,7943,7964,15907
<class,경인선,주안,9390,8254,17644
<class,경인선,제물포,4476,4409,8885
<class,경인선,동인천,7257,7013,14270
<class,경인선,인천,2350,1737,4087
<class,경인선,구일,2561,2531,5092
<class,경인선,소사,4576,4407,8983
<class,경인선,부개,3899,3676,7575
<class,경인선,간석,2530,2457,4987
<class,경인선,도원,1390,1437,2827
<class,경인선,온수,3130,2934,6064
<class,경인선,중동,4088,3808,7896
<class,경인선,도화,1949,1779,3728
<class,경춘선,신내,612,651,1263
<class,경춘선,갈매,1125,1032,2157
<class,경춘선,별내,1431,1360,2791
<class,경춘선,퇴계원,1716,1659,3375
<class,경춘선,사릉,1311,1444,2755
<class,경춘선,금곡,673,631,1304
<class,경춘선,평내호평,2688,2568,5256
<class,경춘선,천마산,863,745,1608
<class,경춘선,마석,1912,1837,3749
<class,경춘선,대성리,428,321,749
<class,경춘선,청평,1355,981,2336
<class,경춘선,상천,199,180,379
<class,경춘선,가평,1871,1205,3076
<class,경춘선,굴봉산,124,87,211
<class,경춘선,백양리,110,88,198
<class,경춘선,강촌,497,314,811
<class,경춘선,김유정,242,224,466
<class,경춘선,남춘천,1758,1781,3539
<class,경춘선,춘천,1062,881,1943
<class,공항철도 1호선,서울역,6227,5207,11434
<class,공항철도 1호선,공덕,902,1281,2183
<class,공항철도 1호선,홍대입구,6370,6097,12467
<class,공항철도 1호선,디지털미디어시티,2915,3046,5961
<class,공항철도 1호선,마곡나루,1671,1851,3522
<class,공항철도 1호선,김포공항,10638,5377,16015
<class,공항철도 1호선,계양,3844,3774,7618
<class,공항철도 1호선,검암,2786,2862,5648
<class,공항철도 1호선,청라국제도시,2528,2468,4996
<class,공항철도 1호선,운서,3894,4184,8078
<class,공항철도 1호선,공항화물청사,914,954,1868
<class,공항철도 1호선,인천공항1터미널,2521,2592,5113
<class,공항철도 1호선,인천공항2터미널,1580,1445,3025
<class,공항철도 1호선,영종,1854,1748,3602
<class,과천선,선바위,2870,2723,5593
<class,과천선,경마공원,734,706,1440
<class,과천선,대공원,1771,1798,3569
<class,과천선,과천,2394,2287,4681
<class,과천선,정부과천청사,3112,3229,6341
<class,과천선,인덕원,8651,8071,16722
<class,과천선,평촌,5065,4986,10051
<class,과천선,범계,12036,11670,23706
<class,분당선,선릉,2394,3501,5895
<class,분당선,한티,6353,6324,12677
<class,분당선,도곡,2333,2274,4607
<class,분당선,구룡,588,586,1174
<class,분당선,개포동,1629,1718,3347
<class,분당선,대모산입구,1444,1399,2843
<class,분당선,수서,7533,6952,14485
<class,분당선,복정,1,0,1
<class,분당선,수원,4869,3907,8776
<class,분당선,서울숲,3876,4028,7904
<class,분당선,압구정로데오,8467,9326,17793
<class,분당선,강남구청,2676,3107,5783
<class,분당선,선정릉,1886,1995,3881
<class,분당선,가천대,3004,3610,6614
<class,분당선,태평,7147,6653,13800
<class,분당선,모란,12619,13146,25765
<class,분당선,야탑,11106,11285,22391
<class,분당선,서현,11759,11846,23605
<class,분당선,수내,5097,4912,10009
<class,분당선,정자,6066,6490,12556
<class,분당선,미금,6219,6488,12707
<class,분당선,오리,4662,4067,8729
<class,분당선,이매,2632,2744,5376
<class,분당선,보정,922,850,1772
<class,분당선,죽전,6791,7966,14757
<class,분당선,구성,1945,2101,4046
<class,분당선,신갈,1706,1733,3439
<class,분당선,기흥,4211,4063,8274
<class,분당선,상갈,2362,2382,4744
<class,분당선,청명,1661,1756,3417
<class,분당선,영통,3976,4068,8044
<class,분당선,망포,5385,5713,11098
<class,분당선,매탄권선,2056,2040,4096
<class,분당선,수원시청,6246,6247,12493
<class,분당선,매교,1172,1202,2374
<class,수인선,고색,1338,1363,2701
<class,수인선,오목천,1120,1131,2251
<class,수인선,어천,442,569,1011
<class,수인선,야목,138,106,244
<class,수인선,사리,1973,1777,3750
<class,수인선,달월,33,35,68
<class,수인선,월곶,1397,1321,2718
<class,수인선,소래포구,3212,3093,6305
<class,수인선,인천논현,2443,2645,5088
<class,수인선,호구포,1584,1653,3237
<class,수인선,남동인더스파크,471,480,951
<class,수인선,원인재,2311,2349,4660
<class,수인선,연수,2309,2274,4583
<class,수인선,송도,1163,1108,2271
<class,수인선,인하대,2526,2419,4945
<class,수인선,숭의,1551,1458,3009
<class,수인선,신포,930,841,1771
<class,수인선,인천,792,1201,1993
<class,안산선,산본,7128,7730,14858
<class,안산선,대야미,2272,2154,4426
<class,안산선,반월,2027,2026,4053
<class,안산선,상록수,7639,7426,15065
<class,안산선,한대앞,4327,4154,8481
<class,안산선,중앙,9549,9461,19010
<class,안산선,고잔,3599,3417,7016
<class,안산선,초지,1850,1844,3694
<class,안산선,안산,8017,7311,15328
<class,안산선,신길온천,895,852,1747
<class,안산선,정왕,4222,4507,8729
<class,안산선,오이도,4596,4608,9204
<class,안산선,수리산,1679,1487,3166
<class,우이신설선,북한산우이,1670,1703,3373
<class,우이신설선,솔밭공원,1116,1082,2198
<class,우이신설선,4.19민주묘지,1384,1245,2629
<class,우이신설선,가오리,1917,1799,3716
<class,우이신설선,화계,1723,1618,3341
<class,우이신설선,삼양,1002,917,1919
<class,우이신설선,삼양사거리,1160,1160,2320
<class,우이신설선,솔샘,2147,1964,4111
<class,우이신설선,북한산보국문,2924,2659,5583
<class,우이신설선,정릉,2103,1850,3953
<class,우이신설선,성신여대입구,1562,1926,3488
<class,우이신설선,보문,759,789,1548
<class,우이신설선,신설동,784,728,1512
<class,일산선,원흥,4245,4132,8377
<class,일산선,삼송,8317,8281,16598
<class,일산선,원당,4830,4649,9479
<class,일산선,화정,7392,7552,14944
<class,일산선,대곡,784,684,1468
<class,일산선,백석,4618,4554,9172
<class,일산선,마두,2762,2733,5495
<class,일산선,정발산,3857,3822,7679
<class,일산선,주엽,3517,3548,7065
<class,일산선,대화,5222,4698,9920
<class,장항선,봉명,531,507,1038
<class,장항선,쌍용,1076,1125,2201
<class,장항선,아산,2516,1742,4258
<class,장항선,배방,697,767,1464
<class,장항선,온양온천,3460,3457,6917
<class,장항선,신창,718,844,1562
<class,중앙선,회기,12132,12334,24466
<class,중앙선,중랑,2888,2788,5676
<class,중앙선,상봉,3376,3340,6716
<class,중앙선,망우,3967,3958,7925
<class,중앙선,양원,563,596,1159
<class,중앙선,구리,5880,6280,12160
<class,중앙선,도농,3679,3724,7403
<class,중앙선,양정,382,321,703
<class,중앙선,덕소,2695,2763,5458
<class,중앙선,도심,947,863,1810
<class,중앙선,팔당,805,754,1559
<class,중앙선,운길산,734,641,1375
<class,중앙선,양수,1321,1230,2551
<class,중앙선,신원,113,96,209
<class,중앙선,국수,422,350,772
<class,중앙선,아신,415,362,777
<class,중앙선,오빈,133,123,256
<class,중앙선,양평,1700,1528,3228
<class,중앙선,원덕,263,200,463
<class,중앙선,용문,1587,1198,2785
<class,중앙선,지평,51,28,79
<class,1호선,서울역,22868,19664,42532
<class,1호선,동묘앞,5605,5775,11380
<class,1호선,시청,5671,5415,11086
<class,1호선,종각,9596,8868,18464
<class,1호선,종로3가,10938,9895,20833
<class,1호선,종로5가,6812,7067,13879
<class,1호선,동대문,6446,6688,13134
<class,1호선,신설동,5114,5165,10279
<class,1호선,제기동,6494,6688,13182
<class,1호선,청량리,9871,9977,19848
<class,2호선,시청,4364,3638,8002
<class,2호선,을지로입구,12577,12022,24599
<class,2호선,을지로3가,6399,5993,12392
<class,2호선,을지로4가,2488,2316,4804
<class,2호선,동대문역사문화공원,5703,6689,12392
<class,2호선,신당,6085,6558,12643
<class,2호선,상왕십리,5628,5541,11169
<class,2호선,왕십리,7689,6754,14443
<class,2호선,한양대,1961,2094,4055
<class,2호선,뚝섬,7253,7499,14752
<class,2호선,성수,10044,11053,21097
<class,2호선,건대입구,20381,21865,42246
<class,2호선,구의,9565,9563,19128
<class,2호선,강변,18132,17286,35418
<class,2호선,잠실나루,4152,4245,8397
<class,2호선,잠실,37241,35203,72444
<class,2호선,잠실새내,9502,9759,19261
<class,2호선,종합운동장,4320,4622,8942
<class,2호선,삼성,19801,19908,39709
<class,2호선,선릉,10624,9251,19875
<class,2호선,역삼,9526,10441,19967
<class,2호선,강남,30583,29829,60412
<class,2호선,교대,9391,10113,19504
<class,2호선,서초,9752,9126,18878
<class,2호선,방배,5636,5987,11623
<class,2호선,사당,16832,18447,35279
<class,2호선,낙성대,12811,13344,26155
<class,2호선,서울대입구,22487,23407,45894
<class,2호선,봉천,10308,10064,20372
<class,2호선,신림,31258,30908,62166
<class,경원선,왕십리,9780,11309,21089
<class,경원선,청량리,11997,14026,26023
<class,경원선,외대앞,4897,4778,9675
<class,경원선,신이문,5325,4797,10122
<class,경원선,석계,5350,5667,11017
<class,중앙선,상봉,4356,4300,8656
<class,경원선,광운대,4747,4575,9322
<class,경원선,월계,4163,3817,7980
<class,경원선,녹천,2930,2464,5394
<class,중앙선,지평,48,72,120
<class,중앙선,용문,2626,2966,5592
<class,중앙선,원덕,263,338,601
<class,중앙선,양평,2051,2343,4394
<class,중앙선,오빈,213,252,465
<class,중앙선,아신,449,448,897
<class,중앙선,국수,540,574,1114
<class,중앙선,신원,170,136,306
<class,중앙선,양수,2007,2176,4183
<class,중앙선,운길산,976,913,1889
<class,중앙선,팔당,1135,1118,2253
<class,중앙선,도심,1306,1163,2469
<class,경원선,방학,6344,6161,12505
<class,경원선,도봉,3894,3631,7525
<class,경원선,도봉산,7129,4815,11944
<class,경원선,망월사,4750,4776,9526
<class,중앙선,덕소,3660,3711,7371
<class,중앙선,양정,598,503,1101
<class,중앙선,도농,5464,5194,10658
<class,중앙선,구리,8479,8726,17205
<class,중앙선,양원,1024,1007,2031
<class,중앙선,망우,5320,5198,10518
<class,경원선,회룡,7797,7836,15633
<class,경원선,의정부,13801,14741,28542
<class,경원선,가능,4527,4266,8793
<class,경원선,녹양,2943,2881,5824
<class,경원선,양주,4913,4715,9628
<class,경원선,덕계,1901,1813,3714
<class,경원선,덕정,3476,3413,6889
<class,경원선,지행,4378,4288,8666
<class,경원선,동두천중앙,2275,2349,4624
<class,경원선,보산,1146,1188,2334
<class,경원선,동두천,1357,1731,3088
<class,경원선,소요산,3252,2904,6156
<class,경의선,서울역,937,1096,2033
<class,경의선,신촌,249,247,496
<class,경의선,효창공원앞,1368,1604,2972
<class,경의선,공덕,1853,1585,3438
<class,경의선,서강대,1445,1305,2750
<class,경의선,홍대입구,1280,1355,2635
<class,경의선,가좌,3189,2980,6169
<class,경의선,디지털미디어시티,1502,1417,2919
<class,경의선,수색,1276,1251,2527
<class,우이신설선,보문,994,984,1978
<class,우이신설선,성신여대입구,2278,2582,4860
<class,우이신설선,정릉,2838,2459,5297
<class,우이신설선,북한산보국문,3883,3479,7362
<class,우이신설선,솔샘,3003,2802,5805
<class,우이신설선,삼양사거리,1768,1697,3465
<class,우이신설선,삼양,1372,1432,2804
<class,우이신설선,화계,2218,2055,4273
<class,우이신설선,가오리,2541,2447,4988
<class,우이신설선,4.19민주묘지,1949,1732,3681
<class,우이신설선,솔밭공원,1523,1542,3065
<class,우이신설선,북한산우이,2763,2829,5592
<class,안산선,수리산,2537,2156,4693
<class,안산선,오이도,6034,6302,12336
<class,안산선,정왕,5558,5660,11218
<class,안산선,신길온천,1202,1189,2391
<class,안산선,안산,8251,8858,17109
<class,안산선,초지,2524,2606,5130
<class,안산선,고잔,4833,4713,9546
<class,경의선,화전,785,778,1563
<class,일산선,마두,4171,4139,8310
<class,일산선,백석,6103,6232,12335
<class,일산선,대곡,1120,955,2075
<class,중앙선,중랑,3992,3778,7770
<class,중앙선,회기,15380,14316,29696
<class,장항선,신창,876,842,1718
<class,장항선,온양온천,2936,3056,5992
<class,장항선,배방,818,845,1663
<class,장항선,아산,2200,2208,4408
<class,장항선,쌍용,1259,1144,2403
<class,장항선,봉명,700,619,1319
<class,일산선,대화,6880,6208,13088
<class,일산선,주엽,5266,5304,10570
<class,일산선,정발산,5002,5260,10262
<class,안산선,중앙,12097,12690,24787
<class,안산선,한대앞,5730,5837,11567
<class,안산선,상록수,10227,10215,20442
<class,안산선,반월,2771,2605,5376
<class,안산선,대야미,3407,3013,6420
<class,안산선,산본,10234,10852,21086
<class,수인선,인천,901,1497,2398
<class,수인선,신포,1205,1284,2489
<class,수인선,숭의,2367,2213,4580
<class,수인선,인하대,3698,3409,7107
<class,수인선,송도,1750,1735,3485
<class,수인선,연수,3122,3207,6329
<class,수인선,원인재,3061,3128,6189
<class,수인선,남동인더스파크,887,855,1742
<class,수인선,호구포,2308,2202,4510
<class,수인선,인천논현,3838,3984,7822
<class,수인선,소래포구,4102,4231,8333
<class,수인선,월곶,1762,1800,3562
<class,수인선,달월,47,43,90
<class,수인선,사리,2646,2214,4860
<class,수인선,야목,151,142,293
<class,수인선,어천,610,520,1130
<class,수인선,오목천,1662,1486,3148
<class,수인선,고색,2200,2112,4312
<class,분당선,매교,1697,1690,3387
<class,분당선,수원시청,8938,9545,18483
<class,분당선,매탄권선,2834,2757,5591
<class,분당선,망포,7451,6888,14339
<class,분당선,영통,5519,5372,10891
<class,분당선,청명,2164,2124,4288
<class,분당선,상갈,3162,3164,6326
<class,분당선,기흥,5510,5220,10730
<class,분당선,신갈,2296,2292,4588
<class,분당선,구성,2522,2677,5199
<class,분당선,죽전,8307,9349,17656
<class,분당선,보정,1300,1218,2518
<class,분당선,이매,3344,3046,6390
<class,분당선,오리,6393,5336,11729
<class,분당선,미금,9182,9346,18528
<class,분당선,정자,8871,8959,17830
<class,분당선,수내,7282,6883,14165
<class,분당선,서현,14731,15211,29942
<class,분당선,야탑,13981,14697,28678
<class,분당선,모란,13235,13324,26559
<class,분당선,태평,9279,8579,17858
<class,분당선,가천대,4312,4725,9037
<class,분당선,선정릉,2841,2839,5680
<class,분당선,강남구청,4356,5042,9398
<class,분당선,압구정로데오,13936,15800,29736
<class,분당선,서울숲,5626,5575,11201
<class,분당선,수원,5966,5153,11119
<class,분당선,수서,7760,8453,16213
<class,분당선,대모산입구,2153,1967,4120
<class,분당선,개포동,2291,2199,4490
<class,분당선,구룡,1672,1546,3218
<class,분당선,도곡,3715,3283,6998
<class,분당선,한티,10151,9778,19929
<class,분당선,선릉,4264,6386,10650
<class,과천선,범계,15754,15612,31366
<class,과천선,평촌,7357,7333,14690
<class,과천선,인덕원,11965,11891,23856
<class,과천선,정부과천청사,4517,4564,9081
<class,과천선,과천,3216,3077,6293
<class,과천선,대공원,2806,2841,5647
<class,과천선,경마공원,982,951,1933
<class,과천선,선바위,3916,3637,7553
<class,공항철도 1호선,영종,2203,2356,4559
<class,공항철도 1호선,인천공항2터미널,1733,1547,3280
<class,공항철도 1호선,인천공항1터미널,2811,2939,5750
<class,공항철도 1호선,공항화물청사,1217,1217,2434
<class,공항철도 1호선,운서,4844,4832,9676
<class,공항철도 1호선,청라국제도시,3036,3018,6054
<class,공항철도 1호선,검암,3637,3774,7411
<class,공항철도 1호선,계양,4938,4687,9625
<class,공항철도 1호선,김포공항,9302,5464,14766
<class,공항철도 1호선,마곡나루,2384,2499,4883
<class,공항철도 1호선,디지털미디어시티,4014,3757,7771
<class,공항철도 1호선,홍대입구,7263,6693,13956
<class,공항철도 1호선,공덕,1113,1615,2728
<class,공항철도 1호선,서울역,4816,5217,10033
<class,경춘선,춘천,1052,1033,2085
<class,경춘선,남춘천,1924,1907,3831
<class,경춘선,김유정,252,348,600
<class,경춘선,강촌,416,509,925
<class,경춘선,백양리,100,108,208
<class,경춘선,굴봉산,135,164,299
<class,일산선,화정,10335,10710,21045
<class,일산선,원당,6878,6688,13566
<class,일산선,삼송,10928,10774,21702
<class,일산선,지축,1,0,1
<class,일산선,원흥,5931,5811,11742
<class,우이신설선,신설동,1206,1111,2317
<class,경의선,강매,1543,1439,2982
<class,경의선,행신,4131,4211,8342
<class,경의선,능곡,2263,2192,4455
<class,경의선,곡산,324,331,655
<class,경의선,백마,3400,3314,6714
<class,경의선,풍산,3356,3238,6594
<class,경의선,일산,4806,4637,9443
<class,경의선,탄현,4325,4218,8543
<class,경의선,야당,4340,4379,8719
<class,경의선,운정,3914,3820,7734
<class,경의선,금릉,2989,2907,5896
<class,경의선,금촌,4650,4486,9136
<class,경의선,월롱,1228,1120,2348
<class,경의선,파주,813,624,1437
<class,경의선,문산,3658,3613,7271
<class,경의선,임진강,35,40,75
<class,경의선,공덕,8,11,19
<class,경인선,개봉,13520,13315,26835
<class,경인선,오류동,7797,7152,14949
<class,경인선,역곡,16327,16191,32518
<class,경인선,부천,23716,24467,48183
<class,경인선,송내,14534,14516,29050
<class,경인선,부평,23956,26158,50114
<class,경인선,백운,4570,4580,9150
<class,경인선,동암,10579,10811,21390
<class,경인선,주안,12917,11395,24312
<class,경인선,제물포,6187,5964,12151
<class,경인선,동인천,9424,9361,18785
<class,경인선,인천,3221,2750,5971
<class,경부선,직산,507,502,1009
<class,경부선,두정,4905,5341,10246
<class,경춘선,가평,1646,2070,3716
<class,경부선,천안,5166,5467,10633
<class,경춘선,상천,245,261,506
<class,경춘선,청평,1395,1572,2967
<class,경춘선,대성리,532,462,994
<class,경춘선,마석,2589,2684,5273
<class,경춘선,천마산,1138,1150,2288
<class,경춘선,평내호평,3711,3632,7343
<class,경춘선,금곡,971,933,1904
<class,경춘선,사릉,1808,1899,3707
<class,경춘선,퇴계원,2222,2065,4287
<class,경춘선,별내,1952,1870,3822
<class,경춘선,갈매,1653,1483,3136
<class,경인선,도화,2672,2465,5137
<class,경인선,중동,5502,5202,10704
<class,경인선,온수,4154,3918,8072
<class,경인선,도원,1777,1878,3655
<class,경인선,구일,4032,3826,7858
<class,경인선,간석,3774,3646,7420
<class,경인선,부개,5579,5203,10782
<class,경인선,소사,5758,5801,11559
<class,경춘선,신내,902,915,1817
<class,1호선,서울역,20637,22061,42698
<class,1호선,동묘앞,8761,8998,17759
<class,1호선,시청,7348,7357,14705
<class,1호선,종각,13128,12573,25701
<class,1호선,종로3가,16366,15707,32073
<class,1호선,종로5가,13441,13566,27007
<class,1호선,동대문,8863,8072,16935
<class,1호선,신설동,7672,7110,14782
<class,1호선,제기동,13044,13400,26444
<class,1호선,청량리,15193,15556,30749
<class,2호선,시청,6115,5447,11562
<class,2호선,을지로입구,14958,15262,30220
<class,2호선,을지로3가,7238,7373,14611
<class,2호선,을지로4가,5379,5337,10716
<class,2호선,동대문역사문화공원,7467,7885,15352
<class,2호선,신당,8844,9016,17860
<class,2호선,상왕십리,7797,7324,15121
<class,2호선,왕십리,10024,8387,18411
<class,2호선,한양대,3559,3538,7097
<class,2호선,뚝섬,9857,10227,20084
<class,2호선,성수,13198,15001,28199
<class,2호선,건대입구,23893,25665,49558
<class,2호선,구의,13391,12822,26213
<class,2호선,강변,18906,20470,39376
<class,2호선,잠실나루,5978,5869,11847
<class,2호선,잠실,42242,40518,82760
<class,2호선,잠실새내,13642,13949,27591
<class,2호선,종합운동장,3664,4063,7727
<class,2호선,삼성,16920,17316,34236
<class,2호선,선릉,19349,17014,36363
<class,2호선,역삼,14045,15301,29346
<class,2호선,강남,45658,44727,90385
<class,2호선,교대,13921,15547,29468
<class,2호선,서초,8236,7153,15389
<class,2호선,방배,7929,8189,16118
<class,2호선,사당,21481,23301,44782
<class,2호선,낙성대,17524,16201,33725
<class,2호선,서울대입구,30505,29406,59911
<class,2호선,봉천,14777,13329,28106
<class,2호선,신림,41139,39165,80304
<class,2호선,신대방,16731,15932,32663
<class,2호선,구로디지털단지,27616,27289,54905
<class,2호선,대림,15587,16574,32161
<class,2호선,신도림,30709,30600,61309
<class,2호선,문래,9316,9644,18960
<class,2호선,영등포구청,10128,10258,20386
<class,2호선,당산,9726,10701,20427
<class,2호선,합정,19081,20296,39377
<class,2호선,홍대입구,36362,37574,73936
<class,2호선,신촌,21855,22076,43931
<class,2호선,이대,7764,7979,15743
<class,2호선,아현,6360,5975,12335
<class,2호선,충정로,4385,4544,8929
<class,2호선,용답,1807,1734,3541
<class,2호선,신답,812,839,1651
<class,2호선,신설동,2369,2415,4784
<class,2호선,도림천,737,685,1422
<class,2호선,양천구청,3524,3610,7134
<class,2호선,신정네거리,6023,6116,12139
<class,2호선,용두,1504,1437,2941
<class,3호선,지축,2266,2183,4449
<class,3호선,구파발,12539,12521,25060
<class,3호선,연신내,24988,23182,48170
<class,3호선,불광,10562,11818,22380
<class,3호선,녹번,8465,7435,15900
<class,3호선,홍제,10701,10057,20758
<class,3호선,무악재,2139,2171,4310
<class,3호선,독립문,4617,4655,9272
<class,3호선,경복궁,9993,10077,20070
<class,3호선,안국,8448,9360,17808
<class,3호선,종로3가,4366,5763,10129
<class,3호선,을지로3가,3598,3939,7537
<class,3호선,충무로,1,0,1
<class,3호선,동대입구,4701,4953,9654
<class,3호선,약수,7494,7233,14727
<class,3호선,금호,4823,4355,9178
<class,3호선,옥수,5586,5744,11330
<class,3호선,압구정,19880,20642,40522
<class,3호선,신사,18104,18977,37081
<class,3호선,잠원,2859,2728,5587
<class,3호선,고속터미널,31672,34146,65818
<class,3호선,교대,5431,3211,8642
<class,3호선,남부터미널,15295,16113,31408
<class,3호선,양재,15944,17183,33127
<class,3호선,매봉,5188,5014,10202
<class,3호선,도곡,2918,2837,5755
<class,3호선,대치,7590,6944,14534
<class,3호선,학여울,1777,1964,3741
<class,3호선,대청,4636,4307,8943
<class,3호선,일원,4279,4153,8432
<class,3호선,수서,10005,10574,20579
<class,3호선,가락시장,4973,4642,9615
<class,3호선,경찰병원,3386,3296,6682
<class,3호선,오금,3192,2958,6150
<class,4호선,수유,22213,21335,43548
<class,4호선,미아,9064,8661,17725
<class,4호선,미아사거리,18091,17392,35483
<class,4호선,길음,11336,10467,21803
<class,4호선,성신여대입구,13187,12476,25663
<class,4호선,한성대입구,8503,8256,16759
<class,4호선,혜화,18074,18617,36691
<class,4호선,동대문,11038,10821,21859
<class,4호선,동대문역사문화공원,8152,7010,15162
<class,4호선,충무로,9498,9892,19390
<class,4호선,명동,8925,10223,19148
<class,4호선,회현,12523,13290,25813
<class,4호선,서울역,4074,8169,12243
<class,4호선,숙대입구,6907,6540,13447
<class,4호선,삼각지,2383,2927,5310
<class,4호선,신용산,7586,8466,16052
<class,4호선,이촌,4657,5183,9840
<class,4호선,동작,1525,1557,3082
<class,4호선,총신대입구,11603,12384,23987
<class,4호선,사당,14439,12295,26734
<class,4호선,남태령,783,664,1447
<class,4호선,당고개,8653,8266,16919
<class,4호선,상계,11681,10948,22629
<class,4호선,노원,12994,14277,27271
<class,4호선,창동,16195,16968,33163
<class,4호선,쌍문,17843,16302,34145
<class,5호선,방화,4199,4100,8299
<class,5호선,개화산,3122,2999,6121
<class,5호선,김포공항,6147,6687,12834
<class,5호선,송정,4357,4281,8638
<class,5호선,마곡,4495,4529,9024
<class,5호선,발산,10562,11386,21948
<class,5호선,우장산,8119,7943,16062
<class,5호선,화곡,16620,15302,31922
<class,5호선,까치산,17905,17133,35038
<class,5호선,신정,7421,6305,13726
<class,5호선,목동,9447,9535,18982
<class,5호선,오목교,13677,14212,27889
<class,5호선,양평,2921,2840,5761
<class,5호선,영등포구청,1693,1626,3319
<class,5호선,영등포시장,5559,5603,11162
<class,5호선,신길,2087,2092,4179
<class,5호선,여의도,7218,7834,15052
<class,5호선,여의나루,5833,6386,12219
<class,5호선,마포,5764,5814,11578
<class,5호선,공덕,5245,5454,10699
<class,5호선,애오개,3166,2918,6084
<class,5호선,충정로,1573,1474,3047
<class,5호선,서대문,5485,5342,10827
<class,5호선,광화문,10062,10638,20700
<class,5호선,종로3가,7611,7883,15494
<class,5호선,을지로4가,2504,2742,5246
<class,5호선,동대문역사문화공원,762,994,1756
<class,5호선,청구,2172,1853,4025
<class,5호선,신금호,3496,3541,7037
<class,5호선,행당,4689,4054,8743
<class,5호선,왕십리,2774,3187,5961
<class,5호선,마장,3122,2905,6027
<class,5호선,답십리,8660,7791,16451
<class,5호선,장한평,9354,8994,18348
<class,5호선,군자,6930,7642,14572
<class,5호선,아차산,9769,9417,19186
<class,5호선,광나루,7965,7523,15488
<class,5호선,천호,13423,12793,26216
<class,5호선,강동,10208,9788,19996
<class,5호선,길동,5093,5192,10285
<class,5호선,굽은다리,6567,6231,12798
<class,5호선,명일,5027,5043,10070
<class,5호선,고덕,5079,4924,10003
<class,5호선,상일동,7996,7309,15305
<class,5호선,둔촌동,6300,6205,12505
<class,5호선,올림픽공원,2390,2109,4499
<class,5호선,방이,4335,4340,8675
<class,5호선,오금,2036,1908,3944
<class,5호선,개롱,3981,4191,8172
<class,5호선,거여,4887,4618,9505
<class,5호선,마천,3686,3770,7456
<class,5호선,강일,1845,1717,3562
<class,5호선,미사,9189,9192,18381
<class,5호선,하남풍산,2201,2371,4572
<class,5호선,하남시청,3642,3634,7276
<class,5호선,하남검단산,3575,3562,7137
<class,6호선,응암,10779,10577,21356
<class,6호선,역촌,2486,2705,5191
<class,6호선,불광,3318,3073,6391
<class,6호선,독바위,1775,1982,3757
<class,6호선,연신내,1,0,1
<class,6호선,구산,4505,3535,8040
<class,6호선,새절,7837,7483,15320
<class,6호선,증산,6422,6322,12744
<class,6호선,디지털미디어시티,5999,5991,11990
<class,6호선,월드컵경기장,3764,3878,7642
<class,6호선,마포구청,7940,7203,15143
<class,6호선,망원,9504,10315,19819
<class,6호선,합정,8769,8168,16937
<class,6호선,상수,5233,5951,11184
<class,6호선,광흥창,4255,3796,8051
<class,6호선,대흥,4337,4294,8631
<class,6호선,공덕,7675,7218,14893
<class,6호선,효창공원앞,3779,3218,6997
<class,6호선,삼각지,3460,2764,6224
<class,6호선,녹사평,3176,3156,6332
<class,6호선,이태원,7004,7667,14671
<class,6호선,한강진,5204,6126,11330
<class,6호선,버티고개,1075,1152,2227
<class,6호선,약수,2050,2053,4103
<class,6호선,청구,2018,1951,3969
<class,6호선,신당,4725,3987,8712
<class,6호선,동묘앞,6247,5802,12049
<class,6호선,창신,1822,1514,3336
<class,6호선,보문,4217,3773,7990
<class,6호선,안암,4689,4443,9132
<class,6호선,고려대,4322,3966,8288
<class,6호선,월곡,6338,6303,12641
<class,6호선,상월곡,3566,3101,6667
<class,6호선,돌곶이,5135,4663,9798
<class,6호선,석계,7566,7476,15042
<class,6호선,태릉입구,3220,3388,6608
<class,6호선,화랑대,5586,4744,10330
<class,6호선,봉화산,4438,4307,8745
<class,6호선,신내,1,0,1
<class,7호선,장암,1232,877,2109
<class,7호선,도봉산,5248,7197,12445
<class,7호선,수락산,8637,8568,17205
<class,7호선,마들,7553,7192,14745
<class,7호선,노원,13224,13903,27127
<class,7호선,중계,8104,7230,15334
<class,7호선,하계,10313,9603,19916
<class,7호선,공릉,7289,7128,14417
<class,7호선,태릉입구,5443,5125,10568
<class,7호선,먹골,6594,6359,12953
<class,7호선,중화,7161,6844,14005
<class,7호선,상봉,11177,10813,21990
<class,7호선,면목,9719,9468,19187
<class,7호선,사가정,10641,10352,20993
<class,7호선,용마산,3940,3935,7875
<class,7호선,중곡,6002,5527,11529
<class,7호선,군자,9212,7117,16329
<class,7호선,어린이대공원,7953,7416,15369
<class,7호선,건대입구,8398,8013,16411
<class,7호선,뚝섬유원지,6002,5802,11804
<class,7호선,청담,9435,9825,19260
<class,7호선,강남구청,7887,8701,16588
<class,7호선,학동,8943,9330,18273
<class,7호선,논현,9588,10296,19884
<class,7호선,반포,3535,3424,6959
<class,7호선,고속터미널,9448,8011,17459
<class,7호선,내방,6558,6485,13043
<class,7호선,이수,9709,8991,18700
<class,7호선,남성,6712,6327,13039
<class,7호선,숭실대입구,6637,6566,13203
<class,7호선,상도,6304,5746,12050
<class,7호선,장승배기,5862,5505,11367
<class,7호선,신대방삼거리,9719,9063,18782
<class,7호선,보라매,5567,5288,10855
<class,7호선,신풍,6965,6742,13707
<class,7호선,대림,6122,6256,12378
<class,7호선,남구로,7637,7900,15537
<class,7호선,가산디지털단지,12122,11109,23231
<class,7호선,철산,12339,12614,24953
<class,7호선,광명사거리,14390,14539,28929
<class,7호선,천왕,5898,5617,11515
<class,7호선,온수,5112,4834,9946
<class,7호선,까치울,4653,4717,9370
<class,7호선,부천종합운동장,2863,2566,5429
<class,7호선,춘의,4399,4261,8660
<class,7호선,신중동,8200,8180,16380
<class,7호선,부천시청,8443,8408,16851
<class,7호선,상동,8676,8876,17552
<class,7호선,삼산체육관,3093,2798,5891
<class,7호선,굴포천,5568,5785,11353
<class,7호선,부평구청,4290,3831,8121
<class,8호선,암사,10387,9655,20042
<class,8호선,천호,9636,11338,20974
<class,8호선,강동구청,5171,5081,10252
<class,8호선,몽촌토성,3434,3331,6765
<class,8호선,잠실,9214,10797,20011
<class,8호선,석촌,4828,5660,10488
<class,8호선,송파,4648,4509,9157
<class,8호선,가락시장,4469,4566,9035
<class,8호선,문정,6675,6665,13340
<class,8호선,장지,10186,9588,19774
<class,8호선,복정,5733,5061,10794
<class,8호선,산성,3709,3608,7317
<class,8호선,남한산성입구,7375,6752,14127
<class,8호선,단대오거리,6331,5998,12329
<class,8호선,신흥,3289,3405,6694
<class,8호선,수진,3628,3182,6810
<class,8호선,모란,3011,2715,5726
<class,9호선,개화,1130,1037,2167
<class,9호선,김포공항,6416,11168,17584
<class,9호선,공항시장,2013,2108,4121
<class,9호선,신방화,3953,3713,7666
<class,9호선,마곡나루,6214,6147,12361
<class,9호선,양천향교,4930,4864,9794
<class,9호선,가양,11422,10900,22322
<class,9호선,증미,3533,3513,7046
<class,9호선,등촌,6373,6144,12517
<class,9호선,염창,9643,8775,18418
<class,9호선,신목동,1920,1677,3597
<class,9호선,선유도,3195,3059,6254
<class,9호선,당산,9875,9295,19170
<class,9호선,국회의사당,3064,3197,6261
<class,9호선,여의도,7373,6916,14289
<class,9호선,샛강,1992,1976,3968
<class,9호선,노량진,16970,16497,33467
<class,9호선,노들,2699,2242,4941
<class,9호선,흑석,4404,4353,8757
<class,9호선,동작,1149,878,2027
<class,9호선,구반포,1524,1622,3146
<class,9호선,신반포,1968,1959,3927
<class,9호선,고속터미널,8547,12117,20664
<class,9호선,사평,1746,1626,3372
<class,9호선,신논현,18947,18981,37928
<class,9호선2~3단계,언주,4722,4643,9365
<class,9호선2~3단계,선정릉,3630,3938,7568
<class,9호선2~3단계,삼성중앙,2390,2414,4804
<class,9호선2~3단계,봉은사,7656,7627,15283
<class,9호선2~3단계,종합운동장,2632,2361,4993
<class,9호선2~3단계,삼전,3977,3771,7748
<class,9호선2~3단계,석촌고분,3400,3219,6619
<class,9호선2~3단계,석촌,5058,4131,9189
<class,9호선2~3단계,송파나루,3096,3281,6377
<class,9호선2~3단계,한성백제,1430,1263,2693
<class,9호선2~3단계,올림픽공원,3491,3499,6990
<class,9호선2~3단계,둔촌오륜,606,586,1192
<class,9호선2~3단계,중앙보훈병원,3716,3369,7085
<class,경강선,판교,2357,2200,4557
<class,경강선,이매,655,523,1178
<class,경강선,삼동,1270,1213,2483
<class,경강선,경기광주,4064,4058,8122
<class,경강선,초월,1743,1649,3392
<class,경강선,곤지암,1594,1810,3404
<class,경강선,신둔도예촌,850,901,1751
<class,경강선,이천,1953,2139,4092
<class,경강선,부발,1390,1297,2687
<class,경강선,세종대왕릉,214,250,464
<class,경강선,여주,1640,1985,3625
<class,경부선,서울역,3864,1354,5218
<class,경부선,남영,4783,4837,9620
<class,경부선,용산,24079,27204,51283
<class,경부선,노량진,6409,5703,12112
<class,경부선,대방,6348,6365,12713
<class,경부선,영등포,28436,29905,58341
<class,경부선,신도림,2401,2410,4811
<class,경부선,신길,5396,4329,9725
<class,경부선,구로,10860,11111,21971
<class,경부선,가산디지털단지,5196,6635,11831
<class,경부선,금천구청,6808,6752,13560
<class,경부선,석수,5299,4863,10162
<class,경부선,관악,4768,4671,9439
<class,경부선,안양,14038,14153,28191
<class,경부선,명학,4011,3893,7904
<class,경부선,금정,14897,15035,29932
<class,경부선,군포,3696,3430,7126
<class,경부선,의왕,4959,4737,9696
<class,경부선,성균관대,8395,8259,16654
<class,경부선,화서,4159,4218,8377
<class,경부선,수원,29020,31532,60552
<class,경부선,독산,7059,7058,14117
<class,경부선,세류,2132,2217,4349
<class,경부선,병점,9718,9489,19207
<class,경부선,세마,1815,1615,3430
<class,경부선,오산대,2293,2058,4351
<class,경부선,오산,7709,7309,15018
<class,경부선,진위,870,787,1657
<class,경부선,송탄,3767,3471,7238
<class,경부선,서정리,5080,4286,9366
<class,경부선,평택지제,2253,2107,4360
<class,경부선,평택,10771,10422,21193
<class,경부선,성환,2517,2403,4920
<class,경부선,당정,3357,3255,6612
<class,경부선,서동탄,758,800,1558
<class,경부선,광명,1856,1806,3662
<class,경원선,이촌,2449,1839,4288
<class,경원선,서빙고,1079,957,2036
<class,경원선,한남,2414,2184,4598
<class,경원선,옥수,37,27,64
<class,경원선,응봉,1116,909,2025
<class,분당선,매교,1204,1142,2346
<class,2호선,낙성대,12045,12520,24565
<class,2호선,서울대입구,20979,21671,42650
<class,2호선,봉천,9584,9420,19004
<class,2호선,신림,28441,28777,57218
<class,2호선,신대방,11895,11691,23586
<class,2호선,구로디지털단지,17776,17502,35278
<class,2호선,대림,11324,11453,22777
<class,2호선,신도림,20640,20851,41491
<class,2호선,문래,5442,5803,11245
<class,2호선,영등포구청,5895,6050,11945
<class,2호선,당산,6201,6736,12937
<class,2호선,합정,13201,13699,26900
<class,2호선,홍대입구,26005,25978,51983
<class,2호선,신촌,15452,15281,30733
<class,2호선,이대,5182,5595,10777
<class,2호선,아현,3947,3973,7920
<class,2호선,충정로,2679,2782,5461
<class,2호선,용답,1316,1292,2608
<class,2호선,신답,548,618,1166
<class,2호선,신설동,1798,1908,3706
<class,2호선,도림천,404,426,830
<class,2호선,양천구청,2549,2690,5239
<class,2호선,신정네거리,3853,3899,7752
<class,2호선,용두,803,879,1682
<class,3호선,지축,1502,1432,2934
<class,3호선,구파발,8563,8811,17374
<class,3호선,연신내,16532,15870,32402
<class,3호선,불광,7251,8433,15684
<class,3호선,녹번,5498,4930,10428
<class,3호선,홍제,6734,6528,13262
<class,3호선,무악재,1460,1442,2902
<class,3호선,독립문,2941,2937,5878
<class,3호선,경복궁,6998,7428,14426
<class,3호선,안국,5794,6118,11912
<class,3호선,종로3가,2678,3369,6047
<class,3호선,을지로3가,2220,2055,4275
<class,3호선,동대입구,4120,4427,8547
<class,3호선,약수,4970,4760,9730
<class,3호선,금호,3248,3113,6361
<class,3호선,옥수,3747,4032,7779
<class,3호선,압구정,10376,10787,21163
<class,3호선,신사,9087,9271,18358
<class,3호선,잠원,1481,1585,3066
<class,3호선,고속터미널,26981,24466,51447
<class,3호선,교대,3297,2088,5385
<class,3호선,남부터미널,10611,10878,21489
<class,3호선,양재,9541,11080,20621
<class,3호선,매봉,3478,3487,6965
<class,3호선,도곡,1563,1550,3113
<class,3호선,대치,4548,4004,8552
<class,3호선,학여울,568,595,1163
<class,3호선,대청,3007,3027,6034
<class,3호선,일원,2373,2555,4928
<class,3호선,수서,7856,7520,15376
<class,3호선,가락시장,2657,2947,5604
<class,3호선,경찰병원,2046,2098,4144
<class,3호선,오금,2014,1994,4008
<class,4호선,수유,15235,14899,30134
<class,4호선,미아,6170,5891,12061
<class,4호선,미아사거리,11922,11550,23472
<class,4호선,길음,7321,7199,14520
<class,4호선,성신여대입구,9434,9023,18457
<class,4호선,한성대입구,5819,5869,11688
<class,4호선,혜화,14085,14786,28871
<class,4호선,동대문,4375,5073,9448
<class,4호선,동대문역사문화공원,6115,5977,12092
<class,4호선,충무로,5442,5665,11107
<class,4호선,명동,6575,6685,13260
<class,4호선,회현,5834,5869,11703
<class,4호선,서울역,2851,5825,8676
<class,4호선,숙대입구,4830,4685,9515
<class,4호선,삼각지,1602,2156,3758
<class,4호선,신용산,5813,5896,11709
<class,4호선,이촌,3287,3603,6890
<class,4호선,동작,1102,1105,2207
<class,4호선,총신대입구,7711,8365,16076
<class,4호선,사당,10060,9443,19503
<class,4호선,남태령,444,423,867
<class,4호선,당고개,6240,6156,12396
<class,4호선,상계,7856,7356,15212
<class,4호선,노원,9028,9755,18783
<class,4호선,창동,10623,11281,21904
<class,4호선,쌍문,12287,11094,23381
<class,5호선,개화산,2043,2139,4182
<class,5호선,김포공항,5639,5366,11005
<class,5호선,송정,2908,2986,5894
<class,5호선,마곡,2740,2852,5592
<class,5호선,발산,6561,6823,13384
<class,5호선,우장산,4884,5128,10012
<class,5호선,화곡,10843,10137,20980
<class,5호선,까치산,12429,12473,24902
<class,5호선,신정,5010,4592,9602
<class,5호선,목동,5867,6000,11867
<class,5호선,오목교,8855,9279,18134
<class,5호선,양평,1980,2014,3994
<class,5호선,영등포구청,992,960,1952
<class,5호선,영등포시장,3291,3534,6825
<class,5호선,신길,1459,1576,3035
<class,5호선,여의도,4543,4991,9534
<class,5호선,여의나루,4313,4545,8858
<class,5호선,마포,3368,3374,6742
<class,5호선,공덕,3317,3297,6614
<class,5호선,애오개,1919,1948,3867
<class,5호선,충정로,1156,1145,2301
<class,5호선,서대문,3752,3685,7437
<class,5호선,광화문,7687,8116,15803
<class,5호선,종로3가,5172,4906,10078
<class,5호선,을지로4가,982,1070,2052
<class,5호선,동대문역사문화공원,562,580,1142
<class,5호선,청구,1333,1206,2539
<class,5호선,신금호,2163,2376,4539
<class,5호선,행당,2858,2664,5522
<class,5호선,왕십리,1854,2013,3867
<class,5호선,마장,2126,2040,4166
<class,5호선,답십리,5557,5163,10720
<class,5호선,장한평,5585,5810,11395
<class,5호선,군자,4529,5020,9549
<class,5호선,아차산,6958,6882,13840
<class,5호선,광나루,5358,5128,10486
<class,5호선,천호,8874,8480,17354
<class,5호선,강동,6493,6565,13058
<class,5호선,길동,3329,3422,6751
<class,5호선,굽은다리,4158,3932,8090
<class,5호선,명일,3278,3432,6710
<class,5호선,고덕,3115,3067,6182
<class,5호선,상일동,5258,5009,10267
<class,5호선,둔촌동,3446,3527,6973
<class,5호선,올림픽공원,1552,1305,2857
<class,5호선,방이,3021,2934,5955
<class,5호선,오금,1215,1132,2347
<class,5호선,개롱,2295,2478,4773
<class,5호선,거여,2910,2863,5773
<class,5호선,마천,2648,2788,5436
<class,5호선,강일,1237,1211,2448
<class,5호선,미사,6157,6261,12418
<class,5호선,하남풍산,1593,1639,3232
<class,5호선,하남시청,2489,2433,4922
<class,5호선,하남검단산,2738,2799,5537
<class,6호선,응암,7075,7052,14127
<class,6호선,역촌,1561,1844,3405
<class,6호선,불광,2399,2113,4512
<class,6호선,독바위,1209,1448,2657
<class,6호선,구산,3053,2303,5356
<class,6호선,새절,5169,5028,10197
<class,6호선,증산,4290,4324,8614
<class,6호선,디지털미디어시티,3710,4025,7735
<class,6호선,월드컵경기장,2434,2516,4950
<class,6호선,마포구청,5649,5324,10973
<class,6호선,망원,6347,7012,13359
<class,6호선,합정,6249,5675,11924
<class,6호선,상수,3702,4243,7945
<class,6호선,광흥창,3103,3006,6109
<class,6호선,대흥,2979,3035,6014
<class,6호선,공덕,4910,4563,9473
<class,6호선,효창공원앞,2487,2243,4730
<class,6호선,삼각지,2469,1960,4429
<class,6호선,녹사평,2293,2290,4583
<class,6호선,이태원,5485,5441,10926
<class,6호선,한강진,4730,5252,9982
<class,6호선,버티고개,730,882,1612
<class,6호선,약수,1422,1372,2794
<class,6호선,청구,1269,1229,2498
<class,6호선,신당,2743,3416,6159
<class,6호선,동묘앞,4196,4164,8360
<class,6호선,창신,1284,1144,2428
<class,6호선,보문,3104,2788,5892
<class,6호선,안암,3497,3720,7217
<class,6호선,고려대,3112,2924,6036
<class,6호선,월곡,4041,4117,8158
<class,6호선,상월곡,2474,2189,4663
<class,6호선,돌곶이,3798,3731,7529
<class,6호선,석계,5034,5071,10105
<class,6호선,태릉입구,2290,2416,4706
<class,6호선,화랑대,3766,3309,7075
<class,6호선,봉화산,2948,2944,5892
<class,6호선,신내,1,0,1
<class,7호선,장암,1065,813,1878
<class,7호선,도봉산,3870,5385,9255
<class,7호선,수락산,6097,6147,12244
<class,7호선,마들,4494,4251,8745
<class,7호선,노원,8397,8540,16937
<class,7호선,중계,5134,4742,9876
<class,7호선,하계,6566,6328,12894
<class,7호선,공릉,4818,4948,9766
<class,7호선,태릉입구,3725,3382,7107
<class,7호선,먹골,4195,4182,8377
<class,7호선,중화,4655,4513,9168
<class,7호선,상봉,7036,6549,13585
<class,7호선,면목,6261,6258,12519
<class,7호선,사가정,7083,7011,14094
<class,7호선,용마산,2663,2772,5435
<class,7호선,중곡,3792,3797,7589
<class,7호선,군자,5958,4819,10777
<class,7호선,어린이대공원,5280,5305,10585
<class,7호선,건대입구,5289,5182,10471
<class,7호선,뚝섬유원지,4193,3964,8157
<class,7호선,청담,5265,5398,10663
<class,7호선,강남구청,4238,4633,8871
<class,7호선,학동,4453,4829,9282
<class,7호선,논현,4951,5297,10248
<class,7호선,반포,2108,2148,4256
<class,7호선,고속터미널,8712,5454,14166
<class,7호선,내방,3975,4076,8051
<class,7호선,이수,6200,6076,12276
<class,7호선,남성,4146,4245,8391
<class,7호선,숭실대입구,4517,4751,9268
<class,7호선,상도,3913,3980,7893
<class,7호선,장승배기,3809,3859,7668
<class,7호선,신대방삼거리,6293,6229,12522
<class,7호선,보라매,3364,3417,6781
<class,7호선,신풍,4762,4603,9365
<class,7호선,대림,5151,4833,9984
<class,7호선,남구로,5518,5492,11010
<class,7호선,가산디지털단지,8102,7555,15657
<class,7호선,철산,8035,8130,16165
<class,7호선,광명사거리,9670,9506,19176
<class,7호선,천왕,3878,3689,7567
<class,7호선,온수,3059,3078,6137
<class,7호선,까치울,3242,3227,6469
<class,7호선,부천종합운동장,1948,1759,3707
<class,7호선,춘의,2749,2641,5390
<class,7호선,신중동,5157,5058,10215
<class,7호선,부천시청,5515,5337,10852
<class,7호선,상동,5436,5343,10779
<class,7호선,삼산체육관,1974,1791,3765
<class,7호선,굴포천,3678,3747,7425
<class,7호선,부평구청,2832,2585,5417
<class,8호선,암사,6913,6483,13396
<class,8호선,천호,6630,7720,14350
<class,8호선,강동구청,3343,3570,6913
<class,8호선,몽촌토성,2364,2365,4729
<class,8호선,잠실,6574,7209,13783
<class,8호선,석촌,3258,3937,7195
<class,8호선,송파,2658,2769,5427
<class,8호선,가락시장,2321,3079,5400
<class,8호선,문정,3947,4180,8127
<class,8호선,장지,6973,7289,14262
<class,8호선,복정,3706,3413,7119
<class,8호선,산성,2519,2637,5156
<class,8호선,남한산성입구,5087,4779,9866
<class,8호선,단대오거리,4219,4219,8438
<class,8호선,신흥,2225,2314,4539
<class,8호선,수진,2330,2059,4389
<class,8호선,모란,2015,1774,3789
<class,9호선,개화,813,789,1602
<class,9호선,김포공항,6141,9418,15559
<class,9호선,공항시장,1340,1548,2888
<class,9호선,신방화,2533,2623,5156
<class,9호선,마곡나루,4032,4153,8185
<class,9호선,양천향교,3120,3354,6474
<class,9호선,가양,7674,7735,15409
<class,9호선,증미,1942,1988,3930
<class,9호선,등촌,4070,4152,8222
<class,9호선,염창,6227,6150,12377
<class,9호선,신목동,1284,1179,2463
<class,9호선,선유도,2082,2108,4190
<class,9호선,당산,6292,6306,12598
<class,9호선,국회의사당,3268,3073,6341
<class,9호선,여의도,4916,4596,9512
<class,9호선,샛강,1206,1250,2456
<class,9호선,노량진,11051,11760,22811
<class,9호선,노들,1937,1651,3588
<class,9호선,흑석,2883,3040,5923
<class,9호선,동작,859,677,1536
<class,9호선,구반포,806,875,1681
<class,9호선,신반포,1153,1194,2347
<class,9호선,고속터미널,7002,8439,15441
<class,9호선,사평,999,1072,2071
<class,9호선,신논현,10914,10609,21523
<class,9호선2~3단계,언주,2677,2750,5427
<class,9호선2~3단계,선정릉,2242,2571,4813
<class,9호선2~3단계,삼성중앙,1417,1444,2861
<class,9호선2~3단계,봉은사,4635,4541,9176
<class,9호선2~3단계,종합운동장,1697,1563,3260
<class,9호선2~3단계,삼전,2718,2788,5506
<class,9호선2~3단계,석촌고분,2349,2397,4746
<class,9호선2~3단계,석촌,3413,2937,6350
<class,9호선2~3단계,송파나루,2150,2328,4478
<class,9호선2~3단계,한성백제,998,907,1905
<class,9호선2~3단계,올림픽공원,2149,2208,4357
<class,9호선2~3단계,둔촌오륜,338,384,722
<class,9호선2~3단계,중앙보훈병원,2426,2370,4796
<class,경강선,판교,1896,1668,3564
<class,경강선,이매,521,374,895
<class,경강선,삼동,803,771,1574
<class,경강선,경기광주,2711,2707,5418
<class,경강선,초월,1250,1208,2458
<class,경강선,곤지암,1184,1358,2542
<class,경강선,신둔도예촌,631,581,1212
<class,경강선,이천,1477,1676,3153
<class,경강선,부발,906,1488,2394
<class,경강선,세종대왕릉,177,181,358
<class,경강선,여주,1450,1382,2832
<class,경부선,서울역,5154,1045,6199
<class,경부선,남영,3186,3409,6595
<class,경부선,용산,22908,19894,42802
<class,경부선,노량진,4150,3922,8072
<class,경부선,대방,4302,4787,9089
<class,경부선,영등포,22375,21463,43838
<class,경부선,신도림,1717,1693,3410
<class,경부선,신길,3812,3366,7178
<class,경부선,구로,7365,7657,15022
<class,경부선,가산디지털단지,3536,4795,8331
<class,경부선,금천구청,4781,4825,9606
<class,경부선,석수,3863,3715,7578
<class,경부선,관악,3510,3214,6724
<class,경부선,안양,10219,9934,20153
<class,경부선,명학,2633,2610,5243
<class,경부선,금정,10409,10836,21245
<class,경부선,군포,2426,2311,4737
<class,경부선,의왕,3312,3348,6660
<class,경부선,성균관대,5888,6232,12120
<class,경부선,화서,3132,2949,6081
<class,경부선,수원,25250,24388,49638
<class,경부선,독산,4499,4748,9247
<class,경부선,세류,1565,1630,3195
<class,경부선,병점,6870,7673,14543
<class,경부선,세마,1329,1286,2615
<class,경부선,오산대,1638,1640,3278
<class,경부선,오산,5988,6505,12493
<class,경부선,진위,704,716,1420
<class,경부선,송탄,2786,3086,5872
<class,경부선,서정리,3403,4671,8074
<class,경부선,평택지제,1815,1622,3437
<class,경부선,평택,9024,9396,18420
<class,경부선,성환,2141,2434,4575
<class,경부선,직산,437,520,957
<class,경부선,두정,4274,4361,8635
<class,경부선,천안,5161,4753,9914
<class,경부선,당정,2295,2327,4622
<class,경부선,서동탄,588,586,1174
<class,경부선,광명,1789,1218,3007
<class,경원선,이촌,1646,1385,3031
<class,경원선,서빙고,953,995,1948
<class,경원선,한남,1472,1516,2988
<class,경원선,옥수,55,24,79
<class,경원선,응봉,792,725,1517
<class,경원선,왕십리,6535,7676,14211
<class,경원선,청량리,10747,9431,20178
<class,경원선,외대앞,3772,3701,7473
<class,경원선,신이문,3639,3454,7093
<class,경원선,석계,3616,3953,7569
<class,경원선,광운대,3184,3243,6427
<class,경원선,월계,2853,2629,5482
<class,경원선,녹천,2077,1799,3876
<class,경원선,방학,4552,4388,8940
<class,경원선,도봉,2688,2515,5203
<class,경원선,도봉산,5820,4161,9981
<class,경원선,망월사,3707,3617,7324
<class,경원선,회룡,5326,5416,10742
<class,경원선,의정부,10373,10575,20948
<class,경원선,가능,3178,3025,6203
<class,경원선,녹양,2092,2088,4180
<class,경원선,양주,3674,3570,7244
<class,경원선,덕계,1362,1253,2615
<class,경원선,덕정,2583,2731,5314
<class,경원선,지행,3301,3240,6541
<class,경원선,동두천중앙,1676,1608,3284
<class,경원선,보산,987,864,1851
<class,경원선,동두천,1066,1290,2356
<class,경원선,소요산,3283,2750,6033
<class,경의선,서울역,785,715,1500
<class,경의선,신촌,175,175,350
<class,경의선,효창공원앞,938,1075,2013
<class,경의선,공덕,1259,1094,2353
<class,경의선,서강대,942,955,1897
<class,경의선,홍대입구,967,1094,2061
<class,경의선,가좌,2004,2122,4126
<class,경의선,디지털미디어시티,1011,935,1946
<class,경의선,수색,701,802,1503
<class,경의선,화전,625,627,1252
<class,경의선,강매,1105,1019,2124
<class,경의선,행신,3236,3190,6426
<class,경의선,능곡,1678,1687,3365
<class,경의선,곡산,226,227,453
<class,경의선,백마,2425,2446,4871
<class,경의선,풍산,2692,2629,5321
<class,경의선,일산,3427,3253,6680
<class,경의선,탄현,3227,2972,6199
<class,경의선,야당,3285,3275,6560
<class,경의선,운정,2742,2660,5402
<class,경의선,금릉,2205,2145,4350
<class,경의선,금촌,3622,3810,7432
<class,경의선,월롱,669,1393,2062
<class,경의선,파주,504,431,935
<class,경의선,문산,2766,2778,5544
<class,경의선,임진강,43,46,89
<class,경인선,개봉,9101,8983,18084
<class,경인선,오류동,5507,5135,10642
<class,경인선,역곡,10751,10730,21481
<class,경인선,부천,16755,16277,33032
<class,경인선,송내,10277,10053,20330
<class,경인선,부평,17447,17673,35120
<class,경인선,백운,3117,3120,6237
<class,경인선,동암,7568,7483,15051
<class,경인선,주안,8986,8039,17025
<class,경인선,제물포,4233,4105,8338
<class,경인선,동인천,6887,6716,13603
<class,경인선,인천,2583,2015,4598
<class,경인선,구일,2447,2460,4907
<class,경인선,소사,4116,3942,8058
<class,경인선,부개,3661,3487,7148
<class,경인선,간석,2499,2368,4867
<class,경인선,도원,1241,1303,2544
<class,경인선,온수,2761,2607,5368
<class,경인선,중동,3838,3567,7405
<class,경인선,도화,1869,1686,3555
<class,경춘선,신내,660,669,1329
<class,경춘선,갈매,1107,978,2085
<class,경춘선,별내,1454,1337,2791
<class,경춘선,퇴계원,1593,1549,3142
<class,경춘선,사릉,1313,1422,2735
<class,경춘선,금곡,746,690,1436
<class,경춘선,평내호평,2552,2527,5079
<class,경춘선,천마산,907,859,1766
<class,경춘선,마석,1946,1866,3812
<class,경춘선,대성리,566,427,993
<class,경춘선,청평,1334,1088,2422
<class,경춘선,상천,290,236,526
<class,경춘선,가평,1832,1382,3214
<class,경춘선,굴봉산,193,148,341
<class,경춘선,백양리,135,92,227
<class,경춘선,강촌,607,452,1059
<class,경춘선,김유정,281,264,545
<class,경춘선,남춘천,1690,1724,3414
<class,경춘선,춘천,1046,918,1964
<class,공항철도 1호선,서울역,5281,4179,9460
<class,공항철도 1호선,공덕,810,1081,1891
<class,공항철도 1호선,홍대입구,5258,5048,10306
<class,공항철도 1호선,디지털미디어시티,2681,2655,5336
<class,공항철도 1호선,마곡나루,1553,1695,3248
<class,공항철도 1호선,김포공항,10119,5058,15177
<class,공항철도 1호선,계양,3660,3616,7276
<class,공항철도 1호선,검암,2703,2713,5416
<class,공항철도 1호선,청라국제도시,2325,2215,4540
<class,공항철도 1호선,운서,3829,4124,7953
<class,공항철도 1호선,공항화물청사,902,986,1888
<class,공항철도 1호선,인천공항1터미널,2803,2761,5564
<class,공항철도 1호선,인천공항2터미널,1549,1459,3008
<class,공항철도 1호선,영종,1740,1760,3500
<class,과천선,선바위,2557,2463,5020
<class,과천선,경마공원,710,691,1401
<class,과천선,대공원,2199,2322,4521
<class,과천선,과천,2198,2109,4307
<class,과천선,정부과천청사,3081,3198,6279
<class,과천선,인덕원,8138,8129,16267
<class,과천선,평촌,4699,4550,9249
<class,과천선,범계,10596,10256,20852
<class,분당선,선릉,2189,3173,5362
<class,분당선,한티,6710,6476,13186
<class,분당선,도곡,1928,1814,3742
<class,분당선,구룡,522,600,1122
<class,분당선,개포동,1379,1395,2774
<class,분당선,대모산입구,1250,1193,2443
<class,분당선,수서,6537,5774,12311
<class,분당선,수원,4545,3755,8300
<class,분당선,서울숲,3448,3394,6842
<class,분당선,압구정로데오,7369,8189,15558
<class,분당선,강남구청,2563,3016,5579
<class,분당선,선정릉,1608,1666,3274
<class,분당선,가천대,2886,3462,6348
<class,분당선,태평,6548,6026,12574
<class,분당선,모란,8675,8844,17519
<class,분당선,야탑,9749,10008,19757
<class,분당선,서현,10478,10650,21128
<class,분당선,수내,4986,4875,9861
<class,분당선,정자,5853,6030,11883
<class,분당선,미금,5512,6081,11593
<class,분당선,오리,4260,3732,7992
<class,분당선,이매,2281,2384,4665
<class,분당선,보정,834,790,1624
<class,분당선,죽전,5768,6697,12465
<class,분당선,구성,1691,1848,3539
<class,분당선,신갈,1465,1496,2961
<class,분당선,기흥,3923,3759,7682
<class,분당선,상갈,2229,2263,4492
<class,분당선,청명,1406,1495,2901
<class,분당선,영통,3653,3657,7310
<class,분당선,망포,4844,5161,10005
<class,분당선,매탄권선,1912,1895,3807
<class,분당선,수원시청,5893,5920,11813
<class,2호선,사당,14354,16067,30421
<class,수인선,고색,1239,1353,2592
<class,수인선,오목천,1178,1179,2357
<class,수인선,어천,397,509,906
<class,수인선,야목,123,97,220
<class,수인선,사리,1983,1645,3628
<class,수인선,달월,44,45,89
<class,2호선,신당,5859,6216,12075
<class,2호선,동대문역사문화공원,5180,6182,11362
<class,2호선,을지로4가,2376,2103,4479
<class,2호선,을지로3가,5359,5010,10369
<class,2호선,을지로입구,11167,10658,21825
<class,우이신설선,가오리,1844,1807,3651
<class,우이신설선,화계,1644,1559,3203
<class,우이신설선,삼양,915,949,1864
<class,우이신설선,삼양사거리,1192,1181,2373
<class,우이신설선,솔샘,1967,1870,3837
<class,우이신설선,북한산보국문,2671,2547,5218
<class,우이신설선,정릉,1949,1720,3669
<class,우이신설선,성신여대입구,1616,1833,3449
<class,우이신설선,보문,791,782,1573
<class,우이신설선,신설동,881,842,1723
<class,일산선,원흥,4201,4069,8270
<class,일산선,삼송,7740,7718,15458
<class,일산선,원당,4819,4704,9523
<class,일산선,화정,7178,7370,14548
<class,일산선,대곡,841,740,1581
<class,일산선,백석,4312,4245,8557
<class,일산선,마두,2593,2495,5088
<class,일산선,정발산,3757,3682,7439
<class,일산선,주엽,3274,3206,6480
<class,일산선,대화,4661,4361,9022
<class,장항선,봉명,450,451,901
<class,장항선,쌍용,911,903,1814
<class,장항선,아산,2388,1634,4022
<class,장항선,배방,596,660,1256
<class,장항선,온양온천,2575,2507,5082
<class,장항선,신창,769,865,1634
<class,중앙선,회기,11735,11674,23409
<class,중앙선,중랑,2625,2637,5262
<class,중앙선,상봉,3194,3186,6380
<class,중앙선,망우,3668,3654,7322
<class,중앙선,양원,640,696,1336
<class,중앙선,구리,5711,6100,11811
<class,중앙선,도농,3578,3612,7190
<class,중앙선,양정,396,340,736
<class,중앙선,덕소,2572,2602,5174
<class,중앙선,도심,922,837,1759
<class,중앙선,팔당,972,930,1902
<class,중앙선,운길산,849,812,1661
<class,2호선,상왕십리,5332,5231,10563
<class,2호선,왕십리,7006,6030,13036
<class,2호선,한양대,1802,1880,3682
<class,2호선,뚝섬,6709,6929,13638
<class,2호선,성수,8669,9670,18339
<class,2호선,건대입구,17579,18872,36451
<class,2호선,구의,8739,8940,17679
<class,2호선,강변,15644,14589,30233
<class,2호선,잠실나루,4018,4076,8094
<class,2호선,잠실,30082,28364,58446
<class,2호선,잠실새내,8096,8538,16634
<class,2호선,종합운동장,2724,2893,5617
<class,2호선,삼성,10771,10708,21479
<class,2호선,선릉,9741,8410,18151
<class,2호선,역삼,8158,9216,17374
<class,2호선,강남,24776,23822,48598
<class,2호선,교대,8237,8966,17203
<class,2호선,시청,3963,3319,7282
<class,2호선,서초,8127,7649,15776
<class,1호선,청량리,9881,9982,19863
<class,1호선,제기동,7336,7685,15021
<class,1호선,신설동,5228,5175,10403
<class,1호선,동대문,6591,7164,13755
<class,1호선,종로5가,5782,5967,11749
<class,1호선,종로3가,9748,8909,18657
<class,1호선,종각,8286,7681,15967
<class,5호선,방화,2645,2724,5369
<class,수인선,월곶,1290,1223,2513
<class,수인선,소래포구,3278,3182,6460
<class,수인선,인천논현,2287,2475,4762
<class,수인선,호구포,1616,1682,3298
<class,수인선,남동인더스파크,536,564,1100
<class,수인선,원인재,2248,2311,4559
<class,수인선,연수,2419,2308,4727
<class,수인선,송도,1265,1242,2507
<class,수인선,인하대,2590,2511,5101
<class,수인선,숭의,1606,1524,3130
<class,수인선,신포,860,862,1722
<class,수인선,인천,725,1090,1815
<class,안산선,산본,6377,6913,13290
<class,안산선,대야미,2282,2116,4398
<class,안산선,반월,1948,1972,3920
<class,안산선,상록수,6943,6994,13937
<class,안산선,한대앞,4078,4098,8176
<class,안산선,중앙,8855,8564,17419
<class,안산선,고잔,3336,3184,6520
<class,안산선,초지,1724,1556,3280
<class,안산선,안산,7821,7034,14855
<class,안산선,신길온천,932,861,1793
<class,안산선,정왕,4140,4607,8747
<class,안산선,오이도,4543,4367,8910
<class,안산선,수리산,1636,1532,3168
<class,우이신설선,북한산우이,2266,2403,4669
<class,우이신설선,솔밭공원,1169,1119,2288
<class,우이신설선,4.19민주묘지,1568,1434,3002
<class,중앙선,양수,1659,1571,3230
<class,중앙선,신원,188,123,311
<class,중앙선,국수,466,399,865
<class,중앙선,아신,388,378,766
<class,중앙선,오빈,177,136,313
<class,중앙선,양평,1710,1476,3186
<class,중앙선,원덕,243,202,445
<class,중앙선,용문,1640,1311,2951
<class,중앙선,지평,56,55,111
<class,1호선,시청,5024,4787,9811
<class,1호선,동묘앞,7941,7994,15935
<class,1호선,서울역,18432,15850,34282
<class,2호선,방배,5078,5417,10495
<class,7호선,온수,4517,4383,8900
<class,7호선,천왕,5105,4794,9899
<class,7호선,광명사거리,13142,13302,26444
<class,7호선,철산,11264,11375,22639
<class,7호선,가산디지털단지,11473,10498,21971
<class,7호선,남구로,6889,7294,14183
<class,일산선,화정,9541,9871,19412
<class,일산선,원당,6145,6020,12165
<class,일산선,삼송,10055,9994,20049
<class,경춘선,사릉,1854,1817,3671
<class,경춘선,퇴계원,2143,1947,4090
<class,경춘선,별내,1816,1776,3592
<class,경춘선,갈매,1453,1301,2754
<class,경춘선,신내,898,855,1753
<class,경인선,도화,2402,2247,4649
<class,경인선,중동,4811,4669,9480
<class,경인선,온수,3681,3326,7007
<class,경인선,도원,1609,1597,3206
<class,경인선,간석,3268,3190,6458
<class,경인선,부개,4950,4737,9687
<class,경인선,소사,5047,5040,10087
<class,경인선,구일,3198,3080,6278
<class,4호선,삼각지,2106,2457,4563
<class,4호선,숙대입구,6053,5806,11859
<class,4호선,서울역,3575,6851,10426
<class,4호선,회현,12212,12784,24996
<class,4호선,명동,7599,8588,16187
<class,4호선,충무로,8357,8686,17043
<class,4호선,동대문역사문화공원,7695,6710,14405
<class,4호선,동대문,10647,10411,21058
<class,4호선,혜화,16373,16854,33227
<class,4호선,한성대입구,7603,7194,14797
<class,4호선,성신여대입구,12278,11509,23787
<class,4호선,길음,10096,9544,19640
<class,4호선,미아사거리,16621,16060,32681
<class,4호선,미아,8648,8266,16914
<class,4호선,수유,20414,19917,40331
<class,3호선,오금,2646,2555,5201
<class,3호선,경찰병원,3023,2977,6000
<class,3호선,가락시장,4644,4219,8863
<class,3호선,수서,8289,9065,17354
<class,3호선,일원,3850,3908,7758
<class,3호선,대청,4800,4398,9198
<class,3호선,학여울,806,755,1561
<class,3호선,대치,7574,6854,14428
<class,3호선,도곡,2358,2271,4629
<class,3호선,매봉,4537,4391,8928
<class,3호선,양재,14104,15193,29297
<class,3호선,남부터미널,13735,14479,28214
<class,3호선,교대,4925,2980,7905
<class,3호선,고속터미널,28704,30498,59202
<class,3호선,잠원,2512,2403,4915
<class,3호선,신사,16149,16716,32865
<class,3호선,압구정,18557,19121,37678
<class,3호선,옥수,5291,5271,10562
<class,3호선,금호,4455,4144,8599
<class,3호선,약수,6856,6501,13357
<class,3호선,동대입구,4061,4303,8364
<class,3호선,을지로3가,3432,3516,6948
<class,3호선,종로3가,3773,5046,8819
<class,3호선,안국,7323,8195,15518
<class,3호선,경복궁,8783,8868,17651
<class,3호선,독립문,3914,3826,7740
<class,3호선,무악재,1965,2002,3967
<class,3호선,홍제,9676,9108,18784
<class,3호선,녹번,7640,6809,14449
<class,3호선,불광,9655,11037,20692
<class,3호선,연신내,22915,21426,44341
<class,3호선,구파발,11965,12176,24141
<class,3호선,지축,2117,2095,4212
<class,2호선,용두,1426,1399,2825
<class,2호선,신정네거리,5457,5419,10876
<class,2호선,양천구청,3491,3664,7155
<class,2호선,도림천,630,640,1270
<class,2호선,신설동,2481,2434,4915
<class,2호선,신답,783,859,1642
<class,2호선,용답,1640,1523,3163
<class,2호선,충정로,3810,3790,7600
<class,2호선,아현,5709,5415,11124
<class,2호선,이대,7043,7271,14314
<class,2호선,신촌,19778,19756,39534
<class,2호선,홍대입구,33792,34612,68404
<class,2호선,합정,17413,18318,35731
<class,2호선,당산,8668,9552,18220
<class,2호선,영등포구청,8744,9019,17763
<class,2호선,문래,8066,8270,16336
<class,2호선,신도림,27392,26983,54375
<class,2호선,대림,13678,14717,28395
<class,2호선,구로디지털단지,25261,24906,50167
<class,2호선,신대방,15662,15357,31019
<class,2호선,신림,37639,36329,73968
<class,2호선,봉천,13565,12466,26031
<class,2호선,서울대입구,29057,27496,56553
<class,2호선,낙성대,16018,14850,30868
<class,2호선,사당,19765,21074,40839
<class,2호선,방배,6933,7323,14256
<class,2호선,서초,6843,6126,12969
<class,2호선,교대,12775,14199,26974
<class,2호선,강남,41697,40497,82194
<class,2호선,역삼,13071,14182,27253
<class,2호선,선릉,17217,15260,32477
<class,2호선,삼성,15637,15570,31207
<class,2호선,종합운동장,3389,3841,7230
<class,2호선,잠실새내,12273,12624,24897
<class,2호선,잠실,39211,37600,76811
<class,2호선,잠실나루,5397,5282,10679
<class,2호선,강변,17064,18659,35723
<class,2호선,구의,12339,12026,24365
<class,2호선,건대입구,21888,23623,45511
<class,2호선,성수,12200,13695,25895
<class,2호선,뚝섬,8731,9057,17788
<class,2호선,한양대,2954,2787,5741
<class,2호선,왕십리,9442,7648,17090
<class,2호선,상왕십리,7461,7010,14471
<class,2호선,신당,8032,8166,16198
<class,2호선,동대문역사문화공원,6706,7049,13755
<class,2호선,을지로4가,5185,5007,10192
<class,2호선,을지로3가,6719,6625,13344
<class,경원선,창동,1,0,1
<class,2호선,을지로입구,13293,13564,26857
<class,경춘선,백양리,139,140,279
<class,경춘선,굴봉산,182,223,405
<class,경춘선,가평,1659,1987,3646
<class,경춘선,상천,336,298,634
<class,경춘선,청평,1403,1468,2871
<class,경춘선,대성리,518,536,1054
<class,장항선,온양온천,2690,2772,5462
<class,장항선,신창,825,754,1579
<class,중앙선,회기,13734,12790,26524
<class,중앙선,중랑,3496,3396,6892
<class,중앙선,상봉,4098,4072,8170
<class,중앙선,망우,4856,4780,9636
<class,중앙선,양원,913,943,1856
<class,중앙선,구리,7874,8070,15944
<class,중앙선,도농,4971,4752,9723
<class,중앙선,양정,515,483,998
<class,중앙선,덕소,3475,3538,7013
<class,중앙선,도심,1166,1026,2192
<class,4호선,신용산,6870,7646,14516
<class,4호선,이촌,4335,4692,9027
<class,중앙선,팔당,1148,1189,2337
<class,4호선,동작,1450,1437,2887
<class,4호선,총신대입구,10872,11843,22715
<class,4호선,사당,13443,11495,24938
<class,4호선,남태령,581,497,1078
<class,4호선,당고개,7884,7548,15432
<class,4호선,상계,10787,10265,21052
<class,4호선,노원,11711,12825,24536
<class,4호선,창동,14836,15771,30607
<class,4호선,쌍문,16326,14948,31274
<class,5호선,방화,3707,3565,7272
<class,5호선,개화산,2885,2839,5724
<class,5호선,김포공항,5889,6036,11925
<class,5호선,송정,3810,3733,7543
<class,5호선,마곡,4178,4151,8329
<class,5호선,발산,9424,9687,19111
<class,5호선,우장산,7147,7302,14449
<class,5호선,화곡,15143,14199,29342
<class,5호선,까치산,16179,15679,31858
<class,5호선,신정,6693,5863,12556
<class,5호선,목동,8543,8546,17089
<class,5호선,오목교,12296,12628,24924
<class,5호선,양평,2685,2542,5227
<class,5호선,영등포구청,1541,1431,2972
<class,5호선,영등포시장,4905,5007,9912
<class,5호선,신길,1802,1976,3778
<class,5호선,여의도,6298,6829,13127
<class,5호선,여의나루,4787,5089,9876
<class,5호선,마포,5182,5112,10294
<class,5호선,공덕,4835,4928,9763
<class,5호선,애오개,2888,2724,5612
<class,5호선,충정로,1407,1292,2699
<class,5호선,서대문,4772,4651,9423
<class,5호선,광화문,9143,9385,18528
<class,5호선,종로3가,7025,7236,14261
<class,5호선,을지로4가,2399,2635,5034
<class,5호선,동대문역사문화공원,771,906,1677
<class,5호선,청구,2032,1702,3734
<class,5호선,신금호,3001,3077,6078
<class,5호선,행당,4247,3629,7876
<class,5호선,왕십리,2638,3023,5661
<class,5호선,마장,2840,2600,5440
<class,5호선,답십리,8007,7255,15262
<class,5호선,장한평,8458,8378,16836
<class,5호선,군자,6248,6780,13028
<class,5호선,아차산,8986,8712,17698
<class,5호선,광나루,7482,7192,14674
<class,5호선,천호,12441,11786,24227
<class,5호선,강동,9428,8951,18379
<class,5호선,길동,4898,5022,9920
<class,5호선,굽은다리,5727,5494,11221
<class,5호선,명일,4467,4457,8924
<class,5호선,고덕,4731,4617,9348
<class,5호선,상일동,7336,6736,14072
<class,5호선,둔촌동,4768,4740,9508
<class,5호선,올림픽공원,2193,1841,4034
<class,5호선,방이,4008,3967,7975
<class,5호선,오금,1661,1509,3170
<class,5호선,개롱,3450,3645,7095
<class,5호선,거여,4300,4083,8383
<class,5호선,마천,3448,3564,7012
<class,5호선,강일,1743,1695,3438
<class,5호선,미사,8364,8332,16696
<class,5호선,하남풍산,2026,2159,4185
<class,5호선,하남시청,3358,3291,6649
<class,5호선,하남검단산,3707,3725,7432
<class,6호선,응암,9635,9667,19302
<class,6호선,역촌,2287,2538,4825
<class,6호선,불광,2936,2605,5541
<class,6호선,독바위,1686,1953,3639
<class,6호선,연신내,3,0,3
<class,6호선,구산,4129,3246,7375
<class,6호선,새절,6929,6553,13482
<class,6호선,증산,5771,5685,11456
<class,6호선,디지털미디어시티,5394,5528,10922
<class,6호선,월드컵경기장,3598,3746,7344
<class,6호선,마포구청,7540,6700,14240
<class,6호선,망원,9015,9818,18833
<class,6호선,합정,8234,7564,15798
<class,6호선,상수,4934,5718,10652
<class,6호선,광흥창,3977,3723,7700
<class,6호선,대흥,4087,3986,8073
<class,6호선,공덕,7016,6685,13701
<class,6호선,효창공원앞,3441,3017,6458
<class,6호선,삼각지,3167,2568,5735
<class,6호선,녹사평,2918,2951,5869
<class,6호선,이태원,6311,6755,13066
<class,6호선,한강진,4913,5674,10587
<class,6호선,버티고개,1017,1102,2119
<class,6호선,약수,1938,1862,3800
<class,6호선,청구,1871,1786,3657
<class,6호선,신당,4300,3550,7850
<class,6호선,동묘앞,5947,5614,11561
<class,6호선,창신,1771,1379,3150
<class,6호선,보문,3863,3375,7238
<class,6호선,안암,4441,4121,8562
<class,6호선,고려대,3999,3691,7690
<class,6호선,월곡,5762,5797,11559
<class,6호선,상월곡,3272,2930,6202
<class,6호선,돌곶이,4594,4429,9023
<class,6호선,석계,6735,6761,13496
<class,6호선,태릉입구,3073,3350,6423
<class,6호선,화랑대,4958,4268,9226
<class,6호선,봉화산,4012,4020,8032
<class,7호선,장암,1358,1032,2390
<class,일산선,원흥,5408,5276,10684
<class,우이신설선,신설동,1117,1069,2186
<class,우이신설선,보문,1005,909,1914
<class,우이신설선,성신여대입구,2181,2494,4675
<class,우이신설선,정릉,2568,2223,4791
<class,우이신설선,북한산보국문,3456,3182,6638
<class,우이신설선,솔샘,2863,2571,5434
<class,우이신설선,삼양사거리,1597,1563,3160
<class,우이신설선,삼양,1188,1319,2507
<class,우이신설선,화계,1962,1867,3829
<class,우이신설선,가오리,2496,2379,4875
<class,우이신설선,4.19민주묘지,1898,1680,3578
<class,우이신설선,솔밭공원,1541,1438,2979
<class,우이신설선,북한산우이,2608,2719,5327
<class,안산선,수리산,2283,2070,4353
<class,안산선,오이도,5784,5970,11754
<class,안산선,정왕,4941,5093,10034
<class,안산선,신길온천,1027,1041,2068
<class,안산선,안산,7582,8187,15769
<class,안산선,초지,2144,2246,4390
<class,안산선,고잔,4166,4106,8272
<class,안산선,중앙,10772,11189,21961
<class,안산선,한대앞,5099,5163,10262
<class,안산선,상록수,8995,9019,18014
<class,7호선,대림,5547,5888,11435
<class,공항철도 1호선,공덕,1047,1309,2356
<class,공항철도 1호선,홍대입구,6670,6278,12948
<class,공항철도 1호선,디지털미디어시티,3677,3435,7112
<class,7호선,상봉,10255,9754,20009
<class,2호선,시청,5440,5024,10464
<class,경인선,부평,21610,23228,44838
<class,경인선,백운,3958,3939,7897
<class,경인선,동암,9399,9644,19043
<class,경인선,주안,11437,10154,21591
<class,경인선,제물포,5249,5246,10495
<class,경인선,동인천,8736,8505,17241
<class,경인선,인천,2914,2363,5277
<class,1호선,청량리,13745,14084,27829
<class,1호선,제기동,11410,11731,23141
<class,1호선,신설동,7186,6937,14123
<class,1호선,동대문,8369,7520,15889
<class,1호선,종로5가,12549,12634,25183
<class,1호선,종로3가,14925,14442,29367
<class,1호선,종각,11152,10772,21924
<class,1호선,시청,6325,6322,12647
<class,1호선,동묘앞,8423,8395,16818
<class,1호선,서울역,18534,19380,37914
<class,7호선,면목,8970,8752,17722
<class,7호선,사가정,9707,9459,19166
<class,7호선,용마산,3309,3452,6761
<class,7호선,중곡,5298,5076,10374
<class,7호선,군자,8251,6529,14780
<class,7호선,어린이대공원,6472,6185,12657
<class,7호선,건대입구,8101,7714,15815
<class,7호선,뚝섬유원지,5426,5129,10555
<class,7호선,청담,8001,8417,16418
<class,7호선,강남구청,7078,7563,14641
<class,7호선,학동,7254,7502,14756
<class,7호선,논현,8929,9512,18441
<class,7호선,반포,3472,3297,6769
<class,7호선,고속터미널,8080,6782,14862
<class,7호선,내방,6072,6025,12097
<class,7호선,이수,8972,8423,17395
<class,과천선,경마공원,839,863,1702
<class,과천선,대공원,2566,2750,5316
<class,과천선,과천,3069,2900,5969
<class,과천선,정부과천청사,4268,4320,8588
<class,과천선,인덕원,10861,10704,21565
<class,과천선,평촌,6480,6294,12774
<class,과천선,범계,14318,13900,28218
<class,분당선,선릉,3807,5544,9351
<class,분당선,한티,9920,9537,19457
<class,분당선,도곡,3053,2874,5927
<class,분당선,구룡,1328,1189,2517
<class,분당선,개포동,2084,2051,4135
<class,분당선,대모산입구,2022,1834,3856
<class,분당선,수서,6434,7374,13808
<class,분당선,수원,5296,4445,9741
<class,분당선,서울숲,4874,4948,9822
<class,분당선,압구정로데오,12502,13718,26220
<class,분당선,강남구청,3723,4410,8133
<class,분당선,선정릉,2521,2568,5089
<class,분당선,가천대,3463,3906,7369
<class,분당선,태평,8596,8026,16622
<class,분당선,모란,12318,12345,24663
<class,분당선,야탑,12534,13302,25836
<class,분당선,서현,14229,14354,28583
<class,분당선,수내,6900,6630,13530
<class,과천선,선바위,3592,3350,6942
<class,분당선,정자,8361,8581,16942
<class,분당선,미금,8446,8696,17142
<class,분당선,오리,5796,4920,10716
<class,분당선,이매,3275,3184,6459
<class,분당선,보정,1268,1166,2434
<class,분당선,죽전,7562,8594,16156
<class,분당선,구성,2346,2517,4863
<class,분당선,신갈,2068,2117,4185
<class,분당선,기흥,5139,4938,10077
<class,분당선,상갈,2898,2935,5833
<class,분당선,청명,2039,2008,4047
<class,분당선,영통,5095,5040,10135
<class,분당선,망포,6719,6278,12997
<class,분당선,매탄권선,2521,2443,4964
<class,분당선,수원시청,7617,7846,15463
<class,분당선,매교,1590,1544,3134
<class,수인선,고색,1853,1804,3657
<class,수인선,오목천,1447,1323,2770
<class,수인선,어천,540,472,1012
<class,수인선,야목,149,148,297
<class,수인선,사리,2406,2079,4485
<class,수인선,달월,53,51,104
<class,수인선,월곶,1568,1514,3082
<class,수인선,소래포구,3635,3729,7364
<class,수인선,인천논현,3375,3468,6843
<class,수인선,호구포,2211,2125,4336
<class,수인선,남동인더스파크,944,927,1871
<class,수인선,원인재,2804,2888,5692
<class,수인선,연수,2908,2913,5821
<class,수인선,송도,1421,1480,2901
<class,수인선,인하대,3089,2864,5953
<class,수인선,숭의,2116,1939,4055
<class,수인선,신포,1148,1130,2278
<class,수인선,인천,964,1439,2403
<class,중앙선,운길산,972,894,1866
<class,7호선,남성,6126,5724,11850
<class,안산선,산본,8916,9641,18557
<class,안산선,대야미,2929,2638,5567
<class,안산선,반월,2462,2409,4871
<class,일산선,대곡,997,904,1901
<class,일산선,백석,5724,5768,11492
<class,일산선,마두,4058,4033,8091
<class,일산선,정발산,4756,4843,9599
<class,일산선,주엽,4944,4880,9824
<class,일산선,대화,6411,5794,12205
<class,장항선,봉명,617,567,1184
<class,장항선,쌍용,1094,1008,2102
<class,장항선,아산,2033,1997,4030
<class,장항선,배방,739,703,1442
<class,중앙선,지평,32,65,97
<class,중앙선,양수,1973,1977,3950
<class,중앙선,신원,177,160,337
<class,중앙선,국수,513,518,1031
<class,중앙선,아신,459,485,944
<class,중앙선,오빈,210,225,435
<class,중앙선,양평,1904,1991,3895
<class,중앙선,원덕,268,321,589
<class,중앙선,용문,2000,2193,4193
<class,공항철도 1호선,영종,1940,2019,3959
<class,공항철도 1호선,인천공항2터미널,1799,1693,3492
<class,공항철도 1호선,인천공항1터미널,2942,3033,5975
<class,공항철도 1호선,공항화물청사,1219,1319,2538
<class,공항철도 1호선,운서,4482,4483,8965
<class,공항철도 1호선,청라국제도시,2879,2817,5696
<class,공항철도 1호선,검암,3150,3251,6401
<class,공항철도 1호선,계양,4691,4450,9141
<class,공항철도 1호선,김포공항,8932,5149,14081
<class,공항철도 1호선,마곡나루,2050,2137,4187
<class,공항철도 1호선,서울역,4492,4841,9333
<class,경춘선,춘천,1362,1324,2686
<class,경춘선,남춘천,2441,2591,5032
<class,경춘선,김유정,353,434,787
<class,경춘선,강촌,652,664,1316
<class,경인선,송내,12986,13064,26050
<class,경인선,부천,21635,22321,43956
<class,경인선,역곡,14889,14905,29794
<class,경인선,오류동,6986,6481,13467
<class,경인선,개봉,12395,12045,24440
<class,경의선,임진강,52,34,86
<class,경의선,문산,3515,3431,6946
<class,경의선,파주,657,542,1199
<class,경의선,월롱,1151,1078,2229
<class,7호선,숭실대입구,5854,5903,11757
<class,7호선,상도,5479,5101,10580
<class,7호선,장승배기,5299,5106,10405
<class,7호선,신대방삼거리,9184,8630,17814
<class,7호선,보라매,4609,4474,9083
<class,7호선,신풍,6387,6095,12482
<class,7호선,도봉산,5279,7369,12648
<class,7호선,수락산,8633,8658,17291
<class,경의선,금촌,4052,4047,8099
<class,경의선,금릉,2676,2621,5297
<class,경의선,운정,3398,3219,6617
<class,경의선,야당,3802,3813,7615
<class,경의선,탄현,3878,3808,7686
<class,경의선,일산,4275,4271,8546
<class,경의선,풍산,3036,3008,6044
<class,경의선,백마,3107,3016,6123
<class,경의선,곡산,322,308,630
<class,경의선,능곡,2079,2055,4134
<class,경의선,행신,3541,3799,7340
<class,경의선,강매,1392,1340,2732
<class,경의선,화전,723,733,1456
<class,경의선,수색,1094,1007,2101
<class,경의선,디지털미디어시티,1424,1342,2766
<class,경의선,가좌,2905,2662,5567
<class,경의선,홍대입구,1129,1221,2350
<class,경의선,서강대,1222,1122,2344
<class,경의선,공덕,1545,1308,2853
<class,경의선,효창공원앞,1275,1483,2758
<class,경의선,신촌,270,277,547
<class,경의선,서울역,839,911,1750
<class,경원선,소요산,3947,3573,7520
<class,경원선,동두천,1280,1661,2941
<class,경원선,보산,993,985,1978
<class,경원선,동두천중앙,1958,1991,3949
<class,경원선,지행,3949,4041,7990
<class,경원선,덕정,3294,3106,6400
<class,경원선,덕계,1876,1712,3588
<class,경원선,양주,4682,4482,9164
<class,경원선,녹양,2612,2574,5186
<class,경원선,가능,4050,3900,7950
<class,경원선,의정부,12760,13288,26048
<class,경원선,회룡,7271,7371,14642
<class,경원선,망월사,4280,4504,8784
<class,경원선,도봉산,7559,5068,12627
<class,경원선,도봉,3569,3431,7000
<class,경원선,방학,5946,5768,11714
<class,경원선,녹천,2731,2273,5004
<class,경원선,월계,3558,3412,6970
<class,경원선,광운대,4299,4153,8452
<class,경원선,석계,4894,5169,10063
<class,경원선,신이문,4863,4568,9431
<class,경원선,외대앞,4468,4284,8752
<class,경원선,청량리,11431,13175,24606
<class,경원선,왕십리,8756,10185,18941
<class,경원선,응봉,1302,1170,2472
<class,경원선,옥수,31,29,60
<class,경원선,한남,2222,1956,4178
<class,경원선,서빙고,1011,839,1850
<class,경원선,이촌,2147,1679,3826
<class,경부선,광명,1687,1596,3283
<class,경부선,서동탄,727,731,1458
<class,경부선,당정,2800,2691,5491
<class,경부선,천안,4673,5084,9757
<class,경부선,두정,4021,4286,8307
<class,경부선,직산,514,558,1072
<class,경부선,성환,2240,2074,4314
<class,경부선,평택,9465,9338,18803
<class,경부선,평택지제,2094,1925,4019
<class,경부선,서정리,4729,4051,8780
<class,경부선,송탄,3410,3007,6417
<class,경부선,진위,790,746,1536
<class,경부선,오산,7227,6760,13987
<class,경부선,오산대,1924,1803,3727
<class,경부선,세마,1545,1365,2910
<class,경부선,병점,8561,8597,17158
<class,경부선,세류,1916,2002,3918
<class,경부선,독산,6459,6570,13029
<class,경부선,수원,25930,28092,54022
<class,경부선,화서,3618,3624,7242
<class,경부선,성균관대,7212,7154,14366
<class,경부선,의왕,4418,4337,8755
<class,경부선,군포,3456,3274,6730
<class,경부선,금정,13568,13509,27077
<class,경부선,명학,3794,3658,7452
<class,경부선,안양,12997,12989,25986
<class,경부선,관악,4308,4048,8356
<class,경부선,석수,5094,4763,9857
<class,경부선,금천구청,6032,6137,12169
<class,경부선,가산디지털단지,4538,6171,10709
<class,경부선,구로,9759,9885,19644
<class,경부선,신길,4718,3833,8551
<class,경부선,신도림,2094,2103,4197
<class,경부선,영등포,25594,26924,52518
<class,경부선,대방,5806,5734,11540
<class,경부선,노량진,5788,5093,10881
<class,경부선,용산,21294,23961,45255
<class,경부선,남영,3951,4010,7961
<class,경부선,서울역,3148,1169,4317
<class,경강선,여주,1552,1843,3395
<class,경강선,세종대왕릉,209,244,453
<class,경강선,부발,1264,1085,2349
<class,경강선,이천,1860,1982,3842
<class,경강선,신둔도예촌,730,764,1494
<class,경강선,곤지암,1408,1492,2900
<class,경강선,초월,1642,1580,3222
<class,경강선,경기광주,3769,3641,7410
<class,경강선,삼동,1190,1142,2332
<class,경강선,이매,598,537,1135
<class,경강선,판교,2314,2099,4413
<class,9호선2~3단계,중앙보훈병원,3201,3039,6240
<class,9호선2~3단계,둔촌오륜,475,480,955
<class,9호선2~3단계,올림픽공원,3180,3156,6336
<class,9호선2~3단계,한성백제,1340,1216,2556
<class,9호선2~3단계,송파나루,2944,3112,6056
<class,9호선2~3단계,석촌,4673,4014,8687
<class,9호선2~3단계,석촌고분,3261,3065,6326
<class,9호선2~3단계,삼전,3788,3556,7344
<class,9호선2~3단계,종합운동장,2554,2313,4867
<class,9호선2~3단계,봉은사,6202,6387,12589
<class,9호선2~3단계,삼성중앙,2350,2335,4685
<class,9호선2~3단계,선정릉,3311,3526,6837
<class,9호선2~3단계,언주,4124,3982,8106
<class,9호선,신논현,17272,17185,34457
<class,9호선,사평,1673,1567,3240
<class,9호선,고속터미널,7913,11061,18974
<class,9호선,신반포,1773,1682,3455
<class,9호선,구반포,1344,1335,2679
<class,9호선,동작,1064,860,1924
<class,9호선,흑석,4028,4007,8035
<class,9호선,노들,2445,2078,4523
<class,9호선,노량진,16091,15511,31602
<class,9호선,샛강,1798,1806,3604
<class,9호선,여의도,6396,6075,12471
<class,9호선,국회의사당,2328,2382,4710
<class,9호선,당산,9022,8440,17462
<class,9호선,선유도,2861,2707,5568
<class,9호선,신목동,1757,1495,3252
<class,9호선,염창,8403,7723,16126
<class,9호선,등촌,5737,5616,11353
<class,9호선,증미,3310,3228,6538
<class,9호선,가양,10512,10106,20618
<class,9호선,양천향교,4481,4397,8878
<class,9호선,마곡나루,5229,5102,10331
<class,9호선,신방화,3624,3519,7143
<class,9호선,공항시장,1822,1925,3747
<class,9호선,김포공항,6155,10006,16161
<class,9호선,개화,1082,1007,2089
<class,8호선,모란,2722,2347,5069
<class,8호선,수진,3297,2983,6280
<class,8호선,신흥,3103,3344,6447
<class,8호선,단대오거리,5958,5557,11515
<class,8호선,남한산성입구,7338,6618,13956
<class,8호선,산성,3423,3583,7006
<class,8호선,복정,5195,4490,9685
<class,8호선,장지,9216,8852,18068
<class,8호선,문정,5831,5913,11744
<class,8호선,가락시장,4122,3984,8106
<class,8호선,송파,3793,3838,7631
<class,8호선,석촌,4491,5242,9733
<class,8호선,잠실,8532,9723,18255
<class,8호선,몽촌토성,3190,3127,6317
<class,8호선,강동구청,4648,4776,9424
<class,8호선,천호,8990,10682,19672
<class,8호선,암사,9598,8976,18574
<class,7호선,부평구청,3823,3423,7246
<class,7호선,굴포천,5071,5293,10364
<class,7호선,삼산체육관,2510,2324,4834
<class,7호선,상동,7567,7740,15307
<class,7호선,마들,6886,6476,13362
<class,7호선,노원,12252,12748,25000
<class,7호선,중계,7145,6444,13589
<class,7호선,하계,9077,8532,17609
<class,7호선,공릉,6577,6498,13075
<class,7호선,태릉입구,4980,4652,9632
<class,7호선,먹골,6030,5863,11893
<class,7호선,중화,6181,5913,12094
<class,경춘선,마석,2448,2526,4974
<class,경춘선,천마산,1121,1119,2240
<class,경춘선,평내호평,3419,3474,6893
<class,경춘선,금곡,914,836,1750
<class,7호선,부천시청,7623,7660,15283
<class,7호선,신중동,7511,7318,14829
<class,7호선,춘의,4324,4172,8496
<class,7호선,부천종합운동장,2734,2401,5135
<class,7호선,까치울,4172,4144,8316
<class,5호선,상일동,4806,4763,9569
<class,2호선,낙성대,10851,11442,22293
<class,2호선,서울대입구,19484,20276,39760
<class,2호선,봉천,8796,8757,17553
<class,2호선,신림,26402,26360,52762
<class,2호선,신대방,11253,11084,22337
<class,2호선,구로디지털단지,16500,16620,33120
<class,2호선,대림,10304,10670,20974
<class,2호선,신도림,19019,19216,38235
<class,2호선,문래,5219,5513,10732
<class,2호선,영등포구청,5417,5684,11101
<class,2호선,당산,5921,6250,12171
<class,2호선,합정,12786,13101,25887
<class,2호선,홍대입구,25835,25553,51388
<class,2호선,신촌,14047,13884,27931
<class,2호선,이대,4673,5287,9960
<class,3호선,독립문,2515,2671,5186
<class,3호선,경복궁,6457,6757,13214
<class,3호선,안국,5405,5939,11344
<class,3호선,종로3가,2435,3072,5507
<class,3호선,을지로3가,1746,1644,3390
<class,3호선,동대입구,3668,3769,7437
<class,3호선,구파발,8386,8816,17202
<class,3호선,연신내,15799,14818,30617
<class,3호선,불광,6611,7735,14346
<class,3호선,녹번,5026,4539,9565
<class,3호선,홍제,6317,6083,12400
<class,3호선,무악재,1278,1380,2658
<class,5호선,천호,8864,8257,17121
<class,5호선,강동,6221,6119,12340
<class,7호선,내방,3718,3864,7582
<class,7호선,이수,5733,5619,11352
<class,7호선,남성,3900,3913,7813
<class,7호선,숭실대입구,3916,4210,8126
<class,7호선,상도,3727,3770,7497
<class,7호선,장승배기,3528,3481,7009
<class,7호선,신대방삼거리,5758,5622,11380
<class,7호선,보라매,2973,3080,6053
<class,중앙선,지평,62,33,95
<class,중앙선,용문,2246,1939,4185
<class,중앙선,원덕,291,233,524
<class,중앙선,양평,2319,2079,4398
<class,중앙선,오빈,192,157,349
<class,중앙선,아신,463,348,811
<class,중앙선,국수,452,399,851
<class,중앙선,신원,187,125,312
<class,중앙선,양수,1679,1580,3259
<class,중앙선,운길산,989,906,1895
<class,중앙선,팔당,1154,1132,2286
<class,중앙선,도심,884,820,1704
<class,중앙선,덕소,2551,2589,5140
<class,중앙선,양정,373,319,692
<class,중앙선,도농,3404,3347,6751
<class,중앙선,구리,5356,5766,11122
<class,중앙선,양원,632,648,1280
<class,중앙선,망우,3612,3797,7409
<class,중앙선,상봉,2994,3032,6026
<class,중앙선,중랑,2570,2454,5024
<class,중앙선,회기,10350,10590,20940
<class,장항선,신창,759,826,1585
<class,장항선,온양온천,2478,2524,5002
<class,장항선,배방,540,598,1138
<class,장항선,아산,2152,1480,3632
<class,장항선,쌍용,824,826,1650
<class,장항선,봉명,431,432,863
<class,일산선,대화,4521,4234,8755
<class,일산선,주엽,3127,3057,6184
<class,일산선,정발산,3545,3586,7131
<class,일산선,마두,2622,2592,5214
<class,일산선,백석,4256,4082,8338
<class,일산선,대곡,753,640,1393
<class,일산선,화정,6780,6998,13778
<class,일산선,원당,4304,4248,8552
<class,일산선,삼송,7347,7122,14469
<class,일산선,원흥,3756,3524,7280
<class,우이신설선,신설동,854,806,1660
<class,우이신설선,보문,693,692,1385
<class,우이신설선,성신여대입구,1510,1817,3327
<class,우이신설선,정릉,1825,1474,3299
<class,우이신설선,북한산보국문,2582,2382,4964
<class,우이신설선,솔샘,1867,1721,3588
<class,우이신설선,삼양사거리,1112,1197,2309
<class,우이신설선,삼양,899,932,1831
<class,우이신설선,화계,1472,1353,2825
<class,우이신설선,가오리,1761,1705,3466
<class,우이신설선,4.19민주묘지,1594,1316,2910
<class,우이신설선,솔밭공원,1044,1080,2124
<class,우이신설선,북한산우이,2586,2749,5335
<class,안산선,수리산,1537,1492,3029
<class,안산선,오이도,4556,4702,9258
<class,안산선,정왕,3864,4202,8066
<class,안산선,신길온천,858,774,1632
<class,안산선,안산,7525,6757,14282
<class,안산선,초지,1580,1526,3106
<class,안산선,고잔,3077,2877,5954
<class,안산선,중앙,7965,7667,15632
<class,안산선,한대앞,3746,3810,7556
<class,안산선,상록수,6482,6347,12829
<class,안산선,반월,1715,1789,3504
<class,안산선,대야미,2135,2041,4176
<class,안산선,산본,6125,6473,12598
<class,수인선,인천,819,1202,2021
<class,수인선,신포,824,803,1627
<class,수인선,숭의,1423,1344,2767
<class,수인선,인하대,2345,2242,4587
<class,수인선,송도,1148,1100,2248
<class,수인선,연수,2197,2164,4361
<class,수인선,원인재,2031,2160,4191
<class,수인선,남동인더스파크,562,576,1138
<class,수인선,호구포,1497,1509,3006
<class,수인선,인천논현,2251,2238,4489
<class,수인선,소래포구,3315,3255,6570
<class,수인선,월곶,1245,1191,2436
<class,수인선,달월,38,40,78
<class,수인선,사리,1763,1524,3287
<class,수인선,야목,131,110,241
<class,수인선,어천,421,501,922
<class,수인선,오목천,955,1003,1958
<class,수인선,고색,1202,1247,2449
<class,분당선,매교,963,1026,1989
<class,분당선,수원시청,5072,5148,10220
<class,분당선,매탄권선,1756,1719,3475
<class,분당선,망포,4396,4750,9146
<class,분당선,영통,3459,3426,6885
<class,분당선,청명,1309,1309,2618
<class,분당선,상갈,2085,2096,4181
<class,분당선,기흥,3711,3550,7261
<class,분당선,신갈,1351,1432,2783
<class,분당선,구성,1605,1769,3374
<class,분당선,죽전,5655,6484,12139
<class,분당선,보정,768,737,1505
<class,분당선,이매,2097,2090,4187
<class,분당선,오리,3936,3529,7465
<class,분당선,미금,5042,5359,10401
<class,분당선,정자,5430,5640,11070
<class,분당선,수내,4485,4408,8893
<class,분당선,서현,9726,9858,19584
<class,분당선,야탑,9024,9257,18281
<class,분당선,모란,8043,8208,16251
<class,분당선,태평,6086,5669,11755
<class,분당선,가천대,2442,3094,5536
<class,분당선,선정릉,1482,1546,3028
<class,분당선,강남구청,2223,2681,4904
<class,분당선,압구정로데오,7064,7750,14814
<class,분당선,서울숲,3560,3581,7141
<class,분당선,수원,4167,3367,7534
<class,분당선,수서,6093,5163,11256
<class,분당선,대모산입구,1049,984,2033
<class,분당선,개포동,1186,1223,2409
<class,분당선,구룡,441,479,920
<class,분당선,도곡,1895,1804,3699
<class,분당선,한티,6792,6555,13347
<class,분당선,선릉,2036,3009,5045
<class,과천선,범계,9828,9602,19430
<class,과천선,평촌,4123,4116,8239
<class,과천선,인덕원,7215,7237,14452
<class,과천선,정부과천청사,3053,3205,6258
<class,과천선,과천,2158,2080,4238
<class,과천선,대공원,2253,2327,4580
<class,과천선,경마공원,676,654,1330
<class,과천선,선바위,2287,2260,4547
<class,공항철도 1호선,영종,1634,1624,3258
<class,공항철도 1호선,인천공항2터미널,1791,1720,3511
<class,공항철도 1호선,인천공항1터미널,2919,2968,5887
<class,공항철도 1호선,공항화물청사,974,1003,1977
<class,공항철도 1호선,운서,3795,4082,7877
<class,공항철도 1호선,청라국제도시,2236,2086,4322
<class,공항철도 1호선,검암,2477,2574,5051
<class,공항철도 1호선,계양,3324,3327,6651
<class,공항철도 1호선,김포공항,10038,4853,14891
<class,공항철도 1호선,마곡나루,1398,1617,3015
<class,공항철도 1호선,디지털미디어시티,2492,2553,5045
<class,공항철도 1호선,홍대입구,5385,5329,10714
<class,공항철도 1호선,공덕,757,1023,1780
<class,공항철도 1호선,서울역,4972,3666,8638
<class,경춘선,춘천,1409,1125,2534
<class,경춘선,남춘천,1886,1772,3658
<class,경춘선,김유정,310,318,628
<class,경춘선,강촌,657,601,1258
<class,경춘선,백양리,165,133,298
<class,경춘선,굴봉산,237,176,413
<class,경춘선,가평,1803,1393,3196
<class,경춘선,상천,385,306,691
<class,경춘선,청평,1291,1084,2375
<class,경춘선,대성리,533,398,931
<class,경춘선,마석,2035,2039,4074
<class,경춘선,천마산,849,825,1674
<class,경춘선,평내호평,2505,2562,5067
<class,경춘선,금곡,721,676,1397
<class,경춘선,사릉,1170,1270,2440
<class,경춘선,퇴계원,1504,1515,3019
<class,경춘선,별내,1328,1290,2618
<class,경춘선,갈매,1056,958,2014
<class,경춘선,신내,627,616,1243
<class,경인선,도화,1755,1580,3335
<class,경인선,중동,3386,3206,6592
<class,경인선,온수,2460,2390,4850
<class,경인선,도원,1110,1183,2293
<class,경인선,간석,2307,2216,4523
<class,경인선,부개,3462,3259,6721
<class,경인선,소사,3758,3586,7344
<class,경인선,구일,2194,2210,4404
<class,경인선,인천,2674,2190,4864
<class,경인선,동인천,6529,6297,12826
<class,경인선,제물포,3849,3823,7672
<class,경인선,주안,8452,7289,15741
<class,경인선,동암,6979,6890,13869
<class,경인선,백운,2853,2833,5686
<class,경인선,부평,16789,16990,33779
<class,경인선,송내,9180,9115,18295
<class,경인선,부천,16333,16017,32350
<class,경인선,역곡,10012,10121,20133
<class,경인선,오류동,4680,4577,9257
<class,경인선,개봉,8131,8220,16351
<class,경의선,임진강,54,42,96
<class,경의선,문산,2745,2768,5513
<class,경의선,파주,520,446,966
<class,경의선,월롱,626,1210,1836
<class,경의선,금촌,3021,3211,6232
<class,경의선,금릉,1942,1947,3889
<class,경의선,운정,2380,2422,4802
<class,경의선,야당,3026,2816,5842
<class,경의선,탄현,2883,2721,5604
<class,경의선,일산,3621,3491,7112
<class,경의선,풍산,2436,2391,4827
<class,경의선,백마,2293,2136,4429
<class,경의선,곡산,224,245,469
<class,경의선,능곡,1503,1574,3077
<class,경의선,행신,3081,2783,5864
<class,경의선,강매,984,938,1922
<class,경의선,화전,545,572,1117
<class,경의선,수색,624,702,1326
<class,경의선,디지털미디어시티,987,975,1962
<class,경의선,가좌,1972,2102,4074
<class,경의선,홍대입구,916,1020,1936
<class,경의선,서강대,819,868,1687
<class,경의선,공덕,1089,934,2023
<class,경의선,효창공원앞,945,1053,1998
<class,경의선,신촌,175,190,365
<class,경의선,서울역,688,649,1337
<class,경원선,소요산,4159,3643,7802
<class,경원선,동두천,1066,1273,2339
<class,경원선,보산,880,818,1698
<class,경원선,동두천중앙,1651,1475,3126
<class,경원선,지행,3039,2940,5979
<class,경원선,덕정,2339,2465,4804
<class,경원선,덕계,1144,1125,2269
<class,경원선,양주,3485,3496,6981
<class,경원선,녹양,1860,1894,3754
<class,경원선,가능,2944,2772,5716
<class,경원선,의정부,9942,10043,19985
<class,경원선,회룡,5065,5150,10215
<class,경원선,망월사,3270,3387,6657
<class,경원선,도봉산,6986,4927,11913
<class,경원선,도봉,2631,2453,5084
<class,경원선,방학,4189,4136,8325
<class,경원선,창동,1,0,1
<class,경원선,녹천,1936,1607,3543
<class,경원선,월계,2669,2537,5206
<class,경원선,광운대,3092,3179,6271
<class,경원선,석계,3449,3883,7332
<class,경원선,신이문,3580,3264,6844
<class,경원선,외대앞,3146,3214,6360
<class,경원선,청량리,10871,9226,20097
<class,경원선,왕십리,6538,7813,14351
<class,경원선,응봉,771,724,1495
<class,경원선,옥수,50,11,61
<class,경원선,한남,1446,1484,2930
<class,경원선,서빙고,691,676,1367
<class,경원선,이촌,1415,1129,2544
<class,경부선,광명,1680,1143,2823
<class,경부선,서동탄,515,559,1074
<class,경부선,당정,2021,2088,4109
<class,경부선,천안,4924,4533,9457
<class,경부선,두정,3568,3686,7254
<class,경부선,직산,416,470,886
<class,경부선,성환,1809,1991,3800
<class,경부선,평택,8194,8417,16611
<class,경부선,평택지제,1757,1562,3319
<class,경부선,서정리,3071,4261,7332
<class,경부선,송탄,2596,2882,5478
<class,경부선,진위,513,550,1063
<class,경부선,오산,5856,6338,12194
<class,경부선,오산대,1529,1578,3107
<class,경부선,세마,1198,1177,2375
<class,경부선,병점,6402,6981,13383
<class,경부선,세류,1503,1563,3066
<class,경부선,독산,4237,4387,8624
<class,경부선,수원,23322,22104,45426
<class,경부선,화서,2599,2580,5179
<class,경부선,성균관대,5270,5558,10828
<class,경부선,의왕,2947,3074,6021
<class,경부선,군포,2226,2128,4354
<class,경부선,금정,9496,10005,19501
<class,경부선,명학,2345,2455,4800
<class,경부선,안양,9423,9197,18620
<class,경부선,관악,3397,3060,6457
<class,경부선,석수,3500,3461,6961
<class,경부선,금천구청,4389,4331,8720
<class,경부선,가산디지털단지,3334,4579,7913
<class,경부선,구로,6732,6701,13433
<class,경강선,여주,1496,1391,2887
<class,경강선,세종대왕릉,206,181,387
<class,경강선,부발,902,1428,2330
<class,경강선,이천,1449,1587,3036
<class,경강선,신둔도예촌,631,551,1182
<class,경강선,곤지암,1070,1286,2356
<class,경강선,초월,1172,1119,2291
<class,경강선,경기광주,2612,2644,5256
<class,경강선,삼동,780,791,1571
<class,경강선,이매,470,371,841
<class,경강선,판교,1721,1570,3291
<class,9호선2~3단계,중앙보훈병원,2324,2258,4582
<class,9호선2~3단계,둔촌오륜,284,298,582
<class,9호선2~3단계,올림픽공원,1989,2057,4046
<class,9호선2~3단계,한성백제,1007,894,1901
<class,9호선2~3단계,송파나루,2139,2457,4596
<class,9호선2~3단계,석촌,3214,2780,5994
<class,9호선2~3단계,석촌고분,2192,2284,4476
<class,9호선2~3단계,삼전,2559,2575,5134
<class,9호선2~3단계,종합운동장,1591,1504,3095
<class,9호선2~3단계,봉은사,4340,4514,8854
<class,9호선2~3단계,삼성중앙,1463,1502,2965
<class,9호선2~3단계,선정릉,2232,2405,4637
<class,9호선2~3단계,언주,2357,2476,4833
<class,9호선,신논현,10029,9891,19920
<class,9호선,사평,1054,1119,2173
<class,9호선,고속터미널,6860,7785,14645
<class,9호선,신반포,959,1012,1971
<class,9호선,구반포,795,847,1642
<class,9호선,동작,862,722,1584
<class,9호선,흑석,2625,2823,5448
<class,9호선,노들,1707,1530,3237
<class,9호선,노량진,10454,11375,21829
<class,9호선,샛강,1212,1264,2476
<class,9호선,여의도,4558,4431,8989
<class,9호선,국회의사당,1879,1919,3798
<class,9호선,당산,5776,5797,11573
<class,9호선,선유도,1942,1982,3924
<class,9호선,신목동,1187,1064,2251
<class,9호선,염창,5856,5824,11680
<class,9호선,등촌,3722,4002,7724
<class,9호선,증미,2133,2306,4439
<class,9호선,가양,6985,7168,14153
<class,9호선,양천향교,2996,3163,6159
<class,9호선,마곡나루,3630,3812,7442
<class,9호선,신방화,2492,2456,4948
<class,9호선,공항시장,1285,1415,2700
<class,9호선,김포공항,6158,8530,14688
<class,9호선,개화,819,810,1629
<class,8호선,모란,1870,1587,3457
<class,8호선,수진,2234,2010,4244
<class,8호선,신흥,2183,2348,4531
<class,8호선,단대오거리,3953,3974,7927
<class,8호선,남한산성입구,4906,4572,9478
<class,8호선,산성,2446,2491,4937
<class,8호선,복정,3387,3108,6495
<class,8호선,장지,6682,7033,13715
<class,8호선,문정,3556,3776,7332
<class,8호선,가락시장,2262,2947,5209
<class,8호선,송파,2468,2544,5012
<class,8호선,석촌,2983,3606,6589
<class,8호선,잠실,6877,7416,14293
<class,8호선,몽촌토성,2280,2272,4552
<class,8호선,강동구청,3185,3276,6461
<class,8호선,천호,6455,7428,13883
<class,8호선,암사,6564,6292,12856
<class,7호선,부평구청,2716,2425,5141
<class,7호선,굴포천,3602,3611,7213
<class,7호선,삼산체육관,1825,1684,3509
<class,7호선,상동,5207,5297,10504
<class,7호선,부천시청,5258,5168,10426
<class,7호선,신중동,5022,4879,9901
<class,7호선,춘의,2609,2499,5108
<class,7호선,부천종합운동장,1940,1776,3716
<class,7호선,까치울,2995,2939,5934
<class,7호선,온수,2795,2826,5621
<class,7호선,천왕,3417,3272,6689
<class,7호선,광명사거리,8899,8905,17804
<class,7호선,철산,7296,7248,14544
<class,7호선,가산디지털단지,7837,7366,15203
<class,7호선,남구로,5155,5147,10302
<class,7호선,대림,4932,4624,9556
<class,7호선,신풍,4406,4166,8572
<class,7호선,고속터미널,8110,4876,12986
<class,7호선,반포,2208,2230,4438
<class,7호선,논현,4665,5012,9677
<class,7호선,학동,3777,4090,7867
<class,7호선,강남구청,4000,4287,8287
<class,7호선,청담,4505,4793,9298
<class,7호선,뚝섬유원지,4498,4086,8584
<class,7호선,건대입구,5729,5391,11120
<class,7호선,어린이대공원,5278,4951,10229
<class,7호선,군자,5586,4620,10206
<class,7호선,중곡,3579,3530,7109
<class,7호선,용마산,2356,2573,4929
<class,7호선,사가정,6753,6672,13425
<class,7호선,면목,6019,6126,12145
<class,7호선,상봉,6961,6542,13503
<class,7호선,중화,4088,4056,8144
<class,경부선,서울역,4340,872,5212
<class,경부선,남영,2739,3009,5748
<class,경부선,용산,22322,18834,41156
<class,경부선,노량진,3858,3796,7654
<class,경부선,대방,3732,4170,7902
<class,경부선,영등포,21894,20625,42519
<class,경부선,신도림,1460,1549,3009
<class,경부선,신길,3519,3026,6545
<class,7호선,먹골,4006,3978,7984
<class,7호선,태릉입구,3531,3311,6842
<class,7호선,공릉,4507,4635,9142
<class,7호선,하계,6322,6034,12356
<class,7호선,중계,4950,4519,9469
<class,7호선,노원,7973,8058,16031
<class,7호선,마들,4259,4003,8262
<class,7호선,수락산,6801,6783,13584
<class,7호선,도봉산,4263,6342,10605
<class,7호선,장암,1332,1028,2360
<class,6호선,봉화산,2920,2854,5774
<class,6호선,화랑대,3387,2988,6375
<class,6호선,태릉입구,2151,2377,4528
<class,6호선,석계,4754,4830,9584
<class,6호선,돌곶이,3806,3589,7395
<class,6호선,상월곡,2280,2018,4298
<class,6호선,월곡,3964,4027,7991
<class,6호선,고려대,2972,2853,5825
<class,6호선,안암,3236,3401,6637
<class,6호선,보문,2824,2621,5445
<class,6호선,창신,1178,1063,2241
<class,6호선,동묘앞,4337,4450,8787
<class,6호선,신당,2687,3472,6159
<class,6호선,청구,1214,1260,2474
<class,6호선,약수,1225,1218,2443
<class,6호선,버티고개,776,814,1590
<class,6호선,한강진,3920,4394,8314
<class,6호선,이태원,5138,5137,10275
<class,6호선,녹사평,2282,2136,4418
<class,6호선,삼각지,2313,1724,4037
<class,6호선,효창공원앞,2328,2130,4458
<class,6호선,공덕,4594,4353,8947
<class,6호선,대흥,2845,2900,5745
<class,6호선,광흥창,2663,2560,5223
<class,6호선,상수,3625,4312,7937
<class,6호선,합정,6050,5611,11661
<class,6호선,망원,6478,6985,13463
<class,6호선,마포구청,5148,4830,9978
<class,6호선,월드컵경기장,3079,2984,6063
<class,6호선,디지털미디어시티,3545,3727,7272
<class,6호선,증산,4097,4240,8337
<class,6호선,새절,4630,4644,9274
<class,6호선,구산,2710,2203,4913
<class,6호선,독바위,1210,1462,2672
<class,6호선,불광,1974,1776,3750
<class,6호선,역촌,1453,1670,3123
<class,6호선,응암,6780,6957,13737
<class,5호선,하남검단산,3091,3087,6178
<class,5호선,하남시청,2281,2283,4564
<class,5호선,하남풍산,1464,1549,3013
<class,5호선,미사,5655,5688,11343
<class,5호선,강일,1165,1130,2295
<class,5호선,마천,2524,2650,5174
<class,5호선,거여,2798,2742,5540
<class,5호선,개롱,2235,2424,4659
<class,5호선,오금,1057,1039,2096
<class,5호선,방이,2595,2580,5175
<class,5호선,올림픽공원,1517,1241,2758
<class,5호선,둔촌동,2973,3052,6025
<class,5호선,고덕,3003,3110,6113
<class,5호선,명일,2907,2992,5899
<class,5호선,굽은다리,3928,3818,7746
<class,5호선,길동,3162,3256,6418
<class,5호선,광나루,5422,5283,10705
<class,5호선,아차산,6716,6627,13343
<class,5호선,군자,4221,4712,8933
<class,5호선,장한평,5211,5346,10557
<class,5호선,답십리,5064,4687,9751
<class,5호선,마장,1983,1797,3780
<class,5호선,왕십리,1838,2077,3915
<class,5호선,행당,2732,2405,5137
<class,5호선,신금호,2100,2311,4411
<class,5호선,청구,1247,1143,2390
<class,5호선,동대문역사문화공원,463,589,1052
<class,5호선,을지로4가,985,1021,2006
<class,5호선,종로3가,4913,4618,9531
<class,5호선,광화문,7215,7355,14570
<class,5호선,서대문,3116,3138,6254
<class,5호선,충정로,921,972,1893
<class,5호선,애오개,1758,1847,3605
<class,5호선,공덕,2969,3097,6066
<class,5호선,마포,3153,3218,6371
<class,5호선,여의나루,4083,4182,8265
<class,5호선,여의도,4333,4726,9059
<class,5호선,신길,1289,1428,2717
<class,5호선,영등포시장,3073,3140,6213
<class,5호선,영등포구청,925,952,1877
<class,5호선,양평,1718,1858,3576
<class,5호선,오목교,8544,8856,17400
<class,5호선,목동,5334,5575,10909
<class,5호선,신정,4535,4123,8658
<class,5호선,까치산,11326,11330,22656
<class,5호선,화곡,10067,9541,19608
<class,5호선,우장산,4492,4604,9096
<class,5호선,발산,6142,6476,12618
<class,5호선,마곡,2492,2546,5038
<class,5호선,송정,2774,2796,5570
<class,5호선,김포공항,5981,5255,11236
<class,5호선,개화산,2101,2136,4237
<class,5호선,방화,2616,2632,5248
<class,4호선,쌍문,11217,10041,21258
<class,4호선,창동,10346,10939,21285
<class,4호선,노원,8055,8754,16809
<class,4호선,상계,7450,7029,14479
<class,4호선,당고개,6196,6010,12206
<class,4호선,남태령,406,380,786
<class,4호선,사당,9403,8959,18362
<class,4호선,총신대입구,7026,7678,14704
<class,4호선,동작,1161,1199,2360
<class,4호선,이촌,2858,3296,6154
<class,4호선,신용산,5318,5524,10842
<class,4호선,삼각지,1384,1700,3084
<class,4호선,숙대입구,4195,4177,8372
<class,4호선,서울역,2705,5082,7787
<class,4호선,회현,5791,5911,11702
<class,4호선,명동,6032,6041,12073
<class,4호선,충무로,5099,5251,10350
<class,4호선,동대문역사문화공원,5908,6084,11992
<class,4호선,동대문,4403,5012,9415
<class,4호선,혜화,12988,13530,26518
<class,4호선,한성대입구,5431,5493,10924
<class,4호선,성신여대입구,8630,8547,17177
<class,4호선,길음,6876,6744,13620
<class,4호선,미아사거리,11575,11025,22600
<class,4호선,미아,5655,5468,11123
<class,4호선,수유,14379,13843,28222
<class,3호선,오금,1790,1805,3595
<class,3호선,경찰병원,1922,2028,3950
<class,3호선,가락시장,2504,2802,5306
<class,3호선,수서,7320,6756,14076
<class,3호선,일원,2206,2341,4547
<class,3호선,대청,2846,2808,5654
<class,3호선,학여울,506,508,1014
<class,3호선,대치,4644,4130,8774
<class,3호선,도곡,1316,1425,2741
<class,3호선,매봉,2808,2893,5701
<class,3호선,양재,8181,9768,17949
<class,3호선,남부터미널,9903,9975,19878
<class,3호선,교대,2747,1791,4538
<class,3호선,고속터미널,25789,22121,47910
<class,3호선,잠원,1461,1414,2875
<class,3호선,신사,8221,8290,16511
<class,3호선,압구정,8908,9446,18354
<class,3호선,옥수,3575,3832,7407
<class,3호선,금호,2960,2887,5847
<class,3호선,약수,4521,4458,8979
<class,3호선,지축,1410,1351,2761
<class,2호선,용두,924,919,1843
<class,2호선,신정네거리,3671,3744,7415
<class,2호선,양천구청,2147,2318,4465
<class,2호선,도림천,332,346,678
<class,2호선,신설동,2097,2211,4308
<class,2호선,신답,493,566,1059
<class,2호선,용답,1279,1242,2521
<class,2호선,충정로,2431,2538,4969
<class,2호선,아현,3650,3648,7298
<class,2호선,사당,13292,14803,28095
<class,2호선,방배,4476,4823,9299
<class,2호선,서초,4504,4010,8514
<class,2호선,교대,7343,8226,15569
<class,2호선,강남,22663,21855,44518
<class,2호선,역삼,7036,8113,15149
<class,2호선,선릉,9219,8014,17233
<class,2호선,삼성,10780,10566,21346
<class,2호선,종합운동장,2330,2498,4828
<class,2호선,잠실새내,7591,7960,15551
<class,2호선,잠실,28528,27156,55684
<class,2호선,잠실나루,3521,3668,7189
<class,2호선,강변,14769,13181,27950
<class,2호선,구의,8250,8231,16481
<class,2호선,건대입구,16624,17922,34546
<class,2호선,성수,8224,9504,17728
<class,2호선,뚝섬,6024,6401,12425
<class,2호선,한양대,1710,1947,3657
<class,2호선,왕십리,6377,5586,11963
<class,2호선,상왕십리,4850,4773,9623
<class,2호선,신당,5619,6015,11634
<class,2호선,동대문역사문화공원,5076,6225,11301
<class,2호선,을지로4가,2257,1971,4228
<class,2호선,을지로3가,4096,3870,7966
<class,2호선,을지로입구,10216,9901,20117
<class,2호선,시청,3730,3290,7020
<class,1호선,청량리,9683,9911,19594
<class,1호선,제기동,6770,7164,13934
<class,1호선,신설동,5292,5342,10634
<class,1호선,동대문,6426,7027,13453
<class,1호선,종로5가,5401,5703,11104
<class,1호선,종로3가,9246,8494,17740
<class,1호선,종각,7638,7222,14860
<class,1호선,시청,4502,4310,8812
<class,1호선,동묘앞,9224,9032,18256
<class,1호선,서울역,17507,14388,31895
<class,경춘선,강촌,574,667,1241
<class,경춘선,남춘천,2206,2199,4405
<class,경춘선,춘천,1332,1306,2638
<class,공항철도 1호선,서울역,4270,4651,8921
<class,공항철도 1호선,공덕,1053,1371,2424
<class,공항철도 1호선,홍대입구,6766,6454,13220
<class,공항철도 1호선,디지털미디어시티,3402,3189,6591
<class,공항철도 1호선,마곡나루,2000,2175,4175
<class,공항철도 1호선,김포공항,8780,4893,13673
<class,공항철도 1호선,계양,4724,4481,9205
<class,공항철도 1호선,검암,3249,3320,6569
<class,공항철도 1호선,청라국제도시,2814,2674,5488
<class,공항철도 1호선,운서,4471,4584,9055
<class,1호선,서울역,18055,18400,36455
<class,1호선,동묘앞,7698,7735,15433
<class,1호선,시청,6466,6176,12642
<class,1호선,종각,11376,10998,22374
<class,1호선,종로3가,14941,14142,29083
<class,1호선,종로5가,12106,12087,24193
<class,1호선,동대문,8020,7331,15351
<class,1호선,신설동,7044,6553,13597
<class,1호선,제기동,10643,10602,21245
<class,1호선,청량리,13340,13495,26835
<class,2호선,시청,5656,5256,10912
<class,2호선,을지로입구,13466,13611,27077
<class,2호선,을지로3가,6556,6481,13037
<class,2호선,을지로4가,4988,5042,10030
<class,2호선,동대문역사문화공원,6915,7269,14184
<class,2호선,신당,7987,8172,16159
<class,2호선,상왕십리,7493,7164,14657
<class,2호선,왕십리,8997,7336,16333
<class,2호선,한양대,2510,2424,4934
<class,2호선,뚝섬,8550,8944,17494
<class,2호선,성수,12232,13723,25955
<class,2호선,건대입구,21729,23279,45008
<class,2호선,구의,12296,11987,24283
<class,2호선,강변,16842,17798,34640
<class,2호선,잠실나루,5543,5444,10987
<class,2호선,잠실,39735,38475,78210
<class,2호선,잠실새내,12245,12568,24813
<class,2호선,종합운동장,3210,3541,6751
<class,2호선,삼성,17511,17258,34769
<class,2호선,선릉,17225,15176,32401
<class,2호선,역삼,13011,14155,27166
<class,2호선,강남,42937,41636,84573
<class,2호선,교대,12462,13985,26447
<class,2호선,서초,6837,5899,12736
<class,2호선,방배,6880,7240,14120
<class,2호선,사당,19558,21213,40771
<class,2호선,낙성대,15918,14823,30741
<class,2호선,서울대입구,28244,27393,55637
<class,2호선,봉천,13469,12391,25860
<class,2호선,신림,38330,36632,74962
<class,2호선,신대방,15247,14855,30102
<class,2호선,구로디지털단지,25287,24704,49991
<class,2호선,대림,13672,14586,28258
<class,2호선,신도림,26918,26611,53529
<class,2호선,문래,7950,8274,16224
<class,2호선,영등포구청,8858,8857,17715
<class,2호선,당산,8303,9148,17451
<class,2호선,합정,17232,17959,35191
<class,2호선,홍대입구,34196,35340,69536
<class,2호선,신촌,20259,20026,40285
<class,2호선,이대,7011,7170,14181
<class,2호선,아현,5588,5433,11021
<class,2호선,충정로,3605,3646,7251
<class,2호선,용답,1657,1585,3242
<class,2호선,신답,701,729,1430
<class,2호선,신설동,2290,2224,4514
<class,2호선,도림천,674,684,1358
<class,2호선,양천구청,3501,3522,7023
<class,2호선,신정네거리,5629,5806,11435
<class,2호선,용두,1396,1392,2788
<class,3호선,지축,2041,1990,4031
<class,3호선,구파발,11839,11960,23799
<class,3호선,연신내,23075,21396,44471
<class,3호선,불광,9732,10918,20650
<class,3호선,녹번,7628,6654,14282
<class,3호선,홍제,9662,9082,18744
<class,3호선,무악재,1975,2029,4004
<class,3호선,독립문,3744,3589,7333
<class,3호선,경복궁,8775,8938,17713
<class,3호선,안국,7311,8027,15338
<class,3호선,종로3가,3855,4950,8805
<class,3호선,을지로3가,3428,3622,7050
<class,3호선,동대입구,3881,3919,7800
<class,3호선,약수,6883,6437,13320
<class,3호선,금호,4415,4039,8454
<class,3호선,옥수,5143,5283,10426
<class,3호선,압구정,18833,19475,38308
<class,3호선,신사,16665,17013,33678
<class,3호선,잠원,2524,2431,4955
<class,3호선,고속터미널,30227,31777,62004
<class,3호선,교대,4716,2802,7518
<class,3호선,남부터미널,13691,14671,28362
<class,3호선,양재,13542,14656,28198
<class,3호선,매봉,4372,4286,8658
<class,3호선,도곡,2341,2248,4589
<class,3호선,대치,7616,6778,14394
<class,3호선,학여울,744,689,1433
<class,3호선,대청,4361,3981,8342
<class,3호선,일원,3362,3401,6763
<class,3호선,수서,8461,9185,17646
<class,3호선,가락시장,4582,4255,8837
<class,3호선,경찰병원,2958,2992,5950
<class,3호선,오금,2944,2859,5803
<class,4호선,수유,20405,20109,40514
<class,4호선,미아,8435,8044,16479
<class,4호선,미아사거리,16844,16232,33076
<class,4호선,길음,10105,9617,19722
<class,4호선,성신여대입구,12370,11617,23987
<class,4호선,한성대입구,7372,7013,14385
<class,4호선,혜화,16744,17030,33774
<class,4호선,동대문,10375,10122,20497
<class,4호선,동대문역사문화공원,7479,6585,14064
<class,4호선,충무로,8518,8834,17352
<class,4호선,명동,7407,8352,15759
<class,4호선,회현,12217,12695,24912
<class,4호선,서울역,3682,7030,10712
<class,4호선,숙대입구,6208,5932,12140
<class,4호선,삼각지,2079,2482,4561
<class,4호선,신용산,6923,7321,14244
<class,4호선,이촌,4431,4843,9274
<class,4호선,동작,1228,1258,2486
<class,4호선,총신대입구,10675,11533,22208
<class,4호선,사당,13406,11269,24675
<class,4호선,남태령,724,585,1309
<class,4호선,당고개,7856,7575,15431
<class,4호선,상계,10836,10139,20975
<class,4호선,노원,12106,13063,25169
<class,4호선,창동,14641,15662,30303
<class,4호선,쌍문,16613,15385,31998
<class,5호선,방화,3723,3612,7335
<class,5호선,개화산,2847,2809,5656
<class,5호선,김포공항,6162,6065,12227
<class,5호선,송정,3978,3742,7720
<class,5호선,마곡,4093,4159,8252
<class,5호선,발산,9168,9699,18867
<class,5호선,우장산,7227,7238,14465
<class,5호선,화곡,15246,14194,29440
<class,5호선,까치산,16096,15544,31640
<class,5호선,신정,6764,5908,12672
<class,5호선,목동,8451,8548,16999
<class,5호선,오목교,12511,12876,25387
<class,5호선,양평,2718,2595,5313
<class,5호선,영등포구청,1433,1407,2840
<class,5호선,영등포시장,4772,4826,9598
<class,5호선,신길,1891,1923,3814
<class,5호선,여의도,7099,7586,14685
<class,5호선,여의나루,4519,5102,9621
<class,5호선,마포,5200,5280,10480
<class,5호선,공덕,4847,4978,9825
<class,5호선,애오개,2674,2519,5193
<class,5호선,충정로,1471,1422,2893
<class,5호선,서대문,4888,4743,9631
<class,5호선,광화문,9530,9770,19300
<class,5호선,종로3가,7275,7391,14666
<class,5호선,을지로4가,2316,2474,4790
<class,5호선,동대문역사문화공원,778,936,1714
<class,5호선,청구,2071,1754,3825
<class,5호선,신금호,3155,3251,6406
<class,5호선,행당,4095,3607,7702
<class,5호선,왕십리,2652,2944,5596
<class,5호선,마장,2971,2747,5718
<class,5호선,답십리,7788,7203,14991
<class,5호선,장한평,8371,8257,16628
<class,5호선,군자,6132,6892,13024
<class,5호선,아차산,8884,8513,17397
<class,5호선,광나루,7240,6767,14007
<class,5호선,천호,12414,11858,24272
<class,5호선,강동,9161,8739,17900
<class,5호선,길동,4824,5038,9862
<class,5호선,굽은다리,5772,5475,11247
<class,5호선,명일,4423,4472,8895
<class,5호선,고덕,4769,4726,9495
<class,5호선,상일동,7226,6760,13986
<class,5호선,둔촌동,4936,4939,9875
<class,5호선,올림픽공원,2107,1737,3844
<class,5호선,방이,4098,3943,8041
<class,5호선,오금,1973,1857,3830
<class,5호선,개롱,3127,3353,6480
<class,5호선,거여,4456,4356,8812
<class,5호선,마천,3433,3445,6878
<class,5호선,강일,1628,1598,3226
<class,5호선,미사,8188,8143,16331
<class,5호선,하남풍산,1962,2108,4070
<class,5호선,하남시청,3395,3283,6678
<class,5호선,하남검단산,3663,3639,7302
<class,6호선,응암,9696,9707,19403
<class,6호선,역촌,2307,2495,4802
<class,6호선,불광,2856,2754,5610
<class,6호선,독바위,1637,1841,3478
<class,6호선,연신내,1,0,1
<class,6호선,구산,4216,3299,7515
<class,6호선,새절,7011,6836,13847
<class,6호선,증산,5781,5702,11483
<class,6호선,디지털미디어시티,5225,5385,10610
<class,6호선,월드컵경기장,3344,3403,6747
<class,6호선,마포구청,7363,6629,13992
<class,6호선,망원,8971,9817,18788
<class,6호선,합정,8042,7519,15561
<class,6호선,상수,4936,5602,10538
<class,6호선,광흥창,3776,3556,7332
<class,6호선,대흥,4054,4152,8206
<class,6호선,공덕,6973,6620,13593
<class,6호선,효창공원앞,3330,2936,6266
<class,6호선,삼각지,3224,2376,5600
<class,6호선,녹사평,2913,2926,5839
<class,6호선,이태원,6313,6733,13046
<class,6호선,한강진,4720,5486,10206
<class,6호선,버티고개,945,1179,2124
<class,6호선,약수,1975,1750,3725
<class,6호선,청구,1793,1874,3667
<class,6호선,신당,4187,3537,7724
<class,6호선,동묘앞,5760,5497,11257
<class,6호선,창신,1726,1413,3139
<class,공항철도 1호선,공항화물청사,1246,1241,2487
<class,공항철도 1호선,인천공항1터미널,3410,3354,6764
<class,공항철도 1호선,인천공항2터미널,2269,2120,4389
<class,공항철도 1호선,영종,2023,2156,4179
<class,과천선,선바위,3431,3128,6559
<class,과천선,경마공원,826,769,1595
<class,과천선,대공원,2198,2319,4517
<class,과천선,과천,3081,2826,5907
<class,과천선,정부과천청사,4357,4432,8789
<class,과천선,인덕원,10830,10625,21455
<class,과천선,평촌,6553,6422,12975
<class,과천선,범계,14389,14075,28464
<class,분당선,선릉,3716,5425,9141
<class,6호선,보문,3762,3335,7097
<class,6호선,안암,4093,3904,7997
<class,6호선,고려대,3900,3631,7531
<class,6호선,월곡,5617,5633,11250
<class,6호선,상월곡,3113,2807,5920
<class,6호선,돌곶이,4560,4243,8803
<class,6호선,석계,6609,6805,13414
<class,6호선,태릉입구,2994,3176,6170
<class,6호선,화랑대,5171,4397,9568
<class,6호선,봉화산,4101,4111,8212
<class,7호선,장암,1347,1044,2391
<class,7호선,도봉산,5867,7338,13205
<class,7호선,수락산,8198,8055,16253
<class,7호선,마들,7096,6653,13749
<class,7호선,노원,12179,12816,24995
<class,7호선,중계,7032,6329,13361
<class,7호선,하계,9200,8756,17956
<class,7호선,공릉,6587,6467,13054
<class,7호선,태릉입구,4894,4543,9437
<class,7호선,먹골,5998,6019,12017
<class,7호선,중화,6260,6000,12260
<class,7호선,상봉,9907,9408,19315
<class,7호선,면목,8701,8559,17260
<class,7호선,사가정,9641,9437,19078
<class,7호선,용마산,3552,3554,7106
<class,7호선,중곡,5292,5086,10378
<class,7호선,군자,8430,6500,14930
<class,7호선,어린이대공원,6333,5991,12324
<class,7호선,건대입구,7883,7516,15399
<class,7호선,뚝섬유원지,5070,4883,9953
<class,7호선,청담,8166,8517,16683
<class,7호선,강남구청,6765,7362,14127
<class,7호선,학동,7263,7681,14944
<class,7호선,논현,8699,9535,18234
<class,7호선,반포,3464,3204,6668
<class,7호선,고속터미널,8460,6889,15349
<class,7호선,내방,6130,6080,12210
<class,7호선,이수,8747,8373,17120
<class,7호선,남성,5830,5463,11293
<class,7호선,숭실대입구,5695,5729,11424
<class,7호선,상도,5629,5231,10860
<class,7호선,장승배기,5584,5263,10847
<class,7호선,신대방삼거리,8826,8429,17255
<class,7호선,보라매,4832,4528,9360
<class,7호선,신풍,6371,6054,12425
<class,7호선,대림,5710,6045,11755
<class,7호선,남구로,6804,7155,13959
<class,7호선,가산디지털단지,11583,10553,22136
<class,7호선,철산,11438,11384,22822
<class,7호선,광명사거리,13060,13346,26406
<class,7호선,천왕,5130,4880,10010
<class,7호선,온수,4503,4392,8895
<class,7호선,까치울,4152,4096,8248
<class,7호선,부천종합운동장,2524,2256,4780
<class,7호선,춘의,4441,4250,8691
<class,7호선,신중동,7567,7405,14972
<class,7호선,부천시청,7452,7557,15009
<class,7호선,상동,7506,7641,15147
<class,7호선,삼산체육관,2565,2420,4985
<class,7호선,굴포천,5022,5282,10304
<class,7호선,부평구청,3975,3478,7453
<class,8호선,암사,9768,9028,18796
<class,8호선,천호,9080,10781,19861
<class,8호선,강동구청,4623,4727,9350
<class,8호선,몽촌토성,3257,3061,6318
<class,8호선,잠실,8715,9743,18458
<class,8호선,석촌,4652,5426,10078
<class,8호선,송파,3762,3769,7531
<class,8호선,가락시장,4108,3958,8066
<class,8호선,문정,5763,5755,11518
<class,8호선,장지,9246,8740,17986
<class,8호선,복정,5188,4566,9754
<class,8호선,산성,3427,3455,6882
<class,8호선,남한산성입구,7103,6429,13532
<class,8호선,단대오거리,5718,5446,11164
<class,8호선,신흥,3184,3425,6609
<class,8호선,수진,3529,3143,6672
<class,8호선,모란,3311,2920,6231
<class,9호선,김포공항,6283,9817,16100
<class,분당선,한티,10020,9468,19488
<class,분당선,도곡,3124,2885,6009
<class,분당선,구룡,956,856,1812
<class,분당선,개포동,2051,1945,3996
<class,분당선,대모산입구,1808,1662,3470
<class,분당선,수서,6566,7269,13835
<class,분당선,복정,1,0,1
<class,분당선,수원,5460,4575,10035
<class,분당선,서울숲,4555,4507,9062
<class,분당선,압구정로데오,12244,13475,25719
<class,중앙선,지평,47,74,121
<class,분당선,강남구청,3694,4188,7882
<class,분당선,선정릉,2475,2493,4968
<class,분당선,가천대,3282,3844,7126
<class,분당선,태평,8710,8077,16787
<class,분당선,모란,14529,14734,29263
<class,분당선,야탑,12409,13299,25708
<class,분당선,서현,14147,14388,28535
<class,분당선,수내,6986,6643,13629
<class,분당선,정자,8195,8353,16548
<class,분당선,미금,8684,8862,17546
<class,분당선,오리,5864,4883,10747
<class,분당선,이매,3144,3018,6162
<class,분당선,보정,1159,1011,2170
<class,분당선,죽전,7451,8502,15953
<class,분당선,구성,2285,2477,4762
<class,분당선,신갈,1994,2086,4080
<class,분당선,기흥,5245,5039,10284
<class,분당선,상갈,2934,2989,5923
<class,분당선,청명,1915,1899,3814
<class,분당선,영통,4933,4728,9661
<class,분당선,망포,6622,6162,12784
<class,분당선,매탄권선,2552,2394,4946
<class,분당선,수원시청,7362,7804,15166
<class,분당선,매교,1474,1497,2971
<class,수인선,고색,1885,1887,3772
<class,수인선,오목천,1606,1428,3034
<class,수인선,어천,532,444,976
<class,수인선,야목,149,134,283
<class,수인선,사리,2337,2019,4356
<class,수인선,달월,39,47,86
<class,수인선,월곶,1548,1529,3077
<class,수인선,소래포구,3726,3768,7494
<class,9호선,공항시장,1775,2054,3829
<class,9호선,신방화,3623,3542,7165
<class,9호선,마곡나루,5250,5161,10411
<class,9호선,양천향교,4450,4362,8812
<class,9호선,가양,10306,9924,20230
<class,9호선,증미,3384,3354,6738
<class,9호선,등촌,5877,5727,11604
<class,9호선,염창,8417,7892,16309
<class,9호선,신목동,1661,1418,3079
<class,9호선,선유도,2792,2663,5455
<class,9호선,당산,8941,8466,17407
<class,9호선,국회의사당,2293,2345,4638
<class,9호선,여의도,7212,6497,13709
<class,9호선,샛강,1876,1847,3723
<class,9호선,노량진,16194,15800,31994
<class,9호선,노들,2400,2029,4429
<class,9호선,흑석,3866,3902,7768
<class,9호선,동작,964,792,1756
<class,9호선,구반포,1352,1379,2731
<class,9호선,신반포,1779,1707,3486
<class,9호선,고속터미널,8036,11262,19298
<class,9호선,사평,1559,1505,3064
<class,9호선,신논현,17759,17379,35138
<class,9호선2~3단계,언주,3994,3955,7949
<class,9호선2~3단계,선정릉,3213,3512,6725
<class,9호선2~3단계,삼성중앙,2312,2384,4696
<class,9호선2~3단계,봉은사,6733,6887,13620
<class,9호선2~3단계,종합운동장,2322,2187,4509
<class,9호선2~3단계,삼전,3812,3565,7377
<class,9호선2~3단계,석촌고분,3212,3167,6379
<class,9호선2~3단계,석촌,4677,3916,8593
<class,9호선2~3단계,송파나루,2975,3283,6258
<class,9호선2~3단계,한성백제,1281,1208,2489
<class,9호선2~3단계,올림픽공원,2683,2731,5414
<class,9호선2~3단계,둔촌오륜,483,496,979
<class,9호선2~3단계,중앙보훈병원,3392,3247,6639
<class,경강선,판교,2229,2179,4408
<class,경강선,이매,608,459,1067
<class,경강선,삼동,1217,1137,2354
<class,경강선,경기광주,3762,3597,7359
<class,경강선,초월,1601,1510,3111
<class,경강선,곤지암,1361,1536,2897
<class,경강선,신둔도예촌,750,786,1536
<class,경강선,이천,1858,2019,3877
<class,경강선,부발,1326,1201,2527
<class,경강선,세종대왕릉,221,251,472
<class,경강선,여주,1588,1809,3397
<class,경부선,서울역,3172,1025,4197
<class,경부선,남영,3858,3720,7578
<class,경부선,용산,21101,24380,45481
<class,경부선,노량진,5823,5468,11291
<class,경부선,대방,5552,5810,11362
<class,경부선,영등포,26401,27568,53969
<class,경부선,신도림,1951,1929,3880
<class,경부선,신길,4637,3854,8491
<class,경부선,구로,9629,10257,19886
<class,경부선,가산디지털단지,4572,6226,10798
<class,경부선,금천구청,5745,6285,12030
<class,경부선,석수,5154,4816,9970
<class,경부선,관악,4130,4059,8189
<class,경부선,안양,12739,13263,26002
<class,경부선,명학,4048,3898,7946
<class,경부선,금정,13376,13733,27109
<class,경부선,군포,3377,3048,6425
<class,경부선,의왕,4315,4324,8639
<class,경부선,성균관대,7254,7281,14535
<class,경부선,화서,3548,3608,7156
<class,경부선,수원,26049,27781,53830
<class,경부선,독산,6282,6518,12800
<class,경부선,세류,1997,1990,3987
<class,경부선,병점,8817,8667,17484
<class,경부선,세마,1508,1377,2885
<class,경부선,오산대,1917,1799,3716
<class,경부선,오산,6834,6574,13408
<class,경부선,진위,775,674,1449
<class,경부선,송탄,3430,3226,6656
<class,경부선,서정리,4591,3843,8434
<class,경부선,평택지제,2094,1976,4070
<class,경부선,평택,9654,9384,19038
<class,경부선,성환,2159,2057,4216
<class,경부선,직산,507,477,984
<class,경부선,두정,4156,4366,8522
<class,경부선,천안,4939,5222,10161
<class,경부선,당정,2889,2740,5629
<class,경부선,서동탄,761,803,1564
<class,경부선,광명,1586,1629,3215
<class,경원선,이촌,2107,1618,3725
<class,경원선,서빙고,956,822,1778
<class,경원선,한남,2107,1945,4052
<class,경원선,옥수,37,34,71
<class,경원선,응봉,1002,808,1810
<class,경원선,왕십리,8762,10298,19060
<class,경원선,청량리,11208,12820,24028
<class,경원선,외대앞,4090,4048,8138
<class,경원선,신이문,4774,4251,9025
<class,경원선,석계,4858,5037,9895
<class,경원선,광운대,4226,4045,8271
<class,경원선,월계,3689,3371,7060
<class,경원선,녹천,2515,2100,4615
<class,경원선,방학,5814,5583,11397
<class,경원선,도봉,3421,3217,6638
<class,경원선,도봉산,6213,4722,10935
<class,경원선,망월사,4409,4398,8807
<class,경원선,회룡,6880,7073,13953
<class,경원선,의정부,12790,13405,26195
<class,경원선,가능,3914,3708,7622
<class,경원선,녹양,2555,2435,4990
<class,경원선,양주,4695,4522,9217
<class,경원선,덕계,1670,1516,3186
<class,경원선,덕정,3292,3110,6402
<class,경원선,지행,3908,4016,7924
<class,경원선,동두천중앙,1912,1978,3890
<class,경원선,보산,1034,1064,2098
<class,경원선,동두천,1391,1695,3086
<class,경원선,소요산,4061,3680,7741
<class,경의선,서울역,773,980,1753
<class,경의선,신촌,253,241,494
<class,경의선,효창공원앞,1270,1424,2694
<class,경의선,공덕,1576,1321,2897
<class,경의선,서강대,1287,1115,2402
<class,경의선,홍대입구,1106,1225,2331
<class,경의선,가좌,3067,2907,5974
<class,경의선,디지털미디어시티,1374,1239,2613
<class,경의선,수색,1021,963,1984
<class,경의선,화전,682,635,1317
<class,경의선,강매,1343,1275,2618
<class,경의선,행신,3617,3741,7358
<class,경의선,능곡,2106,2051,4157
<class,경의선,곡산,286,323,609
<class,경의선,백마,3046,2983,6029
<class,수인선,인천논현,3390,3535,6925
<class,수인선,호구포,2058,1981,4039
<class,수인선,남동인더스파크,875,814,1689
<class,수인선,원인재,2679,2843,5522
<class,수인선,연수,2765,2817,5582
<class,수인선,송도,1417,1370,2787
<class,우이신설선,4.19민주묘지,1766,1541,3307
<class,우이신설선,화계,1873,1787,3660
<class,우이신설선,삼양,1208,1282,2490
<class,우이신설선,삼양사거리,1564,1576,3140
<class,우이신설선,솔샘,2731,2515,5246
<class,우이신설선,북한산보국문,3432,3143,6575
<class,우이신설선,정릉,2493,2132,4625
<class,경의선,일산,4272,4162,8434
<class,우이신설선,성신여대입구,2118,2360,4478
<class,우이신설선,보문,885,847,1732
<class,우이신설선,신설동,1075,1000,2075
<class,일산선,원흥,5302,5165,10467
<class,일산선,삼송,9844,9898,19742
<class,일산선,원당,5933,5738,11671
<class,일산선,화정,9280,9593,18873
<class,일산선,대곡,943,839,1782
<class,일산선,백석,5642,5605,11247
<class,일산선,마두,3913,3978,7891
<class,일산선,정발산,4809,4865,9674
<class,일산선,주엽,4863,4902,9765
<class,일산선,대화,6348,5861,12209
<class,장항선,봉명,585,527,1112
<class,장항선,쌍용,1127,1037,2164
<class,장항선,아산,1960,1908,3868
<class,장항선,배방,718,659,1377
<class,경의선,풍산,3005,2900,5905
<class,장항선,온양온천,3546,3629,7175
<class,장항선,신창,884,838,1722
<class,중앙선,회기,13238,12380,25618
<class,중앙선,중랑,3488,3282,6770
<class,중앙선,상봉,3895,3806,7701
<class,중앙선,망우,4674,4605,9279
<class,중앙선,양원,927,885,1812
<class,중앙선,구리,7576,7739,15315
<class,중앙선,도농,4627,4536,9163
<class,중앙선,양정,485,460,945
<class,중앙선,덕소,3482,3533,7015
<class,중앙선,도심,1194,976,2170
<class,중앙선,팔당,1127,1146,2273
<class,중앙선,운길산,887,869,1756
<class,중앙선,양수,1606,1742,3348
<class,중앙선,신원,207,159,366
<class,중앙선,국수,482,493,975
<class,중앙선,아신,519,521,1040
<class,중앙선,오빈,210,237,447
<class,중앙선,양평,2015,2054,4069
<class,중앙선,원덕,281,331,612
<class,중앙선,용문,2627,2981,5608
<class,우이신설선,가오리,2312,2221,4533
<class,우이신설선,솔밭공원,1412,1364,2776
<class,우이신설선,북한산우이,2419,2628,5047
<class,안산선,수리산,2217,1931,4148
<class,안산선,오이도,5860,5983,11843
<class,안산선,정왕,4730,4939,9669
<class,안산선,신길온천,992,1047,2039
<class,안산선,안산,7527,7843,15370
<class,안산선,초지,2220,2298,4518
<class,안산선,고잔,4062,4019,8081
<class,안산선,중앙,10699,11217,21916
<class,안산선,한대앞,5137,5253,10390
<class,안산선,상록수,9003,8873,17876
<class,안산선,반월,2568,2396,4964
<class,안산선,대야미,2880,2643,5523
<class,안산선,산본,8745,9469,18214
<class,수인선,인천,1168,1706,2874
<class,수인선,신포,1045,1075,2120
<class,수인선,숭의,2072,1954,4026
<class,수인선,인하대,3061,2831,5892
<class,9호선,개화,1066,985,2051
<class,경의선,탄현,3800,3854,7654
<class,경의선,야당,3887,3838,7725
<class,경의선,운정,3322,3239,6561
<class,경의선,금릉,2699,2654,5353
<class,경의선,금촌,4004,3990,7994
<class,경의선,월롱,1069,1045,2114
<class,경의선,파주,693,536,1229
<class,경의선,문산,3723,3758,7481
<class,경의선,임진강,40,42,82
<class,경인선,개봉,12109,12145,24254
<class,경인선,오류동,7051,6379,13430
<class,경인선,역곡,14384,14587,28971
<class,경인선,부천,21786,22367,44153
<class,경인선,송내,12967,12948,25915
<class,경인선,부평,21622,23323,44945
<class,경인선,백운,4065,3968,8033
<class,경인선,동암,9233,9527,18760
<class,경인선,주안,11261,10020,21281
<class,경인선,제물포,5196,5233,10429
<class,경인선,동인천,8841,8656,17497
<class,경인선,인천,3046,2516,5562
<class,경인선,구일,3282,3096,6378
<class,경인선,소사,4980,4910,9890
<class,경인선,부개,4718,4446,9164
<class,경인선,간석,3230,3106,6336
<class,경인선,도원,1453,1517,2970
<class,경인선,온수,3633,3261,6894
<class,경인선,중동,4780,4603,9383
<class,경인선,도화,2469,2337,4806
<class,경춘선,신내,876,812,1688
<class,경춘선,갈매,1438,1327,2765
<class,경춘선,별내,1676,1635,3311
<class,경춘선,퇴계원,2014,1891,3905
<class,경춘선,사릉,1677,1723,3400
<class,경춘선,금곡,825,772,1597
<class,경춘선,평내호평,3295,3327,6622
<class,경춘선,천마산,1036,1053,2089
<class,경춘선,마석,2397,2537,4934
<class,경춘선,대성리,457,460,917
<class,경춘선,청평,1298,1373,2671
<class,경춘선,상천,334,284,618
<class,경춘선,가평,1768,1990,3758
<class,경춘선,굴봉산,182,182,364
<class,경춘선,백양리,182,203,385
<class,경춘선,김유정,350,435,785
<class,우이신설선,가오리,1716,1647,3363
<class,장항선,봉명,437,426,863
<class,장항선,쌍용,838,831,1669
<class,장항선,아산,2030,1481,3511
<class,장항선,배방,570,618,1188
<class,장항선,온양온천,2392,2465,4857
<class,장항선,신창,820,902,1722
<class,중앙선,회기,10247,10518,20765
<class,중앙선,중랑,2485,2473,4958
<class,중앙선,상봉,3017,2975,5992
<class,중앙선,망우,3182,3413,6595
<class,중앙선,양원,576,599,1175
<class,중앙선,구리,5366,5639,11005
<class,중앙선,도농,3328,3338,6666
<class,중앙선,양정,380,338,718
<class,중앙선,덕소,2570,2584,5154
<class,중앙선,도심,953,820,1773
<class,중앙선,팔당,1103,1091,2194
<class,일산선,대화,4753,4350,9103
<class,경원선,창동,1,0,1
<class,1호선,서울역,16271,13807,30078
<class,1호선,동묘앞,8210,7968,16178
<class,1호선,시청,4563,4450,9013
<class,1호선,종각,7803,7279,15082
<class,1호선,종로3가,9222,8528,17750
<class,1호선,종로5가,5403,5566,10969
<class,1호선,동대문,6082,6636,12718
<class,1호선,신설동,4908,4933,9841
<class,1호선,제기동,6541,6813,13354
<class,1호선,청량리,9575,9732,19307
<class,2호선,시청,3614,3149,6763
<class,2호선,을지로입구,10098,9635,19733
<class,2호선,을지로3가,4348,3965,8313
<class,2호선,을지로4가,2164,2101,4265
<class,2호선,동대문역사문화공원,5147,6090,11237
<class,2호선,신당,5503,5898,11401
<class,2호선,상왕십리,4874,4815,9689
<class,2호선,왕십리,6253,5384,11637
<class,2호선,한양대,1921,1861,3782
<class,2호선,뚝섬,5553,5929,11482
<class,2호선,성수,7837,8671,16508
<class,2호선,건대입구,16175,17061,33236
<class,2호선,구의,8018,8194,16212
<class,2호선,강변,14220,12988,27208
<class,2호선,잠실나루,3721,3817,7538
<class,2호선,잠실,29102,27573,56675
<class,2호선,잠실새내,7469,7739,15208
<class,2호선,종합운동장,2161,2316,4477
<class,2호선,삼성,12061,11701,23762
<class,2호선,선릉,8750,7575,16325
<class,2호선,역삼,7023,7848,14871
<class,2호선,강남,23092,21811,44903
<class,2호선,교대,6985,7884,14869
<class,2호선,서초,4248,3762,8010
<class,2호선,방배,4283,4731,9014
<class,2호선,사당,13011,14481,27492
<class,2호선,낙성대,10686,11152,21838
<class,2호선,서울대입구,19091,20017,39108
<class,2호선,봉천,8600,8587,17187
<class,2호선,신림,26504,26509,53013
<class,2호선,신대방,10761,10741,21502
<class,2호선,구로디지털단지,15981,15940,31921
<class,2호선,대림,10027,10179,20206
<class,2호선,신도림,17664,17981,35645
<class,2호선,문래,4773,4965,9738
<class,2호선,영등포구청,5113,5187,10300
<class,2호선,당산,5601,6026,11627
<class,2호선,합정,12360,12803,25163
<class,2호선,홍대입구,25789,25701,51490
<class,2호선,신촌,14001,13863,27864
<class,2호선,이대,4599,5005,9604
<class,2호선,아현,3683,3727,7410
<class,2호선,충정로,2624,2684,5308
<class,2호선,용답,1235,1237,2472
<class,2호선,신답,458,544,1002
<class,2호선,신설동,1877,2066,3943
<class,2호선,도림천,345,373,718
<class,2호선,양천구청,2052,2210,4262
<class,2호선,신정네거리,3571,3713,7284
<class,2호선,용두,802,804,1606
<class,3호선,지축,1347,1280,2627
<class,3호선,구파발,8484,8686,17170
<class,3호선,연신내,15678,14886,30564
<class,3호선,불광,6845,7834,14679
<class,3호선,녹번,4860,4439,9299
<class,3호선,홍제,6369,6163,12532
<class,3호선,무악재,1249,1321,2570
<class,3호선,독립문,2610,2518,5128
<class,3호선,경복궁,6176,6487,12663
<class,3호선,안국,5273,5765,11038
<class,3호선,종로3가,2449,3135,5584
<class,3호선,을지로3가,1767,1806,3573
<class,3호선,동대입구,3118,3315,6433
<class,3호선,약수,4309,4229,8538
<class,3호선,금호,2954,2802,5756
<class,3호선,옥수,3408,3701,7109
<class,3호선,압구정,9573,10027,19600
<class,3호선,신사,8395,8540,16935
<class,3호선,잠원,1385,1386,2771
<class,3호선,고속터미널,26540,23297,49837
<class,3호선,교대,2779,1783,4562
<class,3호선,남부터미널,10008,10000,20008
<class,3호선,양재,8147,9566,17713
<class,3호선,매봉,2839,2930,5769
<class,3호선,도곡,1221,1309,2530
<class,3호선,대치,4605,3912,8517
<class,3호선,학여울,510,524,1034
<class,3호선,대청,2759,2585,5344
<class,3호선,일원,2203,2349,4552
<class,3호선,수서,7139,6628,13767
<class,3호선,가락시장,2348,2634,4982
<class,3호선,경찰병원,1928,1988,3916
<class,3호선,오금,1867,1903,3770
<class,4호선,수유,14061,13963,28024
<class,4호선,미아,5617,5308,10925
<class,4호선,미아사거리,11356,10838,22194
<class,4호선,길음,6769,6667,13436
<class,4호선,성신여대입구,8717,8493,17210
<class,4호선,한성대입구,5415,5438,10853
<class,4호선,혜화,13076,13656,26732
<class,4호선,동대문,4121,4812,8933
<class,4호선,동대문역사문화공원,5814,5846,11660
<class,4호선,충무로,4957,5152,10109
<class,4호선,명동,5875,5895,11770
<class,4호선,회현,5808,5980,11788
<class,4호선,서울역,2715,4980,7695
<class,4호선,숙대입구,4406,4136,8542
<class,4호선,삼각지,1456,1709,3165
<class,4호선,신용산,5049,5210,10259
<class,4호선,이촌,3246,3540,6786
<class,4호선,동작,1003,994,1997
<class,4호선,총신대입구,6814,7565,14379
<class,4호선,사당,9315,8780,18095
<class,4호선,남태령,406,370,776
<class,4호선,당고개,5963,5756,11719
<class,4호선,상계,7400,6895,14295
<class,4호선,노원,8271,8895,17166
<class,4호선,창동,9657,10243,19900
<class,4호선,쌍문,11044,10292,21336
<class,5호선,방화,2678,2705,5383
<class,5호선,개화산,1974,2041,4015
<class,5호선,김포공항,6156,5195,11351
<class,5호선,송정,2611,2729,5340
<class,5호선,마곡,2506,2614,5120
<class,5호선,발산,6017,6308,12325
<class,5호선,우장산,4508,4771,9279
<class,5호선,화곡,9817,9445,19262
<class,5호선,까치산,11010,10952,21962
<class,5호선,신정,4403,4034,8437
<class,5호선,목동,5214,5351,10565
<class,5호선,오목교,8289,8588,16877
<class,5호선,양평,1776,1769,3545
<class,5호선,영등포구청,885,863,1748
<class,5호선,영등포시장,2995,3040,6035
<class,5호선,신길,1336,1529,2865
<class,5호선,여의도,4913,5172,10085
<class,5호선,여의나루,4283,4758,9041
<class,5호선,마포,3202,3227,6429
<class,5호선,공덕,2891,3013,5904
<class,5호선,애오개,1789,1824,3613
<class,5호선,충정로,968,1011,1979
<class,5호선,서대문,3077,3029,6106
<class,5호선,광화문,7090,7350,14440
<class,5호선,종로3가,5128,4736,9864
<class,5호선,을지로4가,1026,1053,2079
<class,5호선,동대문역사문화공원,501,567,1068
<class,5호선,청구,1216,1115,2331
<class,5호선,신금호,2025,2209,4234
<class,5호선,행당,2802,2576,5378
<class,5호선,왕십리,1635,1833,3468
<class,5호선,마장,1993,1918,3911
<class,5호선,답십리,4994,4656,9650
<class,5호선,장한평,5289,5297,10586
<class,5호선,군자,4124,4709,8833
<class,5호선,아차산,6402,6294,12696
<class,5호선,광나루,5299,5017,10316
<class,5호선,천호,8551,8068,16619
<class,5호선,강동,5879,6022,11901
<class,5호선,길동,3004,3230,6234
<class,5호선,굽은다리,3726,3396,7122
<class,5호선,명일,2844,2918,5762
<class,5호선,고덕,2931,2963,5894
<class,5호선,상일동,4525,4432,8957
<class,5호선,둔촌동,3126,3197,6323
<class,5호선,올림픽공원,1318,1136,2454
<class,5호선,방이,2505,2483,4988
<class,5호선,오금,1313,1148,2461
<class,5호선,개롱,2204,2375,4579
<class,5호선,거여,2607,2596,5203
<class,5호선,마천,2413,2622,5035
<class,5호선,강일,1140,1119,2259
<class,5호선,미사,5476,5596,11072
<class,5호선,하남풍산,1495,1601,3096
<class,5호선,하남시청,2216,2175,4391
<class,5호선,하남검단산,3116,3005,6121
<class,6호선,응암,6348,6500,12848
<class,6호선,역촌,1410,1635,3045
<class,6호선,불광,2132,1968,4100
<class,6호선,독바위,1258,1393,2651
<class,6호선,구산,2637,2168,4805
<class,6호선,새절,4564,4572,9136
<class,6호선,증산,3909,4003,7912
<class,6호선,디지털미디어시티,3478,3667,7145
<class,6호선,월드컵경기장,2200,2181,4381
<class,6호선,마포구청,5261,4954,10215
<class,6호선,망원,6278,6933,13211
<class,6호선,합정,5909,5343,11252
<class,6호선,상수,3506,4237,7743
<class,6호선,광흥창,2881,2754,5635
<class,6호선,대흥,2857,3008,5865
<class,6호선,공덕,4399,4174,8573
<class,6호선,효창공원앞,2252,2037,4289
<class,6호선,삼각지,2227,1847,4074
<class,6호선,녹사평,2158,2119,4277
<class,6호선,이태원,5043,5006,10049
<class,6호선,한강진,4331,4671,9002
<class,6호선,버티고개,698,798,1496
<class,6호선,약수,1223,1139,2362
<class,6호선,청구,1177,1232,2409
<class,6호선,신당,2760,3571,6331
<class,6호선,동묘앞,4059,4168,8227
<class,6호선,창신,1175,1100,2275
<class,6호선,보문,2539,2484,5023
<class,6호선,안암,3356,3586,6942
<class,6호선,고려대,2826,2849,5675
<class,6호선,월곡,3727,3751,7478
<class,6호선,상월곡,2202,1998,4200
<class,6호선,돌곶이,3733,3534,7267
<class,6호선,석계,4466,4588,9054
<class,6호선,태릉입구,2036,2276,4312
<class,6호선,화랑대,3403,2968,6371
<class,6호선,봉화산,2888,2834,5722
<class,7호선,장암,1158,915,2073
<class,7호선,도봉산,4989,5991,10980
<class,7호선,수락산,6459,6444,12903
<class,7호선,마들,4236,3948,8184
<class,7호선,노원,8213,8283,16496
<class,7호선,중계,4693,4368,9061
<class,7호선,하계,6243,5940,12183
<class,7호선,공릉,4515,4596,9111
<class,7호선,태릉입구,3439,3212,6651
<class,7호선,먹골,3957,3812,7769
<class,7호선,중화,4231,4217,8448
<class,7호선,상봉,6496,6030,12526
<class,7호선,면목,5852,5938,11790
<class,7호선,사가정,6662,6487,13149
<class,7호선,용마산,2240,2592,4832
<class,7호선,중곡,3428,3419,6847
<class,7호선,군자,5417,4389,9806
<class,7호선,어린이대공원,4286,4400,8686
<class,7호선,건대입구,5174,5251,10425
<class,7호선,뚝섬유원지,3863,3651,7514
<class,7호선,청담,4666,4754,9420
<class,7호선,강남구청,3748,4102,7850
<class,7호선,학동,3693,3968,7661
<class,7호선,논현,4594,4961,9555
<class,7호선,반포,1997,2027,4024
<class,7호선,고속터미널,8207,4936,13143
<class,7호선,내방,3682,3866,7548
<class,7호선,이수,5517,5459,10976
<class,7호선,남성,3882,3985,7867
<class,7호선,숭실대입구,3768,4059,7827
<class,7호선,상도,3636,3747,7383
<class,7호선,장승배기,3501,3622,7123
<class,7호선,신대방삼거리,5679,5700,11379
<class,7호선,보라매,3165,3190,6355
<class,7호선,신풍,4372,4164,8536
<class,7호선,대림,5011,4683,9694
<class,7호선,남구로,4937,4955,9892
<class,7호선,가산디지털단지,7706,7066,14772
<class,7호선,철산,7225,7276,14501
<class,7호선,광명사거리,8658,8651,17309
<class,7호선,천왕,3342,3263,6605
<class,7호선,온수,2782,2703,5485
<class,7호선,까치울,2802,2930,5732
<class,7호선,부천종합운동장,1783,1527,3310
<class,7호선,춘의,2731,2576,5307
<class,7호선,신중동,4806,4695,9501
<class,7호선,부천시청,4761,4740,9501
<class,7호선,상동,5073,4911,9984
<class,7호선,삼산체육관,1735,1611,3346
<class,7호선,굴포천,3334,3328,6662
<class,7호선,부평구청,2583,2355,4938
<class,8호선,암사,6416,6176,12592
<class,8호선,천호,6258,7147,13405
<class,8호선,강동구청,3076,3317,6393
<class,8호선,몽촌토성,2299,2229,4528
<class,8호선,잠실,6861,7445,14306
<class,8호선,석촌,2949,3495,6444
<class,8호선,송파,2609,2681,5290
<class,8호선,가락시장,2183,2776,4959
<class,8호선,문정,3427,3739,7166
<class,8호선,장지,6587,7031,13618
<class,8호선,복정,3255,3061,6316
<class,8호선,산성,2402,2443,4845
<class,8호선,남한산성입구,4777,4480,9257
<class,8호선,단대오거리,3761,3923,7684
<class,8호선,신흥,2079,2240,4319
<class,8호선,수진,2272,2018,4290
<class,8호선,모란,1944,1656,3600
<class,9호선,개화,775,788,1563
<class,9호선,김포공항,6369,8514,14883
<class,9호선,공항시장,1319,1456,2775
<class,9호선,신방화,2483,2445,4928
<class,9호선,마곡나루,3534,3739,7273
<class,9호선,양천향교,2925,3230,6155
<class,9호선,가양,6747,6899,13646
<class,9호선,증미,1820,1866,3686
<class,9호선,등촌,3774,3995,7769
<class,9호선,염창,5854,5778,11632
<class,9호선,신목동,1119,1060,2179
<class,9호선,선유도,1923,1939,3862
<class,9호선,당산,5840,5868,11708
<class,9호선,국회의사당,2024,2023,4047
<class,9호선,여의도,5340,4906,10246
<class,9호선,샛강,1148,1174,2322
<class,9호선,노량진,10496,11145,21641
<class,9호선,노들,1665,1492,3157
<class,9호선,흑석,2541,2716,5257
<class,9호선,동작,736,605,1341
<class,9호선,구반포,745,819,1564
<class,9호선,신반포,922,930,1852
<class,9호선,고속터미널,6645,8078,14723
<class,9호선,사평,1096,1117,2213
<class,9호선,신논현,10297,9941,20238
<class,9호선2~3단계,언주,2245,2383,4628
<class,9호선2~3단계,선정릉,2023,2297,4320
<class,9호선2~3단계,삼성중앙,1439,1513,2952
<class,9호선2~3단계,봉은사,4710,4675,9385
<class,9호선2~3단계,종합운동장,1701,1484,3185
<class,9호선2~3단계,삼전,2508,2660,5168
<class,9호선2~3단계,석촌고분,2245,2255,4500
<class,9호선2~3단계,석촌,3037,2645,5682
<class,9호선2~3단계,송파나루,2201,2345,4546
<class,9호선2~3단계,한성백제,928,894,1822
<class,9호선2~3단계,올림픽공원,2035,1925,3960
<class,9호선2~3단계,둔촌오륜,322,347,669
<class,9호선2~3단계,중앙보훈병원,2281,2306,4587
<class,경강선,판교,1784,1629,3413
<class,경강선,이매,461,353,814
<class,경강선,삼동,758,806,1564
<class,경강선,경기광주,2572,2586,5158
<class,경강선,초월,1158,1147,2305
<class,경강선,곤지암,1012,1186,2198
<class,경강선,신둔도예촌,621,558,1179
<class,경강선,이천,1418,1530,2948
<class,경강선,부발,866,1400,2266
<class,경강선,세종대왕릉,182,151,333
<class,경강선,여주,1513,1390,2903
<class,경부선,서울역,4262,931,5193
<class,경부선,남영,2664,3005,5669
<class,경부선,용산,21124,17773,38897
<class,경부선,노량진,3875,3626,7501
<class,경부선,대방,3796,4109,7905
<class,경부선,영등포,21861,20681,42542
<class,경부선,신도림,1335,1475,2810
<class,경부선,신길,3367,2934,6301
<class,경부선,구로,6560,6604,13164
<class,경부선,가산디지털단지,3074,4482,7556
<class,경부선,금천구청,4220,4169,8389
<class,경부선,석수,3421,3279,6700
<class,경부선,관악,3162,3038,6200
<class,경부선,안양,9454,9283,18737
<class,경부선,명학,2348,2314,4662
<class,경부선,금정,9355,9779,19134
<class,경부선,군포,2206,2105,4311
<class,경부선,의왕,2817,2884,5701
<class,경부선,성균관대,5113,5501,10614
<class,경부선,화서,2507,2420,4927
<class,경부선,수원,23067,21794,44861
<class,경부선,독산,3973,4174,8147
<class,경부선,세류,1461,1542,3003
<class,경부선,병점,6276,6934,13210
<class,경부선,세마,1130,1069,2199
<class,경부선,오산대,1479,1487,2966
<class,경부선,오산,5486,5855,11341
<class,경부선,진위,542,584,1126
<class,경부선,송탄,2574,2877,5451
<class,경부선,서정리,2921,4092,7013
<class,경부선,평택지제,1643,1454,3097
<class,경부선,평택,8094,8410,16504
<class,경부선,성환,1672,1973,3645
<class,경부선,직산,382,424,806
<class,경부선,두정,3724,3716,7440
<class,경부선,천안,4947,4591,9538
<class,경부선,당정,1895,1943,3838
<class,경부선,서동탄,493,503,996
<class,경부선,광명,1721,1130,2851
<class,경원선,이촌,1394,1185,2579
<class,경원선,서빙고,691,652,1343
<class,경원선,한남,1450,1454,2904
<class,경원선,옥수,52,17,69
<class,경원선,응봉,725,703,1428
<class,경원선,왕십리,6031,7179,13210
<class,경원선,청량리,10425,9085,19510
<class,경원선,외대앞,3125,3177,6302
<class,경원선,신이문,3353,3254,6607
<class,경원선,석계,3277,3708,6985
<class,경원선,광운대,2977,2891,5868
<class,경원선,월계,2437,2328,4765
<class,경원선,녹천,2012,1682,3694
<class,경원선,방학,3905,3783,7688
<class,경원선,도봉,2492,2338,4830
<class,경원선,도봉산,5773,4539,10312
<class,경원선,망월사,3166,3221,6387
<class,경원선,회룡,4963,5003,9966
<class,경원선,의정부,9609,9546,19155
<class,경원선,가능,2861,2763,5624
<class,경원선,녹양,1803,1824,3627
<class,경원선,양주,3414,3387,6801
<class,경원선,덕계,1174,1105,2279
<class,경원선,덕정,2337,2354,4691
<class,경원선,지행,2919,2887,5806
<class,경원선,동두천중앙,1699,1603,3302
<class,경원선,보산,921,846,1767
<class,경원선,동두천,1148,1321,2469
<class,경원선,소요산,4292,3812,8104
<class,경의선,서울역,675,571,1246
<class,경의선,신촌,204,192,396
<class,경의선,효창공원앞,879,1047,1926
<class,경의선,공덕,1140,993,2133
<class,경의선,서강대,851,829,1680
<class,경의선,홍대입구,864,1039,1903
<class,경의선,가좌,2099,2122,4221
<class,경의선,디지털미디어시티,946,872,1818
<class,경의선,수색,598,651,1249
<class,경의선,화전,493,530,1023
<class,경의선,강매,963,913,1876
<class,경의선,행신,2923,2783,5706
<class,경의선,능곡,1528,1540,3068
<class,경의선,곡산,187,191,378
<class,경의선,백마,2170,2112,4282
<class,경의선,풍산,2323,2204,4527
<class,경의선,일산,3060,2973,6033
<class,경의선,탄현,2866,2757,5623
<class,경의선,야당,2789,2678,5467
<class,경의선,운정,2361,2395,4756
<class,경의선,금릉,1886,1837,3723
<class,경의선,금촌,2838,3029,5867
<class,경의선,월롱,686,1307,1993
<class,경의선,파주,489,443,932
<class,경의선,문산,2989,2903,5892
<class,경의선,임진강,66,76,142
<class,경인선,개봉,7828,7992,15820
<class,경인선,오류동,4528,4340,8868
<class,경인선,역곡,9555,9538,19093
<class,경인선,부천,15066,14787,29853
<class,경인선,송내,8890,8761,17651
<class,경인선,부평,16180,16484,32664
<class,경인선,백운,2586,2580,5166
<class,경인선,동암,6650,6641,13291
<class,경인선,주안,8100,7243,15343
<class,경인선,제물포,3851,3622,7473
<class,경인선,동인천,6561,6363,12924
<class,경인선,인천,2718,2143,4861
<class,경인선,구일,2106,2120,4226
<class,경인선,소사,3555,3458,7013
<class,경인선,부개,3289,3113,6402
<class,경인선,간석,2267,2170,4437
<class,경인선,도원,1010,1054,2064
<class,경인선,온수,2333,2227,4560
<class,경인선,중동,3305,3080,6385
<class,경인선,도화,1641,1553,3194
<class,경춘선,신내,659,649,1308
<class,경춘선,갈매,1009,876,1885
<class,경춘선,별내,1255,1138,2393
<class,경춘선,퇴계원,1439,1457,2896
<class,경춘선,사릉,1146,1187,2333
<class,경춘선,금곡,652,653,1305
<class,경춘선,평내호평,2501,2443,4944
<class,경춘선,천마산,769,769,1538
<class,경춘선,마석,1924,1859,3783
<class,경춘선,대성리,479,354,833
<class,경춘선,청평,1196,989,2185
<class,경춘선,상천,372,330,702
<class,경춘선,가평,1881,1563,3444
<class,경춘선,굴봉산,269,230,499
<class,경춘선,백양리,220,202,422
<class,경춘선,강촌,634,527,1161
<class,경춘선,김유정,341,317,658
<class,경춘선,남춘천,2035,2050,4085
<class,경춘선,춘천,1514,1174,2688
<class,공항철도 1호선,서울역,4924,3703,8627
<class,공항철도 1호선,공덕,798,1059,1857
<class,공항철도 1호선,홍대입구,5193,5113,10306
<class,공항철도 1호선,디지털미디어시티,2396,2580,4976
<class,공항철도 1호선,마곡나루,1361,1491,2852
<class,공항철도 1호선,김포공항,10291,4705,14996
<class,공항철도 1호선,계양,3297,3298,6595
<class,공항철도 1호선,검암,2446,2541,4987
<class,공항철도 1호선,청라국제도시,2209,2105,4314
<class,공항철도 1호선,운서,3683,4021,7704
<class,공항철도 1호선,공항화물청사,941,980,1921
<class,공항철도 1호선,인천공항1터미널,3296,3297,6593
<class,공항철도 1호선,인천공항2터미널,2274,2145,4419
<class,공항철도 1호선,영종,1600,1696,3296
<class,과천선,선바위,2346,2227,4573
<class,과천선,경마공원,627,626,1253
<class,과천선,대공원,2047,2114,4161
<class,과천선,과천,2156,2051,4207
<class,과천선,정부과천청사,2936,3117,6053
<class,과천선,인덕원,7185,7362,14547
<class,과천선,평촌,4181,4038,8219
<class,과천선,범계,10087,9676,19763
<class,분당선,선릉,1888,2899,4787
<class,분당선,한티,7053,6622,13675
<class,분당선,도곡,1593,1655,3248
<class,분당선,구룡,476,482,958
<class,분당선,개포동,1166,1187,2353
<class,분당선,대모산입구,1207,1074,2281
<class,분당선,수서,6135,5260,11395
<class,분당선,수원,4329,3439,7768
<class,분당선,서울숲,3232,3273,6505
<class,분당선,압구정로데오,7036,7581,14617
<class,분당선,강남구청,2198,2599,4797
<class,분당선,선정릉,1398,1534,2932
<class,분당선,가천대,2369,2998,5367
<class,분당선,태평,6111,5590,11701
<class,분당선,모란,7915,8171,16086
<class,분당선,야탑,8937,9203,18140
<class,분당선,서현,9999,9975,19974
<class,분당선,수내,4596,4494,9090
<class,분당선,정자,5320,5563,10883
<class,분당선,미금,4872,5320,10192
<class,분당선,오리,3902,3485,7387
<class,분당선,이매,2226,2236,4462
<class,분당선,보정,732,669,1401
<class,분당선,죽전,5143,6146,11289
<class,분당선,구성,1553,1751,3304
<class,분당선,신갈,1271,1346,2617
<class,분당선,기흥,3566,3504,7070
<class,분당선,상갈,1949,2035,3984
<class,분당선,청명,1501,1428,2929
<class,분당선,영통,3218,3219,6437
<class,분당선,망포,4154,4626,8780
<class,분당선,매탄권선,1710,1721,3431
<class,분당선,수원시청,5075,5119,10194
<class,분당선,매교,941,990,1931
<class,수인선,고색,1282,1317,2599
<class,수인선,오목천,982,985,1967
<class,수인선,어천,362,486,848
<class,수인선,야목,115,97,212
<class,수인선,사리,1698,1506,3204
<class,수인선,달월,31,34,65
<class,수인선,월곶,1194,1177,2371
<class,수인선,소래포구,3338,3251,6589
<class,수인선,인천논현,2135,2199,4334
<class,수인선,호구포,1390,1487,2877
<class,수인선,남동인더스파크,562,577,1139
<class,수인선,원인재,1992,2056,4048
<class,수인선,연수,2039,1994,4033
<class,수인선,송도,1075,1043,2118
<class,수인선,인하대,2151,2017,4168
<class,수인선,숭의,1359,1311,2670
<class,수인선,신포,719,759,1478
<class,수인선,인천,919,1325,2244
<class,안산선,산본,5917,6324,12241
<class,안산선,대야미,2060,1921,3981
<class,안산선,반월,1672,1681,3353
<class,안산선,상록수,6353,6390,12743
<class,안산선,한대앞,3667,3681,7348
<class,안산선,중앙,7924,7645,15569
<class,안산선,고잔,2868,2772,5640
<class,안산선,초지,1569,1529,3098
<class,안산선,안산,7096,6434,13530
<class,안산선,신길온천,772,749,1521
<class,안산선,정왕,3603,3984,7587
<class,안산선,오이도,4681,4580,9261
<class,안산선,수리산,1487,1416,2903
<class,우이신설선,북한산우이,2646,2725,5371
<class,우이신설선,솔밭공원,1072,1055,2127
<class,우이신설선,4.19민주묘지,1455,1343,2798
<class,우이신설선,화계,1454,1385,2839
<class,우이신설선,삼양,897,868,1765
<class,우이신설선,삼양사거리,1110,1116,2226
<class,우이신설선,솔샘,1846,1791,3637
<class,우이신설선,북한산보국문,2421,2293,4714
<class,우이신설선,정릉,1730,1469,3199
<class,우이신설선,성신여대입구,1553,1792,3345
<class,우이신설선,보문,692,646,1338
<class,우이신설선,신설동,742,767,1509
<class,일산선,원흥,3723,3573,7296
<class,일산선,지축,1,0,1
<class,일산선,삼송,7396,7281,14677
<class,일산선,원당,4176,4220,8396
<class,일산선,화정,6656,6876,13532
<class,일산선,대곡,703,620,1323
<class,일산선,백석,3983,3982,7965
<class,일산선,마두,2509,2496,5005
<class,일산선,정발산,3534,3464,6998
<class,일산선,주엽,3289,3210,6499
<class,중앙선,운길산,842,758,1600
<class,중앙선,양수,1446,1293,2739
<class,중앙선,신원,209,123,332
<class,중앙선,국수,423,348,771
<class,중앙선,아신,476,352,828
<class,중앙선,오빈,199,166,365
<class,중앙선,양평,1797,1581,3378
<class,중앙선,원덕,279,201,480
<class,중앙선,용문,4040,3664,7704
<class,중앙선,지평,69,46,115
<class,2호선,양천구청,3070,3141,6211
<class,2호선,도림천,477,474,951
<class,2호선,신설동,2255,2292,4547
<class,2호선,신답,687,745,1432
<class,2호선,용답,1613,1510,3123
<class,2호선,충정로,3488,3556,7044
<class,2호선,아현,5579,5323,10902
<class,2호선,이대,7170,7463,14633
<class,2호선,신촌,20467,20269,40736
<class,2호선,홍대입구,36540,37316,73856
<class,2호선,합정,17503,18751,36254
<class,2호선,당산,8535,9431,17966
<class,2호선,영등포구청,8605,8706,17311
<class,2호선,문래,7756,7994,15750
<class,2호선,신도림,26312,25987,52299
<class,2호선,대림,13277,14365,27642
<class,2호선,구로디지털단지,24995,24528,49523
<class,2호선,신대방,15127,14625,29752
<class,2호선,신림,37748,35749,73497
<class,2호선,봉천,13265,12105,25370
<class,2호선,서울대입구,28016,26840,54856
<class,2호선,낙성대,15547,14355,29902
<class,2호선,사당,19268,21010,40278
<class,2호선,방배,6785,7087,13872
<class,2호선,서초,6614,5751,12365
<class,2호선,교대,11996,13313,25309
<class,경원선,석계,4819,5280,10099
<class,경원선,광운대,4080,4004,8084
<class,경원선,월계,3432,3226,6658
<class,경원선,녹천,2718,2172,4890
<class,경원선,방학,5657,5479,11136
<class,경원선,도봉산,6530,4442,10972
<class,경원선,도봉,3401,3289,6690
<class,경의선,서울역,856,916,1772
<class,경원선,소요산,3635,3317,6952
<class,경원선,동두천,1302,1584,2886
<class,경원선,보산,1010,1079,2089
<class,경원선,동두천중앙,1962,2067,4029
<class,경부선,독산,6260,6400,12660
<class,경부선,수원,26469,28685,55154
<class,경부선,화서,3370,3328,6698
<class,경부선,성균관대,6834,6795,13629
<class,경부선,의왕,4030,3997,8027
<class,경부선,군포,3162,2820,5982
<class,경부선,금정,13239,13047,26286
<class,경부선,명학,3595,3304,6899
<class,경부선,안양,12497,12796,25293
<class,경부선,관악,4090,3864,7954
<class,경부선,석수,4777,4445,9222
<class,경부선,금천구청,5691,5656,11347
<class,경부선,가산디지털단지,4431,5929,10360
<class,경부선,구로,9372,9357,18729
<class,경부선,신길,4456,3670,8126
<class,경부선,신도림,1859,1936,3795
<class,경부선,영등포,26525,28231,54756
<class,경부선,대방,5475,5455,10930
<class,경부선,노량진,5581,5040,10621
<class,경부선,용산,22193,25368,47561
<class,경부선,남영,4111,4147,8258
<class,장항선,신창,928,798,1726
<class,중앙선,회기,13250,12520,25770
<class,중앙선,중랑,3416,3267,6683
<class,중앙선,상봉,3907,3831,7738
<class,중앙선,망우,4576,4490,9066
<class,중앙선,양원,828,883,1711
<class,중앙선,구리,7450,7535,14985
<class,중앙선,도농,4536,4546,9082
<class,중앙선,양정,465,397,862
<class,중앙선,덕소,3428,3506,6934
<class,중앙선,도심,1188,1022,2210
<class,중앙선,팔당,1101,1038,2139
<class,중앙선,운길산,813,773,1586
<class,중앙선,양수,1711,1733,3444
<class,중앙선,신원,179,137,316
<class,중앙선,국수,438,459,897
<class,중앙선,아신,439,504,943
<class,중앙선,오빈,188,251,439
<class,중앙선,양평,2017,2142,4159
<class,중앙선,원덕,282,300,582
<class,중앙선,용문,2361,2715,5076
<class,경부선,서울역,3294,1161,4455
<class,경강선,여주,1614,1878,3492
<class,경강선,세종대왕릉,232,233,465
<class,경강선,부발,1325,1100,2425
<class,경강선,이천,1950,2077,4027
<class,경강선,신둔도예촌,774,800,1574
<class,경강선,곤지암,1492,1573,3065
<class,경강선,초월,1559,1423,2982
<class,경강선,경기광주,3600,3551,7151
<class,경강선,삼동,1100,1045,2145
<class,경강선,이매,618,464,1082
<class,경강선,판교,2338,2105,4443
<class,9호선2~3단계,중앙보훈병원,3393,3174,6567
<class,9호선2~3단계,둔촌오륜,492,496,988
<class,9호선2~3단계,올림픽공원,2637,2635,5272
<class,9호선2~3단계,한성백제,1278,1099,2377
<class,9호선2~3단계,송파나루,3002,3246,6248
<class,9호선2~3단계,석촌,4628,3873,8501
<class,9호선2~3단계,석촌고분,3152,3148,6300
<class,9호선2~3단계,삼전,3755,3515,7270
<class,9호선2~3단계,종합운동장,2251,2149,4400
<class,9호선2~3단계,봉은사,6873,7053,13926
<class,9호선2~3단계,삼성중앙,2240,2245,4485
<class,9호선2~3단계,선정릉,3234,3530,6764
<class,9호선2~3단계,언주,4007,3985,7992
<class,9호선,신논현,17617,17226,34843
<class,9호선,사평,1571,1527,3098
<class,9호선,고속터미널,8054,11373,19427
<class,9호선,신반포,1617,1588,3205
<class,9호선,구반포,1306,1337,2643
<class,9호선,동작,978,804,1782
<class,9호선,흑석,3689,3787,7476
<class,9호선,노들,2428,2074,4502
<class,9호선,노량진,15703,14969,30672
<class,9호선,샛강,1716,1720,3436
<class,9호선,여의도,7254,6755,14009
<class,9호선,국회의사당,2254,2296,4550
<class,9호선,당산,8960,8360,17320
<class,9호선,선유도,2753,2727,5480
<class,9호선,신목동,1626,1451,3077
<class,9호선,염창,8250,7711,15961
<class,9호선,등촌,5631,5492,11123
<class,9호선,증미,3288,3251,6539
<class,9호선,가양,10074,9747,19821
<class,9호선,양천향교,4413,4279,8692
<class,9호선,마곡나루,5001,4964,9965
<class,9호선,신방화,3637,3536,7173
<class,9호선,공항시장,1821,1917,3738
<class,9호선,김포공항,6220,10228,16448
<class,9호선,개화,1087,888,1975
<class,8호선,모란,2664,2296,4960
<class,8호선,수진,3204,2876,6080
<class,8호선,신흥,2839,3115,5954
<class,8호선,단대오거리,5702,5360,11062
<class,8호선,남한산성입구,6775,6076,12851
<class,8호선,산성,3156,3273,6429
<class,8호선,복정,4957,4293,9250
<class,8호선,장지,9013,8572,17585
<class,8호선,문정,5523,5542,11065
<class,8호선,가락시장,3886,3763,7649
<class,8호선,송파,4121,4066,8187
<class,8호선,석촌,4487,5186,9673
<class,8호선,잠실,8905,10141,19046
<class,8호선,몽촌토성,3104,3046,6150
<class,8호선,강동구청,4458,4407,8865
<class,8호선,천호,8891,10438,19329
<class,8호선,암사,9308,8687,17995
<class,7호선,부평구청,3742,3383,7125
<class,7호선,굴포천,4841,5070,9911
<class,7호선,삼산체육관,2532,2435,4967
<class,7호선,상동,7193,7417,14610
<class,7호선,부천시청,7379,7365,14744
<class,7호선,신중동,7289,7299,14588
<class,7호선,춘의,4100,3871,7971
<class,7호선,부천종합운동장,2435,2148,4583
<class,7호선,까치울,4059,4054,8113
<class,7호선,온수,4226,4123,8349
<class,7호선,천왕,5394,5073,10467
<class,7호선,광명사거리,12698,12907,25605
<class,7호선,철산,10907,10991,21898
<class,중앙선,지평,29,64,93
<class,7호선,가산디지털단지,11187,10215,21402
<class,7호선,남구로,6714,7060,13774
<class,7호선,대림,5695,6156,11851
<class,7호선,신풍,6107,5835,11942
<class,7호선,보라매,4603,4264,8867
<class,7호선,신대방삼거리,8736,8177,16913
<class,7호선,장승배기,5134,4943,10077
<class,7호선,상도,5367,5075,10442
<class,7호선,숭실대입구,5727,5703,11430
<class,7호선,남성,5832,5407,11239
<class,7호선,이수,8655,7980,16635
<class,7호선,내방,5858,5749,11607
<class,7호선,고속터미널,8538,7107,15645
<class,7호선,반포,3481,3237,6718
<class,7호선,논현,8278,8966,17244
<class,7호선,학동,6857,7083,13940
<class,7호선,강남구청,6832,7339,14171
<class,7호선,청담,7771,8061,15832
<class,7호선,뚝섬유원지,4957,4713,9670
<class,7호선,건대입구,7539,7323,14862
<class,7호선,어린이대공원,6053,5719,11772
<class,7호선,군자,8197,6407,14604
<class,7호선,중곡,5036,4769,9805
<class,7호선,용마산,3224,3309,6533
<class,7호선,사가정,9438,9117,18555
<class,7호선,면목,8462,8410,16872
<class,7호선,상봉,9620,9117,18737
<class,7호선,중화,5990,5749,11739
<class,7호선,먹골,5782,5545,11327
<class,7호선,태릉입구,4792,4385,9177
<class,7호선,공릉,6369,6425,12794
<class,7호선,하계,9014,8430,17444
<class,7호선,중계,6975,6185,13160
<class,7호선,노원,12051,12230,24281
<class,7호선,마들,6784,6519,13303
<class,7호선,수락산,7806,7887,15693
<class,7호선,도봉산,4848,6692,11540
<class,7호선,장암,1196,860,2056
<class,6호선,봉화산,3957,3923,7880
<class,6호선,화랑대,5096,4044,9140
<class,6호선,태릉입구,3073,3199,6272
<class,6호선,석계,6522,6322,12844
<class,6호선,돌곶이,4585,4340,8925
<class,6호선,상월곡,3154,2760,5914
<class,6호선,월곡,5340,5464,10804
<class,6호선,고려대,3864,3585,7449
<class,6호선,안암,4370,4071,8441
<class,6호선,보문,3720,3245,6965
<class,6호선,창신,1676,1395,3071
<class,6호선,동묘앞,5634,5379,11013
<class,6호선,신당,4995,4178,9173
<class,6호선,청구,1883,1888,3771
<class,6호선,약수,1912,1826,3738
<class,6호선,버티고개,981,1143,2124
<class,6호선,한강진,5123,5968,11091
<class,6호선,이태원,6593,7109,13702
<class,6호선,녹사평,2997,3133,6130
<class,6호선,삼각지,3176,2569,5745
<class,6호선,효창공원앞,3313,2828,6141
<class,6호선,공덕,6981,6445,13426
<class,6호선,대흥,3940,3826,7766
<class,6호선,광흥창,3836,3539,7375
<class,6호선,상수,5047,5812,10859
<class,6호선,합정,8286,7712,15998
<class,6호선,망원,9213,10136,19349
<class,6호선,마포구청,7060,6301,13361
<class,6호선,월드컵경기장,3379,3451,6830
<class,6호선,디지털미디어시티,5279,5153,10432
<class,6호선,증산,5560,5429,10989
<class,6호선,새절,6698,6322,13020
<class,6호선,구산,4034,3268,7302
<class,6호선,독바위,1547,1701,3248
<class,6호선,불광,2831,2658,5489
<class,6호선,역촌,2159,2406,4565
<class,6호선,응암,9590,9483,19073
<class,5호선,하남검단산,3577,3469,7046
<class,5호선,하남시청,3199,3137,6336
<class,5호선,하남풍산,1972,2064,4036
<class,5호선,미사,8060,8007,16067
<class,5호선,강일,1656,1641,3297
<class,5호선,마천,3380,3366,6746
<class,5호선,거여,4171,4032,8203
<class,5호선,개롱,3180,3349,6529
<class,5호선,오금,1580,1414,2994
<class,경원선,지행,3828,3810,7638
<class,경원선,덕정,3329,3073,6402
<class,경원선,덕계,1649,1518,3167
<class,경원선,양주,4636,4491,9127
<class,경원선,녹양,2556,2498,5054
<class,경원선,가능,3838,3761,7599
<class,경원선,의정부,12677,13148,25825
<class,경원선,회룡,6891,6963,13854
<class,수인선,송도,1409,1338,2747
<class,수인선,연수,2678,2737,5415
<class,수인선,원인재,2729,2813,5542
<class,수인선,남동인더스파크,757,636,1393
<class,수인선,호구포,1982,1869,3851
<class,수인선,인천논현,3211,3333,6544
<class,수인선,소래포구,3804,3920,7724
<class,수인선,월곶,1559,1536,3095
<class,수인선,달월,43,47,90
<class,수인선,사리,2332,2059,4391
<class,수인선,야목,160,169,329
<class,수인선,어천,580,482,1062
<class,수인선,오목천,1376,1303,2679
<class,수인선,고색,1768,1632,3400
<class,분당선,매교,1423,1471,2894
<class,분당선,수원시청,7118,7614,14732
<class,분당선,매탄권선,2425,2306,4731
<class,분당선,망포,6486,6017,12503
<class,분당선,영통,4778,4697,9475
<class,분당선,청명,1876,1790,3666
<class,분당선,상갈,2839,2736,5575
<class,분당선,기흥,5082,4887,9969
<class,분당선,신갈,1996,1979,3975
<class,분당선,구성,2190,2455,4645
<class,분당선,죽전,7246,8264,15510
<class,분당선,보정,1181,1063,2244
<class,분당선,이매,3005,2941,5946
<class,분당선,오리,5504,4663,10167
<class,분당선,미금,8180,8422,16602
<class,분당선,정자,7983,8104,16087
<class,분당선,수내,6538,6259,12797
<class,분당선,서현,13348,13427,26775
<class,분당선,야탑,12197,12850,25047
<class,분당선,모란,12133,11990,24123
<class,분당선,태평,8406,7873,16279
<class,분당선,가천대,3221,3598,6819
<class,분당선,선정릉,2501,2464,4965
<class,분당선,강남구청,3681,4311,7992
<class,분당선,압구정로데오,12411,13628,26039
<class,분당선,서울숲,4701,4653,9354
<class,분당선,수원,5431,4755,10186
<class,분당선,복정,2,0,2
<class,분당선,수서,6540,7593,14133
<class,분당선,대모산입구,1650,1501,3151
<class,분당선,개포동,1941,1908,3849
<class,분당선,구룡,916,799,1715
<class,분당선,도곡,3108,2841,5949
<class,분당선,한티,9475,9070,18545
<class,분당선,선릉,3718,5308,9026
<class,과천선,범계,13802,13650,27452
<class,과천선,평촌,6262,6085,12347
<class,과천선,인덕원,10284,10191,20475
<class,과천선,정부과천청사,4054,4176,8230
<class,과천선,과천,3064,2819,5883
<class,과천선,대공원,2318,2437,4755
<class,과천선,경마공원,762,741,1503
<class,과천선,선바위,3433,3163,6596
<class,공항철도 1호선,영종,2113,2124,4237
<class,공항철도 1호선,인천공항2터미널,2473,2274,4747
<class,공항철도 1호선,인천공항1터미널,3830,3917,7747
<class,공항철도 1호선,공항화물청사,1180,1231,2411
<class,공항철도 1호선,운서,4477,4662,9139
<class,공항철도 1호선,청라국제도시,2860,2784,5644
<class,공항철도 1호선,검암,3244,3310,6554
<class,공항철도 1호선,계양,4779,4425,9204
<class,공항철도 1호선,김포공항,9019,5161,14180
<class,공항철도 1호선,마곡나루,2005,2125,4130
<class,공항철도 1호선,디지털미디어시티,3373,3248,6621
<class,공항철도 1호선,홍대입구,7347,6874,14221
<class,공항철도 1호선,공덕,1019,1389,2408
<class,공항철도 1호선,서울역,4660,5106,9766
<class,경춘선,춘천,1387,1324,2711
<class,경춘선,남춘천,1984,2219,4203
<class,경춘선,김유정,328,387,715
<class,경춘선,강촌,645,686,1331
<class,경춘선,백양리,160,156,316
<class,경춘선,굴봉산,178,194,372
<class,경원선,망월사,4203,4204,8407
<class,2호선,강남,41805,40653,82458
<class,2호선,역삼,12785,13843,26628
<class,2호선,선릉,16978,14866,31844
<class,2호선,삼성,18310,18140,36450
<class,2호선,종합운동장,3199,3530,6729
<class,2호선,잠실새내,11860,12172,24032
<class,2호선,잠실,40874,39139,80013
<class,2호선,잠실나루,5174,5213,10387
<class,2호선,강변,17348,18797,36145
<class,2호선,구의,12046,11872,23918
<class,2호선,건대입구,21975,23515,45490
<class,2호선,성수,12226,13843,26069
<class,2호선,뚝섬,8632,8849,17481
<class,2호선,한양대,2443,2275,4718
<class,2호선,왕십리,8841,7545,16386
<class,2호선,상왕십리,7226,6964,14190
<class,2호선,신당,8055,8232,16287
<class,2호선,동대문역사문화공원,6622,7133,13755
<class,2호선,을지로4가,4755,4782,9537
<class,2호선,을지로3가,6490,6366,12856
<class,2호선,을지로입구,13596,13636,27232
<class,2호선,시청,5645,5137,10782
<class,1호선,청량리,13754,14000,27754
<class,1호선,제기동,10915,11221,22136
<class,1호선,신설동,6924,6511,13435
<class,1호선,동대문,8281,7525,15806
<class,1호선,종로5가,12038,11951,23989
<class,1호선,종로3가,14374,13432,27806
<class,1호선,종각,11641,11197,22838
<class,1호선,시청,6485,6295,12780
<class,1호선,동묘앞,8406,8450,16856
<class,1호선,서울역,19227,20630,39857
<class,경춘선,가평,1958,2236,4194
<class,경춘선,상천,263,259,522
<class,경춘선,청평,1268,1437,2705
<class,경춘선,대성리,477,455,932
<class,경춘선,마석,2395,2464,4859
<class,경춘선,천마산,993,1007,2000
<class,경춘선,평내호평,3293,3299,6592
<class,경춘선,신내,900,838,1738
<class,경인선,도화,2299,2135,4434
<class,경인선,중동,4758,4519,9277
<class,경인선,온수,3565,3245,6810
<class,경인선,도원,1506,1506,3012
<class,경인선,간석,3201,3058,6259
<class,경인선,부개,4642,4336,8978
<class,경인선,소사,4828,4950,9778
<class,경인선,구일,2998,2876,5874
<class,경인선,인천,3196,2729,5925
<class,경인선,동인천,8775,8778,17553
<class,경인선,제물포,5163,5119,10282
<class,경인선,주안,10990,9875,20865
<class,경인선,동암,9064,9333,18397
<class,경인선,백운,3958,4018,7976
<class,경인선,부평,21769,23652,45421
<class,경인선,송내,12490,12518,25008
<class,경인선,부천,21677,22039,43716
<class,경인선,역곡,14440,14386,28826
<class,경인선,오류동,6827,6320,13147
<class,경인선,개봉,12071,11928,23999
<class,경의선,임진강,54,44,98
<class,경의선,문산,3502,3518,7020
<class,경의선,파주,648,477,1125
<class,경의선,월롱,1051,994,2045
<class,경의선,금촌,4251,4185,8436
<class,경의선,금릉,2562,2470,5032
<class,경의선,운정,3366,3246,6612
<class,경의선,야당,3768,3738,7506
<class,경의선,탄현,3897,3826,7723
<class,경의선,일산,4251,4182,8433
<class,경의선,풍산,2956,2930,5886
<class,경의선,백마,3186,3032,6218
<class,경의선,곡산,294,299,593
<class,경의선,능곡,2099,1955,4054
<class,경의선,행신,3604,3796,7400
<class,경의선,강매,1341,1318,2659
<class,경의선,화전,781,734,1515
<class,경의선,수색,1040,1001,2041
<class,경의선,디지털미디어시티,1322,1232,2554
<class,경의선,가좌,2808,2718,5526
<class,경의선,홍대입구,1165,1274,2439
<class,경의선,서강대,1286,1191,2477
<class,경의선,공덕,1559,1293,2852
<class,경의선,효창공원앞,1299,1454,2753
<class,경의선,신촌,261,243,504
<class,경춘선,금곡,905,807,1712
<class,경춘선,사릉,1706,1676,3382
<class,경춘선,퇴계원,2084,1924,4008
<class,경춘선,별내,1722,1633,3355
<class,경춘선,갈매,1348,1168,2516
<class,수인선,인하대,2998,2751,5749
<class,수인선,숭의,1978,1829,3807
<class,수인선,신포,1023,1062,2085
<class,경부선,세류,1802,1895,3697
<class,경부선,병점,8439,8525,16964
<class,경부선,세마,1482,1352,2834
<class,경부선,오산대,1795,1697,3492
<class,경부선,오산,7206,6573,13779
<class,경부선,진위,731,663,1394
<class,경부선,송탄,3394,3104,6498
<class,경부선,서정리,4557,3880,8437
<class,경부선,평택지제,2049,2023,4072
<class,5호선,방이,3583,3512,7095
<class,5호선,올림픽공원,1909,1594,3503
<class,5호선,둔촌동,4610,4636,9246
<class,5호선,상일동,7046,6553,13599
<class,5호선,고덕,4441,4469,8910
<class,5호선,명일,4173,4317,8490
<class,5호선,굽은다리,5581,5111,10692
<class,5호선,길동,4634,4704,9338
<class,경부선,평택,9885,9687,19572
<class,경부선,성환,2238,2131,4369
<class,경부선,직산,493,478,971
<class,경부선,두정,3831,3829,7660
<class,경부선,천안,4873,5275,10148
<class,수인선,인천,1090,1630,2720
<class,안산선,산본,8701,9503,18204
<class,안산선,대야미,2712,2413,5125
<class,5호선,강동,8888,8484,17372
<class,5호선,천호,12185,11516,23701
<class,5호선,광나루,6882,6399,13281
<class,5호선,아차산,8696,8401,17097
<class,5호선,군자,5940,6524,12464
<class,5호선,장한평,7977,7983,15960
<class,5호선,답십리,7521,6816,14337
<class,5호선,마장,2845,2629,5474
<class,안산선,반월,2481,2317,4798
<class,안산선,상록수,8544,8723,17267
<class,안산선,한대앞,4853,4981,9834
<class,안산선,중앙,10372,10868,21240
<class,안산선,고잔,3867,3792,7659
<class,일산선,대화,6375,5809,12184
<class,장항선,봉명,544,486,1030
<class,장항선,쌍용,1051,885,1936
<class,장항선,아산,1882,1963,3845
<class,장항선,배방,675,651,1326
<class,장항선,온양온천,2776,2895,5671
<class,경부선,당정,2832,2622,5454
<class,경부선,서동탄,676,664,1340
<class,경부선,광명,1615,1730,3345
<class,경원선,이촌,2175,1649,3824
<class,경원선,서빙고,972,824,1796
<class,경원선,한남,2127,2033,4160
<class,경원선,옥수,39,26,65
<class,경원선,응봉,944,789,1733
<class,안산선,초지,2183,2174,4357
<class,안산선,안산,7684,7959,15643
<class,안산선,신길온천,1003,954,1957
<class,안산선,정왕,4801,4864,9665
<class,안산선,오이도,5862,6020,11882
<class,안산선,수리산,2101,1814,3915
<class,우이신설선,북한산우이,2393,2550,4943
<class,우이신설선,솔밭공원,1440,1441,2881
<class,5호선,왕십리,2599,2963,5562
<class,5호선,행당,4055,3474,7529
<class,5호선,신금호,2974,3091,6065
<class,5호선,청구,1950,1677,3627
<class,5호선,동대문역사문화공원,728,921,1649
<class,5호선,을지로4가,2158,2309,4467
<class,5호선,종로3가,7312,7611,14923
<class,5호선,광화문,9516,10007,19523
<class,5호선,서대문,5028,4867,9895
<class,5호선,충정로,1419,1321,2740
<class,5호선,애오개,2777,2677,5454
<class,5호선,공덕,4620,4604,9224
<class,5호선,마포,5032,5054,10086
<class,5호선,여의나루,4710,5406,10116
<class,5호선,여의도,7041,7373,14414
<class,5호선,신길,1782,1870,3652
<class,5호선,영등포시장,4832,4807,9639
<class,5호선,영등포구청,1417,1372,2789
<class,5호선,양평,2605,2451,5056
<class,5호선,오목교,11996,12496,24492
<class,5호선,목동,8316,8363,16679
<class,5호선,신정,6513,5727,12240
<class,5호선,까치산,15848,15452,31300
<class,5호선,화곡,14717,13726,28443
<class,5호선,우장산,7024,7054,14078
<class,5호선,발산,8734,9084,17818
<class,5호선,마곡,3785,3790,7575
<class,5호선,송정,3701,3683,7384
<class,5호선,김포공항,6163,6366,12529
<class,5호선,개화산,2891,2857,5748
<class,5호선,방화,3571,3573,7144
<class,4호선,쌍문,16102,14533,30635
<class,4호선,창동,14269,15257,29526
<class,4호선,노원,11652,12719,24371
<class,4호선,상계,10243,9739,19982
<class,4호선,당고개,7549,7108,14657
<class,4호선,남태령,588,505,1093
<class,4호선,사당,13318,11339,24657
<class,4호선,총신대입구,10529,11375,21904
<class,4호선,동작,1207,1255,2462
<class,4호선,이촌,4370,4870,9240
<class,4호선,신용산,6620,7501,14121
<class,4호선,삼각지,2091,2434,4525
<class,4호선,숙대입구,6168,5933,12101
<class,4호선,서울역,3642,7363,11005
<class,4호선,회현,12413,13193,25606
<class,4호선,명동,7714,8850,16564
<class,4호선,충무로,8250,8291,16541
<class,4호선,동대문역사문화공원,7593,6672,14265
<class,4호선,동대문,10242,10085,20327
<class,4호선,혜화,16485,17182,33667
<class,4호선,한성대입구,7352,6974,14326
<class,4호선,성신여대입구,12152,11384,23536
<class,4호선,길음,9635,9190,18825
<class,4호선,미아사거리,16308,15562,31870
<class,4호선,미아,8307,7829,16136
<class,4호선,수유,19768,19165,38933
<class,3호선,오금,2564,2472,5036
<class,3호선,경찰병원,2850,2818,5668
<class,3호선,가락시장,4409,4043,8452
<class,3호선,수서,8451,9316,17767
<class,3호선,일원,3566,3566,7132
<class,3호선,대청,4205,3753,7958
<class,3호선,학여울,824,784,1608
<class,3호선,대치,7191,6359,13550
<class,3호선,도곡,2194,2117,4311
<class,3호선,매봉,4311,4207,8518
<class,3호선,양재,12950,14039,26989
<class,3호선,남부터미널,13203,14274,27477
<class,3호선,교대,4459,2655,7114
<class,3호선,고속터미널,30643,33184,63827
<class,3호선,잠원,2609,2395,5004
<class,3호선,신사,16201,16821,33022
<class,3호선,압구정,18007,18655,36662
<class,3호선,옥수,5043,5178,10221
<class,3호선,금호,4413,4075,8488
<class,3호선,약수,6743,6288,13031
<class,3호선,동대입구,4004,4100,8104
<class,3호선,충무로,1,0,1
<class,3호선,을지로3가,3241,3448,6689
<class,3호선,종로3가,3502,4670,8172
<class,우이신설선,4.19민주묘지,1733,1530,3263
<class,3호선,안국,7442,8207,15649
<class,3호선,경복궁,8771,9101,17872
<class,3호선,독립문,3836,3690,7526
<class,3호선,무악재,1983,1991,3974
<class,3호선,홍제,9449,9003,18452
<class,3호선,녹번,7369,6479,13848
<class,3호선,불광,9492,10584,20076
<class,3호선,연신내,22444,20713,43157
<class,3호선,구파발,11147,11190,22337
<class,3호선,지축,2070,2045,4115
<class,우이신설선,가오리,2297,2200,4497
<class,우이신설선,화계,1929,1796,3725
<class,우이신설선,삼양,1197,1272,2469
<class,우이신설선,삼양사거리,1555,1512,3067
<class,우이신설선,솔샘,2718,2498,5216
<class,우이신설선,북한산보국문,3331,3088,6419
<class,우이신설선,정릉,2601,2212,4813
<class,우이신설선,성신여대입구,2192,2343,4535
<class,우이신설선,보문,936,898,1834
<class,우이신설선,신설동,1073,1019,2092
<class,일산선,원흥,5381,5182,10563
<class,일산선,지축,1,0,1
<class,일산선,삼송,10164,10151,20315
<class,일산선,원당,5947,5721,11668
<class,일산선,화정,9324,9666,18990
<class,일산선,대곡,1001,824,1825
<class,일산선,백석,5482,5605,11087
<class,일산선,마두,3877,3923,7800
<class,일산선,정발산,4646,4681,9327
<class,일산선,주엽,4863,4828,9691
<class,경원선,왕십리,8678,9916,18594
<class,경원선,청량리,11320,13138,24458
<class,경원선,외대앞,4261,4279,8540
<class,경원선,신이문,4666,4313,8979
<class,2호선,용두,1292,1364,2656
<class,2호선,신정네거리,5350,5383,10733
<class,중앙선,회기,10269,10305,20574
<class,일산선,마두,2306,2354,4660
<class,일산선,정발산,3334,3307,6641
<class,일산선,주엽,3047,3044,6091
<class,일산선,대화,4520,4151,8671
<class,장항선,봉명,369,369,738
<class,장항선,쌍용,801,787,1588
<class,장항선,아산,1950,1505,3455
<class,장항선,배방,554,614,1168
<class,장항선,온양온천,2468,2310,4778
<class,장항선,신창,762,716,1478
<class,중앙선,지평,63,42,105
<class,일산선,대곡,771,611,1382
<class,우이신설선,화계,1385,1395,2780
<class,우이신설선,가오리,1714,1674,3388
<class,우이신설선,4.19민주묘지,1354,1249,2603
<class,우이신설선,솔밭공원,1032,1093,2125
<class,우이신설선,북한산우이,2268,2318,4586
<class,안산선,수리산,1449,1292,2741
<class,안산선,오이도,4417,4225,8642
<class,안산선,정왕,3703,3807,7510
<class,안산선,신길온천,782,740,1522
<class,안산선,안산,6721,6363,13084
<class,안산선,초지,1478,1452,2930
<class,안산선,고잔,2828,2604,5432
<class,안산선,중앙,7336,7269,14605
<class,안산선,한대앞,3676,3589,7265
<class,안산선,상록수,6169,5903,12072
<class,안산선,반월,1681,1669,3350
<class,안산선,대야미,1960,1859,3819
<class,안산선,산본,5806,6205,12011
<class,수인선,인천,869,1311,2180
<class,수인선,신포,765,754,1519
<class,수인선,숭의,1360,1308,2668
<class,수인선,인하대,2107,2028,4135
<class,수인선,송도,1192,1152,2344
<class,수인선,연수,2047,2002,4049
<class,수인선,원인재,1918,2001,3919
<class,수인선,남동인더스파크,513,478,991
<class,수인선,호구포,1356,1436,2792
<class,수인선,인천논현,2065,2141,4206
<class,수인선,소래포구,3333,3255,6588
<class,수인선,월곶,1166,1079,2245
<class,수인선,달월,33,37,70
<class,수인선,사리,1624,1454,3078
<class,수인선,야목,107,110,217
<class,수인선,어천,448,440,888
<class,수인선,오목천,939,867,1806
<class,수인선,고색,1114,1111,2225
<class,분당선,매교,922,912,1834
<class,분당선,수원시청,4703,4867,9570
<class,분당선,매탄권선,1607,1627,3234
<class,분당선,망포,4234,4557,8791
<class,분당선,영통,3344,3394,6738
<class,분당선,청명,1277,1298,2575
<class,분당선,상갈,1990,2146,4136
<class,분당선,기흥,3566,3332,6898
<class,분당선,신갈,1312,1389,2701
<class,분당선,구성,1570,1654,3224
<class,분당선,죽전,5558,6289,11847
<class,분당선,보정,770,722,1492
<class,분당선,이매,2153,2293,4446
<class,분당선,오리,3981,3493,7474
<class,분당선,미금,4997,5313,10310
<class,분당선,정자,5283,5331,10614
<class,분당선,수내,4392,4397,8789
<class,분당선,서현,9796,9923,19719
<class,분당선,야탑,8957,9222,18179
<class,분당선,모란,7998,8299,16297
<class,분당선,태평,6036,5647,11683
<class,분당선,가천대,2324,2894,5218
<class,분당선,선정릉,1399,1490,2889
<class,분당선,강남구청,2219,2733,4952
<class,분당선,압구정로데오,7159,7584,14743
<class,분당선,서울숲,3064,3163,6227
<class,분당선,수원,4204,3386,7590
<class,분당선,수서,6028,5284,11312
<class,분당선,대모산입구,1097,1039,2136
<class,분당선,개포동,1080,1141,2221
<class,분당선,구룡,453,473,926
<class,분당선,도곡,1831,1886,3717
<class,분당선,한티,6773,6391,13164
<class,분당선,선릉,1929,2710,4639
<class,과천선,범계,9544,9409,18953
<class,과천선,평촌,3932,3921,7853
<class,과천선,인덕원,6988,6972,13960
<class,과천선,정부과천청사,2689,2856,5545
<class,과천선,과천,2062,2011,4073
<class,과천선,대공원,1843,1884,3727
<class,과천선,경마공원,588,595,1183
<class,과천선,선바위,2361,2238,4599
<class,공항철도 1호선,영종,1598,1585,3183
<class,공항철도 1호선,인천공항2터미널,2176,2058,4234
<class,공항철도 1호선,인천공항1터미널,3063,3136,6199
<class,공항철도 1호선,공항화물청사,844,934,1778
<class,공항철도 1호선,운서,3612,3863,7475
<class,공항철도 1호선,청라국제도시,2133,2067,4200
<class,공항철도 1호선,검암,2409,2528,4937
<class,공항철도 1호선,계양,3344,3302,6646
<class,공항철도 1호선,김포공항,10177,4875,15052
<class,공항철도 1호선,마곡나루,1209,1303,2512
<class,공항철도 1호선,디지털미디어시티,2513,2565,5078
<class,공항철도 1호선,홍대입구,5472,5283,10755
<class,공항철도 1호선,공덕,828,1087,1915
<class,공항철도 1호선,서울역,5088,4192,9280
<class,경춘선,춘천,1428,1122,2550
<class,경춘선,남춘천,1688,1816,3504
<class,경춘선,김유정,294,264,558
<class,경춘선,강촌,676,489,1165
<class,경춘선,백양리,121,90,211
<class,경춘선,굴봉산,196,170,366
<class,경춘선,가평,2088,1634,3722
<class,경춘선,상천,370,299,669
<class,경춘선,청평,1305,1065,2370
<class,경춘선,대성리,523,390,913
<class,경춘선,마석,1987,1889,3876
<class,경춘선,천마산,814,819,1633
<class,경춘선,평내호평,2430,2437,4867
<class,경춘선,금곡,659,629,1288
<class,경춘선,사릉,1212,1235,2447
<class,경춘선,퇴계원,1538,1505,3043
<class,경춘선,별내,1294,1274,2568
<class,경춘선,갈매,962,878,1840
<class,경춘선,신내,629,651,1280
<class,경인선,도화,1668,1516,3184
<class,경인선,중동,3412,3144,6556
<class,경인선,온수,2304,2158,4462
<class,경인선,도원,1010,1064,2074
<class,경인선,간석,2231,2143,4374
<class,경인선,부개,3254,3004,6258
<class,경인선,소사,3578,3435,7013
<class,경인선,구일,2017,2007,4024
<class,경인선,인천,2698,2118,4816
<class,경인선,동인천,6501,6241,12742
<class,경인선,제물포,3569,3453,7022
<class,경인선,주안,8138,7264,15402
<class,경인선,동암,6736,6712,13448
<class,경인선,백운,2680,2674,5354
<class,경인선,부평,16162,16546,32708
<class,경인선,송내,8823,8661,17484
<class,경인선,부천,15938,15563,31501
<class,경인선,역곡,9603,9606,19209
<class,경인선,오류동,4643,4334,8977
<class,경인선,개봉,8027,8227,16254
<class,경의선,임진강,43,37,80
<class,경의선,문산,2743,2673,5416
<class,경의선,파주,535,421,956
<class,경의선,월롱,649,1305,1954
<class,경의선,금촌,3079,3257,6336
<class,경의선,금릉,1811,1836,3647
<class,경의선,운정,2315,2312,4627
<class,경의선,야당,2885,2803,5688
<class,경의선,탄현,2862,2684,5546
<class,경의선,일산,3215,3000,6215
<class,경의선,풍산,2334,2242,4576
<class,경의선,백마,2230,2166,4396
<class,경의선,곡산,209,228,437
<class,경의선,능곡,1455,1403,2858
<class,경의선,행신,3090,2747,5837
<class,경의선,강매,940,913,1853
<class,경의선,화전,536,589,1125
<class,경의선,수색,582,632,1214
<class,경의선,디지털미디어시티,946,879,1825
<class,경의선,가좌,1920,2025,3945
<class,경의선,홍대입구,953,1139,2092
<class,경의선,서강대,860,884,1744
<class,경의선,공덕,1153,1004,2157
<class,경의선,효창공원앞,867,1000,1867
<class,경의선,신촌,165,175,340
<class,경의선,서울역,701,636,1337
<class,경원선,소요산,3392,2902,6294
<class,경원선,동두천,1061,1242,2303
<class,경원선,보산,908,837,1745
<class,경원선,동두천중앙,1572,1477,3049
<class,경원선,지행,2699,2777,5476
<class,경원선,덕정,2287,2235,4522
<class,경원선,덕계,1136,1110,2246
<class,경원선,양주,3411,3235,6646
<class,경원선,녹양,1796,1745,3541
<class,경원선,가능,2824,2642,5466
<class,경원선,의정부,9570,9552,19122
<class,경원선,회룡,4918,4779,9697
<class,경원선,망월사,3015,3091,6106
<class,경원선,도봉산,5676,3875,9551
<class,경원선,도봉,2463,2371,4834
<class,경원선,방학,3846,3778,7624
<class,경원선,녹천,1755,1526,3281
<class,경원선,월계,2629,2453,5082
<class,경원선,광운대,2984,3005,5989
<class,경원선,석계,3393,3905,7298
<class,경원선,신이문,3374,3198,6572
<class,경원선,외대앞,3105,3138,6243
<class,경원선,청량리,11070,9598,20668
<class,경원선,왕십리,6525,7535,14060
<class,경원선,응봉,681,623,1304
<class,경원선,옥수,49,18,67
<class,경원선,한남,1412,1412,2824
<class,경원선,서빙고,665,659,1324
<class,경원선,이촌,1281,1107,2388
<class,경부선,광명,1817,1252,3069
<class,경부선,서동탄,494,580,1074
<class,경부선,당정,2085,2025,4110
<class,경부선,천안,4801,4299,9100
<class,경부선,두정,3356,3392,6748
<class,경부선,직산,400,389,789
<class,경부선,성환,1870,1831,3701
<class,경부선,평택,8426,8632,17058
<class,경부선,평택지제,1630,1468,3098
<class,경부선,서정리,2910,4180,7090
<class,경부선,송탄,2601,2843,5444
<class,경부선,진위,529,486,1015
<class,경부선,오산,5611,5821,11432
<class,경부선,오산대,1377,1343,2720
<class,경부선,세마,1123,1061,2184
<class,경부선,병점,6261,6833,13094
<class,경부선,세류,1446,1432,2878
<class,경부선,독산,4121,4161,8282
<class,경부선,수원,23297,22449,45746
<class,경부선,화서,2437,2377,4814
<class,경부선,성균관대,4966,5292,10258
<class,경부선,의왕,2786,2802,5588
<class,경부선,군포,2054,2007,4061
<class,경부선,금정,9170,9678,18848
<class,경부선,명학,2274,2177,4451
<class,경부선,안양,9075,8912,17987
<class,경부선,관악,2952,2880,5832
<class,경부선,석수,3229,3178,6407
<class,경부선,금천구청,4052,4125,8177
<class,경부선,가산디지털단지,3164,4650,7814
<class,경부선,구로,6476,6637,13113
<class,경부선,신길,3234,2888,6122
<class,경부선,신도림,1219,1297,2516
<class,경부선,영등포,21952,21033,42985
<class,경부선,대방,3804,4153,7957
<class,경부선,노량진,3735,3776,7511
<class,경부선,용산,23032,19322,42354
<class,경부선,남영,2574,2923,5497
<class,경부선,서울역,4556,1013,5569
<class,경강선,여주,1594,1359,2953
<class,경강선,세종대왕릉,190,184,374
<class,경강선,부발,932,1422,2354
<class,경강선,이천,1484,1555,3039
<class,경강선,신둔도예촌,614,525,1139
<class,경강선,곤지암,1102,1169,2271
<class,경강선,초월,1167,1120,2287
<class,경강선,경기광주,2581,2576,5157
<class,경강선,삼동,748,728,1476
<class,경강선,이매,462,343,805
<class,경강선,판교,1771,1642,3413
<class,9호선2~3단계,중앙보훈병원,2376,2371,4747
<class,9호선2~3단계,둔촌오륜,290,339,629
<class,9호선2~3단계,올림픽공원,1828,1949,3777
<class,9호선2~3단계,한성백제,884,875,1759
<class,9호선2~3단계,송파나루,2139,2314,4453
<class,9호선2~3단계,석촌,3065,2655,5720
<class,9호선2~3단계,석촌고분,2131,2234,4365
<class,9호선2~3단계,삼전,2595,2587,5182
<class,9호선2~3단계,종합운동장,1389,1365,2754
<class,9호선2~3단계,봉은사,5278,5282,10560
<class,9호선2~3단계,삼성중앙,1372,1459,2831
<class,9호선2~3단계,선정릉,2190,2254,4444
<class,9호선2~3단계,언주,2220,2311,4531
<class,9호선,신논현,10268,10072,20340
<class,9호선,사평,1003,1051,2054
<class,9호선,고속터미널,6436,7929,14365
<class,9호선,신반포,906,918,1824
<class,9호선,구반포,663,786,1449
<class,9호선,동작,710,608,1318
<class,9호선,흑석,2550,2651,5201
<class,9호선,노들,1641,1422,3063
<class,9호선,노량진,10253,11229,21482
<class,9호선,샛강,1150,1195,2345
<class,9호선,여의도,5344,4698,10042
<class,9호선,국회의사당,2073,2064,4137
<class,9호선,당산,6019,5909,11928
<class,9호선,선유도,1796,1951,3747
<class,9호선,신목동,1243,1113,2356
<class,9호선,염창,5702,5784,11486
<class,9호선,등촌,3648,3927,7575
<class,9호선,증미,2274,2397,4671
<class,9호선,가양,6607,6618,13225
<class,9호선,양천향교,2938,3203,6141
<class,9호선,마곡나루,3492,3507,6999
<class,9호선,신방화,2516,2535,5051
<class,9호선,공항시장,1244,1481,2725
<class,9호선,김포공항,6155,9150,15305
<class,9호선,개화,788,728,1516
<class,8호선,모란,1822,1486,3308
<class,8호선,수진,2176,1978,4154
<class,8호선,신흥,1987,2200,4187
<class,8호선,단대오거리,3747,3750,7497
<class,8호선,남한산성입구,4803,4487,9290
<class,8호선,산성,2281,2295,4576
<class,8호선,복정,3273,3161,6434
<class,8호선,장지,6529,6928,13457
<class,8호선,문정,3545,3732,7277
<class,8호선,가락시장,2246,2994,5240
<class,8호선,송파,2382,2598,4980
<class,8호선,석촌,2905,3598,6503
<class,8호선,잠실,7213,7592,14805
<class,8호선,몽촌토성,2184,2187,4371
<class,8호선,강동구청,3101,3271,6372
<class,8호선,천호,6181,7067,13248
<class,8호선,암사,6387,6231,12618
<class,7호선,부평구청,2547,2284,4831
<class,7호선,굴포천,3529,3518,7047
<class,7호선,삼산체육관,1707,1694,3401
<class,7호선,상동,5070,4980,10050
<class,7호선,부천시청,4993,4664,9657
<class,7호선,신중동,4617,4527,9144
<class,7호선,춘의,2586,2383,4969
<class,7호선,부천종합운동장,1643,1426,3069
<class,7호선,까치울,2798,2889,5687
<class,7호선,온수,2662,2763,5425
<class,7호선,광명사거리,8765,8596,17361
<class,7호선,철산,7104,7151,14255
<class,7호선,가산디지털단지,7587,6916,14503
<class,7호선,남구로,5025,4972,9997
<class,7호선,대림,5152,5040,10192
<class,7호선,신풍,4109,4010,8119
<class,7호선,보라매,3224,3088,6312
<class,7호선,신대방삼거리,5663,5617,11280
<class,7호선,장승배기,3348,3364,6712
<class,7호선,상도,3443,3530,6973
<class,7호선,숭실대입구,3818,4137,7955
<class,7호선,남성,3724,3854,7578
<class,7호선,이수,5355,5321,10676
<class,7호선,내방,3490,3772,7262
<class,7호선,고속터미널,8568,5002,13570
<class,7호선,반포,2057,2038,4095
<class,7호선,논현,4318,4696,9014
<class,7호선,학동,3700,3885,7585
<class,7호선,강남구청,3679,4026,7705
<class,7호선,청담,4298,4579,8877
<class,7호선,뚝섬유원지,3332,3292,6624
<class,7호선,건대입구,5518,5505,11023
<class,7호선,어린이대공원,4389,4442,8831
<class,7호선,군자,5256,4438,9694
<class,7호선,중곡,3458,3457,6915
<class,7호선,용마산,2199,2301,4500
<class,7호선,사가정,6402,6350,12752
<class,7호선,면목,5861,5934,11795
<class,7호선,상봉,6585,6412,12997
<class,7호선,중화,4077,3942,8019
<class,7호선,먹골,3834,3786,7620
<class,7호선,태릉입구,3252,3076,6328
<class,7호선,공릉,4359,4448,8807
<class,7호선,하계,6114,5972,12086
<class,7호선,중계,4718,4423,9141
<class,7호선,노원,7703,7845,15548
<class,7호선,마들,4202,3969,8171
<class,7호선,수락산,5971,5916,11887
<class,7호선,도봉산,3613,5225,8838
<class,7호선,장암,999,768,1767
<class,6호선,봉화산,2835,2785,5620
<class,6호선,화랑대,3292,2831,6123
<class,6호선,태릉입구,2091,2282,4373
<class,6호선,석계,4612,4605,9217
<class,6호선,돌곶이,3717,3601,7318
<class,6호선,상월곡,2177,2048,4225
<class,6호선,월곡,3872,3872,7744
<class,6호선,고려대,2737,2752,5489
<class,6호선,안암,3219,3399,6618
<class,6호선,보문,2540,2535,5075
<class,6호선,창신,1185,1038,2223
<class,6호선,동묘앞,4036,4063,8099
<class,6호선,신당,3302,4032,7334
<class,6호선,청구,1187,1199,2386
<class,6호선,약수,1188,1231,2419
<class,6호선,버티고개,691,785,1476
<class,6호선,한강진,4643,4966,9609
<class,6호선,이태원,5410,5269,10679
<class,6호선,녹사평,2135,2128,4263
<class,6호선,삼각지,2224,1873,4097
<class,6호선,효창공원앞,2128,1855,3983
<class,6호선,공덕,4464,4354,8818
<class,6호선,대흥,2738,2874,5612
<class,6호선,광흥창,2633,2580,5213
<class,6호선,상수,3963,4574,8537
<class,6호선,합정,6098,5491,11589
<class,6호선,망원,6528,7300,13828
<class,6호선,마포구청,5025,4827,9852
<class,6호선,월드컵경기장,2527,2386,4913
<class,6호선,디지털미디어시티,3403,3633,7036
<class,6호선,증산,3720,3886,7606
<class,6호선,새절,4529,4453,8982
<class,6호선,구산,2687,2210,4897
<class,6호선,연신내,2,0,2
<class,6호선,독바위,1095,1262,2357
<class,6호선,불광,2046,1854,3900
<class,6호선,역촌,1440,1618,3058
<class,6호선,응암,6500,6785,13285
<class,5호선,하남검단산,2782,2757,5539
<class,5호선,하남시청,2257,2232,4489
<class,5호선,하남풍산,1461,1458,2919
<class,5호선,미사,5538,5677,11215
<class,5호선,강일,1154,1141,2295
<class,5호선,마천,2271,2441,4712
<class,5호선,거여,2622,2629,5251
<class,5호선,개롱,2062,2307,4369
<class,5호선,오금,1088,985,2073
<class,5호선,방이,2384,2286,4670
<class,5호선,올림픽공원,1372,1111,2483
<class,5호선,둔촌동,2918,3075,5993
<class,5호선,상일동,4686,4554,9240
<class,5호선,고덕,3072,3125,6197
<class,5호선,명일,2900,2966,5866
<class,5호선,굽은다리,3822,3672,7494
<class,5호선,길동,3054,3218,6272
<class,5호선,강동,5953,6142,12095
<class,5호선,천호,8653,8247,16900
<class,5호선,광나루,4822,4505,9327
<class,5호선,아차산,6224,6162,12386
<class,5호선,군자,4064,4609,8673
<class,5호선,장한평,5033,5210,10243
<class,5호선,답십리,4978,4824,9802
<class,5호선,마장,1967,1879,3846
<class,5호선,왕십리,1722,1944,3666
<class,5호선,행당,2683,2426,5109
<class,5호선,신금호,1991,2162,4153
<class,5호선,청구,1209,1182,2391
<class,5호선,동대문역사문화공원,568,670,1238
<class,5호선,을지로4가,981,1064,2045
<class,5호선,종로3가,5435,4954,10389
<class,5호선,광화문,7584,7761,15345
<class,5호선,서대문,3124,3059,6183
<class,5호선,충정로,988,1051,2039
<class,5호선,애오개,1748,1884,3632
<class,5호선,공덕,2970,2987,5957
<class,5호선,마포,3215,3308,6523
<class,5호선,여의나루,3386,4066,7452
<class,5호선,여의도,4873,5008,9881
<class,5호선,신길,1281,1521,2802
<class,5호선,영등포시장,2848,3133,5981
<class,5호선,영등포구청,893,917,1810
<class,5호선,양평,1790,1907,3697
<class,5호선,오목교,8598,8843,17441
<class,5호선,목동,5283,5450,10733
<class,5호선,신정,4480,4062,8542
<class,5호선,까치산,10898,10756,21654
<class,5호선,화곡,9790,9301,19091
<class,5호선,우장산,4431,4649,9080
<class,5호선,발산,6023,6203,12226
<class,5호선,마곡,2376,2537,4913
<class,5호선,송정,2617,2628,5245
<class,5호선,김포공항,6140,5442,11582
<class,5호선,개화산,2098,2052,4150
<class,5호선,방화,2566,2540,5106
<class,4호선,쌍문,10842,10027,20869
<class,4호선,창동,9943,10614,20557
<class,4호선,노원,8316,8683,16999
<class,4호선,상계,7162,6763,13925
<class,4호선,당고개,5622,5441,11063
<class,4호선,남태령,444,385,829
<class,4호선,사당,9424,8501,17925
<class,4호선,총신대입구,6856,7522,14378
<class,4호선,동작,844,898,1742
<class,4호선,이촌,2989,3216,6205
<class,4호선,신용산,5095,5202,10297
<class,4호선,삼각지,1434,1846,3280
<class,4호선,숙대입구,3993,3885,7878
<class,4호선,서울역,2594,5476,8070
<class,4호선,회현,5648,5804,11452
<class,4호선,명동,6196,6214,12410
<class,4호선,충무로,4825,5115,9940
<class,4호선,동대문역사문화공원,5663,5720,11383
<class,4호선,동대문,3903,4672,8575
<class,4호선,혜화,13273,13748,27021
<class,4호선,한성대입구,5234,5348,10582
<class,4호선,성신여대입구,8594,8394,16988
<class,4호선,길음,6658,6617,13275
<class,4호선,미아사거리,11165,10798,21963
<class,4호선,미아,5531,5290,10821
<class,4호선,수유,14176,13517,27693
<class,3호선,오금,1687,1723,3410
<class,3호선,경찰병원,1908,1958,3866
<class,3호선,가락시장,2494,2803,5297
<class,3호선,수서,7124,6594,13718
<class,3호선,일원,2162,2293,4455
<class,3호선,대청,2835,2761,5596
<class,3호선,학여울,553,565,1118
<class,3호선,대치,4467,3861,8328
<class,3호선,도곡,1444,1395,2839
<class,3호선,매봉,2658,2790,5448
<class,3호선,양재,7991,9542,17533
<class,3호선,남부터미널,10152,9991,20143
<class,3호선,교대,2825,1764,4589
<class,3호선,고속터미널,27221,23843,51064
<class,3호선,잠원,1407,1454,2861
<class,3호선,신사,8348,8424,16772
<class,3호선,압구정,8655,9056,17711
<class,3호선,옥수,3348,3679,7027
<class,3호선,금호,2836,2763,5599
<class,3호선,약수,4385,4207,8592
<class,3호선,동대입구,2992,3188,6180
<class,3호선,을지로3가,1788,1735,3523
<class,3호선,종로3가,2438,3034,5472
<class,3호선,안국,5440,5654,11094
<class,3호선,경복궁,5964,6162,12126
<class,3호선,독립문,2383,2502,4885
<class,3호선,무악재,1338,1380,2718
<class,3호선,홍제,6141,5909,12050
<class,3호선,녹번,4777,4450,9227
<class,3호선,불광,6409,7178,13587
<class,3호선,연신내,14890,14302,29192
<class,3호선,구파발,7881,8189,16070
<class,3호선,지축,1265,1275,2540
<class,2호선,용두,843,873,1716
<class,2호선,신정네거리,3578,3592,7170
<class,2호선,양천구청,2073,2174,4247
<class,2호선,도림천,328,341,669
<class,2호선,신설동,1710,1912,3622
<class,2호선,신답,491,576,1067
<class,2호선,용답,1234,1167,2401
<class,2호선,충정로,2389,2484,4873
<class,2호선,아현,3495,3501,6996
<class,2호선,이대,4401,4861,9262
<class,2호선,신촌,13752,13744,27496
<class,2호선,홍대입구,27687,27235,54922
<class,2호선,합정,12834,13496,26330
<class,2호선,당산,5429,5942,11371
<class,2호선,영등포구청,5280,5549,10829
<class,2호선,문래,4893,5277,10170
<class,2호선,신도림,17539,17656,35195
<class,2호선,대림,10160,10436,20596
<class,2호선,구로디지털단지,16018,16141,32159
<class,2호선,신대방,10635,10774,21409
<class,2호선,신림,25620,25776,51396
<class,2호선,봉천,8460,8424,16884
<class,2호선,서울대입구,18704,19316,38020
<class,2호선,낙성대,10345,10954,21299
<class,2호선,사당,12913,13979,26892
<class,2호선,방배,4314,4779,9093
<class,2호선,서초,4561,4020,8581
<class,2호선,교대,7026,7989,15015
<class,2호선,강남,22794,21657,44451
<class,2호선,역삼,7298,8290,15588
<class,2호선,선릉,8611,7569,16180
<class,2호선,삼성,13530,13007,26537
<class,2호선,종합운동장,2150,2328,4478
<class,2호선,잠실새내,7571,7839,15410
<class,2호선,잠실,29791,28084,57875
<class,2호선,잠실나루,3646,3752,7398
<class,2호선,강변,14937,13651,28588
<class,2호선,구의,7814,8028,15842
<class,2호선,건대입구,16655,17267,33922
<class,2호선,성수,8158,8951,17109
<class,2호선,뚝섬,5661,5917,11578
<class,2호선,한양대,1365,1527,2892
<class,2호선,왕십리,6339,5523,11862
<class,2호선,상왕십리,4753,4749,9502
<class,2호선,신당,5409,5943,11352
<class,2호선,동대문역사문화공원,4860,5881,10741
<class,2호선,을지로4가,2146,2083,4229
<class,2호선,을지로3가,4271,4004,8275
<class,2호선,을지로입구,10285,9709,19994
<class,2호선,시청,3745,3221,6966
<class,1호선,청량리,9818,9799,19617
<class,1호선,제기동,6581,7113,13694
<class,1호선,신설동,4833,4972,9805
<class,1호선,동대문,6247,6718,12965
<class,1호선,종로5가,5528,5629,11157
<class,1호선,종로3가,8999,8604,17603
<class,1호선,종각,7972,7438,15410
<class,1호선,시청,4436,4308,8744
<class,1호선,동묘앞,7760,7771,15531
<class,1호선,서울역,17896,15468,33364
<class,일산선,백석,3937,3888,7825
<class,일산선,화정,6483,6782,13265
<class,일산선,원당,4204,4128,8332
<class,일산선,삼송,7121,7029,14150
<class,일산선,원흥,3656,3505,7161
<class,우이신설선,신설동,797,726,1523
<class,우이신설선,보문,650,698,1348
<class,우이신설선,성신여대입구,1521,1660,3181
<class,우이신설선,정릉,1806,1561,3367
<class,우이신설선,북한산보국문,2453,2252,4705
<class,우이신설선,솔샘,1864,1713,3577
<class,우이신설선,삼양사거리,1092,1081,2173
<class,우이신설선,삼양,966,951,1917
<class,7호선,천왕,3253,3282,6535
<class,중앙선,용문,2424,2068,4492
<class,중앙선,원덕,269,213,482
<class,중앙선,양평,1753,1525,3278
<class,중앙선,오빈,183,161,344
<class,중앙선,아신,443,394,837
<class,중앙선,국수,397,363,760
<class,중앙선,신원,145,117,262
<class,중앙선,양수,1486,1406,2892
<class,중앙선,운길산,792,742,1534
<class,중앙선,팔당,978,928,1906
<class,중앙선,도심,865,812,1677
<class,중앙선,덕소,2408,2425,4833
<class,중앙선,양정,422,333,755
<class,중앙선,도농,3270,3270,6540
<class,중앙선,구리,5279,5572,10851
<class,중앙선,양원,660,662,1322
<class,중앙선,망우,3460,3506,6966
<class,중앙선,상봉,3006,2997,6003
<class,중앙선,중랑,2531,2493,5024
<class,경부선,화서,3645,3711,7356
<class,5호선,목동,8762,8859,17621
<class,일산선,마두,4180,3761,7941
<class,일산선,정발산,5073,5189,10262
<class,일산선,주엽,5272,5221,10493
<class,일산선,대화,7248,6312,13560
<class,장항선,봉명,546,524,1070
<class,장항선,쌍용,1064,977,2041
<class,장항선,아산,2057,1832,3889
<class,장항선,배방,698,721,1419
<class,장항선,온양온천,2728,2840,5568
<class,장항선,신창,820,800,1620
<class,중앙선,회기,14411,13574,27985
<class,중앙선,중랑,3701,3536,7237
<class,중앙선,상봉,4091,4044,8135
<class,중앙선,망우,5366,5078,10444
<class,중앙선,양원,902,913,1815
<class,중앙선,구리,7926,8031,15957
<class,중앙선,도농,5009,4893,9902
<class,중앙선,양정,470,410,880
<class,중앙선,덕소,3593,3615,7208
<class,중앙선,도심,1282,1129,2411
<class,중앙선,팔당,1213,1202,2415
<class,중앙선,운길산,1011,930,1941
<class,중앙선,양수,1878,1951,3829
<class,중앙선,신원,191,176,367
<class,중앙선,국수,490,516,1006
<class,중앙선,아신,585,531,1116
<class,중앙선,오빈,215,244,459
<class,중앙선,양평,2157,2178,4335
<class,중앙선,원덕,298,327,625
<class,중앙선,용문,2327,2684,5011
<class,중앙선,지평,39,64,103
<class,일산선,삼송,10562,10513,21075
<class,일산선,원당,6515,6140,12655
<class,일산선,화정,9921,10396,20317
<class,일산선,대곡,1040,904,1944
<class,일산선,백석,5784,5979,11763
<class,7호선,면목,9405,9107,18512
<class,1호선,서울역,19372,20054,39426
<class,1호선,동묘앞,8839,8860,17699
<class,1호선,시청,6752,6536,13288
<class,1호선,종각,12454,11943,24397
<class,1호선,종로3가,16339,15198,31537
<class,1호선,종로5가,13620,13507,27127
<class,1호선,동대문,8329,7627,15956
<class,1호선,신설동,7148,6862,14010
<class,1호선,제기동,11822,12088,23910
<class,1호선,청량리,14173,14309,28482
<class,2호선,시청,5719,5203,10922
<class,2호선,을지로입구,14436,14409,28845
<class,2호선,을지로3가,7126,7149,14275
<class,2호선,을지로4가,5557,5538,11095
<class,2호선,동대문역사문화공원,7353,7944,15297
<class,2호선,신당,8323,8674,16997
<class,2호선,상왕십리,7615,7191,14806
<class,2호선,왕십리,9435,7869,17304
<class,2호선,한양대,2596,2500,5096
<class,2호선,뚝섬,9736,10125,19861
<class,2호선,성수,13117,14898,28015
<class,2호선,건대입구,23513,25339,48852
<class,2호선,구의,12610,12567,25177
<class,2호선,강변,18060,18948,37008
<class,2호선,잠실나루,5599,5520,11119
<class,2호선,잠실,42549,41255,83804
<class,2호선,잠실새내,12354,12882,25236
<class,2호선,종합운동장,3400,3708,7108
<class,2호선,삼성,21104,20986,42090
<class,2호선,선릉,17593,15500,33093
<class,2호선,역삼,13234,14464,27698
<class,2호선,강남,44891,43388,88279
<class,2호선,교대,12830,14213,27043
<class,2호선,서초,7009,6047,13056
<class,2호선,방배,7071,7399,14470
<class,2호선,사당,20493,22147,42640
<class,2호선,낙성대,16761,15622,32383
<class,2호선,서울대입구,29685,28546,58231
<class,2호선,봉천,13698,12688,26386
<class,2호선,신림,39029,37540,76569
<class,2호선,신대방,15659,15154,30813
<class,2호선,구로디지털단지,26272,25628,51900
<class,2호선,대림,14365,15260,29625
<class,2호선,신도림,27944,27578,55522
<class,2호선,문래,8616,9015,17631
<class,2호선,영등포구청,9000,9123,18123
<class,2호선,당산,9167,9909,19076
<class,2호선,합정,19433,20625,40058
<class,2호선,홍대입구,40407,41434,81841
<class,2호선,신촌,21690,21810,43500
<class,2호선,이대,7150,7331,14481
<class,2호선,아현,5835,5529,11364
<class,2호선,충정로,3685,3803,7488
<class,2호선,용답,1662,1608,3270
<class,2호선,신답,763,811,1574
<class,2호선,신설동,2446,2458,4904
<class,2호선,도림천,676,664,1340
<class,2호선,양천구청,3307,3427,6734
<class,2호선,신정네거리,5870,5990,11860
<class,2호선,용두,1385,1304,2689
<class,3호선,지축,2246,2248,4494
<class,3호선,구파발,12261,12243,24504
<class,3호선,연신내,24229,22819,47048
<class,3호선,불광,9992,11160,21152
<class,3호선,녹번,7998,6887,14885
<class,3호선,홍제,10086,9407,19493
<class,3호선,무악재,2070,2108,4178
<class,3호선,독립문,4004,4055,8059
<class,3호선,경복궁,9927,10516,20443
<class,3호선,안국,8435,9462,17897
<class,3호선,종로3가,4318,5755,10073
<class,3호선,을지로3가,3667,3852,7519
<class,3호선,충무로,1,0,1
<class,3호선,동대입구,4252,4447,8699
<class,3호선,약수,7105,6732,13837
<class,3호선,금호,4754,4416,9170
<class,3호선,옥수,5409,5625,11034
<class,3호선,압구정,18941,19472,38413
<class,3호선,신사,17814,18473,36287
<class,3호선,잠원,3107,3005,6112
<class,3호선,고속터미널,31873,32775,64648
<class,3호선,교대,4926,2949,7875
<class,3호선,남부터미널,13951,14664,28615
<class,3호선,양재,14468,15509,29977
<class,3호선,매봉,4570,4367,8937
<class,3호선,도곡,2303,2339,4642
<class,3호선,대치,7738,6762,14500
<class,3호선,학여울,773,728,1501
<class,3호선,대청,4840,4490,9330
<class,3호선,일원,3743,3807,7550
<class,3호선,수서,8913,9527,18440
<class,3호선,가락시장,4286,4260,8546
<class,3호선,경찰병원,3158,3223,6381
<class,3호선,오금,2828,2759,5587
<class,4호선,수유,20702,20277,40979
<class,4호선,미아,8661,8266,16927
<class,4호선,미아사거리,17152,16587,33739
<class,4호선,길음,10365,9762,20127
<class,4호선,성신여대입구,12938,12141,25079
<class,4호선,한성대입구,7896,7441,15337
<class,4호선,혜화,18376,18833,37209
<class,4호선,동대문,10720,10854,21574
<class,4호선,동대문역사문화공원,7930,7061,14991
<class,4호선,충무로,8927,9065,17992
<class,4호선,명동,8208,9215,17423
<class,4호선,회현,12496,13305,25801
<class,4호선,서울역,3785,7284,11069
<class,4호선,숙대입구,7008,6765,13773
<class,4호선,삼각지,2238,2643,4881
<class,4호선,신용산,7279,8099,15378
<class,4호선,이촌,4749,5217,9966
<class,4호선,동작,1404,1383,2787
<class,4호선,총신대입구,11245,12077,23322
<class,4호선,사당,13908,12223,26131
<class,4호선,남태령,630,566,1196
<class,4호선,당고개,7797,7575,15372
<class,4호선,상계,10997,10414,21411
<class,4호선,노원,12644,13792,26436
<class,4호선,창동,15388,16257,31645
<class,4호선,쌍문,17117,15631,32748
<class,5호선,방화,3749,3702,7451
<class,5호선,개화산,3030,3020,6050
<class,5호선,김포공항,6029,5985,12014
<class,5호선,송정,3998,3900,7898
<class,5호선,마곡,4278,4227,8505
<class,5호선,발산,9514,10087,19601
<class,5호선,우장산,7741,7706,15447
<class,5호선,화곡,15465,14690,30155
<class,5호선,까치산,16764,16187,32951
<class,5호선,신정,6848,6047,12895
<class,5호선,오목교,13207,13446,26653
<class,5호선,양평,2804,2757,5561
<class,5호선,영등포구청,1474,1454,2928
<class,5호선,영등포시장,5023,5095,10118
<class,5호선,신길,1877,2095,3972
<class,5호선,여의도,7300,7802,15102
<class,5호선,여의나루,6350,6887,13237
<class,5호선,마포,5348,5297,10645
<class,5호선,공덕,5043,5161,10204
<class,5호선,애오개,2908,2793,5701
<class,5호선,충정로,1540,1393,2933
<class,5호선,서대문,5068,4781,9849
<class,5호선,광화문,10532,10790,21322
<class,5호선,종로3가,8122,8481,16603
<class,5호선,을지로4가,2495,2842,5337
<class,5호선,동대문역사문화공원,789,987,1776
<class,5호선,청구,2024,1809,3833
<class,5호선,신금호,3317,3404,6721
<class,5호선,행당,4229,3695,7924
<class,5호선,왕십리,2764,3213,5977
<class,5호선,마장,2985,2767,5752
<class,5호선,답십리,8072,7233,15305
<class,5호선,장한평,8684,8724,17408
<class,5호선,군자,6436,6966,13402
<class,5호선,아차산,9161,8831,17992
<class,5호선,광나루,7069,6611,13680
<class,5호선,천호,13037,12301,25338
<class,5호선,강동,9442,8998,18440
<class,5호선,길동,4972,5140,10112
<class,5호선,굽은다리,5813,5455,11268
<class,5호선,명일,4470,4546,9016
<class,5호선,고덕,4933,4973,9906
<class,5호선,상일동,7391,7035,14426
<class,5호선,둔촌동,4888,4933,9821
<class,5호선,올림픽공원,2194,1879,4073
<class,5호선,방이,4207,4216,8423
<class,5호선,오금,2480,2266,4746
<class,5호선,개롱,3269,3529,6798
<class,5호선,거여,4296,4067,8363
<class,5호선,마천,3419,3583,7002
<class,5호선,강일,1753,1699,3452
<class,5호선,미사,8739,8717,17456
<class,5호선,하남풍산,2076,2116,4192
<class,5호선,하남시청,3490,3507,6997
<class,5호선,하남검단산,3787,3745,7532
<class,6호선,응암,10268,10133,20401
<class,6호선,역촌,2378,2570,4948
<class,6호선,불광,3082,2833,5915
<class,6호선,독바위,1635,1853,3488
<class,6호선,연신내,1,0,1
<class,6호선,구산,4354,3447,7801
<class,6호선,새절,6902,6608,13510
<class,6호선,증산,5900,5835,11735
<class,6호선,디지털미디어시티,5350,5523,10873
<class,6호선,월드컵경기장,3558,3627,7185
<class,6호선,마포구청,7447,6541,13988
<class,6호선,망원,9871,10853,20724
<class,6호선,합정,9000,8325,17325
<class,6호선,상수,5607,6712,12319
<class,6호선,광흥창,4133,3751,7884
<class,6호선,대흥,4249,4263,8512
<class,6호선,공덕,7423,6910,14333
<class,6호선,효창공원앞,3497,3000,6497
<class,6호선,삼각지,3250,2708,5958
<class,6호선,녹사평,3352,3421,6773
<class,6호선,이태원,6993,7425,14418
<class,6호선,한강진,4734,5667,10401
<class,6호선,버티고개,1073,1186,2259
<class,6호선,약수,1978,1808,3786
<class,6호선,청구,1704,1774,3478
<class,6호선,신당,4837,4232,9069
<class,6호선,동묘앞,5903,5620,11523
<class,6호선,창신,1727,1392,3119
<class,6호선,보문,3867,3446,7313
<class,6호선,안암,4534,4343,8877
<class,6호선,고려대,4102,3717,7819
<class,6호선,월곡,5878,5831,11709
<class,6호선,상월곡,3315,2963,6278
<class,6호선,돌곶이,4751,4406,9157
<class,6호선,석계,6892,6889,13781
<class,6호선,태릉입구,3154,3371,6525
<class,6호선,화랑대,5116,4197,9313
<class,6호선,봉화산,4118,4036,8154
<class,7호선,장암,1337,1066,2403
<class,7호선,도봉산,5220,7230,12450
<class,7호선,수락산,8490,8391,16881
<class,7호선,마들,7129,6839,13968
<class,7호선,노원,12674,13155,25829
<class,7호선,중계,7348,6546,13894
<class,7호선,하계,9354,8694,18048
<class,7호선,공릉,6652,6655,13307
<class,7호선,태릉입구,5066,4749,9815
<class,7호선,먹골,6205,5997,12202
<class,7호선,중화,6457,6071,12528
<class,7호선,상봉,10243,9907,20150
<class,7호선,사가정,9921,9695,19616
<class,7호선,용마산,3536,3572,7108
<class,7호선,중곡,5400,5146,10546
<class,7호선,군자,8354,6688,15042
<class,7호선,어린이대공원,6797,6421,13218
<class,7호선,건대입구,7964,7790,15754
<class,7호선,뚝섬유원지,5915,5531,11446
<class,7호선,청담,8339,8650,16989
<class,7호선,강남구청,6843,7530,14373
<class,7호선,학동,7627,7832,15459
<class,7호선,논현,8762,9556,18318
<class,7호선,반포,3672,3441,7113
<class,7호선,고속터미널,9029,7239,16268
<class,7호선,내방,6288,6079,12367
<class,7호선,이수,9082,8698,17780
<class,7호선,남성,6095,5616,11711
<class,7호선,숭실대입구,5987,6115,12102
<class,7호선,상도,5569,5260,10829
<class,7호선,장승배기,5438,5121,10559
<class,7호선,신대방삼거리,9410,8663,18073
<class,7호선,보라매,5332,4980,10312
<class,7호선,신풍,6453,6207,12660
<class,7호선,대림,5810,5959,11769
<class,7호선,남구로,7003,7247,14250
<class,7호선,가산디지털단지,11122,10234,21356
<class,7호선,철산,11664,11799,23463
<class,7호선,광명사거리,13536,13700,27236
<class,7호선,천왕,5319,5056,10375
<class,7호선,온수,4507,4446,8953
<class,7호선,까치울,4317,4454,8771
<class,7호선,부천종합운동장,2577,2371,4948
<class,7호선,춘의,4218,4028,8246
<class,7호선,신중동,7501,7359,14860
<class,7호선,부천시청,7934,7727,15661
<class,7호선,상동,7978,8016,15994
<class,7호선,삼산체육관,2688,2470,5158
<class,7호선,굴포천,5127,5389,10516
<class,7호선,부평구청,3961,3550,7511
<class,8호선,암사,10033,9186,19219
<class,8호선,천호,9443,10972,20415
<class,8호선,강동구청,4955,4972,9927
<class,8호선,몽촌토성,3326,3114,6440
<class,8호선,잠실,9244,10339,19583
<class,8호선,석촌,4648,5557,10205
<class,8호선,송파,4315,4374,8689
<class,8호선,가락시장,3691,3982,7673
<class,8호선,문정,5820,5851,11671
<class,8호선,장지,9309,8854,18163
<class,8호선,복정,5514,4744,10258
<class,8호선,산성,3433,3481,6914
<class,8호선,남한산성입구,7144,6481,13625
<class,8호선,단대오거리,5912,5607,11519
<class,8호선,신흥,2989,3202,6191
<class,8호선,수진,3592,3139,6731
<class,8호선,모란,2854,2548,5402
<class,9호선,개화,1095,1010,2105
<class,9호선,김포공항,6242,10015,16257
<class,9호선,공항시장,1839,1983,3822
<class,9호선,신방화,3853,3749,7602
<class,9호선,마곡나루,5722,5568,11290
<class,9호선,양천향교,4547,4530,9077
<class,9호선,가양,10557,10184,20741
<class,9호선,증미,3486,3467,6953
<class,9호선,등촌,6026,5817,11843
<class,9호선,염창,8964,8233,17197
<class,9호선,신목동,1704,1497,3201
<class,9호선,선유도,2953,2875,5828
<class,9호선,당산,9488,9046,18534
<class,9호선,국회의사당,2446,2411,4857
<class,9호선,여의도,7883,7450,15333
<class,9호선,샛강,1839,1945,3784
<class,9호선,노량진,16218,15851,32069
<class,9호선,노들,2474,2224,4698
<class,9호선,흑석,4072,4108,8180
<class,9호선,동작,1060,857,1917
<class,9호선,구반포,1242,1350,2592
<class,9호선,신반포,1816,1689,3505
<class,9호선,고속터미널,8480,11790,20270
<class,9호선,사평,1670,1639,3309
<class,9호선,신논현,18794,18640,37434
<class,9호선2~3단계,언주,4157,4198,8355
<class,9호선2~3단계,선정릉,3517,3696,7213
<class,9호선2~3단계,삼성중앙,2466,2382,4848
<class,9호선2~3단계,봉은사,8160,8410,16570
<class,9호선2~3단계,종합운동장,2302,2101,4403
<class,9호선2~3단계,삼전,3980,3790,7770
<class,9호선2~3단계,석촌고분,3293,3202,6495
<class,9호선2~3단계,석촌,4858,4139,8997
<class,9호선2~3단계,송파나루,3228,3538,6766
<class,9호선2~3단계,한성백제,1374,1257,2631
<class,9호선2~3단계,올림픽공원,3367,3383,6750
<class,9호선2~3단계,둔촌오륜,502,507,1009
<class,9호선2~3단계,중앙보훈병원,3581,3407,6988
<class,경강선,판교,2282,2198,4480
<class,경강선,이매,642,499,1141
<class,경강선,삼동,1171,1080,2251
<class,경강선,경기광주,3840,3793,7633
<class,경강선,초월,1586,1599,3185
<class,경강선,곤지암,1421,1513,2934
<class,경강선,신둔도예촌,846,809,1655
<class,경강선,이천,1926,2046,3972
<class,경강선,부발,1329,1216,2545
<class,경강선,세종대왕릉,230,280,510
<class,경강선,여주,1658,1859,3517
<class,경부선,서울역,3398,1152,4550
<class,경부선,남영,4203,4314,8517
<class,경부선,용산,23233,25445,48678
<class,경부선,노량진,5865,5025,10890
<class,경부선,대방,5973,5929,11902
<class,경부선,영등포,27389,28264,55653
<class,경부선,신도림,2015,2036,4051
<class,경부선,신길,4854,3916,8770
<class,경부선,구로,9919,10163,20082
<class,경부선,가산디지털단지,4585,6201,10786
<class,경부선,금천구청,6271,6347,12618
<class,경부선,석수,5119,4755,9874
<class,경부선,관악,4342,4269,8611
<class,경부선,안양,13371,13508,26879
<class,경부선,명학,3678,3579,7257
<class,경부선,금정,13792,13769,27561
<class,경부선,군포,3338,3079,6417
<class,경부선,의왕,4516,4332,8848
<class,경부선,성균관대,7257,7440,14697
<class,경부선,수원,26720,28467,55187
<class,경부선,독산,6785,6888,13673
<class,경부선,세류,1777,1835,3612
<class,경부선,병점,8734,8794,17528
<class,경부선,세마,1548,1467,3015
<class,경부선,오산대,2007,1824,3831
<class,경부선,오산,7026,6770,13796
<class,경부선,진위,775,700,1475
<class,경부선,송탄,3471,3137,6608
<class,경부선,서정리,4827,4202,9029
<class,경부선,평택지제,2186,2044,4230
<class,경부선,평택,9760,9575,19335
<class,경부선,성환,2165,2091,4256
<class,경부선,직산,488,475,963
<class,경부선,두정,3987,4060,8047
<class,경부선,천안,4737,5207,9944
<class,경부선,당정,2909,2883,5792
<class,경부선,서동탄,753,777,1530
<class,경부선,광명,1738,1673,3411
<class,경원선,이촌,2268,1704,3972
<class,경원선,서빙고,1061,923,1984
<class,경원선,한남,2181,2065,4246
<class,경원선,옥수,27,39,66
<class,경원선,응봉,1056,882,1938
<class,경원선,왕십리,9121,10951,20072
<class,경원선,청량리,11930,13615,25545
<class,경원선,외대앞,4531,4332,8863
<class,경원선,신이문,4910,4536,9446
<class,경원선,석계,5074,5355,10429
<class,경원선,광운대,4399,4360,8759
<class,경원선,월계,3653,3461,7114
<class,경원선,녹천,2710,2260,4970
<class,경원선,방학,6180,6009,12189
<class,경원선,도봉,3624,3390,7014
<class,경원선,도봉산,7304,5007,12311
<class,경원선,망월사,4659,4680,9339
<class,경원선,회룡,7565,7577,15142
<class,경원선,의정부,13451,14064,27515
<class,경원선,가능,4142,4040,8182
<class,경원선,녹양,2728,2694,5422
<class,경원선,양주,4943,4755,9698
<class,경원선,덕계,1812,1697,3509
<class,경원선,덕정,3391,3272,6663
<class,경원선,지행,4307,4229,8536
<class,경원선,동두천중앙,2029,2076,4105
<class,경원선,보산,1066,1103,2169
<class,경원선,동두천,1388,1823,3211
<class,경원선,소요산,3898,3574,7472
<class,경의선,서울역,868,975,1843
<class,경의선,신촌,280,276,556
<class,경의선,효창공원앞,1256,1464,2720
<class,경의선,공덕,1724,1466,3190
<class,경의선,서강대,1383,1215,2598
<class,경의선,홍대입구,1383,1507,2890
<class,경의선,가좌,3011,2813,5824
<class,경의선,디지털미디어시티,1326,1207,2533
<class,경의선,수색,999,935,1934
<class,경의선,화전,800,770,1570
<class,경의선,강매,1501,1418,2919
<class,경의선,행신,3900,3981,7881
<class,경의선,능곡,2245,2121,4366
<class,경의선,곡산,327,332,659
<class,경의선,백마,3331,3215,6546
<class,경의선,풍산,3312,3264,6576
<class,경의선,일산,4581,4465,9046
<class,경의선,탄현,4042,4003,8045
<class,경의선,야당,4009,4002,8011
<class,경의선,운정,3507,3415,6922
<class,경의선,금릉,2816,2748,5564
<class,경의선,금촌,4217,4141,8358
<class,경의선,월롱,1090,1032,2122
<class,경의선,파주,689,560,1249
<class,경의선,문산,3696,3691,7387
<class,경의선,임진강,72,66,138
<class,경인선,개봉,12659,12452,25111
<class,경인선,오류동,7151,6636,13787
<class,경인선,역곡,15347,15394,30741
<class,경인선,부천,22687,23531,46218
<class,경인선,송내,13477,13483,26960
<class,경인선,부평,22315,24080,46395
<class,경인선,백운,4085,4156,8241
<class,경인선,동암,9767,9953,19720
<class,경인선,주안,11671,10645,22316
<class,경인선,제물포,5468,5367,10835
<class,경인선,동인천,9265,9262,18527
<class,경인선,인천,3439,2991,6430
<class,경인선,구일,3117,2998,6115
<class,경인선,소사,5211,5084,10295
<class,경인선,부개,4947,4715,9662
<class,경인선,간석,3392,3225,6617
<class,경인선,도원,1682,1687,3369
<class,경인선,온수,3783,3385,7168
<class,경인선,중동,5137,5007,10144
<class,경인선,도화,2391,2236,4627
<class,경춘선,신내,938,846,1784
<class,경춘선,갈매,1419,1297,2716
<class,경춘선,별내,2033,1940,3973
<class,경춘선,퇴계원,2148,1989,4137
<class,경춘선,사릉,1766,1829,3595
<class,경춘선,금곡,998,885,1883
<class,경춘선,평내호평,3609,3657,7266
<class,경춘선,천마산,1122,1093,2215
<class,경춘선,마석,2481,2655,5136
<class,경춘선,대성리,563,548,1111
<class,경춘선,청평,1375,1553,2928
<class,경춘선,상천,359,324,683
<class,경춘선,가평,2032,2482,4514
<class,경춘선,굴봉산,209,196,405
<class,경춘선,백양리,141,161,302
<class,경춘선,강촌,638,703,1341
<class,경춘선,김유정,346,401,747
<class,경춘선,남춘천,2589,2847,5436
<class,경춘선,춘천,1542,1392,2934
<class,공항철도 1호선,서울역,4771,4764,9535
<class,공항철도 1호선,공덕,1120,1527,2647
<class,공항철도 1호선,홍대입구,8021,7811,15832
<class,공항철도 1호선,디지털미디어시티,3788,3509,7297
<class,공항철도 1호선,마곡나루,2001,2150,4151
<class,공항철도 1호선,김포공항,9148,5171,14319
<class,공항철도 1호선,계양,4826,4752,9578
<class,공항철도 1호선,검암,3432,3447,6879
<class,공항철도 1호선,청라국제도시,3114,3062,6176
<class,공항철도 1호선,운서,4654,5023,9677
<class,공항철도 1호선,공항화물청사,1231,1289,2520
<class,공항철도 1호선,인천공항1터미널,3533,3528,7061
<class,공항철도 1호선,인천공항2터미널,2240,2138,4378
<class,공항철도 1호선,영종,2289,2328,4617
<class,과천선,선바위,3556,3354,6910
<class,과천선,경마공원,861,835,1696
<class,과천선,대공원,2829,2978,5807
<class,과천선,과천,3202,2923,6125
<class,과천선,정부과천청사,4460,4481,8941
<class,과천선,인덕원,10698,10640,21338
<class,과천선,평촌,6600,6444,13044
<class,과천선,범계,14913,13897,28810
<class,분당선,선릉,3883,5502,9385
<class,분당선,한티,10248,9742,19990
<class,분당선,도곡,3244,2954,6198
<class,분당선,구룡,1125,1021,2146
<class,분당선,개포동,2026,2002,4028
<class,분당선,대모산입구,2058,1881,3939
<class,분당선,수서,7318,7988,15306
<class,분당선,수원,5578,4639,10217
<class,분당선,서울숲,5462,5348,10810
<class,분당선,압구정로데오,13534,14948,28482
<class,분당선,강남구청,3782,4499,8281
<class,분당선,선정릉,2530,2535,5065
<class,분당선,가천대,3445,3809,7254
<class,분당선,태평,8787,8189,16976
<class,분당선,모란,12940,13175,26115
<class,분당선,야탑,12688,13427,26115
<class,분당선,서현,14479,14830,29309
<class,분당선,수내,6937,6634,13571
<class,분당선,정자,8496,8569,17065
<class,분당선,미금,8868,9051,17919
<class,분당선,오리,6127,5081,11208
<class,분당선,이매,3029,2973,6002
<class,분당선,보정,1244,1132,2376
<class,분당선,죽전,7851,8827,16678
<class,분당선,구성,2351,2492,4843
<class,분당선,신갈,2106,2123,4229
<class,분당선,기흥,5302,5339,10641
<class,분당선,상갈,3032,3004,6036
<class,분당선,청명,2059,1930,3989
<class,분당선,영통,5037,4880,9917
<class,분당선,망포,6666,6145,12811
<class,분당선,매탄권선,2479,2421,4900
<class,분당선,수원시청,7633,8222,15855
<class,분당선,매교,1423,1501,2924
<class,수인선,고색,1784,1731,3515
<class,수인선,오목천,1452,1311,2763
<class,수인선,어천,527,522,1049
<class,수인선,야목,165,151,316
<class,수인선,사리,2346,2205,4551
<class,수인선,달월,39,40,79
<class,수인선,월곶,1659,1548,3207
<class,수인선,소래포구,4170,4254,8424
<class,수인선,인천논현,3381,3571,6952
<class,수인선,호구포,2140,2005,4145
<class,수인선,남동인더스파크,847,809,1656
<class,수인선,원인재,2801,2909,5710
<class,수인선,연수,2849,2934,5783
<class,수인선,송도,1528,1522,3050
<class,수인선,인하대,3357,3082,6439
<class,수인선,숭의,2141,1972,4113
<class,수인선,신포,1151,1178,2329
<class,수인선,인천,1158,1710,2868
<class,안산선,산본,9360,10146,19506
<class,안산선,대야미,2945,2691,5636
<class,안산선,반월,2511,2453,4964
<class,안산선,상록수,9356,9494,18850
<class,안산선,한대앞,5352,5327,10679
<class,안산선,중앙,11571,11888,23459
<class,안산선,고잔,4173,4052,8225
<class,안산선,초지,2261,2428,4689
<class,안산선,안산,7510,7558,15068
<class,안산선,신길온천,1055,1027,2082
<class,안산선,정왕,4827,5066,9893
<class,안산선,오이도,6244,6436,12680
<class,안산선,수리산,2296,1966,4262
<class,우이신설선,북한산우이,2604,2785,5389
<class,우이신설선,솔밭공원,1501,1479,2980
<class,우이신설선,4.19민주묘지,1895,1658,3553
<class,우이신설선,가오리,2400,2302,4702
<class,우이신설선,화계,1998,1896,3894
<class,우이신설선,삼양,1202,1322,2524
<class,우이신설선,삼양사거리,1598,1562,3160
<class,우이신설선,솔샘,2926,2570,5496
<class,우이신설선,북한산보국문,3476,3085,6561
<class,우이신설선,정릉,2659,2208,4867
<class,우이신설선,성신여대입구,2175,2508,4683
<class,우이신설선,보문,882,906,1788
<class,우이신설선,신설동,1096,1025,2121
<class,일산선,원흥,5695,5588,11283
<class,중앙선,국수,442,364,806
<class,분당선,정자,5488,5766,11254
<class,분당선,수내,4624,4534,9158
<class,분당선,서현,10446,10657,21103
<class,중앙선,덕소,2806,2832,5638
<class,중앙선,도심,969,904,1873
<class,경원선,양주,3841,3789,7630
<class,우이신설선,보문,683,646,1329
<class,우이신설선,신설동,844,864,1708
<class,일산선,원흥,3748,3669,7417
<class,일산선,삼송,7739,7571,15310
<class,일산선,원당,4487,4429,8916
<class,일산선,화정,6988,7134,14122
<class,일산선,대곡,764,696,1460
<class,일산선,백석,4218,4140,8358
<class,일산선,마두,2531,2554,5085
<class,일산선,정발산,3548,3601,7149
<class,일산선,주엽,3362,3389,6751
<class,일산선,대화,4695,4532,9227
<class,장항선,봉명,406,403,809
<class,장항선,쌍용,842,856,1698
<class,장항선,아산,2081,1378,3459
<class,장항선,배방,562,637,1199
<class,장항선,온양온천,2381,2452,4833
<class,장항선,신창,740,779,1519
<class,중앙선,회기,10918,10939,21857
<class,중앙선,중랑,2628,2609,5237
<class,중앙선,상봉,3264,3209,6473
<class,중앙선,망우,3632,3689,7321
<class,중앙선,양원,619,633,1252
<class,중앙선,구리,5784,6116,11900
<class,중앙선,도농,3515,3534,7049
<class,중앙선,양정,437,366,803
<class,중앙선,팔당,1116,1114,2230
<class,중앙선,운길산,884,786,1670
<class,중앙선,양수,1669,1486,3155
<class,중앙선,신원,194,112,306
<class,분당선,야탑,9117,9420,18537
<class,분당선,모란,8441,8698,17139
<class,분당선,태평,6248,5785,12033
<class,분당선,가천대,2447,3079,5526
<class,분당선,선정릉,1452,1532,2984
<class,분당선,강남구청,2340,2784,5124
<class,분당선,압구정로데오,7964,8621,16585
<class,분당선,서울숲,3640,3642,7282
<class,분당선,수원,4254,3432,7686
<class,분당선,수서,6266,5587,11853
<class,중앙선,아신,521,425,946
<class,중앙선,오빈,214,168,382
<class,중앙선,양평,2446,2171,4617
<class,중앙선,원덕,289,207,496
<class,중앙선,용문,2488,2117,4605
<class,중앙선,지평,54,49,103
<class,분당선,죽전,5438,6375,11813
<class,분당선,보정,789,730,1519
<class,분당선,이매,2164,2158,4322
<class,분당선,오리,4057,3517,7574
<class,분당선,미금,5243,5493,10736
<class,우이신설선,성신여대입구,1571,1799,3370
<class,우이신설선,정릉,1871,1592,3463
<class,우이신설선,북한산보국문,2629,2395,5024
<class,우이신설선,솔샘,1995,1964,3959
<class,우이신설선,삼양사거리,1248,1228,2476
<class,우이신설선,삼양,856,883,1739
<class,우이신설선,화계,1485,1428,2913
<class,우이신설선,가오리,1856,1742,3598
<class,우이신설선,4.19민주묘지,1571,1420,2991
<class,우이신설선,솔밭공원,1134,1105,2239
<class,우이신설선,북한산우이,3253,3458,6711
<class,안산선,수리산,1555,1495,3050
<class,안산선,오이도,4853,4830,9683
<class,안산선,정왕,3702,3944,7646
<class,안산선,신길온천,781,823,1604
<class,안산선,안산,6622,6164,12786
<class,안산선,초지,1585,1527,3112
<class,안산선,고잔,3014,2919,5933
<class,안산선,중앙,7880,7683,15563
<class,안산선,한대앞,3853,3831,7684
<class,안산선,상록수,6653,6568,13221
<class,안산선,반월,1785,1785,3570
<class,안산선,대야미,2174,1986,4160
<class,안산선,산본,6363,6961,13324
<class,수인선,인천,968,1398,2366
<class,수인선,신포,865,813,1678
<class,수인선,숭의,1406,1292,2698
<class,수인선,인하대,2282,2160,4442
<class,수인선,송도,1073,1058,2131
<class,분당선,대모산입구,1372,1298,2670
<class,분당선,개포동,1261,1257,2518
<class,분당선,구룡,802,838,1640
<class,분당선,도곡,1850,1782,3632
<class,분당선,한티,7079,6692,13771
<class,분당선,선릉,2026,2987,5013
<class,과천선,범계,10463,10064,20527
<class,과천선,평촌,4398,4354,8752
<class,과천선,인덕원,7630,7720,15350
<class,과천선,정부과천청사,2961,3202,6163
<class,과천선,과천,2336,2154,4490
<class,과천선,대공원,2478,2485,4963
<class,과천선,경마공원,704,669,1373
<class,과천선,선바위,2503,2383,4886
<class,1호선,서울역,18041,15212,33253
<class,1호선,동묘앞,9241,9027,18268
<class,1호선,시청,4921,4584,9505
<class,1호선,종각,8768,8122,16890
<class,1호선,종로3가,9967,9205,19172
<class,1호선,종로5가,5996,6002,11998
<class,1호선,동대문,6455,6300,12755
<class,1호선,신설동,5339,5405,10744
<class,1호선,제기동,7235,7819,15054
<class,1호선,청량리,10069,10208,20277
<class,2호선,시청,3884,3341,7225
<class,2호선,을지로입구,10478,10111,20589
<class,2호선,을지로3가,4442,4310,8752
<class,2호선,을지로4가,2338,2328,4666
<class,2호선,동대문역사문화공원,5250,5700,10950
<class,2호선,신당,5892,6327,12219
<class,2호선,상왕십리,4983,4948,9931
<class,2호선,왕십리,6347,5474,11821
<class,2호선,한양대,1419,1590,3009
<class,2호선,뚝섬,6661,7092,13753
<class,2호선,성수,8947,10023,18970
<class,2호선,건대입구,17772,18972,36744
<class,2호선,구의,8465,8661,17126
<class,2호선,강변,15064,14021,29085
<class,2호선,잠실나루,3723,3807,7530
<class,2호선,잠실,31090,29039,60129
<class,2호선,잠실새내,7605,8100,15705
<class,2호선,종합운동장,2235,2465,4700
<class,2호선,삼성,15048,14970,30018
<class,2호선,선릉,9172,7947,17119
<class,2호선,역삼,7191,8041,15232
<class,2호선,강남,24489,23435,47924
<class,2호선,교대,7434,8458,15892
<class,2호선,서초,4496,3874,8370
<class,2호선,방배,4453,4876,9329
<class,2호선,사당,13870,15200,29070
<class,2호선,낙성대,10943,11616,22559
<class,2호선,서울대입구,20203,20929,41132
<class,2호선,봉천,8875,8839,17714
<class,2호선,신림,27117,27173,54290
<class,2호선,신대방,11180,11253,22433
<class,2호선,구로디지털단지,16575,16606,33181
<class,2호선,대림,10709,10815,21524
<class,2호선,신도림,18299,18420,36719
<class,2호선,문래,5046,5334,10380
<class,2호선,영등포구청,5217,5311,10528
<class,2호선,당산,5905,6480,12385
<class,2호선,합정,13774,14673,28447
<class,2호선,홍대입구,30789,30715,61504
<class,2호선,신촌,14895,14711,29606
<class,2호선,이대,4653,5140,9793
<class,2호선,아현,3727,3848,7575
<class,2호선,충정로,2543,2674,5217
<class,2호선,용답,1188,1201,2389
<class,2호선,신답,571,565,1136
<class,2호선,신설동,2057,2136,4193
<class,2호선,도림천,348,361,709
<class,2호선,양천구청,2216,2312,4528
<class,2호선,신정네거리,3835,3887,7722
<class,2호선,용두,820,821,1641
<class,3호선,지축,1428,1352,2780
<class,3호선,구파발,8945,9018,17963
<class,3호선,연신내,16360,15670,32030
<class,3호선,불광,6869,8023,14892
<class,3호선,녹번,5063,4739,9802
<class,3호선,홍제,6388,6277,12665
<class,3호선,무악재,1381,1502,2883
<class,3호선,독립문,2845,2925,5770
<class,3호선,경복궁,7058,7389,14447
<class,3호선,안국,6354,6891,13245
<class,3호선,종로3가,2673,3498,6171
<class,3호선,을지로3가,1825,1910,3735
<class,3호선,동대입구,3289,3544,6833
<class,3호선,약수,4581,4465,9046
<class,3호선,금호,3145,2995,6140
<class,3호선,옥수,3753,4016,7769
<class,3호선,압구정,9614,9960,19574
<class,3호선,신사,9096,9365,18461
<class,3호선,잠원,1458,1456,2914
<class,3호선,고속터미널,27806,24426,52232
<class,3호선,교대,3009,1919,4928
<class,3호선,남부터미널,10534,10349,20883
<class,3호선,양재,8611,10096,18707
<class,3호선,매봉,2946,3019,5965
<class,3호선,도곡,1351,1452,2803
<class,3호선,대치,4685,4086,8771
<class,3호선,학여울,568,559,1127
<class,3호선,대청,2885,2854,5739
<class,3호선,일원,2459,2515,4974
<class,3호선,수서,7447,6872,14319
<class,3호선,가락시장,2518,2790,5308
<class,3호선,경찰병원,2025,2036,4061
<class,3호선,오금,1907,1857,3764
<class,4호선,수유,14678,14281,28959
<class,4호선,미아,6066,5762,11828
<class,4호선,미아사거리,11634,11058,22692
<class,4호선,길음,7072,7064,14136
<class,4호선,성신여대입구,8998,8817,17815
<class,4호선,한성대입구,5790,5648,11438
<class,4호선,혜화,14252,15072,29324
<class,4호선,동대문,4174,4136,8310
<class,4호선,동대문역사문화공원,6020,5321,11341
<class,4호선,충무로,5260,5430,10690
<class,4호선,명동,6041,6179,12220
<class,4호선,회현,5748,5850,11598
<class,4호선,서울역,2771,5368,8139
<class,4호선,숙대입구,4241,4124,8365
<class,4호선,삼각지,1507,1943,3450
<class,4호선,신용산,5333,5484,10817
<class,4호선,이촌,3305,3721,7026
<class,4호선,동작,946,937,1883
<class,4호선,총신대입구,7483,8196,15679
<class,4호선,사당,9985,9450,19435
<class,4호선,남태령,437,400,837
<class,4호선,당고개,6220,6055,12275
<class,4호선,상계,7568,7110,14678
<class,4호선,노원,8602,9182,17784
<class,4호선,창동,10566,11108,21674
<class,4호선,쌍문,11532,10624,22156
<class,5호선,방화,2688,2662,5350
<class,5호선,개화산,2054,2120,4174
<class,5호선,김포공항,5660,4984,10644
<class,5호선,송정,2769,2817,5586
<class,5호선,마곡,2651,2694,5345
<class,5호선,발산,6274,6687,12961
<class,5호선,우장산,4801,4938,9739
<class,5호선,화곡,10229,9710,19939
<class,5호선,까치산,11427,11408,22835
<class,5호선,신정,4716,4331,9047
<class,5호선,목동,5397,5773,11170
<class,5호선,오목교,8536,8646,17182
<class,5호선,양평,1816,1894,3710
<class,5호선,영등포구청,924,959,1883
<class,5호선,영등포시장,3111,3273,6384
<class,5호선,신길,1402,1638,3040
<class,5호선,여의도,5346,5237,10583
<class,5호선,여의나루,3982,4854,8836
<class,5호선,마포,3397,3424,6821
<class,5호선,공덕,2923,3093,6016
<class,5호선,애오개,1851,1931,3782
<class,5호선,충정로,1040,1061,2101
<class,5호선,서대문,3600,3639,7239
<class,5호선,광화문,7949,7982,15931
<class,5호선,종로3가,5686,5237,10923
<class,5호선,을지로4가,1037,1131,2168
<class,5호선,동대문역사문화공원,485,572,1057
<class,5호선,청구,1306,1152,2458
<class,5호선,신금호,2120,2303,4423
<class,5호선,행당,2940,2722,5662
<class,5호선,왕십리,1607,1862,3469
<class,5호선,마장,2035,1985,4020
<class,5호선,답십리,5246,4945,10191
<class,5호선,장한평,5532,5626,11158
<class,5호선,군자,4457,4972,9429
<class,5호선,아차산,6962,6802,13764
<class,5호선,광나루,5227,5138,10365
<class,5호선,천호,8989,8538,17527
<class,5호선,강동,6285,6419,12704
<class,5호선,길동,3203,3320,6523
<class,5호선,굽은다리,3735,3533,7268
<class,5호선,명일,3022,3087,6109
<class,5호선,고덕,3041,3042,6083
<class,5호선,상일동,4891,4839,9730
<class,5호선,둔촌동,3299,3385,6684
<class,5호선,올림픽공원,1544,1340,2884
<class,5호선,방이,2706,2668,5374
<class,5호선,오금,1183,1084,2267
<class,5호선,개롱,2154,2475,4629
<class,5호선,거여,2879,2832,5711
<class,5호선,마천,2530,2704,5234
<class,5호선,강일,1283,1242,2525
<class,5호선,미사,6049,6066,12115
<class,5호선,하남풍산,1491,1575,3066
<class,5호선,하남시청,2424,2286,4710
<class,5호선,하남검단산,3062,2987,6049
<class,6호선,응암,6598,6685,13283
<class,6호선,역촌,1489,1706,3195
<class,6호선,불광,2189,1992,4181
<class,6호선,독바위,1239,1462,2701
<class,6호선,연신내,2,0,2
<class,6호선,구산,2849,2274,5123
<class,6호선,새절,4748,4630,9378
<class,6호선,증산,4062,4161,8223
<class,6호선,디지털미디어시티,3731,3802,7533
<class,6호선,월드컵경기장,2370,2396,4766
<class,6호선,마포구청,5366,4948,10314
<class,6호선,망원,6654,7562,14216
<class,6호선,합정,6443,5762,12205
<class,6호선,상수,4270,5146,9416
<class,6호선,광흥창,2969,2894,5863
<class,6호선,대흥,2891,3021,5912
<class,6호선,공덕,4526,4302,8828
<class,6호선,효창공원앞,2272,1999,4271
<class,6호선,삼각지,2496,1897,4393
<class,6호선,녹사평,2438,2560,4998
<class,6호선,이태원,5446,5361,10807
<class,6호선,한강진,3704,4162,7866
<class,6호선,버티고개,737,822,1559
<class,6호선,약수,1171,1206,2377
<class,6호선,청구,1278,1227,2505
<class,6호선,신당,3344,3203,6547
<class,6호선,동묘앞,4318,4101,8419
<class,6호선,창신,1200,1115,2315
<class,6호선,보문,2745,2670,5415
<class,6호선,안암,3274,3429,6703
<class,6호선,고려대,2890,2834,5724
<class,6호선,월곡,3770,3908,7678
<class,6호선,상월곡,2312,2124,4436
<class,6호선,돌곶이,3816,3693,7509
<class,6호선,석계,4749,4863,9612
<class,6호선,태릉입구,2303,2511,4814
<class,6호선,화랑대,3657,3189,6846
<class,6호선,봉화산,2833,2809,5642
<class,7호선,장암,1303,1031,2334
<class,7호선,도봉산,4050,5939,9989
<class,7호선,수락산,6652,6769,13421
<class,7호선,마들,4560,4252,8812
<class,7호선,노원,8398,8455,16853
<class,7호선,중계,4890,4540,9430
<class,7호선,하계,6398,6186,12584
<class,7호선,공릉,4688,4803,9491
<class,7호선,태릉입구,3537,3334,6871
<class,7호선,먹골,3931,3910,7841
<class,7호선,중화,4313,4238,8551
<class,7호선,상봉,6719,6381,13100
<class,7호선,면목,6209,6212,12421
<class,7호선,사가정,6967,6874,13841
<class,7호선,용마산,2382,2607,4989
<class,7호선,중곡,3464,3496,6960
<class,7호선,군자,5694,4490,10184
<class,7호선,어린이대공원,4936,4864,9800
<class,7호선,건대입구,5460,5263,10723
<class,7호선,뚝섬유원지,4427,3966,8393
<class,7호선,청담,4783,5215,9998
<class,7호선,강남구청,3870,4293,8163
<class,7호선,학동,3879,4257,8136
<class,7호선,논현,4794,5163,9957
<class,7호선,반포,2037,2032,4069
<class,7호선,고속터미널,8634,5283,13917
<class,7호선,내방,3803,3909,7712
<class,7호선,이수,5771,5660,11431
<class,7호선,남성,3936,3987,7923
<class,7호선,숭실대입구,3957,4364,8321
<class,7호선,상도,3699,3797,7496
<class,7호선,장승배기,3641,3649,7290
<class,7호선,신대방삼거리,5834,5866,11700
<class,7호선,보라매,2999,3065,6064
<class,7호선,신풍,4464,4291,8755
<class,7호선,대림,5162,4979,10141
<class,7호선,남구로,5201,5126,10327
<class,7호선,가산디지털단지,7359,6891,14250
<class,7호선,철산,7586,7522,15108
<class,7호선,광명사거리,9114,9003,18117
<class,7호선,천왕,3548,3508,7056
<class,7호선,온수,2715,2762,5477
<class,7호선,까치울,3045,3141,6186
<class,7호선,부천종합운동장,1854,1652,3506
<class,7호선,춘의,2595,2462,5057
<class,7호선,신중동,5002,4945,9947
<class,7호선,부천시청,5034,4989,10023
<class,7호선,상동,5165,5031,10196
<class,7호선,삼산체육관,1854,1741,3595
<class,7호선,굴포천,3556,3478,7034
<class,7호선,부평구청,2751,2423,5174
<class,8호선,암사,6619,6325,12944
<class,8호선,천호,6349,7342,13691
<class,8호선,강동구청,3141,3274,6415
<class,8호선,몽촌토성,2179,2247,4426
<class,8호선,잠실,6770,7605,14375
<class,8호선,석촌,3076,3833,6909
<class,8호선,송파,2501,2594,5095
<class,8호선,가락시장,2266,2875,5141
<class,8호선,문정,3626,3801,7427
<class,8호선,장지,6693,7025,13718
<class,8호선,복정,3542,3300,6842
<class,8호선,산성,2469,2601,5070
<class,8호선,남한산성입구,4989,4687,9676
<class,8호선,단대오거리,4016,4085,8101
<class,8호선,신흥,2146,2353,4499
<class,8호선,수진,2234,1965,4199
<class,8호선,모란,1956,1718,3674
<class,9호선,개화,918,827,1745
<class,9호선,김포공항,6172,8875,15047
<class,9호선,공항시장,1315,1533,2848
<class,9호선,신방화,2527,2577,5104
<class,9호선,마곡나루,3734,3941,7675
<class,9호선,양천향교,3026,3226,6252
<class,9호선,가양,6977,7057,14034
<class,9호선,증미,1882,1934,3816
<class,9호선,등촌,3831,3932,7763
<class,9호선,염창,6010,6094,12104
<class,9호선,신목동,1200,1057,2257
<class,9호선,선유도,2028,2093,4121
<class,9호선,당산,6242,6336,12578
<class,9호선,국회의사당,2193,2121,4314
<class,9호선,여의도,5859,5185,11044
<class,9호선,샛강,1138,1192,2330
<class,9호선,노량진,10568,11273,21841
<class,9호선,노들,1683,1434,3117
<class,9호선,흑석,2684,2925,5609
<class,9호선,동작,765,645,1410
<class,9호선,구반포,700,804,1504
<class,9호선,신반포,919,1005,1924
<class,9호선,고속터미널,6840,8420,15260
<class,9호선,사평,1104,1102,2206
<class,9호선,신논현,10967,10604,21571
<class,9호선2~3단계,언주,2471,2484,4955
<class,9호선2~3단계,선정릉,2201,2454,4655
<class,9호선2~3단계,삼성중앙,1401,1523,2924
<class,9호선2~3단계,봉은사,6374,6717,13091
<class,9호선2~3단계,종합운동장,1542,1434,2976
<class,9호선2~3단계,삼전,2666,2694,5360
<class,9호선2~3단계,석촌고분,2183,2245,4428
<class,9호선2~3단계,석촌,3276,2862,6138
<class,9호선2~3단계,송파나루,2244,2618,4862
<class,9호선2~3단계,한성백제,1017,914,1931
<class,9호선2~3단계,올림픽공원,2665,2577,5242
<class,9호선2~3단계,둔촌오륜,273,291,564
<class,9호선2~3단계,중앙보훈병원,2494,2333,4827
<class,경강선,판교,1864,1705,3569
<class,경강선,이매,432,371,803
<class,경강선,삼동,838,785,1623
<class,경강선,경기광주,2722,2675,5397
<class,경강선,초월,1169,1209,2378
<class,경강선,곤지암,1116,1250,2366
<class,경강선,신둔도예촌,657,622,1279
<class,경강선,이천,1468,1558,3026
<class,경강선,부발,951,1465,2416
<class,경강선,세종대왕릉,219,185,404
<class,경강선,여주,1482,1408,2890
<class,경부선,서울역,4447,1051,5498
<class,경부선,남영,2761,3013,5774
<class,경부선,용산,23888,19844,43732
<class,경부선,노량진,3760,3608,7368
<class,경부선,대방,3881,4310,8191
<class,경부선,영등포,22387,21280,43667
<class,경부선,신도림,1374,1465,2839
<class,경부선,신길,3455,3128,6583
<class,경부선,구로,6832,6870,13702
<class,경부선,가산디지털단지,3282,4619,7901
<class,경부선,금천구청,4449,4497,8946
<class,경부선,석수,3821,3638,7459
<class,경부선,관악,3456,3215,6671
<class,경부선,안양,10017,9680,19697
<class,경부선,명학,2383,2394,4777
<class,경부선,금정,9632,10099,19731
<class,경부선,군포,2212,2170,4382
<class,경부선,의왕,2980,3062,6042
<class,경부선,성균관대,5387,5741,11128
<class,경부선,화서,2579,2537,5116
<class,경부선,수원,23709,22799,46508
<class,경부선,독산,4359,4377,8736
<class,경부선,세류,1477,1520,2997
<class,경부선,병점,6593,7288,13881
<class,경부선,세마,1218,1126,2344
<class,경부선,오산대,1545,1554,3099
<class,경부선,오산,5765,6297,12062
<class,경부선,진위,515,508,1023
<class,경부선,송탄,2635,2908,5543
<class,경부선,서정리,3079,4333,7412
<class,경부선,평택지제,1739,1561,3300
<class,경부선,평택,8288,8699,16987
<class,경부선,성환,1725,1975,3700
<class,경부선,직산,405,444,849
<class,경부선,두정,3448,3536,6984
<class,경부선,천안,4882,4460,9342
<class,경부선,당정,2206,2171,4377
<class,경부선,서동탄,578,560,1138
<class,경부선,광명,1809,1275,3084
<class,경원선,이촌,1391,1170,2561
<class,경원선,서빙고,663,650,1313
<class,경원선,한남,1431,1443,2874
<class,경원선,옥수,43,16,59
<class,경원선,응봉,707,674,1381
<class,경원선,왕십리,6383,7575,13958
<class,경원선,청량리,11167,9660,20827
<class,경원선,외대앞,3279,3311,6590
<class,경원선,신이문,3571,3416,6987
<class,경원선,석계,3602,3992,7594
<class,경원선,광운대,3123,3126,6249
<class,경원선,월계,2575,2420,4995
<class,경원선,녹천,2033,1734,3767
<class,경원선,방학,4139,4092,8231
<class,경원선,도봉,2600,2492,5092
<class,경원선,도봉산,6799,4641,11440
<class,경원선,망월사,3382,3419,6801
<class,경원선,회룡,5353,5325,10678
<class,경원선,의정부,10012,10258,20270
<class,경원선,가능,3061,2917,5978
<class,경원선,녹양,1987,1968,3955
<class,경원선,덕계,1186,1183,2369
<class,경원선,덕정,2429,2527,4956
<class,경원선,지행,3027,3081,6108
<class,경원선,동두천중앙,1675,1573,3248
<class,경원선,보산,966,908,1874
<class,경원선,동두천,1063,1304,2367
<class,경원선,소요산,4008,3457,7465
<class,경의선,서울역,756,688,1444
<class,경의선,신촌,196,202,398
<class,경의선,효창공원앞,903,1117,2020
<class,경의선,공덕,1147,1053,2200
<class,경의선,서강대,952,967,1919
<class,경의선,홍대입구,1124,1228,2352
<class,경의선,가좌,2162,2216,4378
<class,경의선,디지털미디어시티,989,980,1969
<class,경의선,수색,620,729,1349
<class,경의선,화전,600,595,1195
<class,경의선,강매,1014,955,1969
<class,경의선,행신,3276,2985,6261
<class,경의선,능곡,1659,1616,3275
<class,경의선,곡산,220,217,437
<class,경의선,백마,2465,2354,4819
<class,경의선,풍산,2607,2502,5109
<class,경의선,일산,3841,3736,7577
<class,경의선,탄현,3077,2875,5952
<class,경의선,야당,3044,3035,6079
<class,경의선,운정,2585,2517,5102
<class,경의선,금릉,2019,1928,3947
<class,경의선,금촌,2986,3325,6311
<class,경의선,월롱,643,1269,1912
<class,경의선,파주,511,428,939
<class,경의선,문산,3018,2873,5891
<class,경의선,임진강,78,76,154
<class,경인선,개봉,8553,8819,17372
<class,경인선,오류동,4869,4683,9552
<class,경인선,역곡,10384,10198,20582
<class,경인선,부천,15947,15763,31710
<class,경인선,송내,9330,9232,18562
<class,경인선,부평,16525,16861,33386
<class,경인선,백운,2854,2928,5782
<class,경인선,동암,6977,6932,13909
<class,경인선,주안,8707,7709,16416
<class,경인선,제물포,3958,3838,7796
<class,경인선,동인천,6961,6648,13609
<class,경인선,인천,3065,2485,5550
<class,경인선,구일,2228,2201,4429
<class,경인선,소사,3724,3673,7397
<class,경인선,부개,3520,3351,6871
<class,경인선,간석,2305,2198,4503
<class,경인선,도원,1130,1156,2286
<class,경인선,온수,2443,2245,4688
<class,경인선,중동,3508,3213,6721
<class,경인선,도화,1773,1651,3424
<class,경춘선,신내,691,681,1372
<class,경춘선,갈매,1122,1021,2143
<class,경춘선,별내,1431,1401,2832
<class,경춘선,퇴계원,1604,1598,3202
<class,경춘선,사릉,1242,1295,2537
<class,경춘선,금곡,686,673,1359
<class,경춘선,평내호평,2599,2577,5176
<class,경춘선,천마산,900,885,1785
<class,경춘선,마석,2129,2136,4265
<class,경춘선,대성리,505,421,926
<class,경춘선,청평,1371,1096,2467
<class,경춘선,상천,408,318,726
<class,경춘선,가평,2251,1808,4059
<class,경춘선,굴봉산,207,189,396
<class,경춘선,백양리,225,153,378
<class,경춘선,강촌,736,662,1398
<class,경춘선,김유정,410,412,822
<class,경춘선,남춘천,1968,1988,3956
<class,경춘선,춘천,1480,1071,2551
<class,공항철도 1호선,서울역,5234,4036,9270
<class,공항철도 1호선,공덕,816,1097,1913
<class,공항철도 1호선,홍대입구,6204,6203,12407
<class,공항철도 1호선,디지털미디어시티,2633,2695,5328
<class,공항철도 1호선,마곡나루,1451,1577,3028
<class,공항철도 1호선,김포공항,10303,5197,15500
<class,공항철도 1호선,계양,3534,3655,7189
<class,공항철도 1호선,검암,2610,2668,5278
<class,공항철도 1호선,청라국제도시,2329,2226,4555
<class,공항철도 1호선,운서,3946,4132,8078
<class,공항철도 1호선,공항화물청사,892,965,1857
<class,공항철도 1호선,인천공항1터미널,3376,3301,6677
<class,공항철도 1호선,인천공항2터미널,2240,2139,4379
<class,공항철도 1호선,영종,1791,1872,3663
<class,수인선,연수,2079,2034,4113
<class,수인선,원인재,2075,2118,4193
<class,수인선,남동인더스파크,522,532,1054
<class,수인선,호구포,1414,1475,2889
<class,수인선,인천논현,2158,2282,4440
<class,수인선,소래포구,3516,3393,6909
<class,수인선,월곶,1187,1137,2324
<class,수인선,달월,34,35,69
<class,수인선,사리,1784,1562,3346
<class,수인선,야목,121,114,235
<class,수인선,어천,370,461,831
<class,수인선,오목천,999,985,1984
<class,수인선,고색,1190,1205,2395
<class,분당선,매교,963,1029,1992
<class,분당선,수원시청,4964,4902,9866
<class,분당선,매탄권선,1817,1696,3513
<class,분당선,망포,4453,4776,9229
<class,분당선,영통,3144,3208,6352
<class,분당선,청명,1359,1347,2706
<class,분당선,상갈,2139,2263,4402
<class,분당선,기흥,3803,3653,7456
<class,분당선,신갈,1374,1443,2817
<class,분당선,구성,1626,1824,3450
<class,중앙선,국수,553,574,1127
<class,중앙선,신원,196,171,367
<class,중앙선,양수,1958,2107,4065
<class,중앙선,운길산,1116,1020,2136
<class,중앙선,팔당,1251,1301,2552
<class,중앙선,도심,1297,1142,2439
<class,중앙선,덕소,3759,3746,7505
<class,중앙선,양정,553,494,1047
<class,중앙선,도농,5239,5164,10403
<class,중앙선,구리,8200,8486,16686
<class,중앙선,양원,1065,1071,2136
<class,중앙선,망우,5251,5002,10253
<class,중앙선,상봉,4352,4268,8620
<class,중앙선,중랑,3763,3546,7309
<class,1호선,시청,5601,3452,9053
<class,중앙선,회기,14809,13565,28374
<class,장항선,신창,890,766,1656
<class,장항선,온양온천,3615,3813,7428
<class,장항선,배방,744,736,1480
<class,장항선,아산,2082,2146,4228
<class,장항선,쌍용,1287,1175,2462
<class,장항선,봉명,591,559,1150
<class,일산선,대화,7032,6353,13385
<class,일산선,주엽,5336,5220,10556
<class,일산선,정발산,5076,5184,10260
<class,일산선,마두,4118,4146,8264
<class,일산선,백석,5976,6131,12107
<class,일산선,대곡,1098,967,2065
<class,일산선,화정,10096,10625,20721
<class,일산선,원당,6616,6351,12967
<class,일산선,삼송,10961,10789,21750
<class,일산선,원흥,5840,5610,11450
<class,우이신설선,신설동,1198,1091,2289
<class,우이신설선,보문,909,883,1792
<class,우이신설선,성신여대입구,2263,2527,4790
<class,우이신설선,정릉,2918,2407,5325
<class,우이신설선,북한산보국문,3726,3297,7023
<class,우이신설선,솔샘,2961,2771,5732
<class,우이신설선,삼양사거리,1638,1634,3272
<class,우이신설선,삼양,1331,1359,2690
<class,우이신설선,화계,2175,2072,4247
<class,우이신설선,가오리,2594,2421,5015
<class,우이신설선,4.19민주묘지,2018,1752,3770
<class,우이신설선,솔밭공원,1586,1496,3082
<class,우이신설선,북한산우이,3200,3289,6489
<class,안산선,수리산,2304,2046,4350
<class,안산선,오이도,6283,6493,12776
<class,안산선,정왕,5120,5286,10406
<class,안산선,신길온천,1116,1038,2154
<class,안산선,안산,7961,8124,16085
<class,안산선,초지,2498,2529,5027
<class,안산선,고잔,4656,4474,9130
<class,안산선,중앙,11485,12024,23509
<class,안산선,한대앞,5437,5572,11009
<class,안산선,상록수,9778,9918,19696
<class,안산선,반월,2676,2607,5283
<class,안산선,대야미,3070,2769,5839
<class,안산선,산본,9702,10412,20114
<class,수인선,인천,1192,1774,2966
<class,수인선,신포,1111,1097,2208
<class,수인선,숭의,2326,2073,4399
<class,수인선,인하대,3337,3163,6500
<class,수인선,송도,1609,1577,3186
<class,수인선,연수,3038,3018,6056
<class,수인선,원인재,2980,3175,6155
<class,수인선,남동인더스파크,891,889,1780
<class,수인선,호구포,2166,2094,4260
<class,수인선,인천논현,3599,3754,7353
<class,수인선,소래포구,4178,4329,8507
<class,수인선,월곶,1865,1797,3662
<class,수인선,달월,43,44,87
<class,수인선,사리,2608,2228,4836
<class,수인선,야목,186,167,353
<class,수인선,어천,562,488,1050
<class,수인선,오목천,1560,1346,2906
<class,수인선,고색,1962,1887,3849
<class,분당선,매교,1655,1636,3291
<class,분당선,수원시청,7435,7860,15295
<class,분당선,매탄권선,2601,2491,5092
<class,분당선,망포,7105,6325,13430
<class,분당선,영통,4977,4916,9893
<class,분당선,청명,2052,1969,4021
<class,분당선,상갈,3091,3018,6109
<class,분당선,기흥,5346,5163,10509
<class,분당선,신갈,2164,2226,4390
<class,분당선,구성,2574,2685,5259
<class,분당선,죽전,7947,9043,16990
<class,분당선,보정,1259,1123,2382
<class,분당선,이매,3184,3132,6316
<class,분당선,오리,6245,5130,11375
<class,분당선,미금,8969,9277,18246
<class,분당선,정자,8438,8622,17060
<class,분당선,수내,7289,6731,14020
<class,분당선,서현,14846,14907,29753
<class,분당선,야탑,13418,14398,27816
<class,분당선,모란,15841,16187,32028
<class,분당선,태평,9146,8487,17633
<class,분당선,가천대,3773,4067,7840
<class,분당선,선정릉,2456,2469,4925
<class,분당선,강남구청,3839,4620,8459
<class,분당선,압구정로데오,13529,15178,28707
<class,분당선,서울숲,5900,5636,11536
<class,분당선,수원,5534,4712,10246
<class,분당선,수서,7432,8669,16101
<class,분당선,대모산입구,2475,2330,4805
<class,분당선,개포동,2166,2107,4273
<class,분당선,구룡,1359,1269,2628
<class,분당선,도곡,3465,2945,6410
<class,분당선,한티,10070,9684,19754
<class,분당선,선릉,3836,5638,9474
<class,과천선,범계,15189,14908,30097
<class,과천선,평촌,6914,6677,13591
<class,과천선,인덕원,11437,11280,22717
<class,과천선,정부과천청사,4439,4481,8920
<class,과천선,과천,3462,3059,6521
<class,과천선,대공원,3281,3450,6731
<class,과천선,경마공원,869,794,1663
<class,과천선,선바위,3854,3628,7482
<class,공항철도 1호선,영종,2267,2535,4802
<class,공항철도 1호선,인천공항2터미널,1900,1749,3649
<class,공항철도 1호선,인천공항1터미널,3596,3582,7178
<class,공항철도 1호선,공항화물청사,1219,1202,2421
<class,공항철도 1호선,운서,4879,5089,9968
<class,공항철도 1호선,청라국제도시,3253,3068,6321
<class,공항철도 1호선,검암,3680,3640,7320
<class,공항철도 1호선,계양,5259,4912,10171
<class,공항철도 1호선,김포공항,9753,5767,15520
<class,공항철도 1호선,마곡나루,2337,2458,4795
<class,공항철도 1호선,디지털미디어시티,3721,3513,7234
<class,공항철도 1호선,홍대입구,8343,7729,16072
<class,공항철도 1호선,공덕,1178,1561,2739
<class,공항철도 1호선,서울역,5107,5785,10892
<class,경춘선,춘천,1637,1599,3236
<class,경춘선,남춘천,2153,2526,4679
<class,경춘선,김유정,428,540,968
<class,경춘선,강촌,774,878,1652
<class,경춘선,백양리,165,159,324
<class,경춘선,굴봉산,182,175,357
<class,경춘선,가평,2242,2680,4922
<class,경춘선,상천,379,348,727
<class,경춘선,청평,1541,1732,3273
<class,경춘선,대성리,598,620,1218
<class,경춘선,마석,2722,2825,5547
<class,경춘선,천마산,1182,1232,2414
<class,경춘선,평내호평,3998,3899,7897
<class,경춘선,금곡,1024,909,1933
<class,경춘선,사릉,1916,1943,3859
<class,경춘선,퇴계원,2288,2151,4439
<class,경춘선,별내,1889,1897,3786
<class,경춘선,갈매,1591,1364,2955
<class,경춘선,신내,922,921,1843
<class,경인선,도화,2665,2506,5171
<class,경인선,중동,5343,5012,10355
<class,경인선,온수,3790,3571,7361
<class,경인선,도원,1722,1772,3494
<class,경인선,간석,3509,3298,6807
<class,경인선,부개,5131,4706,9837
<class,경인선,소사,5545,5330,10875
<class,경인선,구일,3418,3224,6642
<class,경인선,인천,3734,3345,7079
<class,경인선,동인천,9633,9559,19192
<class,경인선,제물포,5836,5755,11591
<class,경인선,주안,12433,11048,23481
<class,경인선,동암,10050,10405,20455
<class,경인선,백운,4485,4428,8913
<class,경인선,부평,22371,24392,46763
<class,경인선,송내,14019,13897,27916
<class,경인선,부천,23058,23650,46708
<class,경인선,역곡,15605,15469,31074
<class,경인선,오류동,7360,6769,14129
<class,경인선,개봉,13076,12822,25898
<class,경의선,서울역,6,18,24
<class,경의선,임진강,81,48,129
<class,경의선,문산,4004,3959,7963
<class,경의선,파주,687,582,1269
<class,경의선,월롱,1234,1115,2349
<class,경의선,금촌,4522,4418,8940
<class,경의선,금릉,2990,2905,5895
<class,경의선,운정,3748,3632,7380
<class,경의선,야당,4230,4237,8467
<class,경의선,탄현,4236,4153,8389
<class,경의선,일산,4864,4777,9641
<class,경의선,풍산,3404,3299,6703
<class,경의선,백마,3319,3226,6545
<class,경의선,곡산,330,336,666
<class,경의선,능곡,2330,2247,4577
<class,경의선,행신,3907,4101,8008
<class,경의선,강매,1594,1525,3119
<class,경의선,화전,822,792,1614
<class,경의선,수색,1169,1114,2283
<class,경의선,디지털미디어시티,1537,1294,2831
<class,경의선,가좌,3231,2964,6195
<class,경의선,홍대입구,1525,1604,3129
<class,경의선,서강대,1481,1266,2747
<class,경의선,공덕,1738,1499,3237
<class,경의선,효창공원앞,1397,1567,2964
<class,경의선,신촌,276,258,534
<class,경의선,서울역,952,1038,1990
<class,경원선,소요산,3780,3306,7086
<class,경원선,동두천,1352,1771,3123
<class,경원선,보산,1189,1159,2348
<class,경원선,동두천중앙,2022,2187,4209
<class,경원선,지행,4331,4339,8670
<class,경원선,덕정,3513,3284,6797
<class,경원선,덕계,1845,1735,3580
<class,경원선,양주,5224,5004,10228
<class,경원선,녹양,2738,2713,5451
<class,경원선,가능,4372,4193,8565
<class,경원선,의정부,13576,14453,28029
<class,경원선,회룡,7801,7912,15713
<class,경원선,망월사,4774,4883,9657
<class,경원선,도봉산,7462,5184,12646
<class,경원선,도봉,3866,3633,7499
<class,경원선,방학,6090,5878,11968
<class,경원선,녹천,2838,2350,5188
<class,경원선,월계,3669,3541,7210
<class,경원선,광운대,4567,4350,8917
<class,경원선,석계,5303,5489,10792
<class,경원선,신이문,5103,4530,9633
<class,경원선,외대앞,4550,4535,9085
<class,경원선,청량리,12553,14793,27346
<class,경원선,왕십리,9515,10793,20308
<class,경원선,응봉,1136,899,2035
<class,경원선,옥수,32,32,64
<class,경원선,한남,2401,2140,4541
<class,경원선,서빙고,1129,959,2088
<class,경원선,이촌,2520,1794,4314
<class,경부선,광명,1810,1872,3682
<class,경부선,서동탄,783,796,1579
<class,경부선,당정,3113,2987,6100
<class,경부선,천안,4950,5465,10415
<class,경부선,두정,3679,3798,7477
<class,경부선,직산,533,559,1092
<class,경부선,성환,2352,2206,4558
<class,경부선,평택,10612,10475,21087
<class,경부선,평택지제,2397,2237,4634
<class,경부선,서정리,5033,4279,9312
<class,경부선,송탄,3942,3556,7498
<class,경부선,진위,789,687,1476
<class,경부선,오산,7372,7006,14378
<class,경부선,오산대,2145,1989,4134
<class,경부선,세마,1625,1455,3080
<class,경부선,병점,9492,9226,18718
<class,경부선,세류,1926,1963,3889
<class,경부선,독산,6868,6826,13694
<class,경부선,수원,27529,30301,57830
<class,경부선,화서,3745,3701,7446
<class,경부선,성균관대,7681,7524,15205
<class,경부선,의왕,4716,4618,9334
<class,경부선,군포,3590,3293,6883
<class,경부선,금정,14223,14144,28367
<class,경부선,명학,3887,3706,7593
<class,경부선,안양,13843,13874,27717
<class,경부선,관악,4628,4483,9111
<class,경부선,석수,5422,5004,10426
<class,경부선,금천구청,6445,6476,12921
<class,경부선,가산디지털단지,4839,6194,11033
<class,경부선,구로,10126,10035,20161
<class,경부선,신길,5024,4123,9147
<class,경부선,신도림,2068,2129,4197
<class,경부선,영등포,27392,29079,56471
<class,경부선,대방,6057,5940,11997
<class,경부선,노량진,6185,5365,11550
<class,경부선,용산,24667,29066,53733
<class,경부선,남영,4270,4361,8631
<class,경부선,서울역,3535,1418,4953
<class,경강선,여주,1791,2058,3849
<class,경강선,세종대왕릉,241,301,542
<class,경강선,부발,1409,1256,2665
<class,경강선,이천,2025,2240,4265
<class,경강선,신둔도예촌,863,880,1743
<class,경강선,곤지암,1521,1655,3176
<class,경강선,초월,1724,1726,3450
<class,경강선,경기광주,4134,3994,8128
<class,경강선,삼동,1144,1131,2275
<class,경강선,이매,713,511,1224
<class,경강선,판교,2434,2227,4661
<class,9호선2~3단계,중앙보훈병원,3720,3499,7219
<class,9호선2~3단계,둔촌오륜,505,518,1023
<class,9호선2~3단계,올림픽공원,4926,4514,9440
<class,9호선2~3단계,한성백제,1559,1348,2907
<class,9호선2~3단계,송파나루,3090,3447,6537
<class,9호선2~3단계,석촌,5020,4446,9466
<class,9호선2~3단계,석촌고분,3323,3192,6515
<class,9호선2~3단계,삼전,3971,3734,7705
<class,9호선2~3단계,종합운동장,2545,2122,4667
<class,9호선2~3단계,봉은사,8097,8453,16550
<class,9호선2~3단계,삼성중앙,2341,2336,4677
<class,9호선2~3단계,선정릉,3490,3723,7213
<class,9호선2~3단계,언주,4241,4316,8557
<class,9호선,신논현,19158,18585,37743
<class,9호선,사평,1659,1620,3279
<class,9호선,고속터미널,8713,13093,21806
<class,9호선,신반포,1804,1700,3504
<class,9호선,구반포,1327,1356,2683
<class,9호선,동작,1195,974,2169
<class,9호선,흑석,4308,4200,8508
<class,9호선,노들,2601,2184,4785
<class,9호선,노량진,16220,15478,31698
<class,9호선,샛강,2016,1935,3951
<class,9호선,여의도,7848,7347,15195
<class,9호선,국회의사당,2537,2597,5134
<class,9호선,당산,9553,8917,18470
<class,9호선,선유도,3252,2976,6228
<class,9호선,신목동,1778,1558,3336
<class,9호선,염창,9135,8296,17431
<class,9호선,등촌,6179,5860,12039
<class,9호선,증미,3547,3466,7013
<class,9호선,가양,10883,10166,21049
<class,9호선,양천향교,4644,4482,9126
<class,9호선,마곡나루,5978,5813,11791
<class,9호선,신방화,3858,3719,7577
<class,9호선,공항시장,1904,2016,3920
<class,9호선,김포공항,6145,11742,17887
<class,9호선,개화,1230,973,2203
<class,8호선,모란,3638,3159,6797
<class,8호선,수진,3718,3147,6865
<class,8호선,신흥,3212,3378,6590
<class,8호선,단대오거리,6316,5789,12105
<class,8호선,남한산성입구,7421,6681,14102
<class,8호선,산성,3707,3712,7419
<class,8호선,복정,5464,4737,10201
<class,8호선,장지,9117,8851,17968
<class,8호선,문정,5922,5865,11787
<class,8호선,가락시장,4387,4332,8719
<class,8호선,송파,4213,4107,8320
<class,8호선,석촌,4876,5656,10532
<class,8호선,잠실,8915,10248,19163
<class,8호선,몽촌토성,3471,3202,6673
<class,8호선,강동구청,4859,4869,9728
<class,8호선,천호,9185,10784,19969
<class,8호선,암사,10125,9349,19474
<class,7호선,부평구청,4084,3629,7713
<class,7호선,굴포천,5355,5424,10779
<class,7호선,삼산체육관,2786,2641,5427
<class,7호선,상동,7746,7962,15708
<class,7호선,부천시청,7953,7963,15916
<class,7호선,신중동,7891,7672,15563
<class,7호선,춘의,4382,4188,8570
<class,7호선,부천종합운동장,2743,2456,5199
<class,7호선,까치울,4573,4684,9257
<class,7호선,온수,4642,4360,9002
<class,7호선,천왕,5481,5072,10553
<class,7호선,광명사거리,13851,14082,27933
<class,7호선,철산,12186,12193,24379
<class,7호선,가산디지털단지,11382,10408,21790
<class,7호선,남구로,7129,7404,14533
<class,7호선,대림,5861,6175,12036
<class,7호선,신풍,6594,6227,12821
<class,7호선,보라매,5032,4716,9748
<class,7호선,신대방삼거리,9289,8536,17825
<class,7호선,장승배기,5363,5122,10485
<class,7호선,상도,6014,5466,11480
<class,7호선,숭실대입구,6157,6102,12259
<class,7호선,남성,6280,5781,12061
<class,7호선,이수,9311,8528,17839
<class,7호선,내방,6313,6215,12528
<class,7호선,고속터미널,9525,7988,17513
<class,7호선,반포,3446,3252,6698
<class,7호선,논현,8950,9722,18672
<class,7호선,학동,7447,7625,15072
<class,7호선,강남구청,7352,7932,15284
<class,7호선,청담,8663,9113,17776
<class,7호선,뚝섬유원지,6796,6257,13053
<class,7호선,건대입구,8004,7860,15864
<class,7호선,어린이대공원,6499,6176,12675
<class,7호선,군자,8546,6611,15157
<class,7호선,중곡,5513,5177,10690
<class,7호선,용마산,3797,3914,7711
<class,7호선,사가정,10220,9833,20053
<class,7호선,면목,9316,9179,18495
<class,7호선,상봉,10543,9869,20412
<class,7호선,중화,6816,6457,13273
<class,7호선,먹골,6172,5994,12166
<class,7호선,태릉입구,5184,4817,10001
<class,7호선,공릉,6930,6835,13765
<class,7호선,하계,9809,9156,18965
<class,7호선,중계,7398,6672,14070
<class,7호선,노원,12659,13304,25963
<class,7호선,마들,7513,6890,14403
<class,7호선,수락산,8549,8405,16954
<class,7호선,도봉산,5232,7334,12566
<class,7호선,장암,1282,958,2240
<class,6호선,봉화산,4122,4056,8178
<class,6호선,화랑대,5360,4549,9909
<class,6호선,태릉입구,3308,3555,6863
<class,6호선,돌곶이,4846,4548,9394
<class,6호선,상월곡,3298,2923,6221
<class,6호선,월곡,6007,5814,11821
<class,6호선,고려대,4267,3762,8029
<class,6호선,안암,4703,4353,9056
<class,6호선,보문,3994,3431,7425
<class,6호선,창신,1747,1445,3192
<class,6호선,동묘앞,5993,5807,11800
<class,6호선,신당,4580,4300,8880
<class,6호선,청구,1885,1825,3710
<class,6호선,약수,2057,1896,3953
<class,6호선,버티고개,1040,1172,2212
<class,6호선,한강진,4617,5477,10094
<class,6호선,이태원,7183,7809,14992
<class,6호선,녹사평,3621,3721,7342
<class,6호선,삼각지,3531,2711,6242
<class,6호선,효창공원앞,3719,3074,6793
<class,6호선,공덕,7444,6932,14376
<class,6호선,대흥,4348,4224,8572
<class,6호선,광흥창,4001,3641,7642
<class,6호선,상수,5509,6483,11992
<class,6호선,합정,9068,8316,17384
<class,6호선,망원,9986,11093,21079
<class,6호선,마포구청,7555,6468,14023
<class,6호선,월드컵경기장,3695,3894,7589
<class,6호선,디지털미디어시티,5717,5783,11500
<class,6호선,증산,6201,6063,12264
<class,6호선,새절,7116,6877,13993
<class,6호선,구산,4486,3427,7913
<class,6호선,연신내,1,0,1
<class,6호선,독바위,1825,2115,3940
<class,6호선,불광,2966,2805,5771
<class,6호선,역촌,2314,2529,4843
<class,6호선,응암,10334,9968,20302
<class,5호선,하남검단산,3876,3905,7781
<class,5호선,하남시청,3813,3700,7513
<class,5호선,하남풍산,2122,2245,4367
<class,5호선,미사,9168,9136,18304
<class,5호선,강일,1866,1758,3624
<class,5호선,마천,3699,3690,7389
<class,5호선,거여,4789,4626,9415
<class,5호선,개롱,3720,3776,7496
<class,5호선,오금,1884,1701,3585
<class,5호선,방이,3947,3899,7846
<class,5호선,올림픽공원,2511,2173,4684
<class,5호선,둔촌동,4996,4900,9896
<class,5호선,상일동,7674,7066,14740
<class,5호선,고덕,5311,5266,10577
<class,5호선,명일,4800,4815,9615
<class,5호선,굽은다리,5791,5454,11245
<class,5호선,길동,4973,5068,10041
<class,5호선,강동,9404,8811,18215
<class,5호선,천호,12780,12155,24935
<class,5호선,광나루,7494,7097,14591
<class,5호선,아차산,9662,9233,18895
<class,5호선,군자,6607,7058,13665
<class,5호선,장한평,9173,8747,17920
<class,5호선,답십리,8046,7279,15325
<class,5호선,마장,3055,2800,5855
<class,5호선,왕십리,2655,3023,5678
<class,5호선,행당,4450,3779,8229
<class,5호선,신금호,3334,3426,6760
<class,5호선,청구,2038,1904,3942
<class,5호선,동대문역사문화공원,738,1029,1767
<class,5호선,을지로4가,2641,2950,5591
<class,5호선,종로3가,8503,8726,17229
<class,5호선,광화문,8167,9571,17738
<class,5호선,서대문,5619,5331,10950
<class,5호선,충정로,1564,1525,3089
<class,5호선,애오개,3036,2864,5900
<class,5호선,공덕,5045,5228,10273
<class,5호선,마포,5584,5536,11120
<class,5호선,여의나루,7184,7490,14674
<class,5호선,여의도,7377,8069,15446
<class,5호선,신길,1978,1952,3930
<class,5호선,영등포시장,5214,5154,10368
<class,5호선,영등포구청,1448,1487,2935
<class,5호선,양평,2979,2666,5645
<class,5호선,오목교,12264,12665,24929
<class,5호선,목동,8869,8874,17743
<class,5호선,신정,7182,6181,13363
<class,5호선,까치산,17099,16425,33524
<class,5호선,화곡,16093,14665,30758
<class,5호선,우장산,7789,7748,15537
<class,5호선,발산,9377,9894,19271
<class,5호선,마곡,4185,4248,8433
<class,5호선,송정,4185,4085,8270
<class,5호선,김포공항,6074,6468,12542
<class,5호선,개화산,3004,2991,5995
<class,5호선,방화,4119,3818,7937
<class,4호선,쌍문,17127,15549,32676
<class,4호선,창동,15607,16227,31834
<class,4호선,노원,12734,13618,26352
<class,4호선,상계,11393,10822,22215
<class,4호선,당고개,8412,8295,16707
<class,4호선,남태령,676,519,1195
<class,4호선,사당,14427,12368,26795
<class,4호선,총신대입구,11303,12266,23569
<class,4호선,동작,1560,1516,3076
<class,4호선,이촌,4976,5489,10465
<class,4호선,신용산,7588,8681,16269
<class,4호선,삼각지,2148,2821,4969
<class,4호선,숙대입구,6633,6301,12934
<class,4호선,서울역,4213,8882,13095
<class,4호선,회현,11137,11798,22935
<class,4호선,명동,8981,10165,19146
<class,4호선,충무로,9323,9472,18795
<class,4호선,동대문역사문화공원,8060,7307,15367
<class,4호선,동대문,10120,10293,20413
<class,4호선,혜화,18752,19488,38240
<class,4호선,한성대입구,8185,7662,15847
<class,4호선,성신여대입구,13146,12390,25536
<class,4호선,길음,11046,10228,21274
<class,4호선,미아사거리,17429,16368,33797
<class,4호선,미아,8756,8385,17141
<class,4호선,수유,21168,20543,41711
<class,3호선,오금,2929,2791,5720
<class,3호선,경찰병원,3185,3024,6209
<class,3호선,가락시장,4707,4456,9163
<class,3호선,수서,9488,10352,19840
<class,3호선,일원,3666,3717,7383
<class,3호선,대청,4547,4158,8705
<class,3호선,학여울,923,933,1856
<class,3호선,대치,7575,6812,14387
<class,3호선,도곡,2390,2327,4717
<class,3호선,매봉,4754,4550,9304
<class,3호선,양재,14785,15952,30737
<class,3호선,남부터미널,14885,16588,31473
<class,3호선,교대,5030,2982,8012
<class,3호선,고속터미널,32320,35864,68184
<class,3호선,잠원,2706,2458,5164
<class,3호선,신사,17564,18321,35885
<class,3호선,압구정,19303,20092,39395
<class,3호선,옥수,5675,5623,11298
<class,3호선,금호,4766,4315,9081
<class,3호선,약수,7290,6697,13987
<class,3호선,동대입구,4395,4744,9139
<class,3호선,을지로3가,3663,3958,7621
<class,3호선,종로3가,4149,6092,10241
<class,3호선,안국,9721,10320,20041
<class,3호선,경복궁,9949,10620,20569
<class,3호선,독립문,4597,4651,9248
<class,3호선,무악재,2128,2219,4347
<class,3호선,홍제,10326,9576,19902
<class,3호선,녹번,8102,6967,15069
<class,3호선,불광,10202,11297,21499
<class,3호선,연신내,24369,22534,46903
<class,3호선,구파발,12832,12819,25651
<class,3호선,지축,2378,2369,4747
<class,2호선,용두,1396,1418,2814
<class,2호선,신정네거리,5695,5747,11442
<class,2호선,양천구청,3488,3514,7002
<class,2호선,도림천,642,603,1245
<class,2호선,신설동,2491,2398,4889
<class,2호선,신답,795,842,1637
<class,2호선,용답,1746,1680,3426
<class,2호선,충정로,4140,4190,8330
<class,2호선,아현,6198,5786,11984
<class,2호선,이대,7263,7646,14909
<class,2호선,신촌,21462,21352,42814
<class,2호선,홍대입구,40723,42244,82967
<class,2호선,합정,19536,20465,40001
<class,2호선,당산,9305,10237,19542
<class,2호선,영등포구청,9054,8972,18026
<class,2호선,문래,8694,9192,17886
<class,2호선,신도림,28168,27792,55960
<class,2호선,대림,14788,15660,30448
<class,2호선,구로디지털단지,26562,25727,52289
<class,2호선,신대방,16352,15448,31800
<class,2호선,신림,39928,37671,77599
<class,2호선,봉천,13920,12709,26629
<class,2호선,서울대입구,30111,28318,58429
<class,2호선,낙성대,16851,15204,32055
<class,2호선,사당,21009,22939,43948
<class,2호선,방배,7227,7479,14706
<class,2호선,서초,7689,6493,14182
<class,2호선,교대,12994,14601,27595
<class,2호선,강남,44818,43969,88787
<class,2호선,역삼,13437,14689,28126
<class,2호선,선릉,17698,15643,33341
<class,2호선,삼성,20914,21022,41936
<class,2호선,종합운동장,3454,3877,7331
<class,2호선,잠실새내,12624,13004,25628
<class,2호선,잠실,43446,41597,85043
<class,2호선,잠실나루,6068,5983,12051
<class,2호선,강변,18649,21545,40194
<class,2호선,구의,12915,12326,25241
<class,2호선,건대입구,23813,25610,49423
<class,2호선,성수,13404,15155,28559
<class,2호선,뚝섬,9959,10461,20420
<class,2호선,한양대,2798,2611,5409
<class,2호선,왕십리,9606,8165,17771
<class,2호선,상왕십리,7791,7183,14974
<class,2호선,신당,8569,8974,17543
<class,2호선,동대문역사문화공원,7095,7999,15094
<class,2호선,을지로4가,5521,5686,11207
<class,2호선,을지로3가,7339,7344,14683
<class,2호선,을지로입구,15252,15216,30468
<class,2호선,시청,7132,8098,15230
<class,1호선,청량리,14949,15326,30275
<class,1호선,제기동,12330,12612,24942
<class,1호선,신설동,7557,7101,14658
<class,1호선,동대문,7765,7506,15271
<class,1호선,종로5가,13993,13791,27784
<class,1호선,종로3가,18102,17077,35179
<class,1호선,종각,13776,12412,26188
<class,1호선,동묘앞,9368,9560,18928
<class,1호선,서울역,21222,23912,45134
<class,중앙선,지평,39,65,104
<class,중앙선,용문,2039,2413,4452
<class,중앙선,원덕,312,332,644
<class,6호선,석계,6923,6953,13876
<class,중앙선,양평,2229,2505,4734
<class,중앙선,오빈,217,252,469
<class,중앙선,아신,459,577,1036
<class,중앙선,덕소,2983,3017,6000
<class,중앙선,팔당,1465,1453,2918
<class,중앙선,운길산,1296,1181,2477
<class,7호선,광명사거리,9790,9610,19400
<class,중앙선,양수,2070,1852,3922
<class,7호선,중곡,3824,3762,7586
<class,중앙선,용문,3491,3236,6727
<class,중앙선,지평,32,56,88
<class,중앙선,원덕,350,314,664
<class,중앙선,양평,2058,1839,3897
<class,중앙선,오빈,219,233,452
<class,중앙선,아신,517,486,1003
<class,중앙선,국수,502,459,961
<class,중앙선,신원,247,162,409
<class,중앙선,상봉,3523,3359,6882
<class,중앙선,중랑,3002,2887,5889
<class,중앙선,회기,11189,11148,22337
<class,장항선,신창,723,755,1478
<class,장항선,온양온천,2482,2463,4945
<class,장항선,배방,613,661,1274
<class,장항선,아산,1835,1560,3395
<class,장항선,쌍용,849,815,1664
<class,장항선,봉명,394,399,793
<class,일산선,대화,5008,4581,9589
<class,일산선,주엽,3642,3647,7289
<class,일산선,정발산,3980,4129,8109
<class,일산선,마두,2746,2779,5525
<class,일산선,백석,4519,4493,9012
<class,일산선,대곡,877,780,1657
<class,일산선,화정,7492,7775,15267
<class,일산선,원당,4819,4757,9576
<class,일산선,삼송,8448,8270,16718
<class,일산선,원흥,4207,3989,8196
<class,우이신설선,신설동,975,951,1926
<class,우이신설선,보문,714,669,1383
<class,우이신설선,성신여대입구,1657,2010,3667
<class,우이신설선,정릉,2086,1703,3789
<class,우이신설선,북한산보국문,2869,2698,5567
<class,우이신설선,솔샘,2163,2036,4199
<class,우이신설선,삼양사거리,1286,1243,2529
<class,우이신설선,삼양,1025,1061,2086
<class,우이신설선,화계,1671,1568,3239
<class,우이신설선,가오리,1956,1875,3831
<class,중앙선,양원,697,778,1475
<class,중앙선,구리,6291,6676,12967
<class,중앙선,도농,4051,3944,7995
<class,중앙선,양정,421,403,824
<class,중앙선,망우,4072,4217,8289
<class,우이신설선,4.19민주묘지,1736,1449,3185
<class,우이신설선,솔밭공원,1249,1290,2539
<class,우이신설선,북한산우이,3344,3444,6788
<class,안산선,수리산,1696,1724,3420
<class,안산선,오이도,5792,5700,11492
<class,안산선,정왕,4181,4193,8374
<class,안산선,신길온천,881,836,1717
<class,안산선,안산,7427,6904,14331
<class,안산선,초지,1796,1826,3622
<class,안산선,고잔,3380,3289,6669
<class,안산선,중앙,8987,8985,17972
<class,안산선,한대앞,4113,4091,8204
<class,안산선,상록수,7216,7166,14382
<class,안산선,반월,1988,2039,4027
<class,안산선,대야미,2301,2112,4413
<class,안산선,산본,7084,7576,14660
<class,수인선,인천,1208,1689,2897
<class,수인선,신포,992,1017,2009
<class,수인선,숭의,1618,1473,3091
<class,수인선,인하대,2491,2384,4875
<class,수인선,송도,1268,1255,2523
<class,수인선,연수,2539,2437,4976
<class,수인선,원인재,2362,2388,4750
<class,수인선,남동인더스파크,587,515,1102
<class,수인선,호구포,1539,1559,3098
<class,수인선,인천논현,2452,2636,5088
<class,수인선,소래포구,4229,4217,8446
<class,수인선,월곶,1439,1420,2859
<class,수인선,달월,51,53,104
<class,수인선,사리,1912,1739,3651
<class,수인선,야목,143,123,266
<class,수인선,어천,441,508,949
<class,수인선,오목천,1122,1099,2221
<class,수인선,고색,1230,1213,2443
<class,분당선,매교,1087,1140,2227
<class,분당선,수원시청,5465,5700,11165
<class,분당선,매탄권선,1924,1865,3789
<class,분당선,망포,4808,4714,9522
<class,분당선,영통,3672,3746,7418
<class,분당선,청명,1456,1441,2897
<class,분당선,상갈,2308,2333,4641
<class,분당선,기흥,4208,3961,8169
<class,분당선,신갈,1563,1530,3093
<class,분당선,구성,1831,2016,3847
<class,분당선,죽전,6112,7069,13181
<class,분당선,보정,881,835,1716
<class,분당선,이매,2413,2426,4839
<class,분당선,오리,4247,3571,7818
<class,분당선,미금,5529,5730,11259
<class,분당선,정자,5771,6065,11836
<class,분당선,수내,4645,4578,9223
<class,분당선,서현,10600,10823,21423
<class,분당선,야탑,9529,9896,19425
<class,분당선,모란,8690,8837,17527
<class,분당선,태평,6514,6031,12545
<class,분당선,가천대,2537,3087,5624
<class,분당선,선정릉,1564,1634,3198
<class,분당선,강남구청,2366,2705,5071
<class,분당선,압구정로데오,8720,9722,18442
<class,분당선,서울숲,5040,4941,9981
<class,분당선,수원,4522,3763,8285
<class,분당선,복정,1,0,1
<class,분당선,수서,5793,5466,11259
<class,분당선,대모산입구,1398,1350,2748
<class,분당선,개포동,1250,1295,2545
<class,분당선,구룡,499,480,979
<class,분당선,도곡,2024,1963,3987
<class,분당선,한티,7193,6799,13992
<class,분당선,선릉,2070,3081,5151
<class,과천선,범계,11380,11092,22472
<class,과천선,평촌,4574,4496,9070
<class,과천선,인덕원,8355,8378,16733
<class,과천선,정부과천청사,3280,3470,6750
<class,과천선,과천,2606,2365,4971
<class,과천선,대공원,3635,3653,7288
<class,과천선,경마공원,697,713,1410
<class,과천선,선바위,2743,2548,5291
<class,공항철도 1호선,영종,1967,2116,4083
<class,공항철도 1호선,인천공항2터미널,2002,1948,3950
<class,공항철도 1호선,인천공항1터미널,3654,3565,7219
<class,공항철도 1호선,공항화물청사,954,972,1926
<class,공항철도 1호선,운서,4117,4408,8525
<class,공항철도 1호선,청라국제도시,2454,2464,4918
<class,공항철도 1호선,검암,2794,2899,5693
<class,공항철도 1호선,계양,3935,4030,7965
<class,공항철도 1호선,김포공항,9467,4911,14378
<class,공항철도 1호선,마곡나루,1657,1899,3556
<class,공항철도 1호선,디지털미디어시티,2784,2787,5571
<class,공항철도 1호선,홍대입구,6947,6826,13773
<class,공항철도 1호선,공덕,894,1213,2107
<class,공항철도 1호선,서울역,4885,4244,9129
<class,경춘선,춘천,1864,1471,3335
<class,경춘선,남춘천,2141,2192,4333
<class,경춘선,김유정,487,549,1036
<class,경춘선,강촌,902,733,1635
<class,경춘선,백양리,214,175,389
<class,경춘선,굴봉산,271,237,508
<class,경춘선,가평,2664,2447,5111
<class,경춘선,상천,435,321,756
<class,경춘선,청평,1751,1453,3204
<class,경춘선,대성리,677,577,1254
<class,경춘선,마석,2267,2315,4582
<class,경춘선,천마산,979,1010,1989
<class,경춘선,평내호평,2906,2992,5898
<class,경춘선,금곡,796,799,1595
<class,경춘선,사릉,1421,1464,2885
<class,경춘선,퇴계원,1760,1664,3424
<class,경춘선,별내,1601,1537,3138
<class,경춘선,갈매,1136,1038,2174
<class,경춘선,신내,689,727,1416
<class,경인선,도화,1925,1791,3716
<class,경인선,중동,3806,3563,7369
<class,경인선,온수,2763,2548,5311
<class,경인선,도원,1221,1316,2537
<class,경인선,간석,2616,2504,5120
<class,경인선,부개,3665,3524,7189
<class,경인선,소사,4130,3956,8086
<class,경인선,구일,2501,2418,4919
<class,경인선,인천,3909,3145,7054
<class,경인선,동인천,7856,7680,15536
<class,경인선,제물포,4348,4263,8611
<class,경인선,주안,9221,8357,17578
<class,경인선,동암,7650,7756,15406
<class,경인선,백운,3215,3178,6393
<class,경인선,부평,17687,18913,36600
<class,경인선,송내,10349,10144,20493
<class,경인선,부천,17555,17667,35222
<class,경인선,역곡,11140,11127,22267
<class,경인선,오류동,5147,4958,10105
<class,경인선,개봉,9242,9186,18428
<class,경의선,임진강,80,69,149
<class,경의선,문산,3061,3108,6169
<class,경의선,파주,597,507,1104
<class,경의선,월롱,765,901,1666
<class,경의선,금촌,3299,3436,6735
<class,경의선,금릉,2272,2269,4541
<class,경의선,운정,2723,2728,5451
<class,경의선,야당,3406,3304,6710
<class,경의선,탄현,3230,3174,6404
<class,경의선,일산,3594,3560,7154
<class,경의선,풍산,2677,2690,5367
<class,경의선,백마,2628,2578,5206
<class,경의선,곡산,240,241,481
<class,경의선,능곡,1823,1806,3629
<class,경의선,행신,3288,3123,6411
<class,경의선,강매,1207,1135,2342
<class,경의선,화전,589,615,1204
<class,경의선,수색,720,773,1493
<class,경의선,디지털미디어시티,1069,1004,2073
<class,경의선,가좌,2312,2386,4698
<class,경의선,홍대입구,1221,1445,2666
<class,경의선,서강대,998,969,1967
<class,경의선,공덕,1280,1071,2351
<class,경의선,효창공원앞,1071,1250,2321
<class,경의선,신촌,209,199,408
<class,경의선,서울역,796,776,1572
<class,경원선,소요산,4217,3560,7777
<class,경원선,동두천,1117,1457,2574
<class,경원선,보산,936,968,1904
<class,경원선,동두천중앙,1829,1769,3598
<class,경원선,지행,3371,3224,6595
<class,경원선,덕정,2652,2781,5433
<class,경원선,덕계,1275,1248,2523
<class,경원선,양주,3933,3931,7864
<class,경원선,녹양,2207,2111,4318
<class,경원선,가능,3282,3109,6391
<class,경원선,의정부,10919,11342,22261
<class,경원선,회룡,5878,5902,11780
<class,경원선,망월사,3581,3836,7417
<class,경원선,도봉산,7760,5480,13240
<class,경원선,도봉,2867,2684,5551
<class,경원선,방학,4786,4649,9435
<class,경원선,녹천,2020,1729,3749
<class,경원선,월계,3297,2951,6248
<class,경원선,광운대,3360,3456,6816
<class,경원선,석계,3874,4293,8167
<class,경원선,신이문,3754,3520,7274
<class,경원선,외대앞,3412,3410,6822
<class,경원선,청량리,11879,10874,22753
<class,경원선,왕십리,7162,8226,15388
<class,경원선,응봉,875,794,1669
<class,경원선,옥수,27,22,49
<class,경원선,한남,1680,1707,3387
<class,경원선,서빙고,891,847,1738
<class,경원선,이촌,1729,1327,3056
<class,경부선,광명,1588,1254,2842
<class,경부선,서동탄,618,659,1277
<class,경부선,당정,2325,2301,4626
<class,경부선,천안,4657,4612,9269
<class,경부선,두정,3036,3168,6204
<class,경부선,직산,413,480,893
<class,경부선,성환,1910,1989,3899
<class,경부선,평택,8816,9034,17850
<class,경부선,평택지제,1753,1553,3306
<class,경부선,서정리,3410,3964,7374
<class,경부선,송탄,2904,2959,5863
<class,경부선,진위,616,543,1159
<class,경부선,오산,5854,6135,11989
<class,경부선,오산대,1607,1555,3162
<class,경부선,세마,1257,1146,2403
<class,경부선,병점,7311,7714,15025
<class,경부선,세류,1565,1576,3141
<class,경부선,독산,4867,4764,9631
<class,경부선,수원,24475,24526,49001
<class,경부선,화서,2794,2802,5596
<class,경부선,성균관대,5864,6114,11978
<class,경부선,의왕,3461,3375,6836
<class,경부선,군포,2461,2268,4729
<class,경부선,금정,10493,10771,21264
<class,경부선,명학,2673,2558,5231
<class,경부선,안양,10652,10512,21164
<class,경부선,관악,3725,3439,7164
<class,경부선,석수,4168,4021,8189
<class,경부선,금천구청,5012,4899,9911
<class,경부선,가산디지털단지,3601,4875,8476
<class,경부선,구로,7150,7201,14351
<class,경부선,신길,3745,3154,6899
<class,경부선,신도림,1601,1620,3221
<class,경부선,영등포,22853,22668,45521
<class,경부선,대방,4239,4377,8616
<class,경부선,노량진,4532,3845,8377
<class,경부선,용산,23536,21517,45053
<class,경부선,남영,3531,3613,7144
<class,경부선,서울역,3882,816,4698
<class,경강선,여주,1689,1647,3336
<class,경강선,세종대왕릉,255,225,480
<class,경강선,부발,982,1102,2084
<class,경강선,이천,1622,1736,3358
<class,경강선,신둔도예촌,657,645,1302
<class,경강선,곤지암,1255,1381,2636
<class,경강선,초월,1291,1249,2540
<class,경강선,경기광주,2926,2863,5789
<class,경강선,삼동,868,785,1653
<class,경강선,이매,565,406,971
<class,경강선,판교,1942,1826,3768
<class,9호선2~3단계,중앙보훈병원,2621,2474,5095
<class,9호선2~3단계,둔촌오륜,310,324,634
<class,9호선2~3단계,올림픽공원,3247,3294,6541
<class,9호선2~3단계,한성백제,1074,969,2043
<class,9호선2~3단계,송파나루,2371,2695,5066
<class,9호선2~3단계,석촌,3593,3150,6743
<class,9호선2~3단계,석촌고분,2378,2358,4736
<class,9호선2~3단계,삼전,2823,2663,5486
<class,9호선2~3단계,종합운동장,1654,1551,3205
<class,9호선2~3단계,봉은사,6055,6149,12204
<class,9호선2~3단계,삼성중앙,1518,1557,3075
<class,9호선2~3단계,선정릉,2292,2522,4814
<class,9호선2~3단계,언주,2468,2451,4919
<class,9호선,신논현,11591,11460,23051
<class,9호선,사평,1133,1146,2279
<class,9호선,고속터미널,7023,8946,15969
<class,9호선,신반포,1192,1234,2426
<class,9호선,구반포,815,900,1715
<class,9호선,동작,1165,986,2151
<class,9호선,흑석,2884,2974,5858
<class,9호선,노들,2004,1672,3676
<class,9호선,노량진,11417,11897,23314
<class,9호선,샛강,1229,1334,2563
<class,9호선,여의도,6068,5846,11914
<class,9호선,국회의사당,2454,2455,4909
<class,9호선,당산,6589,6481,13070
<class,9호선,선유도,2239,2224,4463
<class,9호선,신목동,1283,1150,2433
<class,9호선,염창,6548,6486,13034
<class,9호선,등촌,4168,4227,8395
<class,9호선,증미,2453,2497,4950
<class,9호선,가양,7767,7572,15339
<class,9호선,양천향교,3248,3269,6517
<class,9호선,마곡나루,4195,4285,8480
<class,9호선,신방화,2688,2617,5305
<class,9호선,공항시장,1440,1576,3016
<class,9호선,김포공항,6179,9483,15662
<class,9호선,개화,957,906,1863
<class,8호선,모란,2017,1837,3854
<class,8호선,수진,2391,2264,4655
<class,8호선,신흥,2220,2367,4587
<class,8호선,단대오거리,4255,4133,8388
<class,8호선,남한산성입구,5512,5020,10532
<class,8호선,산성,2910,2868,5778
<class,8호선,복정,3558,3515,7073
<class,8호선,장지,6835,6934,13769
<class,8호선,문정,3746,3908,7654
<class,8호선,가락시장,2545,3172,5717
<class,8호선,송파,2833,2877,5710
<class,8호선,석촌,3236,3881,7117
<class,8호선,잠실,7448,8617,16065
<class,8호선,몽촌토성,2627,2481,5108
<class,8호선,강동구청,3445,3500,6945
<class,8호선,천호,6781,7878,14659
<class,8호선,암사,7226,6841,14067
<class,7호선,부평구청,2900,2642,5542
<class,7호선,굴포천,3954,4061,8015
<class,7호선,삼산체육관,2034,1984,4018
<class,7호선,상동,5661,5742,11403
<class,7호선,부천시청,5612,5550,11162
<class,7호선,신중동,5335,5328,10663
<class,7호선,춘의,2781,2618,5399
<class,7호선,부천종합운동장,1945,1820,3765
<class,7호선,까치울,3398,3408,6806
<class,7호선,온수,3022,3150,6172
<class,7호선,천왕,3622,3571,7193
<class,7호선,철산,8313,8513,16826
<class,7호선,가산디지털단지,8067,7307,15374
<class,7호선,남구로,5339,5264,10603
<class,7호선,대림,5190,4944,10134
<class,7호선,신풍,4720,4425,9145
<class,7호선,보라매,3152,3169,6321
<class,7호선,신대방삼거리,6237,5944,12181
<class,7호선,장승배기,4019,4008,8027
<class,7호선,상도,4043,3880,7923
<class,7호선,숭실대입구,4356,4572,8928
<class,7호선,남성,4258,4130,8388
<class,7호선,이수,6564,6114,12678
<class,7호선,내방,4030,4226,8256
<class,7호선,고속터미널,8374,5572,13946
<class,7호선,반포,2331,2202,4533
<class,7호선,논현,5039,5432,10471
<class,7호선,학동,4023,4126,8149
<class,7호선,강남구청,4175,4561,8736
<class,7호선,청담,4923,5064,9987
<class,7호선,뚝섬유원지,6617,5838,12455
<class,7호선,건대입구,6153,6240,12393
<class,7호선,어린이대공원,5199,5180,10379
<class,7호선,군자,6019,4911,10930
<class,7호선,용마산,2605,2916,5521
<class,7호선,사가정,7545,7307,14852
<class,7호선,면목,6487,6378,12865
<class,7호선,상봉,7639,7285,14924
<class,7호선,중화,4646,4464,9110
<class,7호선,먹골,4412,4261,8673
<class,7호선,태릉입구,3858,3632,7490
<class,7호선,공릉,5256,5241,10497
<class,7호선,하계,7110,6645,13755
<class,7호선,중계,5348,5047,10395
<class,7호선,노원,8753,8888,17641
<class,7호선,마들,4722,4537,9259
<class,7호선,수락산,7129,7381,14510
<class,7호선,도봉산,4584,6748,11332
<class,7호선,장암,1195,983,2178
<class,6호선,봉화산,3192,3082,6274
<class,6호선,화랑대,3840,3327,7167
<class,6호선,태릉입구,2409,2592,5001
<class,6호선,석계,5247,5198,10445
<class,6호선,돌곶이,4118,3858,7976
<class,6호선,상월곡,2498,2277,4775
<class,6호선,월곡,4288,4219,8507
<class,6호선,고려대,3126,2973,6099
<class,6호선,안암,3276,3437,6713
<class,6호선,보문,2944,2717,5661
<class,6호선,창신,1391,1117,2508
<class,6호선,동묘앞,5084,4656,9740
<class,6호선,신당,3435,3143,6578
<class,6호선,청구,1317,1254,2571
<class,6호선,약수,1335,1315,2650
<class,6호선,버티고개,792,876,1668
<class,6호선,한강진,3955,4695,8650
<class,6호선,이태원,6454,6484,12938
<class,6호선,녹사평,3013,3055,6068
<class,6호선,삼각지,2921,2250,5171
<class,6호선,효창공원앞,2729,2398,5127
<class,6호선,공덕,5333,4913,10246
<class,6호선,대흥,3096,3039,6135
<class,6호선,광흥창,3010,2854,5864
<class,6호선,상수,4307,5188,9495
<class,6호선,합정,7205,6619,13824
<class,6호선,망원,7623,8532,16155
<class,6호선,마포구청,5692,5035,10727
<class,6호선,월드컵경기장,3324,3403,6727
<class,6호선,디지털미디어시티,3968,4120,8088
<class,6호선,증산,4553,4489,9042
<class,6호선,새절,5240,4944,10184
<class,6호선,구산,3107,2361,5468
<class,6호선,독바위,1358,1621,2979
<class,6호선,불광,2347,2266,4613
<class,6호선,역촌,1636,1886,3522
<class,6호선,응암,7623,7518,15141
<class,5호선,하남검단산,3599,3710,7309
<class,5호선,하남시청,2729,2604,5333
<class,5호선,하남풍산,1585,1654,3239
<class,5호선,미사,6715,6756,13471
<class,5호선,강일,1425,1333,2758
<class,5호선,마천,2606,2882,5488
<class,5호선,거여,3122,3058,6180
<class,5호선,개롱,2282,2528,4810
<class,5호선,오금,1158,1121,2279
<class,5호선,방이,2995,2849,5844
<class,5호선,올림픽공원,1765,1509,3274
<class,5호선,둔촌동,3493,3460,6953
<class,5호선,상일동,5392,5225,10617
<class,5호선,고덕,3534,3550,7084
<class,5호선,명일,3280,3282,6562
<class,5호선,굽은다리,4238,4007,8245
<class,5호선,길동,3402,3528,6930
<class,5호선,강동,6717,6613,13330
<class,5호선,천호,9781,9347,19128
<class,5호선,광나루,5859,5606,11465
<class,5호선,아차산,8249,7984,16233
<class,5호선,군자,4736,5214,9950
<class,5호선,장한평,5890,5811,11701
<class,5호선,답십리,5663,5210,10873
<class,5호선,마장,2291,2129,4420
<class,5호선,왕십리,1856,2241,4097
<class,5호선,행당,3212,2732,5944
<class,5호선,신금호,2353,2500,4853
<class,5호선,청구,1403,1272,2675
<class,5호선,동대문역사문화공원,538,682,1220
<class,5호선,을지로4가,1231,1330,2561
<class,5호선,종로3가,6526,6919,13445
<class,5호선,광화문,6248,6682,12930
<class,5호선,서대문,4485,4351,8836
<class,5호선,충정로,1133,1053,2186
<class,5호선,애오개,1963,1991,3954
<class,5호선,공덕,3371,3481,6852
<class,5호선,마포,3743,3691,7434
<class,5호선,여의나루,7919,8199,16118
<class,5호선,여의도,5510,5910,11420
<class,5호선,신길,1370,1421,2791
<class,5호선,영등포시장,3219,3335,6554
<class,5호선,영등포구청,1103,1033,2136
<class,5호선,양평,2053,2039,4092
<class,5호선,오목교,9048,9674,18722
<class,5호선,목동,5912,5985,11897
<class,5호선,신정,5115,4528,9643
<class,5호선,까치산,12461,12264,24725
<class,5호선,화곡,11181,10614,21795
<class,5호선,우장산,5314,5296,10610
<class,5호선,발산,6574,7084,13658
<class,5호선,마곡,2728,2806,5534
<class,5호선,송정,2957,2997,5954
<class,5호선,김포공항,5997,5543,11540
<class,5호선,개화산,2338,2381,4719
<class,5호선,방화,2986,2956,5942
<class,4호선,쌍문,12439,11564,24003
<class,4호선,창동,11640,12322,23962
<class,4호선,노원,9247,10304,19551
<class,4호선,상계,8171,7674,15845
<class,4호선,당고개,6561,6460,13021
<class,4호선,남태령,504,444,948
<class,4호선,사당,10750,9781,20531
<class,4호선,총신대입구,7997,8730,16727
<class,4호선,동작,1425,1498,2923
<class,4호선,이촌,3623,4194,7817
<class,4호선,신용산,6037,6239,12276
<class,4호선,삼각지,1634,2107,3741
<class,4호선,숙대입구,5222,4947,10169
<class,4호선,서울역,3125,6071,9196
<class,4호선,회현,6703,7022,13725
<class,4호선,명동,7795,8134,15929
<class,4호선,충무로,6027,6066,12093
<class,4호선,동대문역사문화공원,6764,6075,12839
<class,4호선,동대문,5254,5288,10542
<class,4호선,혜화,15991,16955,32946
<class,4호선,한성대입구,6297,6216,12513
<class,4호선,성신여대입구,9705,9316,19021
<class,4호선,길음,7580,7320,14900
<class,4호선,미아사거리,12582,12150,24732
<class,4호선,미아,6283,5915,12198
<class,4호선,수유,16148,15394,31542
<class,3호선,오금,1851,1837,3688
<class,3호선,경찰병원,2115,2130,4245
<class,3호선,가락시장,2832,3065,5897
<class,3호선,수서,7346,7006,14352
<class,3호선,일원,2558,2702,5260
<class,3호선,대청,3213,2998,6211
<class,3호선,학여울,620,648,1268
<class,3호선,대치,4770,4134,8904
<class,3호선,도곡,1462,1455,2917
<class,3호선,매봉,3113,3187,6300
<class,3호선,양재,9367,10547,19914
<class,3호선,남부터미널,10434,10458,20892
<class,3호선,교대,3121,1907,5028
<class,3호선,고속터미널,26967,25089,52056
<class,3호선,잠원,1693,1679,3372
<class,3호선,신사,9963,10417,20380
<class,3호선,압구정,10151,10767,20918
<class,3호선,옥수,4136,4323,8459
<class,3호선,금호,3280,3178,6458
<class,3호선,약수,5038,4720,9758
<class,3호선,동대입구,3952,4393,8345
<class,3호선,을지로3가,2248,2332,4580
<class,3호선,종로3가,2942,4342,7284
<class,3호선,안국,7769,8528,16297
<class,3호선,경복궁,7181,8038,15219
<class,3호선,독립문,3695,4056,7751
<class,3호선,무악재,1545,1565,3110
<class,3호선,홍제,7192,6830,14022
<class,3호선,녹번,5559,5086,10645
<class,3호선,불광,7706,8931,16637
<class,3호선,연신내,17805,16663,34468
<class,3호선,구파발,9685,10059,19744
<class,3호선,지축,1670,1613,3283
<class,2호선,용두,973,959,1932
<class,2호선,신정네거리,4016,4036,8052
<class,2호선,양천구청,2388,2527,4915
<class,2호선,도림천,343,365,708
<class,2호선,신설동,2176,2298,4474
<class,2호선,신답,591,629,1220
<class,2호선,용답,1406,1279,2685
<class,2호선,충정로,2720,2827,5547
<class,2호선,아현,4053,3987,8040
<class,2호선,이대,4901,5288,10189
<class,2호선,신촌,15638,15626,31264
<class,2호선,홍대입구,33907,34520,68427
<class,2호선,합정,14978,15853,30831
<class,2호선,당산,6484,7149,13633
<class,2호선,영등포구청,5841,5950,11791
<class,2호선,문래,5968,6483,12451
<class,2호선,신도림,20688,20594,41282
<class,2호선,대림,11066,11270,22336
<class,2호선,구로디지털단지,18045,17441,35486
<class,2호선,신대방,12333,11955,24288
<class,2호선,신림,29527,29143,58670
<class,2호선,봉천,9599,9043,18642
<class,2호선,서울대입구,21450,22061,43511
<class,2호선,낙성대,12097,11817,23914
<class,2호선,사당,15285,16564,31849
<class,2호선,방배,5006,5334,10340
<class,2호선,서초,6061,5439,11500
<class,2호선,교대,7706,8619,16325
<class,2호선,강남,25274,24398,49672
<class,2호선,역삼,7444,8188,15632
<class,2호선,선릉,9603,8411,18014
<class,2호선,삼성,15526,15199,30725
<class,2호선,종합운동장,2651,2776,5427
<class,2호선,잠실새내,8316,8688,17004
<class,2호선,잠실,34759,33065,67824
<class,2호선,잠실나루,3964,4031,7995
<class,2호선,강변,15479,15009,30488
<class,2호선,구의,8908,8915,17823
<class,2호선,건대입구,19118,20738,39856
<class,2호선,성수,9892,11283,21175
<class,2호선,뚝섬,7572,7956,15528
<class,2호선,한양대,1761,1738,3499
<class,2호선,왕십리,6771,6007,12778
<class,2호선,상왕십리,5297,5211,10508
<class,2호선,신당,6299,6767,13066
<class,2호선,동대문역사문화공원,5652,6505,12157
<class,2호선,을지로4가,2643,2442,5085
<class,2호선,을지로3가,5338,5252,10590
<class,2호선,을지로입구,12391,11801,24192
<class,2호선,시청,4295,3432,7727
<class,1호선,청량리,10588,10740,21328
<class,1호선,제기동,7666,7930,15596
<class,1호선,신설동,5652,5544,11196
<class,1호선,동대문,7044,7086,14130
<class,1호선,종로5가,7415,7130,14545
<class,1호선,종로3가,12730,12000,24730
<class,1호선,종각,9730,8618,18348
<class,1호선,시청,4851,4874,9725
<class,1호선,동묘앞,10245,10256,20501
<class,1호선,서울역,18677,16682,35359
<class,중앙선,도심,1060,972,2032
<class,일산선,대화,6008,5547,11555
<class,일산선,주엽,4670,4686,9356
<class,일산선,정발산,4574,4698,9272
<class,일산선,마두,3733,3720,7453
<class,일산선,백석,5352,5510,10862
<class,일산선,대곡,908,763,1671
<class,일산선,화정,8953,9426,18379
<class,중앙선,원덕,267,285,552
<class,일산선,원당,5703,5574,11277
<class,일산선,삼송,9928,9677,19605
<class,일산선,원흥,5145,4872,10017
<class,우이신설선,신설동,1012,930,1942
<class,우이신설선,보문,866,860,1726
<class,우이신설선,성신여대입구,2004,2303,4307
<class,우이신설선,정릉,2550,2198,4748
<class,우이신설선,북한산보국문,3301,2968,6269
<class,우이신설선,솔샘,2720,2500,5220
<class,우이신설선,삼양사거리,1437,1364,2801
<class,우이신설선,삼양,1179,1241,2420
<class,우이신설선,화계,1847,1786,3633
<class,우이신설선,가오리,2287,2276,4563
<class,우이신설선,4.19민주묘지,1654,1471,3125
<class,우이신설선,솔밭공원,1360,1341,2701
<class,우이신설선,북한산우이,1850,1940,3790
<class,안산선,수리산,2071,1716,3787
<class,안산선,오이도,4973,5084,10057
<class,안산선,정왕,4452,4667,9119
<class,안산선,신길온천,986,932,1918
<class,안산선,안산,6684,6926,13610
<class,안산선,초지,2243,2217,4460
<class,안산선,고잔,4110,3995,8105
<class,안산선,중앙,10250,10690,20940
<class,안산선,한대앞,4954,4911,9865
<class,안산선,상록수,8873,8939,17812
<class,안산선,반월,2389,2309,4698
<class,안산선,대야미,2684,2449,5133
<class,안산선,산본,8640,9339,17979
<class,수인선,인천,776,1169,1945
<class,수인선,신포,958,972,1930
<class,수인선,숭의,1963,1750,3713
<class,수인선,인하대,2806,2645,5451
<class,수인선,송도,1353,1289,2642
<class,수인선,연수,2658,2785,5443
<class,수인선,원인재,2562,2705,5267
<class,수인선,남동인더스파크,903,819,1722
<class,수인선,호구포,1911,1920,3831
<class,수인선,인천논현,3230,3340,6570
<class,수인선,소래포구,3073,3244,6317
<class,수인선,월곶,1492,1546,3038
<class,수인선,달월,47,31,78
<class,수인선,사리,2319,2129,4448
<class,수인선,야목,145,115,260
<class,수인선,어천,479,447,926
<class,수인선,오목천,1388,1243,2631
<class,수인선,고색,1673,1614,3287
<class,분당선,매교,1476,1442,2918
<class,분당선,수원시청,7239,7669,14908
<class,분당선,매탄권선,2539,2417,4956
<class,분당선,망포,6619,6138,12757
<class,분당선,영통,4637,4669,9306
<class,분당선,청명,1980,1806,3786
<class,분당선,상갈,2892,2819,5711
<class,분당선,기흥,4958,4800,9758
<class,분당선,신갈,1964,2057,4021
<class,분당선,구성,2323,2548,4871
<class,분당선,죽전,7370,8241,15611
<class,분당선,보정,1190,1050,2240
<class,분당선,이매,2990,2959,5949
<class,분당선,오리,5794,4852,10646
<class,분당선,미금,8175,8440,16615
<class,분당선,정자,8311,8290,16601
<class,분당선,수내,6816,6408,13224
<class,분당선,서현,13727,13802,27529
<class,분당선,야탑,12109,12906,25015
<class,분당선,모란,11821,11999,23820
<class,분당선,태평,8239,7731,15970
<class,분당선,가천대,3570,4050,7620
<class,분당선,선정릉,2445,2514,4959
<class,분당선,강남구청,4002,4677,8679
<class,분당선,압구정로데오,13426,14644,28070
<class,분당선,서울숲,4868,4792,9660
<class,분당선,수원,5121,4291,9412
<class,분당선,수서,6986,7569,14555
<class,분당선,대모산입구,1849,1728,3577
<class,분당선,개포동,1999,1936,3935
<class,분당선,구룡,945,899,1844
<class,분당선,도곡,3307,2996,6303
<class,분당선,한티,9865,9296,19161
<class,분당선,선릉,3897,5787,9684
<class,과천선,범계,13955,13637,27592
<class,과천선,평촌,6651,6415,13066
<class,과천선,인덕원,10448,10462,20910
<class,과천선,정부과천청사,3999,4046,8045
<class,과천선,과천,3034,2840,5874
<class,과천선,대공원,1763,1879,3642
<class,과천선,경마공원,771,773,1544
<class,과천선,선바위,3537,3278,6815
<class,공항철도 1호선,영종,2004,2018,4022
<class,공항철도 1호선,인천공항2터미널,1844,1763,3607
<class,공항철도 1호선,인천공항1터미널,2852,2827,5679
<class,공항철도 1호선,공항화물청사,1157,1174,2331
<class,공항철도 1호선,운서,4221,4326,8547
<class,공항철도 1호선,청라국제도시,2939,2799,5738
<class,공항철도 1호선,검암,3050,3152,6202
<class,공항철도 1호선,계양,4609,4372,8981
<class,공항철도 1호선,김포공항,8529,4315,12844
<class,공항철도 1호선,마곡나루,2024,2158,4182
<class,공항철도 1호선,디지털미디어시티,3509,3291,6800
<class,공항철도 1호선,홍대입구,7282,7182,14464
<class,공항철도 1호선,공덕,994,1422,2416
<class,공항철도 1호선,서울역,5324,6777,12101
<class,경춘선,춘천,1037,970,2007
<class,경춘선,남춘천,1796,1973,3769
<class,경춘선,김유정,247,256,503
<class,경춘선,강촌,483,548,1031
<class,경춘선,백양리,104,90,194
<class,경춘선,굴봉산,125,138,263
<class,경춘선,가평,1270,1509,2779
<class,경춘선,상천,152,176,328
<class,경춘선,청평,1014,1215,2229
<class,경춘선,대성리,339,370,709
<class,경춘선,마석,2207,2170,4377
<class,경춘선,천마산,939,866,1805
<class,경춘선,평내호평,3075,3041,6116
<class,경춘선,금곡,839,787,1626
<class,경춘선,사릉,1567,1614,3181
<class,경춘선,퇴계원,1827,1777,3604
<class,경춘선,별내,1718,1621,3339
<class,경춘선,갈매,1409,1231,2640
<class,경춘선,신내,809,748,1557
<class,경인선,도화,2277,2107,4384
<class,경인선,중동,4757,4712,9469
<class,경인선,온수,3513,3291,6804
<class,경인선,도원,1305,1390,2695
<class,경인선,간석,3184,3088,6272
<class,경인선,부개,4661,4418,9079
<class,경인선,소사,4972,4967,9939
<class,경인선,구일,3195,3090,6285
<class,경인선,인천,2218,1711,3929
<class,경인선,동인천,7772,7568,15340
<class,경인선,제물포,5002,4936,9938
<class,경인선,주안,11200,10123,21323
<class,경인선,동암,8800,9128,17928
<class,경인선,백운,3849,3887,7736
<class,경인선,부평,20030,21906,41936
<class,경인선,송내,12705,12608,25313
<class,경인선,부천,20533,21222,41755
<class,경인선,역곡,14273,14371,28644
<class,경인선,오류동,6687,6135,12822
<class,경인선,개봉,11814,11801,23615
<class,경의선,임진강,27,20,47
<class,경의선,문산,3080,3077,6157
<class,경의선,파주,597,472,1069
<class,경의선,월롱,1051,995,2046
<class,경의선,금촌,3738,3781,7519
<class,경의선,금릉,2550,2469,5019
<class,경의선,운정,3189,3105,6294
<class,경의선,야당,3711,3751,7462
<class,경의선,탄현,3758,3770,7528
<class,경의선,일산,4335,4239,8574
<class,경의선,풍산,3094,2965,6059
<class,경의선,백마,3048,2881,5929
<class,경의선,곡산,272,281,553
<class,경의선,능곡,1983,1874,3857
<class,경의선,행신,3605,3680,7285
<class,경의선,강매,1382,1317,2699
<class,경의선,화전,660,628,1288
<class,경의선,수색,1046,1004,2050
<class,경의선,디지털미디어시티,1354,1139,2493
<class,경의선,가좌,2809,2681,5490
<class,경의선,홍대입구,1230,1401,2631
<class,경의선,서강대,1288,1160,2448
<class,경의선,공덕,1725,1356,3081
<class,경의선,효창공원앞,1270,1394,2664
<class,경의선,신촌,296,281,577
<class,경의선,서울역,872,957,1829
<class,경원선,소요산,2042,1799,3841
<class,경원선,동두천,1214,1549,2763
<class,경원선,보산,974,1013,1987
<class,경원선,동두천중앙,1815,1877,3692
<class,경원선,지행,3858,3807,7665
<class,경원선,덕정,2973,2791,5764
<class,경원선,덕계,1767,1660,3427
<class,경원선,양주,4540,4249,8789
<class,경원선,녹양,2530,2479,5009
<class,경원선,가능,3860,3754,7614
<class,경원선,의정부,12178,12883,25061
<class,경원선,회룡,6810,6828,13638
<class,경원선,망월사,4172,4244,8416
<class,경원선,도봉산,4821,3237,8058
<class,경원선,도봉,3425,3191,6616
<class,경원선,방학,5645,5456,11101
<class,경원선,녹천,2447,2142,4589
<class,경원선,월계,3368,3146,6514
<class,경원선,광운대,4068,4033,8101
<class,경원선,석계,4713,5010,9723
<class,경원선,신이문,4666,4330,8996
<class,경원선,외대앞,4215,4079,8294
<class,경원선,청량리,10882,12408,23290
<class,경원선,왕십리,8817,10253,19070
<class,경원선,응봉,921,768,1689
<class,경원선,옥수,31,43,74
<class,경원선,한남,2101,1991,4092
<class,경원선,서빙고,915,810,1725
<class,경원선,이촌,2059,1579,3638
<class,경부선,광명,1710,1587,3297
<class,경부선,서동탄,676,661,1337
<class,경부선,당정,2852,2776,5628
<class,경부선,천안,4390,4660,9050
<class,경부선,두정,3353,3489,6842
<class,경부선,직산,429,493,922
<class,경부선,성환,2113,1957,4070
<class,경부선,평택,9286,9071,18357
<class,경부선,평택지제,2244,2006,4250
<class,경부선,서정리,4508,3795,8303
<class,경부선,송탄,3390,3085,6475
<class,경부선,진위,779,683,1462
<class,경부선,오산,7060,6483,13543
<class,경부선,오산대,1877,1773,3650
<class,경부선,세마,1506,1409,2915
<class,경부선,병점,8663,8626,17289
<class,경부선,세류,1735,1737,3472
<class,경부선,독산,6477,6345,12822
<class,경부선,수원,25161,26933,52094
<class,경부선,화서,3516,3510,7026
<class,경부선,성균관대,7052,7182,14234
<class,경부선,의왕,4150,4091,8241
<class,경부선,군포,3120,2930,6050
<class,경부선,금정,13110,13124,26234
<class,경부선,명학,3641,3546,7187
<class,경부선,안양,12331,12535,24866
<class,경부선,관악,3648,3661,7309
<class,경부선,석수,4717,4384,9101
<class,경부선,금천구청,5594,5826,11420
<class,경부선,가산디지털단지,4351,6011,10362
<class,경부선,구로,9378,9548,18926
<class,경부선,신길,4600,3707,8307
<class,경부선,신도림,1838,1929,3767
<class,경부선,영등포,26589,27876,54465
<class,경부선,대방,5417,5518,10935
<class,경부선,노량진,5646,4997,10643
<class,경부선,용산,22748,24534,47282
<class,경부선,남영,4127,4201,8328
<class,경부선,서울역,4000,1252,5252
<class,경강선,여주,1387,1544,2931
<class,경강선,세종대왕릉,193,239,432
<class,경강선,부발,1274,1179,2453
<class,경강선,이천,1866,1974,3840
<class,경강선,신둔도예촌,795,791,1586
<class,경강선,곤지암,1394,1378,2772
<class,경강선,초월,1507,1488,2995
<class,경강선,경기광주,3576,3466,7042
<class,경강선,삼동,1081,968,2049
<class,경강선,이매,593,445,1038
<class,경강선,판교,2166,2090,4256
<class,9호선2~3단계,중앙보훈병원,3311,3095,6406
<class,9호선2~3단계,올림픽공원,2665,2705,5370
<class,9호선2~3단계,한성백제,1374,1190,2564
<class,9호선2~3단계,송파나루,3140,3403,6543
<class,9호선2~3단계,석촌,4674,4022,8696
<class,9호선2~3단계,석촌고분,3200,3172,6372
<class,9호선2~3단계,삼전,3868,3713,7581
<class,9호선2~3단계,종합운동장,2525,2168,4693
<class,9호선2~3단계,봉은사,7270,7601,14871
<class,9호선2~3단계,삼성중앙,2267,2256,4523
<class,9호선2~3단계,선정릉,3370,3652,7022
<class,9호선2~3단계,언주,4350,4284,8634
<class,9호선,신논현,18305,18110,36415
<class,9호선,사평,2051,1881,3932
<class,9호선,고속터미널,7899,11395,19294
<class,9호선,신반포,1761,1672,3433
<class,9호선,구반포,1234,1310,2544
<class,9호선,동작,976,785,1761
<class,9호선,흑석,3967,3840,7807
<class,9호선,노들,2391,2056,4447
<class,9호선,노량진,16114,15464,31578
<class,9호선,샛강,1743,1808,3551
<class,9호선,여의도,8178,7589,15767
<class,9호선,국회의사당,2585,2654,5239
<class,9호선,당산,9203,8780,17983
<class,9호선,선유도,2778,2709,5487
<class,9호선,신목동,1613,1389,3002
<class,9호선,염창,8321,7872,16193
<class,9호선,등촌,5700,5464,11164
<class,9호선,증미,3135,3223,6358
<class,9호선,가양,9982,9606,19588
<class,9호선,양천향교,4467,4375,8842
<class,9호선,마곡나루,5412,5389,10801
<class,9호선,신방화,3703,3556,7259
<class,9호선,공항시장,1805,1856,3661
<class,9호선,김포공항,5499,8362,13861
<class,9호선,개화,1038,893,1931
<class,8호선,모란,2726,2246,4972
<class,8호선,수진,3334,2926,6260
<class,8호선,신흥,2827,3097,5924
<class,8호선,단대오거리,5509,5311,10820
<class,8호선,남한산성입구,6628,6058,12686
<class,8호선,산성,3220,3194,6414
<class,8호선,복정,5202,4509,9711
<class,8호선,장지,9110,8458,17568
<class,8호선,가락시장,4106,4017,8123
<class,8호선,송파,3791,3782,7573
<class,8호선,석촌,4567,5365,9932
<class,8호선,잠실,8895,10278,19173
<class,8호선,몽촌토성,3184,3073,6257
<class,8호선,강동구청,4545,4637,9182
<class,8호선,천호,8755,10171,18926
<class,8호선,암사,9526,8844,18370
<class,7호선,부평구청,3720,3264,6984
<class,7호선,굴포천,4862,5155,10017
<class,7호선,삼산체육관,2588,2430,5018
<class,7호선,부천시청,7420,7300,14720
<class,7호선,신중동,7184,7112,14296
<class,7호선,춘의,4185,4007,8192
<class,7호선,부천종합운동장,2330,1994,4324
<class,7호선,까치울,3973,4088,8061
<class,7호선,온수,4391,4325,8716
<class,7호선,천왕,5169,4896,10065
<class,7호선,광명사거리,12719,12727,25446
<class,7호선,철산,10892,11053,21945
<class,7호선,가산디지털단지,10373,9467,19840
<class,7호선,남구로,6694,6993,13687
<class,7호선,대림,5334,5601,10935
<class,7호선,신풍,6304,5966,12270
<class,7호선,보라매,4847,4559,9406
<class,7호선,신대방삼거리,8792,8172,16964
<class,7호선,장승배기,5151,4961,10112
<class,7호선,상도,5392,5106,10498
<class,7호선,숭실대입구,6055,6111,12166
<class,7호선,남성,5933,5515,11448
<class,7호선,이수,8675,8284,16959
<class,7호선,내방,6041,5970,12011
<class,7호선,고속터미널,9261,7424,16685
<class,7호선,반포,3363,3177,6540
<class,7호선,논현,8522,9104,17626
<class,7호선,학동,7334,7722,15056
<class,7호선,강남구청,7266,7930,15196
<class,7호선,청담,8441,8748,17189
<class,7호선,뚝섬유원지,4517,4203,8720
<class,7호선,건대입구,7577,7666,15243
<class,7호선,어린이대공원,6049,5537,11586
<class,7호선,군자,7992,6215,14207
<class,7호선,중곡,5125,4976,10101
<class,7호선,용마산,3199,3096,6295
<class,9호선2~3단계,둔촌오륜,441,455,896
<class,7호선,사가정,9271,9104,18375
<class,7호선,면목,8512,8519,17031
<class,7호선,상봉,9953,9346,19299
<class,7호선,중화,5836,5760,11596
<class,7호선,먹골,5883,5753,11636
<class,7호선,태릉입구,4844,4528,9372
<class,7호선,공릉,6369,6251,12620
<class,7호선,하계,9125,8476,17601
<class,7호선,중계,7139,6495,13634
<class,7호선,노원,11831,11847,23678
<class,7호선,마들,7664,7207,14871
<class,7호선,수락산,7407,7355,14762
<class,7호선,도봉산,4320,5683,10003
<class,7호선,장암,1059,653,1712
<class,6호선,봉화산,3875,3843,7718
<class,6호선,화랑대,4936,4211,9147
<class,6호선,태릉입구,3002,3202,6204
<class,6호선,석계,6561,6580,13141
<class,6호선,돌곶이,4500,4279,8779
<class,6호선,상월곡,3165,2775,5940
<class,6호선,월곡,5523,5522,11045
<class,6호선,고려대,3785,3576,7361
<class,6호선,안암,4369,4295,8664
<class,6호선,보문,3925,3528,7453
<class,6호선,창신,1643,1328,2971
<class,6호선,동묘앞,5197,4657,9854
<class,6호선,신당,5420,4446,9866
<class,6호선,청구,1832,1926,3758
<class,6호선,약수,1878,1804,3682
<class,6호선,버티고개,1022,1172,2194
<class,6호선,한강진,5242,6088,11330
<class,6호선,이태원,6420,6831,13251
<class,6호선,녹사평,2831,2925,5756
<class,6호선,삼각지,3296,2597,5893
<class,6호선,효창공원앞,3245,2820,6065
<class,6호선,공덕,7081,6711,13792
<class,6호선,대흥,4027,4165,8192
<class,6호선,광흥창,3904,3519,7423
<class,6호선,상수,5249,6067,11316
<class,6호선,합정,8338,7839,16177
<class,6호선,망원,8802,9504,18306
<class,6호선,마포구청,7217,6360,13577
<class,6호선,월드컵경기장,2806,2935,5741
<class,6호선,디지털미디어시티,5122,5388,10510
<class,6호선,증산,5494,5469,10963
<class,6호선,새절,7016,6417,13433
<class,6호선,구산,4044,3189,7233
<class,6호선,독바위,1514,1538,3052
<class,6호선,불광,2628,2439,5067
<class,6호선,역촌,2262,2437,4699
<class,6호선,응암,9313,9264,18577
<class,5호선,하남검단산,3041,3013,6054
<class,5호선,하남시청,3285,3230,6515
<class,5호선,하남풍산,1894,1965,3859
<class,5호선,미사,8272,8322,16594
<class,5호선,강일,1634,1587,3221
<class,5호선,마천,3204,3295,6499
<class,5호선,거여,4333,4121,8454
<class,5호선,개롱,3419,3604,7023
<class,5호선,오금,1587,1472,3059
<class,5호선,방이,4094,3935,8029
<class,5호선,올림픽공원,2079,1728,3807
<class,5호선,둔촌동,4737,4751,9488
<class,5호선,상일동,7206,6805,14011
<class,5호선,고덕,5347,5057,10404
<class,5호선,명일,4360,4450,8810
<class,5호선,굽은다리,5384,5104,10488
<class,5호선,길동,4685,4787,9472
<class,5호선,강동,9392,9064,18456
<class,5호선,천호,11788,11269,23057
<class,5호선,광나루,6537,6124,12661
<class,5호선,아차산,8171,7966,16137
<class,5호선,군자,6125,6802,12927
<class,5호선,장한평,8397,8251,16648
<class,5호선,답십리,7643,7006,14649
<class,5호선,마장,2884,2755,5639
<class,5호선,왕십리,2596,3054,5650
<class,5호선,행당,4273,3714,7987
<class,5호선,신금호,3105,3112,6217
<class,5호선,청구,1958,1720,3678
<class,5호선,동대문역사문화공원,791,921,1712
<class,5호선,을지로4가,2300,2464,4764
<class,5호선,종로3가,7354,7546,14900
<class,5호선,광화문,9301,9754,19055
<class,5호선,서대문,5229,4926,10155
<class,5호선,충정로,1589,1424,3013
<class,5호선,애오개,2744,2732,5476
<class,5호선,공덕,4986,5345,10331
<class,5호선,마포,5393,5473,10866
<class,5호선,여의나루,4236,5164,9400
<class,5호선,여의도,8268,8457,16725
<class,5호선,신길,1916,2031,3947
<class,5호선,영등포시장,4895,5038,9933
<class,5호선,영등포구청,1428,1352,2780
<class,5호선,양평,2808,2704,5512
<class,5호선,오목교,11881,12092,23973
<class,5호선,목동,8387,8622,17009
<class,5호선,신정,6598,5621,12219
<class,5호선,까치산,15576,15311,30887
<class,5호선,화곡,14647,13744,28391
<class,5호선,우장산,7200,7221,14421
<class,5호선,발산,9102,9721,18823
<class,5호선,마곡,3901,3937,7838
<class,5호선,송정,3671,3649,7320
<class,중앙선,용문,1463,1634,3097
<class,5호선,김포공항,5136,4968,10104
<class,5호선,개화산,2813,2758,5571
<class,5호선,방화,3473,3339,6812
<class,4호선,쌍문,16172,15038,31210
<class,4호선,창동,14268,15064,29332
<class,4호선,노원,11768,12662,24430
<class,4호선,상계,10372,9861,20233
<class,4호선,당고개,7053,6791,13844
<class,4호선,남태령,632,481,1113
<class,4호선,사당,13661,11549,25210
<class,4호선,총신대입구,10475,11338,21813
<class,4호선,동작,1026,1062,2088
<class,4호선,이촌,4201,4584,8785
<class,4호선,신용산,6814,7595,14409
<class,4호선,삼각지,2255,2713,4968
<class,4호선,숙대입구,6283,6008,12291
<class,4호선,서울역,3704,7816,11520
<class,4호선,회현,11356,11841,23197
<class,4호선,명동,7444,8517,15961
<class,4호선,충무로,8428,8759,17187
<class,4호선,동대문역사문화공원,7824,6726,14550
<class,4호선,동대문,9781,9590,19371
<class,4호선,혜화,18279,18867,37146
<class,4호선,한성대입구,7554,7106,14660
<class,4호선,성신여대입구,12143,11587,23730
<class,4호선,길음,9982,9563,19545
<class,4호선,미아사거리,15947,15397,31344
<class,4호선,미아,7934,7682,15616
<class,4호선,수유,19735,19574,39309
<class,3호선,오금,2657,2549,5206
<class,3호선,경찰병원,2956,2978,5934
<class,3호선,가락시장,4406,4129,8535
<class,3호선,수서,9221,9326,18547
<class,3호선,일원,3524,3572,7096
<class,3호선,대청,4239,3948,8187
<class,3호선,학여울,792,739,1531
<class,3호선,대치,7736,6694,14430
<class,3호선,도곡,2329,2184,4513
<class,3호선,매봉,4399,4351,8750
<class,3호선,양재,14370,15520,29890
<class,3호선,남부터미널,14896,15238,30134
<class,3호선,교대,4980,3051,8031
<class,3호선,고속터미널,31775,32615,64390
<class,3호선,잠원,2360,2302,4662
<class,3호선,신사,16742,17513,34255
<class,3호선,압구정,18686,19383,38069
<class,3호선,옥수,5074,5154,10228
<class,3호선,금호,4331,4025,8356
<class,3호선,약수,6707,6244,12951
<class,3호선,동대입구,4041,4091,8132
<class,3호선,충무로,1,0,1
<class,3호선,을지로3가,3582,3750,7332
<class,3호선,종로3가,4122,5427,9549
<class,3호선,안국,8263,9105,17368
<class,3호선,경복궁,8746,8942,17688
<class,3호선,독립문,3771,3666,7437
<class,3호선,무악재,1976,2103,4079
<class,3호선,홍제,9318,8669,17987
<class,3호선,녹번,7656,6701,14357
<class,3호선,불광,8779,9608,18387
<class,3호선,연신내,21367,20553,41920
<class,3호선,구파발,10993,10776,21769
<class,3호선,지축,2111,2172,4283
<class,2호선,용두,1310,1287,2597
<class,2호선,신정네거리,5639,5624,11263
<class,2호선,양천구청,3701,3663,7364
<class,2호선,도림천,620,600,1220
<class,2호선,신설동,1945,1929,3874
<class,2호선,신답,662,768,1430
<class,2호선,용답,1600,1522,3122
<class,2호선,충정로,3947,4072,8019
<class,2호선,아현,5631,5467,11098
<class,2호선,이대,7366,7494,14860
<class,2호선,신촌,20671,21067,41738
<class,2호선,홍대입구,37771,38827,76598
<class,2호선,합정,18428,19618,38046
<class,2호선,당산,8355,9308,17663
<class,2호선,영등포구청,8885,8866,17751
<class,2호선,문래,8437,8857,17294
<class,2호선,신도림,27039,27012,54051
<class,2호선,대림,13257,14248,27505
<class,2호선,구로디지털단지,24684,24622,49306
<class,2호선,신대방,15071,14907,29978
<class,2호선,신림,37745,36401,74146
<class,2호선,봉천,13053,12123,25176
<class,2호선,서울대입구,28381,27557,55938
<class,2호선,낙성대,15827,14582,30409
<class,2호선,사당,20043,21585,41628
<class,2호선,방배,7056,7600,14656
<class,2호선,서초,7202,6199,13401
<class,2호선,교대,13027,14448,27475
<class,2호선,강남,43842,42706,86548
<class,2호선,역삼,13420,14613,28033
<class,2호선,선릉,17394,15585,32979
<class,2호선,삼성,19489,19764,39253
<class,2호선,종합운동장,3166,3525,6691
<class,2호선,잠실새내,11880,12207,24087
<class,2호선,잠실,41760,40312,82072
<class,2호선,잠실나루,5328,5259,10587
<class,2호선,강변,17489,18374,35863
<class,2호선,구의,11988,11918,23906
<class,2호선,건대입구,22192,23868,46060
<class,2호선,성수,12537,13981,26518
<class,중앙선,양평,1689,1826,3515
<class,8호선,문정,5774,5915,11689
<class,중앙선,오빈,196,197,393
<class,2호선,뚝섬,9445,9620,19065
<class,2호선,한양대,2924,2720,5644
<class,2호선,왕십리,9374,7917,17291
<class,2호선,상왕십리,7406,7115,14521
<class,2호선,신당,7964,8278,16242
<class,2호선,동대문역사문화공원,7224,7642,14866
<class,2호선,을지로4가,4972,4930,9902
<class,2호선,을지로3가,7010,6979,13989
<class,2호선,을지로입구,13721,13910,27631
<class,2호선,시청,5702,5124,10826
<class,1호선,청량리,12280,12676,24956
<class,1호선,제기동,9758,9744,19502
<class,1호선,신설동,6347,6154,12501
<class,1호선,동대문,7404,6675,14079
<class,1호선,종로5가,12683,12676,25359
<class,1호선,종로3가,14823,14197,29020
<class,1호선,종각,11331,10912,22243
<class,1호선,시청,6530,6456,12986
<class,1호선,동묘앞,5209,5302,10511
<class,1호선,서울역,20301,20642,40943
<class,중앙선,아신,319,372,691
<class,7호선,상동,7488,7511,14999
<class,중앙선,국수,385,427,812
<class,중앙선,신원,117,116,233
<class,중앙선,양수,1402,1498,2900
<class,중앙선,운길산,744,688,1432
<class,중앙선,팔당,722,749,1471
<class,중앙선,도심,1156,940,2096
<class,중앙선,덕소,3275,3270,6545
<class,중앙선,양정,413,395,808
<class,중앙선,도농,4695,4564,9259
<class,중앙선,구리,7279,7475,14754
<class,중앙선,양원,893,882,1775
<class,중앙선,망우,4474,4445,8919
<class,중앙선,상봉,3765,3710,7475
<class,중앙선,중랑,3318,3297,6615
<class,중앙선,회기,13437,13071,26508
<class,장항선,신창,807,695,1502
<class,장항선,온양온천,2493,2592,5085
<class,장항선,배방,693,665,1358
<class,장항선,아산,1944,1848,3792
<class,장항선,쌍용,1040,926,1966
<class,장항선,봉명,531,491,1022
<class,중앙선,지평,34,52,86
<class,1호선,시청,5715,5499,11214
<class,1호선,동묘앞,10739,10843,21582
<class,1호선,서울역,18499,17153,35652
<class,분당선,대모산입구,1694,1540,3234
<class,2호선,구의,9327,9433,18760
<class,경원선,창동,1,0,1
<class,중앙선,지평,53,42,95
<class,중앙선,용문,1882,1609,3491
<class,중앙선,원덕,339,255,594
<class,중앙선,양평,1888,1751,3639
<class,2호선,강변,16575,15840,32415
<class,2호선,잠실나루,4227,4355,8582
<class,2호선,잠실,33749,31636,65385
<class,2호선,잠실새내,8589,8978,17567
<class,2호선,종합운동장,2802,2907,5709
<class,2호선,삼성,14407,14022,28429
<class,2호선,선릉,10010,8682,18692
<class,2호선,역삼,7877,8902,16779
<class,2호선,강남,27292,26207,53499
<class,2호선,교대,8405,9349,17754
<class,2호선,서초,6221,5576,11797
<class,2호선,방배,5256,5865,11121
<class,2호선,사당,15900,17362,33262
<class,2호선,낙성대,12414,12821,25235
<class,2호선,서울대입구,22227,22783,45010
<class,2호선,봉천,10079,9764,19843
<class,2호선,신림,29569,29569,59138
<class,2호선,신대방,12660,12445,25105
<class,2호선,구로디지털단지,18618,18333,36951
<class,2호선,대림,11871,11959,23830
<class,2호선,신도림,20900,20875,41775
<class,2호선,문래,6007,6520,12527
<class,2호선,영등포구청,5904,5879,11783
<class,2호선,당산,6939,7489,14428
<class,2호선,합정,15602,16554,32156
<class,2호선,홍대입구,34805,35011,69816
<class,2호선,신촌,16703,16420,33123
<class,2호선,이대,5241,5724,10965
<class,2호선,아현,4346,4167,8513
<class,2호선,충정로,2812,2975,5787
<class,2호선,용답,1347,1367,2714
<class,2호선,신답,603,628,1231
<class,2호선,신설동,2289,2431,4720
<class,2호선,도림천,367,379,746
<class,2호선,양천구청,2663,2661,5324
<class,2호선,신정네거리,3963,4073,8036
<class,2호선,용두,878,896,1774
<class,3호선,지축,1835,1719,3554
<class,3호선,구파발,10135,10256,20391
<class,3호선,연신내,18345,17423,35768
<class,3호선,불광,8079,9208,17287
<class,3호선,녹번,5921,5199,11120
<class,3호선,홍제,7527,7075,14602
<class,3호선,무악재,1633,1644,3277
<class,3호선,독립문,3536,3602,7138
<class,3호선,경복궁,8332,9014,17346
<class,3호선,안국,7697,8594,16291
<class,3호선,종로3가,2989,4141,7130
<class,3호선,을지로3가,2234,2264,4498
<class,3호선,충무로,1,0,1
<class,3호선,동대입구,3698,4102,7800
<class,3호선,약수,5181,5023,10204
<class,3호선,금호,3636,3431,7067
<class,3호선,옥수,4223,4550,8773
<class,3호선,압구정,10777,11166,21943
<class,3호선,신사,10356,10432,20788
<class,3호선,잠원,1814,1735,3549
<class,3호선,고속터미널,28956,26322,55278
<class,3호선,교대,3299,2129,5428
<class,3호선,남부터미널,12081,12397,24478
<class,3호선,양재,10116,11836,21952
<class,3호선,매봉,3260,3309,6569
<class,3호선,도곡,1355,1467,2822
<class,3호선,대치,5215,4480,9695
<class,3호선,학여울,625,613,1238
<class,3호선,대청,3360,3242,6602
<class,3호선,일원,2706,2867,5573
<class,3호선,수서,7998,7587,15585
<class,3호선,가락시장,2913,3172,6085
<class,3호선,경찰병원,2096,2194,4290
<class,3호선,오금,2294,2247,4541
<class,4호선,수유,16630,15796,32426
<class,4호선,미아,6411,6148,12559
<class,4호선,미아사거리,12710,12240,24950
<class,4호선,길음,8029,7853,15882
<class,4호선,성신여대입구,10300,10029,20329
<class,4호선,한성대입구,6569,6605,13174
<class,4호선,혜화,16517,17338,33855
<class,4호선,동대문,5004,5452,10456
<class,4호선,동대문역사문화공원,7028,6893,13921
<class,4호선,충무로,6076,6373,12449
<class,4호선,명동,7393,7645,15038
<class,4호선,회현,6493,6691,13184
<class,4호선,서울역,3038,6023,9061
<class,4호선,숙대입구,5061,4932,9993
<class,4호선,삼각지,1755,2230,3985
<class,4호선,신용산,5967,6026,11993
<class,4호선,이촌,3788,4116,7904
<class,4호선,동작,1351,1337,2688
<class,4호선,총신대입구,8367,9092,17459
<class,4호선,사당,11140,10506,21646
<class,4호선,남태령,584,494,1078
<class,4호선,당고개,7109,6802,13911
<class,4호선,상계,8642,8032,16674
<class,4호선,노원,9521,10124,19645
<class,4호선,창동,11638,12238,23876
<class,4호선,쌍문,12958,11749,24707
<class,5호선,방화,3150,3111,6261
<class,5호선,개화산,2270,2343,4613
<class,5호선,김포공항,5890,5153,11043
<class,5호선,송정,2982,3086,6068
<class,5호선,마곡,2935,3052,5987
<class,5호선,발산,6842,7362,14204
<class,5호선,우장산,5432,5550,10982
<class,5호선,화곡,11319,10779,22098
<class,5호선,까치산,12954,12328,25282
<class,5호선,신정,5175,4637,9812
<class,5호선,목동,6151,6242,12393
<class,5호선,오목교,9164,9386,18550
<class,5호선,양평,2114,2101,4215
<class,5호선,영등포구청,1121,1067,2188
<class,5호선,영등포시장,3468,3532,7000
<class,5호선,신길,1448,1699,3147
<class,5호선,여의도,5569,5867,11436
<class,5호선,여의나루,6996,7330,14326
<class,5호선,마포,3814,3800,7614
<class,5호선,공덕,3408,3521,6929
<class,5호선,애오개,2165,2142,4307
<class,5호선,충정로,1231,1238,2469
<class,5호선,서대문,4106,4217,8323
<class,5호선,광화문,8593,8804,17397
<class,5호선,종로3가,6294,6047,12341
<class,5호선,을지로4가,1177,1261,2438
<class,5호선,동대문역사문화공원,534,715,1249
<class,5호선,청구,1423,1392,2815
<class,5호선,신금호,2393,2637,5030
<class,5호선,행당,3327,2957,6284
<class,5호선,왕십리,1896,2214,4110
<class,5호선,마장,2453,2369,4822
<class,5호선,답십리,5898,5460,11358
<class,5호선,장한평,6103,5999,12102
<class,5호선,군자,4705,5278,9983
<class,5호선,아차산,8050,7849,15899
<class,5호선,광나루,5875,5727,11602
<class,5호선,천호,9850,9112,18962
<class,5호선,강동,6870,6998,13868
<class,5호선,길동,3380,3599,6979
<class,5호선,굽은다리,4020,3742,7762
<class,5호선,명일,3585,3604,7189
<class,5호선,고덕,3476,3366,6842
<class,5호선,상일동,5487,5372,10859
<class,5호선,둔촌동,3678,3784,7462
<class,5호선,올림픽공원,1689,1469,3158
<class,5호선,방이,3101,2995,6096
<class,5호선,오금,1378,1244,2622
<class,5호선,개롱,2449,2749,5198
<class,5호선,거여,3302,3242,6544
<class,5호선,마천,2839,2972,5811
<class,5호선,강일,1456,1386,2842
<class,5호선,미사,6720,6830,13550
<class,5호선,하남풍산,1638,1638,3276
<class,5호선,하남시청,2722,2651,5373
<class,5호선,하남검단산,3295,3368,6663
<class,6호선,응암,7366,7595,14961
<class,6호선,역촌,1688,1896,3584
<class,6호선,불광,2278,2194,4472
<class,6호선,독바위,1347,1642,2989
<class,6호선,구산,3197,2428,5625
<class,6호선,새절,5239,5118,10357
<class,6호선,증산,4653,4668,9321
<class,6호선,디지털미디어시티,4217,4341,8558
<class,6호선,월드컵경기장,2984,2968,5952
<class,6호선,마포구청,6015,5409,11424
<class,6호선,망원,8053,8663,16716
<class,6호선,합정,7215,6632,13847
<class,6호선,상수,4265,5165,9430
<class,6호선,광흥창,3366,3222,6588
<class,6호선,대흥,3219,3225,6444
<class,6호선,공덕,5265,4974,10239
<class,6호선,효창공원앞,2777,2506,5283
<class,6호선,삼각지,2749,2155,4904
<class,6호선,녹사평,3036,2945,5981
<class,6호선,이태원,6603,6539,13142
<class,6호선,한강진,5184,5994,11178
<class,6호선,버티고개,790,928,1718
<class,6호선,약수,1416,1398,2814
<class,6호선,청구,1382,1304,2686
<class,6호선,신당,3275,3970,7245
<class,6호선,동묘앞,4958,4955,9913
<class,6호선,창신,1390,1252,2642
<class,6호선,보문,3273,3044,6317
<class,6호선,안암,3610,3687,7297
<class,6호선,고려대,3254,3139,6393
<class,6호선,월곡,4358,4333,8691
<class,6호선,상월곡,2668,2477,5145
<class,6호선,돌곶이,3625,3499,7124
<class,6호선,석계,5374,5494,10868
<class,6호선,태릉입구,2562,2709,5271
<class,6호선,화랑대,4130,3618,7748
<class,6호선,봉화산,3288,3221,6509
<class,7호선,장암,1224,937,2161
<class,7호선,도봉산,4483,6452,10935
<class,7호선,수락산,7055,7115,14170
<class,7호선,마들,4978,4720,9698
<class,7호선,노원,9009,9305,18314
<class,7호선,중계,5551,5059,10610
<class,7호선,하계,7226,6902,14128
<class,7호선,공릉,5192,5331,10523
<class,7호선,태릉입구,4014,3866,7880
<class,7호선,먹골,4348,4208,8556
<class,7호선,중화,4697,4500,9197
<class,7호선,상봉,7314,6917,14231
<class,7호선,면목,6719,6627,13346
<class,7호선,사가정,7724,7519,15243
<class,7호선,용마산,2846,3088,5934
<class,7호선,중곡,4007,4030,8037
<class,7호선,군자,6123,4963,11086
<class,7호선,어린이대공원,5392,5425,10817
<class,7호선,건대입구,5720,5844,11564
<class,7호선,뚝섬유원지,6149,5307,11456
<class,7호선,청담,5318,5676,10994
<class,7호선,강남구청,4416,4792,9208
<class,7호선,학동,4380,4605,8985
<class,7호선,논현,5401,5718,11119
<class,7호선,반포,2276,2262,4538
<class,7호선,고속터미널,8885,5707,14592
<class,7호선,내방,4299,4460,8759
<class,7호선,이수,6535,6394,12929
<class,7호선,남성,4524,4445,8969
<class,7호선,숭실대입구,4562,4997,9559
<class,7호선,상도,4358,4323,8681
<class,7호선,장승배기,4278,4196,8474
<class,7호선,신대방삼거리,6568,6554,13122
<class,7호선,보라매,3691,3596,7287
<class,7호선,신풍,4878,4627,9505
<class,7호선,대림,5349,5092,10441
<class,7호선,남구로,5568,5465,11033
<class,7호선,가산디지털단지,7947,7490,15437
<class,7호선,철산,8445,8350,16795
<class,7호선,광명사거리,10272,10157,20429
<class,7호선,천왕,3951,3813,7764
<class,7호선,온수,3170,3146,6316
<class,7호선,까치울,3393,3485,6878
<class,7호선,부천종합운동장,2038,1856,3894
<class,7호선,춘의,2983,2791,5774
<class,7호선,신중동,5439,5433,10872
<class,7호선,부천시청,5532,5403,10935
<class,7호선,상동,5801,5581,11382
<class,7호선,삼산체육관,2171,2115,4286
<class,7호선,굴포천,3804,3858,7662
<class,7호선,부평구청,2852,2555,5407
<class,8호선,암사,7398,7054,14452
<class,8호선,천호,6745,7758,14503
<class,8호선,강동구청,3418,3679,7097
<class,8호선,몽촌토성,2605,2571,5176
<class,8호선,잠실,7327,7962,15289
<class,8호선,석촌,3338,4284,7622
<class,8호선,송파,2672,2825,5497
<class,8호선,가락시장,2487,3158,5645
<class,8호선,문정,4083,4236,8319
<class,8호선,장지,7050,7337,14387
<class,8호선,복정,3799,3592,7391
<class,8호선,산성,2765,2929,5694
<class,8호선,남한산성입구,5652,5069,10721
<class,8호선,단대오거리,4329,4323,8652
<class,8호선,신흥,2296,2535,4831
<class,8호선,수진,2508,2238,4746
<class,8호선,모란,2171,1862,4033
<class,9호선,개화,956,911,1867
<class,9호선,김포공항,6197,9396,15593
<class,9호선,공항시장,1444,1540,2984
<class,9호선,신방화,2796,2735,5531
<class,9호선,마곡나루,4332,4487,8819
<class,9호선,양천향교,3413,3619,7032
<class,9호선,가양,7956,7852,15808
<class,9호선,증미,2067,2082,4149
<class,9호선,등촌,4257,4351,8608
<class,9호선,염창,6656,6576,13232
<class,9호선,신목동,1396,1303,2699
<class,9호선,선유도,2299,2300,4599
<class,9호선,당산,6790,6839,13629
<class,9호선,국회의사당,2647,2585,5232
<class,9호선,여의도,6208,5921,12129
<class,9호선,샛강,1242,1295,2537
<class,9호선,노량진,11610,12286,23896
<class,9호선,노들,1984,1736,3720
<class,9호선,흑석,3088,3308,6396
<class,9호선,동작,1044,850,1894
<class,9호선,구반포,875,930,1805
<class,9호선,신반포,1196,1231,2427
<class,9호선,고속터미널,7377,9367,16744
<class,9호선,사평,1140,1279,2419
<class,9호선,신논현,12102,11774,23876
<class,9호선2~3단계,언주,2608,2611,5219
<class,9호선2~3단계,선정릉,2568,2762,5330
<class,9호선2~3단계,삼성중앙,1518,1604,3122
<class,9호선2~3단계,봉은사,6415,6510,12925
<class,9호선2~3단계,종합운동장,1617,1522,3139
<class,9호선2~3단계,삼전,2848,2847,5695
<class,9호선2~3단계,석촌고분,2466,2445,4911
<class,9호선2~3단계,석촌,3764,3271,7035
<class,9호선2~3단계,송파나루,2396,2694,5090
<class,9호선2~3단계,한성백제,1125,1052,2177
<class,9호선2~3단계,올림픽공원,2506,2483,4989
<class,9호선2~3단계,둔촌오륜,339,378,717
<class,9호선2~3단계,중앙보훈병원,2752,2705,5457
<class,경강선,판교,2000,1892,3892
<class,경강선,이매,504,419,923
<class,경강선,삼동,914,828,1742
<class,경강선,경기광주,2975,3009,5984
<class,경강선,초월,1323,1306,2629
<class,경강선,곤지암,1172,1328,2500
<class,경강선,신둔도예촌,717,663,1380
<class,경강선,이천,1709,1882,3591
<class,경강선,부발,1032,1597,2629
<class,경강선,세종대왕릉,242,249,491
<class,경강선,여주,1653,1580,3233
<class,경부선,서울역,4419,1003,5422
<class,경부선,남영,3429,3707,7136
<class,경부선,용산,23032,20794,43826
<class,경부선,노량진,4657,4245,8902
<class,경부선,대방,4520,4911,9431
<class,경부선,영등포,23642,22615,46257
<class,경부선,신도림,1687,1792,3479
<class,경부선,신길,4215,3780,7995
<class,경부선,구로,7538,7625,15163
<class,경부선,가산디지털단지,3733,5131,8864
<class,경부선,금천구청,5098,5051,10149
<class,경부선,석수,4229,4164,8393
<class,경부선,관악,4322,3967,8289
<class,경부선,안양,11180,11016,22196
<class,경부선,명학,2774,2643,5417
<class,경부선,금정,10917,11199,22116
<class,경부선,군포,2446,2388,4834
<class,경부선,의왕,3479,3525,7004
<class,경부선,성균관대,6250,6422,12672
<class,경부선,화서,3075,2983,6058
<class,경부선,수원,25386,25026,50412
<class,경부선,독산,5067,5020,10087
<class,경부선,세류,1619,1676,3295
<class,경부선,병점,7586,8309,15895
<class,경부선,세마,1312,1265,2577
<class,경부선,오산대,1683,1619,3302
<class,경부선,오산,6151,6556,12707
<class,경부선,진위,593,606,1199
<class,경부선,송탄,3008,3150,6158
<class,경부선,서정리,3452,4657,8109
<class,경부선,평택지제,1864,1677,3541
<class,경부선,평택,9056,9510,18566
<class,경부선,성환,1948,2169,4117
<class,경부선,직산,452,449,901
<class,경부선,두정,3041,3317,6358
<class,경부선,천안,5177,4809,9986
<class,경부선,당정,2515,2465,4980
<class,경부선,서동탄,591,605,1196
<class,경부선,광명,1825,1337,3162
<class,경원선,이촌,1803,1540,3343
<class,경원선,서빙고,930,860,1790
<class,경원선,한남,1645,1663,3308
<class,경원선,옥수,51,18,69
<class,경원선,응봉,897,795,1692
<class,경원선,왕십리,6789,7937,14726
<class,경원선,청량리,11680,10478,22158
<class,경원선,외대앞,3584,3520,7104
<class,경원선,신이문,4075,3746,7821
<class,경원선,석계,4068,4341,8409
<class,경원선,광운대,3539,3495,7034
<class,경원선,월계,3137,2868,6005
<class,경원선,녹천,2260,1914,4174
<class,경원선,방학,4860,4781,9641
<class,경원선,도봉,2972,2934,5906
<class,경원선,도봉산,7319,5303,12622
<class,경원선,망월사,3783,3891,7674
<class,경원선,회룡,6210,6016,12226
<class,경원선,의정부,11148,11323,22471
<class,경원선,가능,3446,3300,6746
<class,경원선,녹양,2292,2159,4451
<class,경원선,양주,4261,4214,8475
<class,경원선,덕계,1419,1337,2756
<class,경원선,덕정,2827,2776,5603
<class,경원선,지행,3557,3547,7104
<class,경원선,동두천중앙,1793,1727,3520
<class,경원선,보산,979,972,1951
<class,경원선,동두천,1241,1397,2638
<class,경원선,소요산,3790,3289,7079
<class,경의선,서울역,757,733,1490
<class,경의선,신촌,248,252,500
<class,경의선,효창공원앞,1027,1232,2259
<class,경의선,공덕,1306,1160,2466
<class,경의선,서강대,1046,1083,2129
<class,경의선,홍대입구,1244,1428,2672
<class,경의선,가좌,2362,2269,4631
<class,경의선,디지털미디어시티,1081,968,2049
<class,경의선,수색,758,809,1567
<class,경의선,화전,590,616,1206
<class,경의선,강매,1255,1131,2386
<class,경의선,행신,3514,3393,6907
<class,경의선,능곡,1885,1786,3671
<class,경의선,곡산,255,267,522
<class,경의선,백마,2809,2670,5479
<class,경의선,풍산,2925,2777,5702
<class,경의선,일산,3825,3745,7570
<class,경의선,탄현,3436,3239,6675
<class,경의선,야당,3476,3404,6880
<class,경의선,운정,2951,2777,5728
<class,경의선,금릉,2291,2327,4618
<class,경의선,금촌,3435,3529,6964
<class,경의선,월롱,720,1387,2107
<class,경의선,파주,609,539,1148
<class,경의선,문산,2964,3032,5996
<class,경의선,임진강,67,50,117
<class,경의선,서울역,47,34,81
<class,경인선,개봉,9729,9612,19341
<class,경인선,오류동,5540,5260,10800
<class,경인선,역곡,11544,11415,22959
<class,경인선,부천,17595,17245,34840
<class,경인선,송내,10452,10079,20531
<class,경인선,부평,17865,18429,36294
<class,경인선,백운,3360,3235,6595
<class,경인선,동암,7839,7821,15660
<class,경인선,주안,9936,8951,18887
<class,경인선,제물포,4405,4480,8885
<class,경인선,동인천,7678,7349,15027
<class,경인선,인천,3205,2796,6001
<class,경인선,구일,2584,2513,5097
<class,경인선,소사,4316,4134,8450
<class,경인선,부개,3809,3597,7406
<class,경인선,간석,2607,2469,5076
<class,경인선,도원,1340,1375,2715
<class,경인선,온수,2921,2749,5670
<class,경인선,중동,3983,3751,7734
<class,경인선,도화,1965,1857,3822
<class,경춘선,신내,707,736,1443
<class,경춘선,갈매,1158,1110,2268
<class,경춘선,별내,1622,1506,3128
<class,경춘선,퇴계원,1778,1718,3496
<class,경춘선,사릉,1393,1453,2846
<class,경춘선,금곡,823,737,1560
<class,경춘선,평내호평,2955,2916,5871
<class,경춘선,천마산,937,959,1896
<class,경춘선,마석,2184,2164,4348
<class,경춘선,대성리,526,456,982
<class,경춘선,청평,1436,1191,2627
<class,경춘선,상천,338,266,604
<class,경춘선,가평,1782,1564,3346
<class,경춘선,굴봉산,169,133,302
<class,경춘선,백양리,172,150,322
<class,경춘선,강촌,765,585,1350
<class,경춘선,김유정,405,408,813
<class,경춘선,남춘천,2398,2420,4818
<class,경춘선,춘천,1411,1193,2604
<class,공항철도 1호선,서울역,5275,4484,9759
<class,공항철도 1호선,공덕,928,1189,2117
<class,공항철도 1호선,홍대입구,7268,6704,13972
<class,공항철도 1호선,디지털미디어시티,2871,2947,5818
<class,공항철도 1호선,마곡나루,1751,1914,3665
<class,공항철도 1호선,김포공항,10239,5210,15449
<class,공항철도 1호선,계양,4001,4014,8015
<class,공항철도 1호선,검암,2930,3034,5964
<class,공항철도 1호선,청라국제도시,2560,2579,5139
<class,공항철도 1호선,운서,4032,4280,8312
<class,공항철도 1호선,공항화물청사,941,981,1922
<class,공항철도 1호선,인천공항1터미널,2966,2914,5880
<class,공항철도 1호선,인천공항2터미널,1834,1700,3534
<class,공항철도 1호선,영종,1925,1950,3875
<class,과천선,선바위,2934,2862,5796
<class,과천선,경마공원,739,731,1470
<class,과천선,대공원,3458,3530,6988
<class,과천선,과천,2585,2418,5003
<class,과천선,정부과천청사,3484,3545,7029
<class,과천선,인덕원,8682,8817,17499
<class,과천선,평촌,4851,4675,9526
<class,과천선,범계,11748,11552,23300
<class,분당선,선릉,2322,3208,5530
<class,분당선,한티,7505,7076,14581
<class,분당선,도곡,2109,1888,3997
<class,분당선,구룡,605,639,1244
<class,분당선,개포동,1509,1563,3072
<class,분당선,수서,6654,6307,12961
<class,분당선,복정,1,0,1
<class,분당선,수원,4666,3662,8328
<class,분당선,서울숲,4928,4963,9891
<class,분당선,압구정로데오,8622,9411,18033
<class,분당선,강남구청,2618,3151,5769
<class,분당선,선정릉,1680,1680,3360
<class,분당선,가천대,2856,3353,6209
<class,분당선,태평,6692,6056,12748
<class,분당선,모란,9339,9417,18756
<class,분당선,야탑,9807,10288,20095
<class,분당선,서현,11062,11224,22286
<class,분당선,수내,4998,4823,9821
<class,분당선,정자,5967,6293,12260
<class,분당선,미금,5714,6023,11737
<class,분당선,오리,4547,3955,8502
<class,분당선,이매,2617,2554,5171
<class,분당선,보정,886,776,1662
<class,분당선,죽전,6004,7015,13019
<class,분당선,구성,1871,2064,3935
<class,분당선,신갈,1543,1632,3175
<class,분당선,기흥,3991,3788,7779
<class,분당선,상갈,2290,2440,4730
<class,분당선,청명,1488,1586,3074
<class,분당선,영통,3741,3703,7444
<class,분당선,망포,4969,5323,10292
<class,분당선,매탄권선,1992,1968,3960
<class,분당선,수원시청,5676,5600,11276
<class,분당선,매교,1089,1158,2247
<class,수인선,고색,1244,1348,2592
<class,수인선,오목천,1097,1095,2192
<class,수인선,어천,444,500,944
<class,수인선,야목,140,133,273
<class,수인선,사리,2085,1698,3783
<class,수인선,달월,35,43,78
<class,수인선,월곶,1409,1309,2718
<class,수인선,소래포구,4195,4097,8292
<class,수인선,인천논현,2435,2497,4932
<class,수인선,호구포,1606,1626,3232
<class,수인선,남동인더스파크,490,509,999
<class,수인선,원인재,2370,2386,4756
<class,수인선,연수,2436,2427,4863
<class,수인선,송도,1326,1239,2565
<class,수인선,인하대,2537,2502,5039
<class,수인선,숭의,1613,1488,3101
<class,수인선,신포,952,915,1867
<class,수인선,인천,914,1320,2234
<class,안산선,산본,7152,7487,14639
<class,안산선,대야미,2525,2369,4894
<class,안산선,반월,2046,2053,4099
<class,안산선,상록수,7511,7301,14812
<class,안산선,한대앞,4312,4207,8519
<class,안산선,중앙,9169,9177,18346
<class,안산선,고잔,3462,3322,6784
<class,안산선,초지,1819,1803,3622
<class,안산선,안산,7503,6989,14492
<class,안산선,신길온천,953,917,1870
<class,안산선,정왕,4091,4325,8416
<class,안산선,오이도,5154,5027,10181
<class,안산선,수리산,1741,1646,3387
<class,우이신설선,북한산우이,3576,3592,7168
<class,우이신설선,솔밭공원,1228,1254,2482
<class,우이신설선,4.19민주묘지,1883,1644,3527
<class,우이신설선,가오리,2079,1925,4004
<class,우이신설선,화계,1786,1697,3483
<class,우이신설선,삼양,1041,1096,2137
<class,우이신설선,삼양사거리,1344,1347,2691
<class,우이신설선,솔샘,2181,2096,4277
<class,우이신설선,북한산보국문,3115,2792,5907
<class,우이신설선,정릉,2293,1924,4217
<class,우이신설선,성신여대입구,1800,2114,3914
<class,우이신설선,보문,773,768,1541
<class,우이신설선,신설동,1017,999,2016
<class,일산선,원흥,4312,4175,8487
<class,일산선,삼송,8726,8690,17416
<class,일산선,원당,5250,5013,10263
<class,일산선,화정,7697,7992,15689
<class,일산선,대곡,912,774,1686
<class,일산선,백석,4594,4569,9163
<class,일산선,마두,2943,2893,5836
<class,일산선,정발산,4569,4636,9205
<class,일산선,주엽,3864,3658,7522
<class,일산선,대화,5306,4786,10092
<class,장항선,봉명,415,411,826
<class,장항선,쌍용,930,927,1857
<class,장항선,아산,2093,1523,3616
<class,장항선,배방,643,717,1360
<class,장항선,온양온천,2671,2568,5239
<class,장항선,신창,820,913,1733
<class,중앙선,회기,12073,12195,24268
<class,중앙선,중랑,2845,2761,5606
<class,중앙선,상봉,3461,3299,6760
<class,중앙선,망우,3875,3800,7675
<class,중앙선,양원,746,859,1605
<class,중앙선,구리,6243,6523,12766
<class,중앙선,도농,4029,4014,8043
<class,중앙선,양정,495,411,906
<class,중앙선,덕소,2969,2931,5900
<class,중앙선,도심,1033,924,1957
<class,중앙선,팔당,1158,1159,2317
<class,중앙선,운길산,1196,1112,2308
<class,중앙선,양수,1894,1721,3615
<class,중앙선,신원,218,153,371
<class,중앙선,국수,493,421,914
<class,중앙선,아신,429,365,794
<class,중앙선,오빈,219,203,422
<class,2호선,건대입구,19687,20802,40489
<class,2호선,성수,9874,11355,21229
<class,2호선,뚝섬,7685,8125,15810
<class,2호선,한양대,2314,2473,4787
<class,2호선,왕십리,7272,6171,13443
<class,2호선,상왕십리,5457,5356,10813
<class,2호선,신당,6517,6929,13446
<class,2호선,동대문역사문화공원,5976,7500,13476
<class,2호선,을지로4가,2474,2419,4893
<class,2호선,을지로3가,5433,5408,10841
<class,2호선,을지로입구,11573,11309,22882
<class,2호선,시청,4295,3655,7950
<class,1호선,청량리,11311,11421,22732
<class,1호선,제기동,8697,9265,17962
<class,1호선,신설동,6027,6027,12054
<class,1호선,동대문,7229,7784,15013
<class,1호선,종로5가,7088,7272,14360
<class,1호선,종로3가,11860,10842,22702
<class,1호선,종각,9965,9024,18989
<class,안산선,오이도,6823,6880,13703
<class,1호선,서울역,22988,23724,46712
<class,1호선,동묘앞,10706,11008,21714
<class,1호선,시청,8303,8063,16366
<class,1호선,종각,14583,13710,28293
<class,1호선,종로3가,19684,18681,38365
<class,1호선,종로5가,15315,15426,30741
<class,1호선,동대문,9620,8947,18567
<class,1호선,신설동,8502,8076,16578
<class,1호선,제기동,14864,15280,30144
<class,1호선,청량리,16561,16885,33446
<class,2호선,시청,7008,6387,13395
<class,2호선,을지로입구,16107,16151,32258
<class,2호선,을지로3가,8318,8310,16628
<class,2호선,을지로4가,6451,6818,13269
<class,2호선,동대문역사문화공원,8199,8698,16897
<class,2호선,신당,9495,9844,19339
<class,2호선,상왕십리,8584,8095,16679
<class,2호선,왕십리,10643,8968,19611
<class,2호선,한양대,3119,3104,6223
<class,2호선,뚝섬,11637,12039,23676
<class,2호선,성수,15284,17455,32739
<class,2호선,건대입구,26494,28794,55288
<class,2호선,구의,13632,13629,27261
<class,2호선,강변,20941,21940,42881
<class,2호선,잠실나루,6631,6474,13105
<class,2호선,잠실,48746,46341,95087
<class,2호선,잠실새내,13847,14185,28032
<class,2호선,종합운동장,3867,4057,7924
<class,2호선,삼성,24181,24456,48637
<class,2호선,선릉,20001,17467,37468
<class,2호선,역삼,14635,16037,30672
<class,2호선,강남,50235,48830,99065
<class,2호선,교대,14617,16542,31159
<class,2호선,서초,8852,7678,16530
<class,2호선,방배,8025,8672,16697
<class,2호선,사당,23649,25927,49576
<class,2호선,낙성대,18394,17070,35464
<class,2호선,서울대입구,33026,32025,65051
<class,2호선,봉천,15257,13930,29187
<class,2호선,신림,43150,41124,84274
<class,2호선,신대방,17349,16790,34139
<class,2호선,구로디지털단지,28689,28416,57105
<class,2호선,대림,15312,16223,31535
<class,2호선,신도림,31860,31671,63531
<class,2호선,문래,9693,10245,19938
<class,2호선,영등포구청,10441,10702,21143
<class,2호선,당산,10902,11702,22604
<class,2호선,합정,22772,24376,47148
<class,2호선,홍대입구,47006,49767,96773
<class,2호선,신촌,24155,24072,48227
<class,2호선,이대,9008,9366,18374
<class,2호선,아현,6712,6333,13045
<class,2호선,충정로,4596,4793,9389
<class,2호선,용답,1808,1756,3564
<class,2호선,신답,868,899,1767
<class,2호선,신설동,2776,2817,5593
<class,2호선,도림천,675,679,1354
<class,2호선,양천구청,3756,3770,7526
<class,2호선,신정네거리,6103,6255,12358
<class,2호선,용두,1555,1536,3091
<class,3호선,지축,2717,2662,5379
<class,3호선,구파발,13237,13119,26356
<class,3호선,연신내,25891,24424,50315
<class,3호선,불광,11064,12683,23747
<class,3호선,녹번,8876,7783,16659
<class,3호선,홍제,11136,10457,21593
<class,3호선,무악재,2303,2370,4673
<class,3호선,독립문,4832,4977,9809
<class,3호선,경복궁,12275,13121,25396
<class,3호선,안국,10550,12168,22718
<class,3호선,종로3가,4666,6623,11289
<class,3호선,을지로3가,4266,4457,8723
<class,3호선,충무로,1,0,1
<class,3호선,동대입구,5136,5534,10670
<class,3호선,약수,7953,7499,15452
<class,3호선,금호,5231,4778,10009
<class,3호선,옥수,6311,6490,12801
<class,3호선,압구정,21503,22291,43794
<class,3호선,신사,20197,20902,41099
<class,3호선,잠원,2941,2767,5708
<class,3호선,고속터미널,36560,36664,73224
<class,3호선,교대,5648,3293,8941
<class,3호선,남부터미널,17665,18472,36137
<class,3호선,양재,16745,17985,34730
<class,3호선,매봉,5036,4917,9953
<class,3호선,도곡,2798,2640,5438
<class,3호선,대치,8384,7551,15935
<class,3호선,학여울,1063,1058,2121
<class,3호선,대청,4995,4562,9557
<class,3호선,일원,4115,4190,8305
<class,3호선,수서,10488,10776,21264
<class,3호선,가락시장,5411,5088,10499
<class,3호선,경찰병원,3409,3288,6697
<class,3호선,오금,3278,3184,6462
<class,4호선,수유,23044,22623,45667
<class,4호선,미아,9432,8985,18417
<class,4호선,미아사거리,18886,18072,36958
<class,4호선,길음,11916,11224,23140
<class,4호선,성신여대입구,14067,13416,27483
<class,4호선,한성대입구,8783,8469,17252
<class,4호선,혜화,21296,22313,43609
<class,4호선,동대문,12502,12444,24946
<class,4호선,동대문역사문화공원,8901,7673,16574
<class,4호선,충무로,10450,11102,21552
<class,4호선,명동,9843,11294,21137
<class,4호선,회현,14799,15680,30479
<class,4호선,서울역,4344,8702,13046
<class,4호선,숙대입구,7008,6763,13771
<class,4호선,삼각지,2575,3271,5846
<class,4호선,신용산,7920,8790,16710
<class,4호선,이촌,5180,5785,10965
<class,4호선,동작,1798,1667,3465
<class,4호선,총신대입구,12387,13505,25892
<class,4호선,사당,16224,13853,30077
<class,4호선,남태령,799,589,1388
<class,4호선,당고개,8740,8393,17133
<class,4호선,상계,12229,11403,23632
<class,4호선,노원,13374,14754,28128
<class,4호선,창동,16984,17710,34694
<class,4호선,쌍문,18547,16992,35539
<class,5호선,방화,4107,3889,7996
<class,5호선,개화산,3300,3267,6567
<class,5호선,김포공항,6337,6405,12742
<class,5호선,송정,4487,4250,8737
<class,5호선,마곡,4598,4606,9204
<class,5호선,발산,10932,11560,22492
<class,5호선,우장산,8504,8501,17005
<class,5호선,화곡,17663,16156,33819
<class,5호선,까치산,18680,17983,36663
<class,5호선,신정,7763,6665,14428
<class,5호선,목동,9806,9911,19717
<class,5호선,오목교,13862,14438,28300
<class,5호선,양평,3185,3046,6231
<class,5호선,영등포구청,1744,1743,3487
<class,5호선,영등포시장,5989,6156,12145
<class,5호선,신길,2097,2200,4297
<class,5호선,여의도,8557,9375,17932
<class,5호선,여의나루,8877,9379,18256
<class,5호선,마포,6245,6248,12493
<class,5호선,공덕,5906,6022,11928
<class,5호선,애오개,3263,3049,6312
<class,5호선,충정로,1673,1616,3289
<class,5호선,서대문,5918,5742,11660
<class,5호선,광화문,11736,11864,23600
<class,5호선,종로3가,9337,9800,19137
<class,5호선,을지로4가,3055,3104,6159
<class,5호선,동대문역사문화공원,814,1088,1902
<class,5호선,청구,2193,2050,4243
<class,5호선,신금호,3625,3761,7386
<class,5호선,행당,4811,4135,8946
<class,5호선,왕십리,2968,3555,6523
<class,5호선,마장,3430,3270,6700
<class,5호선,답십리,8793,8004,16797
<class,5호선,장한평,9558,9453,19011
<class,5호선,군자,7090,7715,14805
<class,5호선,아차산,10646,10372,21018
<class,5호선,광나루,8465,8070,16535
<class,5호선,천호,14036,13424,27460
<class,5호선,강동,10576,10141,20717
<class,5호선,길동,5249,5362,10611
<class,5호선,굽은다리,6262,5795,12057
<class,5호선,명일,5300,5328,10628
<class,5호선,고덕,5721,5602,11323
<class,5호선,상일동,8351,7714,16065
<class,5호선,둔촌동,5391,5389,10780
<class,5호선,올림픽공원,2523,2188,4711
<class,5호선,방이,4564,4451,9015
<class,5호선,오금,2090,1906,3996
<class,5호선,개롱,3755,3923,7678
<class,5호선,거여,5071,4872,9943
<class,5호선,마천,3976,4059,8035
<class,5호선,강일,2032,1965,3997
<class,5호선,미사,9849,9974,19823
<class,5호선,하남풍산,2294,2316,4610
<class,5호선,하남시청,4105,3960,8065
<class,5호선,하남검단산,4275,4298,8573
<class,6호선,응암,11137,11022,22159
<class,6호선,역촌,2475,2828,5303
<class,6호선,불광,3181,2980,6161
<class,6호선,독바위,1813,2034,3847
<class,6호선,구산,4857,3710,8567
<class,6호선,새절,7712,7167,14879
<class,6호선,증산,6457,6314,12771
<class,6호선,디지털미디어시티,6111,6175,12286
<class,6호선,월드컵경기장,4587,4662,9249
<class,6호선,마포구청,8309,7217,15526
<class,6호선,망원,11214,12551,23765
<class,6호선,합정,10634,9663,20297
<class,6호선,상수,6196,7448,13644
<class,6호선,광흥창,4577,4250,8827
<class,6호선,대흥,4712,4704,9416
<class,6호선,공덕,8513,7950,16463
<class,6호선,효창공원앞,3893,3436,7329
<class,6호선,삼각지,4098,3126,7224
<class,6호선,녹사평,4331,4410,8741
<class,6호선,이태원,8627,9132,17759
<class,6호선,한강진,6429,7746,14175
<class,6호선,버티고개,1159,1360,2519
<class,6호선,약수,2133,2089,4222
<class,6호선,청구,2149,2075,4224
<class,6호선,신당,5709,4880,10589
<class,6호선,동묘앞,7196,6579,13775
<class,6호선,창신,1917,1524,3441
<class,6호선,보문,4386,4029,8415
<class,6호선,안암,5103,5030,10133
<class,6호선,고려대,4498,4235,8733
<class,6호선,월곡,6452,6366,12818
<class,6호선,상월곡,3645,3178,6823
<class,6호선,돌곶이,5192,4857,10049
<class,6호선,석계,7604,7564,15168
<class,6호선,태릉입구,3606,3818,7424
<class,6호선,화랑대,5693,4775,10468
<class,6호선,봉화산,4604,4506,9110
<class,7호선,장암,1374,1033,2407
<class,7호선,도봉산,5894,8023,13917
<class,7호선,수락산,9096,8860,17956
<class,7호선,마들,7783,7339,15122
<class,7호선,노원,13451,14184,27635
<class,7호선,중계,8005,7220,15225
<class,7호선,하계,10572,9777,20349
<class,7호선,공릉,7526,7477,15003
<class,7호선,태릉입구,5601,5251,10852
<class,7호선,먹골,6818,6631,13449
<class,7호선,중화,6901,6598,13499
<class,7호선,상봉,11497,10912,22409
<class,7호선,면목,9690,9397,19087
<class,7호선,사가정,10911,10426,21337
<class,7호선,용마산,3881,4006,7887
<class,7호선,중곡,5940,5669,11609
<class,7호선,군자,9148,7227,16375
<class,7호선,어린이대공원,7860,7694,15554
<class,7호선,건대입구,8818,8944,17762
<class,7호선,뚝섬유원지,8052,7238,15290
<class,7호선,청담,9172,9787,18959
<class,7호선,강남구청,8191,8910,17101
<class,7호선,학동,8296,8746,17042
<class,7호선,논현,9739,10408,20147
<class,7호선,반포,3861,3472,7333
<class,7호선,고속터미널,10361,8492,18853
<class,7호선,내방,7029,7019,14048
<class,7호선,이수,10344,9513,19857
<class,7호선,남성,6710,6303,13013
<class,7호선,숭실대입구,7135,7091,14226
<class,7호선,상도,6326,5934,12260
<class,7호선,장승배기,5774,5681,11455
<class,7호선,신대방삼거리,9920,9465,19385
<class,7호선,보라매,5545,5249,10794
<class,7호선,신풍,7038,6648,13686
<class,7호선,대림,6103,6498,12601
<class,7호선,남구로,7441,7908,15349
<class,7호선,가산디지털단지,12163,11156,23319
<class,7호선,철산,12767,13017,25784
<class,7호선,광명사거리,14976,15004,29980
<class,7호선,천왕,5809,5578,11387
<class,7호선,온수,5023,4875,9898
<class,7호선,까치울,4878,4907,9785
<class,7호선,부천종합운동장,2884,2566,5450
<class,7호선,춘의,4612,4444,9056
<class,7호선,신중동,8366,8258,16624
<class,7호선,부천시청,8430,8384,16814
<class,7호선,상동,8899,8945,17844
<class,7호선,삼산체육관,3138,2972,6110
<class,7호선,굴포천,5714,5945,11659
<class,7호선,부평구청,4400,4026,8426
<class,8호선,암사,11090,10136,21226
<class,8호선,천호,10004,11817,21821
<class,8호선,강동구청,5179,5356,10535
<class,8호선,몽촌토성,3757,3592,7349
<class,8호선,잠실,9918,11217,21135
<class,8호선,석촌,5079,6266,11345
<class,8호선,송파,4478,4563,9041
<class,8호선,가락시장,4848,4886,9734
<class,8호선,문정,6936,7001,13937
<class,8호선,장지,10534,9611,20145
<class,8호선,복정,5980,5344,11324
<class,8호선,산성,3885,3904,7789
<class,8호선,남한산성입구,7997,7171,15168
<class,8호선,단대오거리,6754,6139,12893
<class,8호선,신흥,3165,3368,6533
<class,8호선,수진,3696,3324,7020
<class,8호선,모란,3168,2707,5875
<class,9호선,개화,1413,1171,2584
<class,9호선,김포공항,6751,10978,17729
<class,9호선,공항시장,1997,2155,4152
<class,9호선,신방화,4062,4025,8087
<class,9호선,마곡나루,6883,6882,13765
<class,9호선,양천향교,5254,5110,10364
<class,9호선,가양,11951,11214,23165
<class,9호선,증미,3764,3627,7391
<class,9호선,등촌,6690,6608,13298
<class,9호선,염창,9780,9132,18912
<class,9호선,신목동,2025,1677,3702
<class,9호선,선유도,3378,3221,6599
<class,9호선,당산,10577,9814,20391
<class,9호선,국회의사당,3012,3094,6106
<class,9호선,여의도,9074,9000,18074
<class,9호선,샛강,2192,2194,4386
<class,9호선,노량진,18145,17612,35757
<class,9호선,노들,2897,2384,5281
<class,9호선,흑석,4630,4653,9283
<class,9호선,동작,1371,1052,2423
<class,9호선,구반포,1532,1617,3149
<class,9호선,신반포,2081,2032,4113
<class,9호선,고속터미널,10106,13948,24054
<class,9호선,사평,1854,1748,3602
<class,9호선,신논현,21276,20932,42208
<class,9호선2~3단계,언주,4607,4637,9244
<class,9호선2~3단계,선정릉,3919,4312,8231
<class,9호선2~3단계,삼성중앙,2455,2549,5004
<class,9호선2~3단계,봉은사,9236,9727,18963
<class,9호선2~3단계,종합운동장,2417,2434,4851
<class,9호선2~3단계,삼전,4360,4036,8396
<class,9호선2~3단계,석촌고분,3679,3545,7224
<class,9호선2~3단계,석촌,5583,4840,10423
<class,9호선2~3단계,송파나루,3320,3691,7011
<class,9호선2~3단계,한성백제,1605,1375,2980
<class,9호선2~3단계,올림픽공원,3490,3518,7008
<class,9호선2~3단계,둔촌오륜,533,548,1081
<class,9호선2~3단계,중앙보훈병원,3997,3802,7799
<class,경강선,판교,2606,2415,5021
<class,경강선,이매,698,586,1284
<class,경강선,삼동,1251,1244,2495
<class,경강선,경기광주,4320,4049,8369
<class,경강선,초월,1904,1770,3674
<class,경강선,곤지암,1608,1715,3323
<class,경강선,신둔도예촌,901,860,1761
<class,경강선,이천,2145,2198,4343
<class,경강선,부발,1555,1352,2907
<class,경강선,세종대왕릉,276,322,598
<class,경강선,여주,1866,2174,4040
<class,경부선,서울역,4295,1309,5604
<class,경부선,남영,4811,4873,9684
<class,경부선,용산,25883,27887,53770
<class,경부선,노량진,6860,6032,12892
<class,경부선,대방,6690,6626,13316
<class,경부선,영등포,29969,31369,61338
<class,경부선,신도림,2480,2442,4922
<class,경부선,신길,5366,4515,9881
<class,경부선,구로,11145,11186,22331
<class,경부선,가산디지털단지,5370,7016,12386
<class,경부선,금천구청,7140,7207,14347
<class,경부선,석수,5917,5580,11497
<class,경부선,관악,4907,4694,9601
<class,경부선,안양,15157,15087,30244
<class,경부선,명학,4307,4280,8587
<class,경부선,금정,15617,15465,31082
<class,경부선,군포,3698,3447,7145
<class,경부선,의왕,5190,5185,10375
<class,경부선,성균관대,8773,8908,17681
<class,경부선,화서,4481,4412,8893
<class,경부선,수원,29942,31699,61641
<class,경부선,독산,7568,7395,14963
<class,경부선,세류,1992,2140,4132
<class,경부선,병점,10300,10138,20438
<class,경부선,세마,1737,1607,3344
<class,경부선,오산대,2283,2250,4533
<class,경부선,오산,8043,7792,15835
<class,경부선,진위,933,847,1780
<class,경부선,송탄,4044,3584,7628
<class,경부선,서정리,5199,4583,9782
<class,경부선,평택지제,2370,2298,4668
<class,경부선,평택,10978,10482,21460
<class,경부선,성환,2448,2367,4815
<class,경부선,직산,560,547,1107
<class,경부선,두정,3976,4022,7998
<class,경부선,천안,5285,5496,10781
<class,경부선,당정,3435,3266,6701
<class,경부선,서동탄,870,911,1781
<class,경부선,광명,1993,1912,3905
<class,경원선,이촌,2756,2023,4779
<class,경원선,서빙고,1267,1055,2322
<class,경원선,한남,2586,2237,4823
<class,경원선,옥수,34,39,73
<class,경원선,응봉,1230,1083,2313
<class,경원선,왕십리,10162,11601,21763
<class,경원선,청량리,13600,15425,29025
<class,경원선,외대앞,5125,4909,10034
<class,경원선,신이문,5463,5104,10567
<class,경원선,석계,5857,6253,12110
<class,경원선,광운대,4940,4773,9713
<class,경원선,월계,4242,4012,8254
<class,경원선,녹천,2872,2423,5295
<class,경원선,방학,6551,6423,12974
<class,경원선,도봉,4047,3779,7826
<class,경원선,도봉산,8104,5579,13683
<class,경원선,망월사,5056,5178,10234
<class,경원선,회룡,8609,8642,17251
<class,경원선,의정부,14888,15790,30678
<class,경원선,가능,4508,4295,8803
<class,경원선,녹양,3047,2968,6015
<class,경원선,양주,5803,5471,11274
<class,경원선,덕계,2113,1926,4039
<class,경원선,덕정,3718,3647,7365
<class,경원선,지행,5208,5112,10320
<class,경원선,동두천중앙,2381,2391,4772
<class,경원선,보산,2028,1780,3808
<class,경원선,동두천,1444,1893,3337
<class,경원선,소요산,3914,3475,7389
<class,경의선,서울역,1076,1140,2216
<class,경의선,신촌,377,342,719
<class,경의선,효창공원앞,1440,1615,3055
<class,경의선,공덕,2013,1666,3679
<class,경의선,서강대,1589,1436,3025
<class,경의선,홍대입구,1583,1860,3443
<class,경의선,가좌,3582,3344,6926
<class,경의선,디지털미디어시티,1597,1436,3033
<class,경의선,수색,1285,1223,2508
<class,경의선,화전,870,858,1728
<class,경의선,강매,1834,1700,3534
<class,경의선,행신,4326,4462,8788
<class,경의선,능곡,2617,2534,5151
<class,경의선,곡산,378,373,751
<class,경의선,백마,3807,3650,7457
<class,경의선,풍산,3905,3744,7649
<class,경의선,일산,5898,5753,11651
<class,경의선,탄현,4746,4572,9318
<class,경의선,야당,4951,4829,9780
<class,경의선,운정,4286,4072,8358
<class,경의선,금릉,3214,3212,6426
<class,경의선,금촌,4747,4623,9370
<class,경의선,월롱,1233,1202,2435
<class,경의선,파주,757,621,1378
<class,경의선,문산,4111,3941,8052
<class,경의선,임진강,69,58,127
<class,경인선,개봉,14336,14201,28537
<class,경인선,오류동,7831,7142,14973
<class,경인선,역곡,17224,17312,34536
<class,경인선,부천,24925,25773,50698
<class,경인선,송내,15287,15350,30637
<class,경인선,부평,24736,26868,51604
<class,경인선,백운,4718,4634,9352
<class,경인선,동암,10756,11085,21841
<class,경인선,주안,13381,12169,25550
<class,경인선,제물포,6230,6204,12434
<class,경인선,동인천,10427,10240,20667
<class,경인선,인천,4033,3364,7397
<class,경인선,구일,3687,3498,7185
<class,경인선,소사,6144,6023,12167
<class,경인선,부개,5590,5152,10742
<class,경인선,간석,3858,3724,7582
<class,경인선,도원,1721,1824,3545
<class,경인선,온수,4199,3874,8073
<class,경인선,중동,5669,5332,11001
<class,경인선,도화,2689,2618,5307
<class,경춘선,신내,1072,1004,2076
<class,경춘선,갈매,1723,1511,3234
<class,경춘선,별내,2052,2020,4072
<class,경춘선,퇴계원,2489,2224,4713
<class,경춘선,사릉,2119,2045,4164
<class,경춘선,금곡,1060,971,2031
<class,경춘선,평내호평,4166,3933,8099
<class,경춘선,천마산,1258,1348,2606
<class,경춘선,마석,2894,3052,5946
<class,경춘선,대성리,678,598,1276
<class,경춘선,청평,1603,1720,3323
<class,경춘선,상천,386,333,719
<class,경춘선,가평,1743,2178,3921
<class,경춘선,굴봉산,178,201,379
<class,경춘선,백양리,164,139,303
<class,경춘선,강촌,659,794,1453
<class,경춘선,김유정,465,563,1028
<class,경춘선,남춘천,2308,2494,4802
<class,경춘선,춘천,1698,1651,3349
<class,공항철도 1호선,서울역,5601,5798,11399
<class,공항철도 1호선,공덕,1244,1655,2899
<class,공항철도 1호선,홍대입구,9726,9311,19037
<class,공항철도 1호선,디지털미디어시티,4250,3929,8179
<class,공항철도 1호선,마곡나루,2784,2876,5660
<class,공항철도 1호선,김포공항,9903,5539,15442
<class,공항철도 1호선,계양,5671,5469,11140
<class,공항철도 1호선,검암,4203,4230,8433
<class,공항철도 1호선,청라국제도시,3416,3421,6837
<class,공항철도 1호선,운서,4962,5211,10173
<class,공항철도 1호선,공항화물청사,1275,1324,2599
<class,공항철도 1호선,인천공항1터미널,3306,3341,6647
<class,공항철도 1호선,인천공항2터미널,1937,1848,3785
<class,공항철도 1호선,영종,2540,2613,5153
<class,과천선,선바위,4339,3913,8252
<class,과천선,경마공원,848,863,1711
<class,과천선,대공원,4623,4883,9506
<class,과천선,과천,3703,3339,7042
<class,과천선,정부과천청사,5074,5156,10230
<class,과천선,인덕원,12660,12431,25091
<class,과천선,평촌,7661,7455,15116
<class,과천선,범계,16585,16296,32881
<class,분당선,선릉,4470,6579,11049
<class,분당선,한티,10793,10517,21310
<class,분당선,도곡,3702,3366,7068
<class,분당선,구룡,1325,1217,2542
<class,분당선,개포동,2409,2286,4695
<class,분당선,대모산입구,2568,2405,4973
<class,분당선,수서,7919,8569,16488
<class,분당선,수원,6071,5492,11563
<class,분당선,서울숲,7265,7281,14546
<class,분당선,압구정로데오,15435,16994,32429
<class,분당선,강남구청,4623,5395,10018
<class,분당선,선정릉,2776,2783,5559
<class,분당선,가천대,4120,4594,8714
<class,분당선,태평,9366,8817,18183
<class,분당선,모란,14078,14205,28283
<class,분당선,야탑,14525,15403,29928
<class,분당선,서현,15756,15829,31585
<class,분당선,수내,7660,7273,14933
<class,분당선,정자,9021,9313,18334
<class,분당선,미금,9422,9684,19106
<class,분당선,오리,6587,5427,12014
<class,분당선,이매,3539,3336,6875
<class,분당선,보정,1390,1243,2633
<class,분당선,죽전,8643,9840,18483
<class,분당선,구성,2686,2870,5556
<class,분당선,신갈,2376,2417,4793
<class,분당선,기흥,5729,5626,11355
<class,분당선,상갈,3207,3257,6464
<class,분당선,청명,2186,2091,4277
<class,분당선,영통,5461,5415,10876
<class,분당선,망포,7519,7084,14603
<class,분당선,매탄권선,2879,2669,5548
<class,분당선,수원시청,8505,8994,17499
<class,분당선,매교,1741,1780,3521
<class,수인선,고색,1994,1961,3955
<class,수인선,오목천,1593,1529,3122
<class,수인선,어천,632,566,1198
<class,수인선,야목,191,164,355
<class,수인선,사리,2773,2496,5269
<class,수인선,달월,54,69,123
<class,수인선,월곶,1811,1868,3679
<class,수인선,소래포구,5591,5715,11306
<class,수인선,인천논현,3907,4019,7926
<class,수인선,호구포,2305,2310,4615
<class,수인선,남동인더스파크,983,922,1905
<class,수인선,원인재,3555,3596,7151
<class,수인선,연수,3241,3232,6473
<class,수인선,송도,1773,1676,3449
<class,수인선,인하대,3582,3460,7042
<class,수인선,숭의,2427,2245,4672
<class,수인선,신포,1273,1369,2642
<class,수인선,인천,1178,1865,3043
<class,안산선,산본,10668,11599,22267
<class,안산선,대야미,3528,3146,6674
<class,안산선,반월,2996,2806,5802
<class,안산선,상록수,10467,10589,21056
<class,안산선,한대앞,6042,6023,12065
<class,안산선,중앙,13009,13478,26487
<class,안산선,고잔,5213,5068,10281
<class,안산선,초지,2764,2800,5564
<class,안산선,안산,8172,8384,16556
<class,안산선,신길온천,1211,1210,2421
<class,안산선,정왕,5322,5486,10808
<class,안산선,수리산,2619,2351,4970
<class,우이신설선,북한산우이,3042,3062,6104
<class,우이신설선,솔밭공원,1640,1636,3276
<class,우이신설선,4.19민주묘지,2189,1941,4130
<class,우이신설선,가오리,2685,2542,5227
<class,우이신설선,화계,2330,2090,4420
<class,우이신설선,삼양,1356,1426,2782
<class,우이신설선,삼양사거리,1755,1746,3501
<class,우이신설선,솔샘,3268,2936,6204
<class,우이신설선,북한산보국문,3931,3585,7516
<class,우이신설선,정릉,3079,2585,5664
<class,우이신설선,성신여대입구,2445,2809,5254
<class,우이신설선,보문,1028,983,2011
<class,우이신설선,신설동,1286,1291,2577
<class,일산선,원흥,6245,6217,12462
<class,일산선,지축,1,0,1
<class,일산선,삼송,12009,11890,23899
<class,일산선,원당,7368,7136,14504
<class,일산선,화정,11234,11532,22766
<class,일산선,대곡,1187,1057,2244
<class,일산선,백석,6487,6539,13026
<class,일산선,마두,4590,4618,9208
<class,일산선,정발산,5925,6081,12006
<class,일산선,주엽,5837,5739,11576
<class,일산선,대화,7606,6919,14525
<class,장항선,봉명,575,545,1120
<class,장항선,쌍용,1234,1123,2357
<class,장항선,아산,2312,2246,4558
<class,장항선,배방,810,790,1600
<class,장항선,온양온천,3011,3083,6094
<class,장항선,신창,981,1054,2035
<class,중앙선,회기,16281,15722,32003
<class,중앙선,중랑,4204,3969,8173
<class,중앙선,상봉,4588,4450,9038
<class,중앙선,망우,5694,5661,11355
<class,중앙선,양원,1190,1166,2356
<class,중앙선,구리,9102,9142,18244
<class,중앙선,도농,5787,5563,11350
<class,중앙선,양정,627,545,1172
<class,중앙선,덕소,4031,4102,8133
<class,중앙선,도심,1502,1276,2778
<class,중앙선,팔당,1457,1478,2935
<class,중앙선,운길산,1293,1246,2539
<class,중앙선,양수,2266,2298,4564
<class,중앙선,신원,285,196,481
<class,중앙선,국수,611,625,1236
<class,중앙선,아신,555,573,1128
<class,중앙선,오빈,252,287,539
<class,중앙선,양평,3279,3408,6687
<class,중앙선,원덕,373,328,701
<class,중앙선,용문,1981,2360,4341
<class,중앙선,지평,47,68,115
<class,경의선,검암,1,0,1
<class,분당선,망포,5151,5399,10550
<class,분당선,매탄권선,2001,1967,3968
<class,분당선,수원시청,5970,6024,11994
<class,분당선,매교,1188,1257,2445
<class,수인선,고색,1367,1444,2811
<class,수인선,오목천,1206,1212,2418
<class,수인선,어천,431,555,986
<class,수인선,야목,137,132,269
<class,수인선,사리,2201,1901,4102
<class,수인선,달월,32,35,67
<class,수인선,월곶,1413,1403,2816
<class,수인선,소래포구,4726,4653,9379
<class,수인선,인천논현,2599,2610,5209
<class,수인선,호구포,1676,1685,3361
<class,수인선,남동인더스파크,544,569,1113
<class,수인선,원인재,2665,2766,5431
<class,수인선,연수,2503,2495,4998
<class,수인선,송도,1362,1314,2676
<class,수인선,인하대,2922,2879,5801
<class,수인선,숭의,1713,1653,3366
<class,수인선,신포,1051,1040,2091
<class,수인선,인천,970,1424,2394
<class,안산선,산본,7248,7643,14891
<class,안산선,대야미,2541,2315,4856
<class,안산선,반월,2046,2056,4102
<class,안산선,상록수,7554,7335,14889
<class,안산선,한대앞,4487,4247,8734
<class,안산선,중앙,9400,9533,18933
<class,안산선,고잔,3575,3506,7081
<class,안산선,초지,2010,1856,3866
<class,안산선,안산,7655,6928,14583
<class,안산선,신길온천,856,871,1727
<class,안산선,정왕,4317,4672,8989
<class,안산선,오이도,5126,5052,10178
<class,안산선,수리산,1739,1644,3383
<class,우이신설선,북한산우이,2524,2753,5277
<class,우이신설선,솔밭공원,1276,1313,2589
<class,우이신설선,4.19민주묘지,1765,1501,3266
<class,우이신설선,가오리,2144,1993,4137
<class,우이신설선,화계,1804,1702,3506
<class,우이신설선,삼양,1106,1116,2222
<class,우이신설선,삼양사거리,1343,1327,2670
<class,우이신설선,솔샘,2315,2130,4445
<class,우이신설선,북한산보국문,3111,2853,5964
<class,우이신설선,정릉,2244,1890,4134
<class,중앙선,상봉,3639,3550,7189
<class,분당선,상갈,2363,2489,4852
<class,경원선,양주,4332,4305,8637
<class,우이신설선,성신여대입구,1754,2065,3819
<class,우이신설선,보문,772,757,1529
<class,우이신설선,신설동,982,939,1921
<class,일산선,원흥,4562,4323,8885
<class,일산선,삼송,8909,8620,17529
<class,일산선,원당,5178,5038,10216
<class,일산선,화정,8096,8249,16345
<class,일산선,대곡,937,810,1747
<class,일산선,백석,4839,4792,9631
<class,일산선,마두,3049,3045,6094
<class,일산선,정발산,4517,4486,9003
<class,일산선,주엽,3861,3904,7765
<class,일산선,대화,5304,4876,10180
<class,장항선,봉명,502,534,1036
<class,장항선,쌍용,1134,1147,2281
<class,장항선,아산,2742,1816,4558
<class,장항선,배방,706,821,1527
<class,1호선,서울역,20334,18287,38621
<class,1호선,동묘앞,10991,11071,22062
<class,1호선,시청,5985,5857,11842
<class,1호선,종각,9632,8820,18452
<class,1호선,종로3가,12127,11088,23215
<class,1호선,종로5가,6992,7207,14199
<class,1호선,동대문,7459,8019,15478
<class,1호선,신설동,6204,6222,12426
<class,1호선,제기동,8618,9141,17759
<class,1호선,청량리,11800,11468,23268
<class,2호선,시청,4804,3948,8752
<class,2호선,을지로입구,12183,11618,23801
<class,2호선,을지로3가,5728,5459,11187
<class,2호선,을지로4가,2832,2806,5638
<class,2호선,동대문역사문화공원,5697,6981,12678
<class,2호선,신당,6830,7284,14114
<class,2호선,상왕십리,5797,5785,11582
<class,2호선,왕십리,7417,6279,13696
<class,2호선,한양대,2304,2469,4773
<class,2호선,뚝섬,8136,8736,16872
<class,2호선,성수,10718,12308,23026
<class,2호선,건대입구,20868,21940,42808
<class,2호선,구의,9395,9356,18751
<class,2호선,강변,17636,16475,34111
<class,2호선,잠실나루,4266,4327,8593
<class,2호선,잠실,36540,34443,70983
<class,2호선,잠실새내,8438,8824,17262
<class,2호선,종합운동장,2855,3178,6033
<class,2호선,삼성,14863,14592,29455
<class,2호선,선릉,10682,9115,19797
<class,2호선,역삼,8095,9067,17162
<class,2호선,강남,28246,26873,55119
<class,2호선,교대,8704,9587,18291
<class,2호선,서초,7965,7366,15331
<class,2호선,방배,5390,6084,11474
<class,2호선,사당,16542,18275,34817
<class,2호선,낙성대,13121,13575,26696
<class,2호선,서울대입구,22623,23497,46120
<class,2호선,봉천,10121,10091,20212
<class,2호선,신림,30737,30405,61142
<class,2호선,신대방,12520,12447,24967
<class,2호선,구로디지털단지,19159,18985,38144
<class,2호선,대림,11906,12204,24110
<class,2호선,신도림,22176,22447,44623
<class,2호선,문래,6636,7020,13656
<class,2호선,영등포구청,6667,6856,13523
<class,2호선,당산,7210,7728,14938
<class,2호선,합정,16519,17253,33772
<class,2호선,홍대입구,36420,36953,73373
<class,2호선,신촌,17158,17069,34227
<class,2호선,이대,6135,6548,12683
<class,2호선,아현,4413,4392,8805
<class,2호선,충정로,2962,3233,6195
<class,2호선,용답,1436,1440,2876
<class,2호선,신답,647,679,1326
<class,2호선,신설동,2385,2313,4698
<class,2호선,도림천,372,399,771
<class,2호선,양천구청,2724,2868,5592
<class,2호선,신정네거리,4387,4363,8750
<class,2호선,용두,1017,1004,2021
<class,3호선,지축,1774,1755,3529
<class,3호선,구파발,9785,10037,19822
<class,3호선,연신내,18375,17324,35699
<class,3호선,불광,7928,9371,17299
<class,3호선,녹번,6054,5491,11545
<class,3호선,홍제,7474,7195,14669
<class,3호선,무악재,1530,1612,3142
<class,3호선,독립문,3597,3680,7277
<class,3호선,경복궁,8605,9239,17844
<class,3호선,안국,7727,8582,16309
<class,3호선,종로3가,2787,3889,6676
<class,3호선,을지로3가,2278,2372,4650
<class,3호선,동대입구,3773,4228,8001
<class,3호선,약수,5287,5118,10405
<class,3호선,금호,3794,3592,7386
<class,3호선,옥수,4281,4547,8828
<class,3호선,압구정,11024,11522,22546
<class,3호선,신사,10894,11329,22223
<class,3호선,잠원,2105,2008,4113
<class,3호선,고속터미널,30776,27585,58361
<class,3호선,교대,3440,2101,5541
<class,3호선,남부터미널,13175,13357,26532
<class,3호선,양재,10342,12168,22510
<class,3호선,매봉,3370,3346,6716
<class,3호선,도곡,1539,1594,3133
<class,3호선,대치,5396,4604,10000
<class,3호선,학여울,791,774,1565
<class,3호선,대청,3485,3432,6917
<class,3호선,일원,2553,2834,5387
<class,3호선,수서,8467,8135,16602
<class,3호선,가락시장,3068,3332,6400
<class,3호선,경찰병원,2199,2257,4456
<class,3호선,오금,2288,2321,4609
<class,4호선,수유,16877,16121,32998
<class,4호선,미아,6633,6403,13036
<class,4호선,미아사거리,13470,12857,26327
<class,4호선,길음,8431,8173,16604
<class,4호선,성신여대입구,10508,10164,20672
<class,4호선,한성대입구,6367,6395,12762
<class,4호선,혜화,17265,18448,35713
<class,4호선,동대문,5250,5845,11095
<class,4호선,동대문역사문화공원,6495,6404,12899
<class,4호선,충무로,6661,7013,13674
<class,4호선,명동,7636,7942,15578
<class,4호선,회현,6394,6738,13132
<class,4호선,서울역,3187,6311,9498
<class,4호선,숙대입구,4958,4945,9903
<class,4호선,삼각지,1832,2392,4224
<class,4호선,신용산,6108,6351,12459
<class,4호선,이촌,3776,4305,8081
<class,4호선,동작,1371,1320,2691
<class,4호선,총신대입구,8245,9032,17277
<class,4호선,사당,11757,10778,22535
<class,4호선,남태령,520,415,935
<class,4호선,당고개,6701,6338,13039
<class,4호선,상계,8672,8133,16805
<class,4호선,노원,9746,10473,20219
<class,4호선,창동,12370,12868,25238
<class,4호선,쌍문,13111,11877,24988
<class,5호선,방화,3055,2987,6042
<class,5호선,개화산,2365,2396,4761
<class,5호선,김포공항,6160,5445,11605
<class,5호선,송정,3030,3171,6201
<class,5호선,마곡,3149,3224,6373
<class,5호선,발산,7125,7532,14657
<class,5호선,우장산,5574,5601,11175
<class,5호선,화곡,11567,11197,22764
<class,5호선,까치산,13064,12836,25900
<class,5호선,신정,5218,4819,10037
<class,5호선,목동,6304,6664,12968
<class,5호선,오목교,9527,9743,19270
<class,5호선,양평,2100,2263,4363
<class,5호선,영등포구청,1166,1136,2302
<class,5호선,영등포시장,3635,3788,7423
<class,5호선,신길,1493,1687,3180
<class,5호선,여의도,5868,6391,12259
<class,5호선,여의나루,7607,7921,15528
<class,5호선,마포,4045,4009,8054
<class,5호선,공덕,3586,3636,7222
<class,5호선,애오개,2168,2198,4366
<class,5호선,충정로,1185,1221,2406
<class,5호선,서대문,4037,4008,8045
<class,5호선,광화문,8859,9003,17862
<class,5호선,종로3가,6418,6329,12747
<class,5호선,을지로4가,1222,1321,2543
<class,5호선,동대문역사문화공원,530,607,1137
<class,5호선,청구,1505,1386,2891
<class,5호선,신금호,2425,2624,5049
<class,5호선,행당,3364,2947,6311
<class,5호선,왕십리,2147,2356,4503
<class,5호선,마장,2471,2391,4862
<class,5호선,답십리,6148,5736,11884
<class,5호선,장한평,6308,6270,12578
<class,5호선,군자,5106,5540,10646
<class,5호선,아차산,8231,8307,16538
<class,5호선,광나루,6403,6219,12622
<class,5호선,천호,10190,9555,19745
<class,5호선,강동,6910,6900,13810
<class,5호선,길동,3512,3609,7121
<class,5호선,굽은다리,4455,4126,8581
<class,5호선,명일,3696,3647,7343
<class,5호선,고덕,3649,3745,7394
<class,5호선,상일동,5580,5413,10993
<class,5호선,둔촌동,3747,3770,7517
<class,5호선,올림픽공원,1779,1594,3373
<class,5호선,방이,3167,3084,6251
<class,5호선,오금,1353,1237,2590
<class,5호선,개롱,2445,2756,5201
<class,5호선,거여,3319,3232,6551
<class,5호선,마천,2852,3002,5854
<class,5호선,강일,1566,1481,3047
<class,5호선,미사,7087,7182,14269
<class,5호선,하남풍산,1695,1792,3487
<class,5호선,하남시청,3258,3036,6294
<class,5호선,하남검단산,3464,3514,6978
<class,6호선,응암,7886,8072,15958
<class,6호선,역촌,1760,1985,3745
<class,6호선,불광,2365,2196,4561
<class,6호선,독바위,1357,1653,3010
<class,6호선,연신내,1,0,1
<class,6호선,구산,3285,2588,5873
<class,6호선,새절,5425,5247,10672
<class,6호선,증산,4702,4768,9470
<class,6호선,디지털미디어시티,4233,4453,8686
<class,6호선,월드컵경기장,4126,4090,8216
<class,6호선,마포구청,6135,5537,11672
<class,6호선,망원,8435,9126,17561
<class,6호선,합정,7884,7069,14953
<class,6호선,상수,4743,5631,10374
<class,6호선,광흥창,3433,3208,6641
<class,6호선,대흥,3240,3389,6629
<class,6호선,공덕,5661,5404,11065
<class,6호선,효창공원앞,2870,2471,5341
<class,6호선,삼각지,2985,2145,5130
<class,6호선,녹사평,3249,3182,6431
<class,6호선,이태원,6819,6831,13650
<class,6호선,한강진,4994,5678,10672
<class,6호선,버티고개,774,964,1738
<class,6호선,약수,1396,1332,2728
<class,6호선,청구,1460,1440,2900
<class,6호선,신당,3770,4490,8260
<class,6호선,동묘앞,5146,5193,10339
<class,6호선,창신,1412,1193,2605
<class,6호선,보문,3161,2988,6149
<class,6호선,안암,4007,4100,8107
<class,6호선,고려대,3503,3372,6875
<class,6호선,월곡,4639,4591,9230
<class,6호선,상월곡,2646,2463,5109
<class,6호선,돌곶이,3718,3528,7246
<class,6호선,석계,5299,5514,10813
<class,6호선,태릉입구,2661,2810,5471
<class,6호선,화랑대,4321,3651,7972
<class,6호선,봉화산,3408,3263,6671
<class,7호선,장암,1218,859,2077
<class,7호선,도봉산,4589,6589,11178
<class,7호선,수락산,7297,7271,14568
<class,7호선,마들,5036,4620,9656
<class,7호선,노원,9213,9392,18605
<class,7호선,중계,5714,5201,10915
<class,7호선,하계,7201,6905,14106
<class,7호선,공릉,5221,5349,10570
<class,7호선,태릉입구,4176,3923,8099
<class,7호선,먹골,4583,4470,9053
<class,7호선,중화,4736,4691,9427
<class,7호선,상봉,7787,7529,15316
<class,7호선,면목,6899,6833,13732
<class,7호선,사가정,7677,7568,15245
<class,7호선,용마산,2758,3023,5781
<class,7호선,중곡,4431,4284,8715
<class,7호선,군자,6243,5101,11344
<class,7호선,어린이대공원,5771,5889,11660
<class,7호선,건대입구,6570,6659,13229
<class,7호선,뚝섬유원지,6654,5724,12378
<class,7호선,청담,5329,5671,11000
<class,7호선,강남구청,4752,5172,9924
<class,7호선,학동,4297,4617,8914
<class,7호선,논현,5315,5835,11150
<class,7호선,반포,2592,2484,5076
<class,7호선,고속터미널,9446,6036,15482
<class,7호선,내방,4410,4577,8987
<class,7호선,이수,6730,6612,13342
<class,7호선,남성,4451,4417,8868
<class,7호선,숭실대입구,4792,5099,9891
<class,7호선,상도,4390,4488,8878
<class,7호선,장승배기,4238,4117,8355
<class,7호선,신대방삼거리,6697,6538,13235
<class,7호선,보라매,3540,3606,7146
<class,7호선,신풍,4913,4694,9607
<class,7호선,대림,5532,5256,10788
<class,7호선,남구로,5702,5521,11223
<class,7호선,가산디지털단지,8472,7786,16258
<class,7호선,철산,8595,8695,17290
<class,7호선,광명사거리,10400,10237,20637
<class,7호선,천왕,4249,4023,8272
<class,7호선,온수,3281,3281,6562
<class,7호선,까치울,3581,3557,7138
<class,7호선,부천종합운동장,2097,1933,4030
<class,7호선,춘의,2974,2898,5872
<class,7호선,신중동,5677,5543,11220
<class,7호선,부천시청,6120,5824,11944
<class,7호선,상동,5893,5844,11737
<class,7호선,삼산체육관,2216,2107,4323
<class,7호선,굴포천,3963,4050,8013
<class,7호선,부평구청,3151,2811,5962
<class,8호선,암사,7699,7359,15058
<class,8호선,천호,7262,8298,15560
<class,8호선,강동구청,3585,3756,7341
<class,8호선,몽촌토성,2701,2752,5453
<class,8호선,잠실,7700,8446,16146
<class,8호선,석촌,3540,4361,7901
<class,8호선,송파,3056,3225,6281
<class,8호선,가락시장,2693,3436,6129
<class,8호선,문정,4522,4672,9194
<class,8호선,장지,7620,7910,15530
<class,8호선,복정,4124,3841,7965
<class,8호선,산성,2882,2918,5800
<class,8호선,남한산성입구,5838,5512,11350
<class,8호선,단대오거리,4607,4612,9219
<class,8호선,신흥,2331,2475,4806
<class,8호선,수진,2604,2349,4953
<class,8호선,모란,3626,2992,6618
<class,9호선,개화,942,867,1809
<class,9호선,김포공항,6525,10141,16666
<class,9호선,공항시장,1424,1620,3044
<class,9호선,신방화,2875,2791,5666
<class,9호선,마곡나루,4650,4805,9455
<class,9호선,양천향교,3393,3643,7036
<class,9호선,가양,8037,8195,16232
<class,9호선,증미,2454,2501,4955
<class,9호선,등촌,4576,4593,9169
<class,9호선,염창,6871,6936,13807
<class,9호선,신목동,1374,1246,2620
<class,9호선,선유도,2282,2280,4562
<class,9호선,당산,7150,6981,14131
<class,9호선,국회의사당,2854,2827,5681
<class,9호선,여의도,6468,6132,12600
<class,9호선,샛강,1448,1391,2839
<class,9호선,노량진,12069,12830,24899
<class,9호선,노들,2013,1778,3791
<class,9호선,흑석,3144,3277,6421
<class,9호선,동작,969,801,1770
<class,9호선,구반포,780,834,1614
<class,9호선,신반포,1274,1278,2552
<class,9호선,고속터미널,8146,9939,18085
<class,9호선,사평,1206,1256,2462
<class,9호선,신논현,12636,12125,24761
<class,9호선2~3단계,언주,2601,2701,5302
<class,9호선2~3단계,선정릉,2609,2821,5430
<class,9호선2~3단계,삼성중앙,1602,1626,3228
<class,9호선2~3단계,봉은사,5608,5606,11214
<class,9호선2~3단계,종합운동장,1685,1601,3286
<class,9호선2~3단계,삼전,3015,2919,5934
<class,9호선2~3단계,석촌고분,2542,2500,5042
<class,9호선2~3단계,석촌,3801,3297,7098
<class,9호선2~3단계,송파나루,2316,2766,5082
<class,9호선2~3단계,한성백제,1068,1000,2068
<class,9호선2~3단계,올림픽공원,2577,2660,5237
<class,9호선2~3단계,둔촌오륜,344,396,740
<class,9호선2~3단계,중앙보훈병원,2773,2675,5448
<class,경강선,판교,2053,1937,3990
<class,경강선,이매,547,437,984
<class,경강선,삼동,953,878,1831
<class,경강선,경기광주,3174,3222,6396
<class,경강선,초월,1407,1350,2757
<class,경강선,곤지암,1208,1363,2571
<class,경강선,신둔도예촌,705,635,1340
<class,경강선,이천,1669,1837,3506
<class,경강선,부발,1036,1607,2643
<class,경강선,세종대왕릉,246,235,481
<class,경강선,여주,1682,1618,3300
<class,경부선,서울역,5113,1131,6244
<class,경부선,남영,3379,3621,7000
<class,경부선,용산,24464,21285,45749
<class,경부선,노량진,4684,4422,9106
<class,경부선,대방,4563,4999,9562
<class,경부선,영등포,24421,23566,47987
<class,경부선,신도림,1807,1915,3722
<class,경부선,신길,4061,3594,7655
<class,경부선,구로,7698,7801,15499
<class,경부선,가산디지털단지,3720,5300,9020
<class,경부선,금천구청,5434,5383,10817
<class,경부선,석수,4273,4152,8425
<class,경부선,관악,3848,3503,7351
<class,경부선,안양,11435,11106,22541
<class,경부선,명학,2676,2741,5417
<class,경부선,금정,11095,11513,22608
<class,경부선,군포,2555,2430,4985
<class,경부선,의왕,3568,3661,7229
<class,경부선,성균관대,6506,6938,13444
<class,경부선,화서,3133,3162,6295
<class,경부선,수원,26499,25748,52247
<class,경부선,독산,5142,5226,10368
<class,경부선,세류,1696,1651,3347
<class,경부선,병점,7637,8197,15834
<class,경부선,세마,1338,1223,2561
<class,경부선,오산대,1736,1681,3417
<class,경부선,오산,6335,6630,12965
<class,경부선,진위,622,643,1265
<class,경부선,송탄,2901,3224,6125
<class,경부선,서정리,3568,4846,8414
<class,경부선,평택지제,2024,1906,3930
<class,경부선,평택,9332,9502,18834
<class,경부선,성환,1891,2344,4235
<class,경부선,직산,505,549,1054
<class,경부선,두정,3481,3823,7304
<class,경부선,천안,5498,4987,10485
<class,경부선,당정,2574,2570,5144
<class,경부선,서동탄,658,691,1349
<class,경부선,광명,2078,1451,3529
<class,경원선,이촌,1870,1536,3406
<class,경원선,서빙고,937,934,1871
<class,경원선,한남,1712,1601,3313
<class,경원선,옥수,56,20,76
<class,경원선,응봉,940,848,1788
<class,경원선,왕십리,7723,9013,16736
<class,경원선,청량리,12179,10977,23156
<class,경원선,외대앞,3975,4027,8002
<class,경원선,신이문,4170,3814,7984
<class,경원선,석계,4297,4706,9003
<class,경원선,광운대,3669,3766,7435
<class,경원선,월계,3268,3127,6395
<class,경원선,녹천,2400,2097,4497
<class,경원선,창동,1,0,1
<class,경원선,방학,5076,4939,10015
<class,경원선,도봉,3079,2913,5992
<class,경원선,도봉산,7375,5286,12661
<class,경원선,망월사,3844,3867,7711
<class,경원선,회룡,6290,6141,12431
<class,경원선,의정부,11626,11769,23395
<class,경원선,가능,3416,3194,6610
<class,경원선,녹양,2253,2246,4499
<class,경원선,덕계,1505,1428,2933
<class,경원선,덕정,2857,2916,5773
<class,경원선,지행,3941,3849,7790
<class,경원선,동두천중앙,1881,1798,3679
<class,경원선,보산,1515,1423,2938
<class,경원선,동두천,1258,1514,2772
<class,경원선,소요산,3795,3193,6988
<class,경의선,서울역,954,812,1766
<class,경의선,신촌,276,268,544
<class,경의선,효창공원앞,1035,1254,2289
<class,경의선,공덕,1308,1172,2480
<class,경의선,서강대,1214,1112,2326
<class,경의선,홍대입구,1317,1477,2794
<class,경의선,가좌,2579,2616,5195
<class,경의선,디지털미디어시티,1147,1098,2245
<class,경의선,수색,743,842,1585
<class,경의선,화전,762,819,1581
<class,경의선,강매,1306,1195,2501
<class,경의선,행신,3702,3422,7124
<class,경의선,능곡,1841,1880,3721
<class,경의선,곡산,305,307,612
<class,경의선,백마,2892,2782,5674
<class,경의선,풍산,2991,2810,5801
<class,경의선,일산,3984,3766,7750
<class,경의선,탄현,3728,3434,7162
<class,경의선,야당,3733,3543,7276
<class,경의선,운정,3018,3014,6032
<class,경의선,금릉,2415,2406,4821
<class,경의선,금촌,3551,3794,7345
<class,경의선,월롱,727,1404,2131
<class,경의선,파주,619,515,1134
<class,경의선,문산,3122,3129,6251
<class,경의선,임진강,72,59,131
<class,경인선,개봉,9976,9874,19850
<class,경인선,오류동,5652,5472,11124
<class,경인선,역곡,12117,12128,24245
<class,경인선,부천,19027,18549,37576
<class,경인선,송내,11060,10888,21948
<class,경인선,부평,18776,19350,38126
<class,경인선,백운,3445,3312,6757
<class,경인선,동암,8190,8078,16268
<class,경인선,주안,9980,8743,18723
<class,경인선,제물포,4590,4506,9096
<class,경인선,동인천,8127,7729,15856
<class,경인선,인천,3407,2748,6155
<class,경인선,구일,2616,2524,5140
<class,경인선,소사,4579,4516,9095
<class,경인선,부개,4051,3809,7860
<class,경인선,간석,2690,2558,5248
<class,경인선,도원,1375,1429,2804
<class,경인선,온수,3040,2860,5900
<class,경인선,중동,4199,3861,8060
<class,경인선,도화,2065,1962,4027
<class,경춘선,신내,745,803,1548
<class,경춘선,갈매,1269,1139,2408
<class,경춘선,별내,1633,1541,3174
<class,경춘선,퇴계원,1817,1742,3559
<class,경춘선,사릉,1495,1450,2945
<class,경춘선,금곡,787,747,1534
<class,경춘선,평내호평,3075,2916,5991
<class,경춘선,천마산,957,948,1905
<class,경춘선,마석,2221,2214,4435
<class,경춘선,대성리,540,488,1028
<class,경춘선,청평,1428,1207,2635
<class,경춘선,상천,374,273,647
<class,경춘선,가평,1820,1560,3380
<class,경춘선,굴봉산,186,170,356
<class,경춘선,백양리,147,135,282
<class,경춘선,강촌,806,591,1397
<class,경춘선,김유정,450,437,887
<class,경춘선,남춘천,2026,1963,3989
<class,경춘선,춘천,1530,1264,2794
<class,공항철도 1호선,서울역,5725,5032,10757
<class,공항철도 1호선,공덕,915,1242,2157
<class,공항철도 1호선,홍대입구,7960,7389,15349
<class,공항철도 1호선,디지털미디어시티,2878,2928,5806
<class,공항철도 1호선,마곡나루,1999,2122,4121
<class,공항철도 1호선,김포공항,10680,5391,16071
<class,공항철도 1호선,계양,4219,4109,8328
<class,공항철도 1호선,검암,3228,3304,6532
<class,공항철도 1호선,청라국제도시,2673,2571,5244
<class,공항철도 1호선,운서,4253,4488,8741
<class,공항철도 1호선,공항화물청사,918,967,1885
<class,공항철도 1호선,인천공항1터미널,3240,3206,6446
<class,공항철도 1호선,인천공항2터미널,1734,1614,3348
<class,공항철도 1호선,영종,2057,1968,4025
<class,과천선,경마공원,742,714,1456
<class,과천선,대공원,3544,3640,7184
<class,과천선,과천,2622,2400,5022
<class,과천선,정부과천청사,3305,3525,6830
<class,과천선,인덕원,8988,9022,18010
<class,과천선,평촌,5186,4930,10116
<class,과천선,범계,11986,11649,23635
<class,분당선,선릉,2374,3489,5863
<class,분당선,한티,7666,7422,15088
<class,분당선,도곡,2124,2015,4139
<class,분당선,구룡,682,710,1392
<class,분당선,개포동,1418,1424,2842
<class,분당선,대모산입구,1833,1724,3557
<class,분당선,수서,7254,6637,13891
<class,분당선,수원,4819,4042,8861
<class,분당선,서울숲,5470,5512,10982
<class,분당선,압구정로데오,8642,9660,18302
<class,분당선,강남구청,2852,3345,6197
<class,분당선,선정릉,1769,1846,3615
<class,분당선,가천대,3257,3881,7138
<class,분당선,태평,7217,6727,13944
<class,분당선,모란,13634,14198,27832
<class,분당선,야탑,10490,10804,21294
<class,분당선,서현,11213,11378,22591
<class,분당선,수내,5149,4910,10059
<class,분당선,정자,6197,6377,12574
<class,분당선,미금,6012,6332,12344
<class,분당선,오리,4566,3989,8555
<class,분당선,이매,2622,2623,5245
<class,분당선,보정,927,818,1745
<class,분당선,죽전,6687,7606,14293
<class,분당선,구성,2008,2213,4221
<class,분당선,신갈,1650,1759,3409
<class,분당선,기흥,4251,4056,8307
<class,장항선,온양온천,4249,4077,8326
<class,중앙선,중랑,3004,2987,5991
<class,장항선,신창,1029,1415,2444
<class,중앙선,회기,12721,13045,25766
<class,중앙선,지평,33,52,85
<class,중앙선,용문,2035,1655,3690
<class,중앙선,원덕,317,255,572
<class,중앙선,양평,2197,1923,4120
<class,중앙선,오빈,260,214,474
<class,중앙선,아신,509,417,926
<class,중앙선,국수,517,476,993
<class,중앙선,신원,282,165,447
<class,중앙선,양수,1759,1691,3450
<class,중앙선,운길산,1112,993,2105
<class,중앙선,팔당,1236,1259,2495
<class,중앙선,도심,1048,986,2034
<class,중앙선,덕소,2949,3014,5963
<class,중앙선,양정,450,369,819
<class,중앙선,도농,4111,4090,8201
<class,중앙선,구리,6381,6697,13078
<class,중앙선,양원,826,848,1674
<class,중앙선,망우,4138,4186,8324
<class,과천선,선바위,2986,2873,5859
<class,분당선,청명,1634,1653,3287
<class,분당선,영통,3845,3945,7790
<class,1호선,동묘앞,10958,11133,22091
<class,1호선,시청,8521,8546,17067
<class,1호선,종각,15128,13917,29045
<class,1호선,종로3가,19780,18399,38179
<class,1호선,종로5가,15828,15940,31768
<class,1호선,동대문,10089,9002,19091
<class,1호선,신설동,8523,8063,16586
<class,1호선,제기동,15135,15598,30733
<class,1호선,청량리,16839,17387,34226
<class,2호선,시청,7268,6234,13502
<class,2호선,을지로입구,17675,17175,34850
<class,2호선,을지로3가,8713,8679,17392
<class,2호선,을지로4가,6778,6924,13702
<class,2호선,동대문역사문화공원,8808,9129,17937
<class,2호선,신당,9824,10183,20007
<class,2호선,상왕십리,8880,8513,17393
<class,2호선,왕십리,11253,9214,20467
<class,2호선,한양대,3018,2886,5904
<class,2호선,뚝섬,13028,13397,26425
<class,2호선,성수,16285,19406,35691
<class,2호선,건대입구,28613,30656,59269
<class,2호선,구의,14419,14144,28563
<class,2호선,강변,22448,23337,45785
<class,2호선,잠실나루,6940,6789,13729
<class,2호선,잠실,52188,50031,102219
<class,2호선,잠실새내,14255,14802,29057
<class,2호선,종합운동장,4185,4518,8703
<class,2호선,삼성,22057,22113,44170
<class,2호선,선릉,20584,18324,38908
<class,2호선,역삼,15302,16529,31831
<class,2호선,강남,51612,50735,102347
<class,2호선,교대,15128,17064,32192
<class,2호선,서초,8840,7530,16370
<class,2호선,방배,8440,8846,17286
<class,2호선,사당,25457,27481,52938
<class,2호선,낙성대,19611,17847,37458
<class,2호선,서울대입구,34145,33109,67254
<class,2호선,봉천,15624,14448,30072
<class,2호선,신림,44750,42655,87405
<class,2호선,신대방,18228,17742,35970
<class,2호선,구로디지털단지,29807,29450,59257
<class,2호선,대림,16035,16969,33004
<class,2호선,신도림,34057,34356,68413
<class,2호선,문래,10463,11011,21474
<class,2호선,영등포구청,10793,10981,21774
<class,2호선,당산,11483,12428,23911
<class,2호선,합정,23332,25355,48687
<class,2호선,홍대입구,50402,54030,104432
<class,2호선,신촌,26322,26453,52775
<class,2호선,이대,9233,9436,18669
<class,2호선,아현,6695,6224,12919
<class,2호선,충정로,4819,5084,9903
<class,2호선,용답,1990,1808,3798
<class,2호선,신답,883,929,1812
<class,2호선,신설동,2906,1475,4381
<class,2호선,도림천,740,701,1441
<class,2호선,양천구청,4287,4329,8616
<class,2호선,신정네거리,6448,6628,13076
<class,2호선,용두,1687,1598,3285
<class,3호선,지축,2857,2702,5559
<class,3호선,구파발,14107,14185,28292
<class,3호선,연신내,27183,25490,52673
<class,3호선,불광,11799,13616,25415
<class,3호선,녹번,9107,8195,17302
<class,3호선,홍제,11614,10913,22527
<class,3호선,무악재,2452,2591,5043
<class,3호선,독립문,5292,5575,10867
<class,3호선,경복궁,14231,15753,29984
<class,3호선,안국,12013,13833,25846
<class,3호선,종로3가,4986,7120,12106
<class,3호선,을지로3가,4480,4680,9160
<class,3호선,동대입구,5270,5721,10991
<class,3호선,약수,8225,7716,15941
<class,3호선,금호,5352,4903,10255
<class,3호선,옥수,6689,6640,13329
<class,3호선,압구정,22868,23774,46642
<class,3호선,신사,21098,22333,43431
<class,3호선,잠원,3402,3136,6538
<class,3호선,고속터미널,39199,40051,79250
<class,3호선,교대,6006,3551,9557
<class,3호선,남부터미널,17957,18584,36541
<class,3호선,양재,17309,18871,36180
<class,3호선,매봉,5388,5164,10552
<class,3호선,도곡,2912,2746,5658
<class,3호선,대치,8878,7943,16821
<class,3호선,학여울,2035,2163,4198
<class,3호선,대청,5259,4892,10151
<class,3호선,일원,4577,4521,9098
<class,3호선,수서,11078,11350,22428
<class,3호선,가락시장,5685,5489,11174
<class,3호선,경찰병원,3673,3523,7196
<class,3호선,오금,3579,3472,7051
<class,4호선,수유,23527,22868,46395
<class,4호선,미아,9728,9097,18825
<class,4호선,미아사거리,19879,19046,38925
<class,4호선,길음,12477,11597,24074
<class,4호선,성신여대입구,14912,14080,28992
<class,4호선,한성대입구,9693,9264,18957
<class,4호선,혜화,22045,23107,45152
<class,4호선,동대문,13103,13184,26287
<class,4호선,동대문역사문화공원,9640,8580,18220
<class,4호선,충무로,11057,11633,22690
<class,4호선,명동,11331,12904,24235
<class,4호선,회현,15555,16674,32229
<class,4호선,서울역,4560,9299,13859
<class,4호선,숙대입구,7763,7371,15134
<class,4호선,삼각지,2877,3794,6671
<class,4호선,신용산,8740,9539,18279
<class,4호선,이촌,5631,6420,12051
<class,4호선,동작,1975,1981,3956
<class,4호선,총신대입구,12933,14009,26942
<class,4호선,사당,17041,15051,32092
<class,4호선,남태령,804,650,1454
<class,4호선,당고개,8861,8433,17294
<class,4호선,상계,12881,12045,24926
<class,4호선,노원,14128,15575,29703
<class,4호선,창동,17237,18167,35404
<class,4호선,쌍문,19381,17748,37129
<class,5호선,개화산,3534,3448,6982
<class,5호선,김포공항,6280,6220,12500
<class,5호선,송정,4581,4465,9046
<class,5호선,마곡,4909,4931,9840
<class,5호선,발산,11896,12770,24666
<class,5호선,우장산,8874,8776,17650
<class,5호선,화곡,18326,16751,35077
<class,5호선,까치산,19212,18519,37731
<class,5호선,신정,8044,6915,14959
<class,5호선,목동,10231,10351,20582
<class,5호선,오목교,14495,15082,29577
<class,5호선,양평,3254,3111,6365
<class,5호선,영등포구청,1751,1751,3502
<class,5호선,영등포시장,5918,6163,12081
<class,5호선,신길,2180,2386,4566
<class,5호선,여의도,9222,10264,19486
<class,5호선,여의나루,13082,13598,26680
<class,5호선,마포,6467,6439,12906
<class,5호선,공덕,6051,6086,12137
<class,5호선,애오개,3239,3069,6308
<class,5호선,충정로,1764,1584,3348
<class,5호선,서대문,6251,6244,12495
<class,5호선,광화문,12711,12541,25252
<class,5호선,종로3가,10031,10629,20660
<class,5호선,을지로4가,3221,3452,6673
<class,5호선,동대문역사문화공원,903,1176,2079
<class,5호선,청구,2301,2067,4368
<class,5호선,신금호,3776,3751,7527
<class,5호선,행당,5096,4458,9554
<class,5호선,왕십리,3274,3724,6998
<class,5호선,마장,3581,3406,6987
<class,5호선,답십리,9166,8388,17554
<class,5호선,장한평,10302,10024,20326
<class,5호선,군자,7385,8099,15484
<class,5호선,아차산,11978,11490,23468
<class,5호선,광나루,8966,8725,17691
<class,5호선,천호,14622,14094,28716
<class,5호선,강동,10850,10390,21240
<class,5호선,길동,5400,5498,10898
<class,5호선,굽은다리,6508,6071,12579
<class,5호선,명일,5427,5431,10858
<class,5호선,고덕,5866,5710,11576
<class,5호선,상일동,8698,8231,16929
<class,5호선,둔촌동,5666,5586,11252
<class,5호선,올림픽공원,2940,2748,5688
<class,5호선,방이,4885,4734,9619
<class,5호선,오금,2257,2034,4291
<class,5호선,개롱,4075,4437,8512
<class,5호선,거여,5318,5090,10408
<class,5호선,마천,4175,4314,8489
<class,5호선,강일,2344,2157,4501
<class,5호선,미사,10522,10563,21085
<class,5호선,하남풍산,2399,2524,4923
<class,5호선,하남시청,4572,4459,9031
<class,5호선,하남검단산,4685,4743,9428
<class,6호선,응암,11563,11279,22842
<class,6호선,역촌,2554,2983,5537
<class,6호선,불광,3397,3133,6530
<class,6호선,독바위,1958,2222,4180
<class,6호선,구산,5067,3756,8823
<class,6호선,새절,8129,7828,15957
<class,6호선,증산,6678,6537,13215
<class,6호선,디지털미디어시티,6473,6542,13015
<class,6호선,월드컵경기장,5026,5136,10162
<class,6호선,마포구청,8762,7624,16386
<class,6호선,망원,12100,13532,25632
<class,6호선,합정,10984,9908,20892
<class,6호선,상수,6408,7708,14116
<class,6호선,광흥창,4783,4240,9023
<class,6호선,대흥,5011,4974,9985
<class,6호선,공덕,8634,8083,16717
<class,6호선,효창공원앞,4228,3597,7825
<class,6호선,삼각지,4573,3523,8096
<class,6호선,녹사평,4886,4930,9816
<class,6호선,이태원,9372,10194,19566
<class,6호선,한강진,8334,9727,18061
<class,6호선,버티고개,1168,1343,2511
<class,6호선,약수,2253,2179,4432
<class,6호선,청구,2260,2242,4502
<class,6호선,신당,5772,5117,10889
<class,6호선,동묘앞,7281,6887,14168
<class,6호선,창신,2007,1636,3643
<class,6호선,보문,4648,4145,8793
<class,6호선,안암,6080,5797,11877
<class,6호선,고려대,5085,4768,9853
<class,6호선,월곡,6864,6584,13448
<class,6호선,상월곡,3777,3385,7162
<class,6호선,돌곶이,5284,5026,10310
<class,6호선,석계,8115,8175,16290
<class,6호선,태릉입구,3704,3980,7684
<class,6호선,화랑대,6170,5154,11324
<class,6호선,봉화산,4970,4877,9847
<class,7호선,장암,1471,1137,2608
<class,7호선,도봉산,6387,8746,15133
<class,7호선,수락산,9612,9551,19163
<class,7호선,마들,8197,7715,15912
<class,7호선,노원,14516,15103,29619
<class,7호선,중계,8598,7789,16387
<class,7호선,하계,11014,10194,21208
<class,7호선,공릉,7711,7795,15506
<class,7호선,태릉입구,5956,5612,11568
<class,7호선,먹골,7289,7099,14388
<class,7호선,중화,7017,6582,13599
<class,7호선,상봉,11901,11143,23044
<class,7호선,면목,10368,10241,20609
<class,7호선,사가정,11516,10976,22492
<class,7호선,용마산,4205,4399,8604
<class,7호선,중곡,6414,5972,12386
<class,7호선,군자,9665,7444,17109
<class,7호선,어린이대공원,8387,8131,16518
<class,7호선,건대입구,9352,9601,18953
<class,7호선,뚝섬유원지,11245,9915,21160
<class,7호선,청담,9573,10256,19829
<class,7호선,강남구청,8534,9412,17946
<class,7호선,학동,8650,9007,17657
<class,7호선,논현,10153,10959,21112
<class,7호선,반포,3991,3744,7735
<class,7호선,고속터미널,11039,8907,19946
<class,7호선,내방,7236,7150,14386
<class,7호선,이수,10608,9979,20587
<class,7호선,남성,7126,6386,13512
<class,7호선,숭실대입구,7425,7353,14778
<class,7호선,장승배기,6133,5692,11825
<class,7호선,신대방삼거리,10318,9562,19880
<class,7호선,보라매,5488,5295,10783
<class,7호선,신풍,7193,6941,14134
<class,7호선,대림,6235,6652,12887
<class,7호선,남구로,7576,7876,15452
<class,7호선,가산디지털단지,12778,11694,24472
<class,7호선,철산,13705,13750,27455
<class,7호선,광명사거리,15330,15371,30701
<class,7호선,천왕,6215,5811,12026
<class,7호선,온수,5121,5051,10172
<class,7호선,까치울,4950,5006,9956
<class,7호선,부천종합운동장,3045,2721,5766
<class,7호선,춘의,4749,4596,9345
<class,7호선,신중동,8649,8584,17233
<class,7호선,부천시청,8789,8738,17527
<class,7호선,상동,9125,9287,18412
<class,7호선,삼산체육관,3252,3012,6264
<class,7호선,굴포천,5954,6081,12035
<class,7호선,부평구청,4513,3959,8472
<class,8호선,암사,11452,10537,21989
<class,8호선,천호,10854,12452,23306
<class,8호선,강동구청,5492,5498,10990
<class,8호선,몽촌토성,4398,4248,8646
<class,8호선,잠실,10569,12167,22736
<class,8호선,석촌,5254,6601,11855
<class,8호선,송파,4698,4708,9406
<class,8호선,가락시장,5357,5404,10761
<class,8호선,문정,7270,7370,14640
<class,8호선,장지,11128,10309,21437
<class,8호선,복정,6626,5593,12219
<class,8호선,산성,4146,4220,8366
<class,8호선,남한산성입구,8519,7607,16126
<class,8호선,단대오거리,7100,6611,13711
<class,8호선,신흥,3413,3613,7026
<class,8호선,수진,4007,3589,7596
<class,8호선,모란,4938,4290,9228
<class,9호선,개화,1460,1202,2662
<class,9호선,김포공항,6575,10712,17287
<class,9호선,공항시장,1974,2125,4099
<class,9호선,신방화,4196,4098,8294
<class,9호선,마곡나루,6902,6922,13824
<class,9호선,양천향교,5293,5220,10513
<class,9호선,가양,12626,11708,24334
<class,9호선,증미,3840,3719,7559
<class,9호선,등촌,6853,6683,13536
<class,9호선,염창,10303,9581,19884
<class,9호선,신목동,2122,1794,3916
<class,9호선,선유도,3714,3557,7271
<class,9호선,당산,11312,10489,21801
<class,9호선,국회의사당,3307,3347,6654
<class,9호선,여의도,9748,9668,19416
<class,9호선,샛강,2165,2273,4438
<class,9호선,노량진,18974,18666,37640
<class,9호선,노들,3143,2585,5728
<class,9호선,흑석,5031,4999,10030
<class,9호선,동작,1469,1201,2670
<class,9호선,구반포,1573,1640,3213
<class,9호선,신반포,2305,2270,4575
<class,9호선,고속터미널,10817,14872,25689
<class,9호선,사평,1896,1795,3691
<class,9호선,신논현,21641,21223,42864
<class,9호선2~3단계,언주,4913,5018,9931
<class,9호선2~3단계,선정릉,4291,4681,8972
<class,9호선2~3단계,삼성중앙,2572,2593,5165
<class,9호선2~3단계,봉은사,8171,8409,16580
<class,9호선2~3단계,종합운동장,2666,2384,5050
<class,9호선2~3단계,삼전,4557,4302,8859
<class,9호선2~3단계,석촌고분,3726,3646,7372
<class,9호선2~3단계,석촌,5749,4985,10734
<class,9호선2~3단계,송파나루,3480,3931,7411
<class,9호선2~3단계,한성백제,1842,1573,3415
<class,9호선2~3단계,올림픽공원,4977,4952,9929
<class,9호선2~3단계,둔촌오륜,574,551,1125
<class,9호선2~3단계,중앙보훈병원,4060,3784,7844
<class,경강선,판교,2771,2608,5379
<class,경강선,이매,799,628,1427
<class,경강선,삼동,1387,1319,2706
<class,경강선,경기광주,4690,4452,9142
<class,경강선,초월,1994,1919,3913
<class,경강선,곤지암,1689,1872,3561
<class,경강선,신둔도예촌,992,1012,2004
<class,경강선,이천,2422,2544,4966
<class,경강선,부발,1598,1372,2970
<class,경강선,세종대왕릉,279,352,631
<class,경강선,여주,2112,2347,4459
<class,경부선,서울역,4462,1352,5814
<class,경부선,남영,5006,5143,10149
<class,경부선,용산,28037,30272,58309
<class,경부선,노량진,7474,6827,14301
<class,경부선,대방,7106,7056,14162
<class,경부선,영등포,32197,33937,66134
<class,경부선,신도림,2673,2617,5290
<class,경부선,신길,5819,4690,10509
<class,경부선,구로,11546,11783,23329
<class,경부선,가산디지털단지,5467,7350,12817
<class,경부선,금천구청,7492,7481,14973
<class,경부선,석수,6465,6015,12480
<class,경부선,관악,5153,4990,10143
<class,경부선,안양,16001,16265,32266
<class,경부선,명학,4581,4394,8975
<class,경부선,금정,16439,16214,32653
<class,경부선,군포,3987,3668,7655
<class,경부선,의왕,5497,5335,10832
<class,경부선,성균관대,9105,9131,18236
<class,경부선,화서,4677,4720,9397
<class,경부선,수원,31695,34285,65980
<class,경부선,독산,8168,7958,16126
<class,경부선,세류,2221,2197,4418
<class,경부선,병점,10893,10699,21592
<class,경부선,세마,1936,1751,3687
<class,경부선,오산대,2525,2371,4896
<class,경부선,오산,8240,7802,16042
<class,경부선,진위,965,890,1855
<class,경부선,송탄,4521,3887,8408
<class,경부선,서정리,5633,4919,10552
<class,경부선,평택지제,2673,2598,5271
<class,경부선,평택,12039,11457,23496
<class,경부선,성환,2712,2628,5340
<class,경부선,직산,608,615,1223
<class,경부선,두정,4288,4437,8725
<class,경부선,천안,5823,6123,11946
<class,경부선,당정,3686,3522,7208
<class,경부선,서동탄,899,956,1855
<class,경부선,광명,2143,1922,4065
<class,경원선,이촌,3023,2053,5076
<class,경원선,서빙고,1326,1170,2496
<class,경원선,한남,2706,2515,5221
<class,경원선,옥수,43,45,88
<class,경원선,응봉,1278,1087,2365
<class,경원선,왕십리,10976,13003,23979
<class,경원선,청량리,14421,15798,30219
<class,경원선,외대앞,5432,5255,10687
<class,경원선,신이문,5600,5159,10759
<class,경원선,석계,6337,6691,13028
<class,경원선,광운대,5174,5044,10218
<class,경원선,월계,4360,4024,8384
<class,경원선,녹천,3126,2682,5808
<class,경원선,방학,6861,6701,13562
<class,경원선,도봉,4211,3978,8189
<class,경원선,도봉산,8911,6302,15213
<class,경원선,망월사,5173,5337,10510
<class,경원선,회룡,9008,8936,17944
<class,경원선,의정부,15387,16194,31581
<class,경원선,가능,4753,4578,9331
<class,경원선,녹양,3319,3187,6506
<class,경원선,양주,6086,5824,11910
<class,경원선,덕계,2203,2033,4236
<class,경원선,덕정,3968,3776,7744
<class,경원선,지행,5271,5243,10514
<class,경원선,동두천중앙,2431,2409,4840
<class,경원선,보산,2024,1909,3933
<class,경원선,동두천,1545,2051,3596
<class,경원선,소요산,4221,3708,7929
<class,경의선,서울역,1132,1200,2332
<class,경의선,신촌,328,366,694
<class,경의선,효창공원앞,1527,1798,3325
<class,경의선,공덕,2114,1739,3853
<class,경의선,서강대,1645,1438,3083
<class,경의선,홍대입구,1729,1987,3716
<class,경의선,가좌,3538,3448,6986
<class,경의선,디지털미디어시티,1747,1604,3351
<class,경의선,수색,1361,1286,2647
<class,경의선,화전,978,937,1915
<class,경의선,강매,1797,1735,3532
<class,경의선,행신,4694,4741,9435
<class,경의선,능곡,2762,2645,5407
<class,경의선,곡산,401,421,822
<class,경의선,백마,3910,3735,7645
<class,경의선,풍산,3991,3890,7881
<class,경의선,일산,5734,5452,11186
<class,경의선,탄현,4759,4727,9486
<class,경의선,야당,5093,5004,10097
<class,경의선,운정,4351,4123,8474
<class,경의선,금릉,3476,3370,6846
<class,경의선,금촌,4951,4866,9817
<class,경의선,월롱,1392,1369,2761
<class,경의선,파주,829,643,1472
<class,경의선,문산,4790,4661,9451
<class,경의선,임진강,116,80,196
<class,경인선,개봉,14720,14636,29356
<class,경인선,오류동,8391,7772,16163
<class,경인선,역곡,18331,17979,36310
<class,경인선,부천,25927,26666,52593
<class,경인선,송내,16105,15904,32009
<class,경인선,부평,25710,27836,53546
<class,경인선,백운,4933,4873,9806
<class,경인선,동암,11421,11801,23222
<class,경인선,주안,13960,12509,26469
<class,경인선,제물포,6495,6502,12997
<class,경인선,동인천,10892,10780,21672
<class,경인선,인천,4385,3790,8175
<class,경인선,구일,3837,3690,7527
<class,경인선,소사,6333,6223,12556
<class,경인선,부개,5837,5589,11426
<class,경인선,간석,4038,3854,7892
<class,경인선,도원,1926,1972,3898
<class,경인선,온수,4505,4157,8662
<class,경인선,중동,6122,5842,11964
<class,경인선,도화,2982,2774,5756
<class,경춘선,신내,1097,1094,2191
<class,경춘선,갈매,1832,1588,3420
<class,경춘선,별내,2286,2161,4447
<class,경춘선,퇴계원,2495,2280,4775
<class,경춘선,사릉,2097,2118,4215
<class,경춘선,금곡,1083,989,2072
<class,경춘선,평내호평,4349,4343,8692
<class,경춘선,천마산,1286,1269,2555
<class,경춘선,마석,3128,3241,6369
<class,경춘선,대성리,790,768,1558
<class,경춘선,청평,1648,1727,3375
<class,경춘선,상천,456,438,894
<class,경춘선,가평,1934,2189,4123
<class,경춘선,굴봉산,219,202,421
<class,경춘선,백양리,151,164,315
<class,경춘선,강촌,812,883,1695
<class,경춘선,김유정,620,783,1403
<class,경춘선,남춘천,2422,2561,4983
<class,경춘선,춘천,1896,1762,3658
<class,공항철도 1호선,서울역,5679,5980,11659
<class,공항철도 1호선,공덕,1280,1750,3030
<class,공항철도 1호선,홍대입구,10325,9986,20311
<class,공항철도 1호선,디지털미디어시티,4316,4088,8404
<class,공항철도 1호선,마곡나루,2889,3136,6025
<class,공항철도 1호선,김포공항,9444,5103,14547
<class,공항철도 1호선,계양,6055,5871,11926
<class,공항철도 1호선,검암,4363,4457,8820
<class,공항철도 1호선,청라국제도시,3639,3500,7139
<class,공항철도 1호선,운서,5487,5667,11154
<class,공항철도 1호선,공항화물청사,1347,1371,2718
<class,공항철도 1호선,인천공항1터미널,3232,3353,6585
<class,공항철도 1호선,인천공항2터미널,1888,1641,3529
<class,공항철도 1호선,영종,2603,2800,5403
<class,과천선,선바위,4546,4026,8572
<class,과천선,경마공원,956,952,1908
<class,과천선,대공원,5598,5903,11501
<class,과천선,과천,4027,3565,7592
<class,과천선,정부과천청사,5413,5456,10869
<class,과천선,인덕원,13777,13390,27167
<class,과천선,평촌,8178,7961,16139
<class,과천선,범계,17797,17119,34916
<class,분당선,선릉,4630,6853,11483
<class,분당선,한티,11575,11254,22829
<class,분당선,도곡,3931,3539,7470
<class,분당선,구룡,1208,1038,2246
<class,분당선,개포동,2415,2369,4784
<class,분당선,대모산입구,2560,2360,4920
<class,분당선,수서,8780,9379,18159
<class,분당선,수원,6241,5384,11625
<class,분당선,서울숲,8889,8866,17755
<class,분당선,압구정로데오,16156,17961,34117
<class,분당선,강남구청,4503,5501,10004
<class,분당선,선정릉,2969,3057,6026
<class,분당선,가천대,4709,5203,9912
<class,분당선,태평,10212,9521,19733
<class,분당선,모란,20659,21285,41944
<class,분당선,야탑,15376,16226,31602
<class,분당선,서현,16683,16924,33607
<class,분당선,수내,8084,7580,15664
<class,분당선,정자,9671,10013,19684
<class,분당선,미금,10117,10422,20539
<class,분당선,오리,7261,6104,13365
<class,분당선,이매,3862,3702,7564
<class,분당선,보정,1506,1323,2829
<class,분당선,죽전,9477,10380,19857
<class,분당선,구성,2949,3130,6079
<class,분당선,신갈,2527,2562,5089
<class,분당선,기흥,6141,5892,12033
<class,분당선,상갈,3658,3587,7245
<class,일산선,백석,6864,6809,13673
<class,일산선,마두,4701,4776,9477
<class,일산선,정발산,5791,5885,11676
<class,일산선,주엽,5990,5880,11870
<class,일산선,대화,7775,7009,14784
<class,장항선,봉명,805,747,1552
<class,장항선,쌍용,1561,1402,2963
<class,장항선,아산,2561,2445,5006
<class,장항선,배방,911,938,1849
<class,장항선,온양온천,5285,5246,10531
<class,장항선,신창,1270,1193,2463
<class,중앙선,회기,17918,16937,34855
<class,중앙선,중랑,4179,4043,8222
<class,중앙선,상봉,4828,4664,9492
<class,중앙선,망우,5819,5747,11566
<class,중앙선,양원,1270,1253,2523
<class,중앙선,구리,9448,9703,19151
<class,5호선,방화,4408,4156,8564
<class,분당선,청명,2326,2274,4600
<class,분당선,영통,5828,5797,11625
<class,분당선,망포,8052,7587,15639
<class,분당선,매탄권선,3090,2945,6035
<class,분당선,수원시청,8739,9240,17979
<class,분당선,매교,1869,1933,3802
<class,수인선,고색,2078,2051,4129
<class,수인선,오목천,1897,1653,3550
<class,수인선,어천,685,574,1259
<class,수인선,야목,212,195,407
<class,1호선,서울역,24158,24874,49032
<class,수인선,사리,3082,2751,5833
<class,수인선,달월,64,66,130
<class,수인선,월곶,1999,1945,3944
<class,수인선,소래포구,6206,6440,12646
<class,수인선,인천논현,4180,4276,8456
<class,수인선,호구포,2352,2320,4672
<class,수인선,남동인더스파크,969,955,1924
<class,수인선,원인재,3539,3626,7165
<class,수인선,연수,3342,3301,6643
<class,수인선,송도,1980,1909,3889
<class,수인선,인하대,4055,3787,7842
<class,수인선,숭의,2620,2446,5066
<class,수인선,신포,1398,1452,2850
<class,수인선,인천,1244,1901,3145
<class,안산선,산본,10950,11772,22722
<class,안산선,대야미,3636,3172,6808
<class,안산선,반월,3041,2927,5968
<class,안산선,상록수,10909,11010,21919
<class,안산선,한대앞,6508,6355,12863
<class,안산선,중앙,13528,13997,27525
<class,안산선,고잔,5535,5435,10970
<class,안산선,초지,2761,3012,5773
<class,안산선,안산,8449,8497,16946
<class,안산선,신길온천,1202,1246,2448
<class,안산선,정왕,5609,5761,11370
<class,안산선,오이도,7322,7576,14898
<class,안산선,수리산,2695,2461,5156
<class,우이신설선,북한산우이,3343,3486,6829
<class,우이신설선,솔밭공원,1698,1674,3372
<class,우이신설선,4.19민주묘지,2364,1928,4292
<class,우이신설선,가오리,2863,2788,5651
<class,우이신설선,화계,2347,2263,4610
<class,우이신설선,삼양,1452,1538,2990
<class,우이신설선,삼양사거리,1773,1746,3519
<class,우이신설선,솔샘,3530,3172,6702
<class,우이신설선,북한산보국문,4349,3856,8205
<class,우이신설선,정릉,3323,2715,6038
<class,우이신설선,성신여대입구,2680,3061,5741
<class,7호선,상도,6728,6207,12935
<class,경의선,검암,1,0,1
<class,중앙선,도농,6127,5876,12003
<class,중앙선,양정,565,511,1076
<class,중앙선,덕소,4299,4354,8653
<class,중앙선,도심,1491,1314,2805
<class,중앙선,팔당,1602,1739,3341
<class,중앙선,운길산,1490,1505,2995
<class,중앙선,양수,2265,2277,4542
<class,중앙선,신원,315,262,577
<class,중앙선,국수,684,711,1395
<class,중앙선,아신,590,566,1156
<class,중앙선,오빈,258,311,569
<class,중앙선,양평,2620,2714,5334
<class,중앙선,원덕,457,395,852
<class,중앙선,용문,2172,2474,4646
<class,중앙선,지평,56,91,147
<class,우이신설선,보문,1041,1045,2086
<class,우이신설선,신설동,1314,1267,2581
<class,일산선,원흥,6725,6499,13224
<class,일산선,삼송,12609,12489,25098
<class,일산선,원당,7794,7489,15283
<class,일산선,화정,11656,12011,23667
<class,일산선,대곡,1319,1150,2469
<class,공항철도 1호선,인천공항1터미널,3299,3185,6484
<class,일산선,원당,5657,5473,11130
<class,일산선,원흥,4893,4598,9491
<class,우이신설선,신설동,1073,1085,2158
<class,우이신설선,보문,849,825,1674
<class,우이신설선,성신여대입구,1952,2230,4182
<class,우이신설선,정릉,2318,1993,4311
<class,우이신설선,북한산보국문,3332,3058,6390
<class,우이신설선,솔샘,2420,2254,4674
<class,우이신설선,삼양사거리,1406,1316,2722
<class,우이신설선,삼양,1110,1172,2282
<class,우이신설선,화계,1813,1727,3540
<class,우이신설선,가오리,2127,2068,4195
<class,우이신설선,4.19민주묘지,1946,1659,3605
<class,우이신설선,솔밭공원,1297,1255,2552
<class,우이신설선,북한산우이,3108,3324,6432
<class,안산선,수리산,1919,1968,3887
<class,안산선,오이도,5795,5568,11363
<class,안산선,정왕,4626,5080,9706
<class,안산선,신길온천,1003,921,1924
<class,안산선,안산,8016,7478,15494
<class,안산선,초지,2197,2074,4271
<class,안산선,고잔,4181,3957,8138
<class,안산선,중앙,9738,9824,19562
<class,안산선,한대앞,4805,4728,9533
<class,안산선,상록수,8020,7814,15834
<class,안산선,반월,2217,2141,4358
<class,안산선,대야미,2761,2510,5271
<class,안산선,산본,7664,8204,15868
<class,수인선,인천,1073,1654,2727
<class,수인선,신포,1076,1074,2150
<class,수인선,숭의,1865,1707,3572
<class,수인선,인하대,2918,2932,5850
<class,수인선,송도,1427,1384,2811
<class,수인선,연수,2592,2516,5108
<class,수인선,원인재,2632,2756,5388
<class,수인선,남동인더스파크,575,591,1166
<class,수인선,호구포,1644,1612,3256
<class,수인선,인천논현,2686,2789,5475
<class,수인선,소래포구,5722,5568,11290
<class,수인선,월곶,1562,1444,3006
<class,수인선,달월,50,44,94
<class,수인선,사리,2391,1993,4384
<class,수인선,야목,161,150,311
<class,수인선,어천,455,579,1034
<class,수인선,오목천,1277,1300,2577
<class,수인선,고색,1452,1482,2934
<class,분당선,매교,1186,1232,2418
<class,분당선,수원시청,6166,6127,12293
<class,분당선,매탄권선,2193,2137,4330
<class,분당선,망포,5504,5691,11195
<class,분당선,영통,4096,4204,8300
<class,분당선,청명,1740,1708,3448
<class,분당선,상갈,2574,2671,5245
<class,분당선,기흥,4426,4221,8647
<class,분당선,신갈,1718,1867,3585
<class,분당선,구성,2123,2262,4385
<class,분당선,죽전,6987,7755,14742
<class,분당선,보정,952,900,1852
<class,분당선,이매,2730,2791,5521
<class,분당선,오리,4786,4248,9034
<class,분당선,미금,6255,6561,12816
<class,분당선,정자,6541,6653,13194
<class,분당선,수내,5070,5043,10113
<class,분당선,서현,11591,11844,23435
<class,분당선,야탑,11017,11403,22420
<class,분당선,모란,9796,10038,19834
<class,분당선,태평,7252,6693,13945
<class,분당선,가천대,3475,4069,7544
<class,분당선,선정릉,1734,1904,3638
<class,분당선,강남구청,2800,3446,6246
<class,분당선,압구정로데오,9233,10379,19612
<class,분당선,서울숲,6318,6418,12736
<class,분당선,수원,4961,4215,9176
<class,분당선,복정,1,0,1
<class,분당선,수서,7304,6782,14086
<class,분당선,대모산입구,1692,1585,3277
<class,분당선,개포동,1654,1675,3329
<class,분당선,구룡,626,711,1337
<class,분당선,도곡,2325,2119,4444
<class,분당선,한티,7893,7636,15529
<class,분당선,선릉,2547,3707,6254
<class,과천선,범계,12704,12177,24881
<class,과천선,평촌,5356,5260,10616
<class,과천선,인덕원,9572,9612,19184
<class,과천선,정부과천청사,3702,3860,7562
<class,과천선,과천,2865,2663,5528
<class,과천선,대공원,4789,4985,9774
<class,과천선,경마공원,801,790,1591
<class,과천선,선바위,3329,3061,6390
<class,공항철도 1호선,영종,2182,2089,4271
<class,공항철도 1호선,인천공항2터미널,1639,1504,3143
<class,일산선,화정,8520,8672,17192
<class,공항철도 1호선,공항화물청사,943,1017,1960
<class,공항철도 1호선,운서,4426,4827,9253
<class,공항철도 1호선,청라국제도시,2703,2662,5365
<class,공항철도 1호선,검암,3266,3422,6688
<class,공항철도 1호선,계양,4505,4326,8831
<class,공항철도 1호선,김포공항,10192,5211,15403
<class,공항철도 1호선,마곡나루,2103,2264,4367
<class,공항철도 1호선,디지털미디어시티,2977,3052,6029
<class,공항철도 1호선,홍대입구,8125,7648,15773
<class,공항철도 1호선,공덕,956,1282,2238
<class,공항철도 1호선,서울역,6019,5072,11091
<class,경춘선,춘천,1664,1511,3175
<class,경춘선,남춘천,2258,2343,4601
<class,경춘선,김유정,516,564,1080
<class,경춘선,강촌,806,588,1394
<class,경춘선,백양리,136,113,249
<class,경춘선,굴봉산,208,203,411
<class,경춘선,가평,2007,1583,3590
<class,경춘선,상천,549,390,939
<class,경춘선,청평,1654,1365,3019
<class,경춘선,대성리,724,636,1360
<class,경춘선,마석,2428,2384,4812
<class,경춘선,천마산,1047,1086,2133
<class,경춘선,평내호평,3260,3166,6426
<class,경춘선,금곡,894,838,1732
<class,경춘선,사릉,1625,1565,3190
<class,경춘선,퇴계원,1995,1812,3807
<class,경춘선,별내,1790,1639,3429
<class,경춘선,갈매,1288,1150,2438
<class,경춘선,신내,866,869,1735
<class,경인선,도화,2136,2082,4218
<class,경인선,중동,4393,4199,8592
<class,경인선,온수,3270,3061,6331
<class,경인선,도원,1456,1461,2917
<class,경인선,간석,2832,2621,5453
<class,경인선,부개,4350,3997,8347
<class,경인선,소사,4595,4477,9072
<class,경인선,구일,2754,2728,5482
<class,경인선,인천,3779,3062,6841
<class,경인선,동인천,8471,8131,16602
<class,경인선,제물포,4960,4903,9863
<class,경인선,주안,10353,9175,19528
<class,경인선,동암,8404,8380,16784
<class,경인선,백운,3584,3557,7141
<class,경인선,부평,19470,20410,39880
<class,경인선,송내,11555,11198,22753
<class,경인선,부천,19462,19033,38495
<class,경인선,역곡,12655,12515,25170
<class,경인선,오류동,6102,5867,11969
<class,경인선,개봉,10260,10305,20565
<class,경의선,임진강,72,83,155
<class,경의선,문산,3260,3181,6441
<class,경의선,파주,595,523,1118
<class,경의선,월롱,825,1590,2415
<class,경의선,금촌,3767,3819,7586
<class,경의선,금릉,2466,2472,4938
<class,경의선,운정,3303,3117,6420
<class,경의선,야당,3939,3758,7697
<class,경의선,탄현,3683,3526,7209
<class,경의선,일산,4197,3930,8127
<class,경의선,풍산,3263,3050,6313
<class,경의선,백마,2977,2916,5893
<class,경의선,곡산,281,282,563
<class,경의선,능곡,2140,2012,4152
<class,경의선,행신,3868,3693,7561
<class,경의선,강매,1357,1256,2613
<class,경의선,화전,729,778,1507
<class,경의선,수색,820,901,1721
<class,경의선,디지털미디어시티,1227,1138,2365
<class,경의선,가좌,2506,2591,5097
<class,경의선,홍대입구,1455,1630,3085
<class,경의선,서강대,1184,1163,2347
<class,경의선,공덕,1472,1323,2795
<class,경의선,효창공원앞,1146,1330,2476
<class,경의선,신촌,248,256,504
<class,경의선,서울역,906,846,1752
<class,경원선,소요산,4046,3490,7536
<class,경원선,동두천,1261,1589,2850
<class,경원선,보산,1603,1444,3047
<class,경원선,동두천중앙,2105,2021,4126
<class,경원선,지행,4119,4020,8139
<class,경원선,덕정,3089,3182,6271
<class,경원선,덕계,1531,1499,3030
<class,경원선,양주,4758,4642,9400
<class,경원선,녹양,2507,2376,4883
<class,경원선,가능,3646,3471,7117
<class,경원선,의정부,12071,12262,24333
<class,경원선,회룡,6783,6730,13513
<class,경원선,망월사,4112,4197,8309
<class,경원선,도봉산,8877,6225,15102
<class,경원선,도봉,3217,3063,6280
<class,경원선,방학,5353,5140,10493
<class,경원선,녹천,2280,2052,4332
<class,경원선,월계,3320,3150,6470
<class,경원선,석계,4543,5054,9597
<class,경원선,신이문,4220,3980,8200
<class,경원선,청량리,13032,11846,24878
<class,경원선,왕십리,8049,9522,17571
<class,경원선,응봉,1048,949,1997
<class,경원선,옥수,52,26,78
<class,경원선,한남,1895,1939,3834
<class,경원선,서빙고,1025,929,1954
<class,경원선,이촌,2057,1614,3671
<class,경부선,광명,2207,1579,3786
<class,경부선,서동탄,675,704,1379
<class,경부선,당정,2669,2628,5297
<class,경부선,천안,5746,5197,10943
<class,경부선,두정,3599,4024,7623
<class,경부선,직산,512,542,1054
<class,경부선,성환,2122,2488,4610
<class,경부선,평택,10431,10496,20927
<class,경부선,평택지제,2068,2056,4124
<class,경부선,서정리,3779,5147,8926
<class,경부선,송탄,3184,3534,6718
<class,경부선,진위,716,688,1404
<class,경부선,오산,6511,6944,13455
<class,경부선,오산대,1913,1847,3760
<class,경부선,세마,1522,1400,2922
<class,경부선,병점,8129,8828,16957
<class,경부선,세류,1676,1734,3410
<class,경부선,독산,5542,5537,11079
<class,경부선,수원,28167,27492,55659
<class,경부선,화서,3469,3334,6803
<class,경부선,성균관대,6793,7159,13952
<class,경부선,의왕,3835,3910,7745
<class,경부선,군포,2646,2549,5195
<class,경부선,금정,11999,12337,24336
<class,경부선,명학,3092,2954,6046
<class,경부선,안양,11864,11480,23344
<class,경부선,관악,4348,3947,8295
<class,경부선,석수,4827,4615,9442
<class,경부선,금천구청,5583,5595,11178
<class,경부선,가산디지털단지,4059,5833,9892
<class,경부선,구로,8189,8210,16399
<class,경부선,신길,4432,3948,8380
<class,경부선,신도림,2008,2101,4109
<class,경부선,영등포,25914,25073,50987
<class,경부선,대방,4993,5341,10334
<class,경부선,노량진,5291,5001,10292
<class,경부선,용산,27071,23462,50533
<class,경부선,남영,3798,4113,7911
<class,경부선,서울역,5463,1129,6592
<class,경강선,여주,1951,1865,3816
<class,경강선,세종대왕릉,261,247,508
<class,경강선,부발,1093,1701,2794
<class,경강선,이천,1742,1882,3624
<class,경강선,신둔도예촌,825,770,1595
<class,경강선,곤지암,1398,1525,2923
<class,경강선,초월,1441,1349,2790
<class,경강선,경기광주,3348,3328,6676
<class,경강선,삼동,933,960,1893
<class,경강선,이매,657,465,1122
<class,경강선,판교,2150,1989,4139
<class,9호선2~3단계,중앙보훈병원,2954,2853,5807
<class,9호선2~3단계,둔촌오륜,354,380,734
<class,9호선2~3단계,올림픽공원,3713,3703,7416
<class,9호선2~3단계,한성백제,1239,1085,2324
<class,9호선2~3단계,송파나루,2418,2807,5225
<class,9호선2~3단계,석촌,3989,3396,7385
<class,9호선2~3단계,석촌고분,2570,2618,5188
<class,9호선2~3단계,삼전,3072,2989,6061
<class,9호선2~3단계,종합운동장,1722,1712,3434
<class,9호선2~3단계,봉은사,5711,5777,11488
<class,9호선2~3단계,삼성중앙,1654,1716,3370
<class,9호선2~3단계,선정릉,2577,2967,5544
<class,9호선2~3단계,언주,2851,2853,5704
<class,9호선,신논현,13001,12489,25490
<class,9호선,사평,1243,1266,2509
<class,9호선,고속터미널,8871,11073,19944
<class,9호선,신반포,1393,1447,2840
<class,9호선,구반포,859,912,1771
<class,9호선,동작,1131,921,2052
<class,9호선,흑석,3249,3396,6645
<class,9호선,노들,2282,2026,4308
<class,9호선,노량진,12855,13678,26533
<class,9호선,샛강,1505,1481,2986
<class,9호선,여의도,7043,6803,13846
<class,9호선,국회의사당,3250,3150,6400
<class,9호선,당산,7515,7593,15108
<class,9호선,선유도,2590,2477,5067
<class,9호선,신목동,1444,1354,2798
<class,9호선,염창,7183,7184,14367
<class,9호선,증미,2589,2584,5173
<class,9호선,가양,8529,8627,17156
<class,9호선,양천향교,3753,3858,7611
<class,9호선,마곡나루,4781,4987,9768
<class,9호선,신방화,3005,2870,5875
<class,9호선,공항시장,1443,1669,3112
<class,9호선,김포공항,6203,9682,15885
<class,9호선,개화,1080,1079,2159
<class,8호선,모란,2150,1864,4014
<class,8호선,수진,2508,2270,4778
<class,8호선,신흥,2373,2544,4917
<class,8호선,단대오거리,4718,4607,9325
<class,8호선,남한산성입구,6012,5588,11600
<class,8호선,산성,3158,3156,6314
<class,8호선,복정,4164,3981,8145
<class,8호선,장지,7895,8188,16083
<class,8호선,문정,4690,4997,9687
<class,8호선,가락시장,2827,3636,6463
<class,8호선,송파,3029,3272,6301
<class,8호선,석촌,3603,4458,8061
<class,8호선,잠실,8075,8850,16925
<class,8호선,몽촌토성,2933,2903,5836
<class,8호선,강동구청,3819,3971,7790
<class,8호선,천호,7473,8598,16071
<class,8호선,암사,7884,7430,15314
<class,7호선,부평구청,3260,2863,6123
<class,7호선,굴포천,4081,4123,8204
<class,7호선,삼산체육관,2404,2199,4603
<class,7호선,상동,6414,6276,12690
<class,7호선,부천시청,6013,6073,12086
<class,7호선,신중동,6130,5961,12091
<class,7호선,춘의,3124,3033,6157
<class,7호선,부천종합운동장,2291,2056,4347
<class,7호선,까치울,3728,3724,7452
<class,7호선,온수,3493,3491,6984
<class,7호선,천왕,4174,4054,8228
<class,7호선,광명사거리,10870,10777,21647
<class,7호선,철산,9338,9358,18696
<class,7호선,가산디지털단지,9036,8322,17358
<class,7호선,남구로,5803,5764,11567
<class,7호선,대림,5754,5361,11115
<class,7호선,신풍,5310,5064,10374
<class,7호선,보라매,3923,3855,7778
<class,7호선,신대방삼거리,6850,6885,13735
<class,7호선,장승배기,4134,4081,8215
<class,7호선,상도,4516,4664,9180
<class,7호선,숭실대입구,4961,5376,10337
<class,7호선,남성,4647,4612,9259
<class,7호선,이수,7110,6917,14027
<class,7호선,내방,4518,4672,9190
<class,7호선,고속터미널,10081,6399,16480
<class,7호선,반포,2621,2623,5244
<class,7호선,논현,5576,5875,11451
<class,7호선,학동,4801,5101,9902
<class,7호선,강남구청,4976,5448,10424
<class,7호선,청담,5700,6099,11799
<class,7호선,뚝섬유원지,8876,7784,16660
<class,7호선,건대입구,6889,7047,13936
<class,7호선,어린이대공원,6446,6561,13007
<class,7호선,군자,6707,5341,12048
<class,7호선,중곡,4525,4324,8849
<class,7호선,용마산,2768,3323,6091
<class,7호선,사가정,8216,7953,16169
<class,7호선,면목,7140,7028,14168
<class,7호선,상봉,8344,7956,16300
<class,7호선,중화,5058,4972,10030
<class,7호선,먹골,4891,4757,9648
<class,7호선,태릉입구,4498,4201,8699
<class,7호선,공릉,5655,5856,11511
<class,7호선,하계,7799,7483,15282
<class,7호선,중계,6010,5623,11633
<class,7호선,노원,9676,9826,19502
<class,7호선,마들,5338,5085,10423
<class,7호선,수락산,7940,7863,15803
<class,7호선,도봉산,4956,7542,12498
<class,7호선,장암,1442,1025,2467
<class,6호선,봉화산,3483,3431,6914
<class,6호선,화랑대,4449,3839,8288
<class,6호선,태릉입구,2789,2887,5676
<class,6호선,석계,5826,5905,11731
<class,6호선,돌곶이,3824,3814,7638
<class,6호선,상월곡,2714,2484,5198
<class,6호선,월곡,4789,4775,9564
<class,6호선,고려대,3696,3598,7294
<class,6호선,안암,4325,4676,9001
<class,6호선,보문,3499,3309,6808
<class,6호선,창신,1384,1246,2630
<class,6호선,동묘앞,5540,5509,11049
<class,6호선,신당,3812,4520,8332
<class,6호선,청구,1487,1417,2904
<class,6호선,약수,1551,1424,2975
<class,6호선,버티고개,829,1054,1883
<class,6호선,한강진,5264,6125,11389
<class,6호선,이태원,7506,7380,14886
<class,6호선,녹사평,3691,3504,7195
<class,6호선,삼각지,3133,2415,5548
<class,6호선,효창공원앞,2994,2498,5492
<class,6호선,공덕,5944,5567,11511
<class,6호선,대흥,3489,3532,7021
<class,6호선,광흥창,3643,3386,7029
<class,6호선,상수,4521,5444,9965
<class,6호선,합정,8275,7248,15523
<class,6호선,망원,8612,9560,18172
<class,6호선,마포구청,6326,5711,12037
<class,6호선,월드컵경기장,4153,4196,8349
<class,6호선,디지털미디어시티,4415,4539,8954
<class,6호선,증산,4997,5068,10065
<class,6호선,새절,5718,5591,11309
<class,6호선,구산,3388,2588,5976
<class,6호선,독바위,1416,1777,3193
<class,6호선,불광,2516,2401,4917
<class,6호선,역촌,1715,2029,3744
<class,6호선,응암,8355,8393,16748
<class,5호선,하남검단산,3848,3766,7614
<class,5호선,하남시청,3182,2975,6157
<class,5호선,하남풍산,1728,1838,3566
<class,5호선,미사,7336,7379,14715
<class,5호선,강일,1633,1565,3198
<class,5호선,마천,3102,3276,6378
<class,5호선,거여,3468,3468,6936
<class,5호선,개롱,2622,2776,5398
<class,5호선,오금,1366,1331,2697
<class,5호선,방이,3333,3264,6597
<class,5호선,올림픽공원,1945,1896,3841
<class,5호선,둔촌동,3775,3896,7671
<class,5호선,상일동,6049,5834,11883
<class,5호선,고덕,3909,3884,7793
<class,5호선,명일,3823,3894,7717
<class,5호선,굽은다리,4510,4260,8770
<class,5호선,길동,3661,3802,7463
<class,5호선,강동,7416,7456,14872
<class,5호선,천호,10481,10148,20629
<class,5호선,광나루,6960,6847,13807
<class,5호선,아차산,9405,9304,18709
<class,5호선,군자,5152,5795,10947
<class,5호선,장한평,6590,6598,13188
<class,5호선,답십리,6306,5913,12219
<class,5호선,마장,2571,2451,5022
<class,5호선,왕십리,2239,2547,4786
<class,5호선,행당,3477,3156,6633
<class,5호선,신금호,2636,2880,5516
<class,5호선,청구,1576,1453,3029
<class,5호선,동대문역사문화공원,528,658,1186
<class,5호선,을지로4가,1322,1464,2786
<class,5호선,종로3가,6888,6604,13492
<class,5호선,광화문,9932,10040,19972
<class,5호선,서대문,4783,4814,9597
<class,5호선,충정로,1229,1285,2514
<class,5호선,애오개,2220,2250,4470
<class,5호선,공덕,3820,3905,7725
<class,5호선,마포,4119,4097,8216
<class,5호선,여의나루,10642,10599,21241
<class,5호선,여의도,6331,6921,13252
<class,5호선,신길,1572,1757,3329
<class,5호선,영등포시장,3906,4065,7971
<class,5호선,영등포구청,1250,1220,2470
<class,5호선,양평,2294,2362,4656
<class,5호선,오목교,10207,10569,20776
<class,5호선,목동,6679,6795,13474
<class,5호선,신정,5603,5011,10614
<class,5호선,까치산,13843,13469,27312
<class,5호선,화곡,12488,11791,24279
<class,5호선,우장산,5803,5933,11736
<class,5호선,발산,7878,8275,16153
<class,5호선,마곡,3102,3176,6278
<class,5호선,송정,3223,3293,6516
<class,5호선,김포공항,6092,5355,11447
<class,5호선,개화산,2443,2617,5060
<class,5호선,방화,3216,3137,6353
<class,4호선,쌍문,13934,12551,26485
<class,4호선,창동,12425,13123,25548
<class,4호선,노원,10052,10769,20821
<class,4호선,상계,9261,8619,17880
<class,4호선,당고개,7004,6853,13857
<class,4호선,남태령,602,506,1108
<class,4호선,사당,12412,11555,23967
<class,4호선,총신대입구,8792,9604,18396
<class,4호선,동작,1508,1476,2984
<class,4호선,이촌,3876,4527,8403
<class,4호선,신용산,6540,6784,13324
<class,4호선,삼각지,1978,2715,4693
<class,4호선,숙대입구,5616,5495,11111
<class,4호선,서울역,3454,6808,10262
<class,4호선,회현,6940,7308,14248
<class,4호선,명동,8721,9049,17770
<class,4호선,충무로,7271,7375,14646
<class,4호선,동대문역사문화공원,7035,6813,13848
<class,4호선,동대문,5859,6327,12186
<class,4호선,혜화,17533,18791,36324
<class,4호선,한성대입구,6623,6561,13184
<class,4호선,성신여대입구,10928,10647,21575
<class,4호선,길음,8720,8642,17362
<class,4호선,미아사거리,13973,13287,27260
<class,4호선,미아,7040,6796,13836
<class,4호선,수유,17206,16651,33857
<class,3호선,오금,2369,2365,4734
<class,3호선,경찰병원,2344,2508,4852
<class,3호선,가락시장,3360,3563,6923
<class,3호선,수서,8851,8671,17522
<class,3호선,일원,2819,3044,5863
<class,3호선,대청,3552,3492,7044
<class,3호선,학여울,1480,1531,3011
<class,3호선,대치,5735,4927,10662
<class,3호선,도곡,1626,1649,3275
<class,3호선,매봉,3628,3699,7327
<class,3호선,양재,11003,12867,23870
<class,3호선,남부터미널,13122,13179,26301
<class,3호선,교대,3610,2282,5892
<class,3호선,고속터미널,32470,29426,61896
<class,3호선,잠원,2302,2197,4499
<class,3호선,신사,11584,11920,23504
<class,3호선,압구정,11870,12334,24204
<class,3호선,옥수,4657,4747,9404
<class,3호선,금호,3753,3545,7298
<class,3호선,약수,5685,5521,11206
<class,3호선,동대입구,4194,4715,8909
<class,3호선,을지로3가,2454,2479,4933
<class,3호선,종로3가,3283,4339,7622
<class,3호선,안국,8507,9364,17871
<class,3호선,경복궁,10082,11076,21158
<class,3호선,독립문,3817,4177,7994
<class,3호선,무악재,1755,1964,3719
<class,3호선,홍제,8013,7646,15659
<class,3호선,녹번,6389,5802,12191
<class,3호선,불광,8481,10162,18643
<class,3호선,연신내,19295,17956,37251
<class,3호선,구파발,10313,10422,20735
<class,3호선,지축,2021,1927,3948
<class,2호선,용두,1084,1084,2168
<class,2호선,신정네거리,4468,4628,9096
<class,2호선,양천구청,2834,2933,5767
<class,2호선,도림천,349,378,727
<class,2호선,신설동,2603,1471,4074
<class,2호선,신답,639,697,1336
<class,2호선,용답,1535,1486,3021
<class,2호선,충정로,3151,3299,6450
<class,2호선,아현,4554,4491,9045
<class,2호선,이대,6185,6770,12955
<class,2호선,신촌,19365,19214,38579
<class,2호선,홍대입구,38652,39131,77783
<class,2호선,합정,17379,17970,35349
<class,2호선,당산,8009,8481,16490
<class,2호선,영등포구청,6796,7213,14009
<class,2호선,문래,6906,7475,14381
<class,2호선,신도림,23446,23620,47066
<class,2호선,대림,12807,12945,25752
<class,2호선,구로디지털단지,20112,19672,39784
<class,2호선,신대방,13542,13498,27040
<class,2호선,신림,32188,31808,63996
<class,2호선,봉천,10573,10310,20883
<class,2호선,서울대입구,24194,25140,49334
<class,2호선,낙성대,13905,14264,28169
<class,2호선,사당,17491,19717,37208
<class,2호선,방배,5733,6285,12018
<class,2호선,서초,7531,6961,14492
<class,2호선,교대,8963,9885,18848
<class,2호선,강남,29479,28115,57594
<class,2호선,역삼,8584,9669,18253
<class,2호선,삼성,15562,15262,30824
<class,2호선,종합운동장,3026,3175,6201
<class,2호선,잠실새내,9286,9625,18911
<class,2호선,잠실,37612,35338,72950
<class,2호선,잠실나루,5053,5124,10177
<class,2호선,강변,18732,17541,36273
<class,2호선,구의,10042,10065,20107
<class,2호선,건대입구,21724,22799,44523
<class,2호선,성수,11175,13195,24370
<class,2호선,뚝섬,9265,9546,18811
<class,2호선,한양대,2122,2323,4445
<class,2호선,왕십리,7964,6708,14672
<class,2호선,상왕십리,6213,6185,12398
<class,2호선,신당,7270,7670,14940
<class,2호선,동대문역사문화공원,6302,7658,13960
<class,2호선,을지로4가,2995,2956,5951
<class,2호선,을지로3가,6054,5774,11828
<class,2호선,을지로입구,12996,12447,25443
<class,2호선,시청,4983,4293,9276
<class,1호선,청량리,11782,12183,23965
<class,1호선,제기동,9438,10062,19500
<class,1호선,신설동,6671,6542,13213
<class,1호선,동대문,8307,8715,17022
<class,1호선,종로5가,7235,7435,14670
<class,1호선,종로3가,12539,11143,23682
<class,1호선,종각,9911,8725,18636
<class,1호선,시청,6205,6025,12230
<class,1호선,동묘앞,12050,12245,24295
<class,1호선,서울역,21599,19127,40726
<class,경원선,외대앞,4820,4788,9608
<class,9호선,등촌,4442,4729,9171
<class,경원선,광운대,3872,3908,7780
<class,2호선,선릉,11148,9675,20823
<class,일산선,삼송,9377,9165,18542
<class,중앙선,지평,54,69,123
<class,중앙선,용문,4608,4024,8632
<class,중앙선,원덕,360,310,670
<class,중앙선,양평,2305,1959,4264
<class,중앙선,오빈,219,226,445
<class,중앙선,아신,580,534,1114
<class,중앙선,국수,642,538,1180
<class,중앙선,신원,378,247,625
<class,중앙선,양수,2166,1999,4165
<class,중앙선,운길산,1320,1149,2469
<class,중앙선,팔당,1666,1720,3386
<class,중앙선,도심,1163,1119,2282
<class,중앙선,덕소,3399,3291,6690
<class,중앙선,양정,485,420,905
<class,중앙선,도농,4591,4523,9114
<class,중앙선,구리,6985,7210,14195
<class,중앙선,양원,867,967,1834
<class,중앙선,망우,4445,4386,8831
<class,중앙선,상봉,3862,3694,7556
<class,중앙선,중랑,3158,3194,6352
<class,중앙선,회기,13863,13874,27737
<class,장항선,신창,997,1555,2552
<class,장항선,온양온천,2899,2661,5560
<class,장항선,배방,691,802,1493
<class,장항선,아산,2863,1911,4774
<class,장항선,쌍용,1046,1149,2195
<class,장항선,봉명,461,466,927
<class,일산선,대화,5562,5033,10595
<class,일산선,주엽,3994,3895,7889
<class,일산선,정발산,4289,4249,8538
<class,일산선,마두,3087,3048,6135
<class,일산선,백석,4797,4742,9539
<class,일산선,대곡,904,770,1674
<class,7호선,건대입구,9550,9879,19429
<class,5호선,양평,3381,3303,6684
<class,1호선,서울역,25272,25929,51201
<class,1호선,동묘앞,10721,11019,21740
<class,1호선,시청,9094,9032,18126
<class,1호선,종각,15528,14371,29899
<class,1호선,종로3가,20221,18768,38989
<class,1호선,종로5가,16853,16942,33795
<class,1호선,동대문,9980,9226,19206
<class,1호선,신설동,9030,8381,17411
<class,1호선,제기동,16611,17326,33937
<class,1호선,청량리,17404,17884,35288
<class,2호선,시청,7735,6828,14563
<class,2호선,을지로입구,18217,18409,36626
<class,2호선,을지로3가,9146,9292,18438
<class,2호선,을지로4가,7128,7286,14414
<class,2호선,동대문역사문화공원,8836,9731,18567
<class,2호선,신당,10033,10527,20560
<class,2호선,상왕십리,9224,8543,17767
<class,2호선,왕십리,11689,9686,21375
<class,2호선,한양대,3372,3410,6782
<class,2호선,뚝섬,13629,13943,27572
<class,2호선,성수,19839,23038,42877
<class,2호선,건대입구,30090,31711,61801
<class,2호선,구의,15143,14784,29927
<class,2호선,강변,23603,23939,47542
<class,2호선,잠실나루,7152,7019,14171
<class,2호선,잠실,53510,50813,104323
<class,2호선,잠실새내,14888,15423,30311
<class,2호선,종합운동장,4530,4874,9404
<class,2호선,삼성,23578,23530,47108
<class,2호선,선릉,21205,18605,39810
<class,2호선,역삼,16151,17831,33982
<class,2호선,강남,53623,52947,106570
<class,2호선,교대,15856,17559,33415
<class,2호선,서초,9191,7637,16828
<class,2호선,방배,8729,9006,17735
<class,2호선,사당,25642,28320,53962
<class,2호선,낙성대,19919,18513,38432
<class,2호선,서울대입구,35364,34593,69957
<class,2호선,봉천,15962,14727,30689
<class,2호선,신림,45823,43817,89640
<class,2호선,신대방,18520,17933,36453
<class,2호선,구로디지털단지,30838,30349,61187
<class,2호선,대림,16276,17494,33770
<class,2호선,신도림,35847,35862,71709
<class,2호선,문래,11083,11708,22791
<class,2호선,영등포구청,11396,11754,23150
<class,2호선,당산,11949,12895,24844
<class,2호선,합정,24974,27557,52531
<class,2호선,홍대입구,54257,57135,111392
<class,2호선,신촌,28900,29777,58677
<class,2호선,이대,9439,9872,19311
<class,2호선,아현,7008,6521,13529
<class,2호선,충정로,5044,5289,10333
<class,2호선,용답,2068,1924,3992
<class,2호선,신답,964,1016,1980
<class,2호선,신설동,2938,1516,4454
<class,2호선,도림천,757,737,1494
<class,2호선,양천구청,4294,4384,8678
<class,2호선,신정네거리,6883,7037,13920
<class,2호선,용두,1751,1709,3460
<class,3호선,지축,2916,2877,5793
<class,3호선,구파발,14500,14654,29154
<class,3호선,연신내,28039,26277,54316
<class,3호선,불광,12377,14039,26416
<class,3호선,녹번,9575,8437,18012
<class,3호선,홍제,12276,11449,23725
<class,3호선,무악재,2565,2686,5251
<class,3호선,독립문,5420,5638,11058
<class,3호선,경복궁,14501,15913,30414
<class,3호선,안국,12810,14782,27592
<class,3호선,종로3가,5259,7249,12508
<class,3호선,을지로3가,4469,4926,9395
<class,3호선,충무로,1,0,1
<class,3호선,동대입구,5470,6005,11475
<class,3호선,약수,8447,8028,16475
<class,3호선,금호,5625,5066,10691
<class,3호선,옥수,6702,6780,13482
<class,3호선,압구정,23807,24604,48411
<class,3호선,신사,22254,23140,45394
<class,3호선,잠원,3646,3462,7108
<class,3호선,고속터미널,41028,41325,82353
<class,3호선,교대,6202,3757,9959
<class,3호선,남부터미널,18122,18602,36724
<class,3호선,양재,18448,19943,38391
<class,3호선,매봉,5643,5474,11117
<class,3호선,도곡,3144,3209,6353
<class,3호선,대치,9018,7991,17009
<class,3호선,학여울,2626,2952,5578
<class,3호선,대청,5645,5122,10767
<class,3호선,일원,4592,4563,9155
<class,3호선,수서,12003,12184,24187
<class,3호선,가락시장,5707,5329,11036
<class,3호선,경찰병원,3872,3737,7609
<class,3호선,오금,3653,3547,7200
<class,4호선,수유,24360,23631,47991
<class,4호선,미아,10173,9888,20061
<class,4호선,미아사거리,20511,19367,39878
<class,4호선,길음,12954,12176,25130
<class,4호선,성신여대입구,16100,15337,31437
<class,4호선,한성대입구,9790,9430,19220
<class,4호선,혜화,22480,23765,46245
<class,4호선,동대문,13519,13335,26854
<class,4호선,동대문역사문화공원,9980,8634,18614
<class,4호선,충무로,11651,12079,23730
<class,4호선,명동,10987,12472,23459
<class,4호선,회현,15490,16716,32206
<class,4호선,서울역,4600,9748,14348
<class,4호선,숙대입구,7888,7602,15490
<class,4호선,삼각지,2959,3819,6778
<class,4호선,신용산,8838,9959,18797
<class,4호선,이촌,5884,6613,12497
<class,4호선,동작,1838,1986,3824
<class,4호선,총신대입구,13400,14417,27817
<class,4호선,사당,17904,15451,33355
<class,4호선,남태령,946,775,1721
<class,4호선,당고개,9473,8997,18470
<class,4호선,상계,13385,12586,25971
<class,4호선,노원,14689,16114,30803
<class,4호선,창동,17914,18610,36524
<class,4호선,쌍문,20211,18097,38308
<class,5호선,방화,4360,4098,8458
<class,5호선,개화산,3507,3468,6975
<class,5호선,김포공항,6497,6463,12960
<class,5호선,송정,4784,4558,9342
<class,5호선,마곡,5103,5119,10222
<class,5호선,발산,12395,13199,25594
<class,5호선,우장산,9241,9038,18279
<class,5호선,화곡,18850,17220,36070
<class,5호선,까치산,19886,19235,39121
<class,5호선,신정,8206,7152,15358
<class,5호선,목동,10635,10737,21372
<class,5호선,오목교,14788,15292,30080
<class,5호선,영등포구청,1870,1781,3651
<class,5호선,영등포시장,6388,6572,12960
<class,5호선,신길,2315,2419,4734
<class,5호선,여의도,9285,10322,19607
<class,5호선,여의나루,12715,13299,26014
<class,5호선,마포,6546,6569,13115
<class,5호선,공덕,6332,6467,12799
<class,5호선,애오개,3440,3231,6671
<class,5호선,충정로,1887,1788,3675
<class,5호선,서대문,6481,6331,12812
<class,5호선,광화문,12681,12981,25662
<class,5호선,종로3가,10584,11016,21600
<class,5호선,을지로4가,3397,3688,7085
<class,5호선,동대문역사문화공원,892,1194,2086
<class,5호선,청구,2408,2229,4637
<class,5호선,신금호,3960,4090,8050
<class,5호선,행당,5205,4580,9785
<class,5호선,왕십리,3251,3745,6996
<class,5호선,마장,3921,3812,7733
<class,5호선,답십리,9503,8709,18212
<class,5호선,장한평,10465,10121,20586
<class,5호선,군자,7818,8251,16069
<class,5호선,아차산,11911,11580,23491
<class,5호선,광나루,9617,9175,18792
<class,5호선,천호,14989,14558,29547
<class,5호선,강동,11600,10883,22483
<class,5호선,길동,5685,5926,11611
<class,5호선,굽은다리,6895,6320,13215
<class,5호선,명일,5577,5588,11165
<class,5호선,고덕,5980,5796,11776
<class,5호선,상일동,8925,8285,17210
<class,5호선,둔촌동,6264,6231,12495
<class,5호선,올림픽공원,2915,2698,5613
<class,5호선,방이,5222,5043,10265
<class,5호선,오금,2499,2271,4770
<class,5호선,개롱,4352,4439,8791
<class,5호선,거여,5307,5039,10346
<class,5호선,마천,4258,4321,8579
<class,5호선,강일,2333,2209,4542
<class,5호선,미사,10724,10638,21362
<class,5호선,하남풍산,2398,2501,4899
<class,5호선,하남시청,4546,4415,8961
<class,5호선,하남검단산,4645,4776,9421
<class,6호선,응암,11916,11789,23705
<class,6호선,역촌,2624,3040,5664
<class,6호선,불광,3440,3278,6718
<class,6호선,독바위,1913,2258,4171
<class,6호선,연신내,1,0,1
<class,6호선,구산,5066,3772,8838
<class,6호선,새절,8192,7774,15966
<class,6호선,증산,6992,6901,13893
<class,6호선,디지털미디어시티,6661,6844,13505
<class,6호선,월드컵경기장,4826,5107,9933
<class,6호선,마포구청,8764,7759,16523
<class,6호선,망원,12678,14095,26773
<class,6호선,합정,11691,10633,22324
<class,6호선,상수,7104,8479,15583
<class,6호선,광흥창,4969,4624,9593
<class,6호선,대흥,5129,5117,10246
<class,6호선,공덕,8989,8370,17359
<class,6호선,효창공원앞,4115,3729,7844
<class,6호선,삼각지,4670,3575,8245
<class,6호선,녹사평,4588,4880,9468
<class,6호선,이태원,9880,10693,20573
<class,6호선,한강진,7692,9132,16824
<class,6호선,버티고개,1170,1404,2574
<class,6호선,약수,2367,2193,4560
<class,6호선,청구,2323,2260,4583
<class,6호선,신당,5824,5012,10836
<class,6호선,동묘앞,7493,7033,14526
<class,6호선,창신,1977,1647,3624
<class,6호선,보문,4818,4420,9238
<class,6호선,안암,6099,5703,11802
<class,6호선,고려대,4992,4761,9753
<class,6호선,월곡,7106,6800,13906
<class,6호선,상월곡,3865,3445,7310
<class,6호선,돌곶이,5558,5167,10725
<class,6호선,석계,8197,8233,16430
<class,6호선,태릉입구,3940,4150,8090
<class,6호선,화랑대,6391,5375,11766
<class,6호선,봉화산,4944,4807,9751
<class,7호선,장암,1591,1153,2744
<class,7호선,도봉산,6152,8630,14782
<class,7호선,수락산,9786,9475,19261
<class,7호선,마들,8350,7812,16162
<class,7호선,노원,14465,14994,29459
<class,7호선,중계,8674,7808,16482
<class,7호선,하계,11186,10235,21421
<class,7호선,공릉,8091,7954,16045
<class,7호선,태릉입구,6084,5683,11767
<class,7호선,먹골,7170,6941,14111
<class,7호선,중화,7404,6985,14389
<class,7호선,상봉,11917,11405,23322
<class,7호선,면목,10427,10272,20699
<class,7호선,사가정,11781,11395,23176
<class,7호선,용마산,4213,4420,8633
<class,7호선,중곡,6565,6080,12645
<class,7호선,군자,9803,7628,17431
<class,7호선,어린이대공원,9190,8908,18098
<class,7호선,뚝섬유원지,10839,9972,20811
<class,7호선,청담,9787,10621,20408
<class,7호선,강남구청,8932,9787,18719
<class,7호선,학동,9050,9428,18478
<class,7호선,논현,10496,11282,21778
<class,7호선,반포,4090,3993,8083
<class,7호선,고속터미널,11630,9411,21041
<class,7호선,내방,7516,7284,14800
<class,7호선,이수,10677,10009,20686
<class,7호선,남성,7146,6467,13613
<class,7호선,숭실대입구,7801,7806,15607
<class,7호선,상도,6928,6434,13362
<class,7호선,장승배기,6244,6075,12319
<class,7호선,신대방삼거리,10657,10023,20680
<class,7호선,보라매,6163,5922,12085
<class,7호선,신풍,7579,7137,14716
<class,7호선,대림,6330,6653,12983
<class,7호선,남구로,7679,7987,15666
<class,7호선,가산디지털단지,13597,12278,25875
<class,7호선,철산,14220,14252,28472
<class,7호선,광명사거리,15720,15768,31488
<class,7호선,천왕,6420,6043,12463
<class,7호선,온수,5403,5241,10644
<class,7호선,까치울,5146,5159,10305
<class,7호선,부천종합운동장,3066,2799,5865
<class,7호선,춘의,4836,4639,9475
<class,7호선,신중동,9048,8944,17992
<class,7호선,부천시청,9022,8900,17922
<class,7호선,상동,9696,9815,19511
<class,7호선,삼산체육관,3347,3047,6394
<class,7호선,굴포천,6042,6204,12246
<class,7호선,부평구청,4651,4062,8713
<class,8호선,암사,11478,10654,22132
<class,8호선,천호,10771,12653,23424
<class,8호선,강동구청,5557,5646,11203
<class,8호선,몽촌토성,4202,4171,8373
<class,8호선,잠실,10767,12558,23325
<class,8호선,석촌,5441,6525,11966
<class,8호선,송파,5034,4875,9909
<class,8호선,가락시장,5069,5119,10188
<class,8호선,문정,7460,7728,15188
<class,8호선,장지,11177,10312,21489
<class,8호선,복정,6640,5738,12378
<class,8호선,산성,4311,4307,8618
<class,8호선,남한산성입구,8343,7492,15835
<class,8호선,단대오거리,6954,6506,13460
<class,8호선,신흥,3408,3698,7106
<class,8호선,수진,3978,3493,7471
<class,8호선,모란,3267,2793,6060
<class,9호선,개화,1401,1248,2649
<class,9호선,김포공항,6701,10908,17609
<class,9호선,공항시장,2143,2271,4414
<class,9호선,신방화,4474,4184,8658
<class,9호선,마곡나루,7233,7492,14725
<class,9호선,양천향교,5307,5180,10487
<class,9호선,가양,12727,12014,24741
<class,9호선,증미,3932,3817,7749
<class,9호선,등촌,7017,6866,13883
<class,9호선,염창,10783,9860,20643
<class,9호선,신목동,2166,1906,4072
<class,9호선,선유도,3604,3566,7170
<class,9호선,당산,11604,10789,22393
<class,9호선,국회의사당,3409,3562,6971
<class,9호선,여의도,9906,9713,19619
<class,9호선,샛강,2201,2344,4545
<class,9호선,노량진,19933,19581,39514
<class,9호선,노들,3157,2729,5886
<class,9호선,흑석,5065,5184,10249
<class,9호선,동작,1605,1319,2924
<class,9호선,구반포,1711,1877,3588
<class,9호선,신반포,2434,2467,4901
<class,9호선,고속터미널,11008,15555,26563
<class,9호선,사평,1940,1820,3760
<class,9호선,신논현,22473,21847,44320
<class,9호선2~3단계,언주,4960,5070,10030
<class,9호선2~3단계,선정릉,4535,5078,9613
<class,9호선2~3단계,삼성중앙,2730,2651,5381
<class,9호선2~3단계,봉은사,8364,8590,16954
<class,9호선2~3단계,종합운동장,2802,2393,5195
<class,9호선2~3단계,삼전,4465,4213,8678
<class,9호선2~3단계,석촌고분,3833,3586,7419
<class,9호선2~3단계,석촌,5770,4987,10757
<class,9호선2~3단계,송파나루,3514,4033,7547
<class,9호선2~3단계,한성백제,1913,1671,3584
<class,9호선2~3단계,올림픽공원,4896,4781,9677
<class,9호선2~3단계,둔촌오륜,591,619,1210
<class,9호선2~3단계,중앙보훈병원,4265,3941,8206
<class,경강선,판교,2711,2512,5223
<class,경강선,이매,767,642,1409
<class,경강선,삼동,1382,1239,2621
<class,경강선,경기광주,4756,4543,9299
<class,경강선,초월,2029,1902,3931
<class,경강선,곤지암,1751,1829,3580
<class,경강선,신둔도예촌,1036,1049,2085
<class,경강선,이천,2333,2504,4837
<class,경강선,부발,1662,1476,3138
<class,경강선,세종대왕릉,290,350,640
<class,경강선,여주,2148,2361,4509
<class,경부선,서울역,4812,1524,6336
<class,경부선,남영,5132,5326,10458
<class,경부선,용산,29304,30958,60262
<class,경부선,노량진,8153,7143,15296
<class,경부선,대방,7098,7202,14300
<class,경부선,영등포,32598,34478,67076
<class,경부선,신도림,2660,2803,5463
<class,경부선,신길,5944,4768,10712
<class,경부선,구로,11949,12276,24225
<class,경부선,가산디지털단지,5587,7611,13198
<class,경부선,금천구청,7752,7636,15388
<class,경부선,석수,6516,5962,12478
<class,경부선,관악,5390,4993,10383
<class,경부선,안양,16125,16242,32367
<class,경부선,명학,4504,4337,8841
<class,경부선,금정,16583,16523,33106
<class,경부선,군포,4104,3692,7796
<class,경부선,의왕,5538,5391,10929
<class,경부선,성균관대,9450,9550,19000
<class,경부선,화서,4853,4981,9834
<class,경부선,수원,32804,35681,68485
<class,경부선,독산,8366,8125,16491
<class,경부선,세류,2360,2324,4684
<class,경부선,병점,11002,10891,21893
<class,경부선,세마,1984,1806,3790
<class,경부선,오산대,2624,2320,4944
<class,경부선,오산,8189,7900,16089
<class,경부선,진위,970,881,1851
<class,경부선,송탄,4358,3888,8246
<class,경부선,서정리,5848,5115,10963
<class,경부선,평택지제,2659,2534,5193
<class,경부선,평택,11997,11359,23356
<class,경부선,성환,2793,2665,5458
<class,경부선,직산,565,608,1173
<class,경부선,두정,5131,5199,10330
<class,경부선,천안,5701,5957,11658
<class,경부선,당정,3625,3489,7114
<class,경부선,서동탄,942,935,1877
<class,경부선,광명,2101,2059,4160
<class,경원선,이촌,3010,2210,5220
<class,경원선,서빙고,1259,1178,2437
<class,경원선,한남,2649,2437,5086
<class,경원선,옥수,29,34,63
<class,경원선,응봉,1742,1381,3123
<class,경원선,왕십리,11052,13071,24123
<class,경원선,청량리,15128,16486,31614
<class,경원선,외대앞,5802,5662,11464
<class,경원선,신이문,5677,5193,10870
<class,경원선,석계,6409,6751,13160
<class,경원선,광운대,5406,5229,10635
<class,경원선,월계,4345,4215,8560
<class,경원선,녹천,3169,2780,5949
<class,경원선,방학,7117,6897,14014
<class,경원선,도봉,4240,3978,8218
<class,경원선,도봉산,8876,6096,14972
<class,경원선,망월사,5804,5850,11654
<class,경원선,회룡,9303,9362,18665
<class,경원선,의정부,16070,16762,32832
<class,경원선,가능,4999,4755,9754
<class,경원선,녹양,3389,3268,6657
<class,경원선,양주,6339,6137,12476
<class,경원선,덕계,2271,2076,4347
<class,경원선,덕정,4188,3951,8139
<class,경원선,지행,5421,5478,10899
<class,경원선,동두천중앙,2439,2440,4879
<class,경원선,보산,1830,1767,3597
<class,경원선,동두천,1557,2014,3571
<class,경원선,소요산,4212,3616,7828
<class,경의선,서울역,1218,1338,2556
<class,경의선,신촌,416,356,772
<class,경의선,효창공원앞,1619,1814,3433
<class,경의선,공덕,2199,1749,3948
<class,경의선,서강대,1711,1596,3307
<class,경의선,홍대입구,1912,2026,3938
<class,경의선,가좌,3716,3605,7321
<class,경의선,디지털미디어시티,1815,1587,3402
<class,경의선,수색,1416,1359,2775
<class,경의선,화전,1046,962,2008
<class,경의선,강매,1925,1782,3707
<class,경의선,행신,4718,4944,9662
<class,경의선,능곡,2779,2632,5411
<class,경의선,곡산,391,407,798
<class,경의선,백마,4136,3960,8096
<class,경의선,풍산,4062,3883,7945
<class,경의선,일산,5863,5606,11469
<class,경의선,탄현,5006,4825,9831
<class,경의선,야당,5376,5316,10692
<class,경의선,운정,4530,4275,8805
<class,경의선,금릉,3511,3468,6979
<class,경의선,금촌,5728,5722,11450
<class,경의선,월롱,1418,1442,2860
<class,경의선,파주,798,637,1435
<class,경의선,문산,4574,4417,8991
<class,경의선,임진강,71,58,129
<class,경인선,개봉,14946,14865,29811
<class,경인선,오류동,8369,7678,16047
<class,경인선,역곡,18668,18302,36970
<class,경인선,부천,26406,27512,53918
<class,경인선,송내,16728,16628,33356
<class,경인선,부평,27119,29580,56699
<class,경인선,백운,5281,5237,10518
<class,경인선,동암,11837,11973,23810
<class,경인선,주안,14590,13033,27623
<class,경인선,제물포,6858,6606,13464
<class,경인선,동인천,11061,10852,21913
<class,경인선,인천,4180,3644,7824
<class,경인선,구일,3942,3724,7666
<class,경인선,소사,6482,6366,12848
<class,경인선,부개,6027,5687,11714
<class,경인선,간석,4025,3844,7869
<class,경인선,도원,2122,2101,4223
<class,경인선,온수,4665,4238,8903
<class,경인선,중동,6409,6048,12457
<class,경인선,도화,3047,2793,5840
<class,경춘선,신내,1086,1078,2164
<class,경춘선,갈매,1929,1689,3618
<class,경춘선,별내,2256,2128,4384
<class,경춘선,퇴계원,2558,2364,4922
<class,경춘선,사릉,2245,2244,4489
<class,경춘선,금곡,1125,1021,2146
<class,경춘선,평내호평,4348,4203,8551
<class,경춘선,천마산,1333,1342,2675
<class,경춘선,마석,3025,3174,6199
<class,경춘선,대성리,708,710,1418
<class,경춘선,청평,1626,1781,3407
<class,경춘선,상천,447,380,827
<class,경춘선,가평,1861,2084,3945
<class,경춘선,굴봉산,166,191,357
<class,경춘선,백양리,170,190,360
<class,경춘선,강촌,795,871,1666
<class,경춘선,김유정,523,680,1203
<class,경춘선,남춘천,2459,2599,5058
<class,경춘선,춘천,1921,1777,3698
<class,공항철도 1호선,서울역,6064,6278,12342
<class,공항철도 1호선,공덕,1293,1828,3121
<class,공항철도 1호선,홍대입구,10774,10365,21139
<class,공항철도 1호선,디지털미디어시티,4592,4290,8882
<class,공항철도 1호선,마곡나루,2979,3183,6162
<class,공항철도 1호선,김포공항,10005,5299,15304
<class,공항철도 1호선,계양,6110,5724,11834
<class,공항철도 1호선,검암,4393,4456,8849
<class,공항철도 1호선,청라국제도시,3736,3678,7414
<class,공항철도 1호선,운서,5527,5694,11221
<class,공항철도 1호선,공항화물청사,1257,1313,2570
<class,공항철도 1호선,인천공항1터미널,3268,3385,6653
<class,공항철도 1호선,인천공항2터미널,1735,1625,3360
<class,공항철도 1호선,영종,2701,2753,5454
<class,과천선,선바위,4754,4213,8967
<class,과천선,경마공원,1038,1064,2102
<class,과천선,대공원,5637,5841,11478
<class,과천선,과천,4048,3569,7617
<class,과천선,정부과천청사,5593,5668,11261
<class,과천선,인덕원,13996,13752,27748
<class,과천선,평촌,8191,7987,16178
<class,과천선,범계,17777,17308,35085
<class,분당선,선릉,4712,7039,11751
<class,분당선,한티,12030,11606,23636
<class,분당선,도곡,4399,3788,8187
<class,분당선,구룡,1384,1267,2651
<class,분당선,개포동,2529,2468,4997
<class,분당선,대모산입구,2769,2499,5268
<class,분당선,수서,9126,9444,18570
<class,분당선,수원,6604,5057,11661
<class,분당선,서울숲,8658,8888,17546
<class,분당선,압구정로데오,16825,19026,35851
<class,분당선,강남구청,4796,5866,10662
<class,분당선,선정릉,3053,3384,6437
<class,분당선,가천대,4718,5075,9793
<class,분당선,태평,9982,9413,19395
<class,분당선,모란,14877,15123,30000
<class,분당선,야탑,15671,16629,32300
<class,분당선,서현,16822,16824,33646
<class,분당선,수내,8197,7732,15929
<class,분당선,정자,9998,10215,20213
<class,분당선,미금,10262,10665,20927
<class,분당선,오리,7103,5899,13002
<class,분당선,이매,3770,3680,7450
<class,분당선,보정,1499,1366,2865
<class,분당선,죽전,9408,10334,19742
<class,분당선,구성,2910,3061,5971
<class,분당선,신갈,2616,2604,5220
<class,분당선,기흥,6230,5944,12174
<class,분당선,상갈,3652,3589,7241
<class,분당선,청명,2443,2414,4857
<class,분당선,영통,6315,6156,12471
<class,분당선,망포,8110,7570,15680
<class,분당선,매탄권선,3231,3115,6346
<class,분당선,수원시청,9238,9844,19082
<class,분당선,매교,1899,1950,3849
<class,수인선,고색,2271,2305,4576
<class,수인선,오목천,1897,1636,3533
<class,수인선,어천,660,560,1220
<class,수인선,야목,206,182,388
<class,수인선,사리,3138,2674,5812
<class,수인선,달월,66,68,134
<class,수인선,월곶,1914,1944,3858
<class,수인선,소래포구,6636,6956,13592
<class,수인선,인천논현,4231,4415,8646
<class,수인선,호구포,2481,2436,4917
<class,수인선,남동인더스파크,1079,971,2050
<class,수인선,원인재,3474,3646,7120
<class,수인선,연수,3459,3360,6819
<class,수인선,송도,1999,1953,3952
<class,수인선,인하대,4220,3955,8175
<class,수인선,숭의,2714,2504,5218
<class,수인선,신포,1317,1365,2682
<class,수인선,인천,1275,1930,3205
<class,안산선,산본,11201,12154,23355
<class,안산선,대야미,3713,3296,7009
<class,안산선,반월,3160,2968,6128
<class,안산선,상록수,11243,11312,22555
<class,안산선,한대앞,6567,6572,13139
<class,안산선,중앙,14297,14546,28843
<class,안산선,고잔,5536,5478,11014
<class,안산선,초지,2909,2987,5896
<class,안산선,안산,8712,8940,17652
<class,안산선,신길온천,1284,1322,2606
<class,안산선,정왕,5765,5807,11572
<class,안산선,오이도,7325,7585,14910
<class,안산선,수리산,2701,2464,5165
<class,우이신설선,북한산우이,3100,3324,6424
<class,우이신설선,솔밭공원,1789,1688,3477
<class,우이신설선,4.19민주묘지,2319,2056,4375
<class,우이신설선,가오리,2923,2738,5661
<class,우이신설선,화계,2423,2179,4602
<class,우이신설선,삼양,1474,1576,3050
<class,우이신설선,삼양사거리,1776,1757,3533
<class,우이신설선,솔샘,3525,3174,6699
<class,우이신설선,북한산보국문,4407,3824,8231
<class,우이신설선,정릉,3307,2833,6140
<class,우이신설선,성신여대입구,2774,3142,5916
<class,우이신설선,보문,1063,1042,2105
<class,우이신설선,신설동,1360,1320,2680
<class,일산선,원흥,6747,6564,13311
<class,일산선,삼송,13272,12878,26150
<class,일산선,원당,8031,7594,15625
<class,일산선,화정,12159,12581,24740
<class,일산선,대곡,1280,1164,2444
<class,일산선,백석,7162,7210,14372
<class,일산선,마두,4850,4899,9749
<class,일산선,정발산,6308,6413,12721
<class,일산선,주엽,6414,6290,12704
<class,일산선,대화,8303,7319,15622
<class,장항선,봉명,664,580,1244
<class,장항선,쌍용,1333,1204,2537
<class,장항선,아산,2586,2377,4963
<class,장항선,배방,873,850,1723
<class,장항선,온양온천,3099,3104,6203
<class,장항선,신창,1153,1118,2271
<class,중앙선,회기,18276,17559,35835
<class,중앙선,중랑,4348,4247,8595
<class,중앙선,상봉,4807,4726,9533
<class,중앙선,망우,6159,5996,12155
<class,중앙선,양원,1297,1289,2586
<class,중앙선,구리,9613,9770,19383
<class,중앙선,도농,6473,6211,12684
<class,중앙선,양정,598,587,1185
<class,중앙선,덕소,4300,4384,8684
<class,중앙선,도심,1569,1331,2900
<class,중앙선,팔당,1589,1661,3250
<class,중앙선,운길산,1324,1358,2682
<class,중앙선,양수,2474,2462,4936
<class,중앙선,신원,373,334,707
<class,중앙선,국수,662,683,1345
<class,중앙선,아신,590,611,1201
<class,중앙선,오빈,301,310,611
<class,중앙선,양평,2757,2778,5535
<class,중앙선,원덕,384,361,745
<class,중앙선,용문,2196,2416,4612
<class,중앙선,지평,48,79,127
<class,중앙선,국수,710,556,1266
<class,중앙선,신원,395,312,707
<class,중앙선,양수,2237,1997,4234
<class,중앙선,운길산,1343,1211,2554
<class,중앙선,팔당,1551,1648,3199
<class,중앙선,도심,1218,1088,2306
<class,중앙선,덕소,3363,3386,6749
<class,중앙선,양정,533,485,1018
<class,중앙선,도농,4680,4572,9252
<class,중앙선,구리,6980,7277,14257
<class,중앙선,양원,956,954,1910
<class,중앙선,망우,4437,4389,8826
<class,중앙선,상봉,3839,3843,7682
<class,중앙선,중랑,3294,3154,6448
<class,중앙선,회기,13978,14111,28089
<class,장항선,신창,997,1546,2543
<class,장항선,온양온천,2773,2702,5475
<class,장항선,배방,705,829,1534
<class,장항선,아산,2870,1960,4830
<class,장항선,쌍용,1044,1106,2150
<class,장항선,봉명,426,454,880
<class,일산선,대화,5843,5352,11195
<class,일산선,주엽,4283,4274,8557
<class,일산선,정발산,4715,4747,9462
<class,일산선,마두,3328,3293,6621
<class,일산선,백석,5351,5205,10556
<class,일산선,대곡,990,831,1821
<class,일산선,화정,8786,8895,17681
<class,일산선,원당,5796,5625,11421
<class,일산선,삼송,10181,9938,20119
<class,일산선,원흥,4894,4741,9635
<class,우이신설선,신설동,1044,1103,2147
<class,우이신설선,보문,829,863,1692
<class,우이신설선,성신여대입구,2006,2256,4262
<class,우이신설선,정릉,2381,2057,4438
<class,우이신설선,북한산보국문,3371,3191,6562
<class,우이신설선,솔샘,2542,2303,4845
<class,우이신설선,삼양사거리,1490,1434,2924
<class,우이신설선,삼양,1003,1106,2109
<class,우이신설선,화계,1894,1825,3719
<class,우이신설선,가오리,2230,2050,4280
<class,우이신설선,4.19민주묘지,1872,1658,3530
<class,우이신설선,솔밭공원,1285,1321,2606
<class,우이신설선,북한산우이,3297,3417,6714
<class,안산선,수리산,2011,2019,4030
<class,안산선,오이도,5714,5647,11361
<class,안산선,정왕,4466,5164,9630
<class,안산선,신길온천,1082,1014,2096
<class,안산선,안산,8162,7612,15774
<class,안산선,초지,2168,2065,4233
<class,안산선,고잔,4126,3944,8070
<class,안산선,중앙,10460,10519,20979
<class,안산선,한대앞,4920,4861,9781
<class,안산선,상록수,8420,8164,16584
<class,안산선,반월,2297,2274,4571
<class,안산선,대야미,2791,2618,5409
<class,안산선,산본,8066,8577,16643
<class,수인선,인천,1070,1583,2653
<class,수인선,신포,1043,1069,2112
<class,수인선,숭의,2022,1812,3834
<class,수인선,인하대,3071,2900,5971
<class,수인선,송도,1453,1367,2820
<class,수인선,연수,2718,2743,5461
<class,수인선,원인재,2741,2874,5615
<class,수인선,남동인더스파크,493,495,988
<class,수인선,호구포,1791,1775,3566
<class,수인선,인천논현,2687,2846,5533
<class,수인선,소래포구,5864,5832,11696
<class,수인선,월곶,1568,1538,3106
<class,수인선,달월,56,59,115
<class,수인선,사리,2317,1991,4308
<class,수인선,야목,167,144,311
<class,수인선,어천,547,666,1213
<class,수인선,오목천,1261,1319,2580
<class,수인선,고색,1549,1637,3186
<class,분당선,매교,1230,1280,2510
<class,분당선,수원시청,6564,6599,13163
<class,분당선,매탄권선,2254,2147,4401
<class,분당선,망포,5458,5695,11153
<class,분당선,영통,4339,4351,8690
<class,분당선,청명,1764,1688,3452
<class,분당선,상갈,2681,2797,5478
<class,분당선,기흥,4510,4333,8843
<class,분당선,신갈,1792,1822,3614
<class,분당선,구성,2155,2285,4440
<class,분당선,죽전,6974,7849,14823
<class,분당선,보정,955,893,1848
<class,분당선,이매,2708,2830,5538
<class,분당선,오리,4886,4390,9276
<class,분당선,미금,6403,6835,13238
<class,분당선,정자,6648,6905,13553
<class,분당선,수내,5695,5583,11278
<class,분당선,서현,12163,12243,24406
<class,분당선,야탑,11274,11666,22940
<class,분당선,모란,10051,10611,20662
<class,분당선,태평,7441,6973,14414
<class,분당선,가천대,3333,3961,7294
<class,분당선,선정릉,1951,2055,4006
<class,분당선,강남구청,2873,3476,6349
<class,분당선,압구정로데오,10165,11428,21593
<class,분당선,서울숲,6820,6735,13555
<class,분당선,수원,5152,3678,8830
<class,분당선,수서,7522,7029,14551
<class,분당선,대모산입구,1919,1876,3795
<class,분당선,개포동,1776,1828,3604
<class,분당선,구룡,693,725,1418
<class,분당선,도곡,2308,2217,4525
<class,분당선,한티,8217,7955,16172
<class,분당선,선릉,2525,3685,6210
<class,과천선,범계,12920,12650,25570
<class,과천선,평촌,5639,5416,11055
<class,과천선,인덕원,9938,9912,19850
<class,과천선,정부과천청사,3895,4026,7921
<class,과천선,과천,3044,2855,5899
<class,과천선,대공원,4692,4875,9567
<class,과천선,경마공원,918,887,1805
<class,과천선,선바위,3312,3109,6421
<class,공항철도 1호선,영종,2206,2123,4329
<class,공항철도 1호선,인천공항2터미널,1742,1634,3376
<class,공항철도 1호선,인천공항1터미널,3120,3010,6130
<class,공항철도 1호선,공항화물청사,981,1044,2025
<class,공항철도 1호선,운서,4637,4921,9558
<class,공항철도 1호선,청라국제도시,2914,2852,5766
<class,공항철도 1호선,검암,3350,3454,6804
<class,공항철도 1호선,계양,4560,4465,9025
<class,공항철도 1호선,김포공항,10048,5298,15346
<class,공항철도 1호선,마곡나루,2135,2419,4554
<class,공항철도 1호선,디지털미디어시티,3223,3229,6452
<class,공항철도 1호선,홍대입구,9124,8380,17504
<class,공항철도 1호선,공덕,1033,1370,2403
<class,공항철도 1호선,서울역,6063,5209,11272
<class,경춘선,춘천,1666,1455,3121
<class,경춘선,남춘천,2907,3113,6020
<class,경춘선,김유정,513,551,1064
<class,경춘선,강촌,857,652,1509
<class,경춘선,백양리,142,128,270
<class,경춘선,굴봉산,248,250,498
<class,경춘선,가평,1875,1587,3462
<class,경춘선,상천,526,405,931
<class,경춘선,청평,1655,1370,3025
<class,경춘선,대성리,768,642,1410
<class,경춘선,마석,2566,2455,5021
<class,경춘선,천마산,1110,1070,2180
<class,경춘선,평내호평,3403,3257,6660
<class,경춘선,금곡,948,911,1859
<class,경춘선,사릉,1687,1750,3437
<class,경춘선,퇴계원,2099,1858,3957
<class,경춘선,별내,1853,1692,3545
<class,경춘선,갈매,1453,1276,2729
<class,경춘선,신내,904,884,1788
<class,경인선,도화,2159,2042,4201
<class,경인선,중동,4563,4191,8754
<class,경인선,온수,3308,3080,6388
<class,경인선,도원,1494,1513,3007
<class,경인선,간석,2937,2703,5640
<class,경인선,부개,4522,4169,8691
<class,경인선,소사,4778,4746,9524
<class,경인선,구일,3245,3092,6337
<class,경인선,인천,3663,2967,6630
<class,경인선,동인천,8607,8320,16927
<class,경인선,제물포,5216,5105,10321
<class,경인선,주안,10893,9694,20587
<class,경인선,동암,8811,8864,17675
<class,경인선,백운,3788,3704,7492
<class,경인선,부평,20947,21839,42786
<class,경인선,송내,12162,11595,23757
<class,경인선,부천,19683,19257,38940
<class,경인선,역곡,13063,13090,26153
<class,경인선,오류동,6304,5953,12257
<class,경인선,개봉,10689,10563,21252
<class,경의선,계양,1,0,1
<class,경의선,임진강,50,57,107
<class,경의선,문산,3353,3333,6686
<class,경의선,파주,621,560,1181
<class,경의선,월롱,904,1584,2488
<class,경의선,금촌,3805,4085,7890
<class,경의선,금릉,2593,2496,5089
<class,경의선,운정,3306,3141,6447
<class,경의선,야당,4025,3849,7874
<class,경의선,탄현,3839,3646,7485
<class,경의선,일산,4232,3944,8176
<class,경의선,풍산,3227,3011,6238
<class,경의선,백마,3291,3132,6423
<class,경의선,곡산,287,295,582
<class,경의선,능곡,2032,2023,4055
<class,경의선,행신,3858,3631,7489
<class,경의선,강매,1377,1316,2693
<class,경의선,화전,748,823,1571
<class,경의선,수색,874,899,1773
<class,경의선,디지털미디어시티,1278,1174,2452
<class,경의선,가좌,2620,2627,5247
<class,경의선,홍대입구,1638,1708,3346
<class,경의선,서강대,1231,1211,2442
<class,경의선,공덕,1474,1307,2781
<class,경의선,효창공원앞,1181,1411,2592
<class,경의선,신촌,282,270,552
<class,경의선,서울역,992,933,1925
<class,경원선,소요산,4109,3566,7675
<class,경원선,동두천,1281,1585,2866
<class,경원선,보산,1345,1413,2758
<class,경원선,동두천중앙,2008,1866,3874
<class,경원선,지행,4048,4138,8186
<class,경원선,덕정,3136,3334,6470
<class,경원선,덕계,1715,1595,3310
<class,경원선,양주,4921,4832,9753
<class,경원선,녹양,2562,2452,5014
<class,경원선,가능,3810,3557,7367
<class,경원선,의정부,12405,12534,24939
<class,경원선,회룡,6882,6937,13819
<class,경원선,망월사,4349,4420,8769
<class,경원선,도봉산,8602,6267,14869
<class,경원선,도봉,3298,3108,6406
<class,경원선,방학,5346,5228,10574
<class,경원선,창동,1,0,1
<class,경원선,녹천,2320,2060,4380
<class,경원선,월계,3634,3218,6852
<class,경원선,광운대,3876,3953,7829
<class,경원선,석계,4480,4949,9429
<class,경원선,신이문,4453,4167,8620
<class,경원선,외대앞,4433,4405,8838
<class,경원선,청량리,12943,11945,24888
<class,경원선,왕십리,7652,9137,16789
<class,경원선,응봉,969,931,1900
<class,경원선,옥수,50,26,76
<class,경원선,한남,1784,1700,3484
<class,경원선,서빙고,969,958,1927
<class,경원선,이촌,2124,1612,3736
<class,경부선,광명,2122,1547,3669
<class,경부선,서동탄,659,694,1353
<class,경부선,당정,2737,2756,5493
<class,경부선,천안,5848,5360,11208
<class,경부선,두정,4480,4905,9385
<class,경부선,직산,502,554,1056
<class,경부선,성환,2164,2546,4710
<class,경부선,평택,10395,10912,21307
<class,경부선,평택지제,2150,1970,4120
<class,경부선,서정리,4166,5567,9733
<class,경부선,송탄,3258,3506,6764
<class,경부선,진위,687,697,1384
<class,경부선,오산,6848,7380,14228
<class,경부선,오산대,1990,1916,3906
<class,경부선,세마,1572,1491,3063
<class,경부선,병점,8212,8852,17064
<class,경부선,세류,1845,1795,3640
<class,경부선,독산,5837,5945,11782
<class,경부선,수원,28803,28623,57426
<class,경부선,화서,3631,3534,7165
<class,경부선,성균관대,6863,7175,14038
<class,경부선,의왕,3895,4035,7930
<class,경부선,군포,2857,2738,5595
<class,경부선,금정,12249,12619,24868
<class,경부선,명학,2988,2858,5846
<class,경부선,안양,12425,12120,24545
<class,경부선,관악,4374,3960,8334
<class,경부선,석수,4852,4838,9690
<class,경부선,금천구청,5719,5625,11344
<class,경부선,가산디지털단지,4166,5859,10025
<class,경부선,구로,8405,8537,16942
<class,경부선,신길,4426,3918,8344
<class,경부선,신도림,2026,2100,4126
<class,1호선,서울역,21327,19405,40732
<class,1호선,동묘앞,11956,11819,23775
<class,1호선,시청,6352,6259,12611
<class,1호선,종각,10381,9236,19617
<class,1호선,종로3가,13019,11431,24450
<class,1호선,종로5가,8183,8376,16559
<class,1호선,동대문,8377,8698,17075
<class,1호선,신설동,6758,6615,13373
<class,1호선,제기동,10748,11427,22175
<class,1호선,청량리,12821,13182,26003
<class,2호선,시청,4851,4101,8952
<class,2호선,을지로입구,13928,13217,27145
<class,2호선,을지로3가,6393,6188,12581
<class,2호선,을지로4가,3265,3338,6603
<class,2호선,동대문역사문화공원,6658,8037,14695
<class,2호선,신당,7436,8034,15470
<class,2호선,상왕십리,6337,6238,12575
<class,2호선,왕십리,8258,6730,14988
<class,2호선,한양대,2422,2548,4970
<class,2호선,뚝섬,10103,10579,20682
<class,2호선,성수,13829,16154,29983
<class,2호선,건대입구,23023,24288,47311
<class,2호선,구의,10352,10299,20651
<class,2호선,강변,18661,17810,36471
<class,2호선,잠실나루,4684,4803,9487
<class,2호선,잠실,39566,37352,76918
<class,2호선,잠실새내,9593,9912,19505
<class,2호선,종합운동장,3011,3236,6247
<class,2호선,삼성,17037,16647,33684
<class,2호선,선릉,11223,9705,20928
<class,2호선,역삼,9499,10503,20002
<class,2호선,강남,30940,29417,60357
<class,2호선,교대,9163,10257,19420
<class,2호선,서초,8070,7153,15223
<class,2호선,방배,5682,6149,11831
<class,2호선,사당,18290,20318,38608
<class,2호선,낙성대,14597,14886,29483
<class,2호선,서울대입구,25112,25838,50950
<class,2호선,봉천,11084,10594,21678
<class,2호선,신림,33416,32597,66013
<class,2호선,신대방,14024,13835,27859
<class,2호선,구로디지털단지,20963,20453,41416
<class,2호선,대림,13077,13221,26298
<class,2호선,신도림,24820,24760,49580
<class,2호선,문래,6854,7322,14176
<class,2호선,영등포구청,6925,7036,13961
<class,2호선,당산,8037,8609,16646
<class,2호선,합정,18951,20391,39342
<class,2호선,홍대입구,43492,44064,87556
<class,2호선,신촌,21624,21504,43128
<class,2호선,이대,6689,7065,13754
<class,2호선,아현,4710,4713,9423
<class,2호선,충정로,3273,3432,6705
<class,2호선,용답,1568,1499,3067
<class,2호선,신답,666,772,1438
<class,2호선,신설동,2595,1448,4043
<class,2호선,도림천,428,415,843
<class,2호선,양천구청,3182,3337,6519
<class,2호선,신정네거리,4794,4879,9673
<class,2호선,용두,1125,1103,2228
<class,3호선,지축,2009,1977,3986
<class,3호선,구파발,10510,10577,21087
<class,3호선,연신내,20312,18985,39297
<class,3호선,불광,9397,10830,20227
<class,3호선,녹번,6639,6014,12653
<class,3호선,홍제,8292,8005,16297
<class,3호선,무악재,1721,1824,3545
<class,3호선,독립문,4048,4368,8416
<class,3호선,경복궁,11012,11879,22891
<class,3호선,안국,9190,10257,19447
<class,3호선,종로3가,3363,4684,8047
<class,3호선,을지로3가,2670,2558,5228
<class,3호선,동대입구,4346,4678,9024
<class,3호선,약수,5828,5666,11494
<class,3호선,금호,3843,3726,7569
<class,3호선,옥수,4726,4983,9709
<class,3호선,압구정,12407,12832,25239
<class,3호선,신사,12082,12444,24526
<class,3호선,잠원,2058,2034,4092
<class,3호선,고속터미널,34659,31506,66165
<class,3호선,교대,3711,2331,6042
<class,3호선,남부터미널,12845,13235,26080
<class,3호선,양재,11555,13424,24979
<class,3호선,매봉,3849,3842,7691
<class,3호선,도곡,1540,1659,3199
<class,3호선,대치,5624,4941,10565
<class,3호선,학여울,1878,2133,4011
<class,3호선,대청,3600,3539,7139
<class,3호선,일원,2848,3082,5930
<class,3호선,수서,8988,8857,17845
<class,3호선,가락시장,3258,3535,6793
<class,3호선,경찰병원,2530,2714,5244
<class,3호선,오금,2617,2560,5177
<class,4호선,수유,18163,17494,35657
<class,4호선,미아,7325,7007,14332
<class,4호선,미아사거리,14615,13662,28277
<class,4호선,길음,9015,8856,17871
<class,4호선,성신여대입구,11470,11098,22568
<class,4호선,한성대입구,7106,7150,14256
<class,4호선,혜화,18031,19059,37090
<class,4호선,동대문,6024,6672,12696
<class,4호선,동대문역사문화공원,7579,7280,14859
<class,4호선,충무로,7655,7732,15387
<class,4호선,명동,8996,9388,18384
<class,4호선,회현,7313,7860,15173
<class,4호선,서울역,3477,7161,10638
<class,4호선,숙대입구,5852,5563,11415
<class,4호선,삼각지,2016,2599,4615
<class,4호선,신용산,7038,7077,14115
<class,4호선,이촌,4117,4717,8834
<class,4호선,동작,1530,1592,3122
<class,4호선,총신대입구,9260,10199,19459
<class,4호선,사당,12870,12018,24888
<class,4호선,남태령,570,493,1063
<class,4호선,당고개,7323,7196,14519
<class,4호선,상계,9464,8951,18415
<class,4호선,노원,10756,11826,22582
<class,4호선,창동,13229,13838,27067
<class,4호선,쌍문,14240,12880,27120
<class,5호선,방화,3408,3362,6770
<class,5호선,개화산,2554,2579,5133
<class,5호선,김포공항,5991,5292,11283
<class,5호선,송정,3448,3467,6915
<class,5호선,마곡,3317,3362,6679
<class,5호선,발산,7946,8596,16542
<class,5호선,우장산,6130,6322,12452
<class,5호선,화곡,12921,12185,25106
<class,5호선,까치산,14381,13809,28190
<class,5호선,신정,5745,5186,10931
<class,5호선,목동,6963,7148,14111
<class,5호선,오목교,10391,10628,21019
<class,5호선,양평,2313,2320,4633
<class,5호선,영등포구청,1196,1127,2323
<class,5호선,영등포시장,3936,4199,8135
<class,5호선,신길,1695,1884,3579
<class,5호선,여의도,6416,7109,13525
<class,5호선,여의나루,11201,11404,22605
<class,5호선,마포,4182,4198,8380
<class,5호선,공덕,3926,3882,7808
<class,5호선,애오개,2302,2307,4609
<class,5호선,충정로,1342,1391,2733
<class,5호선,서대문,5177,5179,10356
<class,5호선,광화문,9794,9947,19741
<class,5호선,종로3가,7403,7019,14422
<class,5호선,을지로4가,1542,1629,3171
<class,5호선,동대문역사문화공원,584,747,1331
<class,5호선,청구,1670,1507,3177
<class,5호선,신금호,2717,2977,5694
<class,5호선,행당,3750,3325,7075
<class,5호선,왕십리,2213,2349,4562
<class,5호선,마장,2845,2716,5561
<class,5호선,답십리,6540,6157,12697
<class,5호선,장한평,6756,6711,13467
<class,5호선,군자,5354,5879,11233
<class,5호선,아차산,9893,9619,19512
<class,5호선,광나루,7248,7245,14493
<class,5호선,천호,10766,10132,20898
<class,5호선,강동,7881,7900,15781
<class,5호선,길동,3746,3876,7622
<class,5호선,굽은다리,4649,4253,8902
<class,5호선,명일,3973,3949,7922
<class,5호선,고덕,4057,4058,8115
<class,5호선,상일동,6306,6081,12387
<class,5호선,둔촌동,4192,4244,8436
<class,5호선,올림픽공원,2012,1877,3889
<class,5호선,방이,3484,3388,6872
<class,5호선,오금,1520,1422,2942
<class,5호선,개롱,2656,3007,5663
<class,5호선,거여,3787,3660,7447
<class,5호선,마천,3065,3285,6350
<class,5호선,강일,1698,1607,3305
<class,5호선,미사,7573,7569,15142
<class,5호선,하남풍산,1841,1966,3807
<class,5호선,하남시청,3133,3052,6185
<class,경부선,영등포,26795,25988,52783
<class,경부선,대방,4941,5282,10223
<class,5호선,하남검단산,4061,3961,8022
<class,6호선,응암,8512,8399,16911
<class,6호선,역촌,1798,2146,3944
<class,6호선,불광,2540,2560,5100
<class,6호선,독바위,1521,1851,3372
<class,6호선,구산,3532,2692,6224
<class,6호선,새절,5880,5683,11563
<class,6호선,증산,5228,5217,10445
<class,6호선,디지털미디어시티,4582,4944,9526
<class,6호선,월드컵경기장,3741,3811,7552
<class,6호선,마포구청,6635,5912,12547
<class,6호선,망원,9659,10560,20219
<class,6호선,합정,8820,7967,16787
<class,6호선,상수,5617,6641,12258
<class,6호선,광흥창,3777,3531,7308
<class,6호선,대흥,3571,3627,7198
<class,6호선,공덕,5883,5515,11398
<class,6호선,효창공원앞,3048,2684,5732
<class,6호선,삼각지,3378,2611,5989
<class,6호선,녹사평,3703,3579,7282
<class,6호선,이태원,7751,7722,15473
<class,6호선,한강진,5780,6741,12521
<class,6호선,버티고개,817,1005,1822
<class,6호선,약수,1632,1443,3075
<class,6호선,청구,1572,1523,3095
<class,6호선,신당,4128,4825,8953
<class,6호선,동묘앞,5685,5664,11349
<class,6호선,창신,1573,1350,2923
<class,6호선,보문,3614,3347,6961
<class,6호선,안암,4551,4874,9425
<class,6호선,고려대,3973,3878,7851
<class,6호선,월곡,4866,4808,9674
<class,6호선,상월곡,2935,2661,5596
<class,6호선,돌곶이,4124,3889,8013
<class,6호선,석계,5972,6136,12108
<class,6호선,태릉입구,2790,3123,5913
<class,6호선,화랑대,4573,3881,8454
<class,6호선,봉화산,3593,3506,7099
<class,7호선,장암,1445,1056,2501
<class,7호선,도봉산,5145,7469,12614
<class,경부선,노량진,5429,5155,10584
<class,7호선,수락산,8000,7934,15934
<class,7호선,마들,5495,5028,10523
<class,7호선,노원,10152,10282,20434
<class,7호선,중계,6077,5591,11668
<class,7호선,하계,8046,7461,15507
<class,7호선,공릉,5874,6015,11889
<class,7호선,태릉입구,4681,4347,9028
<class,7호선,먹골,4901,4670,9571
<class,7호선,중화,5463,5202,10665
<class,7호선,상봉,8326,7823,16149
<class,7호선,면목,7355,7333,14688
<class,7호선,사가정,8366,7926,16292
<class,7호선,용마산,3238,3641,6879
<class,7호선,중곡,4541,4493,9034
<class,7호선,군자,6950,5485,12435
<class,7호선,어린이대공원,6579,6543,13122
<class,7호선,건대입구,6775,6881,13656
<class,7호선,뚝섬유원지,8968,7918,16886
<class,7호선,청담,6067,6329,12396
<class,7호선,강남구청,5062,5608,10670
<class,7호선,학동,4934,5224,10158
<class,7호선,논현,5715,6064,11779
<class,7호선,반포,2509,2510,5019
<class,경부선,용산,26642,23763,50405
<class,경부선,남영,3757,4107,7864
<class,경부선,서울역,5590,1142,6732
<class,경강선,여주,1954,1867,3821
<class,경강선,세종대왕릉,283,267,550
<class,경강선,부발,1102,1727,2829
<class,경강선,이천,1963,2079,4042
<class,경강선,신둔도예촌,835,765,1600
<class,경강선,곤지암,1317,1443,2760
<class,경강선,초월,1529,1436,2965
<class,경강선,경기광주,3404,3393,6797
<class,경강선,삼동,941,906,1847
<class,경강선,이매,672,478,1150
<class,경강선,판교,2270,2084,4354
<class,9호선2~3단계,중앙보훈병원,3103,3118,6221
<class,9호선2~3단계,둔촌오륜,394,405,799
<class,9호선2~3단계,올림픽공원,3646,3756,7402
<class,9호선2~3단계,한성백제,1367,1181,2548
<class,9호선2~3단계,송파나루,2602,2963,5565
<class,9호선2~3단계,석촌,4246,3774,8020
<class,9호선2~3단계,석촌고분,2684,2698,5382
<class,9호선2~3단계,삼전,3112,3087,6199
<class,9호선2~3단계,종합운동장,1813,1749,3562
<class,9호선2~3단계,봉은사,6008,6251,12259
<class,9호선2~3단계,삼성중앙,1727,1852,3579
<class,9호선2~3단계,선정릉,2846,3189,6035
<class,9호선2~3단계,언주,3244,3190,6434
<class,9호선,신논현,13763,13025,26788
<class,9호선,사평,1301,1341,2642
<class,9호선,고속터미널,9142,11769,20911
<class,9호선,신반포,1405,1458,2863
<class,7호선,고속터미널,10189,6815,17004
<class,7호선,내방,4702,4874,9576
<class,7호선,이수,7444,7245,14689
<class,7호선,남성,4943,4821,9764
<class,7호선,숭실대입구,5306,5618,10924
<class,7호선,상도,4789,4760,9549
<class,7호선,장승배기,4506,4488,8994
<class,7호선,신대방삼거리,7315,7240,14555
<class,7호선,보라매,4219,4219,8438
<class,7호선,신풍,5442,5189,10631
<class,7호선,대림,6116,5749,11865
<class,7호선,남구로,5929,5800,11729
<class,7호선,가산디지털단지,9691,8961,18652
<class,7호선,철산,9491,9491,18982
<class,7호선,광명사거리,11311,11199,22510
<class,7호선,천왕,4431,4253,8684
<class,7호선,온수,3464,3552,7016
<class,7호선,까치울,3797,3822,7619
<class,7호선,부천종합운동장,2269,2042,4311
<class,7호선,춘의,3220,3115,6335
<class,7호선,신중동,6182,6120,12302
<class,7호선,부천시청,6226,5974,12200
<class,7호선,상동,6324,6191,12515
<class,7호선,삼산체육관,2630,2422,5052
<class,7호선,굴포천,4212,4193,8405
<class,7호선,부평구청,3256,3071,6327
<class,8호선,암사,8193,7619,15812
<class,8호선,천호,7817,9013,16830
<class,8호선,강동구청,3904,3947,7851
<class,8호선,몽촌토성,3000,2891,5891
<class,8호선,잠실,8328,9233,17561
<class,8호선,석촌,3601,4582,8183
<class,8호선,송파,3096,3145,6241
<class,8호선,가락시장,2722,3537,6259
<class,8호선,문정,4735,5129,9864
<class,8호선,장지,8113,8348,16461
<class,8호선,복정,4355,4233,8588
<class,8호선,산성,3188,3236,6424
<class,8호선,남한산성입구,6168,5768,11936
<class,8호선,단대오거리,4932,4802,9734
<class,8호선,신흥,2543,2669,5212
<class,8호선,수진,2917,2558,5475
<class,8호선,모란,2434,2094,4528
<class,9호선,개화,1076,1028,2104
<class,9호선,김포공항,6564,9734,16298
<class,9호선,공항시장,1505,1655,3160
<class,9호선,신방화,3104,3039,6143
<class,9호선,마곡나루,5316,5309,10625
<class,9호선,양천향교,3803,4055,7858
<class,9호선,가양,8737,8709,17446
<class,9호선,증미,2269,2354,4623
<class,9호선,등촌,4707,4801,9508
<class,9호선,염창,7550,7307,14857
<class,9호선,신목동,1543,1425,2968
<class,9호선,선유도,2958,2911,5869
<class,9호선,당산,7850,7631,15481
<class,9호선,국회의사당,3222,3244,6466
<class,9호선,여의도,7589,6989,14578
<class,9호선,샛강,1500,1544,3044
<class,9호선,노량진,13150,14008,27158
<class,9호선,노들,2393,2061,4454
<class,9호선,흑석,3496,3656,7152
<class,9호선,동작,1367,1158,2525
<class,9호선,구반포,854,950,1804
<class,중앙선,지평,57,67,124
<class,중앙선,용문,2208,1831,4039
<class,중앙선,원덕,366,312,678
<class,중앙선,양평,2331,2086,4417
<class,중앙선,오빈,221,211,432
<class,중앙선,아신,601,473,1074
<class,경부선,신길,5298,4106,9404
<class,3호선,구파발,13446,13118,26564
<class,3호선,연신내,26947,24527,51474
<class,3호선,불광,11867,13240,25107
<class,3호선,홍제,11599,10513,22112
<class,3호선,무악재,2336,2405,4741
<class,3호선,독립문,5192,5488,10680
<class,3호선,경복궁,12829,13822,26651
<class,3호선,안국,11161,12803,23964
<class,3호선,종로3가,4483,6258,10741
<class,3호선,을지로3가,3897,4115,8012
<class,3호선,충무로,3,0,3
<class,3호선,동대입구,4933,5275,10208
<class,3호선,약수,8126,7222,15348
<class,3호선,금호,5250,4749,9999
<class,3호선,옥수,6418,6299,12717
<class,3호선,압구정,20968,21981,42949
<class,3호선,신사,18521,19506,38027
<class,3호선,잠원,3008,2797,5805
<class,3호선,고속터미널,38223,59558,97781
<class,3호선,교대,5296,3065,8361
<class,3호선,남부터미널,16103,20614,36717
<class,3호선,양재,14964,15821,30785
<class,3호선,매봉,5026,4813,9839
<class,3호선,도곡,2680,2494,5174
<class,3호선,대치,9021,7897,16918
<class,3호선,학여울,859,878,1737
<class,3호선,대청,5107,4556,9663
<class,3호선,일원,3974,3851,7825
<class,3호선,수서,9042,9905,18947
<class,3호선,가락시장,5422,4984,10406
<class,3호선,경찰병원,3349,3025,6374
<class,3호선,오금,3046,2800,5846
<class,4호선,수유,23537,21893,45430
<class,4호선,미아,9769,9255,19024
<class,4호선,미아사거리,19349,18088,37437
<class,4호선,길음,11955,11046,23001
<class,4호선,성신여대입구,14459,12825,27284
<class,4호선,한성대입구,9076,8451,17527
<class,4호선,혜화,20358,20369,40727
<class,4호선,동대문,11330,11485,22815
<class,4호선,동대문역사문화공원,8828,8118,16946
<class,4호선,충무로,9830,9994,19824
<class,4호선,명동,10320,11644,21964
<class,4호선,회현,13768,15105,28873
<class,4호선,서울역,4433,9478,13911
<class,4호선,숙대입구,7082,6647,13729
<class,4호선,삼각지,2595,2979,5574
<class,4호선,신용산,7658,9006,16664
<class,4호선,이촌,5319,5981,11300
<class,4호선,동작,1722,1763,3485
<class,4호선,총신대입구,13196,13990,27186
<class,4호선,사당,15798,13360,29158
<class,4호선,남태령,808,653,1461
<class,4호선,당고개,8864,8472,17336
<class,4호선,상계,12545,11840,24385
<class,4호선,노원,13768,15143,28911
<class,4호선,창동,17603,18662,36265
<class,4호선,쌍문,18679,16470,35149
<class,5호선,방화,4012,3832,7844
<class,5호선,개화산,3359,3235,6594
<class,5호선,김포공항,6236,7576,13812
<class,5호선,송정,4443,4140,8583
<class,5호선,마곡,4450,4412,8862
<class,5호선,우장산,8839,8794,17633
<class,5호선,화곡,17600,15525,33125
<class,5호선,까치산,18816,17143,35959
<class,5호선,신정,7636,6466,14102
<class,5호선,목동,9693,9571,19264
<class,5호선,오목교,13326,13784,27110
<class,5호선,양평,2994,2654,5648
<class,5호선,영등포구청,1618,1545,3163
<class,5호선,영등포시장,5492,5471,10963
<class,5호선,신길,1968,1875,3843
<class,5호선,여의도,7751,8597,16348
<class,5호선,여의나루,11665,12161,23826
<class,5호선,마포,5770,5748,11518
<class,5호선,공덕,5390,5439,10829
<class,5호선,애오개,3050,2819,5869
<class,5호선,충정로,1559,1417,2976
<class,5호선,서대문,5716,5443,11159
<class,5호선,광화문,11632,11546,23178
<class,5호선,종로3가,9443,9797,19240
<class,5호선,을지로4가,2701,2959,5660
<class,5호선,동대문역사문화공원,771,950,1721
<class,5호선,청구,2240,2048,4288
<class,5호선,신금호,3435,3479,6914
<class,5호선,행당,4733,4018,8751
<class,5호선,왕십리,2890,3473,6363
<class,5호선,마장,4143,4020,8163
<class,5호선,답십리,8755,7360,16115
<class,5호선,장한평,9106,8817,17923
<class,5호선,군자,6710,6985,13695
<class,5호선,아차산,10756,10315,21071
<class,5호선,광나루,7926,7734,15660
<class,5호선,천호,13788,13210,26998
<class,5호선,강동,9810,9056,18866
<class,5호선,길동,5456,5550,11006
<class,5호선,굽은다리,6084,5781,11865
<class,5호선,명일,5133,5117,10250
<class,5호선,고덕,5602,5413,11015
<class,5호선,상일동,8241,7402,15643
<class,5호선,둔촌동,5254,5231,10485
<class,5호선,올림픽공원,2555,2301,4856
<class,5호선,방이,4437,4221,8658
<class,5호선,오금,1703,1612,3315
<class,5호선,개롱,3673,3970,7643
<class,5호선,거여,4995,4698,9693
<class,5호선,마천,4079,4204,8283
<class,5호선,강일,2270,2200,4470
<class,5호선,미사,9883,9516,19399
<class,5호선,하남풍산,2377,2417,4794
<class,5호선,하남시청,4354,4112,8466
<class,5호선,하남검단산,4417,4571,8988
<class,6호선,응암,11381,10675,22056
<class,6호선,역촌,2452,2722,5174
<class,6호선,불광,3333,3119,6452
<class,6호선,독바위,1877,2099,3976
<class,6호선,연신내,1,0,1
<class,6호선,구산,4856,3603,8459
<class,6호선,새절,7658,7080,14738
<class,6호선,증산,6618,6232,12850
<class,6호선,디지털미디어시티,5899,5953,11852
<class,6호선,월드컵경기장,4498,4763,9261
<class,6호선,마포구청,8064,6605,14669
<class,6호선,망원,12445,13501,25946
<class,6호선,합정,9886,9029,18915
<class,6호선,상수,6131,6895,13026
<class,6호선,광흥창,4524,4087,8611
<class,6호선,대흥,4674,4320,8994
<class,6호선,공덕,8292,7495,15787
<class,6호선,효창공원앞,3884,3219,7103
<class,6호선,삼각지,3646,2819,6465
<class,6호선,녹사평,4319,4359,8678
<class,6호선,이태원,9486,10218,19704
<class,6호선,한강진,5816,7475,13291
<class,6호선,버티고개,1069,1287,2356
<class,6호선,약수,2236,2025,4261
<class,6호선,청구,2068,2067,4135
<class,6호선,신당,4848,4364,9212
<class,6호선,동묘앞,6697,6312,13009
<class,6호선,창신,1884,1512,3396
<class,6호선,보문,4371,3477,7848
<class,6호선,안암,5336,4457,9793
<class,6호선,고려대,4629,3983,8612
<class,6호선,월곡,6552,6253,12805
<class,6호선,상월곡,3634,3107,6741
<class,6호선,돌곶이,5339,4697,10036
<class,6호선,석계,7639,7623,15262
<class,6호선,태릉입구,3353,3507,6860
<class,6호선,화랑대,5871,4808,10679
<class,6호선,봉화산,4692,4729,9421
<class,6호선,신내,1,0,1
<class,7호선,장암,1489,1164,2653
<class,7호선,도봉산,5789,8052,13841
<class,7호선,수락산,9418,9131,18549
<class,7호선,마들,8083,7478,15561
<class,7호선,노원,14001,14616,28617
<class,7호선,중계,8196,7108,15304
<class,7호선,하계,10766,9674,20440
<class,7호선,공릉,7647,7018,14665
<class,7호선,태릉입구,5606,5000,10606
<class,7호선,먹골,6911,6319,13230
<class,7호선,중화,6740,6216,12956
<class,7호선,상봉,11392,10681,22073
<class,7호선,면목,10210,9697,19907
<class,7호선,사가정,10861,10398,21259
<class,7호선,용마산,3802,3857,7659
<class,7호선,중곡,6036,5598,11634
<class,7호선,군자,9258,6710,15968
<class,7호선,어린이대공원,7951,6815,14766
<class,7호선,건대입구,8885,8656,17541
<class,7호선,뚝섬유원지,10192,9253,19445
<class,7호선,청담,8336,8818,17154
<class,7호선,강남구청,7081,7559,14640
<class,7호선,학동,7006,7226,14232
<class,7호선,논현,9187,10085,19272
<class,7호선,반포,3731,3590,7321
<class,7호선,고속터미널,9293,11644,20937
<class,7호선,내방,6765,6652,13417
<class,7호선,이수,10071,9055,19126
<class,7호선,남성,6695,5762,12457
<class,7호선,숭실대입구,6945,6334,13279
<class,7호선,상도,6534,5435,11969
<class,7호선,장승배기,6067,5516,11583
<class,7호선,신대방삼거리,10036,8649,18685
<class,7호선,보라매,5168,4734,9902
<class,7호선,신풍,7162,6588,13750
<class,7호선,대림,7350,7565,14915
<class,7호선,남구로,7690,7703,15393
<class,7호선,가산디지털단지,12187,10664,22851
<class,7호선,철산,13027,13014,26041
<class,7호선,광명사거리,15971,15790,31761
<class,7호선,천왕,6225,5822,12047
<class,7호선,온수,5055,4801,9856
<class,7호선,까치울,4636,4580,9216
<class,7호선,부천종합운동장,2775,2492,5267
<class,7호선,춘의,4475,4277,8752
<class,7호선,신중동,8271,8034,16305
<class,7호선,부천시청,8522,8389,16911
<class,7호선,상동,8410,8838,17248
<class,7호선,삼산체육관,3009,2723,5732
<class,7호선,굴포천,5582,5643,11225
<class,7호선,부평구청,4207,3957,8164
<class,8호선,암사,11136,10157,21293
<class,8호선,천호,9921,11238,21159
<class,8호선,강동구청,5245,5172,10417
<class,8호선,몽촌토성,3558,3320,6878
<class,8호선,잠실,9820,11305,21125
<class,8호선,석촌,4813,5827,10640
<class,8호선,송파,4285,4161,8446
<class,8호선,가락시장,4721,4807,9528
<class,8호선,문정,5734,5450,11184
<class,8호선,장지,9546,9095,18641
<class,8호선,복정,5627,4881,10508
<class,8호선,산성,3870,3856,7726
<class,8호선,남한산성입구,8017,7042,15059
<class,8호선,단대오거리,6516,5973,12489
<class,8호선,신흥,3211,3402,6613
<class,8호선,수진,3625,3228,6853
<class,8호선,모란,3247,2762,6009
<class,9호선,개화,1382,1133,2515
<class,9호선,김포공항,6151,13871,20022
<class,9호선,공항시장,1940,2012,3952
<class,9호선,신방화,4099,3828,7927
<class,9호선,마곡나루,5842,5623,11465
<class,9호선,양천향교,4888,4309,9197
<class,9호선,가양,12189,10707,22896
<class,9호선,증미,3852,3592,7444
<class,9호선,등촌,6840,6267,13107
<class,9호선,염창,9985,8617,18602
<class,9호선,신목동,2063,1730,3793
<class,9호선,선유도,3398,3123,6521
<class,9호선,당산,10309,8918,19227
<class,9호선,국회의사당,2611,2613,5224
<class,9호선,여의도,8497,8162,16659
<class,9호선,샛강,2235,2232,4467
<class,9호선,노량진,18733,17062,35795
<class,9호선,노들,2933,2451,5384
<class,9호선,흑석,4842,4707,9549
<class,9호선,동작,1109,839,1948
<class,9호선,구반포,1397,1456,2853
<class,9호선,신반포,2036,1959,3995
<class,9호선,고속터미널,10214,22050,32264
<class,9호선,사평,1948,1791,3739
<class,9호선,신논현,20449,20109,40558
<class,9호선2~3단계,언주,4239,3915,8154
<class,9호선2~3단계,선정릉,3677,3733,7410
<class,9호선2~3단계,삼성중앙,2356,2246,4602
<class,9호선2~3단계,봉은사,7457,7535,14992
<class,9호선2~3단계,종합운동장,2422,2134,4556
<class,9호선2~3단계,삼전,4177,3555,7732
<class,9호선2~3단계,석촌고분,3618,3153,6771
<class,9호선2~3단계,석촌,5430,4329,9759
<class,9호선2~3단계,송파나루,3235,3450,6685
<class,9호선2~3단계,한성백제,1607,1240,2847
<class,9호선2~3단계,올림픽공원,4119,4205,8324
<class,9호선2~3단계,둔촌오륜,464,480,944
<class,9호선2~3단계,중앙보훈병원,3671,3507,7178
<class,경강선,판교,2725,2490,5215
<class,경강선,이매,813,617,1430
<class,경강선,삼동,1327,1259,2586
<class,경강선,경기광주,4868,4834,9702
<class,경강선,초월,1929,1833,3762
<class,경강선,곤지암,1747,1908,3655
<class,경강선,신둔도예촌,915,1073,1988
<class,경강선,이천,2416,2612,5028
<class,경강선,부발,1540,1488,3028
<class,경강선,세종대왕릉,335,380,715
<class,경강선,여주,2146,2763,4909
<class,경부선,서울역,3007,1425,4432
<class,경부선,남영,4900,4837,9737
<class,경부선,용산,25332,29607,54939
<class,경부선,노량진,7791,6880,14671
<class,경부선,대방,6462,6068,12530
<class,경부선,영등포,29624,30712,60336
<class,경부선,신도림,2385,2335,4720
<class,경부선,구로,10523,10660,21183
<class,경부선,가산디지털단지,5307,6756,12063
<class,경부선,금천구청,7251,6881,14132
<class,경부선,석수,5851,5340,11191
<class,경부선,관악,4842,4630,9472
<class,경부선,안양,14939,14948,29887
<class,경부선,명학,3855,3698,7553
<class,경부선,금정,15534,15826,31360
<class,경부선,군포,3648,3259,6907
<class,경부선,의왕,4848,4824,9672
<class,경부선,성균관대,8770,8129,16899
<class,경부선,화서,4152,4280,8432
<class,경부선,수원,31670,34216,65886
<class,경부선,독산,7902,7602,15504
<class,경부선,세류,2263,2452,4715
<class,경부선,병점,10070,9986,20056
<class,경부선,세마,1892,1718,3610
<class,경부선,오산대,2433,2190,4623
<class,경부선,오산,8969,8772,17741
<class,경부선,진위,944,789,1733
<class,경부선,송탄,4294,3714,8008
<class,경부선,서정리,5432,4617,10049
<class,경부선,평택지제,2213,2420,4633
<class,경부선,평택,13095,13032,26127
<class,경부선,성환,2730,2647,5377
<class,경부선,직산,616,619,1235
<class,경부선,두정,5167,5365,10532
<class,경부선,천안,6115,7364,13479
<class,경부선,당정,3317,3139,6456
<class,경부선,서동탄,840,843,1683
<class,경부선,광명,1724,1840,3564
<class,경원선,이촌,2835,1998,4833
<class,경원선,서빙고,1192,1078,2270
<class,경원선,한남,2603,2389,4992
<class,경원선,옥수,21,20,41
<class,경원선,응봉,1245,1052,2297
<class,경원선,왕십리,10296,11154,21450
<class,경원선,청량리,13219,14483,27702
<class,경원선,외대앞,5377,4821,10198
<class,경원선,신이문,5780,5277,11057
<class,경원선,석계,6041,6248,12289
<class,경원선,광운대,5194,4860,10054
<class,경원선,월계,4405,3974,8379
<class,경원선,녹천,3050,2555,5605
<class,경원선,창동,1,0,1
<class,경원선,방학,6951,6570,13521
<class,경원선,도봉,4232,3938,8170
<class,경원선,도봉산,8006,5533,13539
<class,경원선,망월사,5189,5372,10561
<class,경원선,회룡,8751,8841,17592
<class,경원선,의정부,16011,16958,32969
<class,경원선,가능,4753,4477,9230
<class,경원선,녹양,3200,3146,6346
<class,경원선,양주,5872,5863,11735
<class,경원선,덕계,2001,1906,3907
<class,경원선,덕정,4052,3755,7807
<class,경원선,지행,4990,5125,10115
<class,경원선,동두천중앙,2393,2395,4788
<class,경원선,보산,2065,1727,3792
<class,경원선,동두천,1525,2117,3642
<class,경원선,소요산,3508,3180,6688
<class,경의선,서울역,1010,1139,2149
<class,경의선,신촌,300,302,602
<class,경의선,효창공원앞,1510,1607,3117
<class,경의선,공덕,1687,1554,3241
<class,경의선,서강대,1498,1269,2767
<class,경의선,홍대입구,1645,1843,3488
<class,경의선,가좌,3530,3211,6741
<class,경의선,디지털미디어시티,1645,1476,3121
<class,경의선,수색,1246,1241,2487
<class,경의선,화전,887,852,1739
<class,경의선,강매,1769,1628,3397
<class,경의선,행신,4383,4447,8830
<class,경의선,능곡,2556,2445,5001
<class,경의선,곡산,382,467,849
<class,경의선,백마,3874,3676,7550
<class,경의선,풍산,3830,3782,7612
<class,경의선,일산,6605,6576,13181
<class,경의선,탄현,4645,4524,9169
<class,경의선,야당,5077,4994,10071
<class,경의선,운정,4245,4101,8346
<class,경의선,금릉,3412,3368,6780
<class,경의선,금촌,5300,5164,10464
<class,경의선,월롱,1252,1073,2325
<class,경의선,파주,782,667,1449
<class,경의선,문산,4289,4278,8567
<class,경의선,임진강,76,70,146
<class,경인선,개봉,13934,13509,27443
<class,경인선,오류동,8039,7058,15097
<class,경인선,역곡,17160,17014,34174
<class,경인선,부천,25438,25914,51352
<class,경인선,송내,15002,14945,29947
<class,경인선,부평,25196,27980,53176
<class,경인선,백운,4820,4681,9501
<class,경인선,동암,10878,11020,21898
<class,경인선,주안,13093,11701,24794
<class,2호선,사당,22266,24456,46722
<class,경인선,제물포,6178,5970,12148
<class,경인선,동인천,10362,10434,20796
<class,경인선,인천,3756,3434,7190
<class,경인선,구일,3655,3336,6991
<class,경인선,소사,5795,5806,11601
<class,경인선,부개,5747,5445,11192
<class,경인선,간석,3656,3591,7247
<class,경인선,도원,1633,1695,3328
<class,경인선,온수,4271,3901,8172
<class,경인선,중동,5749,5565,11314
<class,경인선,도화,2785,2521,5306
<class,경춘선,신내,1002,944,1946
<class,경춘선,갈매,1746,1549,3295
<class,경춘선,별내,2099,2086,4185
<class,경춘선,퇴계원,2345,2205,4550
<class,경춘선,사릉,2170,2194,4364
<class,경춘선,금곡,1113,986,2099
<class,경춘선,평내호평,4221,4237,8458
<class,경춘선,천마산,1293,1293,2586
<class,경춘선,마석,3299,3467,6766
<class,경춘선,대성리,702,689,1391
<class,경춘선,청평,1648,1895,3543
<class,경춘선,상천,431,383,814
<class,경춘선,가평,1784,2391,4175
<class,경춘선,굴봉산,176,198,374
<class,경춘선,백양리,140,189,329
<class,경춘선,강촌,677,773,1450
<class,경춘선,김유정,417,589,1006
<class,경춘선,남춘천,2425,2962,5387
<class,경춘선,춘천,1772,1822,3594
<class,공항철도 1호선,서울역,5098,5724,10822
<class,공항철도 1호선,공덕,1214,1469,2683
<class,공항철도 1호선,홍대입구,9567,9000,18567
<class,공항철도 1호선,디지털미디어시티,4023,3537,7560
<class,공항철도 1호선,마곡나루,2507,2490,4997
<class,공항철도 1호선,김포공항,10190,6841,17031
<class,공항철도 1호선,계양,5556,5308,10864
<class,공항철도 1호선,검암,3825,3867,7692
<class,공항철도 1호선,청라국제도시,3367,3345,6712
<class,공항철도 1호선,운서,5269,5320,10589
<class,공항철도 1호선,공항화물청사,1252,1310,2562
<class,공항철도 1호선,인천공항1터미널,3236,3475,6711
<class,공항철도 1호선,인천공항2터미널,1964,1803,3767
<class,공항철도 1호선,영종,2570,2681,5251
<class,과천선,선바위,4180,3879,8059
<class,과천선,경마공원,1035,1026,2061
<class,과천선,대공원,5293,5576,10869
<class,과천선,과천,3909,3525,7434
<class,과천선,정부과천청사,4924,4964,9888
<class,과천선,인덕원,12360,12230,24590
<class,과천선,평촌,7246,6969,14215
<class,과천선,범계,16431,16110,32541
<class,분당선,선릉,3914,5558,9472
<class,분당선,한티,11260,10602,21862
<class,분당선,도곡,3601,3236,6837
<class,분당선,구룡,1042,914,1956
<class,분당선,개포동,2285,2247,4532
<class,분당선,대모산입구,2452,2253,4705
<class,분당선,수서,6633,7749,14382
<class,분당선,복정,1,0,1
<class,분당선,수원,6212,5543,11755
<class,분당선,서울숲,7382,7458,14840
<class,분당선,압구정로데오,13886,15939,29825
<class,분당선,강남구청,3829,4570,8399
<class,분당선,선정릉,2512,2538,5050
<class,분당선,가천대,3955,3979,7934
<class,분당선,태평,9957,9103,19060
<class,분당선,모란,14326,14441,28767
<class,분당선,야탑,14374,16210,30584
<class,분당선,서현,15824,16036,31860
<class,분당선,수내,7986,7426,15412
<class,분당선,정자,9413,9396,18809
<class,분당선,미금,9665,9791,19456
<class,분당선,오리,6785,5566,12351
<class,분당선,이매,3650,3464,7114
<class,분당선,보정,1391,1289,2680
<class,분당선,죽전,8926,9801,18727
<class,분당선,구성,2744,2939,5683
<class,분당선,신갈,2271,2375,4646
<class,분당선,기흥,5634,5410,11044
<class,분당선,상갈,3462,3441,6903
<class,분당선,청명,2252,2142,4394
<class,분당선,영통,5455,5151,10606
<class,분당선,망포,7608,6717,14325
<class,분당선,매탄권선,2865,2685,5550
<class,분당선,수원시청,7840,8170,16010
<class,분당선,매교,1571,1637,3208
<class,수인선,고색,1940,1949,3889
<class,수인선,오목천,1692,1475,3167
<class,수인선,어천,679,593,1272
<class,수인선,야목,194,179,373
<class,수인선,사리,2817,2442,5259
<class,수인선,달월,60,49,109
<class,수인선,월곶,1788,1791,3579
<class,수인선,소래포구,5874,6271,12145
<class,수인선,인천논현,3902,3993,7895
<class,수인선,호구포,2275,2157,4432
<class,수인선,남동인더스파크,895,827,1722
<class,수인선,원인재,3292,3406,6698
<class,수인선,연수,3421,3337,6758
<class,수인선,송도,1788,1706,3494
<class,수인선,인하대,3667,3227,6894
<class,수인선,숭의,2351,2105,4456
<class,수인선,신포,1254,1331,2585
<class,수인선,인천,1151,1682,2833
<class,안산선,산본,10709,11600,22309
<class,안산선,대야미,3479,3087,6566
<class,안산선,반월,3039,2968,6007
<class,안산선,상록수,10506,10454,20960
<class,안산선,한대앞,6381,6343,12724
<class,안산선,중앙,12702,13698,26400
<class,안산선,고잔,4835,4559,9394
<class,안산선,초지,2626,2726,5352
<class,안산선,안산,9419,10096,19515
<class,안산선,신길온천,1263,1185,2448
<class,안산선,정왕,6005,5630,11635
<class,안산선,오이도,6698,7170,13868
<class,안산선,수리산,2599,2245,4844
<class,우이신설선,북한산우이,3210,3147,6357
<class,우이신설선,솔밭공원,1741,1642,3383
<class,우이신설선,4.19민주묘지,2253,1843,4096
<class,우이신설선,가오리,2822,2570,5392
<class,우이신설선,화계,2358,2133,4491
<class,우이신설선,삼양,1387,1411,2798
<class,우이신설선,삼양사거리,1855,1774,3629
<class,우이신설선,솔샘,3425,2947,6372
<class,우이신설선,북한산보국문,4145,3606,7751
<class,우이신설선,정릉,3273,2632,5905
<class,우이신설선,성신여대입구,2510,2844,5354
<class,우이신설선,보문,1016,929,1945
<class,우이신설선,신설동,1283,1343,2626
<class,일산선,원흥,6393,6006,12399
<class,일산선,지축,2,0,2
<class,일산선,삼송,12352,11989,24341
<class,일산선,원당,7595,7213,14808
<class,일산선,화정,11483,11777,23260
<class,일산선,대곡,1287,1043,2330
<class,일산선,백석,6669,6730,13399
<class,일산선,마두,4464,4473,8937
<class,일산선,정발산,5430,5700,11130
<class,일산선,주엽,5852,5676,11528
<class,일산선,대화,7393,6501,13894
<class,장항선,봉명,647,588,1235
<class,장항선,쌍용,1260,1178,2438
<class,장항선,아산,2306,2789,5095
<class,장항선,배방,872,898,1770
<class,장항선,온양온천,3293,3526,6819
<class,장항선,신창,1143,1156,2299
<class,중앙선,회기,16453,13832,30285
<class,중앙선,중랑,4280,3864,8144
<class,중앙선,상봉,4602,4367,8969
<class,중앙선,망우,5830,5574,11404
<class,중앙선,양원,1106,1100,2206
<class,중앙선,구리,9047,9351,18398
<class,중앙선,도농,5905,5690,11595
<class,중앙선,양정,598,557,1155
<class,중앙선,덕소,4249,4362,8611
<class,중앙선,도심,1497,1245,2742
<class,중앙선,팔당,1530,1659,3189
<class,중앙선,운길산,1419,1424,2843
<class,중앙선,양수,2239,2397,4636
<class,중앙선,신원,377,321,698
<class,중앙선,국수,674,739,1413
<class,중앙선,아신,633,698,1331
<class,중앙선,오빈,250,271,521
<class,중앙선,양평,3845,4453,8298
<class,중앙선,원덕,401,478,879
<class,중앙선,용문,1946,2591,4537
<class,중앙선,지평,43,78,121
<class,2호선,봉천,15038,12651,27689
<class,2호선,신림,42384,36815,79199
<class,2호선,신대방,17176,15430,32606
<class,2호선,구로디지털단지,27380,25558,52938
<class,2호선,대림,15757,16661,32418
<class,2호선,신도림,29968,29518,59486
<class,2호선,문래,8536,8838,17374
<class,2호선,영등포구청,9474,9302,18776
<class,2호선,당산,9838,10431,20269
<class,2호선,방배,7662,7858,15520
<class,2호선,서초,7186,6191,13377
<class,2호선,교대,13406,14927,28333
<class,2호선,강남,45511,45410,90921
<class,2호선,역삼,13171,14256,27427
<class,2호선,선릉,17334,15210,32544
<class,2호선,삼성,20086,20174,40260
<class,2호선,종합운동장,3950,4062,8012
<class,2호선,잠실새내,13614,13824,27438
<class,2호선,잠실,47144,45719,92863
<class,2호선,잠실나루,6181,6135,12316
<class,2호선,강변,20947,29780,50727
<class,2호선,구의,13511,12623,26134
<class,2호선,건대입구,26927,27938,54865
<class,2호선,성수,13635,15667,29302
<class,2호선,뚝섬,11111,11305,22416
<class,2호선,한양대,2462,2209,4671
<class,2호선,왕십리,10250,8116,18366
<class,2호선,상왕십리,8303,7525,15828
<class,2호선,신당,9436,9487,18923
<class,2호선,동대문역사문화공원,7965,8790,16755
<class,2호선,을지로4가,5786,5893,11679
<class,2호선,을지로3가,7575,7439,15014
<class,2호선,을지로입구,15656,15856,31512
<class,2호선,시청,6389,5681,12070
<class,1호선,청량리,18902,19116,38018
<class,1호선,제기동,16939,17860,34799
<class,1호선,신설동,8476,7696,16172
<class,1호선,동대문,10021,9369,19390
<class,1호선,종로5가,15648,15823,31471
<class,1호선,종로3가,18360,17183,35543
<class,1호선,종각,13406,12824,26230
<class,1호선,시청,7786,7761,15547
<class,1호선,동묘앞,10535,10684,21219
<class,1호선,서울역,22200,26522,48722
<class,3호선,녹번,9181,7629,16810
<class,5호선,발산,10398,10731,21129
<class,2호선,합정,20873,22140,43013
<class,2호선,홍대입구,47689,49695,97384
<class,2호선,신촌,23445,22341,45786
<class,2호선,이대,8124,7924,16048
<class,2호선,아현,6132,5613,11745
<class,2호선,충정로,3980,3962,7942
<class,2호선,용답,1965,1694,3659
<class,2호선,신답,842,846,1688
<class,2호선,신설동,2603,2411,5014
<class,2호선,도림천,725,642,1367
<class,2호선,양천구청,3779,3816,7595
<class,2호선,신정네거리,6327,6191,12518
<class,2호선,낙성대,17956,14600,32556
<class,2호선,서울대입구,30976,27405,58381
<class,2호선,용두,1765,1722,3487
<class,3호선,지축,2564,2477,5041
<class,2호선,건대입구,20017,20578,40595
<class,2호선,성수,9430,10907,20337
<class,2호선,뚝섬,7998,7984,15982
<class,2호선,한양대,1635,1435,3070
<class,2호선,왕십리,7048,5480,12528
<class,2호선,상왕십리,5772,5204,10976
<class,2호선,신당,6999,7240,14239
<class,2호선,동대문역사문화공원,6020,7063,13083
<class,2호선,을지로4가,2555,2566,5121
<class,2호선,을지로3가,5086,5283,10369
<class,2호선,을지로입구,11856,11597,23453
<class,2호선,시청,4541,3756,8297
<class,1호선,청량리,14353,14781,29134
<class,1호선,제기동,12011,12515,24526
<class,1호선,신설동,6513,5651,12164
<class,1호선,동대문,9354,9909,19263
<class,1호선,종로5가,8627,8762,17389
<class,1호선,종로3가,12168,10948,23116
<class,1호선,종각,9589,8540,18129
<class,1호선,동묘앞,11071,11073,22144
<class,1호선,서울역,18148,22193,40341
<class,2호선,당산,6760,7087,13847
<class,2호선,영등포구청,5898,5862,11760
<class,2호선,문래,5824,5961,11785
<class,2호선,신도림,20972,20575,41547
<class,2호선,대림,12763,13478,26241
<class,2호선,구로디지털단지,18813,17292,36105
<class,2호선,신대방,12577,11371,23948
<class,2호선,신림,30333,25872,56205
<class,7호선,철산,8982,9060,18042
<class,7호선,광명사거리,12012,12019,24031
<class,1호선,시청,5782,5831,11613
<class,2호선,봉천,10016,8409,18425
<class,중앙선,도농,4337,4313,8650
<class,중앙선,구리,6648,7115,13763
<class,중앙선,양원,775,797,1572
<class,중앙선,망우,4352,4196,8548
<class,중앙선,상봉,3719,3552,7271
<class,중앙선,중랑,3208,2941,6149
<class,중앙선,회기,12594,10768,23362
<class,장항선,신창,855,1084,1939
<class,장항선,온양온천,4045,4271,8316
<class,중앙선,지평,39,81,120
<class,중앙선,용문,1697,2237,3934
<class,중앙선,원덕,338,390,728
<class,중앙선,양평,2101,2550,4651
<class,중앙선,오빈,213,226,439
<class,중앙선,아신,546,561,1107
<class,중앙선,국수,536,550,1086
<class,중앙선,신원,293,274,567
<class,중앙선,양수,1815,1814,3629
<class,중앙선,운길산,1385,1317,2702
<class,중앙선,팔당,1379,1483,2862
<class,중앙선,도심,1122,1039,2161
<class,중앙선,덕소,3166,3224,6390
<class,중앙선,양정,462,421,883
<class,2호선,서울대입구,21160,18598,39758
<class,장항선,배방,731,734,1465
<class,장항선,아산,1852,2145,3997
<class,장항선,쌍용,1085,1075,2160
<class,장항선,봉명,478,454,932
<class,일산선,대화,5396,4928,10324
<class,일산선,주엽,3967,4088,8055
<class,일산선,정발산,4293,4382,8675
<class,일산선,마두,3048,3100,6148
<class,일산선,백석,4906,4924,9830
<class,일산선,대곡,878,799,1677
<class,일산선,화정,8223,8346,16569
<class,일산선,원당,5718,5703,11421
<class,일산선,삼송,9571,9367,18938
<class,일산선,원흥,4725,4326,9051
<class,우이신설선,신설동,1035,994,2029
<class,우이신설선,보문,760,715,1475
<class,우이신설선,성신여대입구,1764,1973,3737
<class,우이신설선,정릉,2320,1897,4217
<class,우이신설선,북한산보국문,3164,2671,5835
<class,2호선,낙성대,12338,10142,22480
<class,2호선,사당,15244,16593,31837
<class,2호선,방배,4770,4802,9572
<class,2호선,서초,6257,5839,12096
<class,2호선,교대,7538,8361,15899
<class,2호선,강남,25909,25349,51258
<class,2호선,역삼,7515,7954,15469
<class,2호선,선릉,8962,7604,16566
<class,2호선,삼성,14023,13962,27985
<class,2호선,종합운동장,2859,2946,5805
<class,2호선,잠실새내,8660,9071,17731
<class,2호선,잠실,36356,35074,71430
<class,우이신설선,솔샘,2486,2218,4704
<class,우이신설선,삼양사거리,1378,1313,2691
<class,우이신설선,삼양,1070,1091,2161
<class,우이신설선,화계,1855,1611,3466
<class,우이신설선,가오리,2075,1930,4005
<class,우이신설선,4.19민주묘지,1712,1419,3131
<class,우이신설선,솔밭공원,1286,1245,2531
<class,우이신설선,북한산우이,2800,2861,5661
<class,안산선,수리산,1901,1770,3671
<class,안산선,오이도,5738,5856,11594
<class,안산선,정왕,5007,4830,9837
<class,안산선,신길온천,1094,1016,2110
<class,안산선,안산,9978,10726,20704
<class,안산선,초지,1962,1991,3953
<class,안산선,고잔,3386,3401,6787
<class,안산선,중앙,9329,9587,18916
<class,안산선,한대앞,4695,4799,9494
<class,안산선,상록수,7990,7942,15932
<class,안산선,반월,2379,2229,4608
<class,안산선,대야미,2671,2320,4991
<class,안산선,산본,7586,8035,15621
<class,수인선,인천,1264,1905,3169
<class,수인선,신포,1048,1072,2120
<class,수인선,숭의,1783,1679,3462
<class,수인선,인하대,2758,2572,5330
<class,수인선,송도,1379,1309,2688
<class,수인선,연수,2569,2530,5099
<class,수인선,원인재,2434,2700,5134
<class,수인선,남동인더스파크,560,510,1070
<class,수인선,호구포,1820,1667,3487
<class,수인선,인천논현,2660,2655,5315
<class,수인선,소래포구,5394,5724,11118
<class,수인선,월곶,1498,1509,3007
<class,수인선,달월,60,62,122
<class,수인선,사리,2145,1938,4083
<class,수인선,야목,143,145,288
<class,수인선,어천,539,440,979
<class,수인선,오목천,1299,1086,2385
<class,수인선,고색,1474,1488,2962
<class,분당선,매교,1203,1269,2472
<class,분당선,수원시청,5345,5480,10825
<class,분당선,매탄권선,2061,2000,4061
<class,분당선,망포,5136,4568,9704
<class,분당선,영통,4008,3725,7733
<class,분당선,청명,1644,1558,3202
<class,분당선,상갈,2623,2675,5298
<class,분당선,기흥,4208,4072,8280
<class,분당선,신갈,1685,1763,3448
<class,분당선,구성,2085,2255,4340
<class,분당선,죽전,7031,7846,14877
<class,분당선,보정,973,886,1859
<class,분당선,이매,2699,2696,5395
<class,분당선,오리,5147,4256,9403
<class,분당선,미금,6340,6412,12752
<class,분당선,정자,6192,6006,12198
<class,분당선,수내,5220,4891,10111
<class,분당선,서현,11425,11535,22960
<class,분당선,야탑,10564,11959,22523
<class,분당선,모란,15322,15717,31039
<class,분당선,태평,7640,7166,14806
<class,분당선,가천대,2956,3011,5967
<class,분당선,선정릉,1569,1484,3053
<class,분당선,강남구청,2136,2465,4601
<class,분당선,압구정로데오,7728,8850,16578
<class,분당선,서울숲,5376,5421,10797
<class,분당선,수원,5143,4515,9658
<class,분당선,수서,5027,6262,11289
<class,분당선,대모산입구,1714,1641,3355
<class,분당선,개포동,1521,1471,2992
<class,분당선,구룡,565,524,1089
<class,분당선,도곡,2049,1886,3935
<class,분당선,한티,7638,7049,14687
<class,분당선,선릉,1973,2729,4702
<class,과천선,범계,11654,11413,23067
<class,과천선,평촌,4920,4744,9664
<class,과천선,인덕원,9048,9020,18068
<class,과천선,정부과천청사,3412,3551,6963
<class,과천선,과천,2819,2492,5311
<class,과천선,대공원,5438,5558,10996
<class,과천선,경마공원,797,760,1557
<class,과천선,선바위,2939,2821,5760
<class,공항철도 1호선,영종,2017,2146,4163
<class,공항철도 1호선,인천공항2터미널,1698,1588,3286
<class,2호선,잠실나루,4145,4063,8208
<class,공항철도 1호선,인천공항1터미널,3107,3186,6293
<class,공항철도 1호선,공항화물청사,946,947,1893
<class,공항철도 1호선,운서,4216,4286,8502
<class,공항철도 1호선,청라국제도시,2538,2531,5069
<class,공항철도 1호선,검암,2958,3034,5992
<class,공항철도 1호선,계양,4161,3922,8083
<class,공항철도 1호선,김포공항,8929,5573,14502
<class,공항철도 1호선,마곡나루,1703,1726,3429
<class,공항철도 1호선,디지털미디어시티,2983,2677,5660
<class,공항철도 1호선,홍대입구,7537,6568,14105
<class,공항철도 1호선,공덕,990,1109,2099
<class,공항철도 1호선,서울역,4045,5157,9202
<class,경춘선,춘천,1684,1730,3414
<class,경춘선,남춘천,2067,2458,4525
<class,경춘선,김유정,455,576,1031
<class,경춘선,강촌,762,696,1458
<class,경춘선,백양리,116,130,246
<class,경춘선,굴봉산,234,223,457
<class,경춘선,가평,1974,2188,4162
<class,경춘선,상천,403,373,776
<class,경춘선,청평,1467,1661,3128
<class,경춘선,대성리,605,583,1188
<class,경춘선,마석,2334,2431,4765
<class,경춘선,천마산,1077,1079,2156
<class,경춘선,평내호평,3224,3269,6493
<class,경춘선,금곡,894,827,1721
<class,경춘선,사릉,1676,1644,3320
<class,경춘선,퇴계원,1961,1827,3788
<class,경춘선,별내,1591,1544,3135
<class,경춘선,갈매,1251,1098,2349
<class,경춘선,신내,786,718,1504
<class,경인선,도화,2117,1990,4107
<class,경인선,중동,4509,4336,8845
<class,경인선,온수,3298,2984,6282
<class,경인선,도원,1428,1464,2892
<class,경인선,간석,2874,2706,5580
<class,경인선,부개,4309,3964,8273
<class,경인선,소사,4536,4380,8916
<class,경인선,구일,2702,2430,5132
<class,경인선,인천,3796,3179,6975
<class,경인선,동인천,8017,8228,16245
<class,경인선,제물포,4711,4638,9349
<class,경인선,주안,9788,8692,18480
<class,경인선,동암,8326,8635,16961
<class,경인선,백운,3460,3390,6850
<class,경인선,부평,20149,22055,42204
<class,경인선,송내,10620,10676,21296
<class,경인선,부천,20059,20298,40357
<class,경인선,역곡,12650,12368,25018
<class,경인선,오류동,5809,5162,10971
<class,경인선,개봉,10292,9925,20217
<class,경의선,임진강,107,80,187
<class,경의선,문산,3599,3746,7345
<class,경의선,파주,670,579,1249
<class,경의선,월롱,850,860,1710
<class,경의선,금촌,4468,4452,8920
<class,경의선,금릉,2508,2574,5082
<class,경의선,운정,3115,2898,6013
<class,경의선,야당,3858,3767,7625
<class,경의선,탄현,3488,3425,6913
<class,경의선,일산,4021,4002,8023
<class,경의선,풍산,3070,3000,6070
<class,경의선,백마,2816,2707,5523
<class,경의선,곡산,296,298,594
<class,경의선,능곡,1904,1841,3745
<class,경의선,행신,3359,3364,6723
<class,경의선,강매,1277,1145,2422
<class,경의선,화전,631,576,1207
<class,경의선,수색,798,760,1558
<class,경의선,디지털미디어시티,1146,1112,2258
<class,경의선,가좌,2616,2243,4859
<class,경의선,홍대입구,1279,1379,2658
<class,경의선,서강대,1076,946,2022
<class,경의선,공덕,1275,1079,2354
<class,경의선,효창공원앞,1067,1181,2248
<class,경의선,신촌,220,220,440
<class,경의선,서울역,771,891,1662
<class,경원선,소요산,3306,3077,6383
<class,경원선,동두천,1306,1728,3034
<class,경원선,보산,1606,1622,3228
<class,경원선,동두천중앙,2023,2081,4104
<class,경원선,지행,3757,4004,7761
<class,경원선,덕정,3216,2962,6178
<class,경원선,덕계,1506,1449,2955
<class,경원선,양주,4789,4758,9547
<class,경원선,녹양,2351,2329,4680
<class,2호선,강변,16619,23365,39984
<class,경원선,가능,3688,3509,7197
<class,경원선,의정부,13240,13744,26984
<class,경원선,회룡,6289,6492,12781
<class,경원선,망월사,3846,3993,7839
<class,경원선,도봉산,7301,5113,12414
<class,경원선,도봉,3317,3131,6448
<class,경원선,방학,5416,5175,10591
<class,경원선,녹천,2406,1856,4262
<class,경원선,월계,3521,3127,6648
<class,경원선,광운대,3967,3621,7588
<class,경원선,석계,4566,4739,9305
<class,경원선,신이문,4531,4066,8597
<class,경원선,외대앞,4095,3660,7755
<class,경원선,청량리,10736,11642,22378
<class,경원선,왕십리,7303,8011,15314
<class,경원선,응봉,965,816,1781
<class,경원선,옥수,36,21,57
<class,경원선,한남,1764,1678,3442
<class,경원선,서빙고,995,874,1869
<class,경원선,이촌,2022,1524,3546
<class,경부선,광명,1383,1530,2913
<class,경부선,서동탄,644,706,1350
<class,경부선,당정,2397,2333,4730
<class,경부선,천안,5369,6579,11948
<class,경부선,두정,4390,4266,8656
<class,경부선,직산,497,539,1036
<class,경부선,성환,2399,2451,4850
<class,경부선,평택,10525,11054,21579
<class,경부선,평택지제,1652,1713,3365
<class,경부선,서정리,3869,3682,7551
<class,경부선,송탄,3278,3094,6372
<class,경부선,진위,660,652,1312
<class,경부선,오산,7042,6793,13835
<class,경부선,오산대,1819,1694,3513
<class,경부선,세마,1421,1334,2755
<class,경부선,병점,7721,7768,15489
<class,경부선,세류,1816,2017,3833
<class,경부선,독산,5683,5184,10867
<class,경부선,수원,28115,30313,58428
<class,경부선,화서,3232,3263,6495
<class,2호선,구의,9334,8435,17769
<class,경부선,성균관대,6411,6141,12552
<class,경부선,의왕,3553,3503,7056
<class,경부선,군포,2792,2496,5288
<class,경부선,금정,12019,12072,24091
<class,경부선,명학,2817,2625,5442
<class,경부선,안양,11227,11339,22566
<class,경부선,관악,3666,3473,7139
<class,경부선,석수,4321,4228,8549
<class,경부선,금천구청,5308,5182,10490
<class,경부선,가산디지털단지,3972,5262,9234
<class,경부선,구로,7963,8011,15974
<class,경부선,신길,4058,3260,7318
<class,경부선,신도림,1753,1677,3430
<class,경부선,영등포,23324,23986,47310
<class,경부선,대방,4545,4274,8819
<class,경부선,노량진,5739,5308,11047
<class,경부선,용산,20724,23998,44722
<class,경부선,남영,3320,3289,6609
<class,경부선,서울역,2686,1151,3837
<class,경강선,여주,1735,2191,3926
<class,경강선,세종대왕릉,308,371,679
<class,경강선,부발,1021,1103,2124
<class,경강선,이천,1832,2177,4009
<class,경강선,신둔도예촌,736,820,1556
<class,경강선,곤지암,1581,1619,3200
<class,경강선,초월,1502,1458,2960
<class,경강선,경기광주,3517,3544,7061
<class,경강선,삼동,1047,961,2008
<class,경강선,이매,672,428,1100
<class,경강선,판교,2067,1867,3934
<class,9호선2~3단계,중앙보훈병원,2657,2467,5124
<class,9호선2~3단계,둔촌오륜,339,335,674
<class,9호선2~3단계,올림픽공원,3281,3226,6507
<class,9호선2~3단계,한성백제,1055,902,1957
<class,9호선2~3단계,송파나루,2270,2476,4746
<class,9호선2~3단계,석촌,3709,2928,6637
<class,9호선2~3단계,석촌고분,2503,2108,4611
<class,9호선2~3단계,삼전,2838,2355,5193
<class,9호선2~3단계,종합운동장,1550,1286,2836
<class,9호선2~3단계,봉은사,5222,5180,10402
<class,9호선2~3단계,삼성중앙,1458,1401,2859
<class,9호선2~3단계,선정릉,2268,2326,4594
<class,9호선2~3단계,언주,2188,2028,4216
<class,9호선,신논현,12166,11349,23515
<class,9호선,사평,1200,1144,2344
<class,9호선,고속터미널,7338,15878,23216
<class,9호선,신반포,1188,1246,2434
<class,9호선,구반포,749,793,1542
<class,9호선,동작,828,638,1466
<class,9호선,흑석,3128,3090,6218
<class,9호선,노들,2277,1837,4114
<class,9호선,노량진,12792,11607,24399
<class,9호선,샛강,1321,1343,2664
<class,9호선,여의도,6320,5889,12209
<class,9호선,국회의사당,2352,2177,4529
<class,9호선,당산,6574,5870,12444
<class,9호선,선유도,2296,2106,4402
<class,9호선,신목동,1397,1278,2675
<class,9호선,염창,7096,6167,13263
<class,9호선,등촌,4825,4443,9268
<class,9호선,증미,2835,2532,5367
<class,9호선,가양,8496,7663,16159
<class,9호선,양천향교,3434,3024,6458
<class,9호선,마곡나루,4014,3676,7690
<class,9호선,신방화,2915,2668,5583
<class,9호선,공항시장,1503,1518,3021
<class,9호선,김포공항,5293,11406,16699
<class,9호선,개화,1051,898,1949
<class,8호선,모란,3865,3201,7066
<class,8호선,수진,2689,2324,5013
<class,8호선,신흥,2419,2471,4890
<class,8호선,단대오거리,4948,4484,9432
<class,8호선,남한산성입구,5998,5147,11145
<class,8호선,산성,2958,2971,5929
<class,8호선,복정,3907,3533,7440
<class,8호선,장지,7119,6974,14093
<class,8호선,문정,3639,3429,7068
<class,8호선,가락시장,2859,3120,5979
<class,8호선,송파,2731,2740,5471
<class,8호선,석촌,3302,3715,7017
<class,8호선,잠실,7383,8502,15885
<class,8호선,몽촌토성,2443,2317,4760
<class,8호선,강동구청,3533,3469,7002
<class,8호선,천호,7154,8146,15300
<class,8호선,암사,7831,7156,14987
<class,7호선,부평구청,3051,2789,5840
<class,7호선,굴포천,3998,4280,8278
<class,7호선,삼산체육관,2133,2076,4209
<class,7호선,상동,5780,5789,11569
<class,7호선,부천시청,5866,5715,11581
<class,7호선,신중동,5608,5674,11282
<class,7호선,춘의,3081,2886,5967
<class,7호선,부천종합운동장,1995,1835,3830
<class,7호선,까치울,3343,3396,6739
<class,7호선,온수,3608,3501,7109
<class,7호선,천왕,4449,4113,8562
<class,7호선,가산디지털단지,9521,8011,17532
<class,7호선,남구로,6070,5931,12001
<class,7호선,대림,7130,6942,14072
<class,7호선,신풍,5062,4742,9804
<class,7호선,보라매,3343,3021,6364
<class,7호선,신대방삼거리,6664,5850,12514
<class,7호선,장승배기,4148,3854,8002
<class,7호선,상도,4440,3788,8228
<class,7호선,숭실대입구,4786,4406,9192
<class,7호선,남성,4448,3886,8334
<class,7호선,이수,6596,6007,12603
<class,7호선,내방,4259,4035,8294
<class,7호선,고속터미널,7106,8420,15526
<class,7호선,반포,2385,2376,4761
<class,7호선,논현,5154,5388,10542
<class,7호선,학동,3442,3353,6795
<class,7호선,강남구청,3768,3879,7647
<class,7호선,청담,4468,4699,9167
<class,7호선,뚝섬유원지,7755,6818,14573
<class,7호선,건대입구,6126,5906,12032
<class,7호선,어린이대공원,5925,5063,10988
<class,7호선,군자,6331,4400,10731
<class,7호선,중곡,4350,4026,8376
<class,7호선,용마산,2830,3033,5863
<class,7호선,사가정,8129,7624,15753
<class,7호선,면목,7358,7103,14461
<class,7호선,상봉,8013,7356,15369
<class,7호선,중화,4890,4585,9475
<class,7호선,먹골,4700,4357,9057
<class,7호선,태릉입구,4012,3542,7554
<class,7호선,공릉,5465,5085,10550
<class,7호선,하계,7743,7080,14823
<class,7호선,중계,5853,5228,11081
<class,7호선,노원,9220,9650,18870
<class,7호선,마들,5229,4711,9940
<class,7호선,수락산,7034,6927,13961
<class,7호선,도봉산,4499,6646,11145
<class,7호선,장암,1153,882,2035
<class,6호선,신내,20,0,20
<class,6호선,봉화산,3289,3324,6613
<class,6호선,화랑대,4066,3353,7419
<class,6호선,태릉입구,2440,2568,5008
<class,6호선,석계,5621,5590,11211
<class,6호선,돌곶이,3779,3341,7120
<class,6호선,상월곡,2717,2321,5038
<class,6호선,월곡,4748,4314,9062
<class,6호선,고려대,3311,2902,6213
<class,6호선,안암,3597,3096,6693
<class,6호선,보문,3177,2530,5707
<class,6호선,창신,1424,1201,2625
<class,6호선,동묘앞,5301,4909,10210
<class,6호선,신당,3558,3207,6765
<class,6호선,청구,1371,1351,2722
<class,6호선,약수,1427,1296,2723
<class,6호선,버티고개,775,800,1575
<class,6호선,한강진,4176,5164,9340
<class,6호선,이태원,7734,8287,16021
<class,6호선,녹사평,3355,3316,6671
<class,6호선,삼각지,2724,1980,4704
<class,6호선,효창공원앞,2664,2256,4920
<class,6호선,공덕,5485,5080,10565
<class,6호선,대흥,3206,2942,6148
<class,6호선,광흥창,3395,2911,6306
<class,6호선,상수,4365,4977,9342
<class,6호선,합정,7221,6329,13550
<class,6호선,망원,9062,9841,18903
<class,6호선,마포구청,5910,4761,10671
<class,6호선,월드컵경기장,3819,3842,7661
<class,6호선,디지털미디어시티,4303,4375,8678
<class,6호선,증산,4832,4704,9536
<class,6호선,새절,5537,5146,10683
<class,6호선,구산,3363,2435,5798
<class,6호선,연신내,2,0,2
<class,6호선,독바위,1416,1653,3069
<class,6호선,불광,2386,2355,4741
<class,6호선,역촌,1762,1953,3715
<class,6호선,응암,8273,7766,16039
<class,5호선,하남검단산,3815,3903,7718
<class,5호선,하남시청,3484,3482,6966
<class,5호선,하남풍산,1818,1895,3713
<class,5호선,미사,6920,6813,13733
<class,5호선,강일,1637,1508,3145
<class,5호선,마천,2993,3156,6149
<class,5호선,거여,3305,3108,6413
<class,5호선,개롱,2561,2710,5271
<class,5호선,오금,1193,1083,2276
<class,5호선,방이,3073,2826,5899
<class,5호선,올림픽공원,1900,1789,3689
<class,5호선,둔촌동,3719,3725,7444
<class,5호선,상일동,5790,5259,11049
<class,5호선,고덕,3629,3525,7154
<class,5호선,명일,3799,3703,7502
<class,5호선,굽은다리,4360,3850,8210
<class,5호선,길동,3810,3840,7650
<class,5호선,강동,6492,6063,12555
<class,5호선,천호,9824,9435,19259
<class,5호선,광나루,5994,5862,11856
<class,5호선,아차산,8401,7969,16370
<class,5호선,군자,4627,4706,9333
<class,5호선,장한평,5867,5572,11439
<class,5호선,답십리,6034,5193,11227
<class,5호선,마장,2945,2930,5875
<class,5호선,왕십리,1966,2269,4235
<class,5호선,행당,3389,2894,6283
<class,5호선,신금호,2560,2579,5139
<class,5호선,청구,1498,1269,2767
<class,5호선,동대문역사문화공원,512,654,1166
<class,5호선,을지로4가,1312,1336,2648
<class,5호선,종로3가,6868,6846,13714
<class,5호선,광화문,8768,8628,17396
<class,5호선,서대문,3694,3554,7248
<class,5호선,충정로,1140,1011,2151
<class,5호선,애오개,2088,1961,4049
<class,5호선,공덕,3528,3435,6963
<class,5호선,마포,3724,3701,7425
<class,5호선,여의나루,10187,10618,20805
<class,5호선,여의도,5479,6190,11669
<class,5호선,신길,1306,1217,2523
<class,5호선,영등포시장,3509,3349,6858
<class,5호선,영등포구청,1176,983,2159
<class,5호선,양평,2176,1876,4052
<class,5호선,오목교,9236,9466,18702
<class,5호선,목동,6254,6213,12467
<class,5호선,신정,5476,4606,10082
<class,5호선,까치산,13560,12245,25805
<class,5호선,화곡,12073,10582,22655
<class,5호선,우장산,5953,6102,12055
<class,5호선,발산,6567,6870,13437
<class,5호선,마곡,2924,2877,5801
<class,5호선,송정,3385,3208,6593
<class,5호선,김포공항,5481,6247,11728
<class,5호선,개화산,2388,2329,4717
<class,5호선,방화,3104,2994,6098
<class,4호선,쌍문,13491,11899,25390
<class,4호선,창동,13307,14071,27378
<class,4호선,노원,9915,10736,20651
<class,4호선,상계,9207,8503,17710
<class,4호선,당고개,6676,6550,13226
<class,4호선,남태령,541,441,982
<class,4호선,사당,11517,9748,21265
<class,4호선,총신대입구,9382,10049,19431
<class,4호선,동작,1235,1226,2461
<class,4호선,이촌,3920,4325,8245
<class,4호선,신용산,5400,6355,11755
<class,4호선,삼각지,1756,2143,3899
<class,4호선,숙대입구,4721,4413,9134
<class,4호선,서울역,3255,7553,10808
<class,4호선,회현,7139,7613,14752
<class,4호선,명동,9084,9989,19073
<class,4호선,충무로,6214,5905,12119
<class,4호선,동대문역사문화공원,7028,6467,13495
<class,4호선,동대문,5637,5650,11287
<class,4호선,혜화,15926,16099,32025
<class,4호선,한성대입구,6605,6171,12776
<class,4호선,성신여대입구,10200,9011,19211
<class,4호선,길음,8824,8245,17069
<class,4호선,미아사거리,13922,12994,26916
<class,4호선,미아,7072,6606,13678
<class,4호선,수유,17151,15821,32972
<class,3호선,오금,2175,1924,4099
<class,3호선,경찰병원,2232,2154,4386
<class,3호선,가락시장,3399,3214,6613
<class,3호선,수서,6444,7268,13712
<class,3호선,일원,2593,2529,5122
<class,3호선,대청,3426,3128,6554
<class,3호선,학여울,587,572,1159
<class,3호선,대치,5800,4894,10694
<class,3호선,도곡,1518,1472,2990
<class,3호선,매봉,3295,3260,6555
<class,3호선,양재,9418,9816,19234
<class,3호선,남부터미널,9449,13139,22588
<class,3호선,교대,3126,1730,4856
<class,3호선,고속터미널,28281,43841,72122
<class,3호선,잠원,1883,1808,3691
<class,3호선,신사,10156,10629,20785
<class,3호선,압구정,11783,12071,23854
<class,3호선,옥수,4480,4374,8854
<class,3호선,금호,3784,3403,7187
<class,3호선,약수,5471,4977,10448
<class,3호선,동대입구,3949,4406,8355
<class,3호선,충무로,2,0,2
<class,3호선,을지로3가,2216,2184,4400
<class,3호선,종로3가,2739,4056,6795
<class,3호선,안국,8018,9150,17168
<class,3호선,경복궁,10132,11228,21360
<class,3호선,독립문,3649,3828,7477
<class,3호선,무악재,1736,1819,3555
<class,3호선,홍제,7979,7093,15072
<class,3호선,녹번,6361,5407,11768
<class,3호선,불광,8751,9647,18398
<class,3호선,연신내,19792,17905,37697
<class,3호선,구파발,9636,9851,19487
<class,3호선,지축,1771,1692,3463
<class,2호선,용두,1275,1265,2540
<class,2호선,신정네거리,4519,4431,8950
<class,2호선,양천구청,2689,2728,5417
<class,2호선,도림천,342,363,705
<class,2호선,신설동,2272,2033,4305
<class,2호선,신답,613,558,1171
<class,2호선,용답,1529,1394,2923
<class,2호선,충정로,2770,2686,5456
<class,2호선,아현,4246,4011,8257
<class,2호선,이대,5354,5002,10356
<class,2호선,신촌,16030,14981,31011
<class,2호선,홍대입구,35828,36299,72127
<class,2호선,합정,14692,15332,30024
<class,경부선,용산,26593,27320,53913
<class,경부선,남영,4636,4848,9484
<class,경부선,서울역,4882,1267,6149
<class,경강선,여주,2183,2440,4623
<class,경강선,세종대왕릉,329,382,711
<class,경강선,부발,1567,1455,3022
<class,경강선,이천,2245,2326,4571
<class,경강선,신둔도예촌,979,990,1969
<class,경강선,곤지암,1694,1840,3534
<class,경강선,초월,1972,1861,3833
<class,경강선,경기광주,4624,4352,8976
<class,경강선,삼동,1300,1166,2466
<class,경강선,이매,753,675,1428
<class,경강선,판교,2668,2421,5089
<class,9호선2~3단계,중앙보훈병원,4086,3913,7999
<class,9호선2~3단계,둔촌오륜,568,593,1161
<class,9호선2~3단계,올림픽공원,4219,4642,8861
<class,9호선2~3단계,한성백제,1759,1538,3297
<class,9호선2~3단계,송파나루,3331,3877,7208
<class,9호선2~3단계,석촌,5837,5084,10921
<class,9호선2~3단계,석촌고분,3654,3604,7258
<class,9호선2~3단계,삼전,4311,4110,8421
<class,9호선2~3단계,종합운동장,2490,2346,4836
<class,9호선2~3단계,봉은사,8065,8352,16417
<class,9호선2~3단계,삼성중앙,2577,2570,5147
<class,9호선2~3단계,선정릉,4372,4720,9092
<class,9호선2~3단계,언주,4991,5042,10033
<class,9호선,신논현,21900,21875,43775
<class,9호선,사평,1877,1769,3646
<class,9호선,고속터미널,10937,14640,25577
<class,9호선,신반포,2302,2228,4530
<class,9호선,구반포,1454,1562,3016
<class,9호선,동작,1335,1171,2506
<class,9호선,흑석,5009,4978,9987
<class,9호선,노들,3097,2737,5834
<class,9호선,노량진,18561,18425,36986
<class,9호선,샛강,2210,2296,4506
<class,9호선,여의도,9528,9231,18759
<class,9호선,국회의사당,3454,3647,7101
<class,9호선,당산,10846,10368,21214
<class,9호선,선유도,3478,3610,7088
<class,9호선,신목동,2082,1801,3883
<class,9호선,염창,10111,9732,19843
<class,9호선,등촌,6599,6388,12987
<class,9호선,증미,3615,3558,7173
<class,9호선,가양,12136,11578,23714
<class,9호선,양천향교,5135,5063,10198
<class,9호선,마곡나루,7001,7139,14140
<class,9호선,신방화,4190,3945,8135
<class,9호선,공항시장,2051,2160,4211
<class,9호선,김포공항,6971,10390,17361
<class,9호선,개화,1372,1192,2564
<class,8호선,모란,3142,2702,5844
<class,8호선,수진,3632,3201,6833
<class,8호선,신흥,3125,3390,6515
<class,8호선,단대오거리,6819,6366,13185
<class,8호선,남한산성입구,8079,7302,15381
<class,8호선,산성,4217,4293,8510
<class,8호선,복정,6314,5449,11763
<class,8호선,장지,10522,9667,20189
<class,8호선,문정,7145,7249,14394
<class,8호선,가락시장,4008,3965,7973
<class,8호선,송파,4466,4465,8931
<class,8호선,석촌,5076,6326,11402
<class,8호선,잠실,9708,11486,21194
<class,경원선,창동,1,0,1
<class,중앙선,지평,43,63,106
<class,중앙선,용문,3911,4102,8013
<class,중앙선,원덕,474,508,982
<class,중앙선,양평,2649,2703,5352
<class,중앙선,오빈,320,303,623
<class,중앙선,아신,635,652,1287
<class,중앙선,국수,689,723,1412
<class,중앙선,신원,427,364,791
<class,중앙선,양수,2369,2418,4787
<class,중앙선,운길산,1773,1667,3440
<class,8호선,몽촌토성,4056,4050,8106
<class,중앙선,팔당,1681,1899,3580
<class,중앙선,도심,1537,1365,2902
<class,중앙선,덕소,4255,4373,8628
<class,중앙선,양정,618,565,1183
<class,중앙선,도농,6101,5933,12034
<class,중앙선,구리,9368,9616,18984
<class,중앙선,양원,1264,1294,2558
<class,중앙선,망우,5793,5567,11360
<class,중앙선,상봉,4941,4593,9534
<class,중앙선,중랑,4166,4013,8179
<class,중앙선,회기,16872,16121,32993
<class,장항선,신창,1164,1114,2278
<class,장항선,온양온천,3129,3304,6433
<class,장항선,배방,935,875,1810
<class,장항선,아산,2496,2263,4759
<class,장항선,쌍용,1404,1283,2687
<class,장항선,봉명,658,588,1246
<class,일산선,대화,7629,6763,14392
<class,일산선,주엽,6033,5893,11926
<class,일산선,정발산,5781,5887,11668
<class,일산선,마두,4725,4724,9449
<class,일산선,백석,6566,6613,13179
<class,일산선,대곡,1313,1114,2427
<class,일산선,화정,11724,12063,23787
<class,일산선,원당,7754,7315,15069
<class,일산선,삼송,12761,12374,25135
<class,일산선,원흥,6604,6381,12985
<class,우이신설선,신설동,1392,1275,2667
<class,우이신설선,보문,1006,973,1979
<class,우이신설선,성신여대입구,2570,3000,5570
<class,우이신설선,정릉,3133,2655,5788
<class,우이신설선,북한산보국문,4219,3906,8125
<class,우이신설선,솔샘,3449,3079,6528
<class,우이신설선,삼양사거리,1827,1760,3587
<class,우이신설선,삼양,1359,1532,2891
<class,우이신설선,화계,2382,2164,4546
<class,우이신설선,가오리,2669,2517,5186
<class,우이신설선,4.19민주묘지,2319,2063,4382
<class,우이신설선,솔밭공원,1651,1571,3222
<class,우이신설선,북한산우이,3272,3367,6639
<class,안산선,수리산,2698,2604,5302
<class,안산선,오이도,7077,7152,14229
<class,안산선,정왕,5414,5576,10990
<class,안산선,신길온천,1308,1274,2582
<class,안산선,안산,7913,8056,15969
<class,안산선,초지,2992,2954,5946
<class,안산선,고잔,5503,5514,11017
<class,안산선,중앙,13598,14002,27600
<class,안산선,한대앞,6398,6310,12708
<class,안산선,상록수,10859,11048,21907
<class,안산선,반월,3179,2987,6166
<class,안산선,대야미,3839,3320,7159
<class,안산선,산본,11249,10509,21758
<class,수인선,인천,1104,1843,2947
<class,수인선,신포,1273,1338,2611
<class,수인선,숭의,2565,2335,4900
<class,수인선,인하대,3891,3783,7674
<class,수인선,송도,1837,1803,3640
<class,수인선,연수,3368,3294,6662
<class,수인선,원인재,3310,3480,6790
<class,수인선,남동인더스파크,933,869,1802
<class,수인선,호구포,2410,2327,4737
<class,수인선,인천논현,3963,4101,8064
<class,수인선,소래포구,6520,6915,13435
<class,수인선,월곶,1916,1897,3813
<class,수인선,달월,70,77,147
<class,수인선,사리,3126,2631,5757
<class,수인선,야목,195,194,389
<class,수인선,어천,597,589,1186
<class,수인선,오목천,1857,1545,3402
<class,수인선,고색,2157,2178,4335
<class,분당선,매교,1883,1937,3820
<class,분당선,수원시청,9020,9717,18737
<class,분당선,매탄권선,3094,2927,6021
<class,분당선,망포,7902,7340,15242
<class,분당선,영통,5696,5500,11196
<class,분당선,청명,2361,2313,4674
<class,분당선,상갈,3558,3522,7080
<class,분당선,기흥,5983,5666,11649
<class,분당선,신갈,2487,2494,4981
<class,분당선,구성,2903,3117,6020
<class,분당선,죽전,9023,10244,19267
<class,분당선,보정,1401,1293,2694
<class,분당선,이매,3637,3574,7211
<class,분당선,오리,6730,5565,12295
<class,분당선,미금,9528,10081,19609
<class,분당선,정자,9178,9602,18780
<class,분당선,수내,7811,7413,15224
<class,분당선,서현,16157,16260,32417
<class,분당선,야탑,14995,15497,30492
<class,분당선,모란,14084,13961,28045
<class,분당선,태평,9467,9113,18580
<class,분당선,가천대,4503,4960,9463
<class,분당선,선정릉,3145,3190,6335
<class,분당선,강남구청,4837,5663,10500
<class,분당선,압구정로데오,16062,18152,34214
<class,분당선,서울숲,7840,8249,16089
<class,분당선,수원,6200,5442,11642
<class,분당선,수서,8982,8788,17770
<class,분당선,대모산입구,2526,2263,4789
<class,분당선,개포동,2430,2434,4864
<class,분당선,구룡,1137,1066,2203
<class,분당선,도곡,3895,3452,7347
<class,분당선,한티,11468,10941,22409
<class,분당선,선릉,4518,6852,11370
<class,과천선,범계,17226,16336,33562
<class,과천선,평촌,8001,7758,15759
<class,과천선,인덕원,13444,13395,26839
<class,과천선,정부과천청사,5267,5500,10767
<class,과천선,과천,4085,3757,7842
<class,과천선,대공원,6138,6411,12549
<class,과천선,경마공원,738,673,1411
<class,과천선,선바위,4444,4140,8584
<class,공항철도 1호선,영종,2562,2690,5252
<class,공항철도 1호선,인천공항2터미널,1832,1683,3515
<class,공항철도 1호선,인천공항1터미널,3057,3125,6182
<class,공항철도 1호선,공항화물청사,1372,1431,2803
<class,공항철도 1호선,운서,5305,5681,10986
<class,공항철도 1호선,청라국제도시,3836,3728,7564
<class,공항철도 1호선,검암,4270,4347,8617
<class,공항철도 1호선,계양,6160,5842,12002
<class,공항철도 1호선,김포공항,10903,5062,15965
<class,공항철도 1호선,마곡나루,2929,3060,5989
<class,공항철도 1호선,디지털미디어시티,4167,4128,8295
<class,공항철도 1호선,홍대입구,9651,9717,19368
<class,공항철도 1호선,공덕,1262,1744,3006
<class,공항철도 1호선,서울역,6030,5543,11573
<class,경춘선,춘천,1913,1718,3631
<class,경춘선,남춘천,2317,2504,4821
<class,경춘선,김유정,676,862,1538
<class,경춘선,강촌,804,782,1586
<class,경춘선,백양리,141,133,274
<class,경춘선,굴봉산,207,243,450
<class,경춘선,가평,2107,2247,4354
<class,경춘선,상천,580,518,1098
<class,경춘선,청평,1701,1783,3484
<class,경춘선,대성리,647,707,1354
<class,경춘선,마석,3042,3119,6161
<class,경춘선,천마산,1364,1346,2710
<class,경춘선,평내호평,4279,4142,8421
<class,경춘선,금곡,1170,1107,2277
<class,경춘선,사릉,2127,2214,4341
<class,경춘선,퇴계원,2523,2319,4842
<class,경춘선,별내,2278,2190,4468
<class,경춘선,갈매,1805,1673,3478
<class,경춘선,신내,1166,1098,2264
<class,경인선,도화,2949,2731,5680
<class,경인선,중동,6083,5667,11750
<class,경인선,온수,4434,4119,8553
<class,경인선,도원,1722,1876,3598
<class,경인선,간석,3913,3781,7694
<class,경인선,부개,5784,5406,11190
<class,경인선,소사,6422,6238,12660
<class,경인선,구일,3859,3759,7618
<class,경인선,인천,4395,3929,8324
<class,경인선,동인천,10601,10505,21106
<class,경인선,제물포,6597,6338,12935
<class,경인선,주안,13557,12321,25878
<class,경인선,동암,11208,11276,22484
<class,경인선,백운,4943,4730,9673
<class,경인선,부평,25790,28121,53911
<class,경인선,송내,15935,15788,31723
<class,경인선,부천,24955,25753,50708
<class,경인선,역곡,18276,18018,36294
<class,경인선,오류동,8197,7508,15705
<class,경인선,개봉,14721,14569,29290
<class,경의선,임진강,90,79,169
<class,경의선,문산,4428,4292,8720
<class,경의선,파주,815,629,1444
<class,경의선,월롱,1277,1384,2661
<class,경의선,금촌,5112,4978,10090
<class,경의선,금릉,3410,3329,6739
<class,경의선,운정,4441,4218,8659
<class,경의선,야당,5088,5159,10247
<class,경의선,탄현,4883,4589,9472
<class,경의선,일산,5679,5356,11035
<class,경의선,풍산,3877,3679,7556
<class,경의선,백마,4007,3820,7827
<class,경의선,곡산,405,393,798
<class,경의선,능곡,2668,2531,5199
<class,경의선,행신,4602,4521,9123
<class,경의선,강매,1864,1763,3627
<class,경의선,화전,1061,1031,2092
<class,경의선,수색,1330,1237,2567
<class,경의선,디지털미디어시티,1605,1571,3176
<class,경의선,가좌,3509,3407,6916
<class,경의선,홍대입구,1617,1770,3387
<class,경의선,서강대,1591,1398,2989
<class,8호선,강동구청,5331,5388,10719
<class,8호선,천호,10317,12019,22336
<class,8호선,암사,11008,10027,21035
<class,7호선,부평구청,4543,4034,8577
<class,7호선,굴포천,5661,5866,11527
<class,7호선,삼산체육관,3245,2954,6199
<class,7호선,상동,9250,9497,18747
<class,7호선,부천시청,8641,8613,17254
<class,7호선,신중동,8653,8489,17142
<class,7호선,춘의,4658,4450,9108
<class,7호선,부천종합운동장,3189,2886,6075
<class,7호선,까치울,5191,5119,10310
<class,7호선,온수,5151,4984,10135
<class,7호선,천왕,6014,5848,11862
<class,7호선,광명사거리,14738,14649,29387
<class,7호선,철산,13861,14024,27885
<class,7호선,가산디지털단지,12892,11822,24714
<class,7호선,남구로,7380,7635,15015
<class,7호선,대림,5750,5981,11731
<class,7호선,신풍,7201,7008,14209
<class,7호선,보라매,5395,5300,10695
<class,7호선,신대방삼거리,10074,9293,19367
<class,7호선,장승배기,6206,5956,12162
<class,7호선,상도,6494,6113,12607
<class,7호선,숭실대입구,7116,7283,14399
<class,7호선,남성,6962,6545,13507
<class,7호선,이수,10661,9949,20610
<class,7호선,내방,7068,7002,14070
<class,7호선,고속터미널,11313,8614,19927
<class,7호선,반포,3960,3579,7539
<class,7호선,논현,10339,11243,21582
<class,7호선,학동,8578,8967,17545
<class,경의선,공덕,2089,1771,3860
<class,7호선,강남구청,8827,9509,18336
<class,7호선,청담,9685,10244,19929
<class,7호선,뚝섬유원지,10233,9589,19822
<class,7호선,건대입구,8974,9051,18025
<class,7호선,어린이대공원,8099,8167,16266
<class,7호선,군자,9579,7425,17004
<class,7호선,중곡,6381,5970,12351
<class,7호선,용마산,3944,4339,8283
<class,7호선,사가정,11022,10807,21829
<class,7호선,면목,10187,9886,20073
<class,7호선,상봉,11649,11271,22920
<class,7호선,중화,7136,6802,13938
<class,7호선,먹골,6942,6742,13684
<class,7호선,태릉입구,6020,5576,11596
<class,7호선,공릉,7534,7820,15354
<class,7호선,하계,10663,9999,20662
<class,7호선,중계,8355,7381,15736
<class,7호선,노원,14370,14756,29126
<class,7호선,마들,8071,7710,15781
<class,7호선,수락산,9609,9502,19111
<class,7호선,도봉산,6457,8899,15356
<class,7호선,장암,1574,1164,2738
<class,6호선,봉화산,4687,4575,9262
<class,6호선,화랑대,6151,5186,11337
<class,6호선,태릉입구,3668,3985,7653
<class,6호선,석계,7753,7860,15613
<class,6호선,돌곶이,5449,5098,10547
<class,6호선,상월곡,3651,3280,6931
<class,6호선,월곡,6648,6522,13170
<class,6호선,고려대,4636,4502,9138
<class,6호선,안암,5582,5554,11136
<class,6호선,보문,4530,3969,8499
<class,6호선,창신,1980,1655,3635
<class,6호선,동묘앞,7305,6725,14030
<class,6호선,신당,5456,4633,10089
<class,6호선,청구,2174,2259,4433
<class,6호선,약수,2266,2163,4429
<class,6호선,버티고개,1159,1354,2513
<class,6호선,한강진,7488,9046,16534
<class,6호선,이태원,13332,14405,27737
<class,6호선,녹사평,4793,4978,9771
<class,6호선,삼각지,4752,3708,8460
<class,6호선,효창공원앞,3982,3451,7433
<class,6호선,공덕,8809,8314,17123
<class,6호선,대흥,4732,4857,9589
<class,6호선,광흥창,4645,4222,8867
<class,6호선,상수,6348,7600,13948
<class,6호선,합정,10912,9994,20906
<class,6호선,망원,11299,12805,24104
<class,6호선,마포구청,8494,7444,15938
<class,경의선,효창공원앞,1593,1828,3421
<class,경의선,신촌,315,353,668
<class,경의선,서울역,1155,1180,2335
<class,경원선,소요산,4298,3594,7892
<class,경원선,동두천,1615,2183,3798
<class,경원선,보산,1612,1516,3128
<class,경원선,동두천중앙,2487,2533,5020
<class,경원선,지행,4946,4936,9882
<class,경원선,덕정,3902,3691,7593
<class,경원선,덕계,2195,2087,4282
<class,경원선,양주,6430,6111,12541
<class,경원선,녹양,3344,3228,6572
<class,경원선,가능,4815,4668,9483
<class,경원선,의정부,15199,16158,31357
<class,경원선,회룡,9016,9004,18020
<class,경원선,망월사,5023,5194,10217
<class,경원선,도봉산,9356,6745,16101
<class,경원선,도봉,4334,4157,8491
<class,경원선,방학,7005,6720,13725
<class,경원선,녹천,3003,2531,5534
<class,경원선,월계,4285,4075,8360
<class,경원선,광운대,5084,4938,10022
<class,경원선,석계,6157,6497,12654
<class,경원선,신이문,5546,5103,10649
<class,경원선,외대앞,5483,5430,10913
<class,2호선,구로디지털단지,29399,28841,58240
<class,2호선,신대방,18128,17617,35745
<class,2호선,신림,43875,42489,86364
<class,2호선,봉천,15300,14326,29626
<class,2호선,서울대입구,33450,32610,66060
<class,2호선,낙성대,18730,17643,36373
<class,2호선,사당,25306,28028,53334
<class,2호선,방배,8499,8859,17358
<class,2호선,서초,8799,7795,16594
<class,2호선,교대,15293,17060,32353
<class,2호선,강남,52434,51433,103867
<class,2호선,역삼,15879,17546,33425
<class,2호선,선릉,20603,18246,38849
<class,2호선,삼성,22392,22744,45136
<class,2호선,종합운동장,4262,4637,8899
<class,2호선,잠실새내,14054,14492,28546
<class,2호선,잠실,51558,48887,100445
<class,2호선,잠실나루,6557,6444,13001
<class,2호선,강변,21701,21631,43332
<class,2호선,구의,14284,13892,28176
<class,2호선,건대입구,27667,29958,57625
<class,2호선,성수,15471,18118,33589
<class,2호선,뚝섬,12154,12845,24999
<class,2호선,한양대,2916,2962,5878
<class,2호선,왕십리,11015,9144,20159
<class,2호선,상왕십리,8475,8083,16558
<class,2호선,신당,9631,9809,19440
<class,2호선,동대문역사문화공원,8021,8613,16634
<class,2호선,을지로4가,5894,5946,11840
<class,2호선,을지로3가,8509,8748,17257
<class,2호선,을지로입구,16653,16526,33179
<class,2호선,시청,7243,6627,13870
<class,1호선,청량리,15153,15461,30614
<class,1호선,제기동,12789,12898,25687
<class,1호선,신설동,8439,8116,16555
<class,1호선,동대문,9524,8829,18353
<class,1호선,종로5가,15671,16097,31768
<class,1호선,종로3가,19826,18334,38160
<class,1호선,종각,14983,13965,28948
<class,1호선,시청,8987,8773,17760
<class,1호선,동묘앞,10477,11009,21486
<class,1호선,서울역,25011,23912,48923
<class,경원선,청량리,13498,14697,28195
<class,경원선,왕십리,10428,12185,22613
<class,2호선,대림,15532,16374,31906
<class,6호선,월드컵경기장,5303,5531,10834
<class,6호선,디지털미디어시티,6374,6449,12823
<class,6호선,증산,6726,6647,13373
<class,6호선,새절,7956,7521,15477
<class,6호선,구산,4971,3698,8669
<class,6호선,연신내,1,0,1
<class,6호선,독바위,1844,2181,4025
<class,6호선,불광,3326,3159,6485
<class,6호선,역촌,2516,2923,5439
<class,6호선,응암,11477,11258,22735
<class,5호선,하남검단산,4540,4616,9156
<class,5호선,하남시청,4493,4283,8776
<class,5호선,하남풍산,2322,2334,4656
<class,5호선,미사,10369,10448,20817
<class,5호선,강일,2272,2113,4385
<class,5호선,마천,4162,4130,8292
<class,5호선,거여,5102,4903,10005
<class,5호선,개롱,4030,4143,8173
<class,5호선,오금,1948,1878,3826
<class,5호선,방이,4608,4550,9158
<class,5호선,올림픽공원,2977,2620,5597
<class,5호선,둔촌동,5438,5551,10989
<class,5호선,상일동,8406,7873,16279
<class,5호선,고덕,5748,5588,11336
<class,5호선,명일,5215,5424,10639
<class,5호선,굽은다리,6190,5771,11961
<class,5호선,길동,5365,5437,10802
<class,5호선,강동,10944,10399,21343
<class,5호선,천호,14141,13749,27890
<class,5호선,광나루,8653,8407,17060
<class,5호선,아차산,11706,11439,23145
<class,5호선,군자,7417,7963,15380
<class,5호선,장한평,10090,9897,19987
<class,5호선,답십리,9200,8458,17658
<class,5호선,마장,3313,3169,6482
<class,5호선,왕십리,3127,3605,6732
<class,5호선,행당,5076,4295,9371
<class,5호선,신금호,3684,3919,7603
<class,5호선,청구,2329,2138,4467
<class,5호선,동대문역사문화공원,856,1098,1954
<class,5호선,을지로4가,2838,3165,6003
<class,5호선,종로3가,9955,10366,20321
<class,5호선,광화문,12141,12266,24407
<class,5호선,서대문,5926,5973,11899
<class,5호선,충정로,1714,1580,3294
<class,5호선,애오개,3374,3188,6562
<class,5호선,공덕,6199,6233,12432
<class,5호선,마포,6334,6365,12699
<class,5호선,여의나루,11979,12679,24658
<class,5호선,여의도,8848,9934,18782
<class,5호선,신길,2231,2447,4678
<class,5호선,영등포시장,6090,6439,12529
<class,5호선,영등포구청,1866,1826,3692
<class,5호선,양평,3199,3039,6238
<class,5호선,오목교,14022,14470,28492
<class,5호선,목동,10167,10248,20415
<class,5호선,신정,7864,6891,14755
<class,5호선,까치산,18761,18250,37011
<class,5호선,화곡,18083,16592,34675
<class,5호선,우장산,8618,8604,17222
<class,5호선,발산,11170,12105,23275
<class,5호선,마곡,4741,4802,9543
<class,5호선,송정,4447,4353,8800
<class,5호선,김포공항,6395,5644,12039
<class,5호선,개화산,3447,3464,6911
<class,5호선,방화,4126,4017,8143
<class,4호선,쌍문,19385,17391,36776
<class,4호선,창동,16934,17685,34619
<class,4호선,노원,14399,15578,29977
<class,4호선,상계,13003,12189,25192
<class,4호선,당고개,9102,8560,17662
<class,4호선,남태령,875,746,1621
<class,4호선,사당,17259,14978,32237
<class,4호선,총신대입구,12954,13821,26775
<class,4호선,동작,1836,1882,3718
<class,4호선,이촌,5759,6461,12220
<class,4호선,신용산,8086,8576,16662
<class,4호선,삼각지,2942,3842,6784
<class,4호선,숙대입구,7609,7222,14831
<class,4호선,서울역,4579,8997,13576
<class,4호선,회현,15535,16856,32391
<class,4호선,명동,10668,12157,22825
<class,4호선,충무로,11456,11838,23294
<class,4호선,동대문역사문화공원,9035,7724,16759
<class,4호선,동대문,13366,13434,26800
<class,4호선,혜화,21478,22441,43919
<class,4호선,한성대입구,9331,9169,18500
<class,4호선,성신여대입구,14640,14133,28773
<class,4호선,길음,12404,11763,24167
<class,4호선,미아사거리,19390,18584,37974
<class,4호선,미아,9498,9068,18566
<class,4호선,수유,23673,23377,47050
<class,3호선,오금,3174,3052,6226
<class,3호선,경찰병원,3425,3290,6715
<class,경원선,응봉,1257,1091,2348
<class,3호선,가락시장,4718,4411,9129
<class,3호선,수서,11204,11102,22306
<class,3호선,일원,4398,4350,8748
<class,3호선,대청,5288,4937,10225
<class,3호선,학여울,1321,1365,2686
<class,3호선,대치,8741,7646,16387
<class,3호선,도곡,2786,2700,5486
<class,3호선,매봉,5395,5123,10518
<class,2호선,신도림,33781,33650,67431
<class,2호선,문래,10142,10716,20858
<class,2호선,영등포구청,11212,11555,22767
<class,2호선,당산,11287,12091,23378
<class,2호선,합정,23247,25311,48558
<class,2호선,홍대입구,48935,52770,101705
<class,2호선,신촌,25161,25471,50632
<class,2호선,이대,8826,9164,17990
<class,2호선,아현,6691,6292,12983
<class,2호선,충정로,4833,4971,9804
<class,2호선,용답,1867,1876,3743
<class,2호선,신답,885,875,1760
<class,2호선,신설동,2803,2789,5592
<class,2호선,도림천,720,703,1423
<class,2호선,양천구청,4122,4241,8363
<class,2호선,신정네거리,6462,6533,12995
<class,2호선,용두,1455,1444,2899
<class,3호선,지축,2836,2772,5608
<class,3호선,구파발,13569,13700,27269
<class,3호선,연신내,26836,25500,52336
<class,3호선,불광,11997,13794,25791
<class,3호선,녹번,9175,8091,17266
<class,3호선,홍제,11598,10825,22423
<class,3호선,무악재,2447,2558,5005
<class,3호선,독립문,5377,5780,11157
<class,3호선,경복궁,13592,15326,28918
<class,3호선,안국,12203,14050,26253
<class,3호선,종로3가,4924,6840,11764
<class,3호선,을지로3가,4354,4673,9027
<class,3호선,충무로,1,0,1
<class,3호선,동대입구,5413,5993,11406
<class,3호선,약수,8111,7687,15798
<class,3호선,금호,5324,4905,10229
<class,3호선,옥수,6532,6517,13049
<class,3호선,압구정,22087,23001,45088
<class,3호선,신사,21633,22688,44321
<class,3호선,잠원,3145,2956,6101
<class,3호선,고속터미널,39401,38015,77416
<class,3호선,교대,6008,3626,9634
<class,3호선,남부터미널,17656,17697,35353
<class,3호선,양재,17702,19256,36958
<class,경원선,옥수,22,36,58
<class,경원선,한남,2614,2434,5048
<class,경원선,서빙고,1237,1140,2377
<class,경원선,이촌,2903,2112,5015
<class,경부선,광명,2103,1942,4045
<class,경부선,서동탄,900,912,1812
<class,경부선,당정,3596,3421,7017
<class,경부선,천안,5498,5803,11301
<class,경부선,두정,4290,4539,8829
<class,경부선,직산,581,580,1161
<class,경부선,성환,2661,2530,5191
<class,경부선,평택,11386,10887,22273
<class,경부선,평택지제,2561,2400,4961
<class,경부선,서정리,5300,4802,10102
<class,경부선,송탄,4142,3826,7968
<class,경부선,진위,913,812,1725
<class,경부선,오산,7806,7538,15344
<class,경부선,오산대,2550,2419,4969
<class,경부선,세마,1928,1745,3673
<class,경부선,병점,10350,10460,20810
<class,경부선,세류,2190,2203,4393
<class,경부선,독산,8142,8005,16147
<class,경부선,수원,30818,32579,63397
<class,경부선,화서,4773,4714,9487
<class,경부선,성균관대,8966,9013,17979
<class,경부선,의왕,5343,5338,10681
<class,경부선,군포,4022,3713,7735
<class,경부선,금정,16506,16339,32845
<class,경부선,명학,4466,4217,8683
<class,경부선,안양,15525,15494,31019
<class,경부선,관악,5441,4944,10385
<class,경부선,석수,6457,5850,12307
<class,경부선,금천구청,7429,7425,14854
<class,경부선,가산디지털단지,5464,7505,12969
<class,경부선,구로,11075,11137,22212
<class,경부선,신길,5570,4715,10285
<class,경부선,신도림,2659,2742,5401
<class,경부선,영등포,31867,33105,64972
<class,경부선,대방,6520,6692,13212
<class,경부선,노량진,7551,6670,14221
<class,일산선,정발산,4317,4334,8651
<class,6호선,상수,4736,5646,10382
<class,6호선,합정,8097,7310,15407
<class,6호선,망원,8571,9322,17893
<class,6호선,마포구청,6446,5872,12318
<class,6호선,월드컵경기장,4712,4849,9561
<class,6호선,디지털미디어시티,4441,4665,9106
<class,6호선,증산,4985,4957,9942
<class,6호선,새절,5739,5522,11261
<class,6호선,구산,3371,2569,5940
<class,6호선,연신내,2,0,2
<class,6호선,독바위,1501,1840,3341
<class,6호선,불광,2446,2392,4838
<class,6호선,역촌,1768,2108,3876
<class,6호선,응암,8262,8158,16420
<class,5호선,하남검단산,3940,3986,7926
<class,5호선,하남시청,3101,3041,6142
<class,5호선,하남풍산,1863,1868,3731
<class,5호선,미사,7451,7356,14807
<class,5호선,강일,1700,1678,3378
<class,5호선,마천,2915,3234,6149
<class,5호선,거여,3568,3461,7029
<class,5호선,개롱,2668,2956,5624
<class,5호선,오금,1438,1322,2760
<class,5호선,방이,3577,3390,6967
<class,5호선,올림픽공원,2222,2219,4441
<class,5호선,둔촌동,3737,3819,7556
<class,5호선,상일동,5822,5724,11546
<class,5호선,고덕,3666,3669,7335
<class,5호선,명일,3796,3794,7590
<class,5호선,굽은다리,4249,3960,8209
<class,5호선,길동,3527,3660,7187
<class,5호선,강동,7414,7307,14721
<class,5호선,천호,10310,9735,20045
<class,5호선,광나루,6902,7055,13957
<class,5호선,아차산,9903,9530,19433
<class,5호선,군자,5232,5650,10882
<class,5호선,장한평,6650,6597,13247
<class,5호선,답십리,6419,5969,12388
<class,5호선,마장,2507,2357,4864
<class,5호선,왕십리,2071,2334,4405
<class,5호선,행당,3477,3208,6685
<class,5호선,신금호,2691,2886,5577
<class,5호선,청구,1572,1546,3118
<class,5호선,동대문역사문화공원,567,632,1199
<class,5호선,을지로4가,1222,1228,2450
<class,5호선,종로3가,7084,6670,13754
<class,5호선,광화문,9172,9017,18189
<class,5호선,서대문,4319,4191,8510
<class,5호선,충정로,1288,1373,2661
<class,5호선,애오개,2236,2322,4558
<class,5호선,공덕,3934,3910,7844
<class,5호선,마포,4231,4100,8331
<class,5호선,여의나루,11097,11157,22254
<class,5호선,여의도,6180,6673,12853
<class,5호선,신길,1616,1899,3515
<class,5호선,영등포시장,3795,3974,7769
<class,5호선,영등포구청,1224,1156,2380
<class,5호선,양평,2214,2207,4421
<class,5호선,오목교,9411,9652,19063
<class,5호선,목동,6683,6877,13560
<class,5호선,신정,5585,5098,10683
<class,5호선,까치산,13547,13221,26768
<class,5호선,화곡,12445,11618,24063
<class,5호선,우장산,5840,6032,11872
<class,5호선,발산,7688,8035,15723
<class,5호선,마곡,3084,3151,6235
<class,5호선,송정,3259,3316,6575
<class,5호선,김포공항,6114,5121,11235
<class,5호선,개화산,2490,2534,5024
<class,5호선,방화,3228,3148,6376
<class,4호선,쌍문,13593,12375,25968
<class,4호선,창동,12274,12623,24897
<class,4호선,노원,10138,10999,21137
<class,4호선,상계,9383,8935,18318
<class,4호선,당고개,7061,6757,13818
<class,4호선,남태령,558,482,1040
<class,4호선,사당,12433,11642,24075
<class,4호선,총신대입구,8944,9749,18693
<class,4호선,동작,1608,1553,3161
<class,4호선,이촌,4367,5020,9387
<class,4호선,신용산,6123,6244,12367
<class,4호선,삼각지,2122,2757,4879
<class,4호선,숙대입구,5510,5396,10906
<class,4호선,서울역,3569,6918,10487
<class,4호선,회현,7022,7511,14533
<class,4호선,명동,8487,8778,17265
<class,4호선,충무로,7593,7792,15385
<class,4호선,동대문역사문화공원,6929,6949,13878
<class,4호선,동대문,5727,6079,11806
<class,4호선,혜화,17208,18377,35585
<class,4호선,한성대입구,7017,7067,14084
<class,4호선,성신여대입구,10921,10547,21468
<class,4호선,길음,8710,8730,17440
<class,4호선,미아사거리,13630,12966,26596
<class,4호선,미아,6860,6573,13433
<class,4호선,수유,17419,16632,34051
<class,3호선,오금,2395,2255,4650
<class,3호선,경찰병원,2327,2391,4718
<class,3호선,가락시장,2701,2962,5663
<class,3호선,수서,8857,8567,17424
<class,3호선,일원,3210,3300,6510
<class,3호선,대청,3634,3565,7199
<class,3호선,학여울,782,764,1546
<class,3호선,대치,5594,4869,10463
<class,3호선,도곡,1591,1712,3303
<class,3호선,매봉,3559,3517,7076
<class,3호선,양재,10738,12416,23154
<class,3호선,남부터미널,11970,12450,24420
<class,3호선,교대,3640,2222,5862
<class,3호선,고속터미널,31965,29256,61221
<class,3호선,잠원,2184,2062,4246
<class,3호선,신사,11318,11833,23151
<class,3호선,압구정,11879,12268,24147
<class,3호선,옥수,4635,4790,9425
<class,3호선,금호,3823,3670,7493
<class,3호선,약수,5673,5501,11174
<class,3호선,동대입구,4589,5207,9796
<class,3호선,충무로,1,0,1
<class,3호선,을지로3가,2555,2474,5029
<class,3호선,종로3가,3234,4271,7505
<class,3호선,안국,8760,9984,18744
<class,3호선,경복궁,10569,11402,21971
<class,3호선,독립문,3830,4203,8033
<class,3호선,무악재,1596,1800,3396
<class,3호선,홍제,7965,7508,15473
<class,3호선,녹번,6301,5688,11989
<class,3호선,불광,8978,10491,19469
<class,3호선,연신내,19453,18256,37709
<class,3호선,구파발,10083,10489,20572
<class,3호선,지축,1839,1751,3590
<class,2호선,용두,942,898,1840
<class,2호선,신정네거리,4433,4542,8975
<class,2호선,양천구청,2723,2864,5587
<class,2호선,도림천,449,418,867
<class,2호선,신설동,2568,2737,5305
<class,2호선,신답,661,687,1348
<class,2호선,용답,1525,1480,3005
<class,2호선,충정로,3352,3470,6822
<class,2호선,아현,4457,4457,8914
<class,2호선,이대,5949,6486,12435
<class,2호선,신촌,18251,17828,36079
<class,2호선,홍대입구,37124,37426,74550
<class,2호선,합정,17186,18202,35388
<class,2호선,당산,8010,8304,16314
<class,2호선,영등포구청,6512,6819,13331
<class,2호선,문래,6512,6923,13435
<class,2호선,신도림,22692,22947,45639
<class,2호선,대림,12482,12720,25202
<class,2호선,구로디지털단지,19654,19312,38966
<class,2호선,신대방,13483,13236,26719
<class,2호선,신림,31555,30850,62405
<class,2호선,봉천,10602,10147,20749
<class,2호선,서울대입구,23955,24846,48801
<class,2호선,낙성대,13631,13976,27607
<class,2호선,사당,18149,20315,38464
<class,2호선,방배,5702,5991,11693
<class,2호선,서초,8058,7555,15613
<class,2호선,교대,9027,10023,19050
<class,2호선,강남,29143,28016,57159
<class,2호선,역삼,9628,10623,20251
<class,2호선,삼성,16306,16136,32442
<class,2호선,종합운동장,3071,3285,6356
<class,2호선,잠실새내,8938,9251,18189
<class,2호선,잠실,37329,34938,72267
<class,2호선,잠실나루,4365,4479,8844
<class,2호선,강변,17269,16706,33975
<class,2호선,구의,9686,9680,19366
<class,2호선,건대입구,21486,22292,43778
<class,2호선,성수,10698,12554,23252
<class,2호선,뚝섬,9018,9397,18415
<class,2호선,한양대,2493,2634,5127
<class,2호선,왕십리,7801,6460,14261
<class,2호선,상왕십리,5786,5857,11643
<class,2호선,신당,7149,7411,14560
<class,2호선,동대문역사문화공원,5886,7183,13069
<class,2호선,을지로4가,2523,2468,4991
<class,2호선,을지로3가,6165,5747,11912
<class,2호선,을지로입구,12399,11721,24120
<class,2호선,시청,4865,4317,9182
<class,1호선,청량리,11127,11153,22280
<class,1호선,제기동,8079,8367,16446
<class,1호선,신설동,6498,6558,13056
<class,1호선,동대문,7568,8210,15778
<class,1호선,종로5가,7329,7558,14887
<class,1호선,종로3가,12261,10934,23195
<class,분당선,청명,1739,1737,3476
<class,분당선,상갈,2561,2719,5280
<class,분당선,기흥,4295,4126,8421
<class,분당선,신갈,1715,1756,3471
<class,분당선,구성,2113,2270,4383
<class,분당선,죽전,6682,7362,14044
<class,분당선,보정,924,891,1815
<class,분당선,이매,2717,2777,5494
<class,분당선,오리,4613,4055,8668
<class,분당선,미금,6121,6457,12578
<class,분당선,정자,6323,6571,12894
<class,분당선,수내,5603,5503,11106
<class,분당선,서현,11336,11578,22914
<class,분당선,야탑,10737,11182,21919
<class,분당선,모란,9576,9783,19359
<class,분당선,태평,7020,6550,13570
<class,분당선,가천대,3387,3954,7341
<class,분당선,선정릉,1794,1957,3751
<class,분당선,강남구청,2881,3434,6315
<class,분당선,압구정로데오,8784,9935,18719
<class,분당선,서울숲,6562,6613,13175
<class,분당선,수원,4681,4147,8828
<class,분당선,복정,1,0,1
<class,분당선,수서,7498,6742,14240
<class,분당선,대모산입구,1905,1793,3698
<class,분당선,개포동,1703,1728,3431
<class,분당선,구룡,654,746,1400
<class,분당선,도곡,2170,2003,4173
<class,분당선,한티,7660,7447,15107
<class,분당선,선릉,2463,3600,6063
<class,과천선,범계,12182,11403,23585
<class,과천선,평촌,5231,5207,10438
<class,과천선,인덕원,9700,9742,19442
<class,과천선,정부과천청사,3810,3953,7763
<class,과천선,과천,3153,3005,6158
<class,과천선,대공원,5194,5287,10481
<class,과천선,경마공원,546,524,1070
<class,과천선,선바위,3283,3060,6343
<class,공항철도 1호선,영종,2094,2027,4121
<class,공항철도 1호선,인천공항2터미널,1777,1645,3422
<class,공항철도 1호선,인천공항1터미널,3331,3257,6588
<class,공항철도 1호선,공항화물청사,1050,1086,2136
<class,공항철도 1호선,운서,4578,4784,9362
<class,공항철도 1호선,청라국제도시,2820,2667,5487
<class,공항철도 1호선,검암,3220,3271,6491
<class,공항철도 1호선,계양,4428,4404,8832
<class,공항철도 1호선,김포공항,11369,5192,16561
<class,공항철도 1호선,마곡나루,2223,2321,4544
<class,공항철도 1호선,디지털미디어시티,3115,3170,6285
<class,공항철도 1호선,홍대입구,7759,7472,15231
<class,공항철도 1호선,공덕,975,1417,2392
<class,공항철도 1호선,서울역,5781,5174,10955
<class,경춘선,춘천,1737,1592,3329
<class,경춘선,남춘천,2042,2166,4208
<class,경춘선,김유정,564,599,1163
<class,경춘선,강촌,824,717,1541
<class,경춘선,백양리,165,106,271
<class,경춘선,굴봉산,250,229,479
<class,경춘선,가평,1942,1682,3624
<class,경춘선,상천,509,414,923
<class,경춘선,청평,1605,1472,3077
<class,경춘선,대성리,714,592,1306
<class,경춘선,마석,2385,2297,4682
<class,경춘선,천마산,1085,1109,2194
<class,경춘선,평내호평,3252,3118,6370
<class,경춘선,금곡,897,879,1776
<class,경춘선,사릉,1663,1620,3283
<class,경춘선,퇴계원,1962,1748,3710
<class,경춘선,별내,1767,1679,3446
<class,경춘선,갈매,1316,1166,2482
<class,경춘선,신내,859,842,1701
<class,경인선,도화,2097,2002,4099
<class,경인선,중동,4259,3990,8249
<class,일산선,백석,4760,4721,9481
<class,일산선,대곡,1018,870,1888
<class,일산선,화정,8493,8683,17176
<class,일산선,원당,5622,5410,11032
<class,일산선,삼송,9471,9232,18703
<class,일산선,원흥,4762,4459,9221
<class,우이신설선,신설동,1055,1005,2060
<class,우이신설선,보문,849,806,1655
<class,우이신설선,성신여대입구,1990,2181,4171
<class,우이신설선,정릉,2357,1995,4352
<class,우이신설선,북한산보국문,3241,3007,6248
<class,우이신설선,솔샘,2527,2361,4888
<class,우이신설선,삼양사거리,1495,1471,2966
<class,우이신설선,삼양,1064,1118,2182
<class,우이신설선,화계,1894,1751,3645
<class,우이신설선,가오리,2183,2035,4218
<class,우이신설선,4.19민주묘지,1950,1701,3651
<class,우이신설선,솔밭공원,1326,1340,2666
<class,우이신설선,북한산우이,3237,3437,6674
<class,안산선,수리산,1936,1961,3897
<class,안산선,오이도,5581,5429,11010
<class,안산선,정왕,4420,4857,9277
<class,안산선,신길온천,1000,974,1974
<class,안산선,안산,7560,7021,14581
<class,안산선,초지,2061,2048,4109
<class,안산선,고잔,3989,3944,7933
<class,안산선,중앙,9730,9821,19551
<class,안산선,한대앞,4684,4582,9266
<class,안산선,상록수,7725,7710,15435
<class,안산선,반월,2250,2312,4562
<class,안산선,대야미,2821,2574,5395
<class,안산선,산본,7719,6756,14475
<class,수인선,인천,1078,1554,2632
<class,수인선,신포,1041,1021,2062
<class,수인선,숭의,1922,1699,3621
<class,수인선,인하대,2945,2870,5815
<class,수인선,송도,1467,1405,2872
<class,수인선,연수,2636,2534,5170
<class,수인선,원인재,2679,2699,5378
<class,수인선,남동인더스파크,571,594,1165
<class,수인선,호구포,1761,1765,3526
<class,수인선,인천논현,2629,2764,5393
<class,수인선,소래포구,5776,5650,11426
<class,수인선,월곶,1462,1440,2902
<class,수인선,달월,61,64,125
<class,수인선,사리,2277,1943,4220
<class,수인선,야목,182,191,373
<class,수인선,어천,495,567,1062
<class,수인선,오목천,1221,1229,2450
<class,수인선,고색,1505,1624,3129
<class,분당선,매교,1292,1348,2640
<class,분당선,수원시청,6272,6175,12447
<class,1호선,종각,9587,8669,18256
<class,1호선,시청,6503,6315,12818
<class,분당선,매탄권선,2206,2127,4333
<class,분당선,망포,5224,5541,10765
<class,분당선,영통,3942,4134,8076
<class,중앙선,지평,69,67,136
<class,중앙선,용문,2222,1828,4050
<class,중앙선,원덕,409,363,772
<class,중앙선,양평,2115,2015,4130
<class,중앙선,오빈,219,193,412
<class,중앙선,아신,616,536,1152
<class,중앙선,국수,670,592,1262
<class,중앙선,신원,435,323,758
<class,중앙선,양수,2050,1925,3975
<class,중앙선,운길산,1849,1785,3634
<class,중앙선,팔당,1568,1683,3251
<class,중앙선,도심,1155,1044,2199
<class,중앙선,덕소,3230,3242,6472
<class,중앙선,양정,554,481,1035
<class,중앙선,도농,4458,4376,8834
<class,중앙선,구리,6771,7045,13816
<class,중앙선,양원,915,997,1912
<class,중앙선,망우,4205,4200,8405
<class,중앙선,상봉,3728,3510,7238
<class,중앙선,중랑,3093,3017,6110
<class,중앙선,회기,13251,13626,26877
<class,장항선,신창,1000,1469,2469
<class,장항선,온양온천,2773,2702,5475
<class,장항선,배방,684,822,1506
<class,장항선,아산,2679,1806,4485
<class,장항선,쌍용,956,1040,1996
<class,장항선,봉명,496,472,968
<class,일산선,대화,5440,4903,10343
<class,일산선,주엽,4060,4019,8079
<class,일산선,마두,3230,3154,6384
<class,경의선,가좌,2583,2628,5211
<class,경의선,홍대입구,1307,1438,2745
<class,경의선,서강대,1128,1106,2234
<class,경의선,공덕,1478,1206,2684
<class,경의선,효창공원앞,1134,1269,2403
<class,경의선,신촌,246,259,505
<class,경의선,서울역,905,838,1743
<class,경원선,소요산,4653,3993,8646
<class,경원선,동두천,1358,1732,3090
<class,경원선,보산,1232,1265,2497
<class,경원선,동두천중앙,1893,1816,3709
<class,경원선,지행,3768,3839,7607
<class,경원선,덕정,2958,3181,6139
<class,경원선,덕계,1585,1489,3074
<class,경원선,양주,5074,4991,10065
<class,경원선,녹양,2501,2424,4925
<class,경원선,가능,3733,3544,7277
<class,경원선,의정부,11886,12061,23947
<class,경원선,회룡,6682,6701,13383
<class,경원선,망월사,4233,4321,8554
<class,경원선,도봉산,9387,6838,16225
<class,경원선,도봉,3316,3059,6375
<class,경원선,방학,5281,5092,10373
<class,경원선,녹천,2590,2218,4808
<class,경원선,월계,3165,2896,6061
<class,경원선,광운대,3657,3725,7382
<class,경원선,석계,4461,4825,9286
<class,경원선,신이문,4216,4021,8237
<class,경원선,외대앞,4110,4177,8287
<class,경원선,청량리,11728,10818,22546
<class,경원선,왕십리,7698,8696,16394
<class,경원선,응봉,967,960,1927
<class,경원선,옥수,72,31,103
<class,경원선,한남,1785,1781,3566
<class,경원선,서빙고,1021,1018,2039
<class,경원선,이촌,2215,1592,3807
<class,경부선,광명,1938,1362,3300
<class,경부선,서동탄,681,713,1394
<class,경부선,당정,2653,2603,5256
<class,경부선,천안,5527,5248,10775
<class,경부선,두정,3594,3993,7587
<class,경부선,직산,494,534,1028
<class,경부선,성환,2097,2490,4587
<class,경부선,평택,9350,10152,19502
<class,경부선,평택지제,2046,1810,3856
<class,경부선,서정리,3758,4999,8757
<class,경부선,송탄,3126,3550,6676
<class,경부선,진위,651,640,1291
<class,경부선,오산,6388,6629,13017
<class,경부선,오산대,2016,1946,3962
<class,경부선,세마,1487,1406,2893
<class,경부선,병점,7875,8535,16410
<class,경부선,세류,1787,1772,3559
<class,경부선,독산,5307,5270,10577
<class,경부선,수원,27575,26428,54003
<class,경부선,화서,3441,3389,6830
<class,경부선,성균관대,6674,7110,13784
<class,경부선,의왕,3764,3890,7654
<class,경부선,군포,2778,2717,5495
<class,경부선,금정,12088,12310,24398
<class,경부선,명학,2906,2836,5742
<class,경부선,안양,11581,11342,22923
<class,경부선,관악,4330,4085,8415
<class,경부선,석수,4784,4714,9498
<class,경부선,금천구청,5466,5459,10925
<class,경부선,가산디지털단지,4011,5511,9522
<class,경부선,구로,8067,8252,16319
<class,경부선,신길,4188,3629,7817
<class,경부선,신도림,1990,2080,4070
<class,경부선,영등포,24900,24355,49255
<class,경부선,대방,4648,5033,9681
<class,경부선,노량진,5238,4987,10225
<class,경부선,용산,23864,21232,45096
<class,경부선,남영,3513,3835,7348
<class,경부선,서울역,5630,1152,6782
<class,경강선,여주,1795,1890,3685
<class,경강선,세종대왕릉,287,270,557
<class,경강선,부발,1096,1695,2791
<class,경강선,이천,1668,1862,3530
<class,경강선,신둔도예촌,843,779,1622
<class,경강선,곤지암,1347,1587,2934
<class,경강선,초월,1391,1375,2766
<class,경강선,경기광주,3178,3160,6338
<class,경강선,삼동,884,870,1754
<class,경강선,이매,592,499,1091
<class,경강선,판교,2082,1895,3977
<class,9호선2~3단계,중앙보훈병원,3004,2812,5816
<class,9호선2~3단계,둔촌오륜,366,420,786
<class,9호선2~3단계,올림픽공원,3685,3999,7684
<class,9호선2~3단계,한성백제,1438,1157,2595
<class,9호선2~3단계,송파나루,2435,2785,5220
<class,9호선2~3단계,석촌,4013,3591,7604
<class,9호선2~3단계,석촌고분,2579,2560,5139
<class,9호선2~3단계,삼전,3067,2959,6026
<class,9호선2~3단계,종합운동장,1683,1676,3359
<class,9호선2~3단계,봉은사,6068,6173,12241
<class,9호선2~3단계,삼성중앙,1593,1657,3250
<class,9호선2~3단계,선정릉,2668,2970,5638
<class,9호선2~3단계,언주,3017,3133,6150
<class,9호선,신논현,12961,12730,25691
<class,9호선,사평,1168,1273,2441
<class,9호선,고속터미널,8659,11236,19895
<class,9호선,신반포,1380,1458,2838
<class,9호선,구반포,874,942,1816
<class,9호선,동작,1089,935,2024
<class,9호선,흑석,3294,3465,6759
<class,9호선,노들,2568,2259,4827
<class,9호선,노량진,12952,13633,26585
<class,9호선,샛강,1452,1550,3002
<class,9호선,여의도,6936,6506,13442
<class,9호선,국회의사당,3265,3192,6457
<class,9호선,당산,7546,7501,15047
<class,9호선,선유도,2704,2646,5350
<class,9호선,신목동,1512,1297,2809
<class,9호선,염창,7175,7091,14266
<class,9호선,등촌,4518,4529,9047
<class,9호선,증미,2129,2155,4284
<class,9호선,가양,8607,8555,17162
<class,9호선,양천향교,3628,3841,7469
<class,9호선,마곡나루,4909,5111,10020
<class,9호선,신방화,2855,2863,5718
<class,9호선,공항시장,1579,1661,3240
<class,9호선,김포공항,6525,9324,15849
<class,9호선,개화,1040,992,2032
<class,8호선,모란,2138,1798,3936
<class,8호선,수진,2564,2309,4873
<class,8호선,신흥,2400,2497,4897
<class,8호선,단대오거리,4514,4510,9024
<class,8호선,남한산성입구,5874,5500,11374
<class,8호선,산성,3021,3167,6188
<class,8호선,복정,4280,4004,8284
<class,8호선,장지,7727,7837,15564
<class,8호선,문정,4528,4860,9388
<class,8호선,가락시장,2214,2755,4969
<class,8호선,송파,2853,2990,5843
<class,8호선,석촌,3486,4383,7869
<class,8호선,잠실,7459,8315,15774
<class,8호선,몽촌토성,3249,3174,6423
<class,8호선,강동구청,3692,3800,7492
<class,8호선,천호,7201,8309,15510
<class,8호선,암사,7585,7261,14846
<class,7호선,부평구청,3184,2886,6070
<class,7호선,굴포천,3990,3947,7937
<class,7호선,삼산체육관,2264,2121,4385
<class,7호선,상동,6075,5966,12041
<class,7호선,부천시청,6038,5839,11877
<class,7호선,신중동,5862,5763,11625
<class,7호선,춘의,3080,2894,5974
<class,7호선,부천종합운동장,2366,2188,4554
<class,7호선,까치울,3923,3921,7844
<class,7호선,온수,3406,3399,6805
<class,7호선,천왕,4413,4220,8633
<class,7호선,광명사거리,10831,10662,21493
<class,7호선,철산,9092,9248,18340
<class,7호선,가산디지털단지,9004,8412,17416
<class,7호선,남구로,5700,5615,11315
<class,7호선,대림,5211,4926,10137
<class,7호선,신풍,5356,5093,10449
<class,7호선,보라매,3703,3680,7383
<class,7호선,신대방삼거리,6980,6866,13846
<class,7호선,장승배기,4361,4261,8622
<class,7호선,상도,4713,4713,9426
<class,7호선,숭실대입구,5011,5413,10424
<class,7호선,남성,4773,4718,9491
<class,7호선,이수,7139,6834,13973
<class,7호선,내방,4549,4660,9209
<class,7호선,고속터미널,9576,6519,16095
<class,7호선,반포,2500,2438,4938
<class,7호선,논현,5824,6133,11957
<class,7호선,학동,5072,5405,10477
<class,7호선,강남구청,5219,5636,10855
<class,7호선,청담,5648,6054,11702
<class,7호선,뚝섬유원지,9300,8487,17787
<class,7호선,건대입구,6184,6205,12389
<class,7호선,어린이대공원,7342,7390,14732
<class,경인선,온수,3308,3098,6406
<class,경인선,도원,1468,1488,2956
<class,경인선,간석,2876,2714,5590
<class,경인선,부개,4148,3933,8081
<class,경인선,소사,4663,4578,9241
<class,경인선,구일,2776,2733,5509
<class,경인선,인천,3940,3330,7270
<class,경인선,동인천,8327,8157,16484
<class,경인선,제물포,4877,4704,9581
<class,경인선,주안,10221,9158,19379
<class,경인선,동암,8328,8223,16551
<class,경인선,백운,3598,3598,7196
<class,1호선,동묘앞,11344,11327,22671
<class,경인선,부평,19425,19896,39321
<class,경인선,송내,11418,11175,22593
<class,경인선,부천,18509,18193,36702
<class,경인선,역곡,12719,12651,25370
<class,경인선,오류동,6060,5759,11819
<class,경인선,개봉,10314,10079,20393
<class,경의선,임진강,122,99,221
<class,경의선,문산,3447,3431,6878
<class,경의선,파주,635,570,1205
<class,경의선,월롱,868,1667,2535
<class,경의선,금촌,3911,4232,8143
<class,경의선,금릉,2511,2458,4969
<class,경의선,운정,3154,3130,6284
<class,경의선,야당,3813,3696,7509
<class,경의선,탄현,3662,3352,7014
<class,경의선,일산,4150,3991,8141
<class,경의선,풍산,2979,2917,5896
<class,경의선,백마,2907,2861,5768
<class,경의선,곡산,292,300,592
<class,경의선,능곡,2045,1875,3920
<class,경의선,행신,3944,3572,7516
<class,경의선,강매,1273,1251,2524
<class,경의선,화전,801,788,1589
<class,경의선,수색,826,939,1765
<class,경의선,디지털미디어시티,1172,1089,2261
<class,경원선,창동,1,0,1
<class,2호선,선릉,10991,9492,20483
<class,1호선,서울역,21731,18551,40282
<class,7호선,군자,6730,5345,12075
<class,7호선,중곡,4583,4401,8984
<class,7호선,용마산,2872,3504,6376
<class,7호선,사가정,8279,7990,16269
<class,7호선,면목,7065,7020,14085
<class,7호선,상봉,7926,7494,15420
<class,7호선,중화,5060,4861,9921
<class,7호선,먹골,5100,4968,10068
<class,7호선,태릉입구,4326,4140,8466
<class,7호선,공릉,5663,5990,11653
<class,7호선,하계,7857,7368,15225
<class,7호선,중계,5958,5438,11396
<class,7호선,노원,9654,9913,19567
<class,7호선,마들,5261,4951,10212
<class,7호선,수락산,8055,7891,15946
<class,7호선,도봉산,5408,7860,13268
<class,7호선,장암,1463,1254,2717
<class,6호선,봉화산,3249,3268,6517
<class,6호선,화랑대,4474,3935,8409
<class,6호선,태릉입구,2875,3063,5938
<class,6호선,석계,5825,5948,11773
<class,6호선,돌곶이,3995,3787,7782
<class,6호선,상월곡,2809,2547,5356
<class,6호선,월곡,4810,4661,9471
<class,6호선,고려대,3663,3599,7262
<class,6호선,안암,4192,4678,8870
<class,6호선,보문,3501,3232,6733
<class,6호선,창신,1505,1307,2812
<class,6호선,동묘앞,5522,5404,10926
<class,6호선,신당,3793,4581,8374
<class,6호선,청구,1504,1458,2962
<class,6호선,약수,1542,1475,3017
<class,6호선,버티고개,782,975,1757
<class,6호선,한강진,5193,6001,11194
<class,6호선,이태원,9470,9739,19209
<class,6호선,녹사평,3710,3587,7297
<class,6호선,삼각지,3215,2340,5555
<class,6호선,효창공원앞,3024,2707,5731
<class,6호선,공덕,5748,5559,11307
<class,6호선,대흥,3393,3531,6924
<class,6호선,광흥창,3640,3444,7084
<class,경춘선,남춘천,3258,3625,6883
<class,6호선,불광,3431,3132,6563
<class,6호선,역촌,2549,2971,5520
<class,6호선,응암,11766,11451,23217
<class,5호선,하남검단산,4772,4779,9551
<class,5호선,하남시청,4426,4219,8645
<class,5호선,하남풍산,2489,2533,5022
<class,5호선,미사,10847,10773,21620
<class,5호선,강일,2381,2236,4617
<class,5호선,마천,4329,4336,8665
<class,5호선,거여,5618,5262,10880
<class,5호선,개롱,4089,4268,8357
<class,5호선,오금,2029,1940,3969
<class,5호선,방이,4677,4633,9310
<class,5호선,올림픽공원,3377,3210,6587
<class,5호선,둔촌동,5901,5827,11728
<class,5호선,상일동,8985,8324,17309
<class,5호선,고덕,6078,5957,12035
<class,5호선,명일,5627,5656,11283
<class,5호선,굽은다리,6467,6138,12605
<class,5호선,길동,5441,5588,11029
<class,5호선,강동,11835,11294,23129
<class,5호선,천호,15082,14379,29461
<class,5호선,광나루,9259,8726,17985
<class,5호선,아차산,12160,11607,23767
<class,5호선,군자,7912,8539,16451
<class,5호선,장한평,10513,10194,20707
<class,5호선,답십리,9403,8462,17865
<class,5호선,마장,3564,3371,6935
<class,5호선,왕십리,3120,3702,6822
<class,5호선,행당,5668,4871,10539
<class,5호선,신금호,3712,3926,7638
<class,5호선,청구,2309,2216,4525
<class,5호선,동대문역사문화공원,873,1134,2007
<class,5호선,을지로4가,3128,3388,6516
<class,5호선,종로3가,10801,11367,22168
<class,5호선,광화문,11884,12761,24645
<class,5호선,서대문,6594,6276,12870
<class,5호선,충정로,1912,1736,3648
<class,5호선,애오개,3349,3069,6418
<class,5호선,공덕,6537,6597,13134
<class,5호선,마포,6496,6620,13116
<class,5호선,여의나루,14030,15139,29169
<class,5호선,여의도,9574,10484,20058
<class,5호선,신길,2421,2533,4954
<class,5호선,영등포시장,6659,6884,13543
<class,5호선,영등포구청,1882,1805,3687
<class,5호선,양평,3433,3175,6608
<class,5호선,오목교,15061,15563,30624
<class,5호선,목동,10536,10440,20976
<class,5호선,신정,8281,7042,15323
<class,5호선,까치산,19736,18888,38624
<class,5호선,화곡,18762,17113,35875
<class,5호선,우장산,9005,8977,17982
<class,5호선,발산,12434,13237,25671
<class,5호선,마곡,4755,4815,9570
<class,5호선,송정,4950,4752,9702
<class,5호선,김포공항,6656,7005,13661
<class,5호선,개화산,3594,3442,7036
<class,4호선,쌍문,20250,18067,38317
<class,4호선,창동,17511,18161,35672
<class,4호선,노원,14858,15864,30722
<class,4호선,상계,13307,12483,25790
<class,4호선,당고개,9052,8670,17722
<class,4호선,남태령,1068,801,1869
<class,4호선,사당,18403,15835,34238
<class,4호선,총신대입구,13573,14547,28120
<class,4호선,동작,1888,1935,3823
<class,4호선,이촌,5910,6729,12639
<class,4호선,신용산,8557,9514,18071
<class,4호선,삼각지,3001,3958,6959
<class,4호선,숙대입구,8401,8000,16401
<class,4호선,서울역,4898,11312,16210
<class,4호선,회현,16119,17475,33594
<class,4호선,명동,11900,13780,25680
<class,4호선,충무로,12101,12503,24604
<class,4호선,동대문역사문화공원,9809,8596,18405
<class,4호선,동대문,13526,13602,27128
<class,4호선,혜화,23328,24139,47467
<class,4호선,한성대입구,9852,9373,19225
<class,4호선,성신여대입구,15958,14667,30625
<class,4호선,길음,13639,13036,26675
<class,4호선,미아사거리,20372,18987,39359
<class,4호선,미아,10512,9762,20274
<class,4호선,수유,24153,23436,47589
<class,3호선,오금,3344,3111,6455
<class,3호선,경찰병원,3640,3479,7119
<class,3호선,가락시장,5279,4924,10203
<class,3호선,수서,11735,12137,23872
<class,3호선,일원,4470,4436,8906
<class,3호선,대청,5269,4913,10182
<class,3호선,학여울,3166,3271,6437
<class,3호선,대치,8629,7760,16389
<class,3호선,도곡,3350,3443,6793
<class,3호선,매봉,5655,5311,10966
<class,3호선,양재,18935,20872,39807
<class,3호선,남부터미널,17580,18712,36292
<class,3호선,교대,6290,3723,10013
<class,3호선,고속터미널,41480,43984,85464
<class,3호선,잠원,3620,3398,7018
<class,3호선,신사,22615,23825,46440
<class,3호선,압구정,22787,23713,46500
<class,3호선,옥수,6866,6923,13789
<class,1호선,서울역,27912,30215,58127
<class,1호선,동묘앞,10868,11022,21890
<class,1호선,종각,15950,14612,30562
<class,1호선,종로3가,21164,19652,40816
<class,1호선,종로5가,16986,16811,33797
<class,1호선,동대문,9894,9300,19194
<class,1호선,신설동,8994,8457,17451
<class,1호선,제기동,13916,14155,28071
<class,1호선,청량리,16432,16590,33022
<class,2호선,시청,7812,6978,14790
<class,2호선,을지로입구,18022,18359,36381
<class,2호선,을지로4가,6460,6804,13264
<class,2호선,동대문역사문화공원,9000,9676,18676
<class,2호선,신당,9886,10173,20059
<class,2호선,상왕십리,9038,8355,17393
<class,2호선,왕십리,12143,10102,22245
<class,2호선,한양대,3596,3643,7239
<class,2호선,뚝섬,13181,13457,26638
<class,2호선,성수,16352,19083,35435
<class,2호선,건대입구,29741,31568,61309
<class,2호선,구의,14679,14313,28992
<class,2호선,강변,23646,25858,49504
<class,2호선,잠실나루,7779,7590,15369
<class,2호선,잠실,55475,52828,108303
<class,2호선,잠실새내,14971,15438,30409
<class,2호선,종합운동장,4486,4839,9325
<class,2호선,삼성,24033,24203,48236
<class,2호선,선릉,21747,19225,40972
<class,2호선,역삼,16342,18020,34362
<class,2호선,강남,52868,52299,105167
<class,2호선,교대,15617,17476,33093
<class,2호선,서초,9207,8137,17344
<class,2호선,방배,9073,9164,18237
<class,2호선,사당,26401,29341,55742
<class,2호선,낙성대,19877,18103,37980
<class,2호선,서울대입구,35053,33356,68409
<class,2호선,봉천,15681,14162,29843
<class,2호선,신림,45477,43500,88977
<class,2호선,신대방,18334,17507,35841
<class,2호선,구로디지털단지,30413,29820,60233
<class,2호선,대림,16630,17460,34090
<class,2호선,신도림,35293,35479,70772
<class,2호선,문래,11147,11563,22710
<class,2호선,영등포구청,11926,12283,24209
<class,2호선,당산,11925,12799,24724
<class,2호선,합정,24937,27274,52211
<class,2호선,홍대입구,52207,55757,107964
<class,2호선,신촌,38019,36582,74601
<class,2호선,이대,9963,9748,19711
<class,2호선,아현,7177,6549,13726
<class,2호선,충정로,5192,5483,10675
<class,2호선,용답,1993,1891,3884
<class,2호선,신답,937,958,1895
<class,2호선,신설동,2861,2699,5560
<class,2호선,도림천,742,689,1431
<class,2호선,양천구청,4785,4795,9580
<class,2호선,신정네거리,6867,6769,13636
<class,2호선,용두,1556,1479,3035
<class,3호선,지축,2914,2817,5731
<class,3호선,구파발,14312,14272,28584
<class,3호선,연신내,27011,25256,52267
<class,3호선,불광,12358,13797,26155
<class,3호선,녹번,9609,8446,18055
<class,3호선,홍제,12142,11113,23255
<class,3호선,무악재,2546,2617,5163
<class,3호선,독립문,5385,5735,11120
<class,3호선,경복궁,15290,16547,31837
<class,3호선,안국,13093,14887,27980
<class,3호선,종로3가,5182,7418,12600
<class,3호선,을지로3가,4567,4997,9564
<class,3호선,동대입구,6102,6697,12799
<class,3호선,약수,8506,7962,16468
<class,3호선,금호,5553,5029,10582
<class,7호선,가산디지털단지,13508,12152,25660
<class,7호선,남구로,7496,7809,15305
<class,7호선,대림,6307,6591,12898
<class,7호선,신풍,7495,7057,14552
<class,7호선,보라매,5518,5209,10727
<class,7호선,신대방삼거리,10329,9511,19840
<class,7호선,장승배기,6381,6003,12384
<class,7호선,상도,6861,6330,13191
<class,7호선,숭실대입구,8112,8013,16125
<class,7호선,남성,7193,6549,13742
<class,7호선,이수,11022,10350,21372
<class,7호선,내방,7265,7084,14349
<class,7호선,고속터미널,12018,10069,22087
<class,7호선,반포,4061,3891,7952
<class,7호선,논현,10390,11192,21582
<class,7호선,학동,9188,9596,18784
<class,7호선,강남구청,9337,10209,19546
<class,7호선,청담,9840,10647,20487
<class,7호선,뚝섬유원지,11238,10456,21694
<class,7호선,건대입구,9466,9772,19238
<class,7호선,어린이대공원,10287,10305,20592
<class,7호선,군자,9777,7456,17233
<class,7호선,중곡,6969,6637,13606
<class,7호선,용마산,4032,4161,8193
<class,7호선,사가정,11732,11018,22750
<class,7호선,면목,10405,10049,20454
<class,7호선,상봉,12224,11559,23783
<class,7호선,중화,7320,6863,14183
<class,7호선,먹골,7499,7289,14788
<class,7호선,태릉입구,6453,6012,12465
<class,7호선,공릉,8269,8069,16338
<class,7호선,하계,12005,10952,22957
<class,7호선,중계,8747,7772,16519
<class,7호선,노원,14487,15227,29714
<class,7호선,마들,8438,7854,16292
<class,7호선,수락산,9592,9332,18924
<class,7호선,도봉산,6632,8968,15600
<class,7호선,장암,1630,1125,2755
<class,6호선,봉화산,4902,4719,9621
<class,6호선,화랑대,6921,5700,12621
<class,6호선,태릉입구,4020,4224,8244
<class,6호선,석계,8222,8127,16349
<class,6호선,돌곶이,5662,5193,10855
<class,6호선,상월곡,3876,3379,7255
<class,6호선,월곡,7132,6757,13889
<class,6호선,고려대,4948,4616,9564
<class,1호선,시청,9264,9301,18565
<class,6호선,안암,6119,5742,11861
<class,6호선,보문,4710,4167,8877
<class,6호선,창신,2053,1640,3693
<class,6호선,동묘앞,7391,7057,14448
<class,6호선,신당,5696,4834,10530
<class,6호선,청구,2346,2252,4598
<class,6호선,약수,2286,2155,4441
<class,6호선,버티고개,1165,1349,2514
<class,6호선,한강진,7032,8469,15501
<class,6호선,이태원,10700,11483,22183
<class,6호선,녹사평,4890,5186,10076
<class,6호선,삼각지,4835,3773,8608
<class,6호선,효창공원앞,4283,3655,7938
<class,6호선,공덕,9111,8642,17753
<class,6호선,대흥,5226,5091,10317
<class,6호선,광흥창,4816,4480,9296
<class,6호선,상수,6955,8258,15213
<class,6호선,합정,11291,10707,21998
<class,6호선,망원,11700,12856,24556
<class,6호선,마포구청,9005,7616,16621
<class,6호선,월드컵경기장,6012,6488,12500
<class,6호선,디지털미디어시티,6551,6659,13210
<class,6호선,증산,6806,6686,13492
<class,6호선,새절,8203,7624,15827
<class,6호선,구산,5217,3748,8965
<class,6호선,연신내,1,0,1
<class,6호선,독바위,1999,2255,4254
<class,7호선,철산,13609,13664,27273
<class,7호선,광명사거리,15425,15227,30652
<class,7호선,천왕,6296,5908,12204
<class,7호선,온수,5229,4954,10183
<class,7호선,까치울,5376,5352,10728
<class,7호선,부천종합운동장,3022,2745,5767
<class,7호선,춘의,4866,4539,9405
<class,7호선,신중동,8950,8808,17758
<class,7호선,부천시청,9004,8798,17802
<class,7호선,상동,9686,10139,19825
<class,7호선,삼산체육관,3471,3158,6629
<class,7호선,굴포천,6001,6303,12304
<class,7호선,부평구청,4656,4111,8767
<class,8호선,암사,11529,10544,22073
<class,8호선,천호,10806,12534,23340
<class,8호선,강동구청,5628,5653,11281
<class,8호선,몽촌토성,4414,4485,8899
<class,8호선,잠실,10859,12627,23486
<class,8호선,석촌,5379,6520,11899
<class,8호선,송파,4583,4742,9325
<class,8호선,가락시장,4364,4374,8738
<class,8호선,문정,7524,7531,15055
<class,8호선,장지,11458,10552,22010
<class,8호선,복정,6620,5832,12452
<class,8호선,산성,4162,4217,8379
<class,8호선,남한산성입구,8514,7572,16086
<class,8호선,단대오거리,6953,6374,13327
<class,8호선,신흥,3479,3619,7098
<class,8호선,수진,3880,3420,7300
<class,8호선,모란,3250,2854,6104
<class,9호선,개화,1462,1198,2660
<class,9호선,김포공항,6845,12880,19725
<class,9호선,공항시장,2139,2264,4403
<class,9호선,신방화,4300,4109,8409
<class,9호선,마곡나루,7284,7135,14419
<class,9호선,양천향교,5442,5204,10646
<class,9호선,가양,13112,12218,25330
<class,9호선,증미,3775,3552,7327
<class,9호선,등촌,7015,6734,13749
<class,9호선,염창,10885,9975,20860
<class,9호선,신목동,2220,1844,4064
<class,9호선,선유도,3923,3725,7648
<class,9호선,당산,11790,10985,22775
<class,9호선,국회의사당,3597,3750,7347
<class,9호선,여의도,10475,10030,20505
<class,9호선,샛강,2247,2356,4603
<class,9호선,노량진,20274,19652,39926
<class,9호선,노들,3334,2837,6171
<class,9호선,흑석,5108,5110,10218
<class,9호선,동작,1464,1216,2680
<class,9호선,구반포,1553,1633,3186
<class,9호선,신반포,2437,2338,4775
<class,9호선,고속터미널,11669,16708,28377
<class,9호선,사평,2025,1852,3877
<class,9호선,신논현,22811,22032,44843
<class,9호선2~3단계,언주,5401,5516,10917
<class,9호선2~3단계,선정릉,4519,4988,9507
<class,9호선2~3단계,삼성중앙,2730,2664,5394
<class,9호선2~3단계,봉은사,8765,9180,17945
<class,9호선2~3단계,종합운동장,2911,2621,5532
<class,9호선2~3단계,삼전,4566,4178,8744
<class,9호선2~3단계,석촌고분,3731,3617,7348
<class,9호선2~3단계,석촌,6251,5260,11511
<class,9호선2~3단계,송파나루,3558,3860,7418
<class,9호선2~3단계,한성백제,2077,1705,3782
<class,9호선2~3단계,올림픽공원,5912,6444,12356
<class,9호선2~3단계,둔촌오륜,620,626,1246
<class,9호선2~3단계,중앙보훈병원,4133,3891,8024
<class,경강선,판교,2722,2562,5284
<class,경강선,이매,901,647,1548
<class,경강선,삼동,1376,1290,2666
<class,경강선,경기광주,4682,4637,9319
<class,경강선,초월,2004,1894,3898
<class,경강선,곤지암,1729,1947,3676
<class,경강선,신둔도예촌,1089,1088,2177
<class,경강선,이천,2472,2703,5175
<class,경강선,부발,1733,1544,3277
<class,경강선,세종대왕릉,331,399,730
<class,경강선,여주,2120,2499,4619
<class,경부선,서울역,5621,1758,7379
<class,경부선,남영,5073,5693,10766
<class,경부선,용산,27946,31991,59937
<class,경부선,노량진,8208,7533,15741
<class,경부선,대방,7472,7388,14860
<class,경부선,영등포,33486,35194,68680
<class,경부선,신도림,2852,2867,5719
<class,경부선,신길,5910,5065,10975
<class,경부선,구로,12052,12347,24399
<class,경부선,가산디지털단지,5765,7902,13667
<class,경부선,금천구청,7895,7817,15712
<class,경부선,석수,6740,6193,12933
<class,경부선,관악,5425,5167,10592
<class,경부선,안양,16185,16295,32480
<class,경부선,명학,4825,4580,9405
<class,경부선,금정,17222,17287,34509
<class,경부선,군포,4070,3688,7758
<class,경부선,의왕,5811,5529,11340
<class,경부선,성균관대,9456,9494,18950
<class,경부선,화서,5098,5118,10216
<class,경부선,수원,33270,36149,69419
<class,경부선,독산,8456,8183,16639
<class,경부선,세류,2349,2342,4691
<class,경부선,병점,11408,11022,22430
<class,경부선,세마,2000,1743,3743
<class,경부선,오산대,2663,2447,5110
<class,경부선,오산,8477,8083,16560
<class,경부선,진위,992,868,1860
<class,경부선,송탄,4267,3879,8146
<class,경부선,서정리,6138,5259,11397
<class,경부선,평택지제,2843,2647,5490
<class,경부선,평택,12511,12038,24549
<class,경부선,성환,2982,2775,5757
<class,경부선,직산,639,617,1256
<class,경부선,두정,5509,5541,11050
<class,경부선,천안,6172,6666,12838
<class,경부선,당정,3864,3650,7514
<class,경부선,서동탄,930,1035,1965
<class,경부선,광명,2469,2365,4834
<class,경원선,이촌,3084,2076,5160
<class,경원선,서빙고,1381,1314,2695
<class,경원선,한남,2754,2574,5328
<class,경원선,옥수,33,26,59
<class,경원선,응봉,1382,1134,2516
<class,경원선,왕십리,11082,12613,23695
<class,경원선,청량리,14352,16014,30366
<class,경원선,외대앞,5784,5502,11286
<class,경원선,신이문,5794,5249,11043
<class,경원선,석계,6534,6889,13423
<class,경원선,광운대,5336,5124,10460
<class,경원선,월계,4345,4042,8387
<class,경원선,녹천,3252,2660,5912
<class,경원선,방학,7064,6861,13925
<class,경원선,도봉,4271,3990,8261
<class,경원선,도봉산,9050,6481,15531
<class,경원선,망월사,5302,5539,10841
<class,경원선,회룡,9197,9152,18349
<class,경원선,의정부,15451,16188,31639
<class,경원선,가능,4835,4615,9450
<class,경원선,녹양,3376,3324,6700
<class,경원선,양주,6614,6477,13091
<class,경원선,덕계,2304,2040,4344
<class,경원선,덕정,4118,3906,8024
<class,경원선,지행,5241,5151,10392
<class,경원선,동두천중앙,2427,2440,4867
<class,경원선,보산,1657,1535,3192
<class,경원선,동두천,1574,2254,3828
<class,경원선,소요산,4316,3629,7945
<class,경의선,서울역,1438,1726,3164
<class,경의선,신촌,848,771,1619
<class,경의선,효창공원앞,1621,1798,3419
<class,경의선,공덕,2333,1828,4161
<class,경의선,서강대,1694,1508,3202
<class,경의선,홍대입구,1703,1898,3601
<class,경의선,가좌,3766,3545,7311
<class,경의선,디지털미디어시티,1820,1611,3431
<class,경의선,수색,1269,1285,2554
<class,경의선,화전,1034,976,2010
<class,경의선,강매,1842,1771,3613
<class,경의선,행신,4882,5007,9889
<class,경의선,능곡,2745,2640,5385
<class,경의선,곡산,435,453,888
<class,경의선,백마,4260,4020,8280
<class,경의선,풍산,4135,3962,8097
<class,경의선,일산,5958,5546,11504
<class,경의선,탄현,5077,4969,10046
<class,경의선,야당,5358,5235,10593
<class,경의선,운정,4555,4174,8729
<class,경의선,금릉,3424,3344,6768
<class,경의선,금촌,5142,5071,10213
<class,경의선,월롱,1504,1361,2865
<class,경의선,파주,861,650,1511
<class,경의선,문산,4469,4392,8861
<class,경의선,임진강,92,78,170
<class,경인선,개봉,15637,15166,30803
<class,경인선,오류동,8668,7851,16519
<class,경인선,역곡,18832,18537,37369
<class,경인선,부천,26490,26909,53399
<class,경인선,송내,16613,16422,33035
<class,경인선,부평,26083,28445,54528
<class,경인선,백운,5190,5079,10269
<class,경인선,동암,11314,11673,22987
<class,경인선,주안,14096,12542,26638
<class,경인선,제물포,6733,6573,13306
<class,경인선,동인천,11094,11089,22183
<class,경인선,인천,4709,4037,8746
<class,경인선,구일,4093,3867,7960
<class,경인선,소사,6568,6595,13163
<class,경인선,부개,6018,5590,11608
<class,경인선,간석,3995,3959,7954
<class,경인선,도원,1922,2034,3956
<class,경인선,온수,4666,4245,8911
<class,경인선,중동,6378,6053,12431
<class,경인선,도화,3078,2785,5863
<class,경춘선,신내,1165,1113,2278
<class,경춘선,갈매,1875,1626,3501
<class,경춘선,별내,2355,2313,4668
<class,경춘선,퇴계원,2627,2436,5063
<class,경춘선,사릉,2157,2193,4350
<class,경춘선,금곡,1133,1115,2248
<class,경춘선,평내호평,4500,4272,8772
<class,경춘선,천마산,1335,1425,2760
<class,경춘선,마석,3076,3218,6294
<class,경춘선,대성리,681,768,1449
<class,경춘선,청평,1750,1966,3716
<class,경춘선,상천,473,432,905
<class,경춘선,가평,2454,2869,5323
<class,경춘선,굴봉산,246,254,500
<class,경춘선,백양리,135,145,280
<class,경춘선,강촌,793,911,1704
<class,경춘선,김유정,646,762,1408
<class,경춘선,춘천,2124,1973,4097
<class,공항철도 1호선,서울역,6331,7155,13486
<class,공항철도 1호선,공덕,1419,2016,3435
<class,공항철도 1호선,홍대입구,10582,10208,20790
<class,공항철도 1호선,디지털미디어시티,4820,4402,9222
<class,공항철도 1호선,마곡나루,3070,3228,6298
<class,공항철도 1호선,김포공항,10971,6300,17271
<class,공항철도 1호선,계양,6595,5986,12581
<class,공항철도 1호선,검암,4326,4512,8838
<class,공항철도 1호선,청라국제도시,3874,3791,7665
<class,공항철도 1호선,운서,5814,5868,11682
<class,공항철도 1호선,공항화물청사,1361,1357,2718
<class,공항철도 1호선,인천공항1터미널,3387,3383,6770
<class,공항철도 1호선,인천공항2터미널,1915,1722,3637
<class,공항철도 1호선,영종,2742,2936,5678
<class,과천선,선바위,4787,4342,9129
<class,과천선,경마공원,1160,1131,2291
<class,과천선,대공원,6385,6823,13208
<class,과천선,과천,4054,3578,7632
<class,과천선,정부과천청사,5575,5585,11160
<class,과천선,인덕원,14167,13948,28115
<class,과천선,평촌,8501,8257,16758
<class,과천선,범계,18182,17817,35999
<class,분당선,선릉,4658,7110,11768
<class,분당선,한티,11396,11357,22753
<class,분당선,도곡,4596,4042,8638
<class,분당선,구룡,1250,1072,2322
<class,분당선,개포동,2566,2500,5066
<class,분당선,대모산입구,3010,2714,5724
<class,분당선,수서,9382,9979,19361
<class,분당선,복정,2,0,2
<class,분당선,수원,6551,5743,12294
<class,분당선,서울숲,8950,9156,18106
<class,분당선,압구정로데오,16508,18763,35271
<class,분당선,강남구청,4811,6094,10905
<class,분당선,선정릉,3203,3320,6523
<class,분당선,가천대,4851,5215,10066
<class,분당선,태평,10145,9367,19512
<class,분당선,모란,14693,14772,29465
<class,분당선,야탑,15827,16687,32514
<class,분당선,서현,16267,16236,32503
<class,분당선,수내,8077,7647,15724
<class,분당선,정자,9771,10004,19775
<class,분당선,미금,9991,10526,20517
<class,분당선,오리,7207,6035,13242
<class,분당선,이매,4009,3908,7917
<class,분당선,보정,1431,1333,2764
<class,분당선,죽전,9783,10715,20498
<class,분당선,구성,3059,3142,6201
<class,분당선,신갈,2701,2670,5371
<class,분당선,기흥,6216,5922,12138
<class,분당선,상갈,3726,3674,7400
<class,분당선,청명,2526,2460,4986
<class,분당선,영통,6123,5995,12118
<class,분당선,망포,8445,7635,16080
<class,분당선,매탄권선,3149,2928,6077
<class,분당선,수원시청,9461,10270,19731
<class,분당선,매교,2005,2028,4033
<class,수인선,고색,2250,2255,4505
<class,수인선,오목천,1840,1637,3477
<class,수인선,어천,710,649,1359
<class,수인선,야목,231,222,453
<class,수인선,사리,3132,2721,5853
<class,수인선,달월,74,73,147
<class,수인선,월곶,1965,1946,3911
<class,수인선,소래포구,7565,7870,15435
<class,수인선,인천논현,4219,4288,8507
<class,수인선,호구포,2371,2314,4685
<class,수인선,남동인더스파크,979,898,1877
<class,수인선,원인재,3444,3565,7009
<class,수인선,연수,3513,3390,6903
<class,수인선,송도,2000,1930,3930
<class,수인선,인하대,3980,3701,7681
<class,수인선,숭의,2813,2531,5344
<class,수인선,신포,1364,1418,2782
<class,수인선,인천,1251,2019,3270
<class,안산선,산본,11689,12169,23858
<class,안산선,대야미,3876,3468,7344
<class,안산선,반월,3319,3121,6440
<class,안산선,상록수,11213,11315,22528
<class,일산선,화정,11847,12310,24157
<class,일산선,대곡,1371,1219,2590
<class,일산선,백석,6859,6854,13713
<class,일산선,마두,4954,4980,9934
<class,일산선,정발산,6168,6480,12648
<class,일산선,주엽,6393,6245,12638
<class,일산선,대화,8442,7583,16025
<class,장항선,봉명,648,615,1263
<class,장항선,쌍용,1441,1277,2718
<class,장항선,아산,2924,2965,5889
<class,장항선,배방,966,952,1918
<class,장항선,온양온천,3446,3516,6962
<class,장항선,신창,1352,1270,2622
<class,중앙선,회기,18141,16839,34980
<class,중앙선,중랑,4412,4131,8543
<class,중앙선,상봉,5085,4916,10001
<class,중앙선,망우,5915,5790,11705
<class,중앙선,양원,1305,1323,2628
<class,중앙선,구리,9850,9901,19751
<class,중앙선,도농,6321,6109,12430
<class,중앙선,양정,717,640,1357
<class,중앙선,덕소,4422,4503,8925
<class,중앙선,도심,1602,1389,2991
<class,중앙선,팔당,1569,1825,3394
<class,중앙선,운길산,1614,1738,3352
<class,중앙선,양수,2367,2395,4762
<class,중앙선,신원,384,291,675
<class,중앙선,국수,657,745,1402
<class,중앙선,아신,657,704,1361
<class,중앙선,오빈,325,348,673
<class,중앙선,양평,2621,3100,5721
<class,중앙선,원덕,405,478,883
<class,중앙선,용문,2324,2763,5087
<class,중앙선,지평,60,86,146
<class,일산선,원흥,6767,6304,13071
<class,우이신설선,신설동,1275,1227,2502
<class,우이신설선,보문,1049,1019,2068
<class,우이신설선,성신여대입구,2558,2944,5502
<class,우이신설선,정릉,3586,2842,6428
<class,우이신설선,북한산보국문,4755,4227,8982
<class,우이신설선,솔샘,3516,3184,6700
<class,우이신설선,삼양사거리,1810,1735,3545
<class,우이신설선,삼양,1477,1513,2990
<class,우이신설선,화계,2358,2150,4508
<class,우이신설선,가오리,2807,2635,5442
<class,우이신설선,4.19민주묘지,2264,2060,4324
<class,우이신설선,솔밭공원,1818,1677,3495
<class,우이신설선,북한산우이,3232,3385,6617
<class,안산선,수리산,2749,2590,5339
<class,안산선,오이도,7631,7970,15601
<class,안산선,정왕,5808,5937,11745
<class,안산선,신길온천,1327,1284,2611
<class,안산선,안산,8606,8893,17499
<class,안산선,초지,3036,3042,6078
<class,안산선,고잔,5711,5635,11346
<class,안산선,중앙,13932,14541,28473
<class,안산선,한대앞,6906,6715,13621
<class,일산선,원당,7928,7565,15493
<class,일산선,삼송,12742,12368,25110
<class,일산선,지축,1,0,1
<class,5호선,방화,4302,3989,8291
<class,2호선,을지로3가,9389,9235,18624
<class,수인선,월곶,1893,1706,3599
<class,수인선,달월,47,55,102
<class,수인선,사리,2518,2117,4635
<class,수인선,야목,164,169,333
<class,수인선,어천,508,575,1083
<class,수인선,오목천,1502,1386,2888
<class,수인선,고색,1599,1577,3176
<class,분당선,매교,1299,1375,2674
<class,분당선,수원시청,6760,7020,13780
<class,분당선,매탄권선,2385,2373,4758
<class,분당선,망포,5959,5684,11643
<class,분당선,영통,4433,4401,8834
<class,분당선,청명,1899,1837,3736
<class,분당선,상갈,2836,2854,5690
<class,분당선,기흥,4685,4580,9265
<class,분당선,신갈,1811,1884,3695
<class,경원선,보산,1163,1299,2462
<class,경원선,동두천,1419,1811,3230
<class,경원선,소요산,4857,4187,9044
<class,경의선,서울역,925,941,1866
<class,경의선,신촌,261,285,546
<class,경의선,효창공원앞,1233,1343,2576
<class,경의선,공덕,1664,1367,3031
<class,경의선,서강대,1254,1171,2425
<class,경의선,홍대입구,1454,1694,3148
<class,경의선,가좌,2859,2792,5651
<class,경의선,디지털미디어시티,1368,1227,2595
<class,경의선,수색,933,941,1874
<class,분당선,구성,2266,2446,4712
<class,분당선,죽전,7666,8420,16086
<class,분당선,보정,1001,956,1957
<class,분당선,이매,2893,2921,5814
<class,분당선,오리,4941,4241,9182
<class,분당선,미금,6467,6830,13297
<class,분당선,정자,6987,7202,14189
<class,분당선,수내,5334,5174,10508
<class,분당선,서현,11765,11958,23723
<class,5호선,오금,1510,1376,2886
<class,공항철도 1호선,검암,3507,3639,7146
<class,공항철도 1호선,청라국제도시,3087,2918,6005
<class,분당선,야탑,11458,11832,23290
<class,분당선,모란,10310,10506,20816
<class,분당선,태평,7586,6774,14360
<class,분당선,가천대,3575,4104,7679
<class,분당선,선정릉,2020,2082,4102
<class,분당선,강남구청,2936,3649,6585
<class,분당선,압구정로데오,10204,11678,21882
<class,분당선,서울숲,7649,8228,15877
<class,분당선,수원,5361,4637,9998
<class,분당선,수서,7085,6989,14074
<class,분당선,대모산입구,1875,1795,3670
<class,분당선,개포동,1562,1594,3156
<class,분당선,구룡,697,668,1365
<class,분당선,도곡,2364,2211,4575
<class,분당선,한티,7766,7374,15140
<class,분당선,선릉,2506,3755,6261
<class,과천선,범계,13715,13061,26776
<class,과천선,평촌,6018,5730,11748
<class,과천선,인덕원,10686,10552,21238
<class,과천선,정부과천청사,4116,4325,8441
<class,과천선,과천,3168,2895,6063
<class,과천선,대공원,6992,7187,14179
<class,과천선,경마공원,974,943,1917
<class,과천선,선바위,3654,3279,6933
<class,공항철도 1호선,영종,2378,2411,4789
<class,공항철도 1호선,인천공항2터미널,1676,1688,3364
<class,경원선,도봉산,9810,7204,17014
<class,공항철도 1호선,인천공항1터미널,3655,3622,7277
<class,공항철도 1호선,공항화물청사,1055,1121,2176
<class,1호선,서울역,22579,20775,43354
<class,1호선,동묘앞,12249,12387,24636
<class,1호선,시청,7295,7213,14508
<class,1호선,종각,11484,10121,21605
<class,1호선,종로3가,14455,12486,26941
<class,1호선,종로5가,8165,8441,16606
<class,1호선,동대문,8421,9063,17484
<class,1호선,신설동,6810,6701,13511
<class,1호선,제기동,8933,9104,18037
<class,1호선,청량리,12328,12248,24576
<class,2호선,시청,5607,4850,10457
<class,2호선,을지로입구,13897,13430,27327
<class,2호선,을지로3가,7250,6839,14089
<class,2호선,을지로4가,3042,3069,6111
<class,2호선,동대문역사문화공원,6763,8455,15218
<class,2호선,신당,7664,8213,15877
<class,2호선,상왕십리,6438,6235,12673
<class,2호선,왕십리,8582,7411,15993
<class,2호선,한양대,3021,3253,6274
<class,2호선,뚝섬,10729,11125,21854
<class,2호선,성수,12465,14438,26903
<class,2호선,건대입구,24060,25448,49508
<class,2호선,구의,10541,10360,20901
<class,2호선,강변,18561,18093,36654
<class,2호선,잠실나루,4769,4808,9577
<class,2호선,잠실,43771,41039,84810
<class,2호선,잠실새내,10011,10379,20390
<class,2호선,종합운동장,3331,3547,6878
<class,2호선,삼성,17700,17790,35490
<class,2호선,선릉,11844,10180,22024
<class,2호선,역삼,9751,10616,20367
<class,2호선,강남,31137,30519,61656
<class,2호선,교대,9242,10128,19370
<class,2호선,서초,8566,7832,16398
<class,2호선,방배,6151,6346,12497
<class,2호선,사당,19747,21945,41692
<class,2호선,낙성대,14970,14264,29234
<class,2호선,서울대입구,25883,26117,52000
<class,2호선,봉천,11259,10700,21959
<class,2호선,신림,34598,33214,67812
<class,2호선,신대방,13985,13749,27734
<class,2호선,구로디지털단지,21505,20876,42381
<class,2호선,대림,13244,13400,26644
<class,2호선,신도림,26085,25984,52069
<class,2호선,문래,7581,8179,15760
<class,2호선,영등포구청,7931,8149,16080
<class,2호선,당산,8645,9450,18095
<class,2호선,합정,19629,20971,40600
<class,2호선,홍대입구,43475,44586,88061
<class,2호선,신촌,21345,21139,42484
<class,2호선,이대,6324,6792,13116
<class,2호선,아현,4877,4701,9578
<class,2호선,충정로,3476,3581,7057
<class,2호선,용답,1568,1537,3105
<class,2호선,신답,715,745,1460
<class,2호선,신설동,2636,2710,5346
<class,2호선,도림천,417,429,846
<class,2호선,양천구청,3326,3375,6701
<class,2호선,신정네거리,4760,4826,9586
<class,2호선,용두,1084,1021,2105
<class,3호선,지축,2077,1972,4049
<class,3호선,구파발,11375,11463,22838
<class,3호선,연신내,20557,19189,39746
<class,3호선,불광,9579,11413,20992
<class,3호선,녹번,6888,6118,13006
<class,3호선,홍제,8693,8111,16804
<class,3호선,무악재,1794,1939,3733
<class,3호선,독립문,4079,4631,8710
<class,3호선,경복궁,12662,14291,26953
<class,3호선,안국,10123,11667,21790
<class,3호선,종로3가,3632,5387,9019
<class,3호선,을지로3가,2879,3037,5916
<class,3호선,동대입구,4914,5549,10463
<class,3호선,약수,6105,5884,11989
<class,3호선,금호,3969,3735,7704
<class,3호선,옥수,4931,5048,9979
<class,3호선,압구정,12187,12738,24925
<class,3호선,신사,12370,13099,25469
<class,3호선,잠원,2191,2034,4225
<class,3호선,고속터미널,33212,31115,64327
<class,3호선,교대,3792,2325,6117
<class,3호선,남부터미널,11429,11784,23213
<class,3호선,양재,12269,13506,25775
<class,3호선,매봉,3787,3780,7567
<class,3호선,도곡,1804,1897,3701
<class,3호선,대치,5397,4622,10019
<class,3호선,학여울,2774,2847,5621
<class,3호선,대청,3887,3621,7508
<class,3호선,일원,2846,2897,5743
<class,3호선,수서,8771,8678,17449
<class,3호선,가락시장,3386,3539,6925
<class,3호선,경찰병원,2485,2495,4980
<class,3호선,오금,2415,2247,4662
<class,4호선,수유,18803,17779,36582
<class,4호선,미아,7725,7437,15162
<class,4호선,미아사거리,14656,13571,28227
<class,4호선,길음,9339,8990,18329
<class,4호선,성신여대입구,13632,12826,26458
<class,4호선,한성대입구,7426,7428,14854
<class,4호선,혜화,19178,20019,39197
<class,4호선,동대문,6613,7154,13767
<class,4호선,동대문역사문화공원,8030,7944,15974
<class,4호선,충무로,8191,8250,16441
<class,4호선,명동,9901,10897,20798
<class,4호선,회현,7618,8449,16067
<class,4호선,서울역,3764,7793,11557
<class,4호선,숙대입구,5979,5670,11649
<class,4호선,삼각지,2223,2960,5183
<class,4호선,신용산,6571,6841,13412
<class,4호선,이촌,4206,4829,9035
<class,4호선,동작,1598,1596,3194
<class,4호선,총신대입구,9745,10557,20302
<class,4호선,사당,13677,12501,26178
<class,4호선,남태령,637,474,1111
<class,4호선,당고개,7361,6972,14333
<class,4호선,상계,9822,9267,19089
<class,4호선,노원,10927,11890,22817
<class,4호선,창동,13354,14074,27428
<class,4호선,쌍문,14720,13146,27866
<class,5호선,방화,3415,3373,6788
<class,5호선,개화산,2684,2787,5471
<class,5호선,김포공항,6028,5911,11939
<class,5호선,송정,3433,3434,6867
<class,5호선,마곡,3252,3300,6552
<class,5호선,발산,8262,8992,17254
<class,5호선,우장산,6158,6221,12379
<class,5호선,화곡,13498,12550,26048
<class,5호선,까치산,14616,14270,28886
<class,5호선,신정,6063,5316,11379
<class,5호선,목동,7226,7253,14479
<class,5호선,오목교,10537,10976,21513
<class,5호선,양평,2527,2380,4907
<class,5호선,영등포구청,1275,1259,2534
<class,5호선,영등포시장,4270,4408,8678
<class,5호선,신길,1854,1914,3768
<class,5호선,여의도,7298,7849,15147
<class,5호선,여의나루,13702,14646,28348
<class,5호선,마포,4453,4567,9020
<class,5호선,공덕,4176,4213,8389
<class,5호선,애오개,2436,2322,4758
<class,5호선,충정로,1332,1356,2688
<class,5호선,서대문,4710,4617,9327
<class,5호선,광화문,10579,10354,20933
<class,5호선,종로3가,8908,8460,17368
<class,5호선,을지로4가,1500,1593,3093
<class,5호선,동대문역사문화공원,601,791,1392
<class,5호선,청구,1717,1616,3333
<class,5호선,신금호,2752,3009,5761
<class,5호선,행당,3640,3214,6854
<class,5호선,왕십리,2426,2804,5230
<class,5호선,마장,2673,2581,5254
<class,5호선,답십리,6939,6299,13238
<class,5호선,장한평,7179,7033,14212
<class,5호선,군자,5712,6304,12016
<class,5호선,아차산,11101,10801,21902
<class,5호선,광나루,7574,7618,15192
<class,5호선,천호,11516,10972,22488
<class,5호선,강동,8172,7878,16050
<class,5호선,길동,3897,4007,7904
<class,5호선,굽은다리,4780,4367,9147
<class,5호선,명일,4126,4184,8310
<class,5호선,고덕,4159,4138,8297
<class,5호선,상일동,6656,6217,12873
<class,5호선,둔촌동,4068,4181,8249
<class,5호선,올림픽공원,2523,2628,5151
<class,5호선,방이,3428,3492,6920
<class,5호선,개롱,2802,2934,5736
<class,5호선,거여,3866,3589,7455
<class,5호선,마천,3282,3423,6705
<class,5호선,강일,1799,1762,3561
<class,5호선,미사,8227,8357,16584
<class,5호선,하남풍산,1958,1940,3898
<class,5호선,하남시청,3429,3203,6632
<class,5호선,하남검단산,4432,4472,8904
<class,6호선,응암,8940,8777,17717
<class,6호선,역촌,1913,2252,4165
<class,6호선,불광,2741,2591,5332
<class,6호선,독바위,1617,2104,3721
<class,6호선,구산,3727,2761,6488
<class,경인선,부천,20644,20787,41431
<class,경인선,역곡,13738,13507,27245
<class,경인선,오류동,6611,6125,12736
<class,경인선,개봉,11225,11105,22330
<class,경의선,임진강,93,72,165
<class,경인선,송내,12740,12351,25091
<class,경인선,부평,21055,22161,43216
<class,경인선,백운,3807,3795,7602
<class,경인선,동암,9104,8995,18099
<class,경인선,주안,10807,9805,20612
<class,경인선,제물포,5372,5156,10528
<class,경인선,동인천,9208,8887,18095
<class,경인선,인천,4726,4035,8761
<class,경인선,구일,3254,3107,6361
<class,경인선,소사,5101,5120,10221
<class,경인선,부개,4585,4271,8856
<class,경인선,간석,2983,2880,5863
<class,경인선,도원,1531,1560,3091
<class,경인선,온수,3544,3321,6865
<class,경인선,중동,4742,4536,9278
<class,경인선,도화,2228,2117,4345
<class,경춘선,신내,961,911,1872
<class,경춘선,갈매,1487,1268,2755
<class,경춘선,별내,1906,1779,3685
<class,경춘선,퇴계원,2136,1999,4135
<class,경춘선,사릉,1813,1795,3608
<class,경춘선,금곡,978,939,1917
<class,경춘선,평내호평,3611,3413,7024
<class,경춘선,천마산,1171,1228,2399
<class,경춘선,마석,2858,2971,5829
<class,경춘선,대성리,692,647,1339
<class,경춘선,청평,1837,1657,3494
<class,경춘선,상천,522,419,941
<class,경춘선,가평,2801,2612,5413
<class,경춘선,굴봉산,281,247,528
<class,경춘선,백양리,188,124,312
<class,경춘선,강촌,1058,991,2049
<class,경춘선,김유정,794,850,1644
<class,경춘선,남춘천,2426,2409,4835
<class,경춘선,춘천,2083,1791,3874
<class,경의선,문산,3496,3525,7021
<class,경의선,파주,698,595,1293
<class,경의선,월롱,915,1223,2138
<class,경의선,금촌,3944,4073,8017
<class,경의선,금릉,2739,2630,5369
<class,경의선,운정,3364,3317,6681
<class,경의선,야당,4242,4224,8466
<class,경의선,탄현,3979,3802,7781
<class,경의선,일산,5269,5145,10414
<class,경의선,풍산,3290,3222,6512
<class,경의선,백마,3403,3220,6623
<class,경의선,곡산,336,341,677
<class,경의선,능곡,2143,2159,4302
<class,경의선,행신,4064,3868,7932
<class,경의선,강매,1451,1382,2833
<class,경의선,화전,808,811,1619
<class,공항철도 1호선,서울역,6003,5368,11371
<class,공항철도 1호선,공덕,1141,1499,2640
<class,공항철도 1호선,홍대입구,9092,8909,18001
<class,공항철도 1호선,디지털미디어시티,3430,3426,6856
<class,공항철도 1호선,마곡나루,2348,2548,4896
<class,공항철도 1호선,김포공항,10176,5344,15520
<class,공항철도 1호선,계양,4898,4761,9659
<class,6호선,새절,6217,6012,12229
<class,6호선,증산,5389,5390,10779
<class,6호선,디지털미디어시티,4822,5010,9832
<class,6호선,월드컵경기장,6238,6563,12801
<class,6호선,마포구청,6919,6016,12935
<class,6호선,망원,9424,10367,19791
<class,6호선,합정,8972,8210,17182
<class,6호선,상수,5462,6514,11976
<class,6호선,광흥창,3617,3328,6945
<class,6호선,대흥,3627,3547,7174
<class,6호선,공덕,6475,6036,12511
<class,6호선,효창공원앞,3106,2738,5844
<class,6호선,삼각지,3653,2799,6452
<class,6호선,녹사평,4133,4183,8316
<class,6호선,이태원,9203,9224,18427
<class,6호선,한강진,5828,7054,12882
<class,6호선,버티고개,893,1030,1923
<class,6호선,약수,1580,1504,3084
<class,6호선,청구,1638,1496,3134
<class,6호선,신당,4073,4827,8900
<class,6호선,동묘앞,6168,6152,12320
<class,6호선,창신,1521,1275,2796
<class,6호선,보문,3710,3327,7037
<class,6호선,안암,4686,4779,9465
<class,6호선,고려대,3904,3673,7577
<class,6호선,월곡,5058,4930,9988
<class,6호선,상월곡,3020,2711,5731
<class,6호선,돌곶이,4251,3882,8133
<class,6호선,석계,6183,6347,12530
<class,6호선,태릉입구,2808,3154,5962
<class,6호선,화랑대,5075,4328,9403
<class,6호선,봉화산,3738,3777,7515
<class,6호선,신내,1,0,1
<class,7호선,장암,1497,1186,2683
<class,7호선,도봉산,5752,8467,14219
<class,7호선,수락산,8392,8365,16757
<class,7호선,마들,5669,5235,10904
<class,7호선,노원,10151,10456,20607
<class,7호선,중계,6449,5911,12360
<class,7호선,하계,8498,7810,16308
<class,7호선,공릉,6113,6296,12409
<class,7호선,태릉입구,4770,4484,9254
<class,7호선,먹골,5168,5031,10199
<class,7호선,중화,5370,5147,10517
<class,7호선,상봉,8917,8551,17468
<class,7호선,면목,7661,7588,15249
<class,7호선,사가정,8799,8485,17284
<class,7호선,용마산,3040,3442,6482
<class,7호선,중곡,4817,4503,9320
<class,7호선,군자,7244,5598,12842
<class,7호선,어린이대공원,8276,8237,16513
<class,7호선,건대입구,7256,7374,14630
<class,7호선,뚝섬유원지,10482,9509,19991
<class,7호선,청담,6134,6396,12530
<class,7호선,강남구청,5449,6037,11486
<class,7호선,학동,4970,5259,10229
<class,7호선,논현,5927,6343,12270
<class,7호선,반포,2688,2725,5413
<class,7호선,고속터미널,9160,6490,15650
<class,7호선,내방,4712,4753,9465
<class,7호선,이수,7730,7452,15182
<class,7호선,남성,5097,4811,9908
<class,7호선,숭실대입구,5290,5562,10852
<class,7호선,상도,4933,4655,9588
<class,7호선,장승배기,4589,4416,9005
<class,7호선,신대방삼거리,7311,6989,14300
<class,7호선,보라매,4437,4412,8849
<class,7호선,신풍,5524,5245,10769
<class,7호선,대림,5898,5574,11472
<class,7호선,남구로,6021,5806,11827
<class,7호선,가산디지털단지,9839,8969,18808
<class,7호선,철산,9684,9706,19390
<class,7호선,광명사거리,11455,11166,22621
<class,7호선,천왕,4714,4413,9127
<class,7호선,온수,3618,3666,7284
<class,7호선,까치울,4107,4146,8253
<class,7호선,부천종합운동장,2376,2107,4483
<class,7호선,춘의,3281,3074,6355
<class,7호선,신중동,6281,6329,12610
<class,7호선,부천시청,6664,6508,13172
<class,7호선,상동,6693,6686,13379
<class,7호선,삼산체육관,2494,2284,4778
<class,7호선,굴포천,4421,4623,9044
<class,중앙선,지평,46,63,109
<class,7호선,부평구청,3517,3062,6579
<class,8호선,암사,8153,7637,15790
<class,8호선,천호,8048,9366,17414
<class,8호선,강동구청,4003,4081,8084
<class,8호선,몽촌토성,3765,3599,7364
<class,8호선,잠실,8887,10023,18910
<class,8호선,석촌,3688,4751,8439
<class,8호선,송파,3187,3273,6460
<class,8호선,가락시장,2585,3325,5910
<class,8호선,문정,5091,5339,10430
<class,8호선,장지,8366,8076,16442
<class,8호선,복정,4535,4156,8691
<class,8호선,산성,3380,3423,6803
<class,8호선,남한산성입구,6458,6007,12465
<class,8호선,단대오거리,5214,4909,10123
<class,8호선,신흥,2410,2517,4927
<class,8호선,수진,2679,2341,5020
<class,8호선,모란,2442,2065,4507
<class,9호선,개화,1152,1090,2242
<class,9호선,김포공항,6479,10464,16943
<class,9호선,공항시장,1651,1741,3392
<class,9호선,신방화,3293,3147,6440
<class,9호선,마곡나루,5616,5664,11280
<class,9호선,양천향교,3927,4024,7951
<class,9호선,가양,9324,9122,18446
<class,9호선,증미,2836,2772,5608
<class,9호선,등촌,5072,4956,10028
<class,9호선,염창,7931,7666,15597
<class,9호선,신목동,1605,1441,3046
<class,9호선,선유도,2961,2913,5874
<class,9호선,당산,8364,7903,16267
<class,9호선,국회의사당,3575,3550,7125
<class,9호선,여의도,8145,7656,15801
<class,9호선,샛강,1558,1528,3086
<class,9호선,노량진,14314,14684,28998
<class,9호선,노들,2675,2350,5025
<class,9호선,흑석,3652,3714,7366
<class,9호선,동작,1183,964,2147
<class,9호선,구반포,1056,1184,2240
<class,9호선,신반포,1554,1603,3157
<class,9호선,고속터미널,8869,12115,20984
<class,9호선,사평,1277,1283,2560
<class,9호선,신논현,14338,13618,27956
<class,9호선2~3단계,언주,3361,3461,6822
<class,9호선2~3단계,선정릉,2819,3181,6000
<class,9호선2~3단계,삼성중앙,1791,1836,3627
<class,9호선2~3단계,봉은사,6754,6805,13559
<class,9호선2~3단계,종합운동장,1857,1659,3516
<class,9호선2~3단계,삼전,3287,3000,6287
<class,9호선2~3단계,석촌고분,2783,2739,5522
<class,9호선2~3단계,석촌,4355,3694,8049
<class,9호선2~3단계,송파나루,2787,3091,5878
<class,9호선2~3단계,한성백제,1688,1406,3094
<class,9호선2~3단계,올림픽공원,4021,4703,8724
<class,9호선2~3단계,둔촌오륜,369,408,777
<class,9호선2~3단계,중앙보훈병원,3084,2964,6048
<class,경강선,판교,2250,2112,4362
<class,경강선,이매,694,511,1205
<class,경강선,삼동,968,937,1905
<class,경강선,경기광주,3537,3548,7085
<class,경강선,초월,1547,1455,3002
<class,경강선,곤지암,1460,1674,3134
<class,경강선,신둔도예촌,820,809,1629
<class,경강선,이천,1914,2073,3987
<class,경강선,부발,1145,1352,2497
<class,경강선,세종대왕릉,364,352,716
<class,경강선,여주,2002,1988,3990
<class,경부선,서울역,4954,1210,6164
<class,경부선,남영,3768,4033,7801
<class,경부선,용산,25239,23511,48750
<class,경부선,노량진,5865,5665,11530
<class,경부선,대방,5248,5437,10685
<class,경부선,영등포,27222,26897,54119
<class,경부선,신도림,2122,2262,4384
<class,경부선,신길,4616,3962,8578
<class,경부선,구로,8614,8697,17311
<class,경부선,가산디지털단지,4458,6039,10497
<class,경부선,금천구청,6066,5851,11917
<class,경부선,석수,5235,4909,10144
<class,경부선,관악,4670,4248,8918
<class,경부선,안양,12699,12372,25071
<class,경부선,명학,3226,3206,6432
<class,경부선,금정,13098,13231,26329
<class,경부선,군포,2697,2574,5271
<class,경부선,의왕,4115,4102,8217
<class,경부선,성균관대,7056,7482,14538
<class,경부선,화서,3786,3756,7542
<class,경부선,수원,29372,29407,58779
<class,경부선,독산,6103,5933,12036
<class,경부선,세류,1918,1963,3881
<class,경부선,병점,8705,8970,17675
<class,경부선,세마,1655,1498,3153
<class,경부선,오산대,2171,2054,4225
<class,경부선,오산,7307,7508,14815
<class,경부선,진위,711,699,1410
<class,경부선,송탄,3367,3552,6919
<class,경부선,서정리,3903,4921,8824
<class,경부선,평택지제,2042,1966,4008
<class,경부선,평택,9914,10541,20455
<class,경부선,성환,2201,2399,4600
<class,경부선,직산,506,538,1044
<class,경부선,두정,4555,4824,9379
<class,경부선,천안,5736,5592,11328
<class,경부선,당정,2897,2783,5680
<class,경부선,서동탄,794,809,1603
<class,경부선,광명,1922,1548,3470
<class,경원선,이촌,2438,1699,4137
<class,경원선,서빙고,1131,1132,2263
<class,경원선,한남,1964,1967,3931
<class,경원선,옥수,50,35,85
<class,경원선,응봉,1134,960,2094
<class,경원선,왕십리,8397,9632,18029
<class,경원선,청량리,12832,12650,25482
<class,경원선,외대앞,4473,4408,8881
<class,경원선,신이문,4408,4170,8578
<class,경원선,석계,4907,5205,10112
<class,경원선,광운대,4117,4101,8218
<class,경원선,월계,3644,3440,7084
<class,경원선,녹천,2444,2053,4497
<class,경원선,방학,5669,5363,11032
<class,경원선,도봉,3457,3276,6733
<class,경원선,망월사,4243,4432,8675
<class,경원선,회룡,7059,7058,14117
<class,경원선,의정부,12921,13311,26232
<class,경원선,가능,3908,3722,7630
<class,경원선,녹양,2561,2474,5035
<class,경원선,양주,5638,5581,11219
<class,공항철도 1호선,운서,4875,5193,10068
<class,경원선,덕계,1634,1572,3206
<class,경원선,덕정,3152,3242,6394
<class,경원선,지행,3932,4036,7968
<class,경원선,동두천중앙,1971,1886,3857
<class,중앙선,용문,2578,2316,4894
<class,중앙선,원덕,448,409,857
<class,중앙선,양평,4501,4188,8689
<class,중앙선,오빈,277,281,558
<class,중앙선,아신,607,577,1184
<class,중앙선,국수,700,686,1386
<class,중앙선,신원,479,347,826
<class,중앙선,양수,2339,2264,4603
<class,중앙선,운길산,2053,1940,3993
<class,중앙선,팔당,1776,1958,3734
<class,중앙선,도심,1241,1195,2436
<class,중앙선,덕소,3642,3603,7245
<class,중앙선,양정,594,529,1123
<class,중앙선,도농,5054,4999,10053
<class,중앙선,구리,7530,7753,15283
<class,중앙선,양원,990,1010,2000
<class,중앙선,망우,4733,4759,9492
<class,중앙선,상봉,4134,4036,8170
<class,중앙선,중랑,3324,3266,6590
<class,중앙선,회기,14145,13896,28041
<class,장항선,신창,1046,1207,2253
<class,장항선,온양온천,2923,2858,5781
<class,장항선,배방,806,857,1663
<class,장항선,아산,2425,1997,4422
<class,장항선,쌍용,984,994,1978
<class,장항선,봉명,479,510,989
<class,일산선,대화,6294,5910,12204
<class,일산선,주엽,4336,4344,8680
<class,일산선,정발산,5250,5382,10632
<class,일산선,마두,3246,3208,6454
<class,일산선,백석,5120,4952,10072
<class,일산선,대곡,1019,862,1881
<class,일산선,화정,8914,9044,17958
<class,일산선,원당,5884,5734,11618
<class,일산선,삼송,10006,9789,19795
<class,일산선,원흥,5137,4926,10063
<class,우이신설선,신설동,1106,1116,2222
<class,우이신설선,보문,835,826,1661
<class,우이신설선,성신여대입구,2033,2446,4479
<class,우이신설선,정릉,2544,2174,4718
<class,우이신설선,북한산보국문,3588,3323,6911
<class,우이신설선,솔샘,2593,2347,4940
<class,우이신설선,삼양사거리,1551,1417,2968
<class,우이신설선,삼양,1171,1209,2380
<class,우이신설선,화계,1831,1757,3588
<class,우이신설선,가오리,2270,2054,4324
<class,우이신설선,4.19민주묘지,1985,1689,3674
<class,우이신설선,솔밭공원,1397,1301,2698
<class,우이신설선,북한산우이,3674,3779,7453
<class,안산선,수리산,2150,2195,4345
<class,안산선,오이도,6711,6762,13473
<class,안산선,정왕,4810,4879,9689
<class,안산선,신길온천,1086,1101,2187
<class,안산선,안산,8679,8127,16806
<class,안산선,초지,2248,2217,4465
<class,안산선,고잔,4308,4170,8478
<class,안산선,중앙,10789,10945,21734
<class,안산선,한대앞,5269,5222,10491
<class,안산선,상록수,8682,8416,17098
<class,안산선,반월,2374,2433,4807
<class,안산선,대야미,2986,2704,5690
<class,안산선,산본,8195,8850,17045
<class,수인선,인천,1260,1900,3160
<class,수인선,신포,1257,1231,2488
<class,수인선,숭의,2025,1931,3956
<class,수인선,인하대,3177,3043,6220
<class,수인선,송도,1543,1480,3023
<class,수인선,연수,2795,2872,5667
<class,수인선,원인재,2907,2931,5838
<class,수인선,남동인더스파크,588,533,1121
<class,수인선,호구포,1903,1837,3740
<class,수인선,인천논현,3002,3094,6096
<class,수인선,소래포구,7909,7831,15740
<class,경원선,창동,1,0,1
<class,경원선,동두천,1480,1943,3423
<class,3호선,대치,7807,6830,14637
<class,1호선,서울역,29541,32178,61719
<class,1호선,동묘앞,10903,11375,22278
<class,1호선,시청,9707,10111,19818
<class,1호선,종각,15451,14224,29675
<class,1호선,종로3가,20835,19163,39998
<class,1호선,종로5가,16603,17132,33735
<class,1호선,동대문,9819,9278,19097
<class,1호선,신설동,8232,7724,15956
<class,1호선,제기동,13835,14130,27965
<class,1호선,청량리,17068,16888,33956
<class,2호선,시청,7803,6913,14716
<class,2호선,을지로입구,17363,17184,34547
<class,2호선,을지로3가,8791,8921,17712
<class,2호선,을지로4가,6031,6369,12400
<class,2호선,동대문역사문화공원,9011,9808,18819
<class,2호선,신당,9855,10160,20015
<class,2호선,상왕십리,8426,7827,16253
<class,2호선,왕십리,11468,9510,20978
<class,2호선,한양대,3866,3915,7781
<class,2호선,뚝섬,12366,12916,25282
<class,2호선,성수,15748,18121,33869
<class,2호선,건대입구,30016,31386,61402
<class,2호선,구의,13814,13324,27138
<class,2호선,강변,23398,26230,49628
<class,2호선,잠실나루,6906,6734,13640
<class,2호선,잠실,56248,53641,109889
<class,2호선,잠실새내,13685,14134,27819
<class,2호선,종합운동장,4116,4558,8674
<class,2호선,삼성,23002,23408,46410
<class,2호선,선릉,19295,16911,36206
<class,2호선,역삼,14701,16366,31067
<class,2호선,강남,45442,45107,90549
<class,2호선,교대,13548,15471,29019
<class,2호선,서초,8368,6949,15317
<class,2호선,방배,8000,8216,16216
<class,2호선,사당,24756,27383,52139
<class,2호선,낙성대,18625,16866,35491
<class,2호선,서울대입구,32361,30871,63232
<class,2호선,봉천,15037,13521,28558
<class,2호선,신림,43711,41075,84786
<class,2호선,신대방,18145,17143,35288
<class,2호선,구로디지털단지,28904,28013,56917
<class,2호선,대림,15580,16481,32061
<class,2호선,신도림,35502,35873,71375
<class,2호선,문래,10159,10723,20882
<class,2호선,영등포구청,11134,11786,22920
<class,2호선,당산,11304,12090,23394
<class,2호선,합정,24398,26547,50945
<class,2호선,홍대입구,55233,58820,114053
<class,2호선,신촌,23483,23588,47071
<class,2호선,이대,8356,8496,16852
<class,2호선,아현,6416,5977,12393
<class,2호선,충정로,4584,4855,9439
<class,2호선,용답,1988,1828,3816
<class,2호선,신답,881,933,1814
<class,2호선,신설동,2698,2632,5330
<class,2호선,도림천,671,679,1350
<class,2호선,양천구청,4138,4055,8193
<class,2호선,신정네거리,6280,6179,12459
<class,2호선,용두,1475,1495,2970
<class,3호선,지축,2720,2634,5354
<class,3호선,구파발,14783,14494,29277
<class,3호선,연신내,25692,23745,49437
<class,3호선,불광,11522,12909,24431
<class,3호선,녹번,9022,7726,16748
<class,3호선,홍제,11550,10696,22246
<class,3호선,무악재,2419,2508,4927
<class,3호선,독립문,4906,5333,10239
<class,3호선,경복궁,14789,16441,31230
<class,3호선,안국,13295,15260,28555
<class,3호선,종로3가,5230,7591,12821
<class,3호선,을지로3가,4275,4603,8878
<class,3호선,동대입구,5599,6082,11681
<class,3호선,약수,7512,7079,14591
<class,3호선,금호,5150,4552,9702
<class,3호선,옥수,6214,6313,12527
<class,3호선,압구정,17565,18525,36090
<class,3호선,신사,19418,20482,39900
<class,3호선,잠원,3342,3210,6552
<class,3호선,고속터미널,41222,46100,87322
<class,3호선,교대,5577,3312,8889
<class,3호선,남부터미널,18098,19548,37646
<class,3호선,양재,17838,19447,37285
<class,3호선,매봉,5193,4924,10117
<class,3호선,도곡,2837,2855,5692
<class,3호선,학여울,1803,2008,3811
<class,3호선,대청,5150,4628,9778
<class,3호선,일원,4607,4472,9079
<class,3호선,수서,11522,11904,23426
<class,3호선,가락시장,5163,4805,9968
<class,3호선,경찰병원,3211,3197,6408
<class,3호선,오금,3217,3066,6283
<class,4호선,수유,22786,21532,44318
<class,4호선,미아,9158,8438,17596
<class,4호선,미아사거리,18614,17487,36101
<class,4호선,길음,12373,11388,23761
<class,4호선,성신여대입구,15102,13974,29076
<class,4호선,한성대입구,9444,8977,18421
<class,4호선,혜화,23283,24010,47293
<class,4호선,동대문,13462,13803,27265
<class,4호선,동대문역사문화공원,9619,8350,17969
<class,4호선,충무로,11185,11853,23038
<class,4호선,명동,12129,14087,26216
<class,4호선,회현,15829,17417,33246
<class,4호선,서울역,4840,12149,16989
<class,4호선,숙대입구,7362,7053,14415
<class,4호선,삼각지,2983,3958,6941
<class,4호선,신용산,8420,9456,17876
<class,4호선,이촌,5665,6301,11966
<class,4호선,동작,1784,1818,3602
<class,4호선,총신대입구,13301,14319,27620
<class,4호선,사당,17542,15119,32661
<class,4호선,남태령,928,661,1589
<class,4호선,당고개,8823,8484,17307
<class,4호선,상계,12131,11152,23283
<class,4호선,노원,13596,14622,28218
<class,4호선,창동,16652,17201,33853
<class,4호선,쌍문,18503,16477,34980
<class,5호선,방화,4025,3759,7784
<class,5호선,개화산,3286,3269,6555
<class,5호선,김포공항,7226,7281,14507
<class,5호선,송정,4536,4325,8861
<class,5호선,마곡,4577,4557,9134
<class,5호선,발산,11538,12101,23639
<class,5호선,우장산,8057,7953,16010
<class,5호선,화곡,17245,15523,32768
<class,5호선,까치산,18665,17523,36188
<class,5호선,신정,7627,6500,14127
<class,5호선,목동,9402,9367,18769
<class,5호선,오목교,13742,14240,27982
<class,5호선,양평,3154,2987,6141
<class,5호선,영등포구청,1744,1658,3402
<class,5호선,영등포시장,6160,6338,12498
<class,5호선,신길,2256,2231,4487
<class,5호선,여의도,9408,10551,19959
<class,5호선,여의나루,13366,14433,27799
<class,5호선,마포,6202,6238,12440
<class,5호선,공덕,5673,5906,11579
<class,5호선,애오개,3064,2832,5896
<class,5호선,충정로,1661,1543,3204
<class,5호선,서대문,5725,5579,11304
<class,5호선,광화문,12116,12489,24605
<class,5호선,종로3가,10999,11417,22416
<class,5호선,을지로4가,2949,3142,6091
<class,5호선,동대문역사문화공원,830,1093,1923
<class,5호선,청구,2098,2008,4106
<class,5호선,신금호,3539,3571,7110
<class,5호선,행당,5286,4592,9878
<class,5호선,왕십리,3045,3610,6655
<class,5호선,마장,3288,3087,6375
<class,5호선,답십리,8877,7771,16648
<class,5호선,장한평,9659,9362,19021
<class,5호선,군자,7430,7922,15352
<class,5호선,아차산,11397,10967,22364
<class,5호선,광나루,9510,9040,18550
<class,5호선,천호,14338,13736,28074
<class,5호선,강동,10801,10296,21097
<class,5호선,길동,4879,5008,9887
<class,5호선,굽은다리,6131,5527,11658
<class,5호선,명일,5368,5274,10642
<class,5호선,고덕,5735,5556,11291
<class,5호선,상일동,8333,7641,15974
<class,5호선,둔촌동,5400,5343,10743
<class,5호선,올림픽공원,3008,3045,6053
<class,5호선,방이,4372,4246,8618
<class,5호선,오금,1892,1746,3638
<class,5호선,개롱,3645,3847,7492
<class,5호선,거여,5109,4901,10010
<class,5호선,마천,4113,4109,8222
<class,5호선,강일,2338,2087,4425
<class,5호선,미사,10426,10475,20901
<class,5호선,하남풍산,2385,2504,4889
<class,5호선,하남시청,4750,4544,9294
<class,5호선,하남검단산,4877,4933,9810
<class,6호선,응암,11169,10830,21999
<class,6호선,역촌,2359,2752,5111
<class,6호선,불광,3298,3124,6422
<class,6호선,독바위,1753,2094,3847
<class,6호선,구산,5053,3705,8758
<class,6호선,새절,8241,7695,15936
<class,6호선,증산,6624,6489,13113
<class,6호선,디지털미디어시티,6506,6383,12889
<class,6호선,월드컵경기장,5800,6095,11895
<class,6호선,마포구청,8178,7231,15409
<class,6호선,망원,11621,12595,24216
<class,6호선,합정,11297,10211,21508
<class,6호선,상수,7491,8768,16259
<class,6호선,광흥창,4564,3977,8541
<class,6호선,대흥,4455,4425,8880
<class,6호선,공덕,8537,8024,16561
<class,6호선,효창공원앞,3847,3285,7132
<class,6호선,삼각지,4611,3674,8285
<class,6호선,녹사평,4918,5096,10014
<class,6호선,이태원,11452,12131,23583
<class,6호선,한강진,8251,10026,18277
<class,6호선,버티고개,1140,1233,2373
<class,6호선,약수,1917,1857,3774
<class,6호선,청구,2076,1992,4068
<class,6호선,신당,5437,4619,10056
<class,6호선,동묘앞,7398,6914,14312
<class,6호선,창신,1887,1538,3425
<class,6호선,보문,4415,3785,8200
<class,6호선,안암,5777,5452,11229
<class,6호선,고려대,4783,4388,9171
<class,6호선,월곡,6404,6222,12626
<class,6호선,상월곡,3587,3089,6676
<class,6호선,돌곶이,5268,4769,10037
<class,6호선,석계,7618,7520,15138
<class,6호선,태릉입구,3751,3964,7715
<class,6호선,화랑대,6157,5097,11254
<class,6호선,봉화산,4659,4553,9212
<class,7호선,장암,1467,1113,2580
<class,7호선,도봉산,6037,8437,14474
<class,7호선,수락산,9086,8722,17808
<class,7호선,마들,7964,7379,15343
<class,7호선,노원,12661,13129,25790
<class,7호선,중계,8022,7064,15086
<class,7호선,하계,10443,9464,19907
<class,7호선,공릉,7574,7303,14877
<class,7호선,태릉입구,5619,5130,10749
<class,7호선,먹골,6967,6719,13686
<class,7호선,중화,6735,6208,12943
<class,7호선,상봉,11350,10827,22177
<class,7호선,면목,9841,9257,19098
<class,7호선,사가정,10636,10144,20780
<class,7호선,용마산,3813,3895,7708
<class,7호선,중곡,5991,5537,11528
<class,7호선,군자,8988,6809,15797
<class,7호선,어린이대공원,8702,8312,17014
<class,7호선,건대입구,9159,9593,18752
<class,7호선,뚝섬유원지,9707,8988,18695
<class,7호선,청담,9185,9736,18921
<class,7호선,강남구청,8423,9362,17785
<class,7호선,학동,8078,8559,16637
<class,7호선,논현,8594,9211,17805
<class,7호선,반포,3623,3428,7051
<class,7호선,고속터미널,11955,10292,22247
<class,7호선,내방,6531,6410,12941
<class,7호선,이수,10469,9622,20091
<class,7호선,남성,6526,5797,12323
<class,7호선,숭실대입구,7408,7225,14633
<class,7호선,상도,6184,5733,11917
<class,7호선,장승배기,5591,5323,10914
<class,7호선,신대방삼거리,9572,8764,18336
<class,7호선,보라매,5330,4999,10329
<class,7호선,신풍,7077,6570,13647
<class,7호선,대림,6226,6558,12784
<class,7호선,남구로,7207,7292,14499
<class,7호선,가산디지털단지,13239,11949,25188
<class,7호선,철산,12615,12741,25356
<class,7호선,광명사거리,14639,14245,28884
<class,7호선,천왕,5808,5455,11263
<class,7호선,온수,4728,4616,9344
<class,7호선,까치울,4971,5030,10001
<class,7호선,부천종합운동장,2822,2578,5400
<class,7호선,춘의,4382,4150,8532
<class,7호선,신중동,8225,7922,16147
<class,7호선,부천시청,8181,8037,16218
<class,7호선,상동,8911,9215,18126
<class,7호선,삼산체육관,3263,2969,6232
<class,7호선,굴포천,5809,5921,11730
<class,7호선,부평구청,4337,3767,8104
<class,8호선,암사,11082,9989,21071
<class,8호선,천호,10178,11726,21904
<class,8호선,강동구청,5159,5254,10413
<class,8호선,몽촌토성,4384,4262,8646
<class,8호선,잠실,10833,12741,23574
<class,8호선,석촌,4891,5964,10855
<class,8호선,송파,4581,4492,9073
<class,8호선,가락시장,4344,4385,8729
<class,8호선,문정,7746,7693,15439
<class,8호선,장지,10755,10010,20765
<class,8호선,복정,6528,5631,12159
<class,8호선,산성,4204,4120,8324
<class,8호선,남한산성입구,8043,7090,15133
<class,8호선,단대오거리,6806,6123,12929
<class,8호선,신흥,3154,3366,6520
<class,8호선,수진,3507,3058,6565
<class,8호선,모란,4561,4026,8587
<class,9호선,개화,1484,1253,2737
<class,9호선,김포공항,7541,13036,20577
<class,9호선,공항시장,2040,2075,4115
<class,9호선,신방화,4132,3837,7969
<class,9호선,마곡나루,7341,7381,14722
<class,9호선,양천향교,5156,4861,10017
<class,9호선,가양,12000,11132,23132
<class,9호선,증미,3560,3399,6959
<class,9호선,등촌,6319,5969,12288
<class,9호선,염창,10503,9322,19825
<class,9호선,신목동,2282,1915,4197
<class,9호선,선유도,3604,3423,7027
<class,9호선,당산,10963,10222,21185
<class,9호선,국회의사당,3528,3725,7253
<class,9호선,여의도,10359,10143,20502
<class,9호선,샛강,2113,2239,4352
<class,9호선,노량진,19222,18703,37925
<class,9호선,노들,3140,2601,5741
<class,9호선,흑석,4506,4437,8943
<class,9호선,동작,1348,1165,2513
<class,9호선,구반포,1640,1790,3430
<class,9호선,신반포,2005,1923,3928
<class,9호선,고속터미널,11202,17452,28654
<class,9호선,사평,1723,1593,3316
<class,9호선,신논현,19896,19049,38945
<class,9호선2~3단계,언주,4776,5002,9778
<class,9호선2~3단계,선정릉,4056,4590,8646
<class,9호선2~3단계,삼성중앙,2474,2520,4994
<class,9호선2~3단계,봉은사,8685,9214,17899
<class,9호선2~3단계,종합운동장,2948,2539,5487
<class,9호선2~3단계,삼전,4246,3874,8120
<class,9호선2~3단계,석촌고분,3506,3383,6889
<class,9호선2~3단계,석촌,5832,4849,10681
<class,9호선2~3단계,송파나루,3573,3955,7528
<class,9호선2~3단계,한성백제,1979,1707,3686
<class,9호선2~3단계,올림픽공원,5816,6259,12075
<class,9호선2~3단계,둔촌오륜,581,573,1154
<class,9호선2~3단계,중앙보훈병원,3921,3710,7631
<class,경강선,판교,2710,2639,5349
<class,경강선,이매,886,611,1497
<class,경강선,삼동,1437,1259,2696
<class,경강선,경기광주,4681,4677,9358
<class,경강선,초월,2013,1911,3924
<class,경강선,곤지암,1876,2027,3903
<class,경강선,신둔도예촌,1044,1071,2115
<class,경강선,이천,2451,2525,4976
<class,경강선,부발,1689,1518,3207
<class,경강선,세종대왕릉,354,483,837
<class,경강선,여주,2350,2699,5049
<class,경부선,서울역,6291,2052,8343
<class,경부선,남영,4966,5034,10000
<class,경부선,용산,29688,33515,63203
<class,경부선,노량진,8402,7454,15856
<class,경부선,대방,7287,7071,14358
<class,경부선,영등포,33235,34507,67742
<class,경부선,신도림,2890,3020,5910
<class,경부선,신길,5622,4620,10242
<class,경부선,구로,11494,11889,23383
<class,경부선,가산디지털단지,5934,7668,13602
<class,경부선,금천구청,7539,7289,14828
<class,경부선,석수,6440,5906,12346
<class,경부선,관악,5460,5116,10576
<class,경부선,안양,16988,16843,33831
<class,경부선,명학,5213,4909,10122
<class,경부선,금정,16656,16404,33060
<class,경부선,군포,3975,3596,7571
<class,경부선,의왕,5513,5304,10817
<class,경부선,성균관대,9321,9239,18560
<class,경부선,화서,5018,4991,10009
<class,경부선,수원,34064,37159,71223
<class,경부선,독산,8162,7840,16002
<class,경부선,세류,2457,2457,4914
<class,경부선,병점,11335,11092,22427
<class,경부선,세마,2031,1793,3824
<class,경부선,오산대,2739,2507,5246
<class,경부선,오산,8619,8063,16682
<class,경부선,진위,948,861,1809
<class,경부선,송탄,4535,3837,8372
<class,경부선,서정리,5916,5154,11070
<class,경부선,평택지제,2830,2747,5577
<class,경부선,평택,12948,12359,25307
<class,경부선,성환,2852,2680,5532
<class,경부선,직산,649,628,1277
<class,경부선,두정,5506,5642,11148
<class,경부선,천안,6569,7167,13736
<class,경부선,당정,3646,3490,7136
<class,경부선,서동탄,1073,1074,2147
<class,경부선,광명,2621,2629,5250
<class,경원선,이촌,2723,1924,4647
<class,경원선,서빙고,1349,1196,2545
<class,경원선,한남,2557,2289,4846
<class,경원선,옥수,49,41,90
<class,경원선,응봉,1472,1122,2594
<class,경원선,왕십리,10773,12324,23097
<class,경원선,청량리,14988,16421,31409
<class,경원선,외대앞,5075,4826,9901
<class,경원선,신이문,5662,5083,10745
<class,경원선,석계,6191,6448,12639
<class,경원선,광운대,5063,4809,9872
<class,경원선,월계,4159,3844,8003
<class,경원선,녹천,3002,2522,5524
<class,경원선,방학,6641,6385,13026
<class,경원선,도봉,4205,3860,8065
<class,경원선,도봉산,8515,6023,14538
<class,경원선,망월사,4894,5087,9981
<class,경원선,회룡,8692,8552,17244
<class,경원선,의정부,15251,16000,31251
<class,경원선,가능,4609,4428,9037
<class,경원선,녹양,3128,3077,6205
<class,경원선,양주,6301,6066,12367
<class,경원선,덕계,2203,2066,4269
<class,경원선,덕정,3833,3652,7485
<class,경원선,지행,4741,4906,9647
<class,경원선,동두천중앙,2226,2246,4472
<class,경원선,보산,1825,1577,3402
<class,경원선,소요산,4054,3632,7686
<class,경의선,서울역,1232,1500,2732
<class,경의선,신촌,313,322,635
<class,경의선,효창공원앞,1547,1710,3257
<class,경의선,공덕,2453,1869,4322
<class,경의선,서강대,1602,1483,3085
<class,경의선,홍대입구,1858,2155,4013
<class,경의선,가좌,3639,3195,6834
<class,경의선,디지털미디어시티,1870,1603,3473
<class,경의선,수색,1272,1233,2505
<class,경의선,화전,1074,972,2046
<class,경의선,강매,1809,1672,3481
<class,경의선,행신,4973,4961,9934
<class,경의선,능곡,2737,2501,5238
<class,경의선,곡산,426,423,849
<class,경의선,백마,4076,3798,7874
<class,경의선,풍산,4055,3902,7957
<class,경의선,일산,5762,5349,11111
<class,경의선,탄현,4921,4618,9539
<class,경의선,야당,5284,5298,10582
<class,경의선,운정,4632,4304,8936
<class,경의선,금릉,3315,3190,6505
<class,경의선,금촌,5031,4863,9894
<class,경의선,월롱,1385,1292,2677
<class,경의선,파주,840,668,1508
<class,경의선,문산,4563,4488,9051
<class,경의선,임진강,78,64,142
<class,경인선,개봉,14901,14392,29293
<class,경인선,오류동,8004,7057,15061
<class,경인선,역곡,17751,17298,35049
<class,경인선,부천,25208,25784,50992
<class,경인선,송내,16086,15670,31756
<class,경인선,부평,25593,27805,53398
<class,경인선,백운,4971,4887,9858
<class,경인선,동암,11279,11587,22866
<class,경인선,주안,13830,12397,26227
<class,경인선,제물포,6568,6367,12935
<class,경인선,동인천,10755,10706,21461
<class,경인선,인천,4822,4210,9032
<class,경인선,구일,3894,3535,7429
<class,경인선,소사,6754,6645,13399
<class,경인선,부개,5819,5476,11295
<class,경인선,간석,3781,3631,7412
<class,경인선,도원,1737,1800,3537
<class,경인선,온수,4463,3998,8461
<class,경인선,중동,5984,5525,11509
<class,경인선,도화,2763,2528,5291
<class,경춘선,신내,1117,1089,2206
<class,경춘선,갈매,1808,1596,3404
<class,경춘선,별내,2229,2171,4400
<class,경춘선,퇴계원,2505,2261,4766
<class,경춘선,사릉,2139,2051,4190
<class,경춘선,금곡,1095,1044,2139
<class,경춘선,평내호평,4288,4050,8338
<class,경춘선,천마산,1322,1363,2685
<class,경춘선,마석,2997,2911,5908
<class,경춘선,대성리,693,694,1387
<class,경춘선,청평,1688,1978,3666
<class,경춘선,상천,375,343,718
<class,경춘선,가평,2692,3270,5962
<class,경춘선,굴봉산,226,191,417
<class,경춘선,백양리,132,131,263
<class,경춘선,강촌,847,921,1768
<class,경춘선,김유정,687,869,1556
<class,경춘선,남춘천,2772,3311,6083
<class,경춘선,춘천,2125,2147,4272
<class,공항철도 1호선,서울역,6880,7954,14834
<class,공항철도 1호선,공덕,1433,2064,3497
<class,공항철도 1호선,홍대입구,10884,10688,21572
<class,공항철도 1호선,디지털미디어시티,5007,4722,9729
<class,공항철도 1호선,마곡나루,3044,3197,6241
<class,공항철도 1호선,김포공항,12069,6257,18326
<class,공항철도 1호선,계양,6355,5712,12067
<class,공항철도 1호선,검암,4410,4385,8795
<class,공항철도 1호선,청라국제도시,3889,3699,7588
<class,공항철도 1호선,운서,5590,5834,11424
<class,공항철도 1호선,공항화물청사,1326,1347,2673
<class,공항철도 1호선,인천공항1터미널,3454,3498,6952
<class,공항철도 1호선,인천공항2터미널,1850,1638,3488
<class,공항철도 1호선,영종,2841,2939,5780
<class,과천선,선바위,4590,3991,8581
<class,과천선,경마공원,1055,1068,2123
<class,과천선,대공원,7037,7475,14512
<class,과천선,과천,3778,3382,7160
<class,과천선,정부과천청사,5200,5332,10532
<class,과천선,인덕원,13783,13535,27318
<class,과천선,평촌,7815,7568,15383
<class,과천선,범계,17172,16667,33839
<class,분당선,선릉,4131,6362,10493
<class,분당선,한티,10076,9558,19634
<class,분당선,도곡,3639,3252,6891
<class,분당선,구룡,1241,1129,2370
<class,분당선,개포동,2427,2307,4734
<class,분당선,대모산입구,2881,2684,5565
<class,분당선,수서,9149,9683,18832
<class,분당선,수원,6714,5773,12487
<class,분당선,서울숲,8290,8397,16687
<class,분당선,압구정로데오,15223,17554,32777
<class,분당선,강남구청,4413,5363,9776
<class,분당선,선정릉,2868,2971,5839
<class,분당선,가천대,5121,5365,10486
<class,분당선,태평,9621,8892,18513
<class,분당선,모란,19583,19917,39500
<class,분당선,야탑,15155,16113,31268
<class,분당선,서현,15393,14848,30241
<class,분당선,수내,7473,7006,14479
<class,분당선,정자,9128,9329,18457
<class,분당선,미금,9246,9461,18707
<class,분당선,오리,7119,5843,12962
<class,분당선,이매,3750,3648,7398
<class,분당선,보정,1471,1276,2747
<class,분당선,죽전,9586,10374,19960
<class,분당선,구성,3009,3192,6201
<class,분당선,신갈,2495,2539,5034
<class,분당선,기흥,6044,5735,11779
<class,분당선,상갈,3641,3678,7319
<class,분당선,청명,2506,2395,4901
<class,분당선,영통,5490,5392,10882
<class,분당선,망포,8251,7392,15643
<class,분당선,매탄권선,3091,2904,5995
<class,분당선,수원시청,8795,9709,18504
<class,분당선,매교,1788,1868,3656
<class,수인선,고색,2255,2248,4503
<class,수인선,오목천,1957,1724,3681
<class,수인선,어천,666,573,1239
<class,수인선,야목,231,191,422
<class,수인선,사리,3075,2593,5668
<class,수인선,달월,73,70,143
<class,수인선,월곶,1923,1893,3816
<class,수인선,소래포구,8372,8785,17157
<class,수인선,인천논현,3652,3691,7343
<class,수인선,호구포,2192,2139,4331
<class,수인선,남동인더스파크,940,876,1816
<class,수인선,원인재,3469,3615,7084
<class,수인선,연수,3340,3372,6712
<class,수인선,송도,1762,1803,3565
<class,수인선,인하대,3836,3603,7439
<class,수인선,숭의,2471,2268,4739
<class,수인선,신포,1373,1409,2782
<class,수인선,인천,1329,2298,3627
<class,안산선,산본,10714,11350,22064
<class,안산선,대야미,3544,3184,6728
<class,안산선,반월,3094,2921,6015
<class,안산선,상록수,11111,10960,22071
<class,안산선,한대앞,6518,6403,12921
<class,안산선,중앙,13531,14146,27677
<class,안산선,고잔,5576,5627,11203
<class,안산선,초지,2970,3036,6006
<class,안산선,안산,8692,9066,17758
<class,안산선,신길온천,1252,1248,2500
<class,안산선,정왕,5698,5723,11421
<class,안산선,오이도,7620,8040,15660
<class,안산선,수리산,2685,2366,5051
<class,우이신설선,북한산우이,3354,3317,6671
<class,우이신설선,솔밭공원,1710,1556,3266
<class,우이신설선,4.19민주묘지,2657,2243,4900
<class,우이신설선,가오리,2727,2570,5297
<class,우이신설선,화계,2333,2149,4482
<class,우이신설선,삼양,1376,1477,2853
<class,우이신설선,삼양사거리,1773,1684,3457
<class,우이신설선,솔샘,3242,2877,6119
<class,우이신설선,북한산보국문,4213,3749,7962
<class,우이신설선,정릉,3158,2553,5711
<class,우이신설선,성신여대입구,2295,2680,4975
<class,우이신설선,보문,965,884,1849
<class,우이신설선,신설동,1284,1199,2483
<class,일산선,원흥,6337,6079,12416
<class,일산선,삼송,12551,12110,24661
<class,일산선,원당,7578,7205,14783
<class,일산선,화정,11338,11720,23058
<class,일산선,대곡,1336,1103,2439
<class,일산선,백석,6482,6625,13107
<class,일산선,마두,4412,4447,8859
<class,일산선,정발산,5952,6050,12002
<class,일산선,주엽,5802,5546,11348
<class,일산선,대화,8217,7516,15733
<class,장항선,봉명,630,624,1254
<class,장항선,쌍용,1586,1436,3022
<class,장항선,아산,2893,3067,5960
<class,장항선,배방,998,1017,2015
<class,장항선,온양온천,5071,5284,10355
<class,장항선,신창,1236,1198,2434
<class,중앙선,회기,17999,17092,35091
<class,중앙선,중랑,4101,3796,7897
<class,중앙선,상봉,4823,4526,9349
<class,중앙선,망우,5715,5570,11285
<class,중앙선,양원,1231,1154,2385
<class,중앙선,구리,9639,9574,19213
<class,중앙선,도농,6281,6080,12361
<class,중앙선,양정,716,612,1328
<class,중앙선,덕소,4211,4346,8557
<class,중앙선,도심,1453,1316,2769
<class,중앙선,팔당,1582,1651,3233
<class,중앙선,운길산,1635,1603,3238
<class,중앙선,양수,2374,2621,4995
<class,중앙선,신원,367,242,609
<class,중앙선,국수,709,748,1457
<class,중앙선,아신,669,670,1339
<class,중앙선,오빈,300,348,648
<class,중앙선,양평,2572,3125,5697
<class,중앙선,원덕,410,447,857
<class,중앙선,용문,2307,2905,5212
<class,중앙선,지평,65,92,157
<class,5호선,길동,3560,3729,7289
<class,중앙선,지평,45,55,100
<class,중앙선,용문,4201,3901,8102
<class,중앙선,원덕,374,338,712
<class,중앙선,양평,2231,1970,4201
<class,중앙선,오빈,242,204,446
<class,중앙선,아신,525,554,1079
<class,중앙선,국수,551,499,1050
<class,중앙선,신원,291,215,506
<class,중앙선,양수,1889,1748,3637
<class,중앙선,운길산,1322,1243,2565
<class,중앙선,팔당,1284,1311,2595
<class,중앙선,도심,1174,1134,2308
<class,중앙선,덕소,3081,3174,6255
<class,중앙선,양정,544,464,1008
<class,중앙선,도농,4476,4484,8960
<class,중앙선,구리,6773,7161,13934
<class,중앙선,양원,746,830,1576
<class,중앙선,망우,4070,3987,8057
<class,중앙선,상봉,3688,3699,7387
<class,중앙선,중랑,3116,2988,6104
<class,중앙선,회기,13493,13568,27061
<class,장항선,신창,916,1081,1997
<class,장항선,온양온천,2920,2791,5711
<class,장항선,배방,775,733,1508
<class,장항선,아산,2558,1941,4499
<class,장항선,쌍용,995,1032,2027
<class,장항선,봉명,479,485,964
<class,일산선,대화,6003,5549,11552
<class,일산선,주엽,3912,3936,7848
<class,일산선,정발산,3968,4122,8090
<class,일산선,마두,2936,2920,5856
<class,일산선,백석,4867,4813,9680
<class,일산선,대곡,908,759,1667
<class,일산선,화정,8087,8369,16456
<class,일산선,원당,5274,4771,10045
<class,일산선,삼송,9094,8998,18092
<class,일산선,원흥,4568,4408,8976
<class,우이신설선,신설동,872,805,1677
<class,우이신설선,보문,753,733,1486
<class,우이신설선,성신여대입구,1854,2106,3960
<class,우이신설선,정릉,2188,1923,4111
<class,우이신설선,북한산보국문,3068,2823,5891
<class,우이신설선,솔샘,2317,2195,4512
<class,우이신설선,삼양사거리,1318,1248,2566
<class,우이신설선,삼양,958,987,1945
<class,우이신설선,화계,1629,1543,3172
<class,우이신설선,가오리,2030,1915,3945
<class,우이신설선,4.19민주묘지,1666,1459,3125
<class,우이신설선,솔밭공원,1170,1128,2298
<class,우이신설선,북한산우이,2353,2481,4834
<class,안산선,수리산,1945,1861,3806
<class,안산선,오이도,5668,5633,11301
<class,안산선,정왕,4467,4707,9174
<class,안산선,신길온천,940,920,1860
<class,안산선,안산,8192,7431,15623
<class,안산선,초지,2111,2114,4225
<class,안산선,고잔,4276,4405,8681
<class,안산선,중앙,10080,10236,20316
<class,안산선,한대앞,4818,4823,9641
<class,안산선,상록수,8336,8332,16668
<class,안산선,반월,2291,2366,4657
<class,안산선,대야미,2560,2381,4941
<class,안산선,산본,7528,7997,15525
<class,수인선,인천,944,1560,2504
<class,수인선,신포,1005,956,1961
<class,수인선,숭의,1780,1623,3403
<class,수인선,인하대,2756,2664,5420
<class,수인선,송도,1367,1264,2631
<class,수인선,연수,2521,2455,4976
<class,수인선,원인재,2555,2669,5224
<class,수인선,남동인더스파크,593,556,1149
<class,수인선,호구포,1734,1723,3457
<class,수인선,인천논현,2572,2678,5250
<class,수인선,소래포구,6362,6495,12857
<class,수인선,월곶,1483,1488,2971
<class,수인선,달월,28,41,69
<class,수인선,사리,2301,2020,4321
<class,수인선,야목,183,161,344
<class,수인선,어천,521,593,1114
<class,수인선,오목천,1360,1250,2610
<class,수인선,고색,1601,1630,3231
<class,분당선,매교,1200,1266,2466
<class,분당선,수원시청,6476,6824,13300
<class,분당선,매탄권선,2324,2213,4537
<class,분당선,망포,5549,5558,11107
<class,분당선,영통,4045,4046,8091
<class,분당선,청명,1689,1640,3329
<class,분당선,상갈,2616,2702,5318
<class,분당선,기흥,4531,4164,8695
<class,분당선,신갈,1714,1790,3504
<class,분당선,구성,2176,2294,4470
<class,분당선,죽전,7135,7873,15008
<class,분당선,보정,1013,944,1957
<class,분당선,이매,2747,2825,5572
<class,분당선,오리,4755,4044,8799
<class,분당선,미금,6319,6540,12859
<class,분당선,정자,6622,6771,13393
<class,분당선,수내,5376,5234,10610
<class,분당선,서현,11735,10528,22263
<class,분당선,야탑,11251,11611,22862
<class,분당선,모란,9647,9975,19622
<class,분당선,태평,7171,6581,13752
<class,분당선,가천대,3527,4023,7550
<class,분당선,선정릉,1952,2048,4000
<class,분당선,강남구청,2880,3514,6394
<class,분당선,압구정로데오,9804,10816,20620
<class,분당선,서울숲,4963,5131,10094
<class,분당선,수원,4959,4262,9221
<class,분당선,수서,7271,7047,14318
<class,분당선,대모산입구,1849,1761,3610
<class,분당선,개포동,1753,1789,3542
<class,분당선,구룡,652,595,1247
<class,분당선,도곡,2112,2012,4124
<class,분당선,한티,7666,7373,15039
<class,분당선,선릉,2568,3765,6333
<class,과천선,범계,13025,12649,25674
<class,과천선,평촌,5703,5578,11281
<class,과천선,인덕원,10010,10073,20083
<class,과천선,정부과천청사,3558,3713,7271
<class,과천선,과천,2767,2622,5389
<class,과천선,대공원,3927,3986,7913
<class,과천선,경마공원,828,786,1614
<class,과천선,선바위,3106,2796,5902
<class,공항철도 1호선,영종,2197,2251,4448
<class,공항철도 1호선,인천공항2터미널,1625,1522,3147
<class,공항철도 1호선,인천공항1터미널,3283,3234,6517
<class,공항철도 1호선,공항화물청사,953,1002,1955
<class,공항철도 1호선,운서,4467,4725,9192
<class,공항철도 1호선,청라국제도시,2742,2748,5490
<class,공항철도 1호선,검암,3165,3177,6342
<class,공항철도 1호선,계양,4494,4406,8900
<class,공항철도 1호선,김포공항,11102,5763,16865
<class,공항철도 1호선,마곡나루,1943,2151,4094
<class,공항철도 1호선,디지털미디어시티,3202,3198,6400
<class,공항철도 1호선,홍대입구,8735,8440,17175
<class,공항철도 1호선,공덕,992,1488,2480
<class,공항철도 1호선,서울역,6476,5742,12218
<class,경춘선,춘천,1880,1482,3362
<class,경춘선,남춘천,2359,2499,4858
<class,경춘선,김유정,600,674,1274
<class,경춘선,강촌,764,650,1414
<class,경춘선,백양리,127,80,207
<class,경춘선,굴봉산,200,178,378
<class,경춘선,가평,2084,1761,3845
<class,경춘선,상천,329,254,583
<class,경춘선,청평,1468,1333,2801
<class,경춘선,대성리,574,497,1071
<class,경춘선,마석,2410,2380,4790
<class,경춘선,천마산,970,903,1873
<class,경춘선,평내호평,2937,2905,5842
<class,경춘선,금곡,781,785,1566
<class,경춘선,사릉,1560,1558,3118
<class,경춘선,퇴계원,1733,1596,3329
<class,경춘선,별내,1725,1640,3365
<class,경춘선,갈매,1293,1139,2432
<class,경춘선,신내,804,842,1646
<class,경인선,도화,2082,1982,4064
<class,경인선,중동,4224,4066,8290
<class,경인선,온수,3183,3001,6184
<class,경인선,도원,1336,1378,2714
<class,경인선,간석,2757,2742,5499
<class,경인선,부개,4043,3943,7986
<class,경인선,소사,4906,4767,9673
<class,경인선,구일,2674,2682,5356
<class,경인선,인천,3288,2586,5874
<class,경인선,동인천,8226,8018,16244
<class,경인선,제물포,4710,4702,9412
<class,경인선,주안,10360,9329,19689
<class,경인선,동암,8399,8553,16952
<class,경인선,백운,3484,3478,6962
<class,경인선,부평,19973,20589,40562
<class,경인선,송내,11470,11220,22690
<class,경인선,부천,18652,18362,37014
<class,경인선,역곡,12568,12458,25026
<class,경인선,오류동,6042,5739,11781
<class,경인선,개봉,10160,10390,20550
<class,경의선,임진강,51,49,100
<class,경의선,문산,2967,2984,5951
<class,경의선,파주,528,459,987
<class,경의선,월롱,718,992,1710
<class,경의선,금촌,3406,3753,7159
<class,경의선,금릉,2282,2280,4562
<class,경의선,운정,3011,2963,5974
<class,경의선,야당,3679,3631,7310
<class,경의선,탄현,3545,3494,7039
<class,경의선,일산,4003,3770,7773
<class,경의선,풍산,3047,2878,5925
<class,경의선,백마,2838,2833,5671
<class,경의선,곡산,267,265,532
<class,경의선,능곡,1874,1880,3754
<class,경의선,행신,3898,3581,7479
<class,경의선,강매,1226,1192,2418
<class,경의선,화전,716,764,1480
<class,경의선,수색,730,787,1517
<class,경의선,디지털미디어시티,1210,1187,2397
<class,경의선,가좌,2432,2422,4854
<class,경의선,홍대입구,1469,1712,3181
<class,경의선,서강대,1019,1010,2029
<class,경의선,공덕,1688,1384,3072
<class,경의선,효창공원앞,1178,1335,2513
<class,경의선,신촌,242,228,470
<class,경의선,서울역,919,932,1851
<class,경원선,소요산,3258,2802,6060
<class,경원선,동두천,1155,1430,2585
<class,경원선,보산,1232,1221,2453
<class,경원선,동두천중앙,1833,1830,3663
<class,경원선,지행,3538,3462,7000
<class,경원선,덕정,2733,2826,5559
<class,경원선,덕계,1450,1410,2860
<class,경원선,양주,4662,4616,9278
<class,경원선,녹양,2244,2240,4484
<class,경원선,가능,3560,3379,6939
<class,경원선,의정부,11568,12043,23611
<class,경원선,회룡,6169,6204,12373
<class,경원선,망월사,3806,3918,7724
<class,경원선,도봉산,6491,4628,11119
<class,경원선,도봉,3065,2881,5946
<class,경원선,방학,4925,4889,9814
<class,경원선,녹천,2159,1885,4044
<class,경원선,월계,2979,2670,5649
<class,경원선,광운대,3566,3636,7202
<class,경원선,석계,4348,4595,8943
<class,경원선,신이문,4039,3796,7835
<class,경원선,외대앞,4045,4044,8089
<class,경원선,청량리,12514,12065,24579
<class,경원선,왕십리,7801,9002,16803
<class,경원선,응봉,880,830,1710
<class,경원선,옥수,65,42,107
<class,경원선,한남,1660,1683,3343
<class,경원선,서빙고,921,914,1835
<class,경원선,이촌,1788,1483,3271
<class,경부선,광명,2163,1674,3837
<class,경부선,서동탄,646,719,1365
<class,경부선,당정,2662,2671,5333
<class,경부선,천안,5589,5414,11003
<class,경부선,두정,4561,4589,9150
<class,경부선,직산,545,525,1070
<class,경부선,성환,2089,2363,4452
<class,경부선,평택,10187,10348,20535
<class,경부선,평택지제,2039,1924,3963
<class,경부선,서정리,3954,4810,8764
<class,경부선,송탄,3284,3549,6833
<class,경부선,진위,683,656,1339
<class,경부선,오산,6722,7048,13770
<class,경부선,오산대,1941,1847,3788
<class,경부선,세마,1454,1366,2820
<class,경부선,병점,8366,8702,17068
<class,경부선,세류,1815,1838,3653
<class,경부선,독산,5640,5592,11232
<class,경부선,수원,29184,28768,57952
<class,경부선,화서,3601,3622,7223
<class,경부선,성균관대,6714,6845,13559
<class,경부선,의왕,3812,3799,7611
<class,경부선,군포,2667,2422,5089
<class,경부선,금정,12338,12630,24968
<class,경부선,명학,3188,3170,6358
<class,경부선,안양,13082,12836,25918
<class,경부선,관악,4012,3812,7824
<class,경부선,석수,4639,4336,8975
<class,경부선,금천구청,5476,5393,10869
<class,경부선,가산디지털단지,4095,5746,9841
<class,경부선,구로,8744,8690,17434
<class,경부선,신길,4375,3716,8091
<class,경부선,신도림,1857,2011,3868
<class,경부선,영등포,27887,27309,55196
<class,경부선,대방,4892,5141,10033
<class,경부선,노량진,5346,5170,10516
<class,경부선,용산,27501,24761,52262
<class,경부선,남영,4062,4210,8272
<class,경부선,서울역,5905,1329,7234
<class,경강선,여주,2050,2040,4090
<class,경강선,세종대왕릉,259,288,547
<class,경강선,부발,1179,1338,2517
<class,경강선,이천,1890,2087,3977
<class,경강선,신둔도예촌,818,829,1647
<class,경강선,곤지암,1451,1634,3085
<class,경강선,초월,1356,1361,2717
<class,경강선,경기광주,3369,3296,6665
<class,경강선,삼동,955,874,1829
<class,경강선,이매,638,434,1072
<class,경강선,판교,2250,2125,4375
<class,9호선2~3단계,중앙보훈병원,2920,2942,5862
<class,9호선2~3단계,둔촌오륜,396,397,793
<class,9호선2~3단계,올림픽공원,5319,5491,10810
<class,9호선2~3단계,한성백제,1383,1200,2583
<class,9호선2~3단계,송파나루,2863,2966,5829
<class,9호선2~3단계,석촌,4108,3464,7572
<class,9호선2~3단계,석촌고분,2583,2645,5228
<class,9호선2~3단계,삼전,3057,3068,6125
<class,9호선2~3단계,종합운동장,1856,1668,3524
<class,9호선2~3단계,봉은사,7555,7674,15229
<class,9호선2~3단계,삼성중앙,1763,1906,3669
<class,9호선2~3단계,선정릉,2760,3201,5961
<class,9호선2~3단계,언주,3551,3609,7160
<class,9호선,신논현,13958,13330,27288
<class,9호선,사평,1271,1247,2518
<class,9호선,고속터미널,8321,11633,19954
<class,9호선,신반포,1327,1355,2682
<class,9호선,구반포,930,985,1915
<class,9호선,동작,944,800,1744
<class,9호선,흑석,3342,3487,6829
<class,9호선,노들,2151,1892,4043
<class,9호선,노량진,13260,13764,27024
<class,9호선,샛강,1448,1554,3002
<class,9호선,여의도,9163,7722,16885
<class,9호선,국회의사당,3376,3530,6906
<class,9호선,당산,7854,7614,15468
<class,9호선,선유도,2548,2562,5110
<class,9호선,신목동,1497,1352,2849
<class,9호선,염창,7508,7319,14827
<class,9호선,등촌,4585,4634,9219
<class,9호선,증미,2221,2259,4480
<class,9호선,가양,8551,8262,16813
<class,9호선,양천향교,3795,3754,7549
<class,9호선,마곡나루,5217,5141,10358
<class,9호선,신방화,2918,2968,5886
<class,9호선,공항시장,1522,1693,3215
<class,9호선,김포공항,6773,11495,18268
<class,9호선,개화,1091,968,2059
<class,8호선,모란,2228,1865,4093
<class,8호선,수진,2657,2396,5053
<class,8호선,신흥,2426,2620,5046
<class,8호선,단대오거리,4692,4488,9180
<class,8호선,남한산성입구,5897,5424,11321
<class,8호선,산성,2978,2966,5944
<class,8호선,복정,4407,3970,8377
<class,8호선,장지,7942,7761,15703
<class,8호선,가락시장,2610,3207,5817
<class,8호선,송파,2987,3207,6194
<class,8호선,석촌,3613,4506,8119
<class,8호선,잠실,9166,10251,19417
<class,8호선,몽촌토성,2950,3002,5952
<class,8호선,강동구청,3825,3952,7777
<class,8호선,천호,7756,9082,16838
<class,8호선,암사,7808,7332,15140
<class,7호선,부평구청,3080,2798,5878
<class,7호선,굴포천,4001,4064,8065
<class,7호선,삼산체육관,2127,2063,4190
<class,7호선,상동,6221,6075,12296
<class,7호선,부천시청,5925,5743,11668
<class,7호선,신중동,5983,5977,11960
<class,7호선,춘의,3197,3031,6228
<class,7호선,부천종합운동장,2072,1823,3895
<class,7호선,까치울,3615,3666,7281
<class,7호선,온수,3354,3401,6755
<class,7호선,천왕,4233,4088,8321
<class,7호선,광명사거리,10593,10373,20966
<class,7호선,철산,8989,8964,17953
<class,7호선,가산디지털단지,9378,8273,17651
<class,7호선,남구로,5734,5752,11486
<class,7호선,대림,6181,5759,11940
<class,7호선,신풍,5429,5245,10674
<class,7호선,보라매,4187,4009,8196
<class,7호선,신대방삼거리,7193,6995,14188
<class,7호선,장승배기,4122,4140,8262
<class,7호선,상도,4680,4536,9216
<class,7호선,숭실대입구,4829,5135,9964
<class,7호선,남성,4588,4537,9125
<class,7호선,이수,7376,7015,14391
<class,7호선,내방,4430,4519,8949
<class,7호선,고속터미널,10241,6853,17094
<class,7호선,반포,2359,2300,4659
<class,7호선,논현,5497,5951,11448
<class,7호선,학동,5184,5506,10690
<class,7호선,강남구청,5168,5842,11010
<class,7호선,청담,5913,6360,12273
<class,7호선,뚝섬유원지,4406,4206,8612
<class,7호선,건대입구,6707,6785,13492
<class,7호선,어린이대공원,6976,6683,13659
<class,7호선,군자,6754,5281,12035
<class,7호선,중곡,4403,4303,8706
<class,7호선,용마산,2702,2912,5614
<class,7호선,사가정,7695,7569,15264
<class,7호선,면목,6878,6952,13830
<class,7호선,상봉,7914,7301,15215
<class,7호선,중화,4903,4757,9660
<class,7호선,먹골,4943,4873,9816
<class,7호선,태릉입구,4226,3891,8117
<class,7호선,공릉,5452,5625,11077
<class,7호선,하계,7717,7305,15022
<class,7호선,중계,5610,5341,10951
<class,7호선,노원,9496,9603,19099
<class,7호선,마들,5109,4839,9948
<class,7호선,수락산,6852,6849,13701
<class,7호선,도봉산,4400,6217,10617
<class,7호선,장암,1123,757,1880
<class,6호선,봉화산,3333,3340,6673
<class,6호선,화랑대,4529,3873,8402
<class,6호선,태릉입구,2752,2894,5646
<class,6호선,석계,5647,5768,11415
<class,6호선,돌곶이,3905,3730,7635
<class,6호선,상월곡,2742,2508,5250
<class,6호선,월곡,4638,4458,9096
<class,6호선,고려대,3517,3361,6878
<class,6호선,안암,4334,4497,8831
<class,6호선,보문,3445,3109,6554
<class,6호선,창신,1374,1300,2674
<class,6호선,동묘앞,4850,4622,9472
<class,6호선,신당,3868,4417,8285
<class,6호선,청구,1570,1479,3049
<class,6호선,약수,1439,1467,2906
<class,6호선,버티고개,775,917,1692
<class,6호선,한강진,5442,6447,11889
<class,6호선,이태원,8795,8572,17367
<class,6호선,녹사평,3538,3667,7205
<class,6호선,삼각지,3371,2651,6022
<class,6호선,효창공원앞,2859,2570,5429
<class,6호선,공덕,6007,5602,11609
<class,6호선,대흥,3235,3313,6548
<class,6호선,광흥창,3501,3364,6865
<class,6호선,상수,6653,7117,13770
<class,6호선,합정,8477,7720,16197
<class,6호선,망원,8319,9142,17461
<class,6호선,마포구청,6292,5581,11873
<class,6호선,월드컵경기장,2848,2988,5836
<class,6호선,디지털미디어시티,4347,4546,8893
<class,6호선,증산,4708,4849,9557
<class,6호선,새절,5510,5348,10858
<class,6호선,구산,3282,2591,5873
<class,6호선,독바위,1302,1518,2820
<class,6호선,불광,2458,2211,4669
<class,6호선,역촌,1823,2031,3854
<class,6호선,응암,7841,7708,15549
<class,5호선,하남검단산,3730,3772,7502
<class,5호선,하남시청,3188,3065,6253
<class,5호선,하남풍산,1809,1856,3665
<class,5호선,미사,7340,7510,14850
<class,5호선,강일,1657,1550,3207
<class,5호선,마천,2921,3131,6052
<class,5호선,거여,3694,3457,7151
<class,5호선,개롱,2594,2950,5544
<class,5호선,오금,1428,1321,2749
<class,5호선,방이,3311,3187,6498
<class,5호선,올림픽공원,2136,2021,4157
<class,5호선,둔촌동,3825,3979,7804
<class,5호선,상일동,5935,5806,11741
<class,5호선,고덕,3647,3565,7212
<class,5호선,명일,3832,3964,7796
<class,5호선,굽은다리,4220,3988,8208
<class,5호선,강동,7901,7799,15700
<class,5호선,천호,10721,9922,20643
<class,5호선,광나루,6413,6143,12556
<class,5호선,아차산,8337,8129,16466
<class,5호선,군자,5426,6117,11543
<class,5호선,장한평,6555,6554,13109
<class,5호선,답십리,6308,6038,12346
<class,5호선,마장,2593,2362,4955
<class,5호선,왕십리,2156,2507,4663
<class,5호선,행당,3455,3187,6642
<class,5호선,신금호,2527,2735,5262
<class,5호선,청구,1497,1433,2930
<class,5호선,동대문역사문화공원,611,785,1396
<class,5호선,을지로4가,1203,1416,2619
<class,5호선,종로3가,8381,8104,16485
<class,5호선,광화문,9660,9396,19056
<class,5호선,서대문,4267,4248,8515
<class,5호선,충정로,1249,1229,2478
<class,5호선,애오개,2301,2246,4547
<class,5호선,공덕,4173,4290,8463
<class,5호선,마포,4209,4271,8480
<class,5호선,여의나루,5247,7285,12532
<class,5호선,여의도,8355,8043,16398
<class,5호선,신길,1669,1813,3482
<class,5호선,영등포시장,4026,4189,8215
<class,5호선,영등포구청,1144,1122,2266
<class,5호선,양평,2234,2347,4581
<class,5호선,오목교,10043,9974,20017
<class,5호선,목동,6619,6744,13363
<class,5호선,신정,5334,4932,10266
<class,5호선,까치산,13502,13315,26817
<class,5호선,화곡,11990,11415,23405
<class,5호선,우장산,5815,5900,11715
<class,5호선,발산,8357,8939,17296
<class,5호선,마곡,3016,3084,6100
<class,5호선,송정,3211,3261,6472
<class,5호선,김포공항,6179,5775,11954
<class,5호선,개화산,2449,2406,4855
<class,5호선,방화,3146,2998,6144
<class,4호선,쌍문,13458,12396,25854
<class,4호선,창동,12088,12724,24812
<class,4호선,노원,10317,10958,21275
<class,4호선,상계,8908,8375,17283
<class,4호선,당고개,6470,6378,12848
<class,4호선,남태령,569,469,1038
<class,4호선,사당,13501,11776,25277
<class,4호선,총신대입구,9757,10468,20225
<class,4호선,동작,933,963,1896
<class,4호선,이촌,3972,4311,8283
<class,4호선,신용산,6497,6620,13117
<class,4호선,삼각지,2111,2819,4930
<class,4호선,숙대입구,6048,5867,11915
<class,4호선,서울역,3692,8485,12177
<class,4호선,회현,7609,7783,15392
<class,4호선,명동,9211,9749,18960
<class,4호선,충무로,7186,7335,14521
<class,4호선,동대문역사문화공원,7717,7362,15079
<class,4호선,동대문,5477,6064,11541
<class,4호선,혜화,19057,19583,38640
<class,4호선,한성대입구,6780,6860,13640
<class,4호선,성신여대입구,11553,10705,22258
<class,4호선,미아사거리,13931,13382,27313
<class,4호선,미아,6698,6443,13141
<class,4호선,수유,16957,16376,33333
<class,3호선,오금,2296,2226,4522
<class,3호선,경찰병원,2427,2517,4944
<class,3호선,가락시장,2999,3316,6315
<class,3호선,수서,9003,8692,17695
<class,3호선,일원,2570,2811,5381
<class,3호선,대청,3427,3330,6757
<class,3호선,학여울,1325,1444,2769
<class,3호선,대치,5168,4512,9680
<class,3호선,도곡,1517,1597,3114
<class,3호선,매봉,3601,3478,7079
<class,3호선,양재,12307,13521,25828
<class,3호선,남부터미널,12862,12976,25838
<class,3호선,교대,3813,2295,6108
<class,3호선,고속터미널,34621,32085,66706
<class,3호선,잠원,1841,1803,3644
<class,3호선,신사,12559,13305,25864
<class,3호선,압구정,11613,12065,23678
<class,3호선,옥수,4122,4424,8546
<class,3호선,금호,3685,3467,7152
<class,3호선,약수,5588,5467,11055
<class,3호선,동대입구,4180,4618,8798
<class,3호선,을지로3가,2932,2732,5664
<class,3호선,종로3가,3682,4948,8630
<class,3호선,안국,9422,10023,19445
<class,3호선,경복궁,10461,10962,21423
<class,3호선,독립문,3570,3968,7538
<class,3호선,무악재,1716,1794,3510
<class,3호선,홍제,7727,7359,15086
<class,3호선,녹번,6334,5632,11966
<class,3호선,불광,8154,9207,17361
<class,3호선,연신내,18396,17635,36031
<class,3호선,구파발,9480,9704,19184
<class,3호선,지축,1692,1719,3411
<class,2호선,용두,846,869,1715
<class,2호선,신정네거리,4478,4616,9094
<class,2호선,양천구청,2631,2850,5481
<class,2호선,도림천,409,386,795
<class,2호선,신설동,2331,1875,4206
<class,2호선,신답,587,679,1266
<class,2호선,용답,1411,1328,2739
<class,2호선,충정로,3340,3673,7013
<class,2호선,아현,4532,4565,9097
<class,2호선,이대,6011,6521,12532
<class,2호선,신촌,18770,18527,37297
<class,2호선,홍대입구,44911,44858,89769
<class,2호선,합정,18649,19738,38387
<class,2호선,당산,7549,8272,15821
<class,2호선,영등포구청,7487,7561,15048
<class,2호선,문래,6887,7153,14040
<class,2호선,신도림,25825,25778,51603
<class,2호선,대림,12577,12822,25399
<class,2호선,구로디지털단지,20318,19674,39992
<class,2호선,신대방,13249,13089,26338
<class,2호선,신림,32283,31869,64152
<class,2호선,봉천,10750,10161,20911
<class,2호선,서울대입구,23688,23828,47516
<class,2호선,낙성대,13788,13493,27281
<class,2호선,사당,18608,20351,38959
<class,2호선,방배,5727,6017,11744
<class,2호선,서초,8445,7588,16033
<class,2호선,교대,9103,10002,19105
<class,2호선,강남,31152,30307,61459
<class,2호선,역삼,9854,10774,20628
<class,2호선,선릉,11457,10209,21666
<class,2호선,삼성,20131,19645,39776
<class,2호선,종합운동장,3188,3464,6652
<class,2호선,잠실새내,10135,10530,20665
<class,2호선,잠실,43430,40189,83619
<class,2호선,잠실나루,4765,4798,9563
<class,2호선,강변,18949,17926,36875
<class,2호선,구의,10014,9914,19928
<class,2호선,건대입구,23680,24720,48400
<class,2호선,성수,11332,12383,23715
<class,2호선,뚝섬,8557,8747,17304
<class,2호선,한양대,2770,2802,5572
<class,2호선,왕십리,8432,7303,15735
<class,2호선,상왕십리,6222,6066,12288
<class,2호선,신당,6801,7541,14342
<class,2호선,동대문역사문화공원,6434,8002,14436
<class,2호선,을지로4가,3077,2955,6032
<class,2호선,을지로3가,6763,6474,13237
<class,2호선,을지로입구,13495,13031,26526
<class,2호선,시청,5471,4603,10074
<class,1호선,청량리,11065,11186,22251
<class,1호선,제기동,7522,7654,15176
<class,1호선,신설동,5705,5889,11594
<class,1호선,동대문,7177,7697,14874
<class,1호선,종로5가,8214,8388,16602
<class,1호선,종로3가,12461,11467,23928
<class,1호선,종각,11034,9947,20981
<class,1호선,동묘앞,7693,7815,15508
<class,1호선,서울역,23858,21579,45437
<class,8호선,문정,5146,5423,10569
<class,4호선,길음,8624,8559,17183
<class,1호선,시청,7214,6993,14207
<class,경부선,천안,6182,6353,12535
<class,5호선,강동,12494,11955,24449
<class,중앙선,덕소,4494,4515,9009
<class,중앙선,도심,1541,1395,2936
<class,중앙선,팔당,1471,1604,3075
<class,중앙선,운길산,1446,1438,2884
<class,중앙선,양수,2393,2432,4825
<class,중앙선,신원,333,268,601
<class,중앙선,국수,705,728,1433
<class,중앙선,아신,656,646,1302
<class,중앙선,오빈,264,297,561
<class,중앙선,양평,2730,2902,5632
<class,중앙선,원덕,464,489,953
<class,중앙선,용문,2303,2612,4915
<class,중앙선,지평,49,81,130
<class,2호선,서초,9947,8295,18242
<class,수인선,인천,1220,1870,3090
<class,안산선,산본,11643,12449,24092
<class,안산선,대야미,3877,3505,7382
<class,안산선,반월,3219,3065,6284
<class,안산선,상록수,11844,11844,23688
<class,안산선,한대앞,7040,6746,13786
<class,안산선,중앙,15947,16184,32131
<class,안산선,고잔,6455,6483,12938
<class,1호선,신설동,9232,8885,18117
<class,6호선,구산,5357,4157,9514
<class,1호선,서울역,29661,30451,60112
<class,1호선,동묘앞,11113,11496,22609
<class,1호선,시청,10127,10793,20920
<class,1호선,종각,17400,16078,33478
<class,1호선,종로3가,21077,20260,41337
<class,1호선,종로5가,18633,18048,36681
<class,1호선,동대문,10521,9715,20236
<class,1호선,제기동,14738,15329,30067
<class,1호선,청량리,17506,17725,35231
<class,2호선,시청,8559,7129,15688
<class,2호선,을지로입구,18446,18457,36903
<class,2호선,을지로3가,9987,9682,19669
<class,2호선,을지로4가,6578,6524,13102
<class,2호선,동대문역사문화공원,9276,10037,19313
<class,2호선,신당,10283,10847,21130
<class,2호선,상왕십리,9449,9064,18513
<class,2호선,왕십리,12870,10781,23651
<class,2호선,한양대,3937,3868,7805
<class,2호선,뚝섬,13126,13358,26484
<class,2호선,성수,17539,19132,36671
<class,2호선,건대입구,30832,32419,63251
<class,2호선,구의,15376,15110,30486
<class,2호선,강변,24639,25408,50047
<class,2호선,잠실나루,7100,7055,14155
<class,2호선,잠실,59481,56888,116369
<class,2호선,잠실새내,16070,16240,32310
<class,2호선,종합운동장,4691,5619,10310
<class,2호선,삼성,30924,30527,61451
<class,2호선,선릉,23185,20209,43394
<class,2호선,역삼,17834,18878,36712
<class,2호선,강남,56982,56416,113398
<class,2호선,교대,16700,18722,35422
<class,2호선,방배,9765,10047,19812
<class,2호선,사당,28286,31252,59538
<class,2호선,낙성대,20165,18975,39140
<class,2호선,서울대입구,35980,34738,70718
<class,2호선,봉천,16610,15338,31948
<class,2호선,신림,47798,46126,93924
<class,2호선,신대방,19046,18599,37645
<class,2호선,구로디지털단지,32156,31707,63863
<class,2호선,대림,16652,17864,34516
<class,2호선,신도림,39613,39667,79280
<class,2호선,문래,11664,12044,23708
<class,2호선,영등포구청,12319,12830,25149
<class,2호선,당산,11534,12840,24374
<class,2호선,합정,26025,27503,53528
<class,2호선,홍대입구,56503,58125,114628
<class,2호선,신촌,27138,26751,53889
<class,2호선,이대,9239,9701,18940
<class,2호선,아현,7082,6801,13883
<class,2호선,충정로,5365,5644,11009
<class,2호선,용답,2153,2045,4198
<class,2호선,신답,938,989,1927
<class,2호선,신설동,3111,1478,4589
<class,2호선,도림천,821,828,1649
<class,2호선,양천구청,4339,4425,8764
<class,2호선,신정네거리,7246,7285,14531
<class,2호선,용두,1576,1700,3276
<class,3호선,지축,2865,2805,5670
<class,3호선,구파발,15251,15215,30466
<class,3호선,연신내,28814,26941,55755
<class,3호선,불광,12679,14409,27088
<class,3호선,녹번,9931,8576,18507
<class,3호선,홍제,12370,11789,24159
<class,3호선,무악재,2660,2836,5496
<class,3호선,독립문,5778,6184,11962
<class,3호선,경복궁,15607,16682,32289
<class,3호선,안국,14527,15591,30118
<class,3호선,종로3가,5738,7757,13495
<class,3호선,을지로3가,4751,5143,9894
<class,3호선,동대입구,5903,6686,12589
<class,3호선,약수,8815,8278,17093
<class,3호선,금호,5578,5242,10820
<class,3호선,옥수,6817,7004,13821
<class,3호선,압구정,23392,24499,47891
<class,3호선,신사,24369,24669,49038
<class,3호선,잠원,3419,3339,6758
<class,3호선,고속터미널,44333,44554,88887
<class,3호선,교대,6528,3915,10443
<class,3호선,남부터미널,20000,20274,40274
<class,3호선,양재,19799,21341,41140
<class,3호선,매봉,5997,5717,11714
<class,3호선,도곡,3183,3206,6389
<class,3호선,대치,8863,7990,16853
<class,3호선,학여울,1486,1584,3070
<class,3호선,대청,5792,5381,11173
<class,3호선,일원,4577,4546,9123
<class,3호선,수서,12557,12621,25178
<class,3호선,가락시장,5930,5511,11441
<class,3호선,경찰병원,3913,3818,7731
<class,3호선,오금,3737,3480,7217
<class,4호선,수유,25406,24500,49906
<class,4호선,미아,10398,9916,20314
<class,4호선,미아사거리,21719,21039,42758
<class,4호선,길음,13143,12846,25989
<class,4호선,성신여대입구,16265,15160,31425
<class,4호선,한성대입구,10425,10117,20542
<class,4호선,혜화,23790,24288,48078
<class,4호선,동대문,13934,13889,27823
<class,4호선,동대문역사문화공원,10345,8969,19314
<class,4호선,충무로,12313,12702,25015
<class,4호선,명동,12795,14480,27275
<class,4호선,회현,16497,17792,34289
<class,4호선,서울역,5133,11514,16647
<class,4호선,숙대입구,8534,8138,16672
<class,4호선,삼각지,3304,4220,7524
<class,4호선,신용산,9657,10323,19980
<class,4호선,이촌,5745,6381,12126
<class,4호선,동작,1377,1584,2961
<class,4호선,총신대입구,14520,15504,30024
<class,4호선,사당,19522,16968,36490
<class,4호선,남태령,964,742,1706
<class,4호선,당고개,9524,9249,18773
<class,4호선,상계,13658,12768,26426
<class,4호선,노원,15539,16570,32109
<class,4호선,창동,18440,19512,37952
<class,4호선,쌍문,20525,18717,39242
<class,5호선,방화,4600,4430,9030
<class,5호선,개화산,3679,3583,7262
<class,5호선,김포공항,7302,7363,14665
<class,5호선,송정,5034,4798,9832
<class,5호선,마곡,5348,5308,10656
<class,5호선,발산,13579,14212,27791
<class,5호선,우장산,9446,9501,18947
<class,5호선,화곡,19335,17797,37132
<class,5호선,까치산,20397,19569,39966
<class,5호선,신정,8344,7450,15794
<class,5호선,목동,10618,10814,21432
<class,5호선,오목교,15623,16199,31822
<class,5호선,양평,3601,3482,7083
<class,5호선,영등포구청,1771,1776,3547
<class,5호선,영등포시장,6805,7262,14067
<class,5호선,신길,2493,2643,5136
<class,5호선,여의도,11616,11340,22956
<class,5호선,여의나루,8624,11067,19691
<class,5호선,마포,6988,7037,14025
<class,5호선,공덕,6620,6860,13480
<class,5호선,애오개,3477,3513,6990
<class,5호선,충정로,1871,1837,3708
<class,5호선,서대문,7024,6850,13874
<class,5호선,광화문,14187,14627,28814
<class,5호선,종로3가,12174,11825,23999
<class,5호선,을지로4가,2926,3354,6280
<class,5호선,동대문역사문화공원,925,1205,2130
<class,5호선,청구,2451,2322,4773
<class,5호선,신금호,4219,4250,8469
<class,5호선,행당,5400,4786,10186
<class,5호선,왕십리,3450,4035,7485
<class,5호선,마장,3741,3644,7385
<class,5호선,답십리,9570,8855,18425
<class,5호선,장한평,10738,10522,21260
<class,5호선,군자,8119,8896,17015
<class,5호선,아차산,12272,11959,24231
<class,5호선,광나루,9812,9431,19243
<class,5호선,천호,16196,15242,31438
<class,5호선,길동,5785,5965,11750
<class,5호선,굽은다리,6812,6475,13287
<class,5호선,명일,5924,5909,11833
<class,5호선,고덕,6724,6489,13213
<class,5호선,상일동,9163,8718,17881
<class,5호선,둔촌동,5936,5939,11875
<class,5호선,올림픽공원,3156,3109,6265
<class,5호선,방이,5248,5156,10404
<class,5호선,오금,2444,2339,4783
<class,5호선,개롱,4171,4392,8563
<class,5호선,거여,5619,5393,11012
<class,5호선,마천,4477,4662,9139
<class,5호선,강일,2613,2442,5055
<class,5호선,미사,11149,11311,22460
<class,5호선,하남풍산,2597,2660,5257
<class,5호선,하남시청,4897,4735,9632
<class,5호선,하남검단산,4760,4830,9590
<class,6호선,응암,12101,12122,24223
<class,6호선,역촌,2622,3104,5726
<class,6호선,불광,3911,3697,7608
<class,6호선,독바위,2006,2318,4324
<class,6호선,새절,8511,8114,16625
<class,6호선,증산,7230,7192,14422
<class,6호선,디지털미디어시티,6861,7149,14010
<class,6호선,월드컵경기장,6386,6862,13248
<class,6호선,마포구청,9346,8339,17685
<class,6호선,망원,12426,13108,25534
<class,6호선,합정,12012,11200,23212
<class,6호선,상수,7481,8076,15557
<class,6호선,광흥창,5032,4679,9711
<class,6호선,대흥,5176,5159,10335
<class,6호선,공덕,9551,9097,18648
<class,6호선,효창공원앞,4100,3783,7883
<class,6호선,삼각지,5052,4116,9168
<class,6호선,녹사평,4655,5099,9754
<class,6호선,이태원,12010,12378,24388
<class,6호선,한강진,7803,9329,17132
<class,6호선,버티고개,1135,1097,2232
<class,6호선,약수,2342,2488,4830
<class,6호선,청구,2365,2458,4823
<class,6호선,신당,5876,4767,10643
<class,6호선,동묘앞,7909,7441,15350
<class,6호선,창신,2029,1729,3758
<class,6호선,보문,4852,4359,9211
<class,6호선,안암,5720,5411,11131
<class,6호선,고려대,4991,4910,9901
<class,6호선,월곡,7423,7249,14672
<class,6호선,상월곡,4478,4063,8541
<class,6호선,돌곶이,5897,5508,11405
<class,6호선,석계,8431,8606,17037
<class,6호선,태릉입구,4039,4374,8413
<class,6호선,화랑대,7465,6152,13617
<class,6호선,봉화산,5124,4979,10103
<class,7호선,장암,1569,1155,2724
<class,7호선,도봉산,6734,9144,15878
<class,7호선,수락산,9902,9866,19768
<class,7호선,마들,9167,8606,17773
<class,7호선,노원,15618,15563,31181
<class,7호선,중계,9031,8311,17342
<class,7호선,하계,11687,11101,22788
<class,7호선,공릉,8481,8353,16834
<class,7호선,태릉입구,6264,5807,12071
<class,7호선,먹골,7978,7784,15762
<class,7호선,중화,7825,7551,15376
<class,7호선,상봉,12882,12329,25211
<class,7호선,면목,10885,10807,21692
<class,7호선,사가정,12068,11487,23555
<class,7호선,용마산,4186,4464,8650
<class,7호선,중곡,7154,6738,13892
<class,7호선,군자,10289,7971,18260
<class,7호선,어린이대공원,9117,9078,18195
<class,7호선,건대입구,10554,10750,21304
<class,7호선,뚝섬유원지,7239,7066,14305
<class,7호선,청담,10908,11791,22699
<class,7호선,강남구청,9733,10885,20618
<class,7호선,학동,10184,10694,20878
<class,7호선,논현,10572,11619,22191
<class,7호선,반포,4322,4153,8475
<class,7호선,고속터미널,12843,10434,23277
<class,7호선,내방,7724,7552,15276
<class,7호선,이수,11566,10832,22398
<class,7호선,남성,7175,6757,13932
<class,7호선,숭실대입구,7889,7751,15640
<class,7호선,상도,7074,6612,13686
<class,7호선,장승배기,6371,6097,12468
<class,7호선,신대방삼거리,10816,10089,20905
<class,7호선,보라매,6346,6124,12470
<class,7호선,신풍,7829,7603,15432
<class,7호선,대림,6971,7231,14202
<class,7호선,남구로,7824,8223,16047
<class,7호선,가산디지털단지,15145,13542,28687
<class,7호선,철산,14196,14386,28582
<class,7호선,광명사거리,16117,16024,32141
<class,7호선,천왕,6438,6137,12575
<class,7호선,온수,5508,5450,10958
<class,7호선,까치울,5523,5473,10996
<class,7호선,부천종합운동장,3141,2766,5907
<class,7호선,춘의,5052,4853,9905
<class,7호선,신중동,9503,9495,18998
<class,7호선,부천시청,9718,9524,19242
<class,7호선,상동,10930,10868,21798
<class,7호선,삼산체육관,3682,3588,7270
<class,7호선,굴포천,6623,6798,13421
<class,7호선,부평구청,4922,4365,9287
<class,8호선,암사,11966,10952,22918
<class,8호선,천호,11571,13643,25214
<class,8호선,강동구청,5903,5984,11887
<class,8호선,몽촌토성,5044,4824,9868
<class,8호선,잠실,12641,14317,26958
<class,8호선,석촌,5668,6794,12462
<class,8호선,송파,5184,5337,10521
<class,8호선,가락시장,5157,5234,10391
<class,8호선,문정,8434,8673,17107
<class,8호선,장지,11993,10940,22933
<class,8호선,복정,7164,6156,13320
<class,8호선,산성,4443,4475,8918
<class,8호선,남한산성입구,8907,8019,16926
<class,8호선,단대오거리,7341,6783,14124
<class,8호선,신흥,3413,3668,7081
<class,8호선,수진,4156,3743,7899
<class,8호선,모란,3557,3042,6599
<class,9호선,개화,1505,1336,2841
<class,9호선,김포공항,7660,12387,20047
<class,9호선,공항시장,2230,2327,4557
<class,9호선,신방화,4596,4333,8929
<class,9호선,마곡나루,7720,7573,15293
<class,9호선,양천향교,5746,5592,11338
<class,9호선,가양,13562,12868,26430
<class,9호선,증미,3977,3899,7876
<class,9호선,등촌,7082,6948,14030
<class,9호선,염창,11019,10298,21317
<class,9호선,신목동,2240,1960,4200
<class,9호선,선유도,3796,3755,7551
<class,9호선,당산,12360,11589,23949
<class,9호선,국회의사당,3965,4303,8268
<class,9호선,여의도,11848,10474,22322
<class,9호선,샛강,2379,2574,4953
<class,9호선,노량진,20898,20087,40985
<class,9호선,노들,3159,2844,6003
<class,9호선,흑석,5109,5135,10244
<class,9호선,동작,1346,1141,2487
<class,9호선,구반포,1676,1765,3441
<class,9호선,신반포,2433,2508,4941
<class,9호선,고속터미널,11424,16684,28108
<class,9호선,사평,2382,2322,4704
<class,9호선,신논현,24152,23216,47368
<class,9호선2~3단계,언주,5901,5960,11861
<class,9호선2~3단계,선정릉,4751,5544,10295
<class,9호선2~3단계,삼성중앙,3024,3095,6119
<class,9호선2~3단계,봉은사,11950,12374,24324
<class,9호선2~3단계,종합운동장,3142,2644,5786
<class,9호선2~3단계,삼전,4937,4736,9673
<class,9호선2~3단계,석촌고분,3966,3802,7768
<class,9호선2~3단계,석촌,6295,5254,11549
<class,9호선2~3단계,송파나루,4103,4129,8232
<class,9호선2~3단계,한성백제,2307,1909,4216
<class,9호선2~3단계,올림픽공원,5448,5979,11427
<class,9호선2~3단계,둔촌오륜,616,628,1244
<class,9호선2~3단계,중앙보훈병원,4337,4156,8493
<class,경강선,판교,2955,2763,5718
<class,경강선,이매,827,651,1478
<class,경강선,삼동,1420,1288,2708
<class,경강선,경기광주,5007,4741,9748
<class,경강선,초월,2151,1986,4137
<class,경강선,곤지암,1853,2095,3948
<class,경강선,신둔도예촌,1160,1150,2310
<class,경강선,이천,2564,2817,5381
<class,경강선,부발,1916,1677,3593
<class,경강선,세종대왕릉,317,412,729
<class,경강선,여주,2335,2640,4975
<class,경부선,서울역,5584,1706,7290
<class,경부선,남영,5608,5869,11477
<class,경부선,용산,31310,33538,64848
<class,경부선,노량진,8348,7655,16003
<class,경부선,대방,7824,7927,15751
<class,경부선,영등포,36553,37527,74080
<class,경부선,신도림,2663,2962,5625
<class,경부선,신길,5933,4922,10855
<class,경부선,구로,12884,13167,26051
<class,경부선,가산디지털단지,5992,8446,14438
<class,경부선,금천구청,8219,8152,16371
<class,경부선,석수,6883,6299,13182
<class,경부선,관악,5780,5432,11212
<class,경부선,안양,18320,18163,36483
<class,경부선,명학,5042,4887,9929
<class,경부선,금정,17889,17884,35773
<class,경부선,군포,4193,3890,8083
<class,경부선,의왕,5935,5795,11730
<class,경부선,성균관대,9608,9715,19323
<class,경부선,화서,5280,5344,10624
<class,경부선,수원,35415,37724,73139
<class,경부선,독산,8644,8526,17170
<class,경부선,세류,2465,2525,4990
<class,경부선,병점,11581,11684,23265
<class,경부선,세마,1982,1781,3763
<class,경부선,오산대,2761,2504,5265
<class,경부선,오산,9079,8563,17642
<class,경부선,진위,986,905,1891
<class,경부선,송탄,4811,4177,8988
<class,경부선,서정리,6467,5411,11878
<class,경부선,평택지제,2977,2755,5732
<class,경부선,평택,13192,12419,25611
<class,경부선,성환,2886,2764,5650
<class,경부선,직산,633,606,1239
<class,경부선,두정,5475,5408,10883
<class,경부선,당정,3815,3619,7434
<class,경부선,서동탄,992,1003,1995
<class,경부선,광명,2522,2242,4764
<class,경원선,이촌,2819,2236,5055
<class,경원선,서빙고,1402,1591,2993
<class,경원선,한남,2668,2495,5163
<class,경원선,옥수,26,31,57
<class,경원선,응봉,1367,1212,2579
<class,경원선,왕십리,12001,13489,25490
<class,경원선,청량리,15199,16505,31704
<class,경원선,외대앞,5569,5526,11095
<class,경원선,신이문,6055,5568,11623
<class,경원선,석계,6540,7012,13552
<class,경원선,광운대,5291,5174,10465
<class,경원선,월계,4603,4204,8807
<class,경원선,녹천,3355,2758,6113
<class,경원선,방학,7315,7110,14425
<class,경원선,도봉,4470,4284,8754
<class,경원선,도봉산,9719,6726,16445
<class,경원선,망월사,6858,6913,13771
<class,경원선,회룡,9613,9456,19069
<class,경원선,의정부,17023,17916,34939
<class,경원선,가능,5234,4907,10141
<class,경원선,녹양,3552,3473,7025
<class,경원선,양주,6709,6476,13185
<class,경원선,덕계,2413,2173,4586
<class,경원선,덕정,4410,4061,8471
<class,경원선,지행,5471,5308,10779
<class,경원선,동두천중앙,2544,2621,5165
<class,경원선,보산,2010,1874,3884
<class,경원선,동두천,1583,2206,3789
<class,경원선,소요산,4224,3803,8027
<class,경의선,서울역,1161,1432,2593
<class,경의선,신촌,345,369,714
<class,경의선,효창공원앞,1725,1925,3650
<class,경의선,공덕,2467,1997,4464
<class,경의선,서강대,1617,1566,3183
<class,경의선,홍대입구,1704,2061,3765
<class,경의선,가좌,3802,3670,7472
<class,경의선,디지털미디어시티,1870,1711,3581
<class,경의선,수색,1425,1399,2824
<class,경의선,화전,1106,1020,2126
<class,경의선,강매,1873,1778,3651
<class,경의선,행신,5000,5081,10081
<class,경의선,능곡,2747,2633,5380
<class,경의선,곡산,479,505,984
<class,경의선,백마,4159,4015,8174
<class,경의선,풍산,4047,3908,7955
<class,경의선,일산,5926,5542,11468
<class,경의선,탄현,5220,5012,10232
<class,경의선,야당,5588,5491,11079
<class,경의선,운정,4818,4571,9389
<class,경의선,금릉,3609,3566,7175
<class,경의선,금촌,5736,5568,11304
<class,경의선,월롱,1530,1512,3042
<class,경의선,파주,863,698,1561
<class,경의선,문산,4629,4635,9264
<class,경의선,임진강,69,71,140
<class,경의선,서울역,36,3,39
<class,경인선,개봉,15703,15653,31356
<class,경인선,오류동,8598,7806,16404
<class,경인선,역곡,19117,18818,37935
<class,경인선,부천,27125,27739,54864
<class,경인선,송내,17114,16851,33965
<class,경인선,부평,27733,29914,57647
<class,경인선,백운,5385,5226,10611
<class,경인선,동암,11581,12047,23628
<class,경인선,주안,15039,13278,28317
<class,경인선,제물포,7052,6923,13975
<class,경인선,동인천,11072,10973,22045
<class,경인선,인천,3822,3276,7098
<class,경인선,구일,4509,4214,8723
<class,경인선,소사,7315,7155,14470
<class,경인선,부개,6265,5919,12184
<class,경인선,간석,4027,4002,8029
<class,경인선,도원,1873,2017,3890
<class,경인선,온수,4761,4375,9136
<class,경인선,중동,6679,6452,13131
<class,경인선,도화,2980,2780,5760
<class,경춘선,신내,1190,1161,2351
<class,경춘선,갈매,1949,1625,3574
<class,경춘선,별내,2308,2234,4542
<class,경춘선,퇴계원,2643,2424,5067
<class,경춘선,사릉,2259,2302,4561
<class,경춘선,금곡,1123,1051,2174
<class,경춘선,평내호평,4493,4281,8774
<class,경춘선,천마산,1295,1344,2639
<class,경춘선,마석,3267,3227,6494
<class,경춘선,대성리,612,579,1191
<class,경춘선,청평,1674,1735,3409
<class,경춘선,상천,471,415,886
<class,경춘선,가평,2245,2361,4606
<class,경춘선,굴봉산,216,217,433
<class,경춘선,백양리,113,159,272
<class,경춘선,강촌,695,824,1519
<class,경춘선,김유정,576,697,1273
<class,경춘선,남춘천,2628,2936,5564
<class,경춘선,춘천,1822,1820,3642
<class,공항철도 1호선,서울역,6533,6888,13421
<class,공항철도 1호선,공덕,1407,2098,3505
<class,공항철도 1호선,홍대입구,10330,10303,20633
<class,공항철도 1호선,디지털미디어시티,5497,5216,10713
<class,공항철도 1호선,마곡나루,2935,3165,6100
<class,공항철도 1호선,김포공항,11117,5881,16998
<class,공항철도 1호선,계양,6679,6233,12912
<class,공항철도 1호선,검암,4273,4364,8637
<class,공항철도 1호선,청라국제도시,3838,3784,7622
<class,공항철도 1호선,운서,5402,5535,10937
<class,공항철도 1호선,공항화물청사,1263,1313,2576
<class,공항철도 1호선,인천공항1터미널,3208,3211,6419
<class,공항철도 1호선,인천공항2터미널,1880,1578,3458
<class,공항철도 1호선,영종,2778,2766,5544
<class,과천선,선바위,4855,4369,9224
<class,과천선,경마공원,1181,1109,2290
<class,과천선,대공원,5685,6192,11877
<class,과천선,과천,4102,3725,7827
<class,과천선,정부과천청사,5912,5847,11759
<class,과천선,인덕원,15025,14815,29840
<class,과천선,평촌,9045,8972,18017
<class,과천선,범계,19490,18772,38262
<class,분당선,선릉,4821,7569,12390
<class,분당선,한티,12013,11478,23491
<class,분당선,도곡,4184,3938,8122
<class,분당선,구룡,1263,1157,2420
<class,분당선,개포동,2754,2677,5431
<class,분당선,대모산입구,3121,2965,6086
<class,분당선,수서,9828,10167,19995
<class,분당선,수원,6868,5949,12817
<class,분당선,서울숲,7993,8693,16686
<class,분당선,압구정로데오,17442,19488,36930
<class,분당선,강남구청,5514,6626,12140
<class,분당선,선정릉,3501,3587,7088
<class,분당선,가천대,5134,5509,10643
<class,분당선,태평,10310,9739,20049
<class,분당선,모란,15378,15715,31093
<class,분당선,야탑,16761,17515,34276
<class,분당선,서현,17671,17518,35189
<class,분당선,수내,8603,8190,16793
<class,분당선,정자,10262,10724,20986
<class,분당선,미금,10404,10703,21107
<class,분당선,오리,7657,6410,14067
<class,분당선,이매,3896,3980,7876
<class,분당선,보정,1590,1420,3010
<class,분당선,죽전,9733,10869,20602
<class,분당선,구성,3227,3320,6547
<class,분당선,신갈,2675,2656,5331
<class,분당선,기흥,6497,6172,12669
<class,분당선,상갈,3785,3740,7525
<class,분당선,청명,2645,2592,5237
<class,분당선,영통,6181,6069,12250
<class,분당선,망포,8784,8089,16873
<class,분당선,매탄권선,3381,3306,6687
<class,분당선,수원시청,10108,10745,20853
<class,분당선,매교,1941,1965,3906
<class,수인선,고색,2674,2572,5246
<class,수인선,오목천,1914,1746,3660
<class,수인선,어천,703,600,1303
<class,수인선,야목,228,221,449
<class,수인선,사리,3252,2787,6039
<class,수인선,달월,66,61,127
<class,수인선,월곶,1966,1943,3909
<class,수인선,소래포구,7001,7154,14155
<class,수인선,인천논현,4293,4357,8650
<class,수인선,호구포,2496,2371,4867
<class,수인선,남동인더스파크,1051,922,1973
<class,수인선,원인재,3591,3762,7353
<class,수인선,연수,3535,3470,7005
<class,수인선,송도,1936,1890,3826
<class,수인선,인하대,4317,3961,8278
<class,수인선,숭의,2686,2564,5250
<class,수인선,신포,1332,1433,2765
<class,안산선,초지,3099,3169,6268
<class,안산선,안산,9129,9491,18620
<class,안산선,신길온천,1408,1351,2759
<class,안산선,정왕,6016,6262,12278
<class,안산선,오이도,7223,7608,14831
<class,안산선,수리산,2885,2558,5443
<class,우이신설선,북한산우이,3656,3540,7196
<class,우이신설선,솔밭공원,1722,1713,3435
<class,우이신설선,4.19민주묘지,2258,1991,4249
<class,우이신설선,가오리,2836,2739,5575
<class,우이신설선,화계,2471,2325,4796
<class,우이신설선,삼양,1429,1558,2987
<class,우이신설선,삼양사거리,1887,1836,3723
<class,우이신설선,솔샘,3664,3387,7051
<class,우이신설선,북한산보국문,4416,3962,8378
<class,우이신설선,정릉,3451,2924,6375
<class,우이신설선,성신여대입구,2638,2959,5597
<class,우이신설선,보문,1099,1069,2168
<class,우이신설선,신설동,1352,1256,2608
<class,일산선,원흥,7008,6760,13768
<class,일산선,삼송,13398,13174,26572
<class,일산선,원당,8122,7827,15949
<class,일산선,화정,12419,12870,25289
<class,일산선,대곡,1430,1189,2619
<class,일산선,백석,7371,7565,14936
<class,일산선,마두,5113,5356,10469
<class,일산선,정발산,6130,6361,12491
<class,일산선,주엽,6463,6353,12816
<class,일산선,대화,8866,7999,16865
<class,장항선,봉명,673,636,1309
<class,장항선,쌍용,1481,1341,2822
<class,장항선,아산,2719,2613,5332
<class,장항선,배방,984,985,1969
<class,장항선,온양온천,3573,3659,7232
<class,장항선,신창,1191,1147,2338
<class,중앙선,회기,18879,17784,36663
<class,중앙선,중랑,4435,4218,8653
<class,중앙선,상봉,4962,4730,9692
<class,중앙선,망우,6408,6206,12614
<class,중앙선,양원,1362,1355,2717
<class,중앙선,구리,9982,10268,20250
<class,중앙선,도농,6611,6454,13065
<class,중앙선,양정,748,699,1447
<class,4호선,상계,9182,8731,17913
<class,9호선,당산,8131,7982,16113
<class,안산선,반월,2197,2202,4399
<class,안산선,상록수,8462,8263,16725
<class,안산선,한대앞,4996,4970,9966
<class,안산선,중앙,11233,10957,22190
<class,안산선,고잔,4302,4350,8652
<class,안산선,초지,2139,2111,4250
<class,안산선,안산,9143,8618,17761
<class,안산선,신길온천,1028,992,2020
<class,안산선,정왕,4831,5195,10026
<class,안산선,오이도,5437,5215,10652
<class,안산선,수리산,1931,1856,3787
<class,우이신설선,북한산우이,3128,3104,6232
<class,우이신설선,솔밭공원,1297,1192,2489
<class,우이신설선,4.19민주묘지,1662,1512,3174
<class,우이신설선,가오리,2186,2037,4223
<class,우이신설선,화계,1808,1700,3508
<class,우이신설선,삼양,1135,1176,2311
<class,우이신설선,삼양사거리,1436,1391,2827
<class,우이신설선,솔샘,2472,2286,4758
<class,우이신설선,북한산보국문,3325,3145,6470
<class,2호선,종합운동장,3446,3666,7112
<class,2호선,삼성,20838,20796,41634
<class,2호선,선릉,11911,10268,22179
<class,2호선,역삼,10212,11073,21285
<class,2호선,강남,31812,30617,62429
<class,2호선,교대,9323,10221,19544
<class,2호선,서초,8849,8211,17060
<class,2호선,방배,6075,6473,12548
<class,2호선,사당,19577,21298,40875
<class,2호선,낙성대,13902,14531,28433
<class,2호선,서울대입구,24514,24888,49402
<class,2호선,봉천,10986,10786,21772
<class,2호선,신림,33963,32885,66848
<class,2호선,신대방,14139,13897,28036
<class,3호선,경찰병원,2545,2579,5124
<class,3호선,오금,2478,2504,4982
<class,4호선,수유,17566,16818,34384
<class,4호선,미아,7287,6889,14176
<class,4호선,미아사거리,14995,14228,29223
<class,4호선,길음,9108,8895,18003
<class,4호선,성신여대입구,11286,10852,22138
<class,4호선,한성대입구,7542,7355,14897
<class,4호선,혜화,18590,19256,37846
<class,4호선,동대문,6290,6942,13232
<class,4호선,동대문역사문화공원,7586,7363,14949
<class,4호선,충무로,7468,7573,15041
<class,4호선,명동,9969,10154,20123
<class,4호선,회현,7315,7719,15034
<class,4호선,서울역,3665,8574,12239
<class,4호선,숙대입구,5839,5723,11562
<class,4호선,삼각지,2135,2793,4928
<class,4호선,신용산,7116,7214,14330
<class,4호선,이촌,3799,4150,7949
<class,4호선,동작,1086,1167,2253
<class,4호선,총신대입구,9684,10594,20278
<class,4호선,사당,13631,12587,26218
<class,4호선,남태령,602,476,1078
<class,4호선,당고개,6832,6462,13294
<class,4호선,노원,10772,11443,22215
<class,4호선,창동,12692,13557,26249
<class,4호선,쌍문,14271,12779,27050
<class,5호선,방화,3159,3216,6375
<class,5호선,개화산,2377,2437,4814
<class,5호선,김포공항,6767,6263,13030
<class,5호선,송정,3464,3568,7032
<class,5호선,마곡,3110,3222,6332
<class,5호선,발산,8471,8916,17387
<class,5호선,우장산,5909,6174,12083
<class,5호선,화곡,12859,12272,25131
<class,5호선,까치산,14326,13844,28170
<class,5호선,신정,5693,5233,10926
<class,5호선,목동,6895,7115,14010
<class,5호선,오목교,10687,10954,21641
<class,5호선,양평,2424,2601,5025
<class,5호선,영등포구청,1256,1234,2490
<class,5호선,영등포시장,4450,4647,9097
<class,5호선,신길,1730,1877,3607
<class,5호선,여의도,7454,7314,14768
<class,5호선,여의나루,6888,8035,14923
<class,5호선,마포,4333,4378,8711
<class,5호선,공덕,4099,4239,8338
<class,5호선,애오개,2321,2318,4639
<class,5호선,충정로,1283,1353,2636
<class,5호선,서대문,5141,5263,10404
<class,5호선,광화문,10147,10329,20476
<class,5호선,종로3가,8020,6918,14938
<class,5호선,을지로4가,1280,1333,2613
<class,5호선,동대문역사문화공원,643,768,1411
<class,5호선,청구,1657,1570,3227
<class,5호선,신금호,2676,2998,5674
<class,5호선,행당,3550,3233,6783
<class,5호선,왕십리,2250,2656,4906
<class,5호선,마장,2690,2451,5141
<class,5호선,답십리,6588,6158,12746
<class,5호선,장한평,6858,6921,13779
<class,5호선,군자,5692,6053,11745
<class,5호선,아차산,9102,9049,18151
<class,5호선,광나루,6759,6690,13449
<class,5호선,천호,11447,10769,22216
<class,5호선,강동,8010,8056,16066
<class,5호선,길동,3889,3921,7810
<class,5호선,굽은다리,4747,4535,9282
<class,5호선,명일,3950,3985,7935
<class,5호선,고덕,4192,4092,8284
<class,5호선,상일동,6074,5954,12028
<class,5호선,둔촌동,3985,4143,8128
<class,5호선,올림픽공원,2260,2249,4509
<class,5호선,방이,3815,3671,7486
<class,5호선,오금,1425,1320,2745
<class,5호선,개롱,2643,2828,5471
<class,5호선,거여,3589,3525,7114
<class,5호선,마천,3144,3373,6517
<class,5호선,강일,1714,1621,3335
<class,5호선,미사,7830,7776,15606
<class,5호선,하남풍산,1798,1821,3619
<class,5호선,하남시청,3365,3211,6576
<class,5호선,하남검단산,3898,3917,7815
<class,6호선,응암,8501,8480,16981
<class,6호선,역촌,1792,2112,3904
<class,6호선,불광,2844,2517,5361
<class,6호선,독바위,1399,1706,3105
<class,6호선,구산,3505,2643,6148
<class,6호선,새절,5712,5638,11350
<class,6호선,증산,4926,5147,10073
<class,6호선,디지털미디어시티,4453,4762,9215
<class,6호선,월드컵경기장,5068,5505,10573
<class,6호선,마포구청,6519,5865,12384
<class,6호선,망원,8484,8891,17375
<class,6호선,합정,8379,7763,16142
<class,6호선,상수,4864,5497,10361
<class,6호선,광흥창,3560,3418,6978
<class,6호선,대흥,3351,3406,6757
<class,6호선,공덕,6302,5780,12082
<class,6호선,효창공원앞,2914,2636,5550
<class,6호선,삼각지,3176,2552,5728
<class,6호선,녹사평,3395,3264,6659
<class,6호선,이태원,7990,7638,15628
<class,6호선,한강진,6064,6864,12928
<class,6호선,버티고개,897,794,1691
<class,6호선,약수,1495,1471,2966
<class,6호선,청구,1573,1490,3063
<class,6호선,신당,3509,4170,7679
<class,6호선,동묘앞,5697,5384,11081
<class,6호선,창신,1474,1319,2793
<class,6호선,보문,3477,3195,6672
<class,6호선,안암,4308,4537,8845
<class,6호선,고려대,3572,3617,7189
<class,6호선,월곡,4985,4914,9899
<class,6호선,상월곡,3005,2843,5848
<class,6호선,돌곶이,4095,3926,8021
<class,6호선,석계,6005,6131,12136
<class,6호선,태릉입구,2905,3086,5991
<class,6호선,화랑대,4616,4035,8651
<class,6호선,봉화산,3562,3525,7087
<class,7호선,장암,1261,969,2230
<class,7호선,도봉산,5178,7323,12501
<class,7호선,수락산,7609,7376,14985
<class,7호선,마들,5400,5024,10424
<class,7호선,노원,9985,9902,19887
<class,7호선,중계,5888,5475,11363
<class,7호선,하계,8194,7898,16092
<class,7호선,공릉,5782,5756,11538
<class,7호선,태릉입구,4593,4252,8845
<class,7호선,먹골,5113,5028,10141
<class,7호선,중화,5191,5016,10207
<class,7호선,상봉,8703,8269,16972
<class,7호선,면목,7441,7289,14730
<class,7호선,사가정,8408,8168,16576
<class,7호선,용마산,3088,3443,6531
<class,7호선,중곡,4677,4679,9356
<class,7호선,군자,7034,5560,12594
<class,7호선,어린이대공원,6357,6386,12743
<class,7호선,건대입구,7100,7103,14203
<class,7호선,뚝섬유원지,5423,5113,10536
<class,7호선,청담,5996,6436,12432
<class,7호선,강남구청,5388,5901,11289
<class,7호선,학동,5520,5849,11369
<class,7호선,논현,5657,6145,11802
<class,7호선,반포,2552,2566,5118
<class,7호선,고속터미널,10476,7026,17502
<class,7호선,내방,4530,4633,9163
<class,7호선,이수,7642,7358,15000
<class,7호선,남성,4817,4692,9509
<class,7호선,숭실대입구,5135,5520,10655
<class,7호선,상도,4624,4544,9168
<class,7호선,장승배기,4353,4402,8755
<class,7호선,신대방삼거리,6992,6934,13926
<class,7호선,보라매,4088,3960,8048
<class,7호선,신풍,5568,5253,10821
<class,7호선,대림,6586,6074,12660
<class,7호선,남구로,5962,5845,11807
<class,7호선,가산디지털단지,11609,10556,22165
<class,7호선,철산,8993,8804,17797
<class,7호선,광명사거리,10985,10953,21938
<class,7호선,천왕,4321,4226,8547
<class,7호선,온수,3609,3729,7338
<class,7호선,까치울,3744,3763,7507
<class,7호선,부천종합운동장,2110,1857,3967
<class,7호선,춘의,3172,3060,6232
<class,7호선,신중동,6317,6156,12473
<class,7호선,부천시청,6332,6252,12584
<class,7호선,상동,6907,6719,13626
<class,7호선,삼산체육관,2266,2264,4530
<class,7호선,굴포천,4356,4399,8755
<class,7호선,부평구청,3319,2950,6269
<class,8호선,암사,8077,7662,15739
<class,8호선,천호,8016,9265,17281
<class,8호선,강동구청,3964,4076,8040
<class,8호선,몽촌토성,3256,3178,6434
<class,8호선,잠실,9566,10775,20341
<class,8호선,석촌,3745,4670,8415
<class,8호선,송파,3038,3255,6293
<class,8호선,가락시장,2731,3454,6185
<class,8호선,문정,5235,5450,10685
<class,8호선,장지,8305,8531,16836
<class,8호선,복정,4635,4296,8931
<class,8호선,산성,2958,3056,6014
<class,8호선,남한산성입구,5919,5508,11427
<class,8호선,단대오거리,4915,4875,9790
<class,8호선,신흥,2413,2609,5022
<class,8호선,수진,2734,2425,5159
<class,8호선,모란,2351,2005,4356
<class,9호선,개화,1071,987,2058
<class,9호선,김포공항,6912,10749,17661
<class,9호선,공항시장,1558,1672,3230
<class,9호선,신방화,3078,3056,6134
<class,9호선,마곡나루,5126,5195,10321
<class,9호선,양천향교,3949,4089,8038
<class,9호선,가양,8918,8690,17608
<class,9호선,증미,2502,2553,5055
<class,9호선,등촌,4602,4760,9362
<class,9호선,염창,7556,7349,14905
<class,9호선,신목동,1527,1409,2936
<class,9호선,선유도,2613,2574,5187
<class,9호선,국회의사당,3790,3707,7497
<class,9호선,여의도,8066,7168,15234
<class,9호선,샛강,1591,1566,3157
<class,9호선,노량진,13439,14118,27557
<class,9호선,노들,2340,2027,4367
<class,9호선,흑석,3331,3432,6763
<class,9호선,동작,1050,854,1904
<class,9호선,구반포,818,882,1700
<class,9호선,신반포,1425,1466,2891
<class,9호선,고속터미널,8870,11823,20693
<class,9호선,사평,1308,1382,2690
<class,9호선,신논현,13358,12949,26307
<class,9호선2~3단계,언주,3584,3594,7178
<class,9호선2~3단계,선정릉,2929,3382,6311
<class,9호선2~3단계,삼성중앙,1783,1871,3654
<class,9호선2~3단계,봉은사,8174,8423,16597
<class,9호선2~3단계,종합운동장,1908,1693,3601
<class,9호선2~3단계,삼전,3200,3159,6359
<class,9호선2~3단계,석촌고분,2738,2692,5430
<class,9호선2~3단계,석촌,4313,3634,7947
<class,9호선2~3단계,송파나루,2953,2965,5918
<class,9호선2~3단계,한성백제,1551,1312,2863
<class,9호선2~3단계,올림픽공원,4250,4668,8918
<class,9호선2~3단계,둔촌오륜,426,451,877
<class,9호선2~3단계,중앙보훈병원,3099,3129,6228
<class,경강선,판교,2280,2116,4396
<class,경강선,이매,644,453,1097
<class,경강선,삼동,976,903,1879
<class,경강선,경기광주,3410,3474,6884
<class,경강선,초월,1482,1406,2888
<class,경강선,곤지암,1518,1685,3203
<class,경강선,신둔도예촌,858,838,1696
<class,경강선,이천,1969,2225,4194
<class,경강선,부발,1185,1886,3071
<class,경강선,세종대왕릉,281,235,516
<class,경강선,여주,1984,2065,4049
<class,경부선,서울역,5999,1419,7418
<class,경부선,남영,3824,3923,7747
<class,경부선,용산,28100,25536,53636
<class,경부선,노량진,5589,5236,10825
<class,경부선,대방,5017,5376,10393
<class,경부선,영등포,29039,28175,57214
<class,경부선,신도림,1935,2059,3994
<class,경부선,신길,4821,4289,9110
<class,경부선,구로,8868,8823,17691
<class,경부선,가산디지털단지,4525,6585,11110
<class,경부선,금천구청,5677,5637,11314
<class,경부선,석수,4805,4611,9416
<class,경부선,관악,4374,3913,8287
<class,경부선,안양,13409,12885,26294
<class,경부선,명학,3227,3131,6358
<class,경부선,금정,12529,12829,25358
<class,경부선,군포,2758,2729,5487
<class,경부선,의왕,3932,4113,8045
<class,경부선,성균관대,6629,6724,13353
<class,경부선,화서,3585,3555,7140
<class,경부선,수원,30351,29561,59912
<class,경부선,독산,5716,5729,11445
<class,경부선,세류,1869,1851,3720
<class,경부선,병점,8497,9182,17679
<class,경부선,세마,1567,1467,3034
<class,경부선,오산대,1913,1905,3818
<class,경부선,오산,6957,7573,14530
<class,경부선,진위,726,700,1426
<class,경부선,송탄,3430,3928,7358
<class,경부선,서정리,4302,5773,10075
<class,경부선,평택지제,2153,2161,4314
<class,경부선,평택,10716,11444,22160
<class,경부선,성환,2295,2764,5059
<class,경부선,직산,538,621,1159
<class,경부선,두정,4473,4796,9269
<class,경부선,천안,5859,5598,11457
<class,경부선,당정,2705,2600,5305
<class,경부선,서동탄,693,742,1435
<class,경부선,광명,2379,1798,4177
<class,경원선,이촌,1818,1524,3342
<class,경원선,서빙고,989,1107,2096
<class,경원선,한남,1783,1744,3527
<class,경원선,옥수,45,21,66
<class,경원선,응봉,971,885,1856
<class,경원선,왕십리,8548,9604,18152
<class,경원선,청량리,13068,12132,25200
<class,경원선,외대앞,4238,4138,8376
<class,경원선,신이문,4343,4056,8399
<class,경원선,석계,4569,5018,9587
<class,경원선,광운대,3772,3800,7572
<class,경원선,월계,3256,3154,6410
<class,경원선,녹천,2214,1971,4185
<class,경원선,방학,5375,5213,10588
<class,경원선,도봉,3252,3075,6327
<class,경원선,도봉산,8436,6002,14438
<class,경원선,망월사,5193,5118,10311
<class,경원선,회룡,6673,6674,13347
<class,경원선,의정부,12768,13077,25845
<class,경원선,가능,3716,3584,7300
<class,경원선,녹양,2554,2390,4944
<class,경원선,양주,4962,4815,9777
<class,경원선,덕계,1557,1550,3107
<class,경원선,덕정,3139,3391,6530
<class,경원선,지행,3947,3992,7939
<class,경원선,동두천중앙,1889,1849,3738
<class,경원선,보산,1315,1511,2826
<class,경원선,동두천,1255,1568,2823
<class,경원선,소요산,3808,3266,7074
<class,경의선,서울역,1015,977,1992
<class,경의선,신촌,258,267,525
<class,경의선,효창공원앞,1207,1331,2538
<class,경의선,공덕,1692,1444,3136
<class,경의선,서강대,1012,1073,2085
<class,경의선,홍대입구,1365,1596,2961
<class,경의선,가좌,2577,2677,5254
<class,경의선,디지털미디어시티,1268,1246,2514
<class,경의선,수색,821,848,1669
<class,경의선,화전,759,802,1561
<class,경의선,강매,1361,1288,2649
<class,경의선,행신,3989,3698,7687
<class,경의선,능곡,2049,1976,4025
<class,경의선,곡산,344,335,679
<class,경의선,백마,3065,2887,5952
<class,경의선,풍산,3122,2926,6048
<class,경의선,일산,4183,3937,8120
<class,경의선,탄현,3774,3596,7370
<class,경의선,야당,3938,3821,7759
<class,경의선,운정,3223,3082,6305
<class,경의선,금릉,2547,2557,5104
<class,경의선,금촌,3723,4075,7798
<class,경의선,월롱,819,1583,2402
<class,경의선,파주,654,597,1251
<class,경의선,문산,3145,3230,6375
<class,경의선,임진강,44,47,91
<class,경인선,개봉,10353,10566,20919
<class,경인선,오류동,6212,5854,12066
<class,경인선,역곡,12887,12702,25589
<class,경인선,부천,20249,19674,39923
<class,경인선,송내,11897,11515,23412
<class,경인선,부평,20622,21181,41803
<class,경인선,백운,3476,3544,7020
<class,경인선,동암,8689,8585,17274
<class,경인선,주안,10730,9128,19858
<class,경인선,제물포,4958,4702,9660
<class,경인선,동인천,8184,7987,16171
<class,경인선,인천,3180,2525,5705
<class,경인선,구일,2739,2742,5481
<class,경인선,소사,5182,5050,10232
<class,경인선,부개,4299,4063,8362
<class,경인선,간석,2928,2830,5758
<class,경인선,도원,1398,1413,2811
<class,경인선,온수,3256,3129,6385
<class,경인선,중동,4397,4116,8513
<class,경인선,도화,2087,2074,4161
<class,경춘선,신내,814,858,1672
<class,경춘선,갈매,1328,1184,2512
<class,경춘선,별내,1668,1545,3213
<class,경춘선,퇴계원,1959,1766,3725
<class,경춘선,사릉,1605,1584,3189
<class,경춘선,금곡,872,830,1702
<class,경춘선,평내호평,3212,3023,6235
<class,경춘선,천마산,1024,1019,2043
<class,경춘선,마석,2354,2355,4709
<class,경춘선,대성리,593,446,1039
<class,경춘선,청평,1524,1330,2854
<class,경춘선,상천,382,318,700
<class,경춘선,가평,1960,1653,3613
<class,경춘선,굴봉산,171,175,346
<class,경춘선,백양리,103,119,222
<class,경춘선,강촌,769,606,1375
<class,경춘선,김유정,485,474,959
<class,경춘선,남춘천,2973,2965,5938
<class,경춘선,춘천,1790,1374,3164
<class,공항철도 1호선,서울역,6556,5878,12434
<class,공항철도 1호선,공덕,1087,1585,2672
<class,공항철도 1호선,홍대입구,8319,7413,15732
<class,공항철도 1호선,디지털미디어시티,3458,3397,6855
<class,공항철도 1호선,마곡나루,2001,2193,4194
<class,공항철도 1호선,김포공항,10670,6285,16955
<class,공항철도 1호선,계양,4719,4637,9356
<class,공항철도 1호선,검암,3314,3290,6604
<class,공항철도 1호선,청라국제도시,2718,2651,5369
<class,공항철도 1호선,운서,4356,4851,9207
<class,공항철도 1호선,공항화물청사,935,1031,1966
<class,공항철도 1호선,인천공항1터미널,3006,2871,5877
<class,공항철도 1호선,인천공항2터미널,1611,1563,3174
<class,공항철도 1호선,영종,2085,2061,4146
<class,과천선,선바위,3333,3034,6367
<class,과천선,경마공원,801,745,1546
<class,과천선,대공원,4026,4151,8177
<class,과천선,과천,2834,2701,5535
<class,과천선,정부과천청사,3638,3880,7518
<class,과천선,인덕원,9880,10136,20016
<class,과천선,평촌,5485,5465,10950
<class,과천선,범계,13238,12496,25734
<class,분당선,선릉,2682,3833,6515
<class,분당선,한티,7970,7753,15723
<class,분당선,도곡,2306,2204,4510
<class,분당선,구룡,650,787,1437
<class,분당선,개포동,1681,1711,3392
<class,분당선,대모산입구,1987,1932,3919
<class,분당선,수서,7629,7322,14951
<class,분당선,수원,5249,4420,9669
<class,분당선,서울숲,5707,5969,11676
<class,분당선,압구정로데오,9964,10585,20549
<class,분당선,강남구청,3064,3770,6834
<class,분당선,선정릉,2080,2174,4254
<class,분당선,가천대,3574,4238,7812
<class,분당선,태평,7346,6926,14272
<class,분당선,모란,10202,10232,20434
<class,분당선,야탑,11636,11977,23613
<class,분당선,서현,11696,11779,23475
<class,분당선,수내,5202,5194,10396
<class,분당선,정자,6474,6872,13346
<class,분당선,미금,6240,6600,12840
<class,분당선,오리,4950,4269,9219
<class,분당선,이매,2803,2878,5681
<class,분당선,보정,1026,962,1988
<class,분당선,죽전,7388,8138,15526
<class,분당선,구성,2093,2341,4434
<class,분당선,신갈,1811,1897,3708
<class,분당선,기흥,4646,4385,9031
<class,분당선,상갈,2628,2804,5432
<class,분당선,청명,1798,1810,3608
<class,분당선,영통,4243,4272,8515
<class,분당선,망포,5662,6016,11678
<class,분당선,매탄권선,2188,2210,4398
<class,분당선,수원시청,6656,6588,13244
<class,분당선,매교,1355,1359,2714
<class,수인선,고색,1457,1530,2987
<class,수인선,오목천,1452,1378,2830
<class,수인선,어천,512,619,1131
<class,수인선,야목,150,144,294
<class,수인선,사리,2253,1949,4202
<class,수인선,달월,51,64,115
<class,수인선,월곶,1505,1435,2940
<class,수인선,소래포구,5460,5407,10867
<class,수인선,인천논현,2681,2862,5543
<class,수인선,호구포,1762,1804,3566
<class,수인선,남동인더스파크,542,528,1070
<class,수인선,원인재,2614,2748,5362
<class,수인선,연수,2762,2635,5397
<class,수인선,송도,1461,1417,2878
<class,수인선,인하대,3165,2926,6091
<class,수인선,숭의,1828,1674,3502
<class,수인선,신포,1013,1030,2043
<class,수인선,인천,971,1389,2360
<class,안산선,산본,7734,8482,16216
<class,안산선,대야미,2766,2524,5290
<class,우이신설선,정릉,2366,2082,4448
<class,우이신설선,성신여대입구,1994,2168,4162
<class,우이신설선,보문,815,829,1644
<class,우이신설선,신설동,1143,1138,2281
<class,일산선,원흥,4756,4585,9341
<class,일산선,삼송,9777,9421,19198
<class,일산선,원당,5537,5386,10923
<class,일산선,화정,8466,8607,17073
<class,일산선,대곡,931,832,1763
<class,일산선,백석,5017,5042,10059
<class,일산선,마두,3192,3165,6357
<class,일산선,정발산,4311,4237,8548
<class,일산선,주엽,4081,3947,8028
<class,일산선,대화,5797,5472,11269
<class,장항선,봉명,448,483,931
<class,장항선,쌍용,1016,1143,2159
<class,장항선,아산,2954,1987,4941
<class,장항선,배방,819,873,1692
<class,장항선,온양온천,3032,2916,5948
<class,장항선,신창,913,1245,2158
<class,중앙선,회기,13703,13897,27600
<class,중앙선,중랑,3151,2983,6134
<class,중앙선,상봉,3958,3779,7737
<class,중앙선,망우,4474,4431,8905
<class,중앙선,양원,952,997,1949
<class,중앙선,구리,7065,7225,14290
<class,중앙선,도농,4496,4495,8991
<class,중앙선,양정,538,495,1033
<class,중앙선,덕소,3057,3214,6271
<class,중앙선,도심,1185,1129,2314
<class,중앙선,팔당,1344,1332,2676
<class,중앙선,운길산,1242,1134,2376
<class,중앙선,양수,1715,1660,3375
<class,중앙선,신원,251,162,413
<class,중앙선,지평,53,65,118
<class,중앙선,용문,2341,1818,4159
<class,중앙선,원덕,362,279,641
<class,중앙선,양평,2060,1890,3950
<class,중앙선,오빈,231,200,431
<class,중앙선,아신,551,491,1042
<class,중앙선,국수,535,460,995
<class,2호선,구로디지털단지,21091,20810,41901
<class,2호선,대림,13151,13504,26655
<class,2호선,신도림,25865,26181,52046
<class,2호선,문래,7231,7570,14801
<class,2호선,영등포구청,7780,7947,15727
<class,2호선,당산,7746,8479,16225
<class,2호선,합정,18201,19260,37461
<class,2호선,홍대입구,40576,40377,80953
<class,2호선,신촌,19030,18293,37323
<class,2호선,이대,6022,6331,12353
<class,2호선,아현,4656,4751,9407
<class,2호선,충정로,3423,3544,6967
<class,2호선,용답,1616,1654,3270
<class,2호선,신답,648,720,1368
<class,2호선,신설동,2545,1327,3872
<class,2호선,도림천,447,458,905
<class,2호선,양천구청,2818,2932,5750
<class,2호선,신정네거리,4689,4686,9375
<class,2호선,용두,1096,1145,2241
<class,3호선,지축,1760,1820,3580
<class,3호선,구파발,10594,10859,21453
<class,3호선,연신내,19654,18425,38079
<class,3호선,불광,8952,10394,19346
<class,3호선,녹번,6502,5990,12492
<class,3호선,홍제,8059,7693,15752
<class,3호선,무악재,1658,1840,3498
<class,3호선,독립문,3760,4084,7844
<class,3호선,경복궁,10709,11398,22107
<class,3호선,안국,9390,10128,19518
<class,3호선,종로3가,3447,4459,7906
<class,3호선,을지로3가,2681,2627,5308
<class,3호선,충무로,3,0,3
<class,3호선,동대입구,4122,4715,8837
<class,3호선,약수,5641,5583,11224
<class,3호선,금호,3751,3613,7364
<class,3호선,옥수,4460,4756,9216
<class,3호선,압구정,11940,12111,24051
<class,3호선,신사,12456,12484,24940
<class,3호선,잠원,1896,1894,3790
<class,3호선,고속터미널,35206,32974,68180
<class,1호선,시청,6944,6625,13569
<class,3호선,교대,3765,2264,6029
<class,3호선,가락시장,3321,3524,6845
<class,3호선,남부터미널,12939,13590,26529
<class,3호선,양재,12028,14037,26065
<class,1호선,신설동,6801,6696,13497
<class,3호선,매봉,3924,3867,7791
<class,3호선,도곡,1699,1795,3494
<class,3호선,대치,5185,4546,9731
<class,3호선,학여울,1120,1155,2275
<class,3호선,대청,3630,3578,7208
<class,3호선,일원,2834,2984,5818
<class,3호선,수서,9316,9348,18664
<class,1호선,제기동,8639,8994,17633
<class,1호선,청량리,11512,11836,23348
<class,2호선,시청,5324,4342,9666
<class,2호선,을지로입구,13184,12595,25779
<class,2호선,을지로3가,6564,6007,12571
<class,2호선,을지로4가,2798,2727,5525
<class,2호선,동대문역사문화공원,6325,7849,14174
<class,2호선,신당,7414,7750,15164
<class,2호선,상왕십리,6192,6131,12323
<class,2호선,왕십리,8455,7443,15898
<class,2호선,한양대,2557,2662,5219
<class,2호선,뚝섬,8814,8947,17761
<class,1호선,서울역,25130,22780,47910
<class,1호선,동묘앞,11641,11967,23608
<class,1호선,종각,11095,9753,20848
<class,1호선,종로3가,12433,11082,23515
<class,1호선,종로5가,7956,7883,15839
<class,1호선,동대문,8531,9048,17579
<class,2호선,성수,11867,12883,24750
<class,2호선,건대입구,22912,23731,46643
<class,2호선,구의,10468,10318,20786
<class,2호선,강변,19268,18826,38094
<class,2호선,잠실나루,4933,5037,9970
<class,2호선,잠실,44553,41612,86165
<class,2호선,잠실새내,9555,9736,19291
<class,9호선2~3단계,석촌,6613,5447,12060
<class,경춘선,신내,1235,1258,2493
<class,경인선,도화,3228,2943,6171
<class,경인선,중동,6829,6447,13276
<class,경인선,온수,4836,4457,9293
<class,경인선,도원,2092,2109,4201
<class,경인선,간석,4279,4115,8394
<class,경인선,부개,6258,5935,12193
<class,경인선,소사,7689,7562,15251
<class,경인선,구일,4405,4186,8591
<class,경인선,인천,4823,4022,8845
<class,경인선,동인천,12070,11961,24031
<class,경인선,제물포,7489,7273,14762
<class,경인선,주안,15716,14044,29760
<class,경인선,동암,12323,12608,24931
<class,경인선,백운,5670,5535,11205
<class,경인선,부평,29186,31821,61007
<class,경인선,송내,18051,17958,36009
<class,경인선,부천,28873,29677,58550
<class,경인선,역곡,20180,19905,40085
<class,경인선,오류동,9034,8255,17289
<class,경인선,개봉,16763,16530,33293
<class,경의선,임진강,112,87,199
<class,경의선,문산,4614,4647,9261
<class,경의선,파주,900,660,1560
<class,경의선,월롱,1589,1500,3089
<class,경의선,금촌,5634,5613,11247
<class,경의선,금릉,3791,3670,7461
<class,경의선,운정,5192,4902,10094
<class,경의선,야당,5953,5872,11825
<class,경의선,탄현,5539,5319,10858
<class,경의선,일산,7380,7220,14600
<class,경의선,풍산,4369,4202,8571
<class,경의선,백마,4629,4491,9120
<class,경의선,곡산,479,494,973
<class,경의선,능곡,3011,2824,5835
<class,경의선,행신,5314,5373,10687
<class,경의선,강매,2041,1868,3909
<class,경의선,화전,1132,1032,2164
<class,경의선,수색,1510,1419,2929
<class,경의선,디지털미디어시티,1857,1680,3537
<class,경의선,가좌,4021,3811,7832
<class,경의선,홍대입구,1816,2223,4039
<class,경의선,서강대,1764,1611,3375
<class,경의선,공덕,2641,2103,4744
<class,경의선,효창공원앞,1814,1981,3795
<class,경의선,신촌,331,365,696
<class,경의선,서울역,1392,1446,2838
<class,경원선,소요산,5474,4865,10339
<class,경원선,동두천,1584,2190,3774
<class,경원선,보산,1988,1937,3925
<class,경원선,동두천중앙,2634,2633,5267
<class,경원선,지행,5735,5734,11469
<class,경원선,덕정,4387,4189,8576
<class,경원선,덕계,2487,2296,4783
<class,경원선,양주,6776,6448,13224
<class,경원선,녹양,3540,3471,7011
<class,경원선,가능,5322,5111,10433
<class,경원선,의정부,17978,18783,36761
<class,경원선,회룡,10064,10182,20246
<class,경원선,망월사,6704,6860,13564
<class,경원선,도봉산,10572,7193,17765
<class,경원선,도봉,4598,4397,8995
<class,경원선,방학,7742,7373,15115
<class,경원선,녹천,3371,2781,6152
<class,경원선,월계,4822,4451,9273
<class,경원선,광운대,5687,5501,11188
<class,경원선,석계,6813,7277,14090
<class,경원선,신이문,6123,5609,11732
<class,경원선,외대앞,6188,5786,11974
<class,경원선,청량리,16382,17740,34122
<class,경원선,왕십리,12319,13956,26275
<class,경원선,응봉,1456,1253,2709
<class,경원선,옥수,50,38,88
<class,경원선,한남,2711,2674,5385
<class,경원선,서빙고,1950,2489,4439
<class,경원선,이촌,3116,2246,5362
<class,경부선,광명,2929,2719,5648
<class,경부선,서동탄,1055,1129,2184
<class,경부선,당정,4094,3966,8060
<class,경부선,천안,6733,6895,13628
<class,경부선,두정,5755,5937,11692
<class,경부선,직산,678,665,1343
<class,경부선,성환,3084,2892,5976
<class,경부선,평택,14330,13391,27721
<class,경부선,평택지제,3161,3047,6208
<class,경부선,서정리,6651,5666,12317
<class,경부선,송탄,5033,4394,9427
<class,경부선,진위,1119,961,2080
<class,경부선,오산,10071,9458,19529
<class,경부선,오산대,3130,2873,6003
<class,경부선,세마,2290,2079,4369
<class,경부선,병점,12994,12782,25776
<class,경부선,세류,2579,2603,5182
<class,경부선,독산,9061,9017,18078
<class,경부선,수원,38641,41568,80209
<class,경부선,화서,5689,5620,11309
<class,경부선,성균관대,10849,10559,21408
<class,경부선,의왕,6372,6245,12617
<class,경부선,군포,4406,4034,8440
<class,경부선,금정,18848,18797,37645
<class,경부선,명학,5379,5144,10523
<class,경부선,안양,18188,18248,36436
<class,경부선,관악,6108,5840,11948
<class,경부선,석수,6930,6564,13494
<class,경부선,금천구청,8638,8465,17103
<class,경부선,가산디지털단지,6638,8851,15489
<class,경부선,구로,13595,13782,27377
<class,경부선,신길,6433,5438,11871
<class,경부선,신도림,3176,3260,6436
<class,경부선,영등포,37282,38755,76037
<class,경부선,대방,8095,8133,16228
<class,경부선,노량진,8842,8320,17162
<class,경부선,용산,32674,35227,67901
<class,경부선,남영,5869,5839,11708
<class,경부선,서울역,6455,1688,8143
<class,경강선,여주,2481,2837,5318
<class,경강선,세종대왕릉,273,372,645
<class,경강선,부발,1917,1780,3697
<class,경강선,이천,2805,3052,5857
<class,경강선,신둔도예촌,1150,1191,2341
<class,경강선,곤지암,1997,2123,4120
<class,경강선,초월,2320,2058,4378
<class,경강선,경기광주,5176,4868,10044
<class,경강선,삼동,1430,1341,2771
<class,경강선,이매,977,707,1684
<class,경강선,판교,3027,2884,5911
<class,9호선2~3단계,중앙보훈병원,4711,4553,9264
<class,9호선2~3단계,둔촌오륜,597,627,1224
<class,9호선2~3단계,올림픽공원,7289,7646,14935
<class,9호선2~3단계,한성백제,2260,1931,4191
<class,9호선2~3단계,송파나루,3943,4289,8232
<class,9호선2~3단계,석촌고분,4233,3970,8203
<class,9호선2~3단계,삼전,4829,4471,9300
<class,9호선2~3단계,종합운동장,3015,2663,5678
<class,9호선2~3단계,봉은사,10583,11286,21869
<class,9호선2~3단계,삼성중앙,2994,2950,5944
<class,9호선2~3단계,선정릉,4927,5635,10562
<class,9호선2~3단계,언주,5979,6179,12158
<class,9호선,신논현,25082,24415,49497
<class,9호선,사평,2201,2046,4247
<class,9호선,고속터미널,12117,17484,29601
<class,9호선,신반포,2701,2519,5220
<class,9호선,구반포,1659,1757,3416
<class,9호선,동작,1492,1259,2751
<class,9호선,흑석,5625,5490,11115
<class,9호선,노들,3311,2830,6141
<class,9호선,노량진,21292,20717,42009
<class,9호선,샛강,2444,2520,4964
<class,9호선,여의도,11535,11238,22773
<class,9호선,국회의사당,3932,4156,8088
<class,9호선,당산,12588,12032,24620
<class,9호선,선유도,4003,3788,7791
<class,9호선,신목동,2372,2057,4429
<class,9호선,염창,11705,10780,22485
<class,9호선,등촌,7280,7045,14325
<class,9호선,증미,3999,3870,7869
<class,9호선,가양,14236,13453,27689
<class,9호선,양천향교,5846,5668,11514
<class,9호선,마곡나루,7979,7992,15971
<class,9호선,신방화,4673,4504,9177
<class,9호선,공항시장,2121,2286,4407
<class,9호선,김포공항,7935,12714,20649
<class,9호선,개화,1586,1340,2926
<class,8호선,모란,5771,4713,10484
<class,8호선,수진,4044,3618,7662
<class,8호선,신흥,3533,3702,7235
<class,8호선,단대오거리,7438,6986,14424
<class,8호선,남한산성입구,9227,8180,17407
<class,8호선,산성,4763,4840,9603
<class,8호선,복정,7743,6657,14400
<class,8호선,장지,12447,11621,24068
<class,8호선,문정,8765,9035,17800
<class,8호선,가락시장,5028,5184,10212
<class,8호선,송파,5548,5538,11086
<class,8호선,석촌,5948,7130,13078
<class,8호선,잠실,12105,14539,26644
<class,8호선,몽촌토성,5101,5019,10120
<class,8호선,강동구청,6033,6025,12058
<class,8호선,천호,11825,13962,25787
<class,8호선,암사,12210,11298,23508
<class,7호선,부평구청,4886,4478,9364
<class,7호선,굴포천,6622,6968,13590
<class,7호선,삼산체육관,3936,3680,7616
<class,7호선,상동,11129,11478,22607
<class,7호선,부천시청,10129,9822,19951
<class,7호선,신중동,9805,9762,19567
<class,7호선,춘의,5153,5026,10179
<class,7호선,부천종합운동장,3403,3028,6431
<class,7호선,까치울,5599,5621,11220
<class,7호선,온수,5663,5553,11216
<class,7호선,천왕,6881,6523,13404
<class,7호선,광명사거리,16674,16661,33335
<class,7호선,철산,14911,14901,29812
<class,7호선,가산디지털단지,16000,14578,30578
<class,7호선,남구로,8026,8333,16359
<class,7호선,대림,6773,7171,13944
<class,7호선,신풍,8007,7550,15557
<class,7호선,보라매,5812,5739,11551
<class,7호선,신대방삼거리,11084,10267,21351
<class,7호선,장승배기,6370,6173,12543
<class,7호선,상도,7355,6785,14140
<class,7호선,숭실대입구,8727,8538,17265
<class,7호선,남성,7300,6633,13933
<class,7호선,이수,11824,11062,22886
<class,7호선,내방,7571,7441,15012
<class,7호선,고속터미널,13756,10688,24444
<class,7호선,반포,4204,4076,8280
<class,7호선,논현,11098,11871,22969
<class,7호선,학동,11041,11604,22645
<class,7호선,강남구청,9723,10762,20485
<class,7호선,청담,11422,12313,23735
<class,7호선,뚝섬유원지,9025,8581,17606
<class,7호선,건대입구,10477,10693,21170
<class,7호선,어린이대공원,9829,9631,19460
<class,7호선,군자,10542,8027,18569
<class,7호선,중곡,6947,6541,13488
<class,7호선,용마산,4562,4699,9261
<class,7호선,사가정,12475,12134,24609
<class,7호선,면목,11498,11085,22583
<class,7호선,상봉,13080,12444,25524
<class,7호선,중화,7736,7304,15040
<class,7호선,먹골,8152,7884,16036
<class,7호선,태릉입구,6516,5934,12450
<class,7호선,공릉,8835,8495,17330
<class,7호선,하계,12284,11407,23691
<class,7호선,중계,9509,8567,18076
<class,7호선,노원,15197,15825,31022
<class,7호선,마들,8995,8461,17456
<class,7호선,수락산,10351,10073,20424
<class,7호선,도봉산,7157,9984,17141
<class,7호선,장암,1755,1166,2921
<class,6호선,봉화산,5319,5243,10562
<class,6호선,화랑대,7236,5994,13230
<class,6호선,태릉입구,4189,4475,8664
<class,6호선,석계,8827,8710,17537
<class,6호선,돌곶이,5898,5528,11426
<class,6호선,상월곡,4000,3481,7481
<class,6호선,월곡,7253,7041,14294
<class,6호선,고려대,5381,5114,10495
<class,6호선,안암,6507,6362,12869
<class,6호선,보문,5024,4602,9626
<class,6호선,창신,2148,1744,3892
<class,6호선,동묘앞,8033,7659,15692
<class,6호선,신당,5843,4976,10819
<class,6호선,청구,2396,2365,4761
<class,6호선,약수,2407,2496,4903
<class,6호선,버티고개,1149,973,2122
<class,6호선,한강진,8187,10001,18188
<class,6호선,이태원,12729,13568,26297
<class,6호선,녹사평,5161,5418,10579
<class,6호선,삼각지,5334,4126,9460
<class,6호선,효창공원앞,4530,3968,8498
<class,6호선,공덕,10001,9408,19409
<class,6호선,대흥,5235,5215,10450
<class,6호선,광흥창,5079,4656,9735
<class,6호선,상수,7526,8619,16145
<class,6호선,합정,12433,11313,23746
<class,6호선,망원,12687,13964,26651
<class,6호선,마포구청,9797,8283,18080
<class,6호선,월드컵경기장,7284,8014,15298
<class,6호선,디지털미디어시티,7182,7264,14446
<class,6호선,증산,7398,7285,14683
<class,6호선,새절,8996,8432,17428
<class,6호선,구산,5422,4039,9461
<class,6호선,연신내,3,0,3
<class,6호선,독바위,2058,2427,4485
<class,6호선,불광,3817,3651,7468
<class,6호선,역촌,2725,3100,5825
<class,6호선,응암,12697,12311,25008
<class,5호선,하남시청,5112,4912,10024
<class,5호선,하남풍산,2520,2578,5098
<class,5호선,미사,11724,11723,23447
<class,5호선,강일,2627,2463,5090
<class,5호선,마천,4756,4834,9590
<class,5호선,거여,5896,5628,11524
<class,5호선,개롱,4323,4575,8898
<class,5호선,오금,2108,2033,4141
<class,5호선,방이,5019,4980,9999
<class,5호선,올림픽공원,3520,3590,7110
<class,5호선,둔촌동,6313,6230,12543
<class,5호선,상일동,9625,8911,18536
<class,5호선,고덕,6276,6121,12397
<class,5호선,명일,6126,6055,12181
<class,5호선,굽은다리,7109,6794,13903
<class,5호선,길동,5720,5844,11564
<class,5호선,강동,12580,11928,24508
<class,5호선,천호,16580,15628,32208
<class,5호선,광나루,10769,10174,20943
<class,5호선,아차산,12789,12220,25009
<class,5호선,군자,8473,9105,17578
<class,5호선,장한평,11043,10744,21787
<class,5호선,답십리,10055,9227,19282
<class,5호선,마장,3851,3669,7520
<class,5호선,왕십리,3619,4247,7866
<class,5호선,행당,5820,4992,10812
<class,5호선,신금호,4066,4227,8293
<class,5호선,청구,2470,2388,4858
<class,5호선,동대문역사문화공원,989,1273,2262
<class,5호선,을지로4가,3445,3929,7374
<class,5호선,종로3가,12837,12884,25721
<class,5호선,광화문,15028,15179,30207
<class,5호선,서대문,7190,7080,14270
<class,5호선,충정로,1884,1747,3631
<class,5호선,애오개,3754,3476,7230
<class,5호선,공덕,7004,7341,14345
<class,5호선,마포,7177,7118,14295
<class,5호선,여의나루,12449,13604,26053
<class,5호선,여의도,10634,11475,22109
<class,5호선,신길,2509,2686,5195
<class,5호선,영등포시장,7404,7790,15194
<class,5호선,영등포구청,1885,1851,3736
<class,5호선,양평,3730,3456,7186
<class,5호선,오목교,16380,16861,33241
<class,5호선,목동,11310,11326,22636
<class,5호선,신정,8755,7686,16441
<class,5호선,까치산,20946,19992,40938
<class,5호선,화곡,20095,18465,38560
<class,5호선,우장산,9576,9515,19091
<class,5호선,발산,13850,14725,28575
<class,5호선,마곡,5193,5294,10487
<class,5호선,송정,5115,4902,10017
<class,5호선,김포공항,7539,7479,15018
<class,5호선,개화산,3695,3593,7288
<class,5호선,방화,4670,4473,9143
<class,4호선,쌍문,21203,19073,40276
<class,4호선,창동,18821,19775,38596
<class,4호선,노원,15917,17147,33064
<class,4호선,상계,13910,12958,26868
<class,4호선,당고개,9715,9273,18988
<class,4호선,남태령,1103,807,1910
<class,4호선,사당,20548,17627,38175
<class,4호선,총신대입구,14852,15977,30829
<class,4호선,동작,1724,1753,3477
<class,4호선,이촌,6663,7308,13971
<class,4호선,신용산,9797,10611,20408
<class,4호선,삼각지,3508,4664,8172
<class,4호선,숙대입구,8519,8009,16528
<class,4호선,서울역,5313,12179,17492
<class,4호선,회현,17795,19219,37014
<class,4호선,명동,14278,16210,30488
<class,4호선,충무로,13318,13885,27203
<class,4호선,동대문역사문화공원,10697,9367,20064
<class,4호선,동대문,13854,13739,27593
<class,4호선,혜화,26650,26980,53630
<class,4호선,한성대입구,11462,10874,22336
<class,4호선,성신여대입구,16119,15225,31344
<class,4호선,길음,13901,13131,27032
<class,4호선,미아사거리,21975,20965,42940
<class,4호선,미아,10540,9996,20536
<class,4호선,수유,25802,24983,50785
<class,3호선,오금,3609,3445,7054
<class,3호선,경찰병원,3951,3821,7772
<class,3호선,가락시장,5884,5663,11547
<class,3호선,수서,13182,13520,26702
<class,3호선,일원,4742,4684,9426
<class,3호선,대청,5853,5266,11119
<class,3호선,학여울,1283,1288,2571
<class,3호선,대치,9155,8140,17295
<class,3호선,도곡,3391,3448,6839
<class,3호선,매봉,5974,5679,11653
<class,3호선,양재,20681,22591,43272
<class,3호선,남부터미널,20299,20677,40976
<class,3호선,교대,6858,4056,10914
<class,3호선,고속터미널,45283,46730,92013
<class,3호선,잠원,3507,3273,6780
<class,3호선,신사,24316,25218,49534
<class,3호선,압구정,24216,25239,49455
<class,3호선,옥수,7092,7282,14374
<class,3호선,금호,5795,5305,11100
<class,3호선,약수,8872,8487,17359
<class,3호선,동대입구,6326,7211,13537
<class,3호선,충무로,6,0,6
<class,3호선,을지로3가,5147,5561,10708
<class,3호선,종로3가,5882,8448,14330
<class,3호선,안국,16089,18156,34245
<class,3호선,경복궁,18209,19958,38167
<class,3호선,독립문,5811,6261,12072
<class,3호선,무악재,2703,2860,5563
<class,3호선,홍제,12978,12255,25233
<class,3호선,녹번,9991,8931,18922
<class,3호선,불광,12941,14852,27793
<class,3호선,연신내,29744,27854,57598
<class,3호선,구파발,16098,16085,32183
<class,3호선,지축,3075,2865,5940
<class,2호선,용두,1638,1640,3278
<class,2호선,신정네거리,7559,7611,15170
<class,2호선,양천구청,4885,4826,9711
<class,2호선,도림천,746,735,1481
<class,2호선,신설동,3057,3105,6162
<class,2호선,신답,948,1044,1992
<class,2호선,용답,2104,1981,4085
<class,2호선,충정로,5624,5971,11595
<class,2호선,아현,7422,6968,14390
<class,2호선,이대,9787,10279,20066
<class,2호선,신촌,27825,28178,56003
<class,2호선,홍대입구,60260,64158,124418
<class,2호선,합정,26786,29126,55912
<class,2호선,당산,12968,13894,26862
<class,2호선,영등포구청,12797,13263,26060
<class,2호선,문래,12246,12634,24880
<class,2호선,신도림,40268,40546,80814
<class,2호선,대림,17394,18582,35976
<class,2호선,구로디지털단지,33158,32466,65624
<class,2호선,신대방,19577,18781,38358
<class,2호선,신림,48909,46702,95611
<class,2호선,봉천,16504,15392,31896
<class,2호선,서울대입구,37590,36381,73971
<class,2호선,낙성대,21172,19569,40741
<class,2호선,사당,29594,33149,62743
<class,2호선,방배,9723,10203,19926
<class,2호선,서초,10167,8477,18644
<class,2호선,교대,17063,19234,36297
<class,2호선,강남,57308,57246,114554
<class,2호선,역삼,17735,19281,37016
<class,2호선,선릉,23859,20972,44831
<class,2호선,삼성,27743,28348,56091
<class,2호선,종합운동장,6781,7272,14053
<class,2호선,잠실새내,16137,16682,32819
<class,2호선,잠실,64989,61557,126546
<class,2호선,잠실나루,7401,7267,14668
<class,2호선,강변,26733,27531,54264
<class,2호선,구의,15976,15217,31193
<class,2호선,건대입구,33038,35149,68187
<class,2호선,성수,19166,21052,40218
<class,2호선,뚝섬,13910,14019,27929
<class,2호선,한양대,3893,4110,8003
<class,2호선,왕십리,13516,11399,24915
<class,2호선,상왕십리,9427,8846,18273
<class,2호선,신당,10680,10980,21660
<class,2호선,동대문역사문화공원,9566,11064,20630
<class,2호선,을지로4가,7341,7487,14828
<class,2호선,을지로3가,10651,10265,20916
<class,2호선,을지로입구,19413,19083,38496
<class,2호선,시청,9181,8091,17272
<class,1호선,청량리,18390,18557,36947
<class,1호선,제기동,15448,15893,31341
<class,1호선,신설동,9326,8898,18224
<class,1호선,동대문,10697,10207,20904
<class,1호선,종로5가,18293,18518,36811
<class,1호선,종로3가,23230,21555,44785
<class,1호선,시청,10925,11168,22093
<class,1호선,동묘앞,11985,12393,24378
<class,1호선,서울역,31208,31936,63144
<class,5호선,하남검단산,5117,5146,10263
<class,1호선,종각,18820,16799,35619
<class,장항선,봉명,736,678,1414
<class,일산선,대화,8571,7668,16239
<class,일산선,주엽,6494,6426,12920
<class,일산선,정발산,6305,6531,12836
<class,일산선,마두,5191,5238,10429
<class,일산선,백석,7475,7655,15130
<class,일산선,대곡,1399,1263,2662
<class,일산선,화정,13061,13464,26525
<class,일산선,원당,8735,8279,17014
<class,일산선,삼송,14032,13514,27546
<class,일산선,원흥,7265,7007,14272
<class,우이신설선,신설동,1372,1313,2685
<class,우이신설선,보문,1140,1104,2244
<class,우이신설선,성신여대입구,2681,3081,5762
<class,우이신설선,정릉,3584,2849,6433
<class,우이신설선,북한산보국문,4608,4157,8765
<class,우이신설선,솔샘,3826,3541,7367
<class,우이신설선,삼양사거리,1886,1863,3749
<class,우이신설선,삼양,1556,1669,3225
<class,우이신설선,화계,2622,2369,4991
<class,우이신설선,가오리,2984,2900,5884
<class,우이신설선,4.19민주묘지,2507,2150,4657
<class,우이신설선,솔밭공원,1854,1730,3584
<class,우이신설선,북한산우이,4208,4138,8346
<class,안산선,수리산,2926,2812,5738
<class,안산선,오이도,8217,8390,16607
<class,안산선,정왕,6361,6450,12811
<class,안산선,신길온천,1489,1399,2888
<class,안산선,안산,9477,9915,19392
<class,안산선,초지,3330,3365,6695
<class,안산선,고잔,6568,6691,13259
<class,안산선,중앙,16451,16898,33349
<class,안산선,한대앞,7342,7304,14646
<class,안산선,상록수,12528,12291,24819
<class,안산선,반월,3507,3262,6769
<class,안산선,대야미,4052,3534,7586
<class,안산선,산본,12417,13184,25601
<class,수인선,인천,1351,2128,3479
<class,수인선,신포,1457,1525,2982
<class,수인선,숭의,2850,2693,5543
<class,수인선,인하대,4260,3969,8229
<class,수인선,송도,2153,2057,4210
<class,수인선,연수,3823,3804,7627
<class,수인선,원인재,3813,3951,7764
<class,수인선,남동인더스파크,1091,986,2077
<class,수인선,호구포,2514,2437,4951
<class,수인선,인천논현,4408,4516,8924
<class,수인선,소래포구,8397,8711,17108
<class,수인선,월곶,2222,2108,4330
<class,수인선,달월,70,71,141
<class,수인선,사리,3516,3046,6562
<class,수인선,야목,237,214,451
<class,수인선,어천,807,692,1499
<class,수인선,오목천,2063,1858,3921
<class,수인선,고색,2341,2375,4716
<class,분당선,매교,2090,2070,4160
<class,분당선,수원시청,11199,11804,23003
<class,분당선,매탄권선,3524,3269,6793
<class,분당선,망포,9368,8585,17953
<class,분당선,영통,6656,6414,13070
<class,분당선,청명,2802,2751,5553
<class,분당선,상갈,4180,4198,8378
<class,분당선,기흥,6799,6353,13152
<class,분당선,신갈,2819,2878,5697
<class,분당선,구성,3340,3517,6857
<class,분당선,죽전,10601,11669,22270
<class,분당선,보정,1629,1475,3104
<class,분당선,이매,4481,4546,9027
<class,분당선,오리,8071,6567,14638
<class,분당선,미금,10899,11323,22222
<class,분당선,정자,10649,10831,21480
<class,분당선,수내,8417,8016,16433
<class,분당선,서현,18370,18275,36645
<class,분당선,야탑,17844,18566,36410
<class,분당선,모란,21411,20948,42359
<class,분당선,태평,10961,10130,21091
<class,분당선,가천대,6169,6506,12675
<class,분당선,선정릉,3606,3703,7309
<class,분당선,강남구청,5248,6581,11829
<class,분당선,압구정로데오,18271,20536,38807
<class,분당선,서울숲,9323,8289,17612
<class,분당선,수원,7518,6675,14193
<class,분당선,수서,10455,11011,21466
<class,분당선,대모산입구,3021,2856,5877
<class,분당선,개포동,2720,2688,5408
<class,분당선,구룡,1460,1392,2852
<class,분당선,도곡,4737,4065,8802
<class,분당선,한티,11964,11448,23412
<class,분당선,선릉,5058,7990,13048
<class,과천선,범계,20110,19563,39673
<class,과천선,평촌,9569,9238,18807
<class,과천선,인덕원,15943,15516,31459
<class,과천선,정부과천청사,5927,6019,11946
<class,과천선,과천,4356,3848,8204
<class,과천선,대공원,7626,8101,15727
<class,과천선,경마공원,1373,1308,2681
<class,과천선,선바위,5209,4710,9919
<class,공항철도 1호선,영종,2918,3013,5931
<class,공항철도 1호선,인천공항2터미널,1847,1675,3522
<class,공항철도 1호선,인천공항1터미널,3404,3373,6777
<class,공항철도 1호선,공항화물청사,1286,1363,2649
<class,장항선,쌍용,1922,1703,3625
<class,장항선,아산,3106,2948,6054
<class,장항선,배방,1117,1071,2188
<class,장항선,온양온천,3963,4113,8076
<class,장항선,신창,1470,1266,2736
<class,중앙선,회기,19463,18448,37911
<class,공항철도 1호선,운서,5986,5810,11796
<class,공항철도 1호선,청라국제도시,4182,4108,8290
<class,공항철도 1호선,검암,4757,4712,9469
<class,공항철도 1호선,계양,7019,6529,13548
<class,공항철도 1호선,김포공항,11692,6115,17807
<class,공항철도 1호선,마곡나루,3473,3575,7048
<class,공항철도 1호선,디지털미디어시티,5393,5122,10515
<class,공항철도 1호선,홍대입구,11556,11031,22587
<class,공항철도 1호선,공덕,1459,2319,3778
<class,공항철도 1호선,서울역,7378,7629,15007
<class,경춘선,춘천,2395,2170,4565
<class,경춘선,남춘천,2886,3316,6202
<class,경춘선,김유정,621,824,1445
<class,경춘선,강촌,881,944,1825
<class,경춘선,백양리,132,216,348
<class,경춘선,굴봉산,214,202,416
<class,경춘선,가평,2769,3084,5853
<class,경춘선,상천,464,363,827
<class,경춘선,청평,1749,1869,3618
<class,경춘선,대성리,721,726,1447
<class,경춘선,마석,3621,3714,7335
<class,경춘선,천마산,1400,1403,2803
<class,경춘선,평내호평,4931,4731,9662
<class,경춘선,금곡,1184,1117,2301
<class,경춘선,사릉,2357,2312,4669
<class,경춘선,퇴계원,2845,2611,5456
<class,중앙선,중랑,4516,4313,8829
<class,중앙선,상봉,5306,5145,10451
<class,중앙선,망우,6582,6339,12921
<class,중앙선,양원,1418,1401,2819
<class,중앙선,구리,10816,11082,21898
<class,중앙선,도농,7072,6840,13912
<class,중앙선,양정,838,799,1637
<class,중앙선,덕소,4840,5016,9856
<class,중앙선,도심,1695,1500,3195
<class,중앙선,팔당,1558,1711,3269
<class,중앙선,운길산,1504,1416,2920
<class,중앙선,양수,2382,2456,4838
<class,중앙선,신원,305,247,552
<class,중앙선,국수,798,800,1598
<class,중앙선,아신,747,734,1481
<class,중앙선,오빈,321,374,695
<class,중앙선,양평,4855,4996,9851
<class,중앙선,원덕,453,469,922
<class,중앙선,용문,2660,3081,5741
<class,중앙선,지평,36,62,98
<class,경춘선,별내,2547,2411,4958
<class,경춘선,갈매,2064,1725,3789
<class,경인선,온수,3714,3559,7273
<class,경인선,도원,1553,1601,3154
<class,경인선,간석,3146,2965,6111
<class,경인선,부개,4702,4450,9152
<class,경인선,소사,6024,5718,11742
<class,경인선,구일,3111,3089,6200
<class,경인선,인천,4433,3770,8203
<class,경인선,동인천,9476,9167,18643
<class,경인선,제물포,5505,5358,10863
<class,경인선,주안,11405,10042,21447
<class,경인선,동암,9590,9586,19176
<class,경인선,백운,3923,3799,7722
<class,경인선,부평,22112,22793,44905
<class,경인선,송내,13159,12867,26026
<class,경인선,부천,21559,21085,42644
<class,경인선,역곡,14034,13868,27902
<class,경인선,오류동,6944,6503,13447
<class,경인선,개봉,11599,11531,23130
<class,경의선,임진강,74,56,130
<class,경의선,문산,4099,4184,8283
<class,경의선,파주,669,593,1262
<class,경의선,월롱,924,1730,2654
<class,경의선,금촌,4175,4394,8569
<class,경의선,금릉,2814,2878,5692
<class,경의선,운정,3657,3513,7170
<class,7호선,상봉,8871,8364,17235
<class,7호선,면목,7711,7784,15495
<class,7호선,사가정,8908,8635,17543
<class,7호선,용마산,3182,3461,6643
<class,7호선,중곡,5024,4893,9917
<class,7호선,군자,7308,5771,13079
<class,7호선,어린이대공원,7342,7608,14950
<class,7호선,건대입구,6983,7415,14398
<class,7호선,뚝섬유원지,7568,7040,14608
<class,7호선,청담,6702,7074,13776
<class,7호선,강남구청,5851,6375,12226
<class,7호선,학동,6162,6497,12659
<class,7호선,논현,6051,6433,12484
<class,7호선,반포,2597,2655,5252
<class,7호선,고속터미널,11919,7654,19573
<class,7호선,내방,4912,5017,9929
<class,7호선,이수,7894,7700,15594
<class,7호선,남성,5065,5051,10116
<class,7호선,숭실대입구,5418,5793,11211
<class,7호선,상도,5026,4942,9968
<class,7호선,장승배기,4562,4477,9039
<class,7호선,신대방삼거리,7524,7464,14988
<class,7호선,보라매,4071,4129,8200
<class,7호선,신풍,6119,5818,11937
<class,7호선,대림,6887,6594,13481
<class,7호선,남구로,6386,6205,12591
<class,7호선,가산디지털단지,11975,10889,22864
<class,7호선,철산,10102,10026,20128
<class,7호선,광명사거리,11950,11906,23856
<class,7호선,천왕,4758,4596,9354
<class,7호선,온수,3984,4046,8030
<class,7호선,까치울,4218,4226,8444
<class,7호선,부천종합운동장,2400,2218,4618
<class,7호선,춘의,3525,3252,6777
<class,7호선,신중동,6650,6506,13156
<class,7호선,부천시청,7067,6818,13885
<class,7호선,상동,7460,7351,14811
<class,7호선,삼산체육관,2802,2642,5444
<class,7호선,굴포천,4615,4601,9216
<class,7호선,부평구청,3589,3274,6863
<class,8호선,암사,8554,8249,16803
<class,8호선,천호,8532,9793,18325
<class,8호선,강동구청,4261,4378,8639
<class,8호선,몽촌토성,4030,3999,8029
<class,8호선,잠실,9457,10850,20307
<class,8호선,석촌,4038,5027,9065
<class,8호선,송파,3353,3504,6857
<class,8호선,가락시장,3007,3587,6594
<class,8호선,문정,5619,5974,11593
<class,8호선,장지,8772,9030,17802
<class,8호선,복정,5115,4774,9889
<class,8호선,산성,3648,3630,7278
<class,8호선,남한산성입구,6899,6439,13338
<class,8호선,단대오거리,5653,5521,11174
<class,8호선,신흥,2702,2921,5623
<class,8호선,수진,2895,2581,5476
<class,8호선,모란,4802,4091,8893
<class,9호선,개화,1229,1122,2351
<class,9호선,김포공항,7248,11702,18950
<class,9호선,공항시장,1675,1913,3588
<class,9호선,신방화,3296,3182,6478
<class,9호선,마곡나루,5639,5786,11425
<class,9호선,양천향교,4191,4358,8549
<class,9호선,가양,9792,9897,19689
<class,9호선,증미,2360,2336,4696
<class,9호선,등촌,4994,5001,9995
<class,9호선,염창,8188,8178,16366
<class,9호선,신목동,1672,1529,3201
<class,9호선,선유도,2920,2842,5762
<class,9호선,당산,8548,8561,17109
<class,9호선,국회의사당,4050,3974,8024
<class,9호선,여의도,8537,7824,16361
<class,9호선,샛강,1603,1642,3245
<class,9호선,노량진,14200,15247,29447
<class,9호선,노들,2450,2244,4694
<class,9호선,흑석,3529,3637,7166
<class,9호선,동작,1122,1003,2125
<class,9호선,신반포,1543,1668,3211
<class,9호선,고속터미널,9919,13239,23158
<class,9호선,사평,1399,1436,2835
<class,9호선,신논현,14608,13624,28232
<class,9호선2~3단계,언주,3609,3694,7303
<class,9호선2~3단계,선정릉,2968,3391,6359
<class,9호선2~3단계,삼성중앙,1886,1965,3851
<class,9호선2~3단계,봉은사,6905,7025,13930
<class,9호선2~3단계,종합운동장,2010,1820,3830
<class,9호선2~3단계,삼전,3374,3289,6663
<class,9호선2~3단계,석촌고분,2932,2849,5781
<class,9호선2~3단계,석촌,4598,3972,8570
<class,9호선2~3단계,송파나루,2824,3114,5938
<class,9호선2~3단계,한성백제,1851,1515,3366
<class,9호선2~3단계,올림픽공원,6098,6567,12665
<class,9호선2~3단계,둔촌오륜,443,440,883
<class,9호선2~3단계,중앙보훈병원,3103,3169,6272
<class,경강선,판교,2330,2187,4517
<class,경강선,이매,720,460,1180
<class,경강선,삼동,1049,1017,2066
<class,경강선,경기광주,3797,3793,7590
<class,경강선,초월,1767,1651,3418
<class,경강선,곤지암,1629,1769,3398
<class,경강선,신둔도예촌,1005,919,1924
<class,경의선,야당,4447,4280,8727
<class,경의선,탄현,4225,3916,8141
<class,경의선,일산,4716,4428,9144
<class,경의선,풍산,3355,3215,6570
<class,경의선,백마,3310,3313,6623
<class,경의선,곡산,342,361,703
<class,경의선,능곡,2222,2189,4411
<class,경의선,행신,4312,4134,8446
<class,경의선,강매,1528,1405,2933
<class,경의선,화전,885,924,1809
<class,경의선,수색,1008,1024,2032
<class,경의선,디지털미디어시티,1347,1253,2600
<class,경강선,이천,2116,2345,4461
<class,경강선,부발,1391,1935,3326
<class,경강선,세종대왕릉,344,285,629
<class,경강선,여주,2186,2265,4451
<class,경부선,서울역,6931,1571,8502
<class,경부선,남영,4052,4380,8432
<class,경부선,용산,29989,27067,57056
<class,경부선,노량진,6134,5820,11954
<class,경부선,대방,5711,6013,11724
<class,경부선,영등포,29756,28794,58550
<class,경부선,신도림,2265,2431,4696
<class,경부선,신길,4896,4265,9161
<class,경부선,구로,10007,10211,20218
<class,경부선,가산디지털단지,5008,7066,12074
<class,경부선,금천구청,6468,6346,12814
<class,경부선,석수,5451,5113,10564
<class,경부선,관악,5068,4443,9511
<class,경부선,안양,13656,13554,27210
<class,경부선,명학,3559,3498,7057
<class,경부선,금정,13707,14186,27893
<class,경부선,군포,3087,2929,6016
<class,경부선,의왕,4450,4613,9063
<class,경부선,성균관대,7468,7940,15408
<class,경부선,화서,4316,4135,8451
<class,경부선,수원,34743,33467,68210
<class,경부선,독산,6175,6175,12350
<class,경부선,세류,2103,2103,4206
<class,경부선,병점,9394,10233,19627
<class,경부선,세마,1771,1692,3463
<class,경부선,오산대,2489,2337,4826
<class,경부선,오산,7509,8024,15533
<class,경부선,진위,863,810,1673
<class,중앙선,지평,58,45,103
<class,중앙선,용문,2867,2300,5167
<class,중앙선,원덕,474,365,839
<class,중앙선,양평,2441,2194,4635
<class,경의선,가좌,2889,2917,5806
<class,경의선,홍대입구,1603,1803,3406
<class,경의선,서강대,1158,1198,2356
<class,경의선,공덕,1785,1490,3275
<class,경의선,효창공원앞,1285,1464,2749
<class,경의선,신촌,250,263,513
<class,경의선,서울역,1118,982,2100
<class,경원선,소요산,5848,5159,11007
<class,경원선,동두천,1406,1772,3178
<class,경원선,보산,1416,1564,2980
<class,경원선,동두천중앙,2180,2020,4200
<class,경원선,지행,4401,4357,8758
<class,경원선,덕정,3366,3400,6766
<class,경원선,덕계,1737,1710,3447
<class,경원선,양주,5258,5116,10374
<class,경원선,녹양,2758,2696,5454
<class,경원선,가능,4181,3806,7987
<class,경원선,의정부,13686,13920,27606
<class,경원선,회룡,7450,7506,14956
<class,경원선,망월사,5224,5369,10593
<class,경원선,도봉산,10540,7733,18273
<class,경원선,도봉,3558,3304,6862
<class,경원선,방학,5710,5492,11202
<class,경원선,녹천,2565,2185,4750
<class,경부선,송탄,3609,4156,7765
<class,경부선,서정리,4509,6190,10699
<class,경부선,평택지제,2429,2317,4746
<class,경부선,평택,11808,12656,24464
<class,경부선,성환,2360,2779,5139
<class,경부선,직산,596,635,1231
<class,경부선,두정,4985,5471,10456
<class,경부선,천안,6883,6615,13498
<class,경부선,당정,3142,3123,6265
<class,경부선,서동탄,786,780,1566
<class,경부선,광명,2824,2017,4841
<class,경원선,이촌,2173,1651,3824
<class,경원선,서빙고,1179,1279,2458
<class,경원선,한남,1861,1857,3718
<class,경원선,옥수,47,25,72
<class,경원선,응봉,1082,994,2076
<class,경원선,왕십리,8480,9775,18255
<class,경원선,청량리,13895,13148,27043
<class,경원선,외대앞,4396,4255,8651
<class,경원선,신이문,4612,4401,9013
<class,6호선,새절,6268,6038,12306
<class,1호선,서울역,26214,23809,50023
<class,1호선,동묘앞,13042,13347,26389
<class,1호선,시청,8144,7899,16043
<class,1호선,종각,12329,10701,23030
<class,1호선,종로3가,14155,12196,26351
<class,1호선,종로5가,8873,8917,17790
<class,1호선,동대문,9513,10138,19651
<class,1호선,신설동,7351,7372,14723
<class,1호선,제기동,9856,10339,20195
<class,1호선,청량리,12880,13105,25985
<class,2호선,시청,5954,5126,11080
<class,2호선,을지로입구,14474,13428,27902
<class,2호선,을지로3가,7225,6916,14141
<class,2호선,을지로4가,3249,3262,6511
<class,2호선,동대문역사문화공원,7312,9181,16493
<class,2호선,신당,7919,8336,16255
<class,2호선,상왕십리,6572,6550,13122
<class,2호선,왕십리,8916,7746,16662
<class,2호선,한양대,2175,2490,4665
<class,2호선,뚝섬,10108,10270,20378
<class,2호선,성수,12838,14168,27006
<class,2호선,건대입구,24926,25678,50604
<class,2호선,구의,10985,10990,21975
<class,2호선,강변,22151,20990,43141
<class,2호선,잠실나루,5045,5185,10230
<class,2호선,잠실,48901,45286,94187
<class,2호선,잠실새내,10320,10732,21052
<class,2호선,종합운동장,6427,6614,13041
<class,2호선,삼성,19067,18657,37724
<class,2호선,선릉,12921,11224,24145
<class,2호선,역삼,9850,10844,20694
<class,경원선,월계,3565,3333,6898
<class,안산선,신길온천,1167,1090,2257
<class,안산선,안산,9362,8742,18104
<class,안산선,초지,2366,2256,4622
<class,안산선,고잔,4820,4646,9466
<class,안산선,중앙,11667,11589,23256
<class,안산선,한대앞,5175,5183,10358
<class,안산선,상록수,9000,8935,17935
<class,안산선,반월,2494,2488,4982
<class,2호선,강남,33739,32249,65988
<class,2호선,교대,10112,11088,21200
<class,2호선,서초,9548,8778,18326
<class,2호선,방배,6401,6754,13155
<class,2호선,사당,21032,23407,44439
<class,2호선,낙성대,15093,15397,30490
<class,2호선,서울대입구,26187,27373,53560
<class,2호선,봉천,11808,11591,23399
<class,2호선,신림,35397,35047,70444
<class,2호선,신대방,14667,14623,29290
<class,2호선,구로디지털단지,22551,22283,44834
<class,2호선,대림,14551,14903,29454
<class,2호선,신도림,28408,28787,57195
<class,2호선,문래,7616,8122,15738
<class,2호선,영등포구청,8315,8575,16890
<class,2호선,당산,8812,9523,18335
<class,2호선,합정,19226,20600,39826
<class,2호선,홍대입구,44831,44711,89542
<class,2호선,신촌,19646,18990,38636
<class,2호선,이대,6748,7214,13962
<class,2호선,아현,4904,4963,9867
<class,2호선,충정로,3754,3987,7741
<class,2호선,용답,1574,1577,3151
<class,2호선,신답,753,747,1500
<class,2호선,신설동,2883,2911,5794
<class,2호선,도림천,464,552,1016
<class,2호선,양천구청,3687,3856,7543
<class,2호선,신정네거리,5218,5215,10433
<class,2호선,용두,1070,1018,2088
<class,3호선,지축,2074,2005,4079
<class,3호선,구파발,11946,12356,24302
<class,3호선,연신내,21047,19650,40697
<class,경원선,석계,4866,5360,10226
<class,3호선,불광,9888,11548,21436
<class,3호선,녹번,7008,6431,13439
<class,3호선,홍제,9032,8674,17706
<class,3호선,무악재,1852,2009,3861
<class,3호선,독립문,4315,4849,9164
<class,3호선,경복궁,13792,15004,28796
<class,3호선,안국,11907,12702,24609
<class,3호선,종로3가,3830,4874,8704
<class,3호선,을지로3가,3116,2985,6101
<class,3호선,동대입구,6851,7080,13931
<class,3호선,약수,6136,6141,12277
<class,3호선,금호,4178,4078,8256
<class,3호선,옥수,4816,5157,9973
<class,3호선,압구정,12854,13185,26039
<class,3호선,신사,13492,13543,27035
<class,3호선,잠원,2146,2151,4297
<class,3호선,고속터미널,37868,35168,73036
<class,3호선,교대,4251,2528,6779
<class,3호선,남부터미널,14248,15050,29298
<class,3호선,양재,12957,14851,27808
<class,3호선,매봉,3946,3948,7894
<class,3호선,도곡,1751,1842,3593
<class,3호선,대치,5666,4981,10647
<class,3호선,학여울,1039,1069,2108
<class,3호선,대청,3914,3847,7761
<class,3호선,일원,3023,3256,6279
<class,3호선,수서,9813,9731,19544
<class,3호선,가락시장,3471,3695,7166
<class,3호선,경찰병원,2583,2652,5235
<class,3호선,오금,2614,2547,5161
<class,4호선,수유,19003,18220,37223
<class,4호선,미아,7541,7270,14811
<class,4호선,미아사거리,15798,15112,30910
<class,4호선,길음,9855,9655,19510
<class,4호선,성신여대입구,11718,11130,22848
<class,4호선,한성대입구,7359,7404,14763
<class,4호선,혜화,20327,21194,41521
<class,4호선,동대문,7195,7536,14731
<class,4호선,동대문역사문화공원,8261,7864,16125
<class,4호선,충무로,8869,8892,17761
<class,4호선,명동,11042,11195,22237
<class,4호선,회현,8217,8747,16964
<class,4호선,서울역,3946,9276,13222
<class,4호선,숙대입구,6035,5978,12013
<class,4호선,삼각지,2431,3215,5646
<class,4호선,신용산,7437,7375,14812
<class,4호선,이촌,4574,5021,9595
<class,4호선,동작,1375,1371,2746
<class,4호선,총신대입구,10464,11351,21815
<class,4호선,사당,14496,13615,28111
<class,4호선,남태령,744,510,1254
<class,4호선,당고개,7473,7030,14503
<class,4호선,상계,10116,9385,19501
<class,4호선,노원,11194,12226,23420
<class,4호선,창동,13546,14213,27759
<class,4호선,쌍문,15162,13719,28881
<class,5호선,방화,3538,3457,6995
<class,5호선,개화산,2688,2727,5415
<class,5호선,김포공항,6786,6591,13377
<class,5호선,송정,3590,3557,7147
<class,5호선,마곡,3349,3411,6760
<class,5호선,발산,9167,9696,18863
<class,5호선,우장산,6557,6707,13264
<class,5호선,화곡,13738,13105,26843
<class,5호선,까치산,15214,14884,30098
<class,5호선,신정,6147,5589,11736
<class,5호선,목동,7406,7744,15150
<class,5호선,오목교,11321,11611,22932
<class,5호선,양평,2515,2562,5077
<class,5호선,영등포구청,1248,1292,2540
<class,5호선,영등포시장,4704,4839,9543
<class,5호선,신길,1717,1929,3646
<class,5호선,여의도,7429,7704,15133
<class,5호선,여의나루,10962,11209,22171
<class,5호선,마포,4651,4595,9246
<class,5호선,공덕,4501,4442,8943
<class,5호선,애오개,2468,2430,4898
<class,5호선,충정로,1410,1389,2799
<class,5호선,서대문,5384,5454,10838
<class,5호선,광화문,11180,10944,22124
<class,5호선,종로3가,8855,8069,16924
<class,5호선,을지로4가,1564,1686,3250
<class,5호선,동대문역사문화공원,635,796,1431
<class,5호선,청구,1692,1707,3399
<class,5호선,신금호,2943,3226,6169
<class,5호선,행당,4000,3643,7643
<class,5호선,왕십리,2342,2842,5184
<class,5호선,마장,2753,2611,5364
<class,5호선,답십리,7157,6695,13852
<class,5호선,장한평,7216,7200,14416
<class,5호선,군자,5832,6350,12182
<class,5호선,아차산,10835,10724,21559
<class,5호선,광나루,7516,7280,14796
<class,5호선,천호,11972,11217,23189
<class,5호선,강동,8719,8639,17358
<class,5호선,길동,3987,4186,8173
<class,5호선,굽은다리,5030,4726,9756
<class,5호선,명일,4476,4439,8915
<class,5호선,고덕,4053,4065,8118
<class,5호선,상일동,6646,6434,13080
<class,5호선,둔촌동,4265,4408,8673
<class,5호선,올림픽공원,2684,2821,5505
<class,5호선,방이,3729,3502,7231
<class,5호선,오금,1558,1474,3032
<class,5호선,개롱,2773,3190,5963
<class,5호선,거여,3963,3872,7835
<class,5호선,마천,3495,3792,7287
<class,5호선,강일,1998,1838,3836
<class,5호선,미사,8634,8746,17380
<class,5호선,하남풍산,1971,2052,4023
<class,5호선,하남시청,3913,3667,7580
<class,5호선,하남검단산,4453,4528,8981
<class,6호선,응암,9062,8950,18012
<class,6호선,역촌,1873,2295,4168
<class,6호선,불광,3021,2876,5897
<class,6호선,독바위,1562,1905,3467
<class,경원선,광운대,4039,4215,8254
<class,6호선,구산,3715,2812,6527
<class,6호선,증산,5374,5392,10766
<class,6호선,디지털미디어시티,4906,5227,10133
<class,6호선,월드컵경기장,6289,6973,13262
<class,6호선,마포구청,7175,6274,13449
<class,6호선,망원,9364,9932,19296
<class,6호선,합정,9007,8002,17009
<class,6호선,상수,5287,6141,11428
<class,6호선,광흥창,3899,3757,7656
<class,6호선,대흥,3534,3612,7146
<class,6호선,공덕,6653,6002,12655
<class,6호선,효창공원앞,3237,2867,6104
<class,안산선,정왕,5090,5493,10583
<class,안산선,오이도,6447,6452,12899
<class,안산선,수리산,2136,2128,4264
<class,우이신설선,북한산우이,3962,3872,7834
<class,우이신설선,솔밭공원,1374,1408,2782
<class,우이신설선,4.19민주묘지,2094,1695,3789
<class,우이신설선,가오리,2347,2219,4566
<class,우이신설선,화계,1946,1791,3737
<class,우이신설선,삼양,1179,1209,2388
<class,우이신설선,삼양사거리,1378,1408,2786
<class,우이신설선,솔샘,2829,2600,5429
<class,우이신설선,북한산보국문,3649,3331,6980
<class,우이신설선,정릉,2596,2238,4834
<class,우이신설선,성신여대입구,2072,2344,4416
<class,우이신설선,보문,872,867,1739
<class,우이신설선,신설동,1132,1159,2291
<class,일산선,원흥,5291,5105,10396
<class,일산선,삼송,10678,10468,21146
<class,일산선,원당,6192,6081,12273
<class,일산선,화정,9345,9508,18853
<class,안산선,대야미,3078,2760,5838
<class,안산선,산본,8515,8933,17448
<class,수인선,인천,1258,1870,3128
<class,수인선,신포,1143,1156,2299
<class,수인선,숭의,2117,1880,3997
<class,수인선,인하대,3188,3136,6324
<class,수인선,송도,1596,1554,3150
<class,수인선,연수,2931,2824,5755
<class,수인선,원인재,2804,2966,5770
<class,수인선,남동인더스파크,562,559,1121
<class,수인선,호구포,1822,1896,3718
<class,수인선,인천논현,2875,2939,5814
<class,수인선,소래포구,7102,6929,14031
<class,수인선,월곶,1775,1595,3370
<class,수인선,달월,61,70,131
<class,수인선,사리,2619,2292,4911
<class,수인선,야목,190,158,348
<class,수인선,어천,569,709,1278
<class,수인선,오목천,1557,1486,3043
<class,수인선,고색,1683,1882,3565
<class,일산선,대곡,1136,921,2057
<class,6호선,삼각지,3587,2873,6460
<class,일산선,백석,5461,5403,10864
<class,6호선,녹사평,3723,3692,7415
<class,6호선,이태원,9104,8512,17616
<class,6호선,한강진,5867,6852,12719
<class,6호선,버티고개,819,750,1569
<class,6호선,약수,1607,1656,3263
<class,6호선,청구,1694,1587,3281
<class,6호선,신당,3843,4420,8263
<class,6호선,동묘앞,6504,6224,12728
<class,6호선,창신,1581,1386,2967
<class,6호선,보문,3674,3489,7163
<class,6호선,안암,4318,4705,9023
<class,6호선,고려대,3728,3584,7312
<class,6호선,월곡,5024,4946,9970
<class,6호선,상월곡,3154,2928,6082
<class,6호선,돌곶이,4373,4046,8419
<class,6호선,석계,6311,6521,12832
<class,6호선,태릉입구,3027,3175,6202
<class,6호선,화랑대,4990,4467,9457
<class,9호선,구반포,947,981,1928
<class,6호선,봉화산,3874,3712,7586
<class,7호선,장암,1440,1048,2488
<class,7호선,도봉산,6054,8743,14797
<class,7호선,수락산,8283,8278,16561
<class,7호선,마들,5815,5509,11324
<class,7호선,노원,10532,10517,21049
<class,7호선,중계,6614,6190,12804
<class,7호선,하계,8592,8273,16865
<class,7호선,공릉,5812,5881,11693
<class,7호선,태릉입구,4843,4422,9265
<class,일산선,마두,3556,3600,7156
<class,일산선,정발산,4785,4853,9638
<class,일산선,주엽,4531,4424,8955
<class,일산선,대화,6043,5508,11551
<class,장항선,봉명,594,605,1199
<class,장항선,쌍용,1346,1406,2752
<class,장항선,아산,3574,2397,5971
<class,장항선,배방,890,1026,1916
<class,장항선,온양온천,5503,5354,10857
<class,장항선,신창,1052,1691,2743
<class,중앙선,회기,14536,14609,29145
<class,중앙선,중랑,3321,3238,6559
<class,중앙선,상봉,4207,4225,8432
<class,중앙선,망우,4829,4784,9613
<class,중앙선,양원,955,993,1948
<class,중앙선,구리,7912,8079,15991
<class,중앙선,도농,4876,5024,9900
<class,중앙선,양정,635,571,1206
<class,중앙선,덕소,3492,3579,7071
<class,중앙선,도심,1265,1084,2349
<class,중앙선,팔당,1610,1696,3306
<class,중앙선,운길산,1643,1458,3101
<class,중앙선,양수,2076,1916,3992
<class,중앙선,신원,347,187,534
<class,중앙선,국수,655,570,1225
<class,중앙선,아신,621,525,1146
<class,중앙선,오빈,270,255,525
<class,분당선,매교,1404,1459,2863
<class,분당선,수원시청,7297,7391,14688
<class,분당선,매탄권선,2573,2486,5059
<class,분당선,망포,6195,6624,12819
<class,7호선,먹골,5497,5392,10889
<class,7호선,중화,5362,5364,10726
<class,분당선,영통,4434,4519,8953
<class,분당선,청명,1965,1915,3880
<class,분당선,상갈,2967,3062,6029
<class,분당선,기흥,5114,4884,9998
<class,분당선,신갈,1947,2017,3964
<class,분당선,구성,2488,2527,5015
<class,분당선,죽전,7948,8763,16711
<class,분당선,보정,1146,1039,2185
<class,분당선,이매,3332,3421,6753
<class,분당선,오리,5576,4797,10373
<class,분당선,미금,7013,7644,14657
<class,분당선,정자,7245,7499,14744
<class,분당선,수내,5983,5784,11767
<class,분당선,서현,13199,13150,26349
<class,분당선,야탑,13398,13458,26856
<class,분당선,모란,18458,19323,37781
<class,분당선,태평,8286,7821,16107
<class,분당선,가천대,3922,4652,8574
<class,분당선,선정릉,2098,2297,4395
<class,분당선,강남구청,3281,3860,7141
<class,분당선,압구정로데오,10411,11587,21998
<class,분당선,서울숲,7326,7651,14977
<class,분당선,수원,5750,4924,10674
<class,분당선,수서,8471,8267,16738
<class,분당선,대모산입구,2217,2148,4365
<class,분당선,개포동,2016,2037,4053
<class,분당선,구룡,742,830,1572
<class,분당선,도곡,2407,2342,4749
<class,분당선,한티,8237,7883,16120
<class,분당선,선릉,2836,4158,6994
<class,과천선,범계,14532,13966,28498
<class,과천선,평촌,6172,6120,12292
<class,과천선,인덕원,11001,11322,22323
<class,과천선,정부과천청사,4306,4354,8660
<class,과천선,과천,3064,2983,6047
<class,과천선,대공원,6675,6802,13477
<class,과천선,경마공원,989,994,1983
<class,과천선,선바위,3722,3413,7135
<class,공항철도 1호선,영종,2414,2405,4819
<class,공항철도 1호선,인천공항2터미널,1678,1663,3341
<class,공항철도 1호선,인천공항1터미널,3319,3197,6516
<class,공항철도 1호선,공항화물청사,980,1080,2060
<class,공항철도 1호선,운서,4586,5272,9858
<class,공항철도 1호선,청라국제도시,3137,3003,6140
<class,공항철도 1호선,검암,3651,3756,7407
<class,공항철도 1호선,계양,5411,5073,10484
<class,공항철도 1호선,김포공항,12081,5755,17836
<class,공항철도 1호선,마곡나루,2348,2567,4915
<class,공항철도 1호선,디지털미디어시티,3904,3866,7770
<class,공항철도 1호선,홍대입구,9243,8509,17752
<class,공항철도 1호선,공덕,1190,1625,2815
<class,공항철도 1호선,서울역,7297,6341,13638
<class,경춘선,춘천,2484,1762,4246
<class,경춘선,남춘천,2849,2742,5591
<class,경춘선,김유정,611,670,1281
<class,경춘선,강촌,1036,811,1847
<class,경춘선,백양리,163,147,310
<class,경춘선,굴봉산,252,227,479
<class,경춘선,가평,2708,2255,4963
<class,경춘선,상천,402,303,705
<class,경춘선,청평,1790,1460,3250
<class,경춘선,대성리,794,687,1481
<class,경춘선,마석,2584,2488,5072
<class,경춘선,천마산,1147,1144,2291
<class,경춘선,평내호평,3568,3405,6973
<class,경춘선,금곡,887,865,1752
<class,경춘선,사릉,1794,1780,3574
<class,경춘선,퇴계원,2236,1927,4163
<class,경춘선,별내,1846,1779,3625
<class,경춘선,갈매,1496,1364,2860
<class,경춘선,신내,861,919,1780
<class,경인선,도화,2344,2228,4572
<class,경인선,중동,4968,4597,9565
<class,6호선,돌곶이,6150,5618,11768
<class,중앙선,용문,5425,5753,11178
<class,중앙선,지평,61,96,157
<class,수인선,송도,2016,1954,3970
<class,수인선,연수,3765,3738,7503
<class,수인선,원인재,3879,4025,7904
<class,수인선,남동인더스파크,927,840,1767
<class,수인선,호구포,2553,2427,4980
<class,수인선,인천논현,4382,4554,8936
<class,수인선,소래포구,7842,8026,15868
<class,수인선,월곶,2118,2095,4213
<class,수인선,달월,72,84,156
<class,수인선,사리,3586,3029,6615
<class,수인선,야목,281,248,529
<class,수인선,어천,758,649,1407
<class,수인선,오목천,2108,1882,3990
<class,수인선,고색,2557,2514,5071
<class,분당선,매교,2112,2092,4204
<class,분당선,수원시청,11431,12459,23890
<class,분당선,매탄권선,3587,3309,6896
<class,분당선,망포,9416,8548,17964
<class,분당선,영통,6518,6496,13014
<class,분당선,청명,2820,2573,5393
<class,분당선,상갈,4073,4116,8189
<class,분당선,기흥,6956,6714,13670
<class,분당선,신갈,2840,2777,5617
<class,분당선,구성,3465,3541,7006
<class,분당선,죽전,11057,12348,23405
<class,분당선,보정,1740,1602,3342
<class,분당선,이매,4136,4088,8224
<class,분당선,오리,7898,6559,14457
<class,분당선,미금,10917,11273,22190
<class,분당선,정자,10786,11172,21958
<class,분당선,수내,8744,8236,16980
<class,분당선,서현,18271,18350,36621
<class,분당선,야탑,17714,18540,36254
<class,분당선,모란,16039,16220,32259
<class,분당선,태평,10633,9961,20594
<class,분당선,가천대,6359,6642,13001
<class,분당선,선정릉,3651,3881,7532
<class,분당선,강남구청,5315,6699,12014
<class,분당선,압구정로데오,19042,21799,40841
<class,분당선,서울숲,10229,11127,21356
<class,분당선,수원,7562,5533,13095
<class,분당선,복정,2,0,2
<class,분당선,수서,10620,10747,21367
<class,분당선,대모산입구,3036,2874,5910
<class,분당선,개포동,2612,2601,5213
<class,분당선,구룡,1901,1714,3615
<class,분당선,도곡,4631,4062,8693
<class,분당선,한티,11983,11599,23582
<class,분당선,선릉,5113,8159,13272
<class,과천선,범계,20543,19708,40251
<class,과천선,평촌,9655,9625,19280
<class,과천선,인덕원,16324,16079,32403
<class,과천선,정부과천청사,6310,6372,12682
<class,과천선,과천,4510,4024,8534
<class,과천선,대공원,9508,9925,19433
<class,과천선,경마공원,1417,1352,2769
<class,과천선,선바위,5407,4788,10195
<class,공항철도 1호선,영종,3154,3185,6339
<class,공항철도 1호선,인천공항2터미널,1915,1702,3617
<class,공항철도 1호선,인천공항1터미널,3601,3485,7086
<class,공항철도 1호선,공항화물청사,1276,1331,2607
<class,공항철도 1호선,운서,6090,6195,12285
<class,공항철도 1호선,청라국제도시,4426,4177,8603
<class,공항철도 1호선,검암,4731,4847,9578
<class,공항철도 1호선,계양,7356,6736,14092
<class,공항철도 1호선,김포공항,11940,6210,18150
<class,공항철도 1호선,마곡나루,3534,3840,7374
<class,공항철도 1호선,디지털미디어시티,5625,5345,10970
<class,공항철도 1호선,홍대입구,12484,12328,24812
<class,공항철도 1호선,공덕,1615,2361,3976
<class,공항철도 1호선,서울역,7824,8187,16011
<class,경춘선,춘천,2643,2374,5017
<class,경춘선,남춘천,3036,3496,6532
<class,경춘선,김유정,674,821,1495
<class,경춘선,강촌,923,944,1867
<class,경춘선,백양리,137,164,301
<class,경춘선,굴봉산,200,211,411
<class,경춘선,가평,3735,4067,7802
<class,경춘선,상천,487,433,920
<class,경춘선,청평,1959,2134,4093
<class,경춘선,대성리,749,721,1470
<class,경춘선,마석,3482,3506,6988
<class,경춘선,천마산,1392,1435,2827
<class,경춘선,평내호평,5145,4891,10036
<class,경춘선,금곡,1261,1152,2413
<class,경춘선,사릉,2440,2340,4780
<class,경춘선,퇴계원,2832,2539,5371
<class,경춘선,별내,2548,2474,5022
<class,경춘선,갈매,2101,1805,3906
<class,경춘선,신내,1277,1310,2587
<class,경인선,도화,3097,2793,5890
<class,경인선,중동,7031,6655,13686
<class,경인선,온수,5219,4691,9910
<class,경인선,도원,2725,2814,5539
<class,경인선,간석,4432,4241,8673
<class,경인선,부개,6666,6170,12836
<class,경인선,소사,7861,7691,15552
<class,경인선,구일,4812,4499,9311
<class,경인선,인천,4897,4181,9078
<class,경인선,동인천,11945,11760,23705
<class,경인선,제물포,7773,7495,15268
<class,경인선,주안,16021,14135,30156
<class,경인선,동암,12299,12687,24986
<class,경인선,백운,5750,5509,11259
<class,경인선,부평,29361,32026,61387
<class,경인선,송내,18901,18462,37363
<class,경인선,부천,29098,29844,58942
<class,경인선,역곡,20809,20245,41054
<class,경인선,오류동,9331,8520,17851
<class,경인선,개봉,16970,16149,33119
<class,경의선,임진강,96,67,163
<class,경의선,문산,4773,4565,9338
<class,경의선,파주,949,694,1643
<class,경의선,월롱,1493,1465,2958
<class,경의선,금촌,5687,5370,11057
<class,경의선,금릉,3978,3818,7796
<class,경의선,운정,5198,4817,10015
<class,경의선,야당,5882,5850,11732
<class,경의선,탄현,5568,5339,10907
<class,경의선,일산,6510,6105,12615
<class,경의선,풍산,4603,4394,8997
<class,경의선,백마,4678,4368,9046
<class,경의선,곡산,435,458,893
<class,경의선,능곡,2956,2727,5683
<class,경의선,행신,5481,5509,10990
<class,경의선,강매,2048,1866,3914
<class,경의선,화전,1212,1060,2272
<class,경의선,수색,1465,1451,2916
<class,경의선,디지털미디어시티,2023,1828,3851
<class,경의선,가좌,4116,3901,8017
<class,경의선,홍대입구,2015,2557,4572
<class,경의선,서강대,1707,1634,3341
<class,경의선,공덕,2737,2112,4849
<class,경의선,효창공원앞,1789,1969,3758
<class,경의선,신촌,416,449,865
<class,경의선,서울역,1387,1704,3091
<class,경원선,소요산,6410,5978,12388
<class,경원선,동두천,1817,2294,4111
<class,경원선,보산,2103,1889,3992
<class,경원선,동두천중앙,3036,3028,6064
<class,경원선,지행,5773,5670,11443
<class,경원선,덕계,2502,2264,4766
<class,경원선,양주,6757,6582,13339
<class,경원선,녹양,3627,3423,7050
<class,경원선,가능,5233,5001,10234
<class,경원선,의정부,17409,18581,35990
<class,경원선,회룡,10107,10227,20334
<class,경원선,망월사,6009,6212,12221
<class,경원선,도봉산,10944,7658,18602
<class,경원선,도봉,4704,4431,9135
<class,경원선,방학,7693,7409,15102
<class,경원선,녹천,3312,2771,6083
<class,경원선,월계,5317,4736,10053
<class,경원선,광운대,5776,5654,11430
<class,경원선,석계,7011,7440,14451
<class,경원선,신이문,6148,5623,11771
<class,경원선,외대앞,6125,5871,11996
<class,경원선,청량리,16839,17593,34432
<class,경원선,왕십리,13274,14632,27906
<class,경원선,응봉,1572,1347,2919
<class,경원선,옥수,36,32,68
<class,경원선,한남,2888,2667,5555
<class,경원선,서빙고,1960,2495,4455
<class,경원선,이촌,3126,2300,5426
<class,경부선,광명,3026,2824,5850
<class,경부선,서동탄,1026,1012,2038
<class,경부선,당정,4529,4219,8748
<class,경부선,천안,6997,7292,14289
<class,경부선,두정,5860,6151,12011
<class,경부선,직산,711,689,1400
<class,경부선,성환,3254,2958,6212
<class,경부선,평택,14942,13933,28875
<class,경부선,평택지제,3224,2987,6211
<class,경부선,서정리,6863,5666,12529
<class,경부선,송탄,5015,4454,9469
<class,경부선,진위,1083,955,2038
<class,경부선,오산,9589,9035,18624
<class,경부선,오산대,3099,2852,5951
<class,경부선,세마,2189,1914,4103
<class,경부선,병점,13036,13004,26040
<class,경부선,세류,2598,2527,5125
<class,경부선,독산,9399,9234,18633
<class,경부선,수원,38382,42331,80713
<class,경부선,화서,5828,5824,11652
<class,경부선,성균관대,10899,10799,21698
<class,경부선,의왕,6136,6066,12202
<class,경부선,군포,4425,4089,8514
<class,경부선,금정,19149,18815,37964
<class,경부선,명학,5194,5025,10219
<class,경부선,안양,18094,18088,36182
<class,경부선,관악,6302,5915,12217
<class,경부선,석수,7209,6679,13888
<class,경부선,금천구청,8907,8696,17603
<class,경부선,가산디지털단지,6588,8763,15351
<class,경부선,구로,13675,14101,27776
<class,경부선,신길,6580,5549,12129
<class,경부선,신도림,3178,3363,6541
<class,경부선,영등포,37477,39348,76825
<class,경부선,대방,8064,8279,16343
<class,경부선,노량진,9098,8426,17524
<class,경부선,용산,35179,37587,72766
<class,경부선,남영,5923,6125,12048
<class,경부선,서울역,6910,1903,8813
<class,경강선,여주,2574,2912,5486
<class,경강선,세종대왕릉,339,442,781
<class,경강선,부발,1853,1727,3580
<class,경강선,이천,2767,2915,5682
<class,경강선,신둔도예촌,1181,1175,2356
<class,경강선,곤지암,2125,2329,4454
<class,경강선,초월,2253,2090,4343
<class,경강선,경기광주,5441,5208,10649
<class,경강선,삼동,1533,1429,2962
<class,경강선,이매,859,646,1505
<class,경강선,판교,3092,2889,5981
<class,9호선2~3단계,중앙보훈병원,4704,4476,9180
<class,9호선2~3단계,둔촌오륜,655,621,1276
<class,9호선2~3단계,올림픽공원,7289,7825,15114
<class,9호선2~3단계,한성백제,2563,2142,4705
<class,9호선2~3단계,송파나루,4114,4416,8530
<class,9호선2~3단계,석촌,6962,5719,12681
<class,9호선2~3단계,석촌고분,4268,3909,8177
<class,9호선2~3단계,삼전,4801,4551,9352
<class,9호선2~3단계,종합운동장,3072,2682,5754
<class,9호선2~3단계,봉은사,9723,10346,20069
<class,9호선2~3단계,삼성중앙,3010,2997,6007
<class,9호선2~3단계,선정릉,5149,5956,11105
<class,9호선2~3단계,언주,6454,6481,12935
<class,9호선,신논현,25609,25052,50661
<class,9호선,사평,2217,2067,4284
<class,9호선,고속터미널,12396,17855,30251
<class,9호선,신반포,2511,2557,5068
<class,9호선,구반포,1719,1782,3501
<class,9호선,동작,1645,1327,2972
<class,9호선,흑석,5557,5564,11121
<class,9호선,노들,3383,2888,6271
<class,9호선,노량진,21559,21312,42871
<class,9호선,샛강,2516,2565,5081
<class,9호선,여의도,11503,10924,22427
<class,9호선,국회의사당,4216,4403,8619
<class,9호선,당산,12812,12135,24947
<class,9호선,선유도,4028,4092,8120
<class,9호선,신목동,2633,2211,4844
<class,9호선,염창,12233,10977,23210
<class,9호선,등촌,7522,7161,14683
<class,9호선,증미,4343,4260,8603
<class,9호선,가양,14087,13286,27373
<class,9호선,양천향교,5823,5630,11453
<class,9호선,마곡나루,8562,8301,16863
<class,9호선,신방화,4726,4424,9150
<class,9호선,공항시장,2317,2465,4782
<class,9호선,김포공항,7899,12421,20320
<class,9호선,개화,1571,1327,2898
<class,8호선,모란,3571,3172,6743
<class,8호선,수진,4209,3690,7899
<class,8호선,신흥,3486,3559,7045
<class,8호선,단대오거리,7503,6933,14436
<class,8호선,남한산성입구,9450,8372,17822
<class,8호선,산성,5012,5069,10081
<class,8호선,복정,7584,6555,14139
<class,8호선,장지,12323,11402,23725
<class,8호선,문정,8777,8947,17724
<class,8호선,가락시장,5408,5619,11027
<class,8호선,송파,5364,5390,10754
<class,8호선,석촌,5853,7195,13048
<class,8호선,잠실,12728,15464,28192
<class,8호선,몽촌토성,6110,6103,12213
<class,8호선,강동구청,6187,6148,12335
<class,8호선,천호,12252,14449,26701
<class,8호선,암사,12501,11398,23899
<class,7호선,부평구청,4988,4481,9469
<class,7호선,굴포천,6723,6767,13490
<class,7호선,삼산체육관,3885,3557,7442
<class,7호선,상동,11094,11390,22484
<class,7호선,부천시청,10001,9743,19744
<class,7호선,신중동,9724,9643,19367
<class,7호선,춘의,5135,4883,10018
<class,7호선,부천종합운동장,3210,2924,6134
<class,7호선,까치울,5752,5838,11590
<class,7호선,온수,5756,5708,11464
<class,7호선,천왕,6842,6458,13300
<class,7호선,광명사거리,16820,16564,33384
<class,7호선,철산,15102,15119,30221
<class,7호선,가산디지털단지,15033,13819,28852
<class,7호선,남구로,8190,8496,16686
<class,7호선,대림,6858,7411,14269
<class,7호선,신풍,8320,7959,16279
<class,7호선,보라매,6711,6367,13078
<class,7호선,신대방삼거리,11111,10375,21486
<class,7호선,장승배기,6732,6470,13202
<class,7호선,상도,7477,6940,14417
<class,7호선,숭실대입구,8667,8349,17016
<class,7호선,남성,7590,7058,14648
<class,7호선,이수,12285,11246,23531
<class,7호선,내방,7778,7694,15472
<class,7호선,고속터미널,14412,11138,25550
<class,7호선,반포,4313,4179,8492
<class,7호선,논현,11263,11958,23221
<class,7호선,학동,10978,11799,22777
<class,7호선,강남구청,9767,10892,20659
<class,7호선,청담,11347,12196,23543
<class,7호선,뚝섬유원지,9613,9012,18625
<class,7호선,건대입구,10732,11051,21783
<class,7호선,어린이대공원,9805,9436,19241
<class,7호선,군자,10705,8225,18930
<class,7호선,중곡,7161,6723,13884
<class,7호선,용마산,4648,4855,9503
<class,7호선,사가정,12482,11971,24453
<class,7호선,면목,11257,10833,22090
<class,7호선,상봉,13246,12695,25941
<class,7호선,중화,7651,7400,15051
<class,7호선,먹골,8305,7909,16214
<class,7호선,태릉입구,6952,6432,13384
<class,7호선,공릉,9669,9262,18931
<class,7호선,하계,12796,11580,24376
<class,7호선,중계,9886,8841,18727
<class,7호선,노원,15839,16420,32259
<class,7호선,마들,9744,9042,18786
<class,7호선,수락산,10498,10318,20816
<class,7호선,도봉산,7605,10606,18211
<class,7호선,장암,1722,1191,2913
<class,6호선,봉화산,5552,5286,10838
<class,6호선,화랑대,8477,6882,15359
<class,6호선,태릉입구,4526,4897,9423
<class,중앙선,원덕,516,573,1089
<class,6호선,상월곡,4268,3706,7974
<class,6호선,월곡,8060,7645,15705
<class,6호선,고려대,5691,5311,11002
<class,6호선,안암,6951,6740,13691
<class,6호선,보문,5308,4625,9933
<class,6호선,창신,2190,1825,4015
<class,6호선,동묘앞,7830,7368,15198
<class,6호선,신당,6253,5651,11904
<class,6호선,청구,2574,2458,5032
<class,6호선,약수,2548,2956,5504
<class,6호선,버티고개,1273,1102,2375
<class,6호선,한강진,9189,10580,19769
<class,6호선,이태원,27566,31654,59220
<class,6호선,녹사평,8470,6978,15448
<class,6호선,삼각지,6648,4933,11581
<class,6호선,효창공원앞,4757,4268,9025
<class,6호선,공덕,10799,10320,21119
<class,6호선,대흥,5618,5629,11247
<class,6호선,광흥창,5497,5079,10576
<class,6호선,상수,8670,10025,18695
<class,6호선,합정,13649,12608,26257
<class,6호선,망원,13080,14627,27707
<class,6호선,마포구청,10116,8676,18792
<class,6호선,월드컵경기장,6739,7460,14199
<class,6호선,디지털미디어시티,7487,7443,14930
<class,6호선,증산,7635,7392,15027
<class,6호선,새절,9210,8502,17712
<class,6호선,구산,5602,4127,9729
<class,6호선,독바위,2166,2446,4612
<class,6호선,불광,3779,3648,7427
<class,6호선,역촌,2592,3098,5690
<class,6호선,응암,12896,12798,25694
<class,5호선,하남검단산,5441,5551,10992
<class,5호선,하남시청,5030,4943,9973
<class,5호선,하남풍산,2803,2809,5612
<class,5호선,미사,12301,12071,24372
<class,5호선,강일,2906,2619,5525
<class,5호선,마천,4641,4751,9392
<class,5호선,거여,5848,5554,11402
<class,5호선,개롱,4551,4728,9279
<class,5호선,오금,2408,2185,4593
<class,5호선,방이,5447,5214,10661
<class,5호선,올림픽공원,4042,3889,7931
<class,5호선,둔촌동,6453,6428,12881
<class,5호선,상일동,9861,9058,18919
<class,5호선,고덕,6766,6657,13423
<class,5호선,명일,6368,6281,12649
<class,5호선,굽은다리,7473,6922,14395
<class,5호선,길동,5910,6171,12081
<class,5호선,강동,12891,12184,25075
<class,5호선,천호,17464,16263,33727
<class,5호선,광나루,11220,10671,21891
<class,5호선,아차산,13395,13211,26606
<class,5호선,군자,8405,9126,17531
<class,5호선,장한평,11138,10859,21997
<class,5호선,답십리,10286,9214,19500
<class,5호선,마장,3969,3725,7694
<class,5호선,왕십리,3667,4341,8008
<class,5호선,행당,5701,4939,10640
<class,5호선,신금호,4346,4479,8825
<class,5호선,청구,2539,2475,5014
<class,5호선,동대문역사문화공원,968,1289,2257
<class,5호선,을지로4가,3487,3749,7236
<class,5호선,종로3가,13606,13835,27441
<class,5호선,광화문,16447,16672,33119
<class,5호선,서대문,7379,7101,14480
<class,5호선,충정로,1905,1708,3613
<class,5호선,애오개,3647,3361,7008
<class,5호선,공덕,7161,7356,14517
<class,5호선,마포,7308,7377,14685
<class,5호선,여의나루,12980,14206,27186
<class,5호선,여의도,10886,11658,22544
<class,5호선,신길,2626,2786,5412
<class,5호선,영등포시장,7159,7465,14624
<class,5호선,영등포구청,1990,1947,3937
<class,5호선,양평,3844,3660,7504
<class,5호선,오목교,16156,16782,32938
<class,5호선,목동,11328,11337,22665
<class,5호선,신정,8911,7724,16635
<class,5호선,까치산,21221,20280,41501
<class,5호선,화곡,20460,18949,39409
<class,5호선,우장산,10083,9732,19815
<class,5호선,발산,13817,14969,28786
<class,5호선,마곡,5387,5257,10644
<class,5호선,송정,5178,4978,10156
<class,5호선,김포공항,7362,7388,14750
<class,5호선,개화산,3752,3716,7468
<class,5호선,방화,4830,4599,9429
<class,4호선,쌍문,21937,19503,41440
<class,4호선,창동,19599,20453,40052
<class,4호선,노원,16046,17413,33459
<class,4호선,상계,14499,13318,27817
<class,4호선,당고개,10149,9498,19647
<class,4호선,남태령,1241,939,2180
<class,4호선,사당,21122,18631,39753
<class,4호선,총신대입구,14989,16378,31367
<class,4호선,동작,1659,1788,3447
<class,4호선,이촌,6433,7216,13649
<class,4호선,신용산,10365,11046,21411
<class,4호선,삼각지,3797,5422,9219
<class,4호선,숙대입구,9089,8662,17751
<class,4호선,서울역,5704,13266,18970
<class,4호선,회현,17727,19429,37156
<class,4호선,명동,15558,17715,33273
<class,4호선,충무로,14948,15819,30767
<class,4호선,동대문역사문화공원,10984,9804,20788
<class,4호선,동대문,13821,13704,27525
<class,4호선,혜화,28407,29624,58031
<class,4호선,한성대입구,11038,10713,21751
<class,4호선,성신여대입구,16531,15571,32102
<class,4호선,길음,14346,13567,27913
<class,4호선,미아사거리,22603,21454,44057
<class,4호선,미아,10699,10174,20873
<class,4호선,수유,26445,25518,51963
<class,3호선,오금,3914,3687,7601
<class,3호선,경찰병원,3893,3785,7678
<class,3호선,가락시장,6248,5906,12154
<class,3호선,수서,13774,13633,27407
<class,3호선,일원,4687,4576,9263
<class,3호선,대청,6161,5661,11822
<class,3호선,학여울,2197,2256,4453
<class,3호선,대치,9306,8360,17666
<class,3호선,도곡,3610,3610,7220
<class,3호선,매봉,5959,5747,11706
<class,3호선,양재,21048,22942,43990
<class,3호선,남부터미널,20823,20720,41543
<class,3호선,교대,6883,4039,10922
<class,3호선,고속터미널,46367,47957,94324
<class,3호선,잠원,3665,3599,7264
<class,3호선,신사,24821,25986,50807
<class,3호선,압구정,24389,25661,50050
<class,3호선,옥수,7231,7409,14640
<class,3호선,금호,5966,5373,11339
<class,3호선,약수,9303,8734,18037
<class,3호선,동대입구,7463,8393,15856
<class,3호선,충무로,1,0,1
<class,3호선,을지로3가,5560,5946,11506
<class,3호선,종로3가,5963,8551,14514
<class,3호선,안국,16886,19632,36518
<class,3호선,경복궁,19781,21545,41326
<class,3호선,독립문,6042,6741,12783
<class,3호선,무악재,2730,2910,5640
<class,3호선,홍제,13287,12402,25689
<class,3호선,녹번,10495,9011,19506
<class,3호선,불광,13350,15374,28724
<class,3호선,연신내,30930,28649,59579
<class,3호선,구파발,17095,16790,33885
<class,3호선,지축,3193,2933,6126
<class,2호선,용두,1709,1687,3396
<class,2호선,신정네거리,7912,7843,15755
<class,2호선,양천구청,4876,4991,9867
<class,2호선,도림천,802,850,1652
<class,2호선,신설동,3154,3076,6230
<class,2호선,신답,1058,1037,2095
<class,2호선,용답,2234,2113,4347
<class,2호선,충정로,5580,5976,11556
<class,2호선,아현,7585,7005,14590
<class,2호선,이대,10835,11249,22084
<class,2호선,신촌,29423,30064,59487
<class,2호선,홍대입구,64173,69749,133922
<class,2호선,합정,28921,30678,59599
<class,2호선,당산,13345,14683,28028
<class,2호선,영등포구청,12872,13259,26131
<class,2호선,문래,12229,12832,25061
<class,2호선,신도림,41644,42476,84120
<class,2호선,대림,18124,19240,37364
<class,2호선,구로디지털단지,34238,33771,68009
<class,2호선,신대방,20181,19150,39331
<class,2호선,신림,50615,47831,98446
<class,2호선,봉천,17015,15610,32625
<class,2호선,서울대입구,38219,37105,75324
<class,2호선,낙성대,22126,20194,42320
<class,2호선,사당,30865,34375,65240
<class,2호선,방배,9827,10201,20028
<class,2호선,서초,10500,8917,19417
<class,2호선,교대,16670,18591,35261
<class,2호선,강남,60381,60378,120759
<class,2호선,역삼,18240,19980,38220
<class,2호선,선릉,24150,21361,45511
<class,2호선,삼성,27052,27617,54669
<class,2호선,종합운동장,5083,5528,10611
<class,2호선,잠실새내,16710,17027,33737
<class,2호선,잠실,69975,66688,136663
<class,2호선,잠실나루,7924,7775,15699
<class,2호선,강변,27869,28422,56291
<class,2호선,구의,16157,15609,31766
<class,2호선,건대입구,35191,37688,72879
<class,2호선,성수,19963,22146,42109
<class,2호선,뚝섬,15416,15385,30801
<class,2호선,한양대,4305,4374,8679
<class,2호선,왕십리,13323,11717,25040
<class,2호선,상왕십리,10168,9617,19785
<class,2호선,신당,10865,11274,22139
<class,2호선,동대문역사문화공원,9975,11320,21295
<class,2호선,을지로4가,7271,7616,14887
<class,2호선,을지로3가,11308,11035,22343
<class,2호선,을지로입구,19848,19738,39586
<class,2호선,시청,9595,8924,18519
<class,1호선,청량리,18195,18692,36887
<class,1호선,제기동,15069,15480,30549
<class,1호선,신설동,9538,9187,18725
<class,1호선,동대문,10856,10139,20995
<class,1호선,종로5가,18610,18802,37412
<class,1호선,종로3가,23632,21596,45228
<class,1호선,종각,19327,17398,36725
<class,1호선,시청,12330,12974,25304
<class,1호선,동묘앞,11568,11989,23557
<class,1호선,서울역,32921,33877,66798
<class,6호선,석계,9291,9308,18599
<class,경원선,덕정,4579,4302,8881
<class,우이신설선,보문,1092,1132,2224
<class,우이신설선,신설동,1379,1353,2732
<class,일산선,원흥,7589,7225,14814
<class,일산선,삼송,14298,14147,28445
<class,일산선,원당,8577,8236,16813
<class,일산선,화정,13430,13685,27115
<class,일산선,대곡,1443,1277,2720
<class,일산선,백석,7654,7710,15364
<class,일산선,마두,5168,5254,10422
<class,일산선,정발산,6512,6788,13300
<class,수인선,인하대,4584,4249,8833
<class,수인선,숭의,2778,2587,5365
<class,수인선,신포,1518,1507,3025
<class,수인선,인천,1262,2194,3456
<class,안산선,산본,13094,13663,26757
<class,안산선,대야미,4157,3674,7831
<class,안산선,반월,3416,3324,6740
<class,안산선,상록수,12462,12443,24905
<class,안산선,한대앞,7616,7467,15083
<class,안산선,중앙,16297,16651,32948
<class,안산선,고잔,6666,6669,13335
<class,안산선,초지,3540,3539,7079
<class,안산선,안산,9590,9790,19380
<class,안산선,신길온천,1521,1393,2914
<class,안산선,정왕,6490,6565,13055
<class,안산선,오이도,7924,8201,16125
<class,안산선,수리산,3036,2897,5933
<class,우이신설선,북한산우이,4532,4468,9000
<class,우이신설선,솔밭공원,1754,1692,3446
<class,우이신설선,4.19민주묘지,2598,2174,4772
<class,우이신설선,가오리,2988,2775,5763
<class,우이신설선,화계,2547,2257,4804
<class,우이신설선,삼양,1543,1586,3129
<class,우이신설선,삼양사거리,1929,1920,3849
<class,우이신설선,솔샘,4001,3543,7544
<class,우이신설선,북한산보국문,4758,4257,9015
<class,우이신설선,정릉,3660,2976,6636
<class,우이신설선,성신여대입구,2862,3243,6105
<class,일산선,주엽,6951,6746,13697
<class,일산선,대화,9722,8740,18462
<class,장항선,봉명,763,681,1444
<class,장항선,쌍용,1665,1490,3155
<class,장항선,아산,3320,3106,6426
<class,장항선,탕정,600,613,1213
<class,장항선,배방,1196,1085,2281
<class,장항선,온양온천,4209,4245,8454
<class,장항선,신창,1382,1252,2634
<class,중앙선,회기,20583,19393,39976
<class,중앙선,중랑,4544,4267,8811
<class,중앙선,상봉,5409,5275,10684
<class,중앙선,망우,6618,6466,13084
<class,중앙선,양원,1394,1409,2803
<class,중앙선,구리,10935,11088,22023
<class,중앙선,도농,7564,7262,14826
<class,중앙선,양정,732,700,1432
<class,중앙선,덕소,4960,4962,9922
<class,중앙선,도심,1669,1450,3119
<class,중앙선,팔당,1669,1881,3550
<class,중앙선,운길산,1566,1511,3077
<class,중앙선,양수,2517,2505,5022
<class,중앙선,신원,270,252,522
<class,중앙선,국수,776,842,1618
<class,중앙선,아신,739,770,1509
<class,중앙선,오빈,322,366,688
<class,중앙선,양평,2982,3421,6403
<class,1호선,동대문,9483,10138,19621
<class,1호선,종로5가,9155,9140,18295
<class,1호선,종로3가,15499,13106,28605
<class,1호선,종각,13598,11352,24950
<class,1호선,시청,9057,9095,18152
<class,1호선,동묘앞,13055,13513,26568
<class,1호선,서울역,29039,26889,55928
<class,일산선,원당,6341,6239,12580
<class,일산선,화정,10004,10077,20081
<class,일산선,대곡,1103,889,1992
<class,일산선,백석,5648,5526,11174
<class,일산선,마두,3628,3652,7280
<class,일산선,정발산,5395,5331,10726
<class,일산선,주엽,4773,4637,9410
<class,일산선,대화,6665,6178,12843
<class,장항선,봉명,542,534,1076
<class,장항선,쌍용,1221,1334,2555
<class,장항선,아산,3778,2392,6170
<class,장항선,탕정,466,415,881
<class,장항선,배방,849,961,1810
<class,장항선,온양온천,3645,3644,7289
<class,장항선,신창,1068,1667,2735
<class,중앙선,회기,15741,15698,31439
<class,중앙선,중랑,3554,3457,7011
<class,중앙선,상봉,4414,4545,8959
<class,중앙선,망우,5075,5076,10151
<class,중앙선,양원,1029,1046,2075
<class,중앙선,구리,7941,8213,16154
<class,중앙선,도농,5256,5135,10391
<class,중앙선,양정,562,462,1024
<class,중앙선,덕소,3539,3461,7000
<class,중앙선,도심,1235,1148,2383
<class,중앙선,팔당,1436,1528,2964
<class,중앙선,운길산,1473,1366,2839
<class,중앙선,양수,2336,2037,4373
<class,중앙선,신원,275,152,427
<class,중앙선,국수,655,526,1181
<class,중앙선,아신,657,570,1227
<class,9호선,증미,3295,3367,6662
<class,분당선,복정,1,0,1
<class,안산선,반월,2629,2578,5207
<class,안산선,상록수,9297,9093,18390
<class,안산선,한대앞,5316,5485,10801
<class,안산선,중앙,11969,11788,23757
<class,안산선,고잔,4789,4589,9378
<class,안산선,초지,2473,2425,4898
<class,안산선,안산,9417,8731,18148
<class,안산선,신길온천,1135,1130,2265
<class,안산선,정왕,5186,5756,10942
<class,안산선,오이도,6435,6254,12689
<class,안산선,수리산,2155,2225,4380
<class,우이신설선,북한산우이,4689,4716,9405
<class,우이신설선,솔밭공원,1472,1387,2859
<class,우이신설선,4.19민주묘지,2321,1888,4209
<class,우이신설선,가오리,2472,2275,4747
<class,우이신설선,화계,2049,2055,4104
<class,우이신설선,삼양,1256,1299,2555
<class,우이신설선,삼양사거리,1555,1503,3058
<class,우이신설선,솔샘,2826,2650,5476
<class,우이신설선,북한산보국문,3879,3462,7341
<class,우이신설선,정릉,2742,2408,5150
<class,우이신설선,성신여대입구,2374,2682,5056
<class,우이신설선,보문,950,937,1887
<class,중앙선,오빈,274,219,493
<class,중앙선,양평,2639,2153,4792
<class,중앙선,원덕,375,329,704
<class,중앙선,용문,3386,2750,6136
<class,중앙선,지평,69,49,118
<class,과천선,대공원,9155,9276,18431
<class,과천선,경마공원,1235,1196,2431
<class,과천선,선바위,4022,3708,7730
<class,공항철도 1호선,영종,2552,2513,5065
<class,공항철도 1호선,인천공항2터미널,1730,1648,3378
<class,공항철도 1호선,인천공항1터미널,3489,3403,6892
<class,공항철도 1호선,공항화물청사,976,1077,2053
<class,공항철도 1호선,운서,5087,5325,10412
<class,공항철도 1호선,청라국제도시,3338,3190,6528
<class,공항철도 1호선,검암,3693,3878,7571
<class,공항철도 1호선,계양,5388,5260,10648
<class,공항철도 1호선,김포공항,11999,5999,17998
<class,공항철도 1호선,마곡나루,2361,2809,5170
<class,공항철도 1호선,디지털미디어시티,3802,3749,7551
<class,공항철도 1호선,홍대입구,10460,9590,20050
<class,공항철도 1호선,공덕,1232,1659,2891
<class,공항철도 1호선,서울역,7894,7085,14979
<class,경춘선,춘천,2637,1931,4568
<class,경춘선,남춘천,2868,2948,5816
<class,경춘선,김유정,573,648,1221
<class,경춘선,강촌,1052,786,1838
<class,경춘선,백양리,180,144,324
<class,경춘선,굴봉산,235,192,427
<class,경춘선,가평,5243,3934,9177
<class,경춘선,상천,514,346,860
<class,경춘선,청평,2096,1525,3621
<class,경춘선,대성리,741,544,1285
<class,경춘선,마석,2745,2653,5398
<class,경춘선,천마산,1150,1180,2330
<class,경춘선,평내호평,3787,3500,7287
<class,경춘선,금곡,926,895,1821
<class,경춘선,사릉,1873,1841,3714
<class,경춘선,퇴계원,2283,2059,4342
<class,경춘선,별내,1995,1834,3829
<class,경춘선,갈매,1548,1418,2966
<class,경춘선,신내,988,1034,2022
<class,경인선,도화,2450,2344,4794
<class,경인선,중동,5258,4927,10185
<class,경인선,온수,3750,3671,7421
<class,경인선,도원,1626,1681,3307
<class,경인선,간석,3249,3096,6345
<class,경인선,부개,4712,4382,9094
<class,경인선,소사,5819,5758,11577
<class,경인선,구일,3278,3259,6537
<class,경인선,인천,4459,3657,8116
<class,경인선,동인천,9615,9077,18692
<class,경인선,제물포,5536,5407,10943
<class,경인선,주안,11799,10449,22248
<class,경인선,동암,9824,9565,19389
<class,경인선,백운,3967,3953,7920
<class,경인선,부평,22992,23626,46618
<class,경인선,송내,13551,13375,26926
<class,경인선,부천,22838,22420,45258
<class,경인선,역곡,14706,14568,29274
<class,경인선,오류동,7165,6858,14023
<class,경인선,개봉,12004,12052,24056
<class,경의선,김포공항,1,0,1
<class,경의선,임진강,94,65,159
<class,경의선,문산,3576,3508,7084
<class,경의선,파주,669,586,1255
<class,경의선,월롱,930,1847,2777
<class,경의선,금촌,4254,4348,8602
<class,경의선,금릉,2895,2898,5793
<class,경의선,운정,3792,3740,7532
<class,경의선,야당,4610,4369,8979
<class,경의선,탄현,4376,4039,8415
<class,경의선,일산,4879,4595,9474
<class,경의선,풍산,3684,3467,7151
<class,경의선,백마,3580,3348,6928
<class,경의선,곡산,335,337,672
<class,경의선,능곡,2296,2182,4478
<class,경의선,행신,4450,4318,8768
<class,경의선,강매,1455,1345,2800
<class,경의선,화전,843,846,1689
<class,경의선,수색,921,965,1886
<class,경의선,디지털미디어시티,1381,1357,2738
<class,경의선,가좌,2854,2948,5802
<class,경의선,홍대입구,1724,1980,3704
<class,경의선,서강대,1281,1375,2656
<class,경의선,공덕,1947,1575,3522
<class,경의선,효창공원앞,1367,1506,2873
<class,경의선,신촌,304,301,605
<class,경의선,서울역,1163,1121,2284
<class,경원선,소요산,7960,7218,15178
<class,경원선,동두천,1375,1724,3099
<class,경원선,보산,1531,1714,3245
<class,경원선,동두천중앙,2190,2121,4311
<class,경원선,지행,4609,4528,9137
<class,경원선,덕정,3519,3584,7103
<class,경원선,덕계,1907,1806,3713
<class,경원선,양주,5477,5373,10850
<class,경원선,녹양,2742,2660,5402
<class,경원선,가능,4160,3979,8139
<class,경원선,의정부,14446,14461,28907
<class,경원선,회룡,7775,7875,15650
<class,경원선,망월사,4771,5118,9889
<class,경원선,도봉산,11472,8230,19702
<class,경원선,도봉,3849,3592,7441
<class,경원선,방학,5982,5832,11814
<class,경원선,녹천,2709,2261,4970
<class,경원선,월계,3869,3673,7542
<class,경원선,광운대,4394,4482,8876
<class,경원선,석계,5175,5582,10757
<class,경원선,신이문,4774,4611,9385
<class,경원선,외대앞,5271,5112,10383
<class,경원선,청량리,14564,14104,28668
<class,경원선,왕십리,10046,11404,21450
<class,경원선,응봉,1092,1025,2117
<class,경원선,옥수,52,22,74
<class,경원선,한남,1867,1973,3840
<class,경원선,서빙고,1216,1272,2488
<class,경원선,이촌,2217,1747,3964
<class,경부선,광명,2792,2090,4882
<class,경부선,서동탄,807,849,1656
<class,경부선,당정,3072,3106,6178
<class,경부선,천안,6782,6364,13146
<class,경부선,두정,4916,5421,10337
<class,경부선,직산,577,633,1210
<class,경부선,성환,2419,2916,5335
<class,경부선,평택,11787,12560,24347
<class,경부선,평택지제,2435,2345,4780
<class,경부선,서정리,4437,5995,10432
<class,경부선,송탄,3790,4239,8029
<class,경부선,진위,887,817,1704
<class,경부선,오산,7676,8220,15896
<class,경부선,오산대,2433,2389,4822
<class,경부선,세마,1792,1656,3448
<class,경부선,병점,9361,10189,19550
<class,경부선,세류,2040,2050,4090
<class,경부선,독산,6282,6493,12775
<class,경부선,수원,34338,33918,68256
<class,경부선,화서,4279,4091,8370
<class,경부선,성균관대,7780,8333,16113
<class,경부선,의왕,4508,4665,9173
<class,경부선,군포,2996,2834,5830
<class,경부선,금정,14047,14533,28580
<class,경부선,명학,3299,3197,6496
<class,경부선,안양,13630,13233,26863
<class,경부선,관악,5093,4478,9571
<class,경부선,석수,5481,5338,10819
<class,경부선,금천구청,6397,6372,12769
<class,경부선,가산디지털단지,4943,6770,11713
<class,경부선,구로,9746,9905,19651
<class,경부선,신길,4775,4349,9124
<class,경부선,신도림,2291,2456,4747
<class,경부선,영등포,30739,29207,59946
<class,경부선,대방,5756,6387,12143
<class,경부선,노량진,6093,5818,11911
<class,경부선,용산,32816,29923,62739
<class,경부선,남영,4188,4455,8643
<class,경부선,서울역,7461,1651,9112
<class,경강선,여주,2405,2364,4769
<class,경강선,세종대왕릉,289,312,601
<class,경강선,부발,1255,1967,3222
<class,경강선,이천,2104,2305,4409
<class,경강선,신둔도예촌,968,982,1950
<class,경강선,곤지암,1884,2002,3886
<class,경강선,초월,1641,1595,3236
<class,경강선,경기광주,3990,3802,7792
<class,경강선,삼동,1074,1049,2123
<class,경강선,이매,688,472,1160
<class,경강선,판교,2456,2269,4725
<class,9호선2~3단계,중앙보훈병원,3411,3345,6756
<class,9호선2~3단계,둔촌오륜,437,490,927
<class,9호선2~3단계,올림픽공원,6184,6615,12799
<class,9호선2~3단계,한성백제,2024,1656,3680
<class,9호선2~3단계,송파나루,3102,3330,6432
<class,9호선2~3단계,석촌,4794,4075,8869
<class,9호선2~3단계,석촌고분,2936,2874,5810
<class,9호선2~3단계,삼전,3610,3530,7140
<class,9호선2~3단계,종합운동장,1983,1791,3774
<class,9호선2~3단계,봉은사,7225,7210,14435
<class,9호선2~3단계,삼성중앙,1876,1986,3862
<class,9호선2~3단계,선정릉,3082,3668,6750
<class,9호선2~3단계,언주,3788,3745,7533
<class,9호선,신논현,15830,15007,30837
<class,9호선,사평,1431,1518,2949
<class,9호선,고속터미널,10200,13597,23797
<class,9호선,신반포,1783,1810,3593
<class,9호선,구반포,815,841,1656
<class,9호선,동작,1235,1025,2260
<class,9호선,흑석,3895,4083,7978
<class,9호선,노들,2636,2308,4944
<class,9호선,노량진,14525,15405,29930
<class,9호선,샛강,1826,1809,3635
<class,9호선,여의도,8341,7886,16227
<class,9호선,국회의사당,4818,4550,9368
<class,9호선,당산,9003,8881,17884
<class,9호선,선유도,3021,2955,5976
<class,9호선,신목동,1815,1641,3456
<class,9호선,염창,8511,8464,16975
<class,9호선,등촌,5157,5280,10437
<class,9호선,가양,10149,9943,20092
<class,9호선,양천향교,4235,4517,8752
<class,9호선,마곡나루,6173,5975,12148
<class,9호선,신방화,3521,3369,6890
<class,9호선,공항시장,1823,1945,3768
<class,9호선,김포공항,7164,11649,18813
<class,9호선,개화,1175,1094,2269
<class,8호선,모란,2583,2273,4856
<class,8호선,수진,2910,2584,5494
<class,8호선,신흥,2588,2776,5364
<class,8호선,단대오거리,5430,5423,10853
<class,8호선,남한산성입구,6966,6548,13514
<class,8호선,산성,3610,3709,7319
<class,8호선,복정,5188,4930,10118
<class,8호선,장지,9062,9298,18360
<class,8호선,문정,5708,6079,11787
<class,8호선,가락시장,3057,3837,6894
<class,8호선,송파,3437,3691,7128
<class,8호선,석촌,4200,5395,9595
<class,8호선,잠실,10266,11791,22057
<class,8호선,몽촌토성,4587,4622,9209
<class,8호선,강동구청,4305,4595,8900
<class,8호선,천호,8837,10270,19107
<class,8호선,암사,8971,8461,17432
<class,7호선,부평구청,3528,3142,6670
<class,7호선,굴포천,4830,4929,9759
<class,7호선,삼산체육관,2694,2541,5235
<class,7호선,상동,7462,7298,14760
<class,7호선,부천시청,7201,6938,14139
<class,7호선,신중동,6700,6652,13352
<class,7호선,춘의,3475,3328,6803
<class,7호선,부천종합운동장,2445,2246,4691
<class,7호선,까치울,4355,4321,8676
<class,7호선,온수,3925,4049,7974
<class,7호선,천왕,4811,4701,9512
<class,7호선,광명사거리,12323,12063,24386
<class,7호선,철산,10396,10234,20630
<class,7호선,가산디지털단지,11129,10498,21627
<class,7호선,남구로,6451,6264,12715
<class,7호선,대림,6994,6470,13464
<class,7호선,신풍,5949,5759,11708
<class,7호선,보라매,4169,4184,8353
<class,7호선,신대방삼거리,7565,7620,15185
<class,7호선,장승배기,4597,4518,9115
<class,7호선,상도,5168,5181,10349
<class,7호선,숭실대입구,5605,6024,11629
<class,7호선,남성,5263,5155,10418
<class,7호선,이수,8352,8054,16406
<class,7호선,내방,4971,5118,10089
<class,7호선,고속터미널,13183,8152,21335
<class,7호선,반포,2799,2730,5529
<class,7호선,논현,5863,6143,12006
<class,7호선,학동,6117,6504,12621
<class,7호선,강남구청,5918,6350,12268
<class,7호선,청담,6657,7218,13875
<class,7호선,뚝섬유원지,7928,7129,15057
<class,7호선,건대입구,8021,8377,16398
<class,7호선,어린이대공원,8520,8597,17117
<class,7호선,군자,7655,6124,13779
<class,7호선,중곡,5204,4971,10175
<class,7호선,용마산,3265,3632,6897
<class,7호선,사가정,9321,9094,18415
<class,7호선,면목,8062,7879,15941
<class,7호선,상봉,9691,9105,18796
<class,7호선,중화,5492,5394,10886
<class,7호선,먹골,5691,5600,11291
<class,7호선,태릉입구,5007,4762,9769
<class,7호선,공릉,6433,6548,12981
<class,7호선,하계,9215,8879,18094
<class,7호선,중계,6974,6480,13454
<class,7호선,노원,10759,11002,21761
<class,7호선,마들,6157,5753,11910
<class,7호선,수락산,8430,8456,16886
<class,7호선,도봉산,6809,9957,16766
<class,7호선,장암,1489,1115,2604
<class,6호선,봉화산,4048,3979,8027
<class,6호선,화랑대,5442,4530,9972
<class,6호선,태릉입구,3308,3468,6776
<class,6호선,석계,6594,6768,13362
<class,6호선,돌곶이,4457,4313,8770
<class,6호선,상월곡,3254,3047,6301
<class,6호선,월곡,5897,5677,11574
<class,6호선,고려대,3966,4059,8025
<class,6호선,안암,4985,5393,10378
<class,6호선,보문,3961,3839,7800
<class,6호선,창신,1705,1584,3289
<class,6호선,동묘앞,6403,6088,12491
<class,6호선,신당,4340,4968,9308
<class,6호선,청구,1696,1617,3313
<class,6호선,약수,1790,1985,3775
<class,6호선,버티고개,933,806,1739
<class,6호선,한강진,6178,7241,13419
<class,6호선,이태원,22451,22685,45136
<class,6호선,녹사평,5252,4477,9729
<class,6호선,삼각지,4245,3140,7385
<class,6호선,효창공원앞,3308,2995,6303
<class,6호선,공덕,7165,7056,14221
<class,6호선,대흥,3906,3936,7842
<class,6호선,광흥창,4115,3994,8109
<class,6호선,상수,6345,7198,13543
<class,6호선,합정,9738,8880,18618
<class,6호선,망원,9598,10226,19824
<class,6호선,마포구청,7481,6594,14075
<class,6호선,월드컵경기장,6280,6984,13264
<class,6호선,디지털미디어시티,5253,5427,10680
<class,6호선,증산,5509,5640,11149
<class,6호선,새절,6491,6324,12815
<class,6호선,구산,3856,2917,6773
<class,6호선,연신내,1,0,1
<class,6호선,독바위,1673,2049,3722
<class,6호선,불광,2937,2812,5749
<class,6호선,역촌,1993,2324,4317
<class,6호선,응암,9636,9644,19280
<class,5호선,하남검단산,4327,4437,8764
<class,5호선,하남시청,3783,3580,7363
<class,5호선,하남풍산,2273,2247,4520
<class,5호선,미사,8748,8584,17332
<class,5호선,강일,2104,1939,4043
<class,5호선,마천,3570,3921,7491
<class,5호선,거여,4143,4053,8196
<class,5호선,개롱,3084,3348,6432
<class,5호선,오금,1602,1555,3157
<class,5호선,방이,3982,3899,7881
<class,5호선,올림픽공원,3256,3301,6557
<class,5호선,둔촌동,4437,4463,8900
<class,5호선,상일동,6793,6679,13472
<class,5호선,고덕,4629,4484,9113
<class,5호선,명일,4951,4913,9864
<class,5호선,굽은다리,5417,5253,10670
<class,5호선,길동,4105,4271,8376
<class,5호선,강동,8878,8879,17757
<class,5호선,천호,12944,11914,24858
<class,5호선,광나루,8560,8615,17175
<class,5호선,아차산,11118,10944,22062
<class,5호선,군자,6168,6804,12972
<class,5호선,장한평,7743,7711,15454
<class,5호선,답십리,7269,6779,14048
<class,5호선,마장,2866,2737,5603
<class,5호선,왕십리,2652,3043,5695
<class,5호선,행당,3946,3543,7489
<class,5호선,신금호,2972,3253,6225
<class,5호선,청구,1746,1711,3457
<class,5호선,동대문역사문화공원,685,787,1472
<class,5호선,을지로4가,1533,1634,3167
<class,5호선,종로3가,9749,8706,18455
<class,5호선,광화문,12635,12240,24875
<class,5호선,서대문,5188,5261,10449
<class,5호선,충정로,1428,1453,2881
<class,5호선,애오개,2541,2583,5124
<class,5호선,공덕,4747,4798,9545
<class,5호선,마포,4610,4579,9189
<class,5호선,여의나루,11375,11863,23238
<class,5호선,여의도,7826,7917,15743
<class,5호선,신길,1819,2058,3877
<class,5호선,영등포시장,4669,4940,9609
<class,5호선,영등포구청,1428,1380,2808
<class,5호선,양평,2619,2619,5238
<class,5호선,오목교,11451,11805,23256
<class,5호선,목동,7573,7789,15362
<class,5호선,신정,6216,5726,11942
<class,5호선,까치산,15339,14945,30284
<class,5호선,화곡,14240,13560,27800
<class,5호선,우장산,6656,6961,13617
<class,5호선,발산,9196,9560,18756
<class,5호선,마곡,3471,3505,6976
<class,5호선,송정,3579,3663,7242
<class,5호선,김포공항,6891,6565,13456
<class,5호선,개화산,2762,2898,5660
<class,5호선,방화,3595,3572,7167
<class,4호선,쌍문,15804,14100,29904
<class,4호선,창동,14362,15276,29638
<class,4호선,노원,11576,12282,23858
<class,4호선,상계,10363,9668,20031
<class,4호선,당고개,7563,7095,14658
<class,4호선,남태령,713,559,1272
<class,4호선,사당,15219,14181,29400
<class,4호선,총신대입구,10798,11719,22517
<class,4호선,동작,1388,1450,2838
<class,4호선,이촌,4590,5232,9822
<class,4호선,신용산,8221,8442,16663
<class,4호선,삼각지,2578,3618,6196
<class,4호선,숙대입구,7144,6908,14052
<class,4호선,서울역,4204,10185,14389
<class,4호선,회현,8602,8998,17600
<class,4호선,명동,12228,12097,24325
<class,4호선,충무로,10028,10150,20178
<class,4호선,동대문역사문화공원,8380,8208,16588
<class,4호선,동대문,6850,7394,14244
<class,4호선,혜화,23267,23987,47254
<class,4호선,한성대입구,7847,8107,15954
<class,4호선,성신여대입구,12392,11712,24104
<class,4호선,길음,10103,10031,20134
<class,4호선,미아사거리,16061,15496,31557
<class,4호선,미아,7721,7372,15093
<class,4호선,수유,19552,18746,38298
<class,3호선,오금,2682,2651,5333
<class,3호선,경찰병원,2678,2759,5437
<class,3호선,가락시장,3898,4056,7954
<class,3호선,수서,10298,10313,20611
<class,3호선,일원,3127,3297,6424
<class,3호선,대청,4053,3945,7998
<class,3호선,학여울,1692,1843,3535
<class,3호선,대치,5782,5105,10887
<class,3호선,도곡,1975,2152,4127
<class,3호선,매봉,4259,4214,8473
<class,3호선,양재,13500,15626,29126
<class,3호선,남부터미널,14842,15468,30310
<class,3호선,교대,4189,2519,6708
<class,3호선,고속터미널,39882,36836,76718
<class,3호선,잠원,2268,2258,4526
<class,3호선,신사,13961,14075,28036
<class,3호선,압구정,12838,13288,26126
<class,3호선,옥수,5160,5307,10467
<class,3호선,금호,4195,3981,8176
<class,3호선,약수,6561,6349,12910
<class,3호선,동대입구,5381,6384,11765
<class,3호선,충무로,1,0,1
<class,3호선,을지로3가,3416,3219,6635
<class,3호선,종로3가,4169,5425,9594
<class,3호선,안국,12768,14138,26906
<class,3호선,경복궁,15230,16434,31664
<class,3호선,독립문,4459,5162,9621
<class,3호선,무악재,1910,2085,3995
<class,3호선,홍제,9304,8887,18191
<class,3호선,녹번,7266,6691,13957
<class,3호선,불광,10071,11930,22001
<class,3호선,연신내,22091,20906,42997
<class,3호선,구파발,12713,13040,25753
<class,3호선,지축,2228,2090,4318
<class,2호선,용두,1121,1137,2258
<class,2호선,신정네거리,5182,5336,10518
<class,2호선,양천구청,3414,3488,6902
<class,2호선,도림천,435,459,894
<class,2호선,신설동,2948,3028,5976
<class,2호선,신답,745,801,1546
<class,2호선,용답,1704,1790,3494
<class,2호선,충정로,3796,4097,7893
<class,2호선,아현,5125,5290,10415
<class,2호선,이대,7190,7806,14996
<class,2호선,신촌,21883,21438,43321
<class,2호선,홍대입구,51690,51428,103118
<class,2호선,합정,20553,21506,42059
<class,2호선,당산,9163,9788,18951
<class,2호선,영등포구청,8538,8961,17499
<class,2호선,문래,8408,8728,17136
<class,2호선,신도림,28880,29664,58544
<class,2호선,대림,14736,15019,29755
<class,2호선,구로디지털단지,23613,23126,46739
<class,2호선,신대방,14973,14883,29856
<class,2호선,신림,36634,36238,72872
<class,2호선,봉천,11985,11684,23669
<class,2호선,서울대입구,27414,28535,55949
<class,2호선,낙성대,15638,16186,31824
<class,2호선,사당,21870,24310,46180
<class,2호선,방배,6501,6957,13458
<class,2호선,서초,9922,9291,19213
<class,2호선,교대,10300,11338,21638
<class,2호선,강남,35888,34675,70563
<class,2호선,역삼,10909,12147,23056
<class,2호선,선릉,13499,11539,25038
<class,2호선,삼성,19838,19529,39367
<class,2호선,종합운동장,3706,3838,7544
<class,2호선,잠실새내,10734,10969,21703
<class,2호선,잠실,54985,50559,105544
<class,2호선,잠실나루,5481,5764,11245
<class,2호선,강변,23076,21854,44930
<class,2호선,구의,11326,11423,22749
<class,2호선,건대입구,27632,28507,56139
<class,2호선,성수,14153,15759,29912
<class,2호선,뚝섬,11258,11119,22377
<class,2호선,한양대,2299,2640,4939
<class,2호선,왕십리,9452,8680,18132
<class,2호선,상왕십리,6873,6874,13747
<class,2호선,신당,8429,8960,17389
<class,2호선,동대문역사문화공원,7468,9054,16522
<class,2호선,을지로4가,3449,3257,6706
<class,2호선,을지로3가,8148,7614,15762
<class,2호선,을지로입구,15156,13873,29029
<class,과천선,과천,3425,3083,6508
<class,과천선,정부과천청사,4521,4807,9328
<class,과천선,인덕원,11776,11736,23512
<class,과천선,평촌,6761,6685,13446
<class,과천선,범계,14847,14433,29280
<class,분당선,선릉,2837,4303,7140
<class,분당선,한티,8240,7975,16215
<class,분당선,도곡,2843,2579,5422
<class,분당선,구룡,720,811,1531
<class,분당선,개포동,1762,1866,3628
<class,분당선,대모산입구,1946,1930,3876
<class,분당선,수서,8388,7908,16296
<class,분당선,수원,5837,4403,10240
<class,분당선,서울숲,8394,8924,17318
<class,분당선,압구정로데오,10974,11980,22954
<class,분당선,강남구청,3232,3941,7173
<class,분당선,선정릉,2270,2352,4622
<class,분당선,가천대,3921,4642,8563
<class,분당선,태평,7964,7434,15398
<class,분당선,모란,10958,11107,22065
<class,분당선,야탑,12894,13280,26174
<class,분당선,서현,13489,13528,27017
<class,분당선,수내,5790,5661,11451
<class,분당선,정자,7351,7812,15163
<class,분당선,미금,7126,7460,14586
<class,분당선,오리,5123,4523,9646
<class,분당선,이매,2991,3194,6185
<class,분당선,보정,1238,1221,2459
<class,분당선,죽전,8746,9726,18472
<class,분당선,구성,2495,2573,5068
<class,분당선,신갈,1942,2062,4004
<class,분당선,기흥,5242,4811,10053
<class,분당선,상갈,3164,3137,6301
<class,분당선,청명,2002,2064,4066
<class,분당선,영통,4559,4573,9132
<class,분당선,망포,6491,6697,13188
<class,분당선,매탄권선,2535,2508,5043
<class,분당선,수원시청,7642,7614,15256
<class,분당선,매교,1416,1562,2978
<class,수인선,고색,1636,1753,3389
<class,2호선,시청,6953,6038,12991
<class,수인선,오목천,1533,1512,3045
<class,수인선,어천,570,670,1240
<class,수인선,야목,199,185,384
<class,수인선,사리,2632,2195,4827
<class,수인선,달월,49,51,100
<class,수인선,월곶,1720,1663,3383
<class,수인선,소래포구,6878,6790,13668
<class,수인선,인천논현,2990,3048,6038
<class,수인선,호구포,1905,1981,3886
<class,수인선,남동인더스파크,574,571,1145
<class,수인선,원인재,3001,3121,6122
<class,수인선,연수,2978,2903,5881
<class,수인선,송도,1624,1606,3230
<class,수인선,인하대,3392,3171,6563
<class,수인선,숭의,2039,1928,3967
<class,수인선,신포,1226,1181,2407
<class,수인선,인천,1388,2029,3417
<class,안산선,산본,9300,9653,18953
<class,안산선,대야미,3152,2806,5958
<class,우이신설선,신설동,1256,1233,2489
<class,일산선,원흥,5341,5168,10509
<class,일산선,삼송,11019,10617,21636
<class,1호선,청량리,13011,13412,26423
<class,1호선,제기동,9959,10367,20326
<class,1호선,신설동,7677,7353,15030
<class,경부선,병점,13252,12963,26215
<class,경춘선,신내,1338,1303,2641
<class,경춘선,갈매,2093,1797,3890
<class,경춘선,별내,2563,2421,4984
<class,경춘선,퇴계원,2875,2469,5344
<class,경춘선,사릉,2524,2385,4909
<class,경춘선,금곡,1171,1124,2295
<class,경춘선,평내호평,4992,4873,9865
<class,경춘선,천마산,1441,1423,2864
<class,경춘선,마석,3549,3555,7104
<class,경춘선,대성리,769,889,1658
<class,경춘선,청평,2001,2275,4276
<class,경춘선,상천,567,427,994
<class,경춘선,가평,4508,5091,9599
<class,경춘선,굴봉산,228,213,441
<class,경춘선,백양리,198,201,399
<class,경춘선,강촌,920,970,1890
<class,경춘선,김유정,644,850,1494
<class,경춘선,남춘천,3180,3661,6841
<class,경춘선,춘천,2679,2482,5161
<class,공항철도 1호선,서울역,7828,8391,16219
<class,공항철도 1호선,공덕,1539,2415,3954
<class,공항철도 1호선,홍대입구,11789,12169,23958
<class,공항철도 1호선,디지털미디어시티,5813,5404,11217
<class,공항철도 1호선,마곡나루,3529,3856,7385
<class,공항철도 1호선,김포공항,11970,5906,17876
<class,공항철도 1호선,계양,7338,6703,14041
<class,공항철도 1호선,검암,4881,4936,9817
<class,공항철도 1호선,청라국제도시,4539,4387,8926
<class,공항철도 1호선,운서,6285,6299,12584
<class,우이신설선,삼양사거리,1923,1870,3793
<class,우이신설선,삼양,1543,1552,3095
<class,우이신설선,화계,2642,2353,4995
<class,우이신설선,가오리,3086,2839,5925
<class,우이신설선,4.19민주묘지,2572,2371,4943
<class,우이신설선,솔밭공원,1908,1772,3680
<class,우이신설선,북한산우이,4907,4851,9758
<class,안산선,수리산,3164,2915,6079
<class,안산선,오이도,8274,8321,16595
<class,안산선,정왕,6874,6776,13650
<class,안산선,신길온천,1630,1464,3094
<class,안산선,안산,9870,10097,19967
<class,안산선,초지,3669,3625,7294
<class,안산선,고잔,7088,6913,14001
<class,안산선,중앙,16932,17903,34835
<class,안산선,한대앞,8065,7702,15767
<class,안산선,상록수,13117,12919,26036
<class,안산선,반월,3551,3376,6927
<class,안산선,대야미,4321,3791,8112
<class,안산선,산본,13474,14185,27659
<class,수인선,인천,1477,2454,3931
<class,수인선,신포,1640,1620,3260
<class,수인선,숭의,2918,2669,5587
<class,수인선,인하대,4931,4483,9414
<class,수인선,송도,2276,2114,4390
<class,수인선,연수,4204,4097,8301
<class,수인선,원인재,3847,3959,7806
<class,수인선,남동인더스파크,1185,1076,2261
<class,수인선,호구포,2589,2410,4999
<class,수인선,인천논현,4634,4623,9257
<class,수인선,소래포구,8164,8416,16580
<class,수인선,월곶,2282,2227,4509
<class,수인선,달월,63,69,132
<class,수인선,사리,3659,2975,6634
<class,수인선,야목,262,221,483
<class,수인선,어천,839,731,1570
<class,수인선,오목천,2278,1907,4185
<class,수인선,고색,2719,2647,5366
<class,분당선,매교,2089,2129,4218
<class,분당선,수원시청,11580,13782,25362
<class,분당선,매탄권선,3848,3556,7404
<class,분당선,망포,9999,8818,18817
<class,분당선,영통,7056,7028,14084
<class,분당선,청명,2985,2792,5777
<class,분당선,상갈,4340,4155,8495
<class,분당선,기흥,7177,6650,13827
<class,분당선,신갈,2997,2946,5943
<class,분당선,구성,3655,3697,7352
<class,분당선,죽전,10797,12054,22851
<class,분당선,보정,1780,1597,3377
<class,분당선,이매,4397,4263,8660
<class,분당선,오리,8610,7123,15733
<class,분당선,미금,11039,11528,22567
<class,분당선,정자,11209,11517,22726
<class,분당선,수내,8982,8274,17256
<class,분당선,서현,19084,19368,38452
<class,분당선,야탑,18680,19683,38363
<class,분당선,모란,16715,16944,33659
<class,분당선,태평,10947,9963,20910
<class,과천선,인덕원,17523,17060,34583
<class,분당선,가천대,5437,5822,11259
<class,분당선,선정릉,3562,3840,7402
<class,분당선,강남구청,5761,7118,12879
<class,분당선,압구정로데오,17627,21702,39329
<class,분당선,서울숲,12009,13323,25332
<class,분당선,수원,8049,6729,14778
<class,분당선,복정,3,0,3
<class,분당선,수서,10958,11127,22085
<class,분당선,대모산입구,3257,2879,6136
<class,분당선,개포동,2708,2630,5338
<class,분당선,구룡,1345,1231,2576
<class,분당선,도곡,5059,4434,9493
<class,분당선,한티,12217,11824,24041
<class,분당선,선릉,5037,8065,13102
<class,공항철도 1호선,공항화물청사,1303,1356,2659
<class,공항철도 1호선,인천공항1터미널,3692,3684,7376
<class,공항철도 1호선,인천공항2터미널,1974,1748,3722
<class,공항철도 1호선,영종,3076,3086,6162
<class,과천선,선바위,6034,5174,11208
<class,과천선,경마공원,6326,6230,12556
<class,과천선,대공원,11623,12079,23702
<class,과천선,과천,4689,4143,8832
<class,과천선,정부과천청사,6924,6911,13835
<class,과천선,범계,21119,21079,42198
<class,과천선,평촌,10155,9937,20092
<class,중앙선,중랑,4615,4286,8901
<class,중앙선,회기,22054,20565,42619
<class,장항선,신창,1430,1304,2734
<class,장항선,온양온천,4388,4581,8969
<class,장항선,배방,1134,1075,2209
<class,장항선,탕정,463,447,910
<class,장항선,아산,3400,3073,6473
<class,장항선,쌍용,1710,1503,3213
<class,장항선,봉명,736,698,1434
<class,일산선,대화,9414,7971,17385
<class,일산선,주엽,7011,6629,13640
<class,일산선,정발산,6849,7652,14501
<class,일산선,마두,5432,5188,10620
<class,일산선,백석,7722,8178,15900
<class,일산선,대곡,1448,1210,2658
<class,일산선,화정,13780,13915,27695
<class,일산선,원당,8967,8268,17235
<class,일산선,삼송,14361,13834,28195
<class,일산선,원흥,7772,7270,15042
<class,우이신설선,신설동,1517,1479,2996
<class,우이신설선,보문,1166,1094,2260
<class,우이신설선,성신여대입구,2829,3232,6061
<class,우이신설선,정릉,3769,3054,6823
<class,우이신설선,북한산보국문,4969,4128,9097
<class,우이신설선,솔샘,4125,3658,7783
<class,중앙선,상봉,5558,5255,10813
<class,중앙선,망우,6646,6648,13294
<class,중앙선,양원,1487,1400,2887
<class,중앙선,구리,11061,11296,22357
<class,중앙선,도농,7664,7074,14738
<class,중앙선,양정,746,641,1387
<class,중앙선,덕소,4829,4861,9690
<class,중앙선,도심,1707,1436,3143
<class,중앙선,팔당,1636,1845,3481
<class,중앙선,운길산,1611,1642,3253
<class,중앙선,양수,2520,2568,5088
<class,중앙선,신원,275,218,493
<class,중앙선,국수,674,718,1392
<class,중앙선,아신,650,694,1344
<class,중앙선,오빈,307,320,627
<class,중앙선,양평,2971,3313,6284
<class,중앙선,원덕,469,524,993
<class,중앙선,용문,3168,3599,6767
<class,중앙선,지평,70,86,156
<class,경부선,오산,10242,9577,19819
<class,경부선,진위,1159,1013,2172
<class,경부선,송탄,5139,4505,9644
<class,경부선,서정리,7116,5848,12964
<class,경부선,평택지제,3252,3036,6288
<class,경부선,평택,14430,13754,28184
<class,경부선,성환,3144,2983,6127
<class,경부선,직산,756,674,1430
<class,경부선,두정,5212,5304,10516
<class,경부선,천안,7102,7375,14477
<class,경부선,당정,4511,4170,8681
<class,경부선,서동탄,1082,1128,2210
<class,경부선,광명,2970,2625,5595
<class,경원선,이촌,3260,2323,5583
<class,경원선,서빙고,2190,2806,4996
<class,경원선,한남,2712,2713,5425
<class,경원선,옥수,41,37,78
<class,경원선,응봉,1551,1334,2885
<class,경원선,왕십리,13350,15012,28362
<class,경원선,청량리,17545,18469,36014
<class,경원선,외대앞,6904,6385,13289
<class,경원선,신이문,6515,5928,12443
<class,경원선,석계,7201,7800,15001
<class,경원선,광운대,6544,6228,12772
<class,경원선,월계,5101,4772,9873
<class,경원선,녹천,3618,3003,6621
<class,경원선,방학,7954,7570,15524
<class,경원선,도봉,4853,4483,9336
<class,경원선,도봉산,11384,7956,19340
<class,경원선,망월사,5867,6080,11947
<class,경원선,회룡,10435,10242,20677
<class,경원선,의정부,18317,19761,38078
<class,경원선,가능,5501,5133,10634
<class,경원선,녹양,4006,3701,7707
<class,경원선,양주,6892,6522,13414
<class,경원선,덕계,2636,2362,4998
<class,경원선,덕정,4763,4450,9213
<class,경원선,지행,6003,6021,12024
<class,경원선,동두천중앙,2824,2823,5647
<class,경원선,보산,1939,1832,3771
<class,경원선,동두천,1685,2224,3909
<class,경원선,소요산,7415,6764,14179
<class,경의선,서울역,1472,1605,3077
<class,경의선,신촌,383,403,786
<class,경의선,효창공원앞,1878,2021,3899
<class,경의선,공덕,2737,2231,4968
<class,경의선,서강대,1956,1798,3754
<class,경의선,홍대입구,1966,2448,4414
<class,경의선,가좌,4144,3958,8102
<class,경의선,디지털미디어시티,1994,1711,3705
<class,경의선,수색,1543,1403,2946
<class,경의선,화전,1197,1129,2326
<class,경의선,강매,2165,1943,4108
<class,경의선,행신,5534,5514,11048
<class,경의선,능곡,3017,2950,5967
<class,경의선,곡산,419,496,915
<class,경의선,백마,4746,4375,9121
<class,경의선,풍산,4668,4365,9033
<class,경의선,일산,6667,6172,12839
<class,경의선,탄현,5740,5343,11083
<class,경의선,야당,5984,6259,12243
<class,경의선,운정,5438,4894,10332
<class,경의선,금릉,3955,3785,7740
<class,경의선,금촌,6271,6047,12318
<class,경의선,월롱,1593,1424,3017
<class,경의선,파주,951,723,1674
<class,경의선,문산,4609,4553,9162
<class,경의선,임진강,88,68,156
<class,경인선,개봉,17365,16529,33894
<class,경인선,오류동,9603,8638,18241
<class,경인선,역곡,21793,20930,42723
<class,경인선,부천,29482,30622,60104
<class,경인선,송내,19576,18954,38530
<class,경인선,부평,29254,33338,62592
<class,경인선,백운,5871,5671,11542
<class,경인선,동암,12888,13034,25922
<class,경인선,주안,16890,14654,31544
<class,경인선,제물포,7994,7559,15553
<class,경인선,동인천,12436,12239,24675
<class,경인선,인천,5364,4877,10241
<class,경인선,구일,4531,4203,8734
<class,경인선,소사,7722,7596,15318
<class,경인선,부개,6945,6522,13467
<class,경인선,간석,4547,4359,8906
<class,경인선,도원,2276,2306,4582
<class,경인선,온수,5188,4772,9960
<class,경인선,중동,7037,6487,13524
<class,4호선,미아사거리,22912,21752,44664
<class,4호선,미아,11080,10290,21370
<class,4호선,수유,26928,26303,53231
<class,3호선,오금,4173,3992,8165
<class,3호선,경찰병원,4397,4112,8509
<class,3호선,가락시장,6401,6037,12438
<class,3호선,수서,13827,13403,27230
<class,3호선,일원,5156,4977,10133
<class,3호선,대청,6170,5507,11677
<class,3호선,학여울,1848,1901,3749
<class,3호선,대치,9287,8311,17598
<class,3호선,도곡,4026,4239,8265
<class,3호선,매봉,6273,5954,12227
<class,3호선,양재,22093,23998,46091
<class,3호선,남부터미널,21770,21947,43717
<class,3호선,교대,7093,4234,11327
<class,3호선,고속터미널,46622,48148,94770
<class,3호선,잠원,3890,3735,7625
<class,3호선,신사,25059,26843,51902
<class,3호선,압구정,24458,25756,50214
<class,3호선,옥수,7502,7541,15043
<class,3호선,금호,6174,5503,11677
<class,3호선,약수,9207,8660,17867
<class,3호선,동대입구,7481,8677,16158
<class,3호선,충무로,2,0,2
<class,3호선,을지로3가,5788,6225,12013
<class,3호선,종로3가,6404,9423,15827
<class,3호선,안국,20518,23322,43840
<class,3호선,경복궁,24310,26811,51121
<class,3호선,독립문,6874,7756,14630
<class,3호선,무악재,2826,2894,5720
<class,3호선,홍제,13808,12716,26524
<class,3호선,녹번,10915,9379,20294
<class,3호선,불광,13535,15787,29322
<class,3호선,연신내,30801,28765,59566
<class,3호선,구파발,17041,16931,33972
<class,3호선,지축,3201,2995,6196
<class,2호선,용두,1771,1755,3526
<class,2호선,신정네거리,8070,8038,16108
<class,2호선,양천구청,4664,4679,9343
<class,2호선,도림천,745,753,1498
<class,2호선,신설동,3314,3204,6518
<class,2호선,신답,1015,1074,2089
<class,2호선,용답,2293,2104,4397
<class,2호선,충정로,5894,6204,12098
<class,2호선,아현,7541,6893,14434
<class,2호선,이대,10503,10795,21298
<class,2호선,신촌,29194,29811,59005
<class,2호선,홍대입구,61055,70358,131413
<class,2호선,합정,27577,31468,59045
<class,2호선,당산,13740,14839,28579
<class,2호선,영등포구청,13268,13932,27200
<class,2호선,문래,12767,13682,26449
<class,2호선,신도림,41727,42227,83954
<class,2호선,대림,18608,19438,38046
<class,2호선,구로디지털단지,35364,34203,69567
<class,2호선,신대방,20871,19560,40431
<class,2호선,신림,51403,48329,99732
<class,2호선,봉천,17332,15248,32580
<class,2호선,서울대입구,39064,37781,76845
<class,2호선,낙성대,22828,20319,43147
<class,2호선,사당,31880,35805,67685
<class,2호선,방배,10057,10221,20278
<class,2호선,서초,10954,8975,19929
<class,2호선,교대,17251,19735,36986
<class,2호선,강남,60591,64409,125000
<class,2호선,역삼,18059,19559,37618
<class,2호선,선릉,24278,21006,45284
<class,2호선,삼성,29887,30384,60271
<class,2호선,종합운동장,5093,5407,10500
<class,2호선,잠실새내,16848,17247,34095
<class,2호선,잠실,70753,67285,138038
<class,2호선,잠실나루,8910,8495,17405
<class,2호선,강변,28721,29315,58036
<class,2호선,구의,16566,15737,32303
<class,2호선,건대입구,35237,39682,74919
<class,2호선,성수,20647,24064,44711
<class,2호선,뚝섬,16184,15775,31959
<class,2호선,한양대,5019,5115,10134
<class,2호선,왕십리,14061,12294,26355
<class,2호선,상왕십리,10201,9477,19678
<class,2호선,신당,11002,11179,22181
<class,2호선,동대문역사문화공원,9830,10861,20691
<class,2호선,을지로4가,7508,7724,15232
<class,2호선,을지로3가,12083,11787,23870
<class,2호선,을지로입구,21611,21080,42691
<class,2호선,시청,11570,11224,22794
<class,1호선,청량리,18827,19041,37868
<class,1호선,제기동,16236,16355,32591
<class,1호선,신설동,10033,9287,19320
<class,1호선,동대문,11133,10373,21506
<class,1호선,종로5가,19032,19008,38040
<class,1호선,종로3가,24571,23079,47650
<class,1호선,종각,21775,19437,41212
<class,1호선,시청,14691,16181,30872
<class,1호선,동묘앞,11725,12160,23885
<class,1호선,서울역,35801,36192,71993
<class,6호선,역촌,2727,3213,5940
<class,4호선,길음,15138,13947,29085
<class,4호선,성신여대입구,17043,16225,33268
<class,4호선,한성대입구,11921,11498,23419
<class,4호선,혜화,30668,32755,63423
<class,4호선,동대문,14200,14054,28254
<class,4호선,동대문역사문화공원,10999,9579,20578
<class,4호선,충무로,15407,16396,31803
<class,4호선,명동,16098,18443,34541
<class,4호선,회현,17986,19752,37738
<class,4호선,서울역,5961,14295,20256
<class,4호선,숙대입구,9470,9250,18720
<class,4호선,삼각지,3726,4868,8594
<class,4호선,신용산,10886,12104,22990
<class,4호선,이촌,6664,7382,14046
<class,4호선,동작,1829,1867,3696
<class,4호선,총신대입구,14787,16052,30839
<class,4호선,사당,22227,19638,41865
<class,4호선,남태령,1228,754,1982
<class,4호선,당고개,10257,9595,19852
<class,4호선,상계,14580,13253,27833
<class,4호선,노원,16091,18256,34347
<class,4호선,창동,20533,21208,41741
<class,4호선,쌍문,22308,19704,42012
<class,5호선,방화,4898,4547,9445
<class,5호선,개화산,3899,3707,7606
<class,5호선,김포공항,7565,7517,15082
<class,5호선,송정,5219,4975,10194
<class,5호선,마곡,5425,5388,10813
<class,5호선,발산,14278,15723,30001
<class,5호선,우장산,10277,9741,20018
<class,5호선,화곡,20914,19070,39984
<class,5호선,까치산,21745,20101,41846
<class,5호선,신정,9273,7715,16988
<class,5호선,목동,11609,11610,23219
<class,5호선,오목교,17506,18092,35598
<class,5호선,양평,3705,3451,7156
<class,5호선,영등포구청,1968,1931,3899
<class,5호선,영등포시장,8058,8414,16472
<class,5호선,신길,2614,2761,5375
<class,5호선,여의도,11045,12172,23217
<class,5호선,여의나루,13050,14055,27105
<class,5호선,마포,7688,7775,15463
<class,5호선,공덕,7599,7799,15398
<class,5호선,애오개,3732,3546,7278
<class,5호선,충정로,2089,1943,4032
<class,5호선,서대문,7803,7656,15459
<class,5호선,광화문,18647,18696,37343
<class,5호선,종로3가,13940,14644,28584
<class,5호선,을지로4가,3626,3949,7575
<class,5호선,동대문역사문화공원,996,1259,2255
<class,5호선,청구,2584,2275,4859
<class,5호선,신금호,4373,4464,8837
<class,5호선,행당,5821,5083,10904
<class,5호선,왕십리,3637,4516,8153
<class,5호선,마장,3955,3752,7707
<class,5호선,답십리,10503,9356,19859
<class,5호선,장한평,11626,11104,22730
<class,5호선,군자,8742,9459,18201
<class,5호선,아차산,14335,13804,28139
<class,5호선,광나루,10520,9993,20513
<class,5호선,천호,17015,16261,33276
<class,5호선,강동,13365,12657,26022
<class,5호선,길동,6070,6313,12383
<class,5호선,굽은다리,7765,7191,14956
<class,5호선,명일,6586,6484,13070
<class,5호선,고덕,6904,6589,13493
<class,5호선,상일동,10267,9387,19654
<class,5호선,둔촌동,6348,6340,12688
<class,5호선,올림픽공원,3980,4117,8097
<class,5호선,방이,5880,5793,11673
<class,5호선,오금,3054,2748,5802
<class,5호선,개롱,4536,4634,9170
<class,5호선,거여,6080,5696,11776
<class,5호선,마천,4902,4912,9814
<class,5호선,강일,2796,2579,5375
<class,5호선,미사,12726,12258,24984
<class,5호선,하남풍산,2713,2710,5423
<class,5호선,하남시청,5191,5005,10196
<class,5호선,하남검단산,5303,5281,10584
<class,6호선,응암,13315,12796,26111
<class,6호선,불광,4032,3818,7850
<class,6호선,독바위,2187,2452,4639
<class,6호선,연신내,2,0,2
<class,6호선,구산,5775,4185,9960
<class,6호선,새절,9429,8701,18130
<class,6호선,증산,7786,7347,15133
<class,6호선,디지털미디어시티,7485,7507,14992
<class,6호선,월드컵경기장,7133,8148,15281
<class,6호선,마포구청,10346,8585,18931
<class,6호선,망원,13011,14036,27047
<class,6호선,합정,12705,12079,24784
<class,6호선,상수,7987,10141,18128
<class,6호선,광흥창,5450,4778,10228
<class,6호선,대흥,5846,5687,11533
<class,6호선,공덕,10845,10002,20847
<class,6호선,효창공원앞,4915,4178,9093
<class,6호선,삼각지,5597,4212,9809
<class,6호선,녹사평,5301,5551,10852
<class,6호선,이태원,12234,16044,28278
<class,6호선,한강진,8871,10903,19774
<class,6호선,버티고개,1273,1359,2632
<class,6호선,약수,2402,2529,4931
<class,6호선,청구,2466,2490,4956
<class,6호선,신당,5489,4545,10034
<class,6호선,동묘앞,8459,7790,16249
<class,6호선,창신,2302,1809,4111
<class,6호선,보문,5268,4701,9969
<class,6호선,안암,7392,6913,14305
<class,6호선,고려대,6034,5610,11644
<class,6호선,월곡,8076,7600,15676
<class,6호선,상월곡,4299,3672,7971
<class,6호선,돌곶이,6494,5845,12339
<class,6호선,석계,9434,9269,18703
<class,6호선,태릉입구,4375,4697,9072
<class,6호선,화랑대,8084,6594,14678
<class,6호선,봉화산,5714,5371,11085
<class,7호선,장암,1718,1289,3007
<class,7호선,도봉산,7715,10868,18583
<class,7호선,수락산,10880,10292,21172
<class,7호선,마들,9649,8653,18302
<class,7호선,노원,15674,16728,32402
<class,7호선,중계,9780,8674,18454
<class,7호선,하계,13039,11789,24828
<class,7호선,공릉,9106,8835,17941
<class,7호선,태릉입구,6844,6300,13144
<class,7호선,먹골,8316,7916,16232
<class,7호선,중화,8124,7543,15667
<class,7호선,상봉,13934,13166,27100
<class,7호선,면목,11456,10849,22305
<class,7호선,사가정,13046,12328,25374
<class,7호선,용마산,4697,4693,9390
<class,7호선,중곡,7238,6760,13998
<class,7호선,군자,10744,7825,18569
<class,7호선,어린이대공원,11216,10875,22091
<class,7호선,건대입구,10735,11689,22424
<class,7호선,뚝섬유원지,9838,9193,19031
<class,7호선,청담,11644,12770,24414
<class,7호선,강남구청,10368,11453,21821
<class,7호선,학동,12006,12636,24642
<class,7호선,논현,11400,12568,23968
<class,7호선,반포,4631,4332,8963
<class,7호선,고속터미널,15216,12069,27285
<class,7호선,내방,7854,7676,15530
<class,7호선,이수,12187,11576,23763
<class,7호선,남성,7837,7152,14989
<class,7호선,숭실대입구,8506,8213,16719
<class,7호선,상도,7609,6968,14577
<class,7호선,장승배기,6955,6480,13435
<class,7호선,신대방삼거리,11922,10844,22766
<class,7호선,보라매,6696,6399,13095
<class,7호선,신풍,8559,7957,16516
<class,7호선,대림,7090,7602,14692
<class,7호선,남구로,8370,8624,16994
<class,7호선,가산디지털단지,15367,14178,29545
<class,7호선,철산,15841,15963,31804
<class,7호선,광명사거리,17560,17323,34883
<class,7호선,천왕,7333,6721,14054
<class,7호선,온수,6006,5831,11837
<class,7호선,까치울,6003,5852,11855
<class,7호선,부천종합운동장,3436,3009,6445
<class,7호선,춘의,5395,5102,10497
<class,7호선,신중동,9968,10189,20157
<class,7호선,부천시청,9955,9834,19789
<class,7호선,상동,11250,11419,22669
<class,7호선,삼산체육관,4027,3669,7696
<class,7호선,굴포천,6934,6981,13915
<class,7호선,부평구청,5173,4478,9651
<class,8호선,암사,13107,11601,24708
<class,8호선,천호,12130,14334,26464
<class,8호선,강동구청,6409,6257,12666
<class,8호선,몽촌토성,8041,7922,15963
<class,8호선,잠실,13049,15772,28821
<class,8호선,석촌,5837,7360,13197
<class,8호선,송파,5752,5569,11321
<class,8호선,가락시장,5567,5888,11455
<class,8호선,문정,9336,9368,18704
<class,8호선,장지,12943,11855,24798
<class,8호선,복정,7889,6709,14598
<class,8호선,산성,5259,5274,10533
<class,8호선,남한산성입구,9940,8742,18682
<class,8호선,단대오거리,7853,7130,14983
<class,8호선,신흥,3641,3868,7509
<class,8호선,수진,4421,3846,8267
<class,8호선,모란,3807,3516,7323
<class,9호선,개화,1589,1368,2957
<class,9호선,김포공항,8350,12857,21207
<class,9호선,공항시장,2374,2430,4804
<class,9호선,신방화,4995,4583,9578
<class,9호선,마곡나루,8663,8413,17076
<class,9호선,양천향교,6111,5749,11860
<class,9호선,가양,14878,13920,28798
<class,9호선,증미,4013,3772,7785
<class,9호선,등촌,7509,7261,14770
<class,9호선,염창,12306,11081,23387
<class,9호선,신목동,2704,2285,4989
<class,9호선,선유도,4132,3924,8056
<class,9호선,당산,12912,11920,24832
<class,9호선,국회의사당,4418,4709,9127
<class,9호선,여의도,11999,11344,23343
<class,9호선,샛강,2595,2644,5239
<class,9호선,노량진,21813,21381,43194
<class,9호선,노들,3377,2771,6148
<class,9호선,흑석,5515,5558,11073
<class,9호선,동작,1780,1546,3326
<class,9호선,구반포,1664,1801,3465
<class,9호선,신반포,2720,2601,5321
<class,9호선,고속터미널,12598,18496,31094
<class,9호선,사평,2303,2123,4426
<class,9호선,신논현,26036,26386,52422
<class,9호선2~3단계,언주,6595,6576,13171
<class,9호선2~3단계,선정릉,5020,5524,10544
<class,9호선2~3단계,삼성중앙,3111,3192,6303
<class,9호선2~3단계,봉은사,11173,11922,23095
<class,9호선2~3단계,종합운동장,3019,2689,5708
<class,9호선2~3단계,삼전,5014,4585,9599
<class,9호선2~3단계,석촌고분,4317,3933,8250
<class,9호선2~3단계,석촌,7040,5696,12736
<class,9호선2~3단계,송파나루,4234,4799,9033
<class,9호선2~3단계,한성백제,3232,2711,5943
<class,9호선2~3단계,올림픽공원,7595,7937,15532
<class,9호선2~3단계,둔촌오륜,655,664,1319
<class,9호선2~3단계,중앙보훈병원,4663,4458,9121
<class,경강선,판교,3046,2974,6020
<class,경강선,이매,1041,699,1740
<class,경강선,삼동,1608,1460,3068
<class,경강선,경기광주,5763,5270,11033
<class,경강선,초월,2459,2259,4718
<class,경강선,곤지암,2308,2376,4684
<class,경강선,신둔도예촌,1223,1218,2441
<class,경강선,이천,2963,3185,6148
<class,경강선,부발,1991,1743,3734
<class,경강선,세종대왕릉,359,437,796
<class,경강선,여주,2633,3121,5754
<class,경부선,서울역,7642,2082,9724
<class,경부선,남영,6298,6287,12585
<class,경부선,용산,38616,40888,79504
<class,경부선,노량진,9521,8932,18453
<class,경부선,대방,9141,8856,17997
<class,경부선,영등포,39729,42395,82124
<class,경부선,신도림,3473,3553,7026
<class,경부선,신길,6505,5529,12034
<class,경부선,구로,14161,14592,28753
<class,경부선,가산디지털단지,6874,8991,15865
<class,경부선,금천구청,9107,8755,17862
<class,경부선,석수,7573,7022,14595
<class,경부선,관악,6846,6123,12969
<class,경부선,안양,18979,18800,37779
<class,경부선,명학,5540,5321,10861
<class,경부선,금정,19979,19818,39797
<class,경부선,군포,4662,4137,8799
<class,경부선,의왕,6437,6158,12595
<class,경부선,성균관대,11398,11115,22513
<class,경부선,화서,6081,5937,12018
<class,경부선,수원,40808,44258,85066
<class,경부선,독산,9683,9222,18905
<class,경부선,세류,2745,2726,5471
<class,경부선,세마,2422,2101,4523
<class,경부선,오산대,3331,3063,6394
<class,경인선,도화,3411,3052,6463
<class,6호선,효창공원앞,3405,3005,6410
<class,장항선,온양온천,4428,4199,8627
<class,장항선,배방,921,970,1891
<class,장항선,탕정,332,348,680
<class,장항선,아산,3868,2600,6468
<class,장항선,쌍용,1220,1399,2619
<class,장항선,봉명,525,522,1047
<class,일산선,대화,6753,5893,12646
<class,일산선,주엽,4767,4720,9487
<class,일산선,정발산,5389,5424,10813
<class,일산선,마두,3504,3423,6927
<class,일산선,백석,5669,5654,11323
<class,일산선,대곡,1119,1006,2125
<class,일산선,화정,9878,10103,19981
<class,일산선,원당,6559,6406,12965
<class,일산선,삼송,10937,10537,21474
<class,일산선,지축,1,0,1
<class,일산선,원흥,5492,5338,10830
<class,우이신설선,신설동,1304,1281,2585
<class,우이신설선,보문,973,959,1932
<class,우이신설선,성신여대입구,2234,2667,4901
<class,우이신설선,정릉,2887,2425,5312
<class,우이신설선,북한산보국문,4037,3664,7701
<class,우이신설선,솔샘,2945,2782,5727
<class,우이신설선,삼양사거리,1659,1601,3260
<class,우이신설선,삼양,1275,1306,2581
<class,우이신설선,화계,2115,2040,4155
<class,우이신설선,가오리,2496,2300,4796
<class,우이신설선,4.19민주묘지,2243,1805,4048
<class,우이신설선,솔밭공원,1541,1504,3045
<class,우이신설선,북한산우이,4754,4799,9553
<class,안산선,수리산,2249,2360,4609
<class,안산선,오이도,6439,6217,12656
<class,안산선,정왕,5490,6178,11668
<class,안산선,신길온천,1192,1139,2331
<class,안산선,안산,9702,9133,18835
<class,안산선,초지,2483,2466,4949
<class,안산선,고잔,5036,4792,9828
<class,안산선,중앙,12183,12246,24429
<class,안산선,한대앞,5675,5553,11228
<class,안산선,상록수,9607,9590,19197
<class,안산선,반월,2679,2593,5272
<class,안산선,대야미,3253,2786,6039
<class,안산선,산본,9313,9999,19312
<class,수인선,인천,1227,1760,2987
<class,수인선,신포,1226,1185,2411
<class,수인선,숭의,2127,1913,4040
<class,수인선,인하대,3257,3225,6482
<class,수인선,송도,1588,1471,3059
<class,수인선,연수,3140,3115,6255
<class,수인선,원인재,3024,3062,6086
<class,수인선,남동인더스파크,541,565,1106
<class,수인선,호구포,1979,1957,3936
<class,수인선,인천논현,3071,3220,6291
<class,수인선,소래포구,6354,6216,12570
<class,수인선,월곶,1727,1582,3309
<class,수인선,달월,61,66,127
<class,수인선,사리,2605,2250,4855
<class,수인선,야목,199,180,379
<class,수인선,어천,574,663,1237
<class,수인선,오목천,1601,1586,3187
<class,수인선,고색,1685,1761,3446
<class,분당선,매교,1512,1576,3088
<class,분당선,수원시청,7915,7790,15705
<class,분당선,매탄권선,2624,2531,5155
<class,분당선,망포,6426,6708,13134
<class,분당선,영통,4846,4932,9778
<class,분당선,청명,2112,2118,4230
<class,분당선,상갈,3103,3196,6299
<class,분당선,기흥,5311,4964,10275
<class,분당선,신갈,2068,2052,4120
<class,분당선,구성,2544,2642,5186
<class,분당선,죽전,8413,9279,17692
<class,분당선,보정,1194,1071,2265
<class,분당선,이매,3517,3589,7106
<class,분당선,오리,5633,4952,10585
<class,분당선,미금,7192,7579,14771
<class,분당선,정자,7430,7878,15308
<class,분당선,수내,5838,5718,11556
<class,분당선,서현,13882,13898,27780
<class,분당선,야탑,13712,13811,27523
<class,분당선,모란,11420,11753,23173
<class,분당선,태평,8247,7862,16109
<class,분당선,가천대,3937,4735,8672
<class,분당선,선정릉,2161,2412,4573
<class,분당선,강남구청,3450,4119,7569
<class,분당선,압구정로데오,10266,11773,22039
<class,분당선,서울숲,9932,10756,20688
<class,분당선,수원,6120,5017,11137
<class,분당선,수서,8817,8361,17178
<class,분당선,대모산입구,2074,1978,4052
<class,분당선,개포동,2027,2002,4029
<class,분당선,구룡,806,878,1684
<class,분당선,도곡,2842,2630,5472
<class,분당선,한티,8097,7961,16058
<class,분당선,선릉,2860,4351,7211
<class,과천선,범계,15579,14950,30529
<class,과천선,평촌,6901,6791,13692
<class,과천선,인덕원,12669,12655,25324
<class,과천선,정부과천청사,4669,4840,9509
<class,과천선,과천,3666,3256,6922
<class,과천선,대공원,10255,10316,20571
<class,과천선,경마공원,6873,6704,13577
<class,과천선,선바위,4426,4054,8480
<class,공항철도 1호선,영종,2413,2382,4795
<class,공항철도 1호선,인천공항2터미널,1891,1789,3680
<class,공항철도 1호선,인천공항1터미널,3713,3426,7139
<class,공항철도 1호선,공항화물청사,1005,1129,2134
<class,공항철도 1호선,운서,5229,5365,10594
<class,공항철도 1호선,청라국제도시,3260,3054,6314
<class,공항철도 1호선,검암,3813,3894,7707
<class,공항철도 1호선,계양,5675,5482,11157
<class,공항철도 1호선,김포공항,11937,5935,17872
<class,공항철도 1호선,마곡나루,2488,2714,5202
<class,공항철도 1호선,디지털미디어시티,3662,3686,7348
<class,공항철도 1호선,홍대입구,9883,9178,19061
<class,공항철도 1호선,공덕,1296,1773,3069
<class,공항철도 1호선,서울역,8276,7440,15716
<class,경춘선,춘천,2430,1837,4267
<class,경춘선,남춘천,3506,3694,7200
<class,경춘선,김유정,618,702,1320
<class,경춘선,강촌,1217,873,2090
<class,경춘선,백양리,133,116,249
<class,경춘선,굴봉산,275,241,516
<class,경춘선,가평,5149,4122,9271
<class,경춘선,상천,562,432,994
<class,경춘선,청평,2275,1602,3877
<class,경춘선,대성리,906,611,1517
<class,경춘선,마석,2883,2799,5682
<class,경춘선,천마산,1249,1189,2438
<class,경춘선,평내호평,3759,3637,7396
<class,경춘선,금곡,1020,944,1964
<class,경춘선,사릉,2039,1932,3971
<class,경춘선,퇴계원,2330,2160,4490
<class,경춘선,별내,2071,1839,3910
<class,경춘선,갈매,1635,1396,3031
<class,경춘선,신내,975,1031,2006
<class,경인선,도화,2495,2334,4829
<class,경인선,중동,5068,4772,9840
<class,경인선,온수,4134,3802,7936
<class,경인선,도원,1598,1706,3304
<class,경인선,간석,3290,3047,6337
<class,경인선,부개,4883,4530,9413
<class,경인선,소사,5861,5682,11543
<class,경인선,구일,3222,3258,6480
<class,경인선,인천,4644,3750,8394
<class,경인선,동인천,9642,9267,18909
<class,경인선,제물포,5782,5718,11500
<class,경인선,주안,12077,10653,22730
<class,경인선,동암,9827,9658,19485
<class,경인선,백운,4160,4112,8272
<class,경인선,부평,22689,23625,46314
<class,경인선,송내,13859,13668,27527
<class,경인선,부천,22435,21996,44431
<class,경인선,역곡,15427,15316,30743
<class,경인선,오류동,7365,6817,14182
<class,경인선,개봉,12131,12131,24262
<class,경의선,임진강,81,60,141
<class,경의선,문산,3605,3745,7350
<class,경의선,파주,708,652,1360
<class,경의선,월롱,1020,1877,2897
<class,경의선,금촌,4186,4372,8558
<class,경의선,금릉,2805,2768,5573
<class,경의선,운정,3937,3721,7658
<class,경의선,야당,4526,4528,9054
<class,경의선,탄현,4343,4093,8436
<class,경의선,일산,4993,4678,9671
<class,경의선,풍산,3670,3455,7125
<class,경의선,백마,3493,3357,6850
<class,경의선,곡산,347,375,722
<class,경의선,능곡,2362,2252,4614
<class,경의선,행신,4684,4447,9131
<class,경의선,강매,1612,1522,3134
<class,경의선,화전,866,899,1765
<class,경의선,수색,928,972,1900
<class,경의선,디지털미디어시티,1486,1367,2853
<class,경의선,가좌,3059,3012,6071
<class,경의선,홍대입구,1606,1865,3471
<class,경의선,서강대,1350,1328,2678
<class,경의선,공덕,1855,1522,3377
<class,경의선,효창공원앞,1360,1558,2918
<class,경의선,신촌,318,300,618
<class,경의선,서울역,1187,1126,2313
<class,경원선,소요산,8061,7065,15126
<class,경원선,동두천,1422,1934,3356
<class,경원선,보산,1417,1559,2976
<class,경원선,동두천중앙,2316,2153,4469
<class,경원선,지행,4559,4574,9133
<class,경원선,덕정,3721,3788,7509
<class,경원선,덕계,1899,1880,3779
<class,경원선,양주,5627,5351,10978
<class,경원선,녹양,2813,2732,5545
<class,경원선,가능,4320,4202,8522
<class,경원선,의정부,14259,14361,28620
<class,경원선,회룡,7918,7849,15767
<class,경원선,망월사,4828,5139,9967
<class,경원선,도봉산,11433,8223,19656
<class,경원선,도봉,3710,3566,7276
<class,경원선,방학,6249,5963,12212
<class,경원선,녹천,2700,2342,5042
<class,경원선,월계,4035,3797,7832
<class,경원선,광운대,4889,4960,9849
<class,경원선,석계,5269,5782,11051
<class,경원선,신이문,4865,4526,9391
<class,경원선,외대앞,4959,4933,9892
<class,경원선,청량리,15508,14669,30177
<class,경원선,왕십리,10677,12114,22791
<class,경원선,응봉,1236,1153,2389
<class,경원선,옥수,58,29,87
<class,경원선,한남,2000,1999,3999
<class,경원선,서빙고,1444,1588,3032
<class,경원선,이촌,2446,1890,4336
<class,경부선,광명,2916,2009,4925
<class,경부선,서동탄,830,875,1705
<class,경부선,당정,3197,3289,6486
<class,경부선,천안,6974,6602,13576
<class,경부선,두정,4324,4884,9208
<class,경부선,직산,622,701,1323
<class,경부선,성환,2556,3122,5678
<class,경부선,평택,12173,12898,25071
<class,경부선,평택지제,2581,2433,5014
<class,경부선,서정리,4836,6431,11267
<class,경부선,송탄,3742,4206,7948
<class,경부선,진위,938,999,1937
<class,경부선,오산,8150,8563,16713
<class,경부선,오산대,2658,2526,5184
<class,경부선,세마,1747,1714,3461
<class,경부선,병점,9815,10635,20450
<class,경부선,세류,2190,2124,4314
<class,경부선,독산,6643,6650,13293
<class,경부선,수원,35833,35536,71369
<class,경부선,화서,4527,4450,8977
<class,경부선,성균관대,8003,8457,16460
<class,경부선,의왕,4497,4583,9080
<class,경부선,군포,3233,2997,6230
<class,경부선,금정,14648,14824,29472
<class,경부선,명학,3752,3685,7437
<class,경부선,안양,14243,13763,28006
<class,경부선,관악,5581,4912,10493
<class,경부선,석수,5531,5329,10860
<class,경부선,금천구청,6679,6708,13387
<class,경부선,가산디지털단지,5363,7179,12542
<class,경부선,구로,10100,10333,20433
<class,경부선,신길,5177,4488,9665
<class,경부선,신도림,2373,2519,4892
<class,경부선,영등포,32172,31429,63601
<class,경부선,대방,6291,6742,13033
<class,경부선,노량진,6509,6358,12867
<class,경부선,용산,35072,31801,66873
<class,경부선,남영,4318,4558,8876
<class,경부선,서울역,7977,1693,9670
<class,경강선,여주,2429,2367,4796
<class,경강선,세종대왕릉,362,345,707
<class,경강선,부발,1363,2022,3385
<class,경강선,이천,2244,2386,4630
<class,경강선,신둔도예촌,1015,994,2009
<class,경강선,곤지암,2142,2279,4421
<class,경강선,초월,1764,1637,3401
<class,경강선,경기광주,3924,3886,7810
<class,경강선,삼동,1088,1036,2124
<class,경강선,이매,767,529,1296
<class,경강선,판교,2436,2283,4719
<class,9호선2~3단계,중앙보훈병원,3673,3517,7190
<class,9호선2~3단계,둔촌오륜,511,498,1009
<class,9호선2~3단계,올림픽공원,6219,6749,12968
<class,9호선2~3단계,한성백제,1972,1597,3569
<class,9호선2~3단계,송파나루,3039,3345,6384
<class,9호선2~3단계,석촌,5017,4414,9431
<class,9호선2~3단계,석촌고분,3101,3157,6258
<class,9호선2~3단계,삼전,3449,3333,6782
<class,9호선2~3단계,종합운동장,2662,2288,4950
<class,9호선2~3단계,봉은사,7802,7692,15494
<class,9호선2~3단계,삼성중앙,1973,2049,4022
<class,9호선2~3단계,선정릉,3209,3602,6811
<class,9호선2~3단계,언주,3866,3867,7733
<class,9호선,신논현,16024,15215,31239
<class,9호선,사평,1580,1621,3201
<class,9호선,고속터미널,10620,14490,25110
<class,9호선,신반포,1861,1891,3752
<class,9호선,구반포,1062,1152,2214
<class,9호선,동작,1507,1261,2768
<class,9호선,흑석,3945,4089,8034
<class,9호선,노들,2655,2300,4955
<class,9호선,노량진,15062,16048,31110
<class,9호선,샛강,1697,1729,3426
<class,9호선,여의도,8631,7899,16530
<class,9호선,국회의사당,5031,4779,9810
<class,9호선,당산,9304,8939,18243
<class,9호선,선유도,2920,2950,5870
<class,9호선,신목동,1869,1630,3499
<class,9호선,염창,8887,8827,17714
<class,9호선,등촌,5266,5286,10552
<class,9호선,증미,2884,2930,5814
<class,9호선,가양,10640,10618,21258
<class,9호선,양천향교,4213,4553,8766
<class,9호선,마곡나루,6009,6145,12154
<class,9호선,신방화,3420,3442,6862
<class,9호선,공항시장,1786,1934,3720
<class,9호선,김포공항,7343,11781,19124
<class,9호선,개화,1265,1171,2436
<class,8호선,모란,2575,2238,4813
<class,8호선,수진,3070,2704,5774
<class,8호선,신흥,2627,2783,5410
<class,8호선,단대오거리,5514,5395,10909
<class,8호선,남한산성입구,7179,6711,13890
<class,8호선,산성,3714,3951,7665
<class,8호선,복정,5418,5128,10546
<class,8호선,장지,9292,9387,18679
<class,8호선,문정,5918,6211,12129
<class,8호선,가락시장,3302,4149,7451
<class,8호선,송파,3487,3718,7205
<class,8호선,석촌,4090,5319,9409
<class,8호선,잠실,10083,11360,21443
<class,8호선,몽촌토성,4472,4460,8932
<class,8호선,강동구청,4685,4667,9352
<class,8호선,천호,9016,10159,19175
<class,8호선,암사,9099,8451,17550
<class,7호선,부평구청,3712,3422,7134
<class,7호선,굴포천,4852,4858,9710
<class,7호선,삼산체육관,2804,2675,5479
<class,7호선,상동,7819,7485,15304
<class,7호선,부천시청,6938,6839,13777
<class,7호선,신중동,7012,6867,13879
<class,7호선,춘의,3544,3446,6990
<class,7호선,부천종합운동장,2566,2284,4850
<class,7호선,까치울,4548,4441,8989
<class,7호선,온수,4327,4331,8658
<class,7호선,천왕,4960,4788,9748
<class,7호선,광명사거리,12778,12496,25274
<class,7호선,철산,10814,10853,21667
<class,7호선,가산디지털단지,11290,10627,21917
<class,7호선,남구로,6669,6622,13291
<class,7호선,대림,6989,6638,13627
<class,7호선,신풍,6218,5949,12167
<class,7호선,보라매,4435,4573,9008
<class,7호선,신대방삼거리,7877,7896,15773
<class,7호선,장승배기,4615,4610,9225
<class,7호선,상도,5327,5271,10598
<class,7호선,숭실대입구,5807,6249,12056
<class,7호선,남성,5487,5292,10779
<class,7호선,이수,8374,8247,16621
<class,7호선,내방,5039,5295,10334
<class,7호선,고속터미널,13720,8685,22405
<class,7호선,반포,2969,2886,5855
<class,7호선,논현,6317,6635,12952
<class,7호선,학동,6741,7332,14073
<class,7호선,강남구청,5884,6561,12445
<class,7호선,청담,6972,7380,14352
<class,7호선,뚝섬유원지,7907,6984,14891
<class,7호선,건대입구,7727,8208,15935
<class,7호선,어린이대공원,8729,8886,17615
<class,7호선,군자,7986,6206,14192
<class,7호선,중곡,5252,5070,10322
<class,7호선,용마산,3272,3756,7028
<class,7호선,사가정,9271,8921,18192
<class,7호선,면목,8071,7897,15968
<class,7호선,상봉,9739,9370,19109
<class,7호선,중화,5724,5605,11329
<class,7호선,먹골,5689,5647,11336
<class,7호선,태릉입구,5175,4676,9851
<class,7호선,공릉,6629,6656,13285
<class,7호선,하계,9190,8680,17870
<class,7호선,중계,6914,6454,13368
<class,7호선,노원,11114,11414,22528
<class,7호선,마들,6362,5832,12194
<class,7호선,수락산,8592,8540,17132
<class,7호선,도봉산,6786,9992,16778
<class,7호선,장암,1538,1136,2674
<class,6호선,봉화산,4195,4068,8263
<class,6호선,화랑대,5820,5079,10899
<class,6호선,태릉입구,3261,3478,6739
<class,6호선,석계,6702,6938,13640
<class,6호선,돌곶이,5193,4893,10086
<class,6호선,상월곡,3376,3038,6414
<class,6호선,월곡,5745,5523,11268
<class,6호선,고려대,4033,4172,8205
<class,6호선,안암,5286,5690,10976
<class,6호선,보문,4064,3838,7902
<class,6호선,창신,1689,1478,3167
<class,6호선,동묘앞,6344,6155,12499
<class,6호선,신당,3417,4135,7552
<class,6호선,청구,1719,1610,3329
<class,6호선,약수,1808,1775,3583
<class,6호선,버티고개,977,984,1961
<class,6호선,한강진,7361,8555,15916
<class,6호선,이태원,9746,8823,18569
<class,6호선,녹사평,4071,3957,8028
<class,6호선,삼각지,3937,2949,6886
<class,2호선,당산,9265,9955,19220
<class,6호선,공덕,7095,6850,13945
<class,6호선,대흥,3887,4032,7919
<class,6호선,광흥창,4202,4009,8211
<class,6호선,상수,5806,6939,12745
<class,6호선,합정,9333,8477,17810
<class,6호선,망원,9659,10087,19746
<class,6호선,마포구청,7527,6601,14128
<class,6호선,월드컵경기장,6302,6984,13286
<class,6호선,디지털미디어시티,5152,5413,10565
<class,6호선,증산,5758,5859,11617
<class,6호선,새절,6670,6449,13119
<class,6호선,구산,3904,3008,6912
<class,6호선,연신내,1,0,1
<class,6호선,독바위,1628,1988,3616
<class,6호선,불광,3055,2853,5908
<class,6호선,역촌,1959,2328,4287
<class,6호선,응암,9606,9526,19132
<class,5호선,하남검단산,4544,4430,8974
<class,5호선,하남시청,3754,3475,7229
<class,5호선,하남풍산,2192,2161,4353
<class,5호선,미사,8803,8770,17573
<class,5호선,강일,2159,2012,4171
<class,5호선,마천,3754,3991,7745
<class,5호선,거여,4343,4102,8445
<class,5호선,개롱,3192,3464,6656
<class,5호선,오금,1610,1560,3170
<class,5호선,방이,4011,3878,7889
<class,5호선,올림픽공원,2997,3114,6111
<class,5호선,둔촌동,4578,4603,9181
<class,5호선,상일동,7277,6811,14088
<class,5호선,고덕,4453,4492,8945
<class,5호선,명일,4820,4983,9803
<class,5호선,굽은다리,5568,5279,10847
<class,5호선,길동,4124,4279,8403
<class,5호선,강동,9387,9145,18532
<class,5호선,천호,12755,12182,24937
<class,5호선,광나루,8294,8037,16331
<class,5호선,아차산,11736,11739,23475
<class,5호선,군자,6285,6880,13165
<class,5호선,장한평,7986,7896,15882
<class,5호선,답십리,7615,7099,14714
<class,5호선,마장,3015,2734,5749
<class,5호선,왕십리,2653,3055,5708
<class,5호선,행당,4012,3570,7582
<class,5호선,신금호,3054,3249,6303
<class,5호선,청구,1811,1672,3483
<class,5호선,동대문역사문화공원,693,785,1478
<class,5호선,을지로4가,1600,1740,3340
<class,5호선,종로3가,9907,8803,18710
<class,5호선,광화문,12873,12502,25375
<class,5호선,서대문,5889,5775,11664
<class,5호선,충정로,1523,1427,2950
<class,5호선,애오개,2776,2751,5527
<class,5호선,공덕,4881,4889,9770
<class,5호선,마포,4981,4848,9829
<class,5호선,여의나루,10936,11311,22247
<class,5호선,여의도,7556,8114,15670
<class,5호선,신길,1921,2060,3981
<class,5호선,영등포시장,5305,5578,10883
<class,5호선,영등포구청,1449,1551,3000
<class,5호선,양평,2679,2729,5408
<class,5호선,오목교,12125,12631,24756
<class,5호선,목동,7897,8010,15907
<class,5호선,신정,6590,5981,12571
<class,5호선,까치산,15731,15360,31091
<class,5호선,화곡,14558,13640,28198
<class,5호선,우장산,7044,7245,14289
<class,5호선,발산,9468,10154,19622
<class,5호선,마곡,3588,3638,7226
<class,5호선,송정,3714,3819,7533
<class,5호선,김포공항,6987,6739,13726
<class,5호선,개화산,2912,2937,5849
<class,5호선,방화,3622,3585,7207
<class,4호선,쌍문,15995,14442,30437
<class,4호선,창동,15362,15881,31243
<class,4호선,노원,11703,12884,24587
<class,4호선,상계,10622,9806,20428
<class,4호선,당고개,7758,7411,15169
<class,4호선,남태령,804,572,1376
<class,4호선,사당,15873,14966,30839
<class,4호선,총신대입구,10801,11787,22588
<class,4호선,동작,1385,1485,2870
<class,4호선,이촌,4973,5490,10463
<class,4호선,신용산,8324,8471,16795
<class,4호선,삼각지,2599,3405,6004
<class,4호선,숙대입구,7006,6611,13617
<class,4호선,서울역,4418,10710,15128
<class,4호선,회현,8928,9715,18643
<class,4호선,명동,12892,12821,25713
<class,4호선,충무로,10739,10763,21502
<class,4호선,동대문역사문화공원,8465,7873,16338
<class,4호선,동대문,7169,7800,14969
<class,4호선,혜화,24021,25356,49377
<class,4호선,한성대입구,8443,8527,16970
<class,4호선,성신여대입구,12676,12123,24799
<class,4호선,길음,10597,10454,21051
<class,4호선,미아사거리,16300,15456,31756
<class,4호선,미아,7967,7415,15382
<class,4호선,수유,20178,19482,39660
<class,3호선,오금,2812,2687,5499
<class,3호선,경찰병원,2721,2872,5593
<class,3호선,가락시장,3866,4161,8027
<class,3호선,수서,10377,10497,20874
<class,3호선,일원,3168,3470,6638
<class,3호선,대청,4235,4069,8304
<class,3호선,학여울,1016,1004,2020
<class,3호선,대치,5680,5034,10714
<class,3호선,도곡,2116,2338,4454
<class,3호선,매봉,4287,4237,8524
<class,3호선,양재,14051,16350,30401
<class,3호선,남부터미널,15102,15972,31074
<class,3호선,교대,4389,2624,7013
<class,3호선,고속터미널,40528,37685,78213
<class,3호선,잠원,2469,2457,4926
<class,3호선,신사,13866,14277,28143
<class,3호선,압구정,13380,13918,27298
<class,3호선,옥수,5386,5610,10996
<class,3호선,금호,4521,4274,8795
<class,3호선,약수,6733,6586,13319
<class,3호선,동대입구,5852,7108,12960
<class,3호선,충무로,2,0,2
<class,3호선,을지로3가,3467,3200,6667
<class,3호선,종로3가,4163,5353,9516
<class,3호선,안국,14832,16354,31186
<class,3호선,경복궁,18095,20102,38197
<class,3호선,독립문,4585,5268,9853
<class,3호선,무악재,1988,2133,4121
<class,3호선,홍제,9530,9114,18644
<class,3호선,녹번,7820,7051,14871
<class,3호선,불광,10201,11892,22093
<class,3호선,연신내,22169,20765,42934
<class,3호선,구파발,12573,13024,25597
<class,3호선,지축,2222,2137,4359
<class,2호선,용두,1216,1207,2423
<class,2호선,신정네거리,5563,5475,11038
<class,2호선,양천구청,3502,3580,7082
<class,2호선,도림천,551,552,1103
<class,2호선,신설동,2938,3028,5966
<class,2호선,신답,841,835,1676
<class,2호선,용답,1794,1764,3558
<class,2호선,충정로,3862,4247,8109
<class,2호선,아현,5135,5141,10276
<class,2호선,이대,7445,7754,15199
<class,2호선,신촌,21865,21207,43072
<class,2호선,홍대입구,48166,48680,96846
<class,2호선,합정,20273,21645,41918
<class,2호선,영등포구청,8724,9201,17925
<class,2호선,문래,8539,9032,17571
<class,2호선,신도림,29452,29843,59295
<class,2호선,대림,14931,15289,30220
<class,2호선,구로디지털단지,24601,24146,48747
<class,2호선,신대방,15808,15690,31498
<class,2호선,신림,37386,36835,74221
<class,2호선,봉천,12433,11877,24310
<class,2호선,서울대입구,27963,29088,57051
<class,2호선,낙성대,16399,16640,33039
<class,2호선,사당,22937,25672,48609
<class,2호선,서초,11196,10339,21535
<class,2호선,교대,10762,11707,22469
<class,2호선,강남,35654,35479,71133
<class,2호선,역삼,11432,12100,23532
<class,2호선,선릉,13300,11601,24901
<class,2호선,삼성,20963,20382,41345
<class,2호선,종합운동장,16168,18223,34391
<class,2호선,잠실새내,12063,12072,24135
<class,2호선,잠실,52461,49225,101686
<class,2호선,잠실나루,5272,5520,10792
<class,2호선,강변,24127,22748,46875
<class,2호선,구의,11446,11455,22901
<class,2호선,건대입구,27038,28553,55591
<class,2호선,성수,15672,17441,33113
<class,2호선,뚝섬,11457,11522,22979
<class,2호선,한양대,2351,2677,5028
<class,2호선,왕십리,9864,8866,18730
<class,2호선,상왕십리,7218,7079,14297
<class,2호선,신당,8115,8621,16736
<class,2호선,동대문역사문화공원,6830,8389,15219
<class,2호선,을지로4가,3605,3396,7001
<class,2호선,을지로3가,8630,7688,16318
<class,2호선,을지로입구,15673,14454,30127
<class,2호선,시청,7994,7170,15164
<class,1호선,청량리,13424,13990,27414
<class,1호선,제기동,10551,11055,21606
<class,1호선,신설동,7810,7776,15586
<class,1호선,동대문,10052,10283,20335
<class,1호선,종로5가,9051,8928,17979
<class,1호선,종로3가,16015,13450,29465
<class,1호선,종각,14538,11693,26231
<class,1호선,시청,10181,10494,20675
<class,1호선,동묘앞,12287,12566,24853
<class,1호선,서울역,30772,28106,58878
<class,분당선,복정,1,0,1
<class,경원선,창동,1,0,1
<class,2호선,방배,6932,7347,14279
<class,중앙선,운길산,1525,1340,2865
<class,중앙선,팔당,1516,1616,3132
<class,중앙선,도심,1365,1205,2570
<class,중앙선,덕소,3605,3675,7280
<class,중앙선,양정,549,478,1027
<class,중앙선,도농,5238,5135,10373
<class,중앙선,구리,8187,8353,16540
<class,중앙선,양원,1014,1066,2080
<class,중앙선,망우,5161,5263,10424
<class,중앙선,상봉,4507,4413,8920
<class,중앙선,중랑,3613,3436,7049
<class,중앙선,회기,16204,16315,32519
<class,장항선,신창,1158,1797,2955
<class,중앙선,지평,80,68,148
<class,중앙선,용문,3121,2528,5649
<class,중앙선,원덕,454,453,907
<class,중앙선,양평,2688,2252,4940
<class,중앙선,오빈,279,258,537
<class,중앙선,아신,740,483,1223
<class,중앙선,국수,644,597,1241
<class,중앙선,신원,282,236,518
<class,중앙선,양수,2099,1884,3983
<class,장항선,아산,3379,3319,6698
<class,장항선,탕정,380,330,710
<class,장항선,배방,1085,1018,2103
<class,장항선,온양온천,4008,4049,8057
<class,분당선,망포,9695,8474,18169
<class,분당선,매탄권선,3765,3267,7032
<class,분당선,수원시청,11096,13301,24397
<class,분당선,매교,2059,2065,4124
<class,수인선,고색,2506,2426,4932
<class,수인선,오목천,2143,1761,3904
<class,수인선,어천,718,656,1374
<class,수인선,야목,232,221,453
<class,수인선,사리,3506,2922,6428
<class,수인선,달월,57,68,125
<class,수인선,월곶,2046,2084,4130
<class,수인선,소래포구,6078,5904,11982
<class,수인선,인천논현,4270,4387,8657
<class,수인선,호구포,2599,2727,5326
<class,수인선,남동인더스파크,917,868,1785
<class,수인선,원인재,4047,4193,8240
<class,수인선,연수,3612,3731,7343
<class,수인선,송도,1949,2421,4370
<class,수인선,인하대,4506,4293,8799
<class,수인선,숭의,2637,2538,5175
<class,수인선,신포,1365,1440,2805
<class,수인선,인천,1187,1956,3143
<class,안산선,산본,12490,13346,25836
<class,안산선,대야미,3997,3524,7521
<class,안산선,반월,3473,3302,6775
<class,안산선,상록수,12887,12449,25336
<class,안산선,한대앞,7465,7289,14754
<class,안산선,중앙,15925,17017,32942
<class,안산선,고잔,6939,6848,13787
<class,안산선,초지,3555,3547,7102
<class,안산선,안산,9711,9949,19660
<class,안산선,신길온천,1483,1441,2924
<class,안산선,정왕,6615,6498,13113
<class,안산선,오이도,7804,7942,15746
<class,안산선,수리산,2962,2658,5620
<class,우이신설선,북한산우이,3823,3930,7753
<class,우이신설선,솔밭공원,1787,1607,3394
<class,우이신설선,4.19민주묘지,2571,2188,4759
<class,우이신설선,가오리,2970,2746,5716
<class,우이신설선,화계,2592,2370,4962
<class,우이신설선,삼양,1547,1573,3120
<class,우이신설선,삼양사거리,1940,1819,3759
<class,우이신설선,솔샘,3961,3436,7397
<class,우이신설선,북한산보국문,4836,4287,9123
<class,분당선,영통,6852,6811,13663
<class,분당선,청명,2795,2738,5533
<class,분당선,상갈,3993,3850,7843
<class,분당선,기흥,6988,6480,13468
<class,분당선,신갈,2815,2682,5497
<class,분당선,구성,3391,3458,6849
<class,분당선,죽전,10406,11583,21989
<class,분당선,보정,1629,1479,3108
<class,분당선,이매,4299,4179,8478
<class,분당선,오리,8246,6852,15098
<class,분당선,미금,10817,11137,21954
<class,분당선,정자,10803,11002,21805
<class,분당선,수내,9212,8458,17670
<class,분당선,서현,18825,19015,37840
<class,분당선,야탑,18461,19225,37686
<class,분당선,모란,16519,16821,33340
<class,분당선,태평,11009,10119,21128
<class,분당선,가천대,5431,5881,11312
<class,분당선,선정릉,3504,3587,7091
<class,분당선,강남구청,5719,6837,12556
<class,분당선,압구정로데오,18382,22238,40620
<class,분당선,서울숲,9425,10142,19567
<class,분당선,수원,7835,6600,14435
<class,분당선,수서,10644,10802,21446
<class,분당선,대모산입구,2934,2635,5569
<class,분당선,개포동,2775,2706,5481
<class,분당선,구룡,1375,1261,2636
<class,분당선,도곡,5027,4052,9079
<class,분당선,한티,11184,10869,22053
<class,분당선,선릉,5052,8129,13181
<class,과천선,범계,20453,20328,40781
<class,과천선,평촌,9780,9514,19294
<class,과천선,인덕원,16980,16298,33278
<class,과천선,정부과천청사,6413,6083,12496
<class,과천선,과천,4669,3987,8656
<class,과천선,대공원,7045,7360,14405
<class,과천선,경마공원,6307,6271,12578
<class,과천선,선바위,6047,5133,11180
<class,공항철도 1호선,영종,3123,3097,6220
<class,공항철도 1호선,인천공항2터미널,2029,1823,3852
<class,공항철도 1호선,인천공항1터미널,3723,3728,7451
<class,공항철도 1호선,공항화물청사,1319,1356,2675
<class,공항철도 1호선,운서,5995,6050,12045
<class,공항철도 1호선,청라국제도시,4475,4186,8661
<class,공항철도 1호선,검암,4761,4924,9685
<class,공항철도 1호선,계양,7095,6656,13751
<class,공항철도 1호선,김포공항,11927,6216,18143
<class,공항철도 1호선,마곡나루,3377,3575,6952
<class,공항철도 1호선,디지털미디어시티,5816,5443,11259
<class,공항철도 1호선,홍대입구,12285,12646,24931
<class,공항철도 1호선,공덕,1625,2500,4125
<class,공항철도 1호선,서울역,8347,9060,17407
<class,경춘선,춘천,1836,1717,3553
<class,경춘선,남춘천,3025,3058,6083
<class,경춘선,김유정,529,683,1212
<class,경춘선,강촌,775,805,1580
<class,경춘선,백양리,120,154,274
<class,경춘선,굴봉산,180,178,358
<class,경춘선,가평,2160,2612,4772
<class,경춘선,상천,396,338,734
<class,경춘선,청평,1588,1975,3563
<class,경춘선,대성리,612,806,1418
<class,경춘선,마석,3574,3562,7136
<class,경춘선,천마산,1411,1406,2817
<class,경춘선,평내호평,4732,4534,9266
<class,경춘선,금곡,1094,1045,2139
<class,경춘선,사릉,2331,2137,4468
<class,경춘선,퇴계원,2669,2451,5120
<class,경춘선,별내,2477,2295,4772
<class,경춘선,갈매,2153,1734,3887
<class,경춘선,신내,1253,1214,2467
<class,경인선,도화,3249,2891,6140
<class,경인선,중동,6763,6119,12882
<class,경인선,온수,4926,4438,9364
<class,경인선,도원,2290,2355,4645
<class,경인선,간석,4322,4183,8505
<class,경인선,부개,6564,6011,12575
<class,경인선,소사,7774,7434,15208
<class,경인선,구일,4502,4265,8767
<class,경인선,인천,4622,4032,8654
<class,경인선,동인천,12822,12365,25187
<class,경인선,제물포,8053,7279,15332
<class,경인선,주안,16637,14329,30966
<class,경인선,동암,12370,12652,25022
<class,경인선,백운,5634,5462,11096
<class,경인선,부평,29383,33132,62515
<class,경인선,송내,18528,18177,36705
<class,경인선,부천,28762,29959,58721
<class,경인선,역곡,20608,19734,40342
<class,경인선,오류동,9380,8441,17821
<class,경인선,개봉,16851,16013,32864
<class,경의선,임진강,78,52,130
<class,경의선,문산,4488,4415,8903
<class,경의선,파주,916,714,1630
<class,경의선,월롱,1540,1369,2909
<class,경의선,금촌,5622,5345,10967
<class,경의선,금릉,3748,3607,7355
<class,경의선,운정,5324,4854,10178
<class,경의선,야당,5949,5925,11874
<class,경의선,탄현,5624,5234,10858
<class,경의선,일산,7422,6982,14404
<class,경의선,풍산,4511,4246,8757
<class,경의선,백마,4787,4485,9272
<class,경의선,곡산,445,468,913
<class,경의선,능곡,2947,2802,5749
<class,경의선,행신,5474,5445,10919
<class,경의선,강매,2075,1869,3944
<class,경의선,화전,1155,1072,2227
<class,경의선,수색,1505,1422,2927
<class,경의선,디지털미디어시티,1963,1817,3780
<class,경의선,가좌,4058,3861,7919
<class,경의선,홍대입구,1877,2386,4263
<class,경의선,서강대,1903,1763,3666
<class,경의선,공덕,2860,2193,5053
<class,경의선,효창공원앞,1836,1887,3723
<class,경의선,신촌,393,393,786
<class,경의선,서울역,1533,1614,3147
<class,경원선,소요산,4317,3822,8139
<class,경원선,동두천,1610,2088,3698
<class,경원선,보산,1886,1795,3681
<class,경원선,동두천중앙,2748,2680,5428
<class,경원선,지행,5639,5659,11298
<class,경원선,덕정,4612,4272,8884
<class,경원선,덕계,2416,2247,4663
<class,경원선,양주,6686,6196,12882
<class,경원선,녹양,3625,3395,7020
<class,경원선,가능,5132,4906,10038
<class,경원선,의정부,17747,18959,36706
<class,경원선,회룡,10025,9895,19920
<class,경원선,망월사,6104,6122,12226
<class,경원선,도봉산,9527,6449,15976
<class,경원선,도봉,4617,4163,8780
<class,경원선,방학,7509,7142,14651
<class,경원선,녹천,3442,2848,6290
<class,경원선,월계,4944,4463,9407
<class,우이신설선,정릉,3834,2974,6808
<class,경원선,광운대,5723,5689,11412
<class,경원선,석계,7264,7515,14779
<class,경원선,신이문,6347,5736,12083
<class,경원선,외대앞,6764,6258,13022
<class,경원선,청량리,17143,18209,35352
<class,경원선,왕십리,12769,14693,27462
<class,경원선,응봉,1477,1286,2763
<class,경원선,옥수,28,33,61
<class,경원선,한남,2656,2674,5330
<class,경원선,서빙고,1952,2432,4384
<class,경원선,이촌,2961,2119,5080
<class,경부선,광명,3036,2680,5716
<class,경부선,서동탄,1118,1173,2291
<class,경부선,당정,4110,3892,8002
<class,경부선,천안,6564,6768,13332
<class,경부선,두정,5077,5134,10211
<class,경부선,직산,725,693,1418
<class,경부선,성환,3014,2880,5894
<class,경부선,평택,13935,13701,27636
<class,경부선,평택지제,3304,2952,6256
<class,경부선,서정리,6941,6067,13008
<class,경부선,송탄,4994,4705,9699
<class,경부선,진위,1084,1016,2100
<class,경부선,오산,10158,9279,19437
<class,경부선,오산대,3098,2659,5757
<class,경부선,세마,2206,1959,4165
<class,경부선,병점,12993,12493,25486
<class,경부선,세류,2644,2686,5330
<class,경부선,독산,9297,8932,18229
<class,경부선,수원,38809,42163,80972
<class,경부선,화서,5789,5721,11510
<class,경부선,성균관대,10879,10638,21517
<class,경부선,의왕,6245,5928,12173
<class,경부선,군포,4551,4073,8624
<class,경부선,금정,19283,19136,38419
<class,경부선,명학,5344,5061,10405
<class,경부선,안양,18258,18189,36447
<class,경부선,관악,6356,6035,12391
<class,경부선,석수,7323,6570,13893
<class,경부선,금천구청,8702,8347,17049
<class,경부선,가산디지털단지,6919,8907,15826
<class,경부선,구로,13669,14499,28168
<class,경부선,신길,6335,5314,11649
<class,경부선,신도림,3042,3306,6348
<class,경부선,영등포,40652,43110,83762
<class,경부선,대방,8466,8188,16654
<class,경부선,노량진,9551,8997,18548
<class,경부선,용산,37771,40479,78250
<class,경부선,남영,5902,6115,12017
<class,경부선,서울역,8030,2156,10186
<class,경강선,여주,2241,2738,4979
<class,경강선,세종대왕릉,291,373,664
<class,경강선,부발,2018,1765,3783
<class,경강선,이천,2882,3165,6047
<class,경강선,신둔도예촌,1192,1184,2376
<class,경강선,곤지암,2089,2194,4283
<class,경강선,초월,2283,2027,4310
<class,경강선,경기광주,5397,4962,10359
<class,경강선,삼동,1538,1392,2930
<class,경강선,이매,889,662,1551
<class,경강선,판교,2994,2845,5839
<class,9호선2~3단계,중앙보훈병원,4745,4234,8979
<class,9호선2~3단계,둔촌오륜,688,654,1342
<class,9호선2~3단계,올림픽공원,6270,6255,12525
<class,9호선2~3단계,한성백제,2080,1762,3842
<class,9호선2~3단계,송파나루,4121,4475,8596
<class,9호선2~3단계,석촌,6720,5527,12247
<class,9호선2~3단계,석촌고분,4256,3963,8219
<class,9호선2~3단계,삼전,5023,4588,9611
<class,9호선2~3단계,종합운동장,3156,2759,5915
<class,9호선2~3단계,봉은사,14518,15803,30321
<class,9호선2~3단계,삼성중앙,3009,3015,6024
<class,9호선2~3단계,선정릉,4836,5384,10220
<class,9호선2~3단계,언주,6791,6956,13747
<class,9호선,신논현,26240,26723,52963
<class,9호선,사평,2381,2178,4559
<class,9호선,고속터미널,12773,19090,31863
<class,9호선,신반포,2547,2520,5067
<class,9호선,구반포,1516,1535,3051
<class,9호선,동작,1567,1345,2912
<class,9호선,흑석,5779,5767,11546
<class,9호선,노들,3335,2742,6077
<class,9호선,노량진,21809,21508,43317
<class,9호선,샛강,2646,2611,5257
<class,우이신설선,성신여대입구,2888,3431,6319
<class,9호선,여의도,12090,11324,23414
<class,9호선,국회의사당,4667,4711,9378
<class,9호선,당산,13013,12129,25142
<class,9호선,선유도,4013,3841,7854
<class,9호선,신목동,2554,2121,4675
<class,9호선,염창,12253,11061,23314
<class,9호선,등촌,7366,6960,14326
<class,9호선,증미,4121,3878,7999
<class,9호선,가양,14947,13747,28694
<class,9호선,양천향교,5943,5544,11487
<class,9호선,마곡나루,8348,8213,16561
<class,9호선,신방화,4718,4329,9047
<class,9호선,공항시장,2409,2456,4865
<class,9호선,김포공항,8070,13050,21120
<class,9호선,개화,1565,1267,2832
<class,8호선,모란,3643,3334,6977
<class,8호선,수진,4221,3703,7924
<class,8호선,신흥,3466,3615,7081
<class,8호선,단대오거리,7683,7068,14751
<class,8호선,남한산성입구,9466,8293,17759
<class,8호선,산성,4791,4669,9460
<class,8호선,복정,7734,6673,14407
<class,8호선,장지,12535,11407,23942
<class,8호선,문정,9427,9310,18737
<class,8호선,가락시장,5649,5960,11609
<class,8호선,송파,4975,5040,10015
<class,8호선,석촌,5989,7071,13060
<class,8호선,잠실,12629,15235,27864
<class,8호선,몽촌토성,4887,4901,9788
<class,8호선,강동구청,6136,6053,12189
<class,8호선,천호,12255,14326,26581
<class,8호선,암사,12552,11330,23882
<class,7호선,부평구청,5148,4516,9664
<class,7호선,굴포천,6760,6997,13757
<class,7호선,삼산체육관,3751,3374,7125
<class,7호선,상동,11365,11799,23164
<class,7호선,부천시청,9855,9655,19510
<class,7호선,신중동,9939,9923,19862
<class,7호선,춘의,5139,4815,9954
<class,7호선,부천종합운동장,3186,2809,5995
<class,7호선,까치울,5645,5654,11299
<class,7호선,온수,5833,5816,11649
<class,7호선,천왕,6922,6533,13455
<class,7호선,광명사거리,17039,16773,33812
<class,7호선,철산,15748,15688,31436
<class,7호선,가산디지털단지,16518,15011,31529
<class,7호선,남구로,8081,8529,16610
<class,7호선,대림,6981,7666,14647
<class,7호선,신풍,8283,7785,16068
<class,7호선,보라매,7018,6551,13569
<class,7호선,신대방삼거리,11426,10350,21776
<class,7호선,장승배기,6724,6228,12952
<class,7호선,상도,7467,6618,14085
<class,7호선,숭실대입구,8695,8439,17134
<class,7호선,남성,7714,6905,14619
<class,7호선,이수,11963,11432,23395
<class,7호선,내방,7933,7786,15719
<class,7호선,고속터미널,15393,11835,27228
<class,7호선,반포,4395,4098,8493
<class,7호선,논현,11420,12830,24250
<class,7호선,학동,11771,12431,24202
<class,7호선,강남구청,10104,11039,21143
<class,7호선,청담,12093,13242,25335
<class,7호선,뚝섬유원지,7147,6677,13824
<class,7호선,건대입구,10410,11255,21665
<class,7호선,어린이대공원,9619,9299,18918
<class,7호선,군자,10820,8138,18958
<class,7호선,중곡,7062,6561,13623
<class,7호선,용마산,4493,4554,9047
<class,7호선,사가정,12459,11893,24352
<class,7호선,면목,11253,10725,21978
<class,7호선,상봉,13056,12697,25753
<class,7호선,중화,7920,7364,15284
<class,7호선,먹골,8310,8002,16312
<class,7호선,태릉입구,6793,6174,12967
<class,7호선,공릉,8993,8543,17536
<class,7호선,하계,12394,11221,23615
<class,7호선,중계,9666,8449,18115
<class,7호선,노원,15658,16331,31989
<class,7호선,마들,8896,8375,17271
<class,7호선,수락산,10145,9869,20014
<class,7호선,도봉산,6775,9198,15973
<class,7호선,장암,1747,1283,3030
<class,6호선,봉화산,5336,5232,10568
<class,6호선,화랑대,7620,6224,13844
<class,6호선,태릉입구,4298,4342,8640
<class,6호선,석계,8997,9012,18009
<class,6호선,돌곶이,6286,5712,11998
<class,6호선,상월곡,4173,3603,7776
<class,6호선,월곡,7654,7309,14963
<class,6호선,고려대,5930,5454,11384
<class,6호선,안암,8623,8218,16841
<class,6호선,보문,5332,4704,10036
<class,6호선,창신,2337,1968,4305
<class,6호선,동묘앞,9372,9880,19252
<class,6호선,신당,5869,4609,10478
<class,6호선,청구,2457,2388,4845
<class,6호선,약수,2570,2580,5150
<class,6호선,버티고개,1387,1425,2812
<class,6호선,한강진,8138,10448,18586
<class,6호선,이태원,12890,16894,29784
<class,6호선,녹사평,5177,5791,10968
<class,6호선,삼각지,5938,4469,10407
<class,6호선,효창공원앞,4681,4097,8778
<class,6호선,공덕,10886,10125,21011
<class,6호선,대흥,5469,5422,10891
<class,6호선,광흥창,5302,4751,10053
<class,6호선,상수,8089,10155,18244
<class,6호선,합정,12486,12105,24591
<class,6호선,망원,12882,14320,27202
<class,6호선,마포구청,9833,8251,18084
<class,6호선,월드컵경기장,4897,5554,10451
<class,6호선,디지털미디어시티,7301,7502,14803
<class,6호선,증산,7665,7278,14943
<class,6호선,새절,8747,8069,16816
<class,6호선,구산,5532,3907,9439
<class,6호선,연신내,2,0,2
<class,6호선,독바위,2117,2350,4467
<class,6호선,불광,3775,3478,7253
<class,6호선,역촌,2753,3099,5852
<class,6호선,응암,12832,12441,25273
<class,5호선,하남검단산,5109,5103,10212
<class,5호선,하남시청,4948,4758,9706
<class,5호선,하남풍산,2605,2596,5201
<class,5호선,미사,11792,11561,23353
<class,5호선,강일,2759,2488,5247
<class,우이신설선,보문,1187,1107,2294
<class,우이신설선,신설동,1538,1440,2978
<class,일산선,원흥,7530,7007,14537
<class,일산선,삼송,14276,13460,27736
<class,일산선,원당,8613,7950,16563
<class,일산선,화정,13222,13471,26693
<class,일산선,대곡,1494,1295,2789
<class,일산선,백석,7750,7906,15656
<class,일산선,정발산,6474,6990,13464
<class,장항선,신창,1412,1280,2692
<class,중앙선,회기,21057,19457,40514
<class,중앙선,중랑,4575,4307,8882
<class,중앙선,상봉,5499,5245,10744
<class,중앙선,망우,6645,6228,12873
<class,중앙선,양원,1285,1360,2645
<class,5호선,마천,4679,4710,9389
<class,5호선,거여,6055,5506,11561
<class,5호선,개롱,4615,4818,9433
<class,5호선,오금,2364,2169,4533
<class,5호선,방이,5409,5104,10513
<class,5호선,올림픽공원,3385,3189,6574
<class,5호선,둔촌동,6457,6373,12830
<class,5호선,상일동,9956,9082,19038
<class,5호선,개화산,3845,3727,7572
<class,5호선,방화,4761,4401,9162
<class,5호선,고덕,6484,6189,12673
<class,5호선,명일,6279,6214,12493
<class,4호선,쌍문,21759,19174,40933
<class,4호선,창동,19652,20717,40369
<class,4호선,노원,15485,17654,33139
<class,4호선,상계,14163,12997,27160
<class,4호선,당고개,10111,9406,19517
<class,4호선,남태령,1131,815,1946
<class,4호선,사당,22381,19658,42039
<class,4호선,총신대입구,14392,15612,30004
<class,4호선,동작,1470,1655,3125
<class,4호선,이촌,7027,7841,14868
<class,4호선,신용산,11092,11908,23000
<class,4호선,삼각지,3753,4951,8704
<class,4호선,숙대입구,9302,9036,18338
<class,4호선,서울역,6150,15612,21762
<class,4호선,회현,18736,19774,38510
<class,4호선,명동,16149,18470,34619
<class,4호선,충무로,15909,16363,32272
<class,4호선,동대문역사문화공원,13052,11494,24546
<class,4호선,동대문,18757,16408,35165
<class,4호선,혜화,30884,32619,63503
<class,4호선,한성대입구,11735,11018,22753
<class,4호선,성신여대입구,16993,16232,33225
<class,4호선,길음,14829,13609,28438
<class,4호선,미아사거리,22693,21534,44227
<class,4호선,미아,10939,10024,20963
<class,4호선,수유,26590,26180,52770
<class,3호선,오금,4022,3684,7706
<class,3호선,경찰병원,4114,4015,8129
<class,3호선,가락시장,6160,5953,12113
<class,3호선,수서,14052,13596,27648
<class,3호선,일원,5131,5055,10186
<class,3호선,대청,6133,5596,11729
<class,3호선,학여울,2441,2455,4896
<class,3호선,대치,8263,7489,15752
<class,3호선,도곡,3692,3797,7489
<class,3호선,매봉,6265,5979,12244
<class,3호선,양재,22335,23950,46285
<class,3호선,남부터미널,22135,22394,44529
<class,3호선,교대,7266,4352,11618
<class,3호선,고속터미널,49211,51572,100783
<class,3호선,잠원,3658,3526,7184
<class,3호선,신사,25103,27316,52419
<class,3호선,압구정,24832,26448,51280
<class,3호선,옥수,7224,7297,14521
<class,3호선,금호,6071,5462,11533
<class,3호선,약수,9222,8699,17921
<class,3호선,동대입구,6958,8097,15055
<class,3호선,충무로,2,0,2
<class,3호선,을지로3가,5783,6677,12460
<class,3호선,종로3가,6471,10292,16763
<class,3호선,안국,16239,17438,33677
<class,3호선,경복궁,17584,18160,35744
<class,3호선,독립문,6743,9031,15774
<class,3호선,무악재,2923,2901,5824
<class,3호선,홍제,13861,13003,26864
<class,3호선,녹번,10767,9114,19881
<class,3호선,불광,13472,15117,28589
<class,3호선,연신내,29874,28090,57964
<class,3호선,구파발,15663,15437,31100
<class,3호선,지축,3188,2919,6107
<class,2호선,용두,1818,1737,3555
<class,2호선,신정네거리,7472,7395,14867
<class,2호선,양천구청,4605,4636,9241
<class,2호선,도림천,859,832,1691
<class,2호선,신설동,3709,3269,6978
<class,2호선,신답,1098,1075,2173
<class,2호선,용답,2215,2099,4314
<class,2호선,충정로,6462,7462,13924
<class,2호선,아현,7789,7163,14952
<class,2호선,이대,10691,10929,21620
<class,2호선,신촌,30612,30875,61487
<class,2호선,홍대입구,62614,71630,134244
<class,2호선,합정,27704,31873,59577
<class,2호선,당산,12854,13839,26693
<class,2호선,영등포구청,13306,13766,27072
<class,2호선,문래,12555,13311,25866
<class,2호선,신도림,41812,42474,84286
<class,2호선,대림,17723,18793,36516
<class,2호선,구로디지털단지,35418,34467,69885
<class,2호선,신대방,20194,19016,39210
<class,2호선,신림,50467,47690,98157
<class,2호선,봉천,17385,15219,32604
<class,2호선,서울대입구,38510,36841,75351
<class,2호선,낙성대,21828,19684,41512
<class,2호선,사당,32804,36423,69227
<class,2호선,방배,10056,10106,20162
<class,2호선,서초,12329,8855,21184
<class,2호선,교대,17349,19639,36988
<class,2호선,강남,61857,65399,127256
<class,2호선,역삼,19021,20647,39668
<class,2호선,선릉,24571,21664,46235
<class,2호선,삼성,35051,35456,70507
<class,2호선,종합운동장,4828,5435,10263
<class,2호선,잠실새내,16445,17023,33468
<class,2호선,잠실,67050,64393,131443
<class,2호선,잠실나루,7797,7480,15277
<class,2호선,강변,28791,29332,58123
<class,2호선,구의,16429,15697,32126
<class,2호선,건대입구,34797,39327,74124
<class,2호선,성수,19234,21897,41131
<class,2호선,뚝섬,14710,14647,29357
<class,2호선,한양대,4082,4036,8118
<class,2호선,왕십리,14122,12211,26333
<class,2호선,상왕십리,10095,9046,19141
<class,2호선,신당,11137,11206,22343
<class,2호선,동대문역사문화공원,11340,12143,23483
<class,2호선,을지로4가,7903,8207,16110
<class,2호선,을지로3가,13565,15088,28653
<class,2호선,을지로입구,18843,18267,37110
<class,2호선,시청,8933,8169,17102
<class,1호선,청량리,18521,18888,37409
<class,1호선,제기동,15716,15746,31462
<class,1호선,신설동,11672,9491,21163
<class,1호선,동대문,14503,12154,26657
<class,1호선,종로5가,21504,20706,42210
<class,1호선,종로3가,27538,27226,54764
<class,1호선,종각,18364,17064,35428
<class,1호선,시청,11179,11876,23055
<class,1호선,동묘앞,11909,11877,23786
<class,1호선,서울역,38309,38972,77281
<class,5호선,굽은다리,7194,6683,13877
<class,경의선,계양,1,0,1
<class,5호선,길동,6122,6304,12426
<class,5호선,강동,13364,12529,25893
<class,5호선,천호,16910,16378,33288
<class,5호선,광나루,10797,10185,20982
<class,5호선,아차산,12596,12039,24635
<class,5호선,군자,8549,9466,18015
<class,5호선,장한평,11457,11121,22578
<class,5호선,답십리,10382,9365,19747
<class,5호선,마장,3959,3804,7763
<class,5호선,왕십리,3587,4313,7900
<class,5호선,행당,5672,4968,10640
<class,5호선,신금호,4186,4242,8428
<class,5호선,청구,2574,2319,4893
<class,5호선,동대문역사문화공원,983,1281,2264
<class,5호선,을지로4가,3573,3897,7470
<class,5호선,종로3가,14248,16855,31103
<class,5호선,광화문,13324,13492,26816
<class,5호선,서대문,8962,9115,18077
<class,5호선,충정로,2232,2004,4236
<class,5호선,애오개,3816,3700,7516
<class,5호선,공덕,7675,7916,15591
<class,5호선,마포,7686,7659,15345
<class,5호선,여의나루,9348,10868,20216
<class,5호선,여의도,11649,12211,23860
<class,5호선,신길,2612,2569,5181
<class,5호선,영등포시장,8099,8629,16728
<class,5호선,영등포구청,2024,1992,4016
<class,5호선,양평,3681,3422,7103
<class,5호선,오목교,16151,16784,32935
<class,5호선,목동,11317,11149,22466
<class,5호선,신정,8948,7354,16302
<class,5호선,까치산,21391,19893,41284
<class,5호선,화곡,20628,18720,39348
<class,5호선,우장산,10155,9824,19979
<class,5호선,발산,14641,15863,30504
<class,5호선,마곡,5253,5261,10514
<class,5호선,송정,5187,4988,10175
<class,5호선,김포공항,7589,7506,15095
<class,중앙선,구리,10952,10934,21886
<class,중앙선,도농,7454,6979,14433
<class,중앙선,양정,639,532,1171
<class,중앙선,덕소,4584,3624,8208
<class,중앙선,도심,1704,1445,3149
<class,중앙선,팔당,1297,1378,2675
<class,중앙선,운길산,1264,1311,2575
<class,중앙선,양수,2077,2214,4291
<class,중앙선,신원,257,202,459
<class,중앙선,국수,649,698,1347
<class,중앙선,아신,588,686,1274
<class,중앙선,오빈,324,351,675
<class,중앙선,양평,3875,4138,8013
<class,중앙선,원덕,415,534,949
<class,중앙선,용문,2218,2551,4769
<class,중앙선,지평,44,59,103
<class,일산선,마두,5286,5360,10646
<class,일산선,주엽,6719,6542,13261
<class,일산선,대화,9091,8188,17279
<class,장항선,봉명,722,684,1406
<class,장항선,쌍용,1665,1392,3057
<class,9호선2~3단계,삼전,3592,3391,6983
<class,9호선2~3단계,봉은사,7690,7658,15348
<class,9호선2~3단계,삼성중앙,1873,1994,3867
<class,9호선2~3단계,선정릉,2949,3383,6332
<class,9호선2~3단계,언주,4150,4085,8235
<class,9호선,신논현,15775,15094,30869
<class,9호선,사평,1398,1501,2899
<class,9호선,고속터미널,10506,14206,24712
<class,9호선,신반포,1570,1745,3315
<class,9호선,구반포,934,955,1889
<class,9호선,동작,1281,1071,2352
<class,9호선,흑석,3768,3990,7758
<class,9호선,노들,2529,2290,4819
<class,9호선,노량진,14421,15407,29828
<class,9호선,샛강,1613,1599,3212
<class,9호선,여의도,8956,8082,17038
<class,9호선,국회의사당,4753,4524,9277
<class,9호선,당산,9007,8801,17808
<class,9호선,선유도,2894,2905,5799
<class,9호선,신목동,1666,1516,3182
<class,9호선,염창,8563,8514,17077
<class,9호선,등촌,5110,5283,10393
<class,9호선,증미,2519,2460,4979
<class,9호선,가양,10162,10011,20173
<class,9호선,양천향교,4244,4423,8667
<class,9호선,마곡나루,6035,5989,12024
<class,9호선,신방화,3316,3347,6663
<class,9호선,공항시장,1776,1956,3732
<class,9호선,김포공항,7430,11761,19191
<class,9호선,개화,1183,1011,2194
<class,8호선,모란,4421,3884,8305
<class,8호선,수진,3248,2858,6106
<class,8호선,신흥,2674,2889,5563
<class,8호선,단대오거리,5676,5520,11196
<class,8호선,남한산성입구,7078,6468,13546
<class,8호선,산성,3471,3559,7030
<class,8호선,복정,5469,5210,10679
<class,8호선,장지,9228,9339,18567
<class,8호선,문정,6086,6450,12536
<class,8호선,가락시장,3209,3897,7106
<class,8호선,송파,3775,3708,7483
<class,8호선,석촌,4219,5150,9369
<class,8호선,잠실,9769,11300,21069
<class,8호선,몽촌토성,3669,3648,7317
<class,8호선,강동구청,4541,4647,9188
<class,8호선,천호,8803,10202,19005
<class,3호선,약수,6446,6367,12813
<class,8호선,암사,9055,8491,17546
<class,7호선,부평구청,3744,3317,7061
<class,7호선,굴포천,4809,4790,9599
<class,7호선,삼산체육관,3340,3269,6609
<class,7호선,상동,7832,7699,15531
<class,7호선,부천시청,6766,6759,13525
<class,7호선,신중동,6842,6746,13588
<class,7호선,춘의,3549,3346,6895
<class,7호선,부천종합운동장,2404,2246,4650
<class,7호선,까치울,4403,4286,8689
<class,7호선,온수,3976,4063,8039
<class,7호선,천왕,4953,4734,9687
<class,7호선,광명사거리,12477,12332,24809
<class,7호선,철산,10693,10563,21256
<class,7호선,가산디지털단지,12066,11050,23116
<class,7호선,남구로,6533,6400,12933
<class,7호선,대림,7569,7142,14711
<class,7호선,신풍,6260,6023,12283
<class,7호선,보라매,4899,4944,9843
<class,7호선,신대방삼거리,7915,7824,15739
<class,7호선,장승배기,4796,4670,9466
<class,7호선,상도,5219,5209,10428
<class,7호선,숭실대입구,5943,6402,12345
<class,7호선,남성,5410,5319,10729
<class,7호선,이수,8364,8179,16543
<class,7호선,내방,4972,5141,10113
<class,7호선,고속터미널,13868,8490,22358
<class,7호선,반포,2792,2720,5512
<class,7호선,논현,6341,6638,12979
<class,7호선,학동,6989,7749,14738
<class,7호선,강남구청,5823,6280,12103
<class,7호선,청담,6900,7519,14419
<class,7호선,뚝섬유원지,6192,5537,11729
<class,7호선,건대입구,7627,7978,15605
<class,7호선,어린이대공원,7287,7499,14786
<class,7호선,군자,7527,5772,13299
<class,7호선,중곡,5096,4928,10024
<class,7호선,용마산,3532,3770,7302
<class,7호선,사가정,9025,8615,17640
<class,7호선,면목,7857,7842,15699
<class,7호선,상봉,9182,8587,17769
<class,7호선,중화,5542,5403,10945
<class,7호선,먹골,6018,5996,12014
<class,7호선,태릉입구,4942,4513,9455
<class,7호선,공릉,6531,6707,13238
<class,7호선,하계,9229,8721,17950
<class,7호선,중계,6543,6181,12724
<class,7호선,노원,10855,10873,21728
<class,7호선,마들,6017,5691,11708
<class,7호선,수락산,8190,8058,16248
<class,7호선,도봉산,5766,8227,13993
<class,7호선,장암,1406,1061,2467
<class,6호선,신내,1,0,1
<class,6호선,봉화산,3997,3901,7898
<class,6호선,화랑대,5675,5016,10691
<class,6호선,태릉입구,3214,3458,6672
<class,6호선,석계,6710,6834,13544
<class,6호선,돌곶이,5136,4949,10085
<class,6호선,상월곡,3273,2819,6092
<class,6호선,월곡,5245,5210,10455
<class,6호선,고려대,4493,4296,8789
<class,6호선,안암,5738,6020,11758
<class,6호선,보문,3934,3704,7638
<class,6호선,창신,1662,1458,3120
<class,6호선,동묘앞,6441,6323,12764
<class,6호선,신당,3462,4230,7692
<class,6호선,청구,1654,1675,3329
<class,6호선,약수,1789,1692,3481
<class,6호선,버티고개,905,1002,1907
<class,6호선,한강진,5943,6976,12919
<class,6호선,이태원,10411,9480,19891
<class,6호선,녹사평,4130,3774,7904
<class,6호선,삼각지,3916,2994,6910
<class,6호선,효창공원앞,3437,3026,6463
<class,6호선,공덕,6881,6478,13359
<class,6호선,대흥,3801,3788,7589
<class,6호선,광흥창,4050,3842,7892
<class,6호선,상수,6207,6995,13202
<class,6호선,합정,9027,8631,17658
<class,6호선,망원,8983,9818,18801
<class,6호선,마포구청,7223,6503,13726
<class,6호선,월드컵경기장,3942,4258,8200
<class,6호선,디지털미디어시티,5222,5359,10581
<class,6호선,증산,5588,5503,11091
<class,6호선,새절,6425,6165,12590
<class,6호선,구산,3808,2844,6652
<class,6호선,독바위,1462,1812,3274
<class,6호선,불광,2951,2697,5648
<class,6호선,역촌,1996,2317,4313
<class,6호선,응암,9066,9030,18096
<class,5호선,하남검단산,4461,4418,8879
<class,5호선,하남시청,3958,3776,7734
<class,5호선,하남풍산,2089,2110,4199
<class,5호선,미사,8585,8583,17168
<class,5호선,강일,2001,1842,3843
<class,5호선,마천,3525,3870,7395
<class,5호선,거여,4303,4004,8307
<class,5호선,개롱,3046,3355,6401
<class,5호선,오금,1665,1519,3184
<class,5호선,방이,4152,4015,8167
<class,5호선,올림픽공원,2585,2380,4965
<class,5호선,둔촌동,4426,4465,8891
<class,5호선,상일동,6882,6552,13434
<class,5호선,고덕,4165,4161,8326
<class,5호선,명일,4798,4850,9648
<class,5호선,굽은다리,5113,4747,9860
<class,5호선,길동,4145,4264,8409
<class,5호선,강동,9048,9023,18071
<class,5호선,천호,12436,11688,24124
<class,5호선,광나루,8063,7752,15815
<class,5호선,아차산,10415,10341,20756
<class,5호선,군자,6000,6631,12631
<class,5호선,장한평,7791,7902,15693
<class,5호선,답십리,7522,6933,14455
<class,5호선,마장,2808,2643,5451
<class,5호선,왕십리,2431,2918,5349
<class,5호선,행당,3964,3642,7606
<class,5호선,신금호,2859,3139,5998
<class,5호선,청구,1775,1631,3406
<class,5호선,동대문역사문화공원,679,820,1499
<class,5호선,을지로4가,1605,1663,3268
<class,5호선,종로3가,9102,8273,17375
<class,5호선,광화문,12236,12133,24369
<class,5호선,서대문,5282,5217,10499
<class,5호선,충정로,1334,1398,2732
<class,5호선,애오개,2622,2632,5254
<class,5호선,공덕,4677,4904,9581
<class,5호선,마포,4896,4852,9748
<class,5호선,여의나루,8672,9630,18302
<class,5호선,여의도,7709,8114,15823
<class,5호선,신길,1774,1993,3767
<class,5호선,영등포시장,5430,5839,11269
<class,5호선,영등포구청,1276,1301,2577
<class,5호선,양평,2543,2550,5093
<class,5호선,오목교,11237,11693,22930
<class,5호선,목동,7554,7726,15280
<class,5호선,신정,6345,5753,12098
<class,5호선,까치산,15529,15017,30546
<class,5호선,화곡,14178,13269,27447
<class,5호선,우장산,6786,6953,13739
<class,5호선,발산,9686,10576,20262
<class,5호선,마곡,3553,3674,7227
<class,5호선,송정,3797,3761,7558
<class,5호선,김포공항,6879,6374,13253
<class,5호선,개화산,2758,2805,5563
<class,5호선,방화,3743,3648,7391
<class,4호선,쌍문,15651,14184,29835
<class,4호선,창동,14768,15302,30070
<class,4호선,노원,11462,12650,24112
<class,4호선,상계,10232,9444,19676
<class,4호선,당고개,7691,7314,15005
<class,4호선,남태령,825,573,1398
<class,4호선,사당,15397,14433,29830
<class,4호선,총신대입구,10174,11178,21352
<class,4호선,동작,1237,1211,2448
<class,4호선,이촌,4750,5249,9999
<class,4호선,신용산,8167,8213,16380
<class,4호선,삼각지,2582,3511,6093
<class,4호선,숙대입구,7135,6759,13894
<class,4호선,서울역,4400,10835,15235
<class,4호선,회현,9008,9495,18503
<class,4호선,명동,12639,12580,25219
<class,4호선,충무로,9847,9654,19501
<class,4호선,동대문역사문화공원,8719,8185,16904
<class,4호선,동대문,7036,7596,14632
<class,4호선,혜화,24172,25282,49454
<class,4호선,한성대입구,8003,8042,16045
<class,4호선,성신여대입구,12305,12061,24366
<class,4호선,길음,10461,10156,20617
<class,4호선,미아사거리,15847,15139,30986
<class,4호선,미아,7840,7541,15381
<class,4호선,수유,19950,19178,39128
<class,3호선,오금,2851,2815,5666
<class,3호선,경찰병원,2839,2862,5701
<class,3호선,가락시장,3756,4072,7828
<class,3호선,수서,10099,10381,20480
<class,3호선,일원,3265,3387,6652
<class,3호선,대청,4264,4105,8369
<class,3호선,학여울,1977,2058,4035
<class,3호선,대치,5065,4586,9651
<class,3호선,도곡,2028,2275,4303
<class,3호선,매봉,4192,4168,8360
<class,3호선,양재,13840,16061,29901
<class,3호선,남부터미널,14974,15793,30767
<class,3호선,교대,4598,2698,7296
<class,3호선,고속터미널,41312,39077,80389
<class,3호선,잠원,2449,2375,4824
<class,3호선,신사,14504,14736,29240
<class,3호선,압구정,13939,14504,28443
<class,3호선,옥수,5124,5326,10450
<class,3호선,금호,4357,4070,8427
<class,3호선,동대입구,6210,7251,13461
<class,3호선,을지로3가,3514,3209,6723
<class,3호선,종로3가,4164,5021,9185
<class,3호선,안국,12040,13130,25170
<class,3호선,경복궁,15128,15947,31075
<class,3호선,독립문,4141,4851,8992
<class,3호선,무악재,1931,2079,4010
<class,3호선,홍제,9400,9021,18421
<class,3호선,녹번,7447,6620,14067
<class,3호선,불광,9931,11367,21298
<class,3호선,연신내,21299,20470,41769
<class,3호선,구파발,11725,11983,23708
<class,3호선,지축,2159,2028,4187
<class,2호선,용두,1035,1032,2067
<class,2호선,신정네거리,5166,5234,10400
<class,2호선,양천구청,3339,3416,6755
<class,2호선,도림천,478,503,981
<class,2호선,신설동,2953,2970,5923
<class,2호선,신답,699,754,1453
<class,2호선,용답,1662,1725,3387
<class,2호선,충정로,3867,4099,7966
<class,2호선,아현,5149,5089,10238
<class,2호선,이대,6967,7463,14430
<class,2호선,신촌,21795,21161,42956
<class,2호선,홍대입구,48120,48022,96142
<class,2호선,합정,20959,22256,43215
<class,2호선,당산,8980,9760,18740
<class,2호선,영등포구청,8361,8673,17034
<class,2호선,문래,8012,8461,16473
<class,2호선,신도림,30181,30247,60428
<class,2호선,대림,15445,15605,31050
<class,2호선,구로디지털단지,24040,23804,47844
<class,2호선,신대방,15261,15026,30287
<class,2호선,신림,36729,36061,72790
<class,2호선,봉천,12225,11842,24067
<class,2호선,서울대입구,27255,28326,55581
<class,2호선,낙성대,15823,16165,31988
<class,2호선,사당,22342,25012,47354
<class,2호선,방배,6834,7191,14025
<class,2호선,서초,10998,10267,21265
<class,2호선,교대,10407,11626,22033
<class,2호선,강남,35726,35775,71501
<class,2호선,역삼,11492,12339,23831
<class,2호선,선릉,13071,11351,24422
<class,2호선,삼성,19899,19598,39497
<class,2호선,종합운동장,3928,4337,8265
<class,2호선,잠실새내,10604,10913,21517
<class,1호선,서울역,30215,27671,57886
<class,1호선,동묘앞,12093,12310,24403
<class,1호선,시청,9084,8819,17903
<class,1호선,종각,13246,11625,24871
<class,1호선,종로3가,15147,13025,28172
<class,1호선,종로5가,8926,8899,17825
<class,1호선,동대문,9606,10053,19659
<class,1호선,신설동,7731,7697,15428
<class,1호선,제기동,10139,10636,20775
<class,1호선,청량리,12710,13100,25810
<class,2호선,시청,6664,5841,12505
<class,2호선,을지로입구,15612,14366,29978
<class,2호선,을지로3가,8454,7762,16216
<class,2호선,을지로4가,3368,3215,6583
<class,2호선,동대문역사문화공원,7339,8875,16214
<class,2호선,신당,8101,8494,16595
<class,2호선,상왕십리,6953,6840,13793
<class,2호선,왕십리,9526,8280,17806
<class,2호선,한양대,2511,2803,5314
<class,2호선,뚝섬,10332,10315,20647
<class,2호선,성수,12923,14466,27389
<class,2호선,건대입구,26433,28073,54506
<class,2호선,구의,11405,11379,22784
<class,2호선,강변,23232,22201,45433
<class,2호선,잠실나루,5356,5485,10841
<class,2호선,잠실,49688,46499,96187
<class,장항선,신창,1086,1738,2824
<class,장항선,온양온천,5334,5294,10628
<class,중앙선,지평,52,42,94
<class,중앙선,용문,2276,1875,4151
<class,중앙선,원덕,389,327,716
<class,중앙선,양평,2330,2064,4394
<class,중앙선,오빈,258,223,481
<class,중앙선,아신,735,603,1338
<class,중앙선,국수,593,482,1075
<class,중앙선,신원,260,159,419
<class,중앙선,양수,1781,1641,3422
<class,중앙선,운길산,1117,1037,2154
<class,중앙선,팔당,1286,1282,2568
<class,중앙선,도심,1244,1134,2378
<class,중앙선,덕소,3430,2747,6177
<class,중앙선,양정,514,442,956
<class,중앙선,도농,5222,5076,10298
<class,중앙선,구리,7608,7782,15390
<class,중앙선,양원,932,971,1903
<class,중앙선,망우,4902,4888,9790
<class,중앙선,상봉,4131,4186,8317
<class,중앙선,중랑,3465,3340,6805
<class,중앙선,회기,15889,16044,31933
<class,장항선,배방,897,975,1872
<class,장항선,탕정,366,389,755
<class,장항선,아산,3879,2582,6461
<class,장항선,쌍용,1389,1490,2879
<class,장항선,봉명,628,639,1267
<class,일산선,대화,6603,6326,12929
<class,일산선,주엽,4403,4490,8893
<class,일산선,정발산,5069,5110,10179
<class,일산선,마두,3487,3410,6897
<class,일산선,백석,5579,5456,11035
<class,일산선,대곡,1231,1014,2245
<class,일산선,화정,9367,9481,18848
<class,일산선,원당,6339,6108,12447
<class,일산선,삼송,10652,10237,20889
<class,일산선,지축,1,0,1
<class,일산선,원흥,5470,5292,10762
<class,우이신설선,신설동,1154,1192,2346
<class,우이신설선,보문,872,898,1770
<class,우이신설선,성신여대입구,2317,2476,4793
<class,우이신설선,정릉,2735,2351,5086
<class,우이신설선,북한산보국문,3772,3391,7163
<class,우이신설선,솔샘,2843,2575,5418
<class,우이신설선,삼양사거리,1525,1464,2989
<class,우이신설선,삼양,1131,1164,2295
<class,우이신설선,화계,2110,1836,3946
<class,우이신설선,가오리,2325,2193,4518
<class,우이신설선,4.19민주묘지,1833,1663,3496
<class,우이신설선,솔밭공원,1374,1342,2716
<class,우이신설선,북한산우이,3370,3464,6834
<class,안산선,수리산,2081,2051,4132
<class,안산선,오이도,6142,5881,12023
<class,안산선,정왕,5509,6278,11787
<class,안산선,신길온천,1190,1072,2262
<class,안산선,안산,10046,9334,19380
<class,안산선,초지,2503,2514,5017
<class,안산선,고잔,4936,4939,9875
<class,안산선,중앙,11823,11745,23568
<class,안산선,한대앞,5576,5546,11122
<class,안산선,상록수,9396,9211,18607
<class,안산선,반월,2599,2581,5180
<class,안산선,대야미,3056,2703,5759
<class,안산선,산본,8837,9419,18256
<class,수인선,인천,1123,1686,2809
<class,수인선,신포,1124,1106,2230
<class,수인선,숭의,2083,1882,3965
<class,수인선,인하대,3368,3178,6546
<class,수인선,송도,1581,1611,3192
<class,수인선,연수,3171,3063,6234
<class,수인선,원인재,2876,3057,5933
<class,수인선,남동인더스파크,554,596,1150
<class,수인선,호구포,2063,2127,4190
<class,수인선,인천논현,2757,2919,5676
<class,수인선,소래포구,5742,5474,11216
<class,수인선,월곶,1608,1509,3117
<class,수인선,달월,43,50,93
<class,수인선,사리,2704,2285,4989
<class,수인선,야목,222,175,397
<class,수인선,어천,577,697,1274
<class,수인선,오목천,1531,1424,2955
<class,수인선,고색,1719,1861,3580
<class,분당선,매교,1390,1509,2899
<class,분당선,수원시청,7997,7942,15939
<class,분당선,매탄권선,2499,2404,4903
<class,분당선,망포,6340,6655,12995
<class,분당선,영통,4746,4866,9612
<class,분당선,청명,2089,2110,4199
<class,분당선,상갈,3014,2988,6002
<class,분당선,기흥,5037,4800,9837
<class,분당선,신갈,1966,2081,4047
<class,분당선,구성,2574,2668,5242
<class,분당선,죽전,7987,8880,16867
<class,분당선,보정,1104,1087,2191
<class,분당선,이매,3282,3420,6702
<class,분당선,오리,5813,5078,10891
<class,분당선,미금,7280,7770,15050
<class,분당선,정자,7339,7533,14872
<class,분당선,수내,5844,5785,11629
<class,분당선,서현,14034,14039,28073
<class,분당선,야탑,14080,14172,28252
<class,분당선,모란,18222,19020,37242
<class,분당선,태평,8325,7887,16212
<class,분당선,가천대,4329,4996,9325
<class,분당선,선정릉,2119,2159,4278
<class,분당선,강남구청,3490,4155,7645
<class,분당선,압구정로데오,10521,11828,22349
<class,분당선,서울숲,7182,7506,14688
<class,분당선,수원,6121,5121,11242
<class,분당선,수서,8774,8556,17330
<class,분당선,대모산입구,2200,2103,4303
<class,분당선,개포동,1819,1806,3625
<class,분당선,구룡,787,869,1656
<class,분당선,도곡,2735,2452,5187
<class,분당선,한티,7315,7188,14503
<class,분당선,선릉,2705,4238,6943
<class,과천선,범계,14980,14509,29489
<class,과천선,평촌,6697,6395,13092
<class,과천선,인덕원,11996,12216,24212
<class,과천선,정부과천청사,4614,4531,9145
<class,과천선,과천,3349,3123,6472
<class,과천선,대공원,5744,5864,11608
<class,과천선,경마공원,6103,6104,12207
<class,과천선,선바위,4058,3672,7730
<class,공항철도 1호선,영종,2369,2299,4668
<class,공항철도 1호선,인천공항2터미널,1813,1788,3601
<class,공항철도 1호선,인천공항1터미널,3650,3663,7313
<class,공항철도 1호선,공항화물청사,947,1038,1985
<class,공항철도 1호선,운서,4896,5279,10175
<class,공항철도 1호선,청라국제도시,3297,3115,6412
<class,공항철도 1호선,검암,3684,3881,7565
<class,공항철도 1호선,계양,5265,5098,10363
<class,공항철도 1호선,김포공항,11641,5867,17508
<class,공항철도 1호선,마곡나루,2353,2534,4887
<class,공항철도 1호선,디지털미디어시티,3958,3956,7914
<class,공항철도 1호선,홍대입구,9775,9087,18862
<class,공항철도 1호선,공덕,1265,1667,2932
<class,공항철도 1호선,서울역,8301,7486,15787
<class,경춘선,춘천,1741,1516,3257
<class,경춘선,남춘천,2598,2728,5326
<class,경춘선,김유정,501,552,1053
<class,경춘선,강촌,837,603,1440
<class,경춘선,백양리,96,94,190
<class,경춘선,굴봉산,177,148,325
<class,경춘선,가평,2464,1810,4274
<class,경춘선,상천,364,296,660
<class,경춘선,청평,1637,1255,2892
<class,경춘선,대성리,964,445,1409
<class,경춘선,마석,2462,2365,4827
<class,경춘선,천마산,1091,1077,2168
<class,경춘선,평내호평,3453,3323,6776
<class,경춘선,금곡,903,853,1756
<class,경춘선,사릉,1743,1816,3559
<class,경춘선,퇴계원,2057,1846,3903
<class,경춘선,별내,1964,1792,3756
<class,경춘선,갈매,1557,1317,2874
<class,경춘선,신내,925,920,1845
<class,경인선,도화,2397,2200,4597
<class,경인선,중동,4875,4552,9427
<class,경인선,온수,3790,3585,7375
<class,경인선,도원,1652,1676,3328
<class,경인선,간석,3158,3021,6179
<class,경인선,부개,4748,4497,9245
<class,경인선,소사,5924,5757,11681
<class,경인선,구일,9155,10975,20130
<class,경인선,인천,4156,3395,7551
<class,경인선,동인천,9762,9532,19294
<class,경인선,제물포,5561,5458,11019
<class,경인선,주안,11979,10551,22530
<class,경인선,동암,9570,9535,19105
<class,경인선,백운,3960,3991,7951
<class,경인선,부평,22825,23184,46009
<class,경인선,송내,13380,13006,26386
<class,경인선,부천,21351,21170,42521
<class,경인선,역곡,14767,14588,29355
<class,경인선,오류동,7197,6728,13925
<class,경인선,개봉,12322,11893,24215
<class,경의선,임진강,43,37,80
<class,경의선,문산,3931,3974,7905
<class,경의선,파주,649,587,1236
<class,경의선,월롱,954,1809,2763
<class,경의선,금촌,4177,4338,8515
<class,경의선,금릉,2844,2765,5609
<class,경의선,운정,3882,3667,7549
<class,경의선,야당,4404,4264,8668
<class,경의선,탄현,4073,3833,7906
<class,경의선,일산,4750,4569,9319
<class,경의선,풍산,3597,3469,7066
<class,경의선,백마,3359,3299,6658
<class,경의선,곡산,345,299,644
<class,경의선,능곡,2217,2165,4382
<class,경의선,행신,4509,4313,8822
<class,경의선,강매,1509,1387,2896
<class,경의선,화전,872,900,1772
<class,경의선,수색,905,974,1879
<class,경의선,디지털미디어시티,1349,1293,2642
<class,경의선,가좌,2828,2780,5608
<class,경의선,홍대입구,1587,1800,3387
<class,경의선,서강대,1256,1314,2570
<class,경의선,공덕,1920,1518,3438
<class,경의선,효창공원앞,1331,1524,2855
<class,경의선,신촌,255,288,543
<class,경의선,서울역,1236,988,2224
<class,경원선,소요산,4668,4066,8734
<class,경원선,동두천,1372,1682,3054
<class,경원선,보산,1299,1623,2922
<class,경원선,동두천중앙,2108,2054,4162
<class,경원선,지행,4430,4520,8950
<class,경원선,덕정,3396,3592,6988
<class,경원선,덕계,1820,1729,3549
<class,경원선,양주,5258,5302,10560
<class,경원선,녹양,2687,2452,5139
<class,경원선,가능,3922,3767,7689
<class,경원선,의정부,14086,14310,28396
<class,경원선,회룡,7551,7595,15146
<class,경원선,망월사,4971,5052,10023
<class,경원선,도봉산,9406,6727,16133
<class,경원선,도봉,3597,3419,7016
<class,경원선,방학,5926,5728,11654
<class,경원선,녹천,2616,2316,4932
<class,경원선,월계,3921,3676,7597
<class,경원선,광운대,4359,4407,8766
<class,경원선,석계,5166,5725,10891
<class,경원선,신이문,4756,4498,9254
<class,경원선,외대앞,5267,5158,10425
<class,경원선,청량리,14080,13106,27186
<class,경원선,왕십리,9556,10767,20323
<class,경원선,응봉,1094,1011,2105
<class,경원선,옥수,66,32,98
<class,경원선,한남,1908,1823,3731
<class,경원선,서빙고,1380,1428,2808
<class,경원선,이촌,2150,1703,3853
<class,경부선,광명,3021,2121,5142
<class,경부선,서동탄,815,830,1645
<class,경부선,당정,3079,2966,6045
<class,경부선,천안,6729,6487,13216
<class,경부선,두정,4432,5090,9522
<class,경부선,직산,631,639,1270
<class,경부선,성환,2658,3092,5750
<class,경부선,평택,11947,12976,24923
<class,경부선,평택지제,2523,2386,4909
<class,경부선,서정리,4554,6217,10771
<class,경부선,송탄,3702,4237,7939
<class,경부선,진위,919,940,1859
<class,경부선,오산,7906,8380,16286
<class,경부선,오산대,2246,2243,4489
<class,경부선,세마,1757,1587,3344
<class,경부선,병점,9767,10510,20277
<class,경부선,세류,2207,2118,4325
<class,경부선,독산,6407,6502,12909
<class,경부선,수원,35147,34049,69196
<class,경부선,화서,4513,4425,8938
<class,경부선,성균관대,8070,8512,16582
<class,경부선,의왕,4376,4496,8872
<class,경부선,군포,3171,3045,6216
<class,경부선,금정,14311,14694,29005
<class,경부선,명학,3840,3920,7760
<class,경부선,안양,13961,13509,27470
<class,경부선,관악,4974,4517,9491
<class,경부선,석수,5356,4968,10324
<class,경부선,금천구청,6666,6461,13127
<class,경부선,가산디지털단지,5186,7103,12289
<class,경부선,구로,11022,10680,21702
<class,경부선,신길,4877,4319,9196
<class,경부선,신도림,2476,2628,5104
<class,경부선,영등포,33051,31933,64984
<class,경부선,대방,5999,6436,12435
<class,경부선,노량진,6387,6237,12624
<class,경부선,용산,34358,30680,65038
<class,경부선,남영,4656,4981,9637
<class,경부선,서울역,8087,1768,9855
<class,경강선,여주,2259,2258,4517
<class,경강선,세종대왕릉,345,328,673
<class,경강선,부발,1412,2021,3433
<class,경강선,이천,2251,2419,4670
<class,경강선,신둔도예촌,1021,981,2002
<class,경강선,곤지암,1855,1893,3748
<class,경강선,초월,1736,1694,3430
<class,경강선,경기광주,3810,3716,7526
<class,경강선,삼동,1090,1059,2149
<class,경강선,이매,672,487,1159
<class,경강선,판교,2472,2252,4724
<class,9호선2~3단계,중앙보훈병원,3347,3230,6577
<class,9호선2~3단계,둔촌오륜,457,469,926
<class,9호선2~3단계,올림픽공원,4887,5055,9942
<class,9호선2~3단계,한성백제,1576,1346,2922
<class,9호선2~3단계,송파나루,2948,3296,6244
<class,9호선2~3단계,석촌,4680,3989,8669
<class,9호선2~3단계,석촌고분,3072,3018,6090
<class,9호선2~3단계,종합운동장,2161,1984,4145
<class,일산선,백석,7609,7736,15345
<class,경부선,평택,14141,13647,27788
<class,경부선,평택지제,3353,3037,6390
<class,경부선,서정리,7196,5885,13081
<class,경부선,송탄,5114,4514,9628
<class,경부선,진위,1044,962,2006
<class,경부선,오산,9587,9002,18589
<class,경부선,오산대,2906,2669,5575
<class,경부선,세마,2277,2037,4314
<class,경부선,병점,12698,12477,25175
<class,경부선,세류,2605,2563,5168
<class,경부선,독산,9317,9117,18434
<class,경부선,수원,38586,42267,80853
<class,경부선,화서,5873,5843,11716
<class,경부선,성균관대,10946,10882,21828
<class,경부선,의왕,6157,5925,12082
<class,경부선,군포,4516,4126,8642
<class,경부선,금정,19374,19036,38410
<class,경부선,명학,5432,5192,10624
<class,경부선,안양,18077,18078,36155
<class,경부선,관악,6099,5788,11887
<class,경부선,석수,7154,6471,13625
<class,경부선,금천구청,8681,8470,17151
<class,경부선,가산디지털단지,6840,8893,15733
<class,경부선,구로,13862,14645,28507
<class,경부선,신길,6319,5188,11507
<class,경부선,신도림,3041,3343,6384
<class,경부선,영등포,40299,42461,82760
<class,경부선,대방,8493,8375,16868
<class,경부선,노량진,9469,9211,18680
<class,경부선,용산,38056,40154,78210
<class,경부선,남영,6310,6611,12921
<class,경부선,서울역,9020,2209,11229
<class,경강선,여주,2333,2678,5011
<class,경강선,세종대왕릉,357,365,722
<class,경강선,부발,1927,1666,3593
<class,경강선,이천,2949,2970,5919
<class,경강선,신둔도예촌,1248,1196,2444
<class,경강선,곤지암,2133,2183,4316
<class,경강선,초월,2352,2151,4503
<class,경강선,경기광주,5418,5182,10600
<class,경강선,삼동,1456,1314,2770
<class,경강선,이매,848,654,1502
<class,경강선,판교,3056,2884,5940
<class,9호선2~3단계,중앙보훈병원,4607,4149,8756
<class,9호선2~3단계,둔촌오륜,634,610,1244
<class,9호선2~3단계,올림픽공원,4749,4919,9668
<class,9호선2~3단계,한성백제,1973,1656,3629
<class,9호선2~3단계,송파나루,4088,4627,8715
<class,9호선2~3단계,석촌,6747,5561,12308
<class,9호선2~3단계,석촌고분,4362,3982,8344
<class,9호선2~3단계,삼전,4861,4378,9239
<class,9호선2~3단계,종합운동장,3289,2949,6238
<class,9호선2~3단계,봉은사,12728,13894,26622
<class,9호선2~3단계,삼성중앙,3157,3184,6341
<class,9호선2~3단계,선정릉,4945,5502,10447
<class,9호선2~3단계,언주,6484,6413,12897
<class,9호선,신논현,26436,27464,53900
<class,9호선,사평,2163,2043,4206
<class,9호선,고속터미널,13136,18984,32120
<class,9호선,신반포,2691,2620,5311
<class,9호선,구반포,1644,1799,3443
<class,9호선,동작,1499,1275,2774
<class,9호선,흑석,5649,5704,11353
<class,9호선,노들,3284,2749,6033
<class,9호선,노량진,21566,21101,42667
<class,9호선,샛강,2652,2677,5329
<class,9호선,여의도,12600,11523,24123
<class,9호선,국회의사당,5017,5212,10229
<class,9호선,당산,13113,12153,25266
<class,9호선,선유도,3778,3605,7383
<class,9호선,신목동,2466,2110,4576
<class,9호선,염창,12225,11088,23313
<class,9호선,등촌,7513,7048,14561
<class,9호선,증미,4064,3836,7900
<class,9호선,가양,13883,12977,26860
<class,9호선,양천향교,6126,5629,11755
<class,9호선,마곡나루,8223,8067,16290
<class,9호선,신방화,4794,4409,9203
<class,9호선,공항시장,2332,2293,4625
<class,9호선,김포공항,8103,13071,21174
<class,9호선,개화,1450,1212,2662
<class,8호선,모란,3451,3155,6606
<class,8호선,수진,4042,3615,7657
<class,8호선,신흥,3416,3624,7040
<class,8호선,단대오거리,7461,6809,14270
<class,8호선,남한산성입구,9421,8129,17550
<class,8호선,산성,4695,4505,9200
<class,8호선,복정,7716,6438,14154
<class,8호선,장지,12435,11211,23646
<class,8호선,문정,9673,9733,19406
<class,8호선,가락시장,5490,5858,11348
<class,8호선,송파,5620,5394,11014
<class,8호선,석촌,5837,6960,12797
<class,8호선,잠실,12143,14920,27063
<class,8호선,몽촌토성,4876,4783,9659
<class,8호선,강동구청,6167,6046,12213
<class,8호선,천호,11966,14388,26354
<class,8호선,암사,12291,11009,23300
<class,7호선,부평구청,5042,4409,9451
<class,7호선,굴포천,6838,6924,13762
<class,7호선,삼산체육관,3764,3362,7126
<class,7호선,상동,11041,11345,22386
<class,7호선,부천시청,9445,9283,18728
<class,7호선,신중동,9869,9969,19838
<class,7호선,춘의,5181,4890,10071
<class,7호선,부천종합운동장,3260,2853,6113
<class,7호선,까치울,5619,5521,11140
<class,7호선,온수,5745,5753,11498
<class,7호선,천왕,7247,6633,13880
<class,7호선,광명사거리,16561,16412,32973
<class,7호선,철산,15313,15470,30783
<class,7호선,가산디지털단지,15424,13960,29384
<class,7호선,남구로,8233,8655,16888
<class,7호선,대림,7188,7863,15051
<class,7호선,신풍,8131,7631,15762
<class,7호선,보라매,6636,6188,12824
<class,7호선,신대방삼거리,11434,10297,21731
<class,7호선,장승배기,6788,6410,13198
<class,7호선,상도,7464,6775,14239
<class,7호선,숭실대입구,11315,10452,21767
<class,7호선,남성,7674,6816,14490
<class,7호선,이수,12069,11583,23652
<class,7호선,내방,7984,7808,15792
<class,7호선,고속터미널,15821,12292,28113
<class,7호선,반포,4513,4232,8745
<class,7호선,논현,11252,12453,23705
<class,7호선,학동,11301,11908,23209
<class,7호선,강남구청,10124,11217,21341
<class,7호선,청담,12094,13071,25165
<class,7호선,뚝섬유원지,7251,6733,13984
<class,7호선,건대입구,14802,14799,29601
<class,7호선,어린이대공원,10850,10859,21709
<class,7호선,군자,10955,8156,19111
<class,7호선,중곡,7078,6391,13469
<class,7호선,용마산,4580,4490,9070
<class,7호선,사가정,12525,11916,24441
<class,7호선,면목,11461,10799,22260
<class,7호선,상봉,13360,12547,25907
<class,7호선,중화,7782,7374,15156
<class,7호선,먹골,8414,8166,16580
<class,7호선,태릉입구,6882,6309,13191
<class,7호선,공릉,9181,8824,18005
<class,7호선,하계,12827,11546,24373
<class,7호선,중계,10318,9098,19416
<class,7호선,노원,16131,17052,33183
<class,7호선,마들,9127,8214,17341
<class,7호선,수락산,10068,9620,19688
<class,7호선,도봉산,6707,8856,15563
<class,7호선,장암,1607,1139,2746
<class,6호선,봉화산,5330,5131,10461
<class,6호선,화랑대,8661,6868,15529
<class,6호선,태릉입구,4411,4551,8962
<class,6호선,석계,8957,8824,17781
<class,6호선,돌곶이,6367,5775,12142
<class,6호선,상월곡,4227,3559,7786
<class,6호선,월곡,7523,7170,14693
<class,6호선,고려대,5744,5291,11035
<class,6호선,안암,6980,6723,13703
<class,6호선,보문,5342,4539,9881
<class,6호선,창신,2210,1789,3999
<class,6호선,동묘앞,7840,7262,15102
<class,6호선,신당,6576,5549,12125
<class,6호선,청구,2392,2353,4745
<class,6호선,약수,2538,2472,5010
<class,6호선,버티고개,1374,1413,2787
<class,6호선,한강진,8275,10612,18887
<class,6호선,이태원,13038,16853,29891
<class,6호선,녹사평,5063,5774,10837
<class,6호선,삼각지,5784,4393,10177
<class,6호선,효창공원앞,4905,4283,9188
<class,6호선,공덕,10615,9992,20607
<class,6호선,대흥,6501,6553,13054
<class,6호선,광흥창,5338,4827,10165
<class,6호선,상수,7912,9861,17773
<class,6호선,합정,12241,11876,24117
<class,6호선,망원,12397,13851,26248
<class,6호선,마포구청,9624,8159,17783
<class,6호선,월드컵경기장,4130,4484,8614
<class,6호선,디지털미디어시티,7354,7233,14587
<class,6호선,증산,7443,7056,14499
<class,6호선,새절,8800,8135,16935
<class,6호선,구산,5318,4029,9347
<class,6호선,연신내,1,0,1
<class,6호선,독바위,1996,2145,4141
<class,6호선,불광,3740,3386,7126
<class,6호선,역촌,2865,3122,5987
<class,6호선,응암,12358,11949,24307
<class,5호선,하남검단산,4903,4874,9777
<class,5호선,하남시청,5182,4828,10010
<class,5호선,하남풍산,2692,2721,5413
<class,5호선,미사,11971,11670,23641
<class,5호선,강일,2658,2382,5040
<class,5호선,마천,4853,5038,9891
<class,5호선,거여,6402,5892,12294
<class,5호선,개롱,4372,4491,8863
<class,5호선,오금,2519,2140,4659
<class,5호선,방이,5546,5249,10795
<class,5호선,올림픽공원,3115,2768,5883
<class,5호선,둔촌동,6186,6222,12408
<class,5호선,상일동,9739,8764,18503
<class,5호선,고덕,6633,6390,13023
<class,5호선,명일,6216,6107,12323
<class,5호선,굽은다리,6935,6401,13336
<class,5호선,길동,5793,5913,11706
<class,5호선,강동,12996,12118,25114
<class,5호선,천호,16693,16135,32828
<class,5호선,광나루,10788,10070,20858
<class,5호선,아차산,12197,11582,23779
<class,5호선,군자,8537,9273,17810
<class,5호선,장한평,11670,11302,22972
<class,5호선,답십리,10380,9304,19684
<class,5호선,마장,3891,3884,7775
<class,5호선,왕십리,3537,4434,7971
<class,5호선,행당,5550,4872,10422
<class,5호선,신금호,4083,4181,8264
<class,5호선,청구,2569,2331,4900
<class,5호선,동대문역사문화공원,1002,1338,2340
<class,5호선,을지로4가,3319,3628,6947
<class,5호선,종로3가,12980,13142,26122
<class,5호선,광화문,15724,16596,32320
<class,5호선,서대문,7534,7338,14872
<class,5호선,충정로,1961,1786,3747
<class,5호선,애오개,3560,3485,7045
<class,5호선,공덕,7454,7687,15141
<class,5호선,마포,7424,7549,14973
<class,5호선,여의나루,9479,11203,20682
<class,5호선,여의도,11693,12188,23881
<class,5호선,신길,2592,2557,5149
<class,5호선,영등포시장,8357,8641,16998
<class,5호선,영등포구청,1957,1993,3950
<class,5호선,양평,3743,3446,7189
<class,5호선,오목교,15968,16925,32893
<class,5호선,목동,11405,11423,22828
<class,5호선,신정,9039,7627,16666
<class,5호선,까치산,21197,19612,40809
<class,5호선,화곡,20633,18369,39002
<class,5호선,우장산,9722,9453,19175
<class,5호선,발산,14107,15294,29401
<class,5호선,마곡,5428,5549,10977
<class,5호선,송정,4974,4799,9773
<class,5호선,김포공항,7689,7390,15079
<class,5호선,개화산,3709,3499,7208
<class,5호선,방화,4538,4247,8785
<class,4호선,쌍문,21712,19105,40817
<class,4호선,창동,19487,20349,39836
<class,4호선,노원,15726,18040,33766
<class,4호선,상계,14274,12927,27201
<class,4호선,당고개,9782,9155,18937
<class,4호선,남태령,1443,925,2368
<class,4호선,사당,22410,19849,42259
<class,4호선,총신대입구,14109,15374,29483
<class,4호선,동작,1341,1447,2788
<class,4호선,이촌,6461,6945,13406
<class,4호선,신용산,11306,12061,23367
<class,4호선,삼각지,3637,4930,8567
<class,4호선,숙대입구,11465,10856,22321
<class,4호선,서울역,5826,14983,20809
<class,4호선,회현,17058,18240,35298
<class,4호선,명동,14968,17712,32680
<class,4호선,충무로,13931,15008,28939
<class,4호선,동대문역사문화공원,11194,9742,20936
<class,4호선,동대문,13517,13456,26973
<class,4호선,혜화,33239,34045,67284
<class,4호선,한성대입구,10813,10507,21320
<class,4호선,성신여대입구,17242,16351,33593
<class,4호선,길음,14970,14073,29043
<class,4호선,미아사거리,22188,21236,43424
<class,4호선,미아,11002,10248,21250
<class,4호선,수유,26384,25847,52231
<class,3호선,오금,3973,3752,7725
<class,3호선,경찰병원,3971,3805,7776
<class,3호선,가락시장,6164,6052,12216
<class,3호선,수서,13559,13356,26915
<class,3호선,일원,4913,4886,9799
<class,3호선,대청,6079,5437,11516
<class,3호선,학여울,2004,2171,4175
<class,3호선,대치,8357,7950,16307
<class,3호선,도곡,3962,4157,8119
<class,3호선,매봉,6354,6085,12439
<class,3호선,양재,21852,23727,45579
<class,3호선,남부터미널,22606,22475,45081
<class,3호선,교대,7030,4377,11407
<class,3호선,고속터미널,49254,51368,100622
<class,3호선,잠원,3638,3505,7143
<class,3호선,신사,25169,27349,52518
<class,3호선,압구정,25287,27127,52414
<class,3호선,옥수,7193,7285,14478
<class,3호선,금호,5885,5258,11143
<class,3호선,약수,9096,8532,17628
<class,3호선,동대입구,7381,8279,15660
<class,3호선,충무로,1,0,1
<class,3호선,을지로3가,5368,6076,11444
<class,3호선,종로3가,5884,8578,14462
<class,3호선,안국,16932,19083,36015
<class,3호선,경복궁,18402,19921,38323
<class,3호선,독립문,5619,5867,11486
<class,3호선,무악재,2761,2761,5522
<class,3호선,홍제,12850,12069,24919
<class,3호선,녹번,10641,9107,19748
<class,3호선,불광,12873,14389,27262
<class,3호선,연신내,29340,27657,56997
<class,3호선,구파발,15392,15244,30636
<class,3호선,지축,3079,2848,5927
<class,2호선,용두,1665,1647,3312
<class,2호선,신정네거리,7600,7505,15105
<class,2호선,양천구청,4711,4635,9346
<class,2호선,도림천,704,732,1436
<class,2호선,신설동,3078,3128,6206
<class,2호선,신답,1013,1059,2072
<class,2호선,용답,2083,1948,4031
<class,2호선,충정로,6084,6315,12399
<class,2호선,아현,7624,6974,14598
<class,2호선,이대,11019,11295,22314
<class,2호선,신촌,32733,32988,65721
<class,2호선,홍대입구,64178,73567,137745
<class,2호선,합정,28574,32399,60973
<class,2호선,당산,13042,14225,27267
<class,2호선,영등포구청,13544,13950,27494
<class,2호선,문래,12835,13605,26440
<class,2호선,신도림,41837,43031,84868
<class,2호선,대림,17695,18524,36219
<class,2호선,구로디지털단지,34881,34172,69053
<class,2호선,신대방,20197,19008,39205
<class,2호선,신림,50344,47394,97738
<class,2호선,봉천,17129,15221,32350
<class,2호선,서울대입구,37880,36556,74436
<class,2호선,낙성대,21312,18932,40244
<class,2호선,사당,31994,35854,67848
<class,2호선,방배,10935,11100,22035
<class,2호선,서초,11498,9318,20816
<class,2호선,교대,17663,20071,37734
<class,2호선,강남,62393,65968,128361
<class,2호선,역삼,18427,20221,38648
<class,2호선,선릉,25307,22328,47635
<class,2호선,삼성,32589,33036,65625
<class,2호선,종합운동장,6229,6785,13014
<class,2호선,잠실새내,16542,17426,33968
<class,2호선,잠실,64746,61778,126524
<class,2호선,잠실나루,7585,7299,14884
<class,2호선,강변,29192,29384,58576
<class,2호선,구의,17115,16390,33505
<class,2호선,건대입구,37526,42014,79540
<class,2호선,성수,19682,22430,42112
<class,2호선,뚝섬,15670,15246,30916
<class,2호선,한양대,4771,4988,9759
<class,2호선,왕십리,13981,12224,26205
<class,2호선,상왕십리,10258,9640,19898
<class,2호선,신당,11128,11380,22508
<class,2호선,동대문역사문화공원,10059,11038,21097
<class,2호선,을지로4가,7147,7342,14489
<class,2호선,을지로3가,11841,12099,23940
<class,2호선,을지로입구,21393,21585,42978
<class,2호선,시청,9949,9081,19030
<class,1호선,청량리,17943,18367,36310
<class,1호선,제기동,14564,14995,29559
<class,1호선,신설동,10097,9333,19430
<class,1호선,동대문,10537,9893,20430
<class,1호선,종로5가,17697,18239,35936
<class,1호선,종로3가,23167,22251,45418
<class,1호선,종각,19783,18916,38699
<class,1호선,시청,12098,12547,24645
<class,1호선,동묘앞,11170,11440,22610
<class,1호선,서울역,37172,36108,73280
<class,중앙선,지평,52,58,110
<class,중앙선,용문,3423,3804,7227
<class,중앙선,원덕,409,455,864
<class,중앙선,양평,2710,2927,5637
<class,중앙선,오빈,261,309,570
<class,중앙선,아신,604,593,1197
<class,중앙선,국수,657,667,1324
<class,중앙선,신원,231,169,400
<class,중앙선,양수,2175,2168,4343
<class,중앙선,운길산,1238,1249,2487
<class,중앙선,팔당,1305,1444,2749
<class,중앙선,도심,1632,1335,2967
<class,중앙선,덕소,4668,3618,8286
<class,중앙선,양정,638,584,1222
<class,중앙선,도농,7471,6951,14422
<class,중앙선,구리,10838,10951,21789
<class,중앙선,양원,1340,1315,2655
<class,중앙선,망우,6613,6419,13032
<class,중앙선,상봉,5431,5044,10475
<class,중앙선,중랑,4619,4268,8887
<class,중앙선,회기,23825,22291,46116
<class,장항선,신창,1463,1404,2867
<class,장항선,온양온천,3752,3952,7704
<class,장항선,배방,1102,1034,2136
<class,장항선,탕정,406,368,774
<class,장항선,아산,3353,3135,6488
<class,장항선,쌍용,1631,1422,3053
<class,장항선,봉명,733,665,1398
<class,일산선,대화,10516,9398,19914
<class,일산선,주엽,6682,6346,13028
<class,일산선,정발산,6897,7314,14211
<class,일산선,마두,5282,5102,10384
<class,경부선,성환,3084,2896,5980
<class,일산선,대곡,1395,1155,2550
<class,일산선,화정,13330,13711,27041
<class,일산선,원당,8517,8036,16553
<class,일산선,삼송,14100,13426,27526
<class,일산선,지축,1,0,1
<class,일산선,원흥,7595,6990,14585
<class,우이신설선,신설동,1433,1411,2844
<class,우이신설선,보문,1061,1045,2106
<class,우이신설선,성신여대입구,2658,3265,5923
<class,경원선,보산,1913,1740,3653
<class,경원선,동두천,1663,2192,3855
<class,경원선,소요산,4010,3322,7332
<class,경의선,서울역,1541,1649,3190
<class,경의선,신촌,464,468,932
<class,경의선,효창공원앞,1935,2025,3960
<class,경의선,공덕,3003,2277,5280
<class,경의선,서강대,2313,2280,4593
<class,경의선,홍대입구,2029,2666,4695
<class,경의선,가좌,3926,3827,7753
<class,경의선,디지털미디어시티,2051,1900,3951
<class,경의선,수색,1537,1500,3037
<class,경의선,화전,2468,2005,4473
<class,경의선,강매,2119,1848,3967
<class,경의선,행신,5512,5497,11009
<class,경의선,능곡,2902,2731,5633
<class,경의선,곡산,452,464,916
<class,경의선,백마,4686,4265,8951
<class,경의선,풍산,4318,4163,8481
<class,경의선,일산,6598,6208,12806
<class,경의선,탄현,5627,5267,10894
<class,경의선,야당,5956,6088,12044
<class,경의선,운정,5262,4832,10094
<class,경의선,금릉,3825,3582,7407
<class,경의선,금촌,5629,5217,10846
<class,경의선,월롱,1585,1436,3021
<class,경의선,파주,932,711,1643
<class,경의선,문산,4415,4335,8750
<class,경의선,임진강,56,30,86
<class,경인선,개봉,16584,15908,32492
<class,경인선,오류동,8964,8234,17198
<class,경인선,역곡,20437,19534,39971
<class,경인선,부천,28257,29381,57638
<class,경인선,송내,18424,17921,36345
<class,경인선,부평,28884,32307,61191
<class,경인선,백운,5371,5299,10670
<class,경인선,동암,12736,12887,25623
<class,경인선,주안,16256,14117,30373
<class,경인선,제물포,7705,7266,14971
<class,경인선,동인천,11861,11658,23519
<class,경인선,인천,4627,3878,8505
<class,경인선,구일,4335,4032,8367
<class,경인선,소사,7470,7308,14778
<class,경인선,부개,6454,5906,12360
<class,경인선,간석,4270,4008,8278
<class,경인선,도원,2056,2142,4198
<class,경인선,온수,4956,4425,9381
<class,경인선,중동,6749,6351,13100
<class,경인선,도화,3226,2889,6115
<class,경춘선,신내,1309,1279,2588
<class,경춘선,갈매,1956,1640,3596
<class,경춘선,별내,2423,2341,4764
<class,경춘선,퇴계원,2705,2396,5101
<class,경춘선,사릉,2431,2307,4738
<class,경춘선,금곡,1057,1062,2119
<class,경춘선,평내호평,4726,4451,9177
<class,경춘선,천마산,1358,1343,2701
<class,경춘선,마석,3177,3089,6266
<class,경춘선,대성리,802,923,1725
<class,경춘선,청평,1665,1881,3546
<class,경춘선,상천,365,320,685
<class,경춘선,가평,2072,2348,4420
<class,경춘선,굴봉산,160,165,325
<class,경춘선,백양리,115,122,237
<class,경춘선,강촌,671,684,1355
<class,경춘선,김유정,463,604,1067
<class,경춘선,남춘천,2862,2951,5813
<class,경춘선,춘천,1753,1615,3368
<class,공항철도 1호선,서울역,8625,8899,17524
<class,공항철도 1호선,공덕,1593,2503,4096
<class,공항철도 1호선,홍대입구,12444,13061,25505
<class,공항철도 1호선,디지털미디어시티,5720,5478,11198
<class,공항철도 1호선,마곡나루,3309,3609,6918
<class,공항철도 1호선,김포공항,12263,5931,18194
<class,공항철도 1호선,계양,7276,6620,13896
<class,공항철도 1호선,검암,4862,4746,9608
<class,공항철도 1호선,청라국제도시,4451,4268,8719
<class,공항철도 1호선,운서,6102,6090,12192
<class,공항철도 1호선,공항화물청사,1258,1301,2559
<class,공항철도 1호선,인천공항1터미널,4022,3922,7944
<class,공항철도 1호선,인천공항2터미널,2187,1814,4001
<class,공항철도 1호선,영종,2965,3041,6006
<class,과천선,선바위,5741,5027,10768
<class,과천선,경마공원,6703,6726,13429
<class,과천선,대공원,5219,5482,10701
<class,과천선,과천,4309,3908,8217
<class,과천선,정부과천청사,6056,6061,12117
<class,과천선,인덕원,17062,16497,33559
<class,과천선,평촌,10043,9656,19699
<class,과천선,범계,20338,20431,40769
<class,분당선,선릉,5361,8482,13843
<class,분당선,한티,11849,11837,23686
<class,분당선,도곡,5264,4178,9442
<class,분당선,구룡,1491,1399,2890
<class,분당선,개포동,2694,2620,5314
<class,분당선,대모산입구,3057,2764,5821
<class,분당선,수서,11108,11197,22305
<class,분당선,복정,1,0,1
<class,분당선,수원,7580,6301,13881
<class,분당선,서울숲,8957,9505,18462
<class,분당선,압구정로데오,18079,22035,40114
<class,분당선,강남구청,5767,7040,12807
<class,분당선,선정릉,3589,3666,7255
<class,분당선,가천대,6142,6466,12608
<class,분당선,태평,10657,9850,20507
<class,분당선,모란,16005,16313,32318
<class,분당선,야탑,18397,19318,37715
<class,분당선,서현,18797,19187,37984
<class,분당선,수내,8803,8158,16961
<class,분당선,정자,10579,10971,21550
<class,분당선,미금,11053,11190,22243
<class,분당선,오리,8238,6901,15139
<class,분당선,이매,4106,4097,8203
<class,분당선,보정,1712,1504,3216
<class,분당선,죽전,11187,12272,23459
<class,분당선,구성,3453,3563,7016
<class,분당선,신갈,2791,2703,5494
<class,분당선,기흥,6807,6433,13240
<class,분당선,상갈,4065,3934,7999
<class,분당선,청명,2803,2651,5454
<class,분당선,영통,7513,7216,14729
<class,분당선,망포,9629,8529,18158
<class,분당선,매탄권선,3576,3212,6788
<class,분당선,수원시청,11261,13619,24880
<class,분당선,매교,2069,1995,4064
<class,수인선,고색,2473,2416,4889
<class,수인선,오목천,2300,1921,4221
<class,수인선,어천,707,646,1353
<class,수인선,야목,267,222,489
<class,수인선,사리,3662,2881,6543
<class,수인선,달월,60,51,111
<class,수인선,월곶,2024,1864,3888
<class,수인선,소래포구,5927,6181,12108
<class,수인선,인천논현,4340,4411,8751
<class,수인선,호구포,2629,2474,5103
<class,수인선,남동인더스파크,1013,933,1946
<class,수인선,원인재,3776,3760,7536
<class,수인선,연수,4024,3912,7936
<class,수인선,송도,2012,1898,3910
<class,수인선,인하대,4635,4281,8916
<class,수인선,숭의,2867,2564,5431
<class,수인선,신포,1450,1547,2997
<class,수인선,인천,1227,2169,3396
<class,안산선,산본,12438,13172,25610
<class,안산선,대야미,3856,3366,7222
<class,안산선,반월,3428,3212,6640
<class,안산선,상록수,12974,12791,25765
<class,안산선,한대앞,7999,7493,15492
<class,안산선,중앙,16041,17351,33392
<class,안산선,고잔,6892,6979,13871
<class,안산선,초지,3551,3607,7158
<class,안산선,안산,9589,9789,19378
<class,안산선,신길온천,1515,1446,2961
<class,안산선,정왕,6851,6760,13611
<class,안산선,오이도,7769,7963,15732
<class,안산선,수리산,2851,2535,5386
<class,우이신설선,북한산우이,3157,3326,6483
<class,우이신설선,솔밭공원,1760,1658,3418
<class,우이신설선,4.19민주묘지,2282,1993,4275
<class,우이신설선,가오리,2908,2634,5542
<class,우이신설선,화계,2487,2227,4714
<class,우이신설선,삼양,1427,1464,2891
<class,우이신설선,삼양사거리,1821,1849,3670
<class,우이신설선,솔샘,3917,3385,7302
<class,우이신설선,북한산보국문,4656,4102,8758
<class,우이신설선,정릉,3649,2942,6591
<class,경원선,동두천중앙,2794,2755,5549
<class,경원선,지행,5745,5685,11430
<class,경원선,덕정,4540,4203,8743
<class,경원선,덕계,2585,2296,4881
<class,경원선,양주,6711,6175,12886
<class,경원선,녹양,3645,3505,7150
<class,경원선,가능,5214,4927,10141
<class,경원선,의정부,17703,19186,36889
<class,경원선,회룡,9813,9606,19419
<class,경원선,망월사,5780,5807,11587
<class,경원선,도봉산,8777,6101,14878
<class,경원선,도봉,4471,4227,8698
<class,경원선,방학,7379,7168,14547
<class,경원선,녹천,3351,2757,6108
<class,경원선,월계,4799,4466,9265
<class,경원선,광운대,5597,5451,11048
<class,경원선,석계,6854,7343,14197
<class,경원선,신이문,6279,5619,11898
<class,경원선,외대앞,6850,6399,13249
<class,경원선,청량리,16858,17322,34180
<class,경원선,왕십리,12756,14601,27357
<class,경원선,응봉,1432,1253,2685
<class,경원선,옥수,56,47,103
<class,경원선,한남,2845,2813,5658
<class,경원선,서빙고,1889,2114,4003
<class,경원선,이촌,2894,2183,5077
<class,경부선,광명,3058,2738,5796
<class,경부선,서동탄,1031,1052,2083
<class,경부선,당정,4130,3812,7942
<class,경부선,천안,6539,6677,13216
<class,경부선,두정,5168,5232,10400
<class,경부선,직산,682,725,1407
<class,4호선,노원,11494,12692,24186
<class,4호선,창동,14641,15417,30058
<class,4호선,쌍문,15602,13957,29559
<class,5호선,방화,3394,3415,6809
<class,5호선,개화산,2551,2637,5188
<class,5호선,김포공항,7155,6393,13548
<class,5호선,송정,3553,3624,7177
<class,5호선,마곡,3387,3502,6889
<class,5호선,발산,9306,9642,18948
<class,5호선,우장산,6504,6735,13239
<class,5호선,화곡,13868,13289,27157
<class,5호선,까치산,14971,14965,29936
<class,5호선,신정,6125,5603,11728
<class,5호선,목동,7858,8175,16033
<class,5호선,오목교,11002,11878,22880
<class,5호선,양평,2548,2641,5189
<class,5호선,영등포구청,1374,1351,2725
<class,5호선,영등포시장,4806,4890,9696
<class,5호선,신길,1775,2087,3862
<class,5호선,여의도,7904,8147,16051
<class,5호선,여의나루,6959,8043,15002
<class,5호선,마포,4658,4666,9324
<class,5호선,공덕,4643,4911,9554
<class,5호선,애오개,2587,2624,5211
<class,5호선,충정로,1388,1386,2774
<class,5호선,서대문,5073,4985,10058
<class,5호선,광화문,11152,11459,22611
<class,5호선,종로3가,8887,7671,16558
<class,5호선,을지로4가,1424,1464,2888
<class,5호선,동대문역사문화공원,738,819,1557
<class,5호선,청구,1683,1544,3227
<class,5호선,신금호,2816,2968,5784
<class,5호선,행당,3859,3507,7366
<class,5호선,왕십리,2490,2968,5458
<class,5호선,마장,2779,2636,5415
<class,5호선,답십리,7299,6895,14194
<class,5호선,장한평,7759,7738,15497
<class,5호선,군자,6023,6564,12587
<class,5호선,아차산,9406,9167,18573
<class,5호선,광나루,7634,7443,15077
<class,5호선,천호,12276,11409,23685
<class,5호선,강동,8728,8897,17625
<class,5호선,길동,3890,4023,7913
<class,5호선,굽은다리,5062,4806,9868
<class,5호선,명일,4552,4616,9168
<class,5호선,고덕,4108,4165,8273
<class,5호선,상일동,6396,6185,12581
<class,5호선,둔촌동,4498,4559,9057
<class,5호선,올림픽공원,2331,2123,4454
<class,5호선,방이,3952,3750,7702
<class,5호선,오금,1563,1522,3085
<class,5호선,개롱,2930,3205,6135
<class,5호선,거여,4366,4266,8632
<class,5호선,마천,3545,3872,7417
<class,5호선,강일,1869,1784,3653
<class,5호선,미사,8216,8223,16439
<class,5호선,하남풍산,1937,2008,3945
<class,5호선,하남시청,3658,3513,7171
<class,5호선,하남검단산,3882,3861,7743
<class,6호선,응암,8910,8974,17884
<class,6호선,역촌,1916,2283,4199
<class,6호선,불광,2765,2421,5186
<class,6호선,독바위,1427,1718,3145
<class,6호선,연신내,1,0,1
<class,6호선,구산,3678,2807,6485
<class,6호선,새절,6204,6077,12281
<class,6호선,증산,5311,5480,10791
<class,6호선,디지털미디어시티,4985,5242,10227
<class,6호선,월드컵경기장,3094,3299,6393
<class,6호선,마포구청,7044,6413,13457
<class,6호선,망원,8698,9386,18084
<class,6호선,합정,9109,8497,17606
<class,6호선,상수,6174,6954,13128
<class,6호선,광흥창,4123,3971,8094
<class,6호선,대흥,4881,5006,9887
<class,6호선,공덕,6875,6503,13378
<class,6호선,효창공원앞,3332,2984,6316
<class,6호선,삼각지,3613,2663,6276
<class,6호선,녹사평,3688,3669,7357
<class,6호선,이태원,9684,8737,18421
<class,6호선,한강진,5798,6923,12721
<class,6호선,버티고개,911,1017,1928
<class,6호선,약수,1653,1625,3278
<class,경부선,가산디지털단지,4838,6778,11616
<class,경부선,구로,9797,10150,19947
<class,경부선,신길,4797,4243,9040
<class,경부선,신도림,2193,2361,4554
<class,경부선,영등포,32033,30665,62698
<class,경부선,대방,5795,6410,12205
<class,경부선,노량진,6041,5901,11942
<class,경부선,용산,34428,30715,65143
<class,경부선,남영,4443,4694,9137
<class,경부선,서울역,8515,1836,10351
<class,경강선,여주,2060,2234,4294
<class,경강선,세종대왕릉,273,267,540
<class,경강선,부발,1284,2002,3286
<class,경강선,이천,2167,2482,4649
<class,경강선,신둔도예촌,946,956,1902
<class,경강선,곤지암,1688,1781,3469
<class,경강선,초월,1618,1604,3222
<class,경강선,경기광주,3708,3631,7339
<class,경강선,삼동,1029,934,1963
<class,경강선,이매,709,473,1182
<class,경강선,판교,2404,2292,4696
<class,9호선2~3단계,중앙보훈병원,3254,3094,6348
<class,9호선2~3단계,둔촌오륜,435,469,904
<class,9호선2~3단계,올림픽공원,4835,5168,10003
<class,9호선2~3단계,한성백제,1325,1177,2502
<class,9호선2~3단계,송파나루,2968,3202,6170
<class,9호선2~3단계,석촌,4666,4088,8754
<class,9호선2~3단계,석촌고분,2832,2900,5732
<class,9호선2~3단계,삼전,3506,3420,6926
<class,9호선2~3단계,종합운동장,2393,2258,4651
<class,9호선2~3단계,봉은사,9335,9913,19248
<class,9호선2~3단계,삼성중앙,1938,1986,3924
<class,9호선2~3단계,선정릉,3288,3782,7070
<class,9호선2~3단계,언주,4239,4192,8431
<class,9호선,신논현,16398,15425,31823
<class,9호선,사평,1426,1503,2929
<class,9호선,고속터미널,10670,14419,25089
<class,9호선,신반포,1621,1786,3407
<class,9호선,구반포,691,747,1438
<class,9호선,동작,1052,892,1944
<class,9호선,흑석,3772,3920,7692
<class,9호선,노들,2470,2135,4605
<class,9호선,노량진,14502,15223,29725
<class,9호선,샛강,1584,1588,3172
<class,9호선,여의도,9064,7987,17051
<class,9호선,국회의사당,5089,4641,9730
<class,9호선,당산,8974,8773,17747
<class,9호선,선유도,2726,2637,5363
<class,9호선,신목동,1670,1526,3196
<class,9호선,염창,8264,8280,16544
<class,9호선,등촌,4997,5223,10220
<class,9호선,증미,2821,2881,5702
<class,9호선,가양,10106,10035,20141
<class,9호선,양천향교,4069,4389,8458
<class,9호선,마곡나루,5417,5456,10873
<class,9호선,신방화,3365,3361,6726
<class,9호선,공항시장,1628,1846,3474
<class,9호선,김포공항,7364,11440,18804
<class,9호선,개화,1009,981,1990
<class,8호선,모란,2329,2065,4394
<class,8호선,수진,2960,2697,5657
<class,8호선,신흥,2433,2692,5125
<class,8호선,단대오거리,5208,5128,10336
<class,8호선,남한산성입구,6422,6007,12429
<class,8호선,산성,3182,3186,6368
<class,8호선,복정,5506,5060,10566
<class,8호선,장지,8953,9022,17975
<class,8호선,문정,5972,6198,12170
<class,8호선,가락시장,3058,3845,6903
<class,8호선,송파,3383,3521,6904
<class,8호선,석촌,4050,5155,9205
<class,8호선,잠실,9595,10731,20326
<class,8호선,몽촌토성,3309,3175,6484
<class,8호선,강동구청,4486,4653,9139
<class,8호선,천호,8685,10062,18747
<class,8호선,암사,8356,7997,16353
<class,7호선,부평구청,3532,3116,6648
<class,7호선,굴포천,4666,4735,9401
<class,7호선,삼산체육관,2485,2319,4804
<class,7호선,상동,7403,7400,14803
<class,7호선,부천시청,6736,6491,13227
<class,7호선,신중동,6529,6515,13044
<class,7호선,춘의,3456,3337,6793
<class,7호선,부천종합운동장,2368,2021,4389
<class,7호선,까치울,4032,3999,8031
<class,7호선,온수,3800,3979,7779
<class,7호선,천왕,4722,4525,9247
<class,7호선,광명사거리,11887,11794,23681
<class,7호선,철산,10057,10180,20237
<class,7호선,가산디지털단지,10885,10147,21032
<class,7호선,남구로,6505,6332,12837
<class,7호선,대림,6967,6612,13579
<class,7호선,신풍,6099,5750,11849
<class,7호선,보라매,4222,4285,8507
<class,7호선,신대방삼거리,7829,7664,15493
<class,7호선,장승배기,4748,4665,9413
<class,7호선,상도,5094,5131,10225
<class,7호선,숭실대입구,5634,6093,11727
<class,7호선,남성,5268,5330,10598
<class,7호선,이수,8349,7977,16326
<class,7호선,내방,5064,5236,10300
<class,7호선,고속터미널,14364,8610,22974
<class,7호선,반포,2871,2883,5754
<class,7호선,논현,6098,6637,12735
<class,7호선,학동,6424,6813,13237
<class,7호선,강남구청,5764,6233,11997
<class,7호선,청담,7033,7693,14726
<class,7호선,뚝섬유원지,4994,4798,9792
<class,7호선,건대입구,7432,8037,15469
<class,7호선,어린이대공원,6264,6309,12573
<class,7호선,군자,7451,5979,13430
<class,7호선,중곡,5109,4917,10026
<class,7호선,용마산,3125,3375,6500
<class,7호선,사가정,8839,8562,17401
<class,7호선,면목,7870,7650,15520
<class,7호선,상봉,9302,8801,18103
<class,7호선,중화,5563,5376,10939
<class,7호선,먹골,5578,5579,11157
<class,7호선,태릉입구,4674,4420,9094
<class,7호선,공릉,6330,6436,12766
<class,7호선,하계,8998,8586,17584
<class,7호선,중계,6803,6277,13080
<class,7호선,노원,10860,10745,21605
<class,7호선,마들,5943,5575,11518
<class,7호선,수락산,7571,7358,14929
<class,7호선,도봉산,4888,6981,11869
<class,7호선,장암,1217,872,2089
<class,6호선,신내,1,0,1
<class,6호선,봉화산,3913,3785,7698
<class,6호선,화랑대,5052,4361,9413
<class,6호선,태릉입구,3126,3302,6428
<class,6호선,석계,6262,6707,12969
<class,6호선,돌곶이,5004,4734,9738
<class,6호선,상월곡,3214,2948,6162
<class,6호선,월곡,5293,5366,10659
<class,6호선,고려대,4077,4032,8109
<class,6호선,안암,5212,5535,10747
<class,6호선,보문,4017,3736,7753
<class,6호선,창신,1576,1479,3055
<class,6호선,동묘앞,5709,5541,11250
<class,6호선,신당,3965,4545,8510
<class,6호선,청구,1618,1532,3150
<class,경부선,천안,6351,6036,12387
<class,경부선,당정,2985,2922,5907
<class,경부선,서동탄,727,765,1492
<class,경부선,광명,2948,2035,4983
<class,경원선,이촌,2025,1637,3662
<class,경원선,서빙고,1332,1378,2710
<class,경원선,한남,1954,1947,3901
<class,경원선,옥수,56,31,87
<class,경원선,응봉,928,912,1840
<class,경원선,왕십리,10174,11457,21631
<class,경원선,청량리,14459,13401,27860
<class,경원선,외대앞,6047,5557,11604
<class,경원선,신이문,4599,4389,8988
<class,경원선,석계,5041,5498,10539
<class,경원선,광운대,4027,4248,8275
<class,경원선,월계,3630,3385,7015
<class,경원선,녹천,2504,2225,4729
<class,경원선,방학,5582,5430,11012
<class,경원선,도봉,3330,3105,6435
<class,경원선,도봉산,7787,5396,13183
<class,경원선,망월사,4362,4513,8875
<class,경원선,회룡,7241,7169,14410
<class,경원선,의정부,13696,13783,27479
<class,경원선,가능,3867,3658,7525
<class,경원선,녹양,2744,2643,5387
<class,경원선,양주,4922,4901,9823
<class,경원선,덕계,1735,1650,3385
<class,경원선,덕정,3226,3405,6631
<class,경원선,지행,4222,4248,8470
<class,경원선,동두천중앙,1970,1897,3867
<class,경원선,보산,1283,1515,2798
<class,경원선,동두천,1274,1645,2919
<class,경원선,소요산,3445,2878,6323
<class,경의선,서울역,1158,1053,2211
<class,경의선,신촌,314,312,626
<class,경의선,효창공원앞,1333,1541,2874
<class,경의선,공덕,1948,1488,3436
<class,경의선,서강대,1992,1894,3886
<class,경의선,홍대입구,1577,2084,3661
<class,경의선,가좌,2711,2914,5625
<class,일산선,삼송,10347,10182,20529
<class,일산선,원흥,5361,5191,10552
<class,우이신설선,신설동,1084,1118,2202
<class,우이신설선,보문,913,1020,1933
<class,우이신설선,성신여대입구,2097,2566,4663
<class,우이신설선,정릉,2654,2210,4864
<class,우이신설선,북한산보국문,3562,3237,6799
<class,우이신설선,솔샘,2795,2585,5380
<class,우이신설선,삼양사거리,1492,1468,2960
<class,우이신설선,삼양,1205,1170,2375
<class,우이신설선,화계,2023,1881,3904
<class,우이신설선,가오리,2295,2116,4411
<class,우이신설선,4.19민주묘지,3490,2938,6428
<class,우이신설선,솔밭공원,1501,1341,2842
<class,우이신설선,북한산우이,2785,2696,5481
<class,안산선,수리산,2035,2097,4132
<class,안산선,오이도,5820,5591,11411
<class,안산선,정왕,5254,5977,11231
<class,안산선,신길온천,1134,1090,2224
<class,안산선,안산,9488,8686,18174
<class,안산선,초지,2470,2245,4715
<class,안산선,고잔,4758,4480,9238
<class,안산선,중앙,11469,11496,22965
<class,안산선,한대앞,5223,5310,10533
<class,안산선,상록수,9146,8955,18101
<class,안산선,반월,2446,2436,4882
<class,4호선,삼각지,2452,3372,5824
<class,1호선,종로3가,13909,12279,26188
<class,경의선,디지털미디어시티,1380,1307,2687
<class,경의선,수색,928,985,1913
<class,경의선,화전,785,874,1659
<class,경의선,강매,1490,1407,2897
<class,경의선,행신,4521,4202,8723
<class,경의선,능곡,2065,2052,4117
<class,경의선,곡산,333,312,645
<class,경의선,백마,3260,3258,6518
<class,2호선,영등포구청,8861,9061,17922
<class,경의선,풍산,3504,3307,6811
<class,경의선,일산,4713,4424,9137
<class,경의선,탄현,4167,3826,7993
<class,경의선,야당,4358,4379,8737
<class,경의선,운정,3702,3580,7282
<class,경의선,금릉,2666,2599,5265
<class,경의선,금촌,4297,4542,8839
<class,경의선,월롱,880,1794,2674
<class,경의선,파주,604,551,1155
<class,경의선,문산,3350,3377,6727
<class,경의선,임진강,42,42,84
<class,경인선,개봉,11939,11845,23784
<class,경인선,오류동,7013,6569,13582
<class,경인선,역곡,14697,14262,28959
<class,경인선,부천,21469,21362,42831
<class,경인선,송내,12973,12641,25614
<class,경인선,부평,21655,22228,43883
<class,경인선,백운,3848,3894,7742
<class,경인선,동암,9289,9224,18513
<class,경인선,주안,11547,10294,21841
<class,경인선,제물포,5303,5146,10449
<class,경인선,동인천,9065,8745,17810
<class,경인선,인천,3470,2657,6127
<class,경인선,구일,3040,3061,6101
<class,경인선,소사,5608,5480,11088
<class,경인선,부개,4544,4298,8842
<class,경인선,간석,3008,2900,5908
<class,경인선,도원,1587,1612,3199
<class,경인선,온수,3546,3403,6949
<class,경인선,중동,4778,4556,9334
<class,경인선,도화,2268,2096,4364
<class,경춘선,신내,933,933,1866
<class,경춘선,갈매,1459,1315,2774
<class,경춘선,별내,1829,1719,3548
<class,경춘선,퇴계원,1998,1886,3884
<class,경춘선,사릉,1623,1635,3258
<class,경춘선,금곡,873,833,1706
<class,경춘선,평내호평,3413,3145,6558
<class,경춘선,천마산,989,956,1945
<class,경춘선,마석,2468,2368,4836
<class,경춘선,대성리,843,471,1314
<class,경춘선,청평,1592,1171,2763
<class,경춘선,상천,315,251,566
<class,경춘선,가평,1925,1366,3291
<class,경춘선,굴봉산,150,152,302
<class,경춘선,백양리,109,100,209
<class,경춘선,강촌,741,535,1276
<class,경춘선,김유정,369,395,764
<class,경춘선,남춘천,2359,2614,4973
<class,경춘선,춘천,1563,1392,2955
<class,공항철도 1호선,서울역,8546,7590,16136
<class,공항철도 1호선,공덕,1240,1711,2951
<class,공항철도 1호선,홍대입구,9973,8916,18889
<class,공항철도 1호선,디지털미디어시티,3471,3498,6969
<class,공항철도 1호선,마곡나루,2191,2542,4733
<class,공항철도 1호선,김포공항,11914,5804,17718
<class,공항철도 1호선,계양,5045,5081,10126
<class,공항철도 1호선,검암,3478,3625,7103
<class,공항철도 1호선,청라국제도시,3200,3034,6234
<class,공항철도 1호선,운서,4898,5240,10138
<class,공항철도 1호선,공항화물청사,965,1064,2029
<class,공항철도 1호선,인천공항1터미널,3722,3622,7344
<class,공항철도 1호선,인천공항2터미널,1942,1778,3720
<class,공항철도 1호선,영종,2370,2296,4666
<class,과천선,선바위,3841,3556,7397
<class,과천선,경마공원,7119,7141,14260
<class,과천선,대공원,3592,3759,7351
<class,과천선,과천,3095,2941,6036
<class,과천선,정부과천청사,4054,4366,8420
<class,과천선,인덕원,12114,12222,24336
<class,과천선,평촌,6526,6303,12829
<class,과천선,범계,14414,14008,28422
<class,분당선,선릉,2937,4591,7528
<class,분당선,한티,7501,7699,15200
<class,분당선,도곡,2712,2448,5160
<class,분당선,구룡,736,856,1592
<class,분당선,개포동,1991,2085,4076
<class,분당선,대모산입구,2217,2115,4332
<class,분당선,수서,8577,8321,16898
<class,분당선,수원,5763,4950,10713
<class,분당선,서울숲,6119,6404,12523
<class,분당선,압구정로데오,10295,11379,21674
<class,분당선,강남구청,3481,4211,7692
<class,분당선,선정릉,2338,2332,4670
<class,2호선,강남,36846,36126,72972
<class,2호선,역삼,11573,12742,24315
<class,2호선,선릉,14034,12184,26218
<class,2호선,삼성,24394,23738,48132
<class,2호선,종합운동장,6861,7523,14384
<class,2호선,잠실새내,10751,10983,21734
<class,2호선,잠실,47623,45380,93003
<class,2호선,잠실나루,5170,5344,10514
<class,2호선,강변,23100,22551,45651
<class,2호선,구의,11189,11301,22490
<class,2호선,건대입구,26082,27216,53298
<class,2호선,성수,13527,14974,28501
<class,2호선,뚝섬,10779,11100,21879
<class,2호선,한양대,2417,2681,5098
<class,2호선,왕십리,9799,8691,18490
<class,2호선,상왕십리,6768,6822,13590
<class,2호선,신당,7876,8443,16319
<class,2호선,동대문역사문화공원,7701,9094,16795
<class,2호선,을지로4가,3282,3143,6425
<class,2호선,을지로3가,8620,8068,16688
<class,2호선,을지로입구,15969,14902,30871
<class,2호선,시청,6430,5429,11859
<class,1호선,청량리,12574,12750,25324
<class,1호선,제기동,9634,9964,19598
<class,1호선,신설동,7233,7112,14345
<class,1호선,동대문,9041,9378,18419
<class,1호선,종로5가,8748,8811,17559
<class,1호선,종각,13015,11262,24277
<class,1호선,시청,8225,8046,16271
<class,1호선,동묘앞,11018,11297,22315
<class,1호선,서울역,31807,29415,61222
<class,2호선,문래,7992,8435,16427
<class,2호선,신도림,28342,28508,56850
<class,2호선,대림,14341,14829,29170
<class,2호선,구로디지털단지,23944,23532,47476
<class,2호선,신대방,14832,14734,29566
<class,2호선,신림,36161,35602,71763
<class,2호선,봉천,11856,11621,23477
<class,2호선,서울대입구,26402,27393,53795
<class,2호선,낙성대,15345,15808,31153
<class,2호선,사당,22026,24345,46371
<class,2호선,방배,6618,7005,13623
<class,2호선,서초,11842,11010,22852
<class,2호선,교대,10548,11809,22357
<class,경부선,두정,4227,4803,9030
<class,경부선,직산,599,639,1238
<class,경부선,성환,2540,3108,5648
<class,경부선,평택,11681,12523,24204
<class,경부선,평택지제,2535,2387,4922
<class,경부선,서정리,4497,6149,10646
<class,경부선,송탄,3576,4109,7685
<class,경부선,진위,848,914,1762
<class,경부선,오산,7552,8073,15625
<class,경부선,오산대,2190,2034,4224
<class,경부선,세마,1680,1582,3262
<class,경부선,병점,9151,10114,19265
<class,경부선,세류,2033,1979,4012
<class,경부선,독산,6189,6286,12475
<class,경부선,수원,33889,32669,66558
<class,경부선,화서,3946,3916,7862
<class,경부선,성균관대,7605,7999,15604
<class,경부선,의왕,4303,4319,8622
<class,경부선,군포,2955,2833,5788
<class,경부선,금정,13731,14101,27832
<class,경부선,명학,3592,3394,6986
<class,경부선,안양,13017,12813,25830
<class,경부선,관악,5010,4549,9559
<class,2호선,당산,8441,9528,17969
<class,2호선,합정,21008,22295,43303
<class,2호선,홍대입구,49496,48657,98153
<class,2호선,신촌,24444,23090,47534
<class,2호선,이대,7154,7700,14854
<class,2호선,아현,5049,5038,10087
<class,2호선,충정로,4029,4324,8353
<class,2호선,용답,1590,1635,3225
<class,2호선,신답,746,801,1547
<class,2호선,신설동,2865,2921,5786
<class,2호선,도림천,425,437,862
<class,2호선,양천구청,3258,3388,6646
<class,2호선,신정네거리,5209,5279,10488
<class,2호선,용두,1087,1121,2208
<class,3호선,지축,1957,1903,3860
<class,분당선,가천대,4374,4984,9358
<class,분당선,태평,7938,7463,15401
<class,분당선,모란,11052,11329,22381
<class,분당선,야탑,13464,13718,27182
<class,분당선,서현,13730,13867,27597
<class,분당선,수내,5760,5660,11420
<class,분당선,정자,7241,7491,14732
<class,분당선,미금,7169,7664,14833
<class,분당선,오리,5346,4608,9954
<class,분당선,이매,3087,3222,6309
<class,분당선,보정,1096,1041,2137
<class,분당선,죽전,8158,8988,17146
<class,분당선,구성,2329,2565,4894
<class,분당선,신갈,1903,1979,3882
<class,분당선,기흥,4921,4661,9582
<class,분당선,상갈,2955,2928,5883
<class,분당선,청명,1962,1942,3904
<class,분당선,영통,5240,5187,10427
<class,분당선,망포,6210,6540,12750
<class,분당선,매탄권선,2497,2385,4882
<class,분당선,수원시청,7673,7764,15437
<class,분당선,매교,1325,1411,2736
<class,수인선,고색,1697,1761,3458
<class,3호선,구파발,10819,11025,21844
<class,3호선,연신내,20544,19470,40014
<class,3호선,불광,9281,10468,19749
<class,3호선,녹번,7275,6483,13758
<class,3호선,홍제,9012,8475,17487
<class,3호선,무악재,1837,2010,3847
<class,3호선,독립문,3948,4431,8379
<class,3호선,경복궁,12463,13168,25631
<class,3호선,안국,11275,12230,23505
<class,3호선,종로3가,3807,5021,8828
<class,3호선,을지로3가,3559,3208,6767
<class,3호선,충무로,2,0,2
<class,3호선,동대입구,11861,11730,23591
<class,3호선,약수,6675,6185,12860
<class,3호선,금호,4193,3959,8152
<class,수인선,오목천,1505,1491,2996
<class,3호선,옥수,4894,5147,10041
<class,일산선,주엽,4503,4444,8947
<class,일산선,대화,7318,6989,14307
<class,장항선,봉명,528,538,1066
<class,장항선,쌍용,1242,1323,2565
<class,장항선,아산,3691,2446,6137
<class,장항선,탕정,247,293,540
<class,장항선,배방,814,871,1685
<class,장항선,온양온천,3365,3332,6697
<class,장항선,신창,1136,1749,2885
<class,중앙선,회기,21675,19948,41623
<class,중앙선,중랑,3293,3294,6587
<class,중앙선,상봉,3934,3952,7886
<class,중앙선,망우,4750,4617,9367
<class,중앙선,양원,907,943,1850
<class,중앙선,구리,7689,7881,15570
<class,중앙선,도농,5032,5039,10071
<class,중앙선,양정,418,359,777
<class,중앙선,덕소,3209,2654,5863
<class,중앙선,도심,1121,980,2101
<class,중앙선,팔당,1014,984,1998
<class,중앙선,운길산,853,770,1623
<class,중앙선,양수,1494,1468,2962
<class,중앙선,신원,199,124,323
<class,중앙선,국수,512,458,970
<class,중앙선,아신,495,472,967
<class,중앙선,오빈,241,184,425
<class,중앙선,양평,2166,2019,4185
<class,중앙선,원덕,302,271,573
<class,중앙선,용문,2000,1596,3596
<class,중앙선,지평,40,28,68
<class,수인선,어천,481,587,1068
<class,수인선,야목,192,160,352
<class,수인선,사리,2596,2186,4782
<class,수인선,달월,39,43,82
<class,수인선,월곶,1536,1402,2938
<class,수인선,소래포구,4677,4493,9170
<class,수인선,인천논현,2744,2951,5695
<class,수인선,호구포,1868,1866,3734
<class,수인선,남동인더스파크,606,589,1195
<class,수인선,원인재,2764,2918,5682
<class,수인선,연수,2948,2998,5946
<class,수인선,송도,1391,1411,2802
<class,수인선,인하대,3280,3159,6439
<class,일산선,원당,6128,5829,11957
<class,일산선,화정,9360,9538,18898
<class,일산선,대곡,1123,914,2037
<class,일산선,백석,5544,5280,10824
<class,일산선,마두,3369,3382,6751
<class,일산선,정발산,4993,4904,9897
<class,3호선,압구정,14112,14853,28965
<class,3호선,신사,14007,14314,28321
<class,수인선,숭의,1915,1795,3710
<class,수인선,신포,1024,995,2019
<class,수인선,인천,986,1500,2486
<class,안산선,산본,8655,9283,17938
<class,안산선,대야미,2912,2650,5562
<class,경부선,석수,5039,4801,9840
<class,경부선,금천구청,6262,6054,12316
<class,3호선,잠원,2289,2314,4603
<class,3호선,고속터미널,42108,39633,81741
<class,3호선,교대,4389,2624,7013
<class,3호선,남부터미널,15477,16216,31693
<class,3호선,양재,14419,16465,30884
<class,3호선,매봉,4113,4208,8321
<class,3호선,도곡,1915,2138,4053
<class,3호선,대치,5352,5038,10390
<class,3호선,학여울,1722,1911,3633
<class,3호선,대청,4262,4136,8398
<class,3호선,일원,3367,3672,7039
<class,3호선,수서,10462,10380,20842
<class,3호선,가락시장,3733,4073,7806
<class,3호선,경찰병원,2681,2761,5442
<class,3호선,오금,2743,2724,5467
<class,4호선,수유,19576,18921,38497
<class,4호선,미아,7806,7440,15246
<class,4호선,미아사거리,15789,15286,31075
<class,4호선,길음,10357,10121,20478
<class,4호선,성신여대입구,12713,12096,24809
<class,4호선,한성대입구,7659,7606,15265
<class,4호선,혜화,28288,27412,55700
<class,4호선,동대문,6865,7337,14202
<class,4호선,동대문역사문화공원,8767,7996,16763
<class,4호선,충무로,10836,10737,21573
<class,4호선,명동,12247,12351,24598
<class,4호선,회현,8377,8760,17137
<class,4호선,서울역,4337,12585,16922
<class,4호선,숙대입구,8056,7558,15614
<class,4호선,신용산,8265,8517,16782
<class,4호선,이촌,4608,5024,9632
<class,4호선,동작,1018,1110,2128
<class,4호선,총신대입구,9894,10984,20878
<class,4호선,사당,15649,14489,30138
<class,4호선,남태령,762,516,1278
<class,4호선,당고개,7526,7130,14656
<class,4호선,상계,10151,9404,19555
<class,경인선,온수,4847,4325,9172
<class,경인선,중동,6641,6210,12851
<class,경인선,도화,3089,2879,5968
<class,경춘선,신내,1298,1293,2591
<class,경춘선,갈매,1935,1654,3589
<class,경춘선,별내,2449,2191,4640
<class,경춘선,퇴계원,2595,2328,4923
<class,경춘선,사릉,2125,2044,4169
<class,경춘선,금곡,1133,1012,2145
<class,경춘선,평내호평,4663,4421,9084
<class,경춘선,천마산,1344,1320,2664
<class,경춘선,마석,3185,3186,6371
<class,경춘선,대성리,788,870,1658
<class,경춘선,청평,1450,1689,3139
<class,경춘선,상천,284,298,582
<class,경춘선,가평,1719,1943,3662
<class,경춘선,굴봉산,158,189,347
<class,경춘선,백양리,75,124,199
<class,경춘선,강촌,578,665,1243
<class,경춘선,김유정,394,490,884
<class,경춘선,남춘천,3273,3343,6616
<class,경춘선,춘천,1615,1500,3115
<class,공항철도 1호선,서울역,8569,8694,17263
<class,공항철도 1호선,공덕,1548,2487,4035
<class,공항철도 1호선,홍대입구,12006,12319,24325
<class,공항철도 1호선,디지털미디어시티,5918,5600,11518
<class,공항철도 1호선,마곡나루,3277,3572,6849
<class,공항철도 1호선,김포공항,12634,6066,18700
<class,공항철도 1호선,계양,7204,6473,13677
<class,공항철도 1호선,검암,4558,4640,9198
<class,공항철도 1호선,청라국제도시,4300,4078,8378
<class,공항철도 1호선,운서,5853,5945,11798
<class,공항철도 1호선,공항화물청사,1294,1361,2655
<class,공항철도 1호선,인천공항1터미널,3814,3884,7698
<class,공항철도 1호선,인천공항2터미널,2007,1817,3824
<class,공항철도 1호선,영종,2935,2923,5858
<class,과천선,선바위,5557,4673,10230
<class,과천선,경마공원,6784,6757,13541
<class,과천선,대공원,4402,4669,9071
<class,과천선,과천,4426,4007,8433
<class,과천선,정부과천청사,5993,5805,11798
<class,과천선,인덕원,16632,16095,32727
<class,과천선,평촌,9960,9602,19562
<class,과천선,범계,20816,20439,41255
<class,분당선,선릉,5526,8594,14120
<class,분당선,한티,11075,11096,22171
<class,분당선,도곡,4845,4392,9237
<class,분당선,구룡,1588,1448,3036
<class,분당선,개포동,2768,2702,5470
<class,분당선,대모산입구,3240,3001,6241
<class,분당선,수서,10663,10994,21657
<class,분당선,수원,7664,6357,14021
<class,분당선,서울숲,8149,8643,16792
<class,분당선,압구정로데오,17655,21353,39008
<class,분당선,강남구청,5747,6931,12678
<class,분당선,선정릉,3539,3669,7208
<class,분당선,가천대,5714,6090,11804
<class,분당선,태평,10586,9858,20444
<class,분당선,모란,16152,16439,32591
<class,분당선,야탑,18713,19463,38176
<class,분당선,서현,18861,19096,37957
<class,분당선,수내,8829,8267,17096
<class,분당선,정자,10832,11158,21990
<class,분당선,미금,10858,10914,21772
<class,분당선,오리,8357,6925,15282
<class,분당선,이매,4192,4161,8353
<class,분당선,보정,1605,1488,3093
<class,분당선,죽전,10320,11432,21752
<class,분당선,구성,3485,3520,7005
<class,분당선,신갈,3023,2945,5968
<class,분당선,기흥,6917,6397,13314
<class,분당선,상갈,3887,3852,7739
<class,분당선,청명,3063,2852,5915
<class,분당선,영통,6841,6868,13709
<class,분당선,망포,9707,8588,18295
<class,분당선,매탄권선,3722,3283,7005
<class,분당선,수원시청,11077,12949,24026
<class,분당선,매교,2185,2204,4389
<class,수인선,고색,2609,2616,5225
<class,수인선,오목천,2213,1844,4057
<class,수인선,어천,682,633,1315
<class,수인선,야목,248,224,472
<class,수인선,사리,3375,2812,6187
<class,수인선,달월,62,65,127
<class,수인선,월곶,2105,2042,4147
<class,수인선,소래포구,5360,5500,10860
<class,수인선,인천논현,4298,4592,8890
<class,수인선,호구포,2544,2388,4932
<class,수인선,남동인더스파크,966,911,1877
<class,수인선,원인재,3643,3740,7383
<class,수인선,연수,3863,3883,7746
<class,수인선,송도,2061,1979,4040
<class,수인선,인하대,4476,4092,8568
<class,수인선,숭의,2817,2622,5439
<class,수인선,신포,1492,1497,2989
<class,수인선,인천,1098,1968,3066
<class,안산선,산본,12483,13304,25787
<class,우이신설선,보문,1042,1020,2062
<class,우이신설선,신설동,1408,1311,2719
<class,일산선,원흥,7564,7056,14620
<class,일산선,삼송,14031,13374,27405
<class,일산선,원당,8374,7842,16216
<class,일산선,화정,12988,13340,26328
<class,일산선,대곡,1362,1126,2488
<class,일산선,백석,7754,7790,15544
<class,일산선,마두,5210,5173,10383
<class,일산선,정발산,6648,7145,13793
<class,일산선,주엽,6687,6499,13186
<class,일산선,대화,9928,9032,18960
<class,장항선,봉명,725,649,1374
<class,장항선,쌍용,1675,1469,3144
<class,장항선,아산,3203,3210,6413
<class,장항선,탕정,455,398,853
<class,장항선,배방,1002,975,1977
<class,장항선,온양온천,3742,3749,7491
<class,장항선,신창,1327,1210,2537
<class,중앙선,회기,21491,19851,41342
<class,중앙선,중랑,4507,4163,8670
<class,중앙선,상봉,5114,4808,9922
<class,중앙선,망우,6343,6102,12445
<class,중앙선,양원,1360,1349,2709
<class,중앙선,구리,10549,10816,21365
<class,중앙선,도농,7336,6863,14199
<class,중앙선,양정,551,501,1052
<class,중앙선,덕소,4498,3524,8022
<class,중앙선,도심,1512,1249,2761
<class,중앙선,팔당,1153,1232,2385
<class,중앙선,운길산,970,919,1889
<class,중앙선,양수,1885,1993,3878
<class,중앙선,신원,233,176,409
<class,중앙선,국수,581,633,1214
<class,중앙선,아신,546,562,1108
<class,중앙선,오빈,258,268,526
<class,중앙선,양평,2491,2725,5216
<class,중앙선,원덕,346,378,724
<class,중앙선,용문,1796,1990,3786
<class,중앙선,지평,46,56,102
<class,6호선,증산,7407,7283,14690
<class,6호선,새절,8454,7784,16238
<class,6호선,구산,5605,4104,9709
<class,6호선,독바위,1966,2201,4167
<class,6호선,불광,3636,3409,7045
<class,6호선,역촌,2809,3299,6108
<class,6호선,응암,12511,12174,24685
<class,5호선,하남검단산,4932,4817,9749
<class,7호선,까치울,5487,5475,10962
<class,5호선,을지로4가,3250,3740,6990
<class,5호선,종로3가,12546,13259,25805
<class,5호선,광화문,16491,17742,34233
<class,5호선,서대문,7445,7141,14586
<class,5호선,충정로,2019,1855,3874
<class,5호선,애오개,3754,3589,7343
<class,5호선,공덕,7616,7968,15584
<class,5호선,마포,7785,7845,15630
<class,5호선,여의나루,8413,9677,18090
<class,5호선,여의도,13026,13144,26170
<class,5호선,신길,2546,2643,5189
<class,5호선,영등포시장,7885,8231,16116
<class,5호선,영등포구청,1852,1913,3765
<class,7호선,부천종합운동장,3318,2968,6286
<class,7호선,춘의,5156,4889,10045
<class,7호선,신중동,9813,9806,19619
<class,7호선,부천시청,9740,9581,19321
<class,7호선,상동,10939,11576,22515
<class,7호선,삼산체육관,3671,3341,7012
<class,7호선,굴포천,6606,6820,13426
<class,7호선,부평구청,5037,4457,9494
<class,8호선,암사,12255,10931,23186
<class,8호선,천호,12144,14339,26483
<class,8호선,강동구청,6035,6066,12101
<class,8호선,몽촌토성,4562,4683,9245
<class,8호선,잠실,12514,14821,27335
<class,8호선,석촌,5662,7015,12677
<class,8호선,송파,5032,5120,10152
<class,8호선,가락시장,5659,5657,11316
<class,8호선,문정,8712,8887,17599
<class,8호선,장지,12161,11178,23339
<class,8호선,복정,7577,6393,13970
<class,8호선,산성,4528,4455,8983
<class,8호선,남한산성입구,9189,8003,17192
<class,8호선,단대오거리,7360,6905,14265
<class,8호선,신흥,3451,3613,7064
<class,8호선,수진,4242,3743,7985
<class,8호선,모란,3421,3129,6550
<class,9호선,개화,1508,1213,2721
<class,9호선,김포공항,8417,13259,21676
<class,9호선,공항시장,2233,2336,4569
<class,9호선,신방화,4835,4614,9449
<class,9호선,마곡나루,8284,8121,16405
<class,9호선,양천향교,5886,5439,11325
<class,9호선,가양,13950,12910,26860
<class,9호선,증미,3853,3755,7608
<class,9호선,등촌,7593,7152,14745
<class,9호선,염창,12128,11003,23131
<class,9호선,신목동,2561,2091,4652
<class,9호선,선유도,4074,3924,7998
<class,9호선,당산,13509,12572,26081
<class,9호선,국회의사당,5028,5076,10104
<class,9호선,여의도,13272,11899,25171
<class,9호선,샛강,2947,2798,5745
<class,9호선,노량진,20573,20107,40680
<class,9호선,노들,3383,2831,6214
<class,9호선,흑석,10788,9638,20426
<class,9호선,동작,1549,1321,2870
<class,9호선,구반포,1594,1697,3291
<class,9호선,신반포,2728,2625,5353
<class,9호선,고속터미널,12971,19106,32077
<class,9호선,사평,2251,2168,4419
<class,9호선,신논현,26680,27664,54344
<class,9호선2~3단계,언주,6569,6588,13157
<class,9호선2~3단계,선정릉,4954,5644,10598
<class,9호선2~3단계,삼성중앙,3213,3255,6468
<class,9호선2~3단계,봉은사,13205,14446,27651
<class,9호선2~3단계,종합운동장,3923,3483,7406
<class,9호선2~3단계,삼전,5013,4522,9535
<class,9호선2~3단계,석촌고분,4093,3960,8053
<class,9호선2~3단계,석촌,6627,5389,12016
<class,9호선2~3단계,송파나루,4027,4545,8572
<class,9호선2~3단계,한성백제,1931,1604,3535
<class,9호선2~3단계,올림픽공원,6894,6984,13878
<class,9호선2~3단계,둔촌오륜,647,648,1295
<class,9호선2~3단계,중앙보훈병원,4473,4161,8634
<class,경강선,판교,2874,2812,5686
<class,경강선,이매,786,615,1401
<class,경강선,삼동,1482,1359,2841
<class,경강선,경기광주,5313,4969,10282
<class,경강선,초월,2303,2028,4331
<class,경강선,곤지암,1880,1979,3859
<class,경강선,신둔도예촌,1244,1152,2396
<class,경강선,이천,2884,2967,5851
<class,경강선,부발,1942,1670,3612
<class,경강선,세종대왕릉,280,334,614
<class,경강선,여주,2138,2467,4605
<class,경부선,서울역,8683,2270,10953
<class,경부선,남영,5865,6130,11995
<class,경부선,용산,36606,38782,75388
<class,경부선,노량진,8242,7599,15841
<class,경부선,대방,8497,8310,16807
<class,경부선,영등포,39536,41947,81483
<class,경부선,신도림,2901,3130,6031
<class,경부선,신길,6142,5124,11266
<class,경부선,구로,13242,13729,26971
<class,경부선,가산디지털단지,6607,8825,15432
<class,경부선,금천구청,8376,8360,16736
<class,경부선,석수,7016,6359,13375
<class,경부선,관악,6023,5695,11718
<class,경부선,안양,18402,18616,37018
<class,경부선,명학,5423,5153,10576
<class,경부선,금정,19044,18951,37995
<class,경부선,군포,4422,3980,8402
<class,경부선,의왕,6096,5847,11943
<class,경부선,성균관대,10835,10657,21492
<class,경부선,화서,6094,5830,11924
<class,경부선,수원,38578,41627,80205
<class,경부선,독산,9089,8796,17885
<class,경부선,세류,2607,2515,5122
<class,경부선,병점,12844,12266,25110
<class,경부선,세마,2233,1970,4203
<class,경부선,오산대,2867,2608,5475
<class,경부선,오산,9828,8848,18676
<class,경부선,진위,1087,872,1959
<class,경부선,송탄,5033,4522,9555
<class,경부선,서정리,7202,5841,13043
<class,경부선,평택지제,3393,3101,6494
<class,경부선,평택,13734,13422,27156
<class,경부선,성환,3005,2725,5730
<class,경부선,직산,651,624,1275
<class,경부선,두정,5322,5286,10608
<class,경부선,천안,6323,6482,12805
<class,경부선,당정,4056,3816,7872
<class,경부선,서동탄,1030,1069,2099
<class,경부선,광명,3028,2733,5761
<class,경원선,이촌,2796,2143,4939
<class,경원선,서빙고,1794,2048,3842
<class,경원선,한남,2716,2735,5451
<class,경원선,옥수,41,33,74
<class,경원선,응봉,1594,1346,2940
<class,경원선,왕십리,13288,14400,27688
<class,경원선,청량리,16567,17418,33985
<class,경원선,외대앞,9458,8951,18409
<class,경원선,신이문,6324,5739,12063
<class,경원선,석계,6975,7282,14257
<class,경원선,광운대,6659,6386,13045
<class,경원선,월계,4700,4342,9042
<class,경원선,녹천,3136,2640,5776
<class,경원선,방학,7380,7085,14465
<class,경원선,도봉,4473,4086,8559
<class,경원선,도봉산,8613,5873,14486
<class,경원선,망월사,5605,5682,11287
<class,경원선,회룡,9656,9513,19169
<class,경원선,의정부,17729,18697,36426
<class,경원선,가능,5276,4955,10231
<class,경원선,녹양,3501,3394,6895
<class,경원선,양주,6507,6078,12585
<class,경원선,덕계,2516,2253,4769
<class,경원선,덕정,4685,4272,8957
<class,경원선,지행,5581,5548,11129
<class,경원선,동두천중앙,2526,2465,4991
<class,경원선,보산,1690,1663,3353
<class,경원선,동두천,1572,2015,3587
<class,경원선,소요산,3535,3014,6549
<class,경의선,서울역,1552,1679,3231
<class,경의선,신촌,429,491,920
<class,경의선,효창공원앞,1787,1833,3620
<class,경의선,공덕,2884,2141,5025
<class,경의선,서강대,1775,1741,3516
<class,경의선,홍대입구,1967,2523,4490
<class,경의선,가좌,4007,3741,7748
<class,경의선,디지털미디어시티,1965,1850,3815
<class,경의선,수색,1495,1404,2899
<class,경의선,화전,1208,1089,2297
<class,경의선,강매,2039,1900,3939
<class,경의선,행신,5414,5392,10806
<class,경의선,능곡,2873,2785,5658
<class,경의선,곡산,417,424,841
<class,경의선,백마,4597,4262,8859
<class,경의선,풍산,4373,4269,8642
<class,경의선,일산,6435,6117,12552
<class,경의선,탄현,5422,5105,10527
<class,경의선,야당,5830,6029,11859
<class,경의선,운정,5386,4926,10312
<class,경의선,금릉,3918,3666,7584
<class,경의선,금촌,5568,5360,10928
<class,경의선,월롱,1602,1317,2919
<class,경의선,파주,891,632,1523
<class,경의선,문산,5843,5678,11521
<class,경의선,임진강,52,104,156
<class,경의선,서울역,3,2,5
<class,5호선,오목교,15766,16561,32327
<class,5호선,목동,11164,11248,22412
<class,5호선,신정,9073,7488,16561
<class,5호선,까치산,20990,19938,40928
<class,5호선,화곡,20270,18331,38601
<class,5호선,우장산,9998,9613,19611
<class,5호선,발산,14124,15563,29687
<class,5호선,마곡,5290,5389,10679
<class,5호선,송정,5115,4872,9987
<class,5호선,김포공항,7600,7482,15082
<class,5호선,개화산,3758,3573,7331
<class,5호선,방화,4715,4474,9189
<class,4호선,쌍문,21388,19037,40425
<class,4호선,창동,19189,20195,39384
<class,4호선,노원,15506,17505,33011
<class,4호선,상계,13765,12762,26527
<class,4호선,당고개,9938,9227,19165
<class,4호선,남태령,1279,768,2047
<class,4호선,사당,22020,19971,41991
<class,4호선,총신대입구,14053,15583,29636
<class,4호선,동작,1386,1434,2820
<class,4호선,이촌,6264,6864,13128
<class,4호선,신용산,10311,11210,21521
<class,4호선,삼각지,3596,4849,8445
<class,4호선,숙대입구,9661,9126,18787
<class,4호선,서울역,6004,15323,21327
<class,4호선,회현,17828,19104,36932
<class,4호선,명동,14929,17210,32139
<class,4호선,충무로,14298,14928,29226
<class,4호선,동대문역사문화공원,12322,11022,23344
<class,4호선,동대문,14075,14161,28236
<class,4호선,혜화,28384,29533,57917
<class,4호선,한성대입구,10483,10077,20560
<class,4호선,성신여대입구,16635,15856,32491
<class,4호선,길음,14677,13646,28323
<class,4호선,미아사거리,22272,21200,43472
<class,4호선,미아,10575,10013,20588
<class,4호선,수유,26089,25815,51904
<class,3호선,오금,3699,3393,7092
<class,3호선,경찰병원,4086,3850,7936
<class,3호선,가락시장,6131,5942,12073
<class,3호선,불광,12935,14375,27310
<class,3호선,수서,13918,13626,27544
<class,3호선,일원,4815,4673,9488
<class,3호선,대청,5944,5407,11351
<class,3호선,학여울,3094,3174,6268
<class,3호선,대치,8214,7696,15910
<class,3호선,도곡,3572,3594,7166
<class,3호선,매봉,6155,5889,12044
<class,3호선,양재,21951,23871,45822
<class,3호선,남부터미널,21809,21746,43555
<class,3호선,교대,7421,4561,11982
<class,3호선,고속터미널,50246,51673,101919
<class,3호선,잠원,3418,3342,6760
<class,3호선,신사,25857,27970,53827
<class,3호선,압구정,25898,27838,53736
<class,3호선,옥수,6972,6978,13950
<class,3호선,금호,5789,5184,10973
<class,3호선,약수,9181,8568,17749
<class,3호선,동대입구,6577,7380,13957
<class,3호선,을지로3가,5500,5794,11294
<class,3호선,종로3가,5928,8468,14396
<class,3호선,안국,16002,17817,33819
<class,3호선,경복궁,17304,18670,35974
<class,3호선,독립문,5808,6138,11946
<class,3호선,무악재,2832,2853,5685
<class,3호선,홍제,13146,12027,25173
<class,3호선,녹번,10584,8990,19574
<class,7호선,온수,5658,5558,11216
<class,7호선,광명사거리,16784,16867,33651
<class,7호선,철산,15496,15867,31363
<class,7호선,가산디지털단지,15662,14074,29736
<class,7호선,남구로,8025,8478,16503
<class,5호선,하남시청,5011,4789,9800
<class,7호선,대림,6910,7389,14299
<class,7호선,신풍,8059,7580,15639
<class,7호선,보라매,6972,6409,13381
<class,7호선,신대방삼거리,11438,10426,21864
<class,7호선,장승배기,6715,6409,13124
<class,7호선,상도,9861,9115,18976
<class,7호선,숭실대입구,8589,8356,16945
<class,7호선,남성,7631,6976,14607
<class,7호선,이수,12243,11518,23761
<class,7호선,내방,7980,7840,15820
<class,7호선,고속터미널,15053,11650,26703
<class,7호선,반포,4512,4222,8734
<class,7호선,논현,11290,12695,23985
<class,7호선,학동,11569,12349,23918
<class,7호선,강남구청,10203,11309,21512
<class,7호선,청담,11770,12889,24659
<class,7호선,뚝섬유원지,6325,5979,12304
<class,7호선,건대입구,10789,11517,22306
<class,7호선,어린이대공원,9927,9484,19411
<class,7호선,군자,10902,8129,19031
<class,7호선,중곡,6972,6515,13487
<class,7호선,용마산,4390,4537,8927
<class,7호선,사가정,12235,11646,23881
<class,7호선,면목,11290,10659,21949
<class,7호선,상봉,13222,12706,25928
<class,7호선,중화,7768,7396,15164
<class,7호선,먹골,8253,7888,16141
<class,7호선,태릉입구,6551,6047,12598
<class,7호선,공릉,9132,8733,17865
<class,7호선,하계,12349,11164,23513
<class,7호선,중계,9373,8282,17655
<class,7호선,노원,15511,16139,31650
<class,7호선,마들,9189,8476,17665
<class,7호선,수락산,10108,9549,19657
<class,7호선,도봉산,6407,8717,15124
<class,7호선,장암,1597,1119,2716
<class,6호선,봉화산,5493,5231,10724
<class,3호선,연신내,28721,27413,56134
<class,6호선,화랑대,7595,5781,13376
<class,분당선,복정,1,0,1
<class,6호선,태릉입구,4081,4513,8594
<class,6호선,석계,8893,8872,17765
<class,6호선,돌곶이,7531,6563,14094
<class,6호선,상월곡,4076,3556,7632
<class,6호선,월곡,7739,7369,15108
<class,6호선,고려대,6122,5426,11548
<class,6호선,안암,8211,7751,15962
<class,6호선,보문,5272,4638,9910
<class,6호선,창신,2186,1743,3929
<class,6호선,동묘앞,7986,7249,15235
<class,6호선,신당,7027,5951,12978
<class,6호선,청구,2416,2362,4778
<class,6호선,약수,2437,2498,4935
<class,3호선,구파발,14805,14793,29598
<class,3호선,지축,3071,2785,5856
<class,2호선,용두,1692,1648,3340
<class,2호선,신정네거리,7320,7276,14596
<class,2호선,양천구청,4533,4622,9155
<class,2호선,도림천,808,818,1626
<class,2호선,신설동,3429,3393,6822
<class,2호선,신답,973,1071,2044
<class,2호선,용답,2256,2026,4282
<class,2호선,충정로,5762,5979,11741
<class,2호선,아현,7610,7055,14665
<class,2호선,이대,12950,12981,25931
<class,2호선,신촌,31283,31813,63096
<class,2호선,홍대입구,63451,71886,135337
<class,2호선,합정,28711,32463,61174
<class,2호선,당산,13028,14199,27227
<class,2호선,영등포구청,13600,14000,27600
<class,2호선,문래,12264,13056,25320
<class,2호선,신도림,41001,41582,82583
<class,2호선,대림,17159,18193,35352
<class,2호선,구로디지털단지,34434,33904,68338
<class,2호선,신대방,19947,18832,38779
<class,2호선,신림,50133,47392,97525
<class,2호선,봉천,16885,15148,32033
<class,2호선,서울대입구,38552,36848,75400
<class,2호선,낙성대,21509,19122,40631
<class,2호선,사당,32089,36139,68228
<class,2호선,방배,10928,11154,22082
<class,2호선,서초,11924,9944,21868
<class,2호선,교대,17853,20345,38198
<class,2호선,강남,62641,65972,128613
<class,2호선,역삼,18902,20410,39312
<class,2호선,선릉,25012,22366,47378
<class,2호선,삼성,34818,35158,69976
<class,2호선,종합운동장,6644,7283,13927
<class,2호선,잠실새내,16553,17028,33581
<class,2호선,잠실,65625,63482,129107
<class,2호선,잠실나루,7925,7701,15626
<class,2호선,강변,27767,28060,55827
<class,2호선,구의,16411,15860,32271
<class,2호선,건대입구,34602,38491,73093
<class,2호선,성수,19175,21850,41025
<class,2호선,뚝섬,13999,14060,28059
<class,2호선,한양대,12383,12380,24763
<class,2호선,왕십리,14819,12542,27361
<class,2호선,상왕십리,9989,9187,19176
<class,2호선,신당,10877,11420,22297
<class,2호선,동대문역사문화공원,11637,12691,24328
<class,2호선,을지로4가,7267,7755,15022
<class,2호선,을지로3가,11743,11877,23620
<class,2호선,을지로입구,22413,22345,44758
<class,2호선,시청,9862,8703,18565
<class,1호선,청량리,17605,17645,35250
<class,1호선,제기동,14316,14388,28704
<class,1호선,신설동,9852,9172,19024
<class,1호선,동대문,10728,9922,20650
<class,1호선,종로5가,18239,18455,36694
<class,1호선,종로3가,22731,21929,44660
<class,1호선,종각,21747,20237,41984
<class,1호선,시청,12424,13314,25738
<class,1호선,동묘앞,10863,11211,22074
<class,1호선,서울역,36779,37426,74205
<class,6호선,버티고개,1342,1388,2730
<class,7호선,천왕,7087,6450,13537
<class,6호선,한강진,9192,11325,20517
<class,6호선,이태원,12109,15414,27523
<class,6호선,녹사평,4986,5509,10495
<class,6호선,삼각지,6023,4694,10717
<class,6호선,효창공원앞,4650,4176,8826
<class,6호선,공덕,10583,10148,20731
<class,6호선,대흥,5466,5403,10869
<class,6호선,광흥창,5182,4777,9959
<class,6호선,상수,8052,10115,18167
<class,6호선,합정,12706,11901,24607
<class,6호선,망원,12455,13581,26036
<class,6호선,마포구청,9665,8302,17967
<class,6호선,월드컵경기장,3796,4197,7993
<class,6호선,디지털미디어시티,7450,7468,14918
<class,경인선,개봉,16157,15627,31784
<class,경인선,오류동,8907,7983,16890
<class,경인선,역곡,19971,19187,39158
<class,경인선,부천,27890,29050,56940
<class,경인선,송내,17858,17503,35361
<class,경인선,부평,28041,31876,59917
<class,경인선,백운,5337,5227,10564
<class,경인선,동암,12175,12454,24629
<class,경인선,주안,16065,14089,30154
<class,경인선,제물포,7346,7057,14403
<class,경인선,동인천,11664,11514,23178
<class,경인선,인천,4079,3518,7597
<class,경인선,구일,4342,4066,8408
<class,경인선,소사,7451,7165,14616
<class,안산선,대야미,3958,3539,7497
<class,안산선,반월,3462,3073,6535
<class,안산선,상록수,13272,13103,26375
<class,안산선,한대앞,7303,6979,14282
<class,안산선,중앙,15731,16871,32602
<class,안산선,고잔,6690,6778,13468
<class,안산선,초지,3381,3231,6612
<class,안산선,안산,9529,9722,19251
<class,안산선,신길온천,1430,1350,2780
<class,안산선,정왕,6586,6600,13186
<class,안산선,오이도,7520,7700,15220
<class,안산선,수리산,2962,2559,5521
<class,우이신설선,북한산우이,3209,3160,6369
<class,우이신설선,솔밭공원,1760,1702,3462
<class,우이신설선,4.19민주묘지,2369,2061,4430
<class,우이신설선,가오리,2959,2749,5708
<class,우이신설선,화계,2422,2195,4617
<class,우이신설선,삼양,1495,1519,3014
<class,우이신설선,삼양사거리,1827,1797,3624
<class,우이신설선,솔샘,3809,3410,7219
<class,우이신설선,북한산보국문,4754,4132,8886
<class,우이신설선,정릉,3711,2960,6671
<class,우이신설선,성신여대입구,2616,3278,5894
<class,5호선,동대문역사문화공원,1076,1335,2411
<class,5호선,청구,2396,2272,4668
<class,5호선,신금호,4060,4074,8134
<class,5호선,행당,5925,5199,11124
<class,5호선,왕십리,3743,4386,8129
<class,5호선,마장,3948,3794,7742
<class,5호선,답십리,10266,9133,19399
<class,5호선,장한평,11295,10967,22262
<class,5호선,군자,8535,9491,18026
<class,5호선,아차산,12188,11511,23699
<class,5호선,광나루,10472,9451,19923
<class,5호선,천호,16561,15889,32450
<class,5호선,강동,13112,12115,25227
<class,5호선,길동,5947,6074,12021
<class,5호선,굽은다리,6956,6445,13401
<class,5호선,명일,6269,6136,12405
<class,5호선,고덕,6176,6047,12223
<class,5호선,상일동,9828,9018,18846
<class,5호선,둔촌동,6239,6190,12429
<class,5호선,올림픽공원,3417,3227,6644
<class,5호선,방이,5196,5169,10365
<class,5호선,오금,2091,2023,4114
<class,5호선,개롱,4321,4455,8776
<class,5호선,거여,5960,5560,11520
<class,5호선,마천,4688,4779,9467
<class,5호선,강일,2750,2459,5209
<class,5호선,미사,12064,11676,23740
<class,5호선,하남풍산,2714,2775,5489
<class,경인선,부개,6315,5928,12243
<class,경인선,간석,4305,4091,8396
<class,경인선,도원,1878,1921,3799
<class,5호선,양평,3711,3470,7181
<class,경춘선,춘천,1459,1339,2798
<class,공항철도 1호선,서울역,8299,7556,15855
<class,공항철도 1호선,공덕,1225,1687,2912
<class,중앙선,지평,65,50,115
<class,중앙선,용문,1843,1565,3408
<class,중앙선,원덕,331,311,642
<class,중앙선,양평,3308,3095,6403
<class,중앙선,오빈,202,182,384
<class,중앙선,아신,558,473,1031
<class,중앙선,국수,601,561,1162
<class,중앙선,신원,188,170,358
<class,중앙선,양수,1648,1519,3167
<class,중앙선,운길산,1015,960,1975
<class,중앙선,팔당,1139,1208,2347
<class,중앙선,도심,1171,1059,2230
<class,중앙선,덕소,3465,2672,6137
<class,중앙선,양정,450,393,843
<class,중앙선,도농,5163,5054,10217
<class,중앙선,구리,7446,7784,15230
<class,중앙선,양원,1051,1063,2114
<class,중앙선,망우,4661,4703,9364
<class,중앙선,상봉,3996,3940,7936
<class,중앙선,중랑,3411,3361,6772
<class,중앙선,회기,16426,15994,32420
<class,장항선,신창,1040,1545,2585
<class,장항선,온양온천,3289,3228,6517
<class,장항선,배방,850,889,1739
<class,장항선,탕정,382,389,771
<class,장항선,아산,3593,2275,5868
<class,장항선,쌍용,1174,1253,2427
<class,장항선,봉명,509,496,1005
<class,일산선,대화,7081,6565,13646
<class,일산선,주엽,4537,4379,8916
<class,일산선,정발산,5213,5166,10379
<class,일산선,마두,3296,3372,6668
<class,일산선,백석,5466,5278,10744
<class,일산선,대곡,1050,882,1932
<class,일산선,화정,9507,9729,19236
<class,일산선,원당,5963,5752,11715
<class,일산선,삼송,10418,10326,20744
<class,일산선,원흥,5214,5047,10261
<class,우이신설선,신설동,1111,1110,2221
<class,우이신설선,보문,887,899,1786
<class,우이신설선,성신여대입구,2132,2540,4672
<class,우이신설선,정릉,2711,2293,5004
<class,우이신설선,북한산보국문,3669,3245,6914
<class,우이신설선,솔샘,2837,2604,5441
<class,우이신설선,삼양사거리,1450,1447,2897
<class,우이신설선,삼양,1150,1151,2301
<class,우이신설선,화계,2005,1903,3908
<class,우이신설선,가오리,2303,2121,4424
<class,우이신설선,4.19민주묘지,1870,1645,3515
<class,우이신설선,솔밭공원,1360,1342,2702
<class,우이신설선,북한산우이,3008,3128,6136
<class,안산선,수리산,2132,2076,4208
<class,안산선,오이도,5930,5675,11605
<class,안산선,정왕,5582,6044,11626
<class,안산선,신길온천,1060,1054,2114
<class,안산선,안산,9289,8545,17834
<class,안산선,초지,2421,2293,4714
<class,안산선,고잔,4897,4689,9586
<class,안산선,중앙,11649,11725,23374
<class,안산선,한대앞,5470,5398,10868
<class,안산선,상록수,9293,9190,18483
<class,안산선,반월,2449,2435,4884
<class,안산선,대야미,2905,2575,5480
<class,안산선,산본,8646,9337,17983
<class,수인선,인천,1088,1580,2668
<class,수인선,신포,1125,1132,2257
<class,수인선,숭의,2140,2003,4143
<class,수인선,인하대,3134,3099,6233
<class,수인선,송도,1475,1460,2935
<class,수인선,연수,3145,3128,6273
<class,수인선,원인재,2885,3080,5965
<class,수인선,남동인더스파크,586,577,1163
<class,수인선,호구포,1993,2025,4018
<class,수인선,인천논현,2940,2953,5893
<class,수인선,소래포구,4544,4360,8904
<class,수인선,월곶,1618,1565,3183
<class,수인선,달월,56,58,114
<class,수인선,사리,2496,2156,4652
<class,수인선,야목,207,167,374
<class,수인선,어천,537,693,1230
<class,수인선,오목천,1451,1400,2851
<class,수인선,고색,1761,1884,3645
<class,분당선,매교,1375,1398,2773
<class,분당선,수원시청,7709,7731,15440
<class,분당선,매탄권선,2452,2403,4855
<class,분당선,망포,6396,6595,12991
<class,분당선,영통,4657,4780,9437
<class,분당선,청명,1976,2089,4065
<class,분당선,상갈,2783,2821,5604
<class,분당선,기흥,5128,4768,9896
<class,분당선,신갈,1868,1961,3829
<class,분당선,구성,2372,2559,4931
<class,분당선,죽전,7501,8601,16102
<class,분당선,보정,1056,1132,2188
<class,분당선,이매,3265,3445,6710
<class,분당선,오리,5570,4826,10396
<class,분당선,미금,7415,7731,15146
<class,분당선,정자,7141,7597,14738
<class,분당선,수내,5837,5773,11610
<class,분당선,서현,14230,14416,28646
<class,분당선,야탑,13567,13806,27373
<class,분당선,모란,11055,11354,22409
<class,분당선,태평,7910,7474,15384
<class,분당선,가천대,3728,4362,8090
<class,분당선,선정릉,2127,2200,4327
<class,분당선,강남구청,3431,4183,7614
<class,분당선,압구정로데오,10328,11592,21920
<class,분당선,서울숲,6113,6250,12363
<class,분당선,수원,5744,4750,10494
<class,분당선,복정,1,0,1
<class,2호선,구의,11724,11787,23511
<class,분당선,수서,8749,8504,17253
<class,분당선,대모산입구,2333,2160,4493
<class,분당선,개포동,2107,2062,4169
<class,분당선,구룡,740,840,1580
<class,분당선,도곡,2639,2614,5253
<class,분당선,한티,7170,7474,14644
<class,분당선,선릉,3127,4574,7701
<class,과천선,범계,14732,14438,29170
<class,과천선,평촌,6731,6640,13371
<class,과천선,인덕원,12024,12235,24259
<class,과천선,정부과천청사,4168,4389,8557
<class,과천선,과천,3376,3051,6427
<class,과천선,대공원,3987,4193,8180
<class,8호선,신흥,2603,2752,5355
<class,과천선,경마공원,7479,7522,15001
<class,과천선,선바위,3883,3474,7357
<class,공항철도 1호선,영종,2339,2167,4506
<class,공항철도 1호선,인천공항2터미널,1981,2091,4072
<class,공항철도 1호선,인천공항1터미널,3941,3763,7704
<class,공항철도 1호선,공항화물청사,930,1055,1985
<class,공항철도 1호선,운서,4939,5259,10198
<class,공항철도 1호선,청라국제도시,3138,3057,6195
<class,공항철도 1호선,검암,3604,3598,7202
<class,공항철도 1호선,계양,5187,4974,10161
<class,공항철도 1호선,김포공항,11803,5725,17528
<class,공항철도 1호선,마곡나루,2283,2630,4913
<class,공항철도 1호선,디지털미디어시티,3743,3682,7425
<class,공항철도 1호선,홍대입구,9575,8842,18417
<class,경원선,창동,1,0,1
<class,1호선,서울역,30756,28808,59564
<class,1호선,동묘앞,11947,12149,24096
<class,1호선,시청,8744,8503,17247
<class,1호선,종각,13936,11960,25896
<class,1호선,종로3가,14404,12648,27052
<class,1호선,종로5가,8905,8854,17759
<class,1호선,동대문,9250,9646,18896
<class,1호선,신설동,7701,7500,15201
<class,1호선,제기동,9619,9967,19586
<class,1호선,청량리,12735,13067,25802
<class,2호선,시청,6608,5596,12204
<class,2호선,을지로입구,16694,15408,32102
<class,2호선,을지로3가,8389,7817,16206
<class,2호선,을지로4가,3401,3352,6753
<class,2호선,동대문역사문화공원,8062,9872,17934
<class,2호선,신당,8250,8821,17071
<class,2호선,상왕십리,6950,6760,13710
<class,2호선,왕십리,10323,9025,19348
<class,2호선,한양대,12222,12102,24324
<class,2호선,뚝섬,10068,10042,20110
<class,2호선,성수,13490,14901,28391
<class,2호선,건대입구,26604,27916,54520
<class,2호선,강변,22894,22458,45352
<class,2호선,잠실나루,5598,5707,11305
<class,2호선,잠실,49546,47343,96889
<class,2호선,잠실새내,11799,11996,23795
<class,2호선,종합운동장,9030,9855,18885
<class,2호선,삼성,23342,22836,46178
<class,2호선,선릉,13886,11879,25765
<class,2호선,역삼,11780,12975,24755
<class,2호선,강남,36019,35870,71889
<class,2호선,교대,10646,11902,22548
<class,2호선,서초,11176,10212,21388
<class,2호선,방배,6750,7238,13988
<class,2호선,사당,21829,24966,46795
<class,2호선,낙성대,15759,16081,31840
<class,2호선,서울대입구,27304,27949,55253
<class,2호선,봉천,11955,11618,23573
<class,2호선,신림,36960,36087,73047
<class,2호선,신대방,14922,14696,29618
<class,2호선,구로디지털단지,23582,23295,46877
<class,2호선,대림,14607,14722,29329
<class,2호선,신도림,28921,29233,58154
<class,2호선,문래,7875,8420,16295
<class,2호선,영등포구청,8661,8886,17547
<class,2호선,당산,8971,9586,18557
<class,2호선,합정,20714,22149,42863
<class,2호선,홍대입구,48702,48609,97311
<class,2호선,신촌,22568,21605,44173
<class,2호선,이대,8852,9055,17907
<class,2호선,아현,5148,5231,10379
<class,2호선,충정로,3882,4093,7975
<class,2호선,용답,1643,1719,3362
<class,2호선,신답,739,774,1513
<class,2호선,신설동,2941,3154,6095
<class,2호선,도림천,470,501,971
<class,2호선,양천구청,3284,3316,6600
<class,2호선,신정네거리,5156,5329,10485
<class,2호선,용두,1082,1073,2155
<class,3호선,지축,2075,1957,4032
<class,3호선,구파발,11082,11299,22381
<class,3호선,연신내,20704,19851,40555
<class,3호선,불광,9436,10901,20337
<class,3호선,녹번,7337,6615,13952
<class,3호선,홍제,8829,8593,17422
<class,3호선,무악재,1850,1986,3836
<class,3호선,독립문,4066,4431,8497
<class,3호선,경복궁,13307,13878,27185
<class,3호선,안국,10748,11515,22263
<class,3호선,종로3가,3674,4869,8543
<class,3호선,을지로3가,3385,3076,6461
<class,3호선,충무로,1,0,1
<class,3호선,동대입구,4597,5017,9614
<class,3호선,약수,6465,6236,12701
<class,3호선,금호,4181,3958,8139
<class,3호선,옥수,4896,5154,10050
<class,3호선,압구정,14549,15162,29711
<class,3호선,신사,14642,15051,29693
<class,3호선,잠원,2206,2133,4339
<class,3호선,고속터미널,41287,39579,80866
<class,3호선,교대,4349,2606,6955
<class,5호선,개롱,3131,3291,6422
<class,3호선,남부터미널,14834,15724,30558
<class,3호선,양재,14204,16443,30647
<class,3호선,매봉,4214,4203,8417
<class,3호선,도곡,1877,2041,3918
<class,3호선,대치,4872,4592,9464
<class,3호선,학여울,2413,2520,4933
<class,3호선,대청,4096,3947,8043
<class,3호선,일원,3437,3581,7018
<class,3호선,수서,10794,10424,21218
<class,3호선,가락시장,3602,3914,7516
<class,3호선,경찰병원,2745,2796,5541
<class,3호선,오금,2688,2685,5373
<class,4호선,수유,19406,18463,37869
<class,4호선,미아,7686,7373,15059
<class,4호선,미아사거리,16248,15157,31405
<class,4호선,길음,10416,10192,20608
<class,4호선,성신여대입구,12368,11887,24255
<class,4호선,한성대입구,7326,7372,14698
<class,4호선,혜화,21694,22890,44584
<class,4호선,동대문,7186,7959,15145
<class,4호선,동대문역사문화공원,9001,8540,17541
<class,4호선,충무로,8399,8485,16884
<class,4호선,명동,12103,12384,24487
<class,4호선,회현,8882,9498,18380
<class,4호선,서울역,4366,11730,16096
<class,4호선,숙대입구,7307,6971,14278
<class,4호선,삼각지,2421,3246,5667
<class,4호선,신용산,7730,7796,15526
<class,4호선,이촌,4616,4960,9576
<class,4호선,동작,1136,1127,2263
<class,4호선,총신대입구,10133,11116,21249
<class,4호선,사당,15575,14429,30004
<class,4호선,남태령,716,510,1226
<class,4호선,당고개,7457,7084,14541
<class,4호선,상계,9973,9242,19215
<class,4호선,노원,11369,12556,23925
<class,4호선,창동,14431,15074,29505
<class,4호선,쌍문,15423,13916,29339
<class,5호선,방화,3568,3540,7108
<class,5호선,개화산,2660,2654,5314
<class,5호선,김포공항,6776,6390,13166
<class,5호선,송정,3702,3657,7359
<class,5호선,마곡,3663,3694,7357
<class,5호선,발산,9449,10172,19621
<class,5호선,우장산,6751,6751,13502
<class,5호선,화곡,13787,13190,26977
<class,5호선,까치산,15337,14751,30088
<class,5호선,신정,6288,5782,12070
<class,5호선,목동,7590,7667,15257
<class,5호선,오목교,11129,11850,22979
<class,5호선,양평,2621,2652,5273
<class,5호선,영등포구청,1323,1278,2601
<class,5호선,영등포시장,5213,5504,10717
<class,5호선,신길,1908,2160,4068
<class,5호선,여의도,8057,8449,16506
<class,5호선,여의나루,7419,8444,15863
<class,5호선,마포,4790,4801,9591
<class,5호선,공덕,4716,4837,9553
<class,5호선,애오개,2600,2707,5307
<class,5호선,충정로,1473,1525,2998
<class,5호선,서대문,5123,4981,10104
<class,5호선,광화문,12425,12683,25108
<class,5호선,종로3가,8636,7840,16476
<class,5호선,을지로4가,1492,1561,3053
<class,5호선,동대문역사문화공원,688,804,1492
<class,5호선,청구,1779,1652,3431
<class,5호선,신금호,3035,3182,6217
<class,5호선,행당,4000,3597,7597
<class,5호선,왕십리,2484,2822,5306
<class,5호선,마장,2897,2739,5636
<class,5호선,답십리,7209,6757,13966
<class,5호선,장한평,7821,7811,15632
<class,5호선,군자,6233,6775,13008
<class,5호선,아차산,9904,9737,19641
<class,5호선,광나루,7735,7665,15400
<class,5호선,천호,12284,11667,23951
<class,5호선,강동,9044,9148,18192
<class,5호선,길동,4084,4190,8274
<class,5호선,굽은다리,4982,4655,9637
<class,5호선,명일,4627,4755,9382
<class,5호선,고덕,4108,4165,8273
<class,5호선,상일동,6679,6540,13219
<class,5호선,둔촌동,4456,4541,8997
<class,5호선,올림픽공원,2504,2354,4858
<class,5호선,방이,4187,3970,8157
<class,5호선,오금,1572,1502,3074
<class,5호선,거여,4184,4050,8234
<class,5호선,마천,3580,3866,7446
<class,5호선,강일,1897,1784,3681
<class,5호선,미사,8481,8446,16927
<class,5호선,하남풍산,1926,2039,3965
<class,5호선,하남시청,3598,3535,7133
<class,5호선,하남검단산,4186,4203,8389
<class,6호선,응암,8939,8929,17868
<class,6호선,역촌,1892,2293,4185
<class,6호선,불광,2872,2635,5507
<class,6호선,독바위,1484,1834,3318
<class,6호선,연신내,1,0,1
<class,6호선,구산,3863,2867,6730
<class,6호선,새절,6195,6048,12243
<class,6호선,증산,5445,5438,10883
<class,6호선,디지털미디어시티,5043,5329,10372
<class,6호선,월드컵경기장,2950,3093,6043
<class,6호선,마포구청,6986,6359,13345
<class,6호선,망원,9093,9788,18881
<class,6호선,합정,9305,8436,17741
<class,6호선,상수,5836,6710,12546
<class,6호선,광흥창,4164,4016,8180
<class,6호선,대흥,3608,3780,7388
<class,6호선,공덕,7075,6475,13550
<class,6호선,효창공원앞,3443,3095,6538
<class,6호선,삼각지,3633,2872,6505
<class,6호선,녹사평,3836,3771,7607
<class,6호선,이태원,9630,8593,18223
<class,6호선,한강진,7525,8472,15997
<class,6호선,버티고개,903,1007,1910
<class,6호선,약수,1695,1597,3292
<class,6호선,청구,1772,1683,3455
<class,6호선,신당,4418,4864,9282
<class,6호선,동묘앞,6040,5905,11945
<class,6호선,창신,1597,1433,3030
<class,6호선,보문,3994,3717,7711
<class,6호선,안암,5766,6028,11794
<class,6호선,고려대,4378,4177,8555
<class,6호선,월곡,5174,5101,10275
<class,6호선,상월곡,3101,2866,5967
<class,6호선,돌곶이,5651,5246,10897
<class,6호선,석계,6545,6755,13300
<class,6호선,태릉입구,3185,3414,6599
<class,6호선,화랑대,5476,4752,10228
<class,6호선,봉화산,3975,3764,7739
<class,7호선,장암,1312,873,2185
<class,7호선,도봉산,5378,7638,13016
<class,7호선,수락산,7957,7682,15639
<class,7호선,마들,5950,5597,11547
<class,7호선,노원,10977,11195,22172
<class,7호선,중계,6574,6135,12709
<class,7호선,하계,8989,8603,17592
<class,7호선,공릉,6702,6694,13396
<class,7호선,태릉입구,4831,4499,9330
<class,7호선,먹골,5617,5431,11048
<class,7호선,중화,5388,5324,10712
<class,7호선,상봉,8978,8532,17510
<class,7호선,면목,7732,7729,15461
<class,7호선,사가정,9016,8635,17651
<class,7호선,용마산,3202,3495,6697
<class,7호선,중곡,4864,4778,9642
<class,7호선,군자,7803,6092,13895
<class,7호선,어린이대공원,9180,8854,18034
<class,7호선,건대입구,7365,7725,15090
<class,7호선,뚝섬유원지,5294,5017,10311
<class,7호선,청담,7095,7775,14870
<class,7호선,강남구청,5803,6247,12050
<class,7호선,학동,6773,7199,13972
<class,7호선,논현,6211,6645,12856
<class,7호선,반포,2799,2850,5649
<class,7호선,고속터미널,13820,8488,22308
<class,7호선,내방,5130,5350,10480
<class,7호선,이수,8433,8016,16449
<class,7호선,남성,5277,5250,10527
<class,7호선,숭실대입구,5897,6229,12126
<class,7호선,상도,6801,6612,13413
<class,7호선,장승배기,4704,4641,9345
<class,7호선,신대방삼거리,7880,7713,15593
<class,7호선,보라매,4670,4618,9288
<class,7호선,신풍,6014,5650,11664
<class,7호선,대림,6961,6596,13557
<class,7호선,남구로,6397,6172,12569
<class,7호선,가산디지털단지,11545,10678,22223
<class,7호선,철산,10676,10604,21280
<class,7호선,광명사거리,12341,12258,24599
<class,7호선,천왕,4737,4606,9343
<class,7호선,온수,4001,3992,7993
<class,7호선,까치울,4030,4051,8081
<class,7호선,부천종합운동장,2546,2179,4725
<class,7호선,춘의,3478,3302,6780
<class,7호선,신중동,6758,6590,13348
<class,7호선,부천시청,6471,6478,12949
<class,7호선,상동,7304,7159,14463
<class,7호선,삼산체육관,2548,2389,4937
<class,7호선,굴포천,4584,4553,9137
<class,7호선,부평구청,3486,3216,6702
<class,8호선,암사,8607,8133,16740
<class,8호선,천호,8768,10024,18792
<class,8호선,강동구청,4505,4675,9180
<class,8호선,몽촌토성,3592,3578,7170
<class,8호선,잠실,9887,11390,21277
<class,8호선,석촌,4173,5019,9192
<class,8호선,송파,3650,3745,7395
<class,8호선,가락시장,3274,4043,7317
<class,8호선,문정,5849,6233,12082
<class,8호선,장지,9168,9342,18510
<class,8호선,복정,5452,5198,10650
<class,8호선,산성,3267,3372,6639
<class,8호선,남한산성입구,6570,6107,12677
<class,8호선,단대오거리,5375,5415,10790
<class,8호선,수진,2958,2622,5580
<class,8호선,모란,2561,2140,4701
<class,9호선,개화,1082,984,2066
<class,9호선,김포공항,7373,11470,18843
<class,9호선,공항시장,1630,1813,3443
<class,9호선,신방화,3263,3314,6577
<class,9호선,마곡나루,5911,5787,11698
<class,9호선,양천향교,4060,4145,8205
<class,9호선,가양,9915,9807,19722
<class,9호선,증미,2385,2433,4818
<class,9호선,등촌,5155,5255,10410
<class,9호선,염창,8579,8511,17090
<class,9호선,신목동,1922,1662,3584
<class,9호선,선유도,2907,2799,5706
<class,9호선,당산,8786,8858,17644
<class,9호선,국회의사당,4992,4676,9668
<class,9호선,여의도,9360,8243,17603
<class,9호선,샛강,1657,1714,3371
<class,9호선,노량진,14046,15241,29287
<class,9호선,노들,2573,2209,4782
<class,9호선,흑석,7247,6694,13941
<class,9호선,동작,1215,1094,2309
<class,9호선,구반포,810,913,1723
<class,9호선,신반포,1679,1736,3415
<class,9호선,고속터미널,10445,14405,24850
<class,9호선,사평,1623,1637,3260
<class,9호선,신논현,15860,15563,31423
<class,9호선2~3단계,언주,3887,3895,7782
<class,9호선2~3단계,선정릉,3080,3531,6611
<class,9호선2~3단계,삼성중앙,2011,2210,4221
<class,9호선2~3단계,봉은사,8550,8638,17188
<class,9호선2~3단계,종합운동장,3201,2608,5809
<class,9호선2~3단계,삼전,3620,3487,7107
<class,9호선2~3단계,석촌고분,3216,3063,6279
<class,9호선2~3단계,석촌,4856,4144,9000
<class,9호선2~3단계,송파나루,2946,3381,6327
<class,9호선2~3단계,한성백제,1479,1377,2856
<class,9호선2~3단계,올림픽공원,5003,5025,10028
<class,9호선2~3단계,둔촌오륜,500,474,974
<class,9호선2~3단계,중앙보훈병원,3369,3261,6630
<class,경강선,판교,2431,2220,4651
<class,경강선,이매,651,446,1097
<class,경강선,삼동,1008,1017,2025
<class,경강선,경기광주,3744,3729,7473
<class,경강선,초월,1587,1644,3231
<class,경강선,곤지암,1451,1550,3001
<class,경강선,신둔도예촌,968,915,1883
<class,경강선,이천,2059,2401,4460
<class,경강선,부발,1345,2049,3394
<class,경강선,세종대왕릉,251,247,498
<class,경강선,여주,2052,2226,4278
<class,경부선,서울역,8975,1927,10902
<class,경부선,남영,4236,4563,8799
<class,경부선,용산,33078,29599,62677
<class,경부선,노량진,5486,5154,10640
<class,경부선,대방,5966,6298,12264
<class,경부선,영등포,32282,31029,63311
<class,경부선,신도림,2222,2392,4614
<class,경부선,신길,4807,4269,9076
<class,경부선,구로,9560,9887,19447
<class,경부선,가산디지털단지,4926,6829,11755
<class,경부선,금천구청,6238,6046,12284
<class,경부선,석수,5295,5101,10396
<class,경부선,관악,4999,4651,9650
<class,경부선,안양,13962,13438,27400
<class,경부선,명학,3631,3566,7197
<class,경부선,금정,13883,14086,27969
<class,경부선,군포,3084,2941,6025
<class,경부선,의왕,4161,4235,8396
<class,경부선,성균관대,7882,8207,16089
<class,경부선,화서,4166,4010,8176
<class,경부선,수원,33950,32858,66808
<class,경부선,독산,6152,6148,12300
<class,경부선,세류,2060,2179,4239
<class,경부선,병점,9456,10352,19808
<class,경부선,세마,1800,1681,3481
<class,경부선,오산대,2103,2126,4229
<class,경부선,오산,8118,8785,16903
<class,경부선,진위,878,868,1746
<class,경부선,송탄,3627,4214,7841
<class,경부선,서정리,4436,6223,10659
<class,경부선,평택지제,2426,2307,4733
<class,경부선,평택,11593,12509,24102
<class,경부선,성환,2357,2848,5205
<class,경부선,직산,555,645,1200
<class,경부선,두정,4183,4888,9071
<class,경부선,천안,6046,5844,11890
<class,경부선,당정,3065,2958,6023
<class,경부선,서동탄,797,815,1612
<class,경부선,광명,3127,2126,5253
<class,경원선,이촌,2069,1688,3757
<class,경원선,서빙고,1361,1462,2823
<class,경원선,한남,1942,1931,3873
<class,경원선,옥수,63,20,83
<class,경원선,응봉,1057,1037,2094
<class,경원선,왕십리,10376,10907,21283
<class,경원선,청량리,14367,13090,27457
<class,경원선,외대앞,9423,8549,17972
<class,경원선,신이문,5045,4587,9632
<class,경원선,석계,4990,5620,10610
<class,경원선,광운대,5561,5269,10830
<class,경원선,월계,3691,3362,7053
<class,경원선,녹천,2625,2326,4951
<class,경원선,방학,5703,5620,11323
<class,경원선,도봉,3420,3269,6689
<class,경원선,도봉산,8779,6298,15077
<class,경원선,망월사,4382,4646,9028
<class,경원선,회룡,7436,7318,14754
<class,경원선,의정부,13421,13911,27332
<class,경원선,가능,3850,3699,7549
<class,경원선,녹양,2797,2688,5485
<class,경원선,양주,4945,4838,9783
<class,경원선,덕계,1715,1666,3381
<class,경원선,덕정,3243,3370,6613
<class,경원선,지행,4220,4281,8501
<class,경원선,동두천중앙,2067,1949,4016
<class,경원선,보산,1244,1527,2771
<class,경원선,동두천,1298,1753,3051
<class,경원선,소요산,3862,3219,7081
<class,경의선,서울역,1213,1097,2310
<class,경의선,신촌,348,319,667
<class,경의선,효창공원앞,1229,1431,2660
<class,경의선,공덕,1856,1503,3359
<class,경의선,서강대,1191,1236,2427
<class,경의선,홍대입구,1562,1737,3299
<class,경의선,가좌,2876,2862,5738
<class,경의선,디지털미디어시티,1407,1307,2714
<class,경의선,수색,1010,1059,2069
<class,경의선,화전,798,794,1592
<class,경의선,강매,1517,1395,2912
<class,경의선,행신,4420,4146,8566
<class,경의선,능곡,2110,2111,4221
<class,경의선,곡산,332,361,693
<class,경의선,백마,3453,3270,6723
<class,경의선,풍산,3483,3328,6811
<class,경의선,일산,5634,5434,11068
<class,경의선,탄현,4252,3942,8194
<class,경의선,야당,4452,4332,8784
<class,경의선,운정,3997,3820,7817
<class,경의선,금릉,2835,2732,5567
<class,경의선,금촌,4188,4284,8472
<class,경의선,월롱,940,1832,2772
<class,경의선,파주,626,556,1182
<class,경의선,문산,4313,4383,8696
<class,경의선,임진강,64,61,125
<class,경인선,개봉,11475,11491,22966
<class,경인선,오류동,7011,6675,13686
<class,경인선,역곡,13966,13814,27780
<class,경인선,부천,20628,20278,40906
<class,경인선,송내,12796,12351,25147
<class,경인선,부평,21878,22347,44225
<class,경인선,백운,3774,3825,7599
<class,경인선,동암,9255,9120,18375
<class,경인선,주안,11474,10239,21713
<class,경인선,제물포,5436,5308,10744
<class,경인선,동인천,9333,9036,18369
<class,경인선,인천,3677,2954,6631
<class,경인선,구일,3371,3217,6588
<class,경인선,소사,5551,5418,10969
<class,경인선,부개,4532,4258,8790
<class,경인선,간석,2978,2905,5883
<class,경인선,도원,2662,2701,5363
<class,경인선,온수,3475,3338,6813
<class,경인선,중동,4673,4402,9075
<class,경인선,도화,2268,2167,4435
<class,경춘선,신내,937,935,1872
<class,경춘선,갈매,1530,1297,2827
<class,경춘선,별내,1903,1869,3772
<class,경춘선,퇴계원,2035,1941,3976
<class,경춘선,사릉,1759,1741,3500
<class,경춘선,금곡,929,886,1815
<class,경춘선,평내호평,3443,3263,6706
<class,경춘선,천마산,1084,1030,2114
<class,경춘선,마석,2813,2762,5575
<class,경춘선,대성리,854,432,1286
<class,경춘선,청평,1526,1152,2678
<class,경춘선,상천,313,266,579
<class,경춘선,가평,1713,1341,3054
<class,경춘선,굴봉산,177,141,318
<class,경춘선,백양리,122,94,216
<class,경춘선,강촌,659,414,1073
<class,경춘선,김유정,426,441,867
<class,경춘선,남춘천,2286,2462,4748
<class,수인선,인천논현,3919,4062,7981
<class,1호선,서울역,31225,32456,63681
<class,1호선,동묘앞,10484,10745,21229
<class,1호선,시청,11421,11907,23328
<class,1호선,종각,21022,20033,41055
<class,1호선,종로3가,21094,20515,41609
<class,1호선,종로5가,16749,16773,33522
<class,1호선,동대문,10359,9368,19727
<class,1호선,신설동,9295,8782,18077
<class,1호선,제기동,13940,14133,28073
<class,1호선,청량리,16651,16867,33518
<class,2호선,시청,8868,7748,16616
<class,2호선,을지로입구,22043,21585,43628
<class,2호선,을지로3가,10801,10831,21632
<class,2호선,을지로4가,6737,6977,13714
<class,2호선,동대문역사문화공원,9852,10937,20789
<class,2호선,신당,10374,10974,21348
<class,2호선,상왕십리,9526,8728,18254
<class,2호선,왕십리,13056,11386,24442
<class,2호선,한양대,4985,5157,10142
<class,2호선,뚝섬,14051,13943,27994
<class,2호선,성수,17791,19903,37694
<class,2호선,건대입구,31462,34816,66278
<class,2호선,구의,15882,15457,31339
<class,2호선,강변,25170,24965,50135
<class,2호선,잠실나루,7001,6766,13767
<class,2호선,잠실,59837,57205,117042
<class,2호선,잠실새내,15481,16299,31780
<class,2호선,종합운동장,4491,4970,9461
<class,2호선,삼성,28058,28277,56335
<class,2호선,선릉,24113,21141,45254
<class,2호선,역삼,18463,20148,38611
<class,2호선,강남,58404,60898,119302
<class,2호선,교대,16999,19050,36049
<class,2호선,서초,10097,8664,18761
<class,2호선,방배,9784,10081,19865
<class,2호선,사당,30324,33482,63806
<class,2호선,낙성대,19995,18336,38331
<class,2호선,서울대입구,36092,34443,70535
<class,2호선,봉천,16675,14936,31611
<class,2호선,신림,48772,46136,94908
<class,2호선,신대방,19112,18191,37303
<class,2호선,구로디지털단지,33488,32550,66038
<class,2호선,대림,16528,17527,34055
<class,2호선,신도림,38708,39086,77794
<class,2호선,문래,12130,12698,24828
<class,2호선,영등포구청,13002,13324,26326
<class,2호선,당산,12169,13113,25282
<class,2호선,합정,26974,30580,57554
<class,2호선,홍대입구,56846,63681,120527
<class,2호선,신촌,28419,28973,57392
<class,2호선,이대,9797,10033,19830
<class,2호선,아현,7013,6610,13623
<class,2호선,충정로,5730,6114,11844
<class,2호선,용답,1979,1873,3852
<class,2호선,신답,947,968,1915
<class,2호선,신설동,3102,3134,6236
<class,2호선,도림천,752,768,1520
<class,2호선,양천구청,4500,4450,8950
<class,2호선,신정네거리,7197,7215,14412
<class,2호선,용두,1614,1571,3185
<class,3호선,지축,3004,2765,5769
<class,3호선,구파발,13833,13778,27611
<class,3호선,연신내,27561,25725,53286
<class,3호선,불광,12197,13497,25694
<class,3호선,녹번,10119,8716,18835
<class,3호선,홍제,12272,11469,23741
<class,3호선,무악재,2682,2735,5417
<class,3호선,독립문,5077,5346,10423
<class,3호선,경복궁,15002,15882,30884
<class,3호선,안국,14448,15973,30421
<class,3호선,종로3가,5254,7549,12803
<class,3호선,을지로3가,5057,5467,10524
<class,3호선,동대입구,6513,7266,13779
<class,3호선,약수,8632,8119,16751
<class,3호선,금호,5546,4980,10526
<class,3호선,옥수,6722,6834,13556
<class,3호선,압구정,24347,25772,50119
<class,3호선,신사,24265,26266,50531
<class,3호선,잠원,3238,3006,6244
<class,3호선,고속터미널,45930,46474,92404
<class,3호선,교대,6773,4214,10987
<class,3호선,남부터미널,20497,20402,40899
<class,3호선,양재,21650,23072,44722
<class,3호선,매봉,5702,5544,11246
<class,3호선,도곡,3234,2989,6223
<class,3호선,대치,7535,6931,14466
<class,3호선,학여울,3879,4314,8193
<class,3호선,대청,5893,5312,11205
<class,3호선,일원,4599,4418,9017
<class,3호선,수서,13324,13003,26327
<class,3호선,가락시장,5897,5676,11573
<class,3호선,경찰병원,3870,3665,7535
<class,3호선,오금,3617,3262,6879
<class,4호선,수유,25477,25166,50643
<class,4호선,미아,10380,9763,20143
<class,4호선,미아사거리,21089,19717,40806
<class,4호선,길음,13714,12909,26623
<class,4호선,성신여대입구,15640,15125,30765
<class,4호선,한성대입구,10257,9893,20150
<class,4호선,혜화,26167,27535,53702
<class,4호선,동대문,13050,13209,26259
<class,4호선,동대문역사문화공원,11155,9618,20773
<class,4호선,충무로,12409,13361,25770
<class,4호선,명동,15649,17835,33484
<class,4호선,회현,17516,18920,36436
<class,4호선,서울역,5209,13037,18246
<class,4호선,숙대입구,8531,8179,16710
<class,4호선,삼각지,3460,4572,8032
<class,4호선,신용산,10412,11204,21616
<class,4호선,이촌,5647,6147,11794
<class,4호선,동작,1154,1221,2375
<class,4호선,총신대입구,13524,14789,28313
<class,4호선,사당,20296,18211,38507
<class,4호선,남태령,1098,685,1783
<class,4호선,당고개,9516,8908,18424
<class,4호선,상계,13338,12253,25591
<class,4호선,노원,14789,16879,31668
<class,4호선,창동,18277,19429,37706
<class,4호선,쌍문,20550,18025,38575
<class,5호선,방화,4533,4338,8871
<class,5호선,개화산,3672,3414,7086
<class,5호선,김포공항,7021,6986,14007
<class,5호선,송정,4749,4633,9382
<class,5호선,마곡,5241,5159,10400
<class,5호선,발산,13612,14759,28371
<class,5호선,우장산,9431,9121,18552
<class,5호선,화곡,19513,17566,37079
<class,5호선,까치산,20398,19100,39498
<class,5호선,신정,8737,7288,16025
<class,5호선,목동,10847,11073,21920
<class,5호선,오목교,15174,15943,31117
<class,5호선,양평,3556,3384,6940
<class,5호선,영등포구청,1900,1872,3772
<class,5호선,영등포시장,7955,8208,16163
<class,5호선,신길,2449,2533,4982
<class,5호선,여의도,10238,11011,21249
<class,5호선,여의나루,5613,6724,12337
<class,5호선,마포,7146,7498,14644
<class,5호선,공덕,6970,7120,14090
<class,5호선,애오개,3738,3478,7216
<class,5호선,충정로,1813,1646,3459
<class,5호선,서대문,7032,6724,13756
<class,5호선,광화문,15754,16655,32409
<class,5호선,종로3가,11360,12100,23460
<class,5호선,을지로4가,3097,3434,6531
<class,5호선,동대문역사문화공원,971,1303,2274
<class,5호선,청구,2435,2246,4681
<class,5호선,신금호,4039,4060,8099
<class,5호선,행당,5141,4437,9578
<class,5호선,왕십리,3386,4115,7501
<class,5호선,마장,3953,3796,7749
<class,5호선,답십리,9868,8841,18709
<class,5호선,장한평,11036,10856,21892
<class,5호선,군자,8164,8899,17063
<class,5호선,아차산,11889,11285,23174
<class,5호선,광나루,9432,8670,18102
<class,5호선,천호,16171,15561,31732
<class,5호선,강동,12957,12147,25104
<class,5호선,길동,5689,5902,11591
<class,5호선,굽은다리,6847,6379,13226
<class,5호선,명일,5842,5748,11590
<class,5호선,고덕,5998,5679,11677
<class,5호선,상일동,9322,8379,17701
<class,5호선,둔촌동,6080,5989,12069
<class,5호선,올림픽공원,3025,2600,5625
<class,5호선,방이,5067,4907,9974
<class,5호선,오금,2003,1888,3891
<class,5호선,개롱,4411,4469,8880
<class,5호선,거여,5775,5404,11179
<class,5호선,마천,4557,4692,9249
<class,5호선,강일,2484,2313,4797
<class,5호선,미사,11419,11259,22678
<class,5호선,하남풍산,2623,2599,5222
<class,5호선,하남시청,5081,4878,9959
<class,5호선,하남검단산,4651,4647,9298
<class,6호선,응암,12138,11748,23886
<class,6호선,역촌,2746,3092,5838
<class,6호선,불광,3419,3089,6508
<class,6호선,독바위,1899,2202,4101
<class,6호선,연신내,1,0,1
<class,6호선,구산,5234,3900,9134
<class,6호선,새절,8278,7614,15892
<class,6호선,증산,7103,6885,13988
<class,6호선,디지털미디어시티,6946,6899,13845
<class,6호선,월드컵경기장,3228,3560,6788
<class,6호선,마포구청,9143,7905,17048
<class,6호선,망원,11859,13131,24990
<class,6호선,합정,11956,11412,23368
<class,6호선,상수,7984,10025,18009
<class,6호선,광흥창,4966,4641,9607
<class,6호선,대흥,5231,5080,10311
<class,6호선,공덕,9828,9319,19147
<class,6호선,효창공원앞,4273,3934,8207
<class,6호선,삼각지,5348,4290,9638
<class,6호선,녹사평,4269,4916,9185
<class,6호선,이태원,10830,13917,24747
<class,6호선,한강진,9137,10977,20114
<class,6호선,버티고개,1280,1359,2639
<class,6호선,약수,2370,2315,4685
<class,6호선,청구,2315,2244,4559
<class,6호선,신당,6775,5481,12256
<class,6호선,동묘앞,7421,6833,14254
<class,6호선,창신,2046,1669,3715
<class,6호선,보문,4845,4395,9240
<class,6호선,안암,6526,6180,12706
<class,6호선,고려대,5123,4745,9868
<class,6호선,월곡,7127,6930,14057
<class,6호선,상월곡,3886,3327,7213
<class,6호선,돌곶이,5893,5254,11147
<class,6호선,석계,8530,8506,17036
<class,6호선,태릉입구,3953,4209,8162
<class,6호선,화랑대,7053,5551,12604
<class,6호선,봉화산,5074,4760,9834
<class,7호선,장암,1571,1063,2634
<class,7호선,도봉산,6020,8109,14129
<class,7호선,수락산,9374,9114,18488
<class,7호선,마들,8593,7887,16480
<class,7호선,노원,14687,15287,29974
<class,7호선,중계,8899,7747,16646
<class,7호선,하계,11568,10651,22219
<class,7호선,공릉,8344,8243,16587
<class,7호선,태릉입구,6353,5699,12052
<class,7호선,먹골,7701,7311,15012
<class,7호선,중화,7311,7015,14326
<class,7호선,상봉,12806,12051,24857
<class,7호선,면목,11187,10616,21803
<class,7호선,사가정,11933,11544,23477
<class,7호선,용마산,4199,4109,8308
<class,7호선,중곡,6750,6282,13032
<class,7호선,군자,10116,7665,17781
<class,7호선,어린이대공원,8423,8226,16649
<class,7호선,건대입구,10011,10577,20588
<class,7호선,뚝섬유원지,5889,5528,11417
<class,7호선,청담,11051,12088,23139
<class,7호선,강남구청,9916,11035,20951
<class,7호선,학동,10991,11706,22697
<class,7호선,논현,10859,12234,23093
<class,7호선,반포,4255,3841,8096
<class,7호선,고속터미널,13522,10773,24295
<class,7호선,내방,7508,7349,14857
<class,7호선,이수,11783,11016,22799
<class,7호선,남성,7405,6771,14176
<class,7호선,숭실대입구,7722,7556,15278
<class,7호선,상도,7185,6541,13726
<class,7호선,장승배기,6366,6032,12398
<class,7호선,신대방삼거리,11040,10067,21107
<class,7호선,보라매,6251,5999,12250
<class,7호선,신풍,7669,7288,14957
<class,7호선,대림,6603,7060,13663
<class,7호선,남구로,7893,8255,16148
<class,7호선,가산디지털단지,14861,13409,28270
<class,7호선,철산,14467,14702,29169
<class,7호선,광명사거리,16369,16418,32787
<class,7호선,천왕,6694,6150,12844
<class,7호선,온수,5378,5375,10753
<class,7호선,까치울,5152,5183,10335
<class,7호선,부천종합운동장,3196,2857,6053
<class,7호선,춘의,5025,4763,9788
<class,7호선,신중동,9371,9531,18902
<class,7호선,부천시청,9367,9239,18606
<class,7호선,상동,10269,10495,20764
<class,7호선,삼산체육관,3339,3139,6478
<class,7호선,굴포천,6492,6575,13067
<class,7호선,부평구청,4811,4097,8908
<class,8호선,암사,12132,10952,23084
<class,8호선,천호,11804,14195,25999
<class,8호선,강동구청,6102,6159,12261
<class,8호선,몽촌토성,4321,4167,8488
<class,8호선,잠실,11992,14442,26434
<class,8호선,석촌,5912,6818,12730
<class,8호선,송파,4857,4870,9727
<class,8호선,가락시장,5360,5619,10979
<class,8호선,문정,9062,9188,18250
<class,8호선,장지,11941,11011,22952
<class,8호선,복정,7286,6182,13468
<class,8호선,산성,4246,4235,8481
<class,8호선,남한산성입구,9060,7991,17051
<class,8호선,단대오거리,7491,6918,14409
<class,8호선,신흥,3535,3801,7336
<class,8호선,수진,4195,3653,7848
<class,8호선,모란,4954,4257,9211
<class,9호선,개화,1354,1161,2515
<class,9호선,김포공항,7328,11766,19094
<class,9호선,공항시장,2221,2230,4451
<class,9호선,신방화,4516,4297,8813
<class,9호선,마곡나루,7670,7414,15084
<class,9호선,양천향교,5807,5441,11248
<class,9호선,가양,13667,12656,26323
<class,9호선,증미,3897,3722,7619
<class,9호선,등촌,7153,6794,13947
<class,9호선,염창,11395,10364,21759
<class,9호선,신목동,2240,1901,4141
<class,9호선,선유도,3716,3599,7315
<class,9호선,당산,12329,11605,23934
<class,9호선,국회의사당,4909,4954,9863
<class,9호선,여의도,10925,10348,21273
<class,9호선,샛강,2476,2689,5165
<class,9호선,노량진,20002,19401,39403
<class,9호선,노들,3124,2562,5686
<class,9호선,흑석,5617,5569,11186
<class,9호선,동작,1361,1153,2514
<class,9호선,구반포,1238,1330,2568
<class,9호선,신반포,2554,2416,4970
<class,9호선,고속터미널,11578,16928,28506
<class,9호선,사평,2005,1862,3867
<class,9호선,신논현,24924,25870,50794
<class,9호선2~3단계,언주,6377,6335,12712
<class,9호선2~3단계,선정릉,4599,5056,9655
<class,9호선2~3단계,삼성중앙,2940,3035,5975
<class,9호선2~3단계,봉은사,10496,11011,21507
<class,9호선2~3단계,종합운동장,2939,2653,5592
<class,9호선2~3단계,삼전,4768,4338,9106
<class,9호선2~3단계,석촌고분,4144,3972,8116
<class,9호선2~3단계,석촌,6414,5348,11762
<class,9호선2~3단계,송파나루,4026,4410,8436
<class,9호선2~3단계,한성백제,1711,1440,3151
<class,9호선2~3단계,올림픽공원,6064,5895,11959
<class,9호선2~3단계,둔촌오륜,633,621,1254
<class,9호선2~3단계,중앙보훈병원,4439,4051,8490
<class,경강선,판교,2917,2863,5780
<class,경강선,이매,794,580,1374
<class,경강선,삼동,1448,1349,2797
<class,경강선,경기광주,5148,4729,9877
<class,경강선,초월,2165,1996,4161
<class,경강선,곤지암,1796,1805,3601
<class,경강선,신둔도예촌,1074,1000,2074
<class,경강선,이천,2647,2693,5340
<class,경강선,부발,1857,1570,3427
<class,경강선,세종대왕릉,236,306,542
<class,경강선,여주,2046,2354,4400
<class,경부선,서울역,6703,1931,8634
<class,경부선,남영,5361,5438,10799
<class,경부선,용산,34080,36549,70629
<class,경부선,노량진,7826,7355,15181
<class,경부선,대방,7842,7884,15726
<class,경부선,영등포,39042,40854,79896
<class,경부선,신도림,2758,2926,5684
<class,경부선,신길,5754,4704,10458
<class,경부선,구로,12969,13695,26664
<class,경부선,가산디지털단지,6270,8270,14540
<class,경부선,금천구청,8204,8125,16329
<class,경부선,석수,6586,6152,12738
<class,경부선,관악,5949,5551,11500
<class,경부선,안양,17775,17633,35408
<class,경부선,명학,5116,4967,10083
<class,경부선,금정,18335,18236,36571
<class,경부선,군포,4338,3954,8292
<class,경부선,의왕,5887,5564,11451
<class,경부선,성균관대,9492,9496,18988
<class,경부선,화서,5291,5212,10503
<class,경부선,수원,34867,38020,72887
<class,경부선,독산,8635,8377,17012
<class,경부선,세류,2517,2466,4983
<class,경부선,병점,11719,11317,23036
<class,경부선,세마,2068,1879,3947
<class,경부선,오산대,2628,2328,4956
<class,경부선,오산,8987,8252,17239
<class,경부선,진위,967,849,1816
<class,경부선,송탄,4712,4087,8799
<class,경부선,서정리,6780,5382,12162
<class,경부선,평택지제,3106,2900,6006
<class,경부선,평택,12773,12432,25205
<class,경부선,성환,2819,2490,5309
<class,경부선,직산,631,592,1223
<class,경부선,두정,4730,4836,9566
<class,경부선,천안,5610,5794,11404
<class,경부선,당정,3916,3664,7580
<class,경부선,서동탄,1009,1009,2018
<class,경부선,광명,2827,2506,5333
<class,경원선,이촌,2692,1948,4640
<class,경원선,서빙고,1504,1588,3092
<class,경원선,한남,2660,2661,5321
<class,경원선,옥수,34,47,81
<class,경원선,응봉,1334,1077,2411
<class,경원선,왕십리,11813,13280,25093
<class,경원선,청량리,14650,15963,30613
<class,경원선,외대앞,6057,5827,11884
<class,경원선,신이문,5908,5308,11216
<class,경원선,석계,6505,6971,13476
<class,경원선,광운대,5641,5575,11216
<class,경원선,월계,4587,4202,8789
<class,경원선,녹천,3148,2651,5799
<class,경원선,방학,7011,6754,13765
<class,경원선,도봉,4331,4150,8481
<class,경원선,도봉산,8282,5532,13814
<class,경원선,망월사,5412,5524,10936
<class,경원선,회룡,9347,9075,18422
<class,경원선,의정부,16744,17814,34558
<class,경원선,가능,4731,4540,9271
<class,경원선,녹양,3365,3158,6523
<class,경원선,양주,6042,5570,11612
<class,경원선,덕계,2277,2063,4340
<class,경원선,덕정,4322,3867,8189
<class,경원선,지행,5229,5189,10418
<class,경원선,동두천중앙,2415,2403,4818
<class,경원선,보산,1622,1578,3200
<class,경원선,동두천,1555,1833,3388
<class,경원선,소요산,3016,2658,5674
<class,경의선,서울역,1229,1459,2688
<class,경의선,신촌,344,366,710
<class,경의선,효창공원앞,1673,1784,3457
<class,경의선,공덕,2622,2027,4649
<class,경의선,서강대,1691,1658,3349
<class,경의선,홍대입구,1659,2150,3809
<class,경의선,가좌,3746,3503,7249
<class,경의선,디지털미디어시티,1827,1626,3453
<class,경의선,수색,1366,1352,2718
<class,경의선,화전,1070,960,2030
<class,경의선,강매,1949,1851,3800
<class,경의선,행신,5024,5099,10123
<class,경의선,능곡,2623,2598,5221
<class,경의선,곡산,382,385,767
<class,경의선,백마,4174,3893,8067
<class,경의선,풍산,4234,3972,8206
<class,경의선,일산,5989,5637,11626
<class,경의선,탄현,5153,4822,9975
<class,경의선,야당,5504,5496,11000
<class,경의선,운정,4877,4438,9315
<class,경의선,금릉,3724,3467,7191
<class,경의선,금촌,5380,4940,10320
<class,경의선,월롱,1435,1257,2692
<class,경의선,파주,798,585,1383
<class,경의선,문산,4361,4335,8696
<class,경의선,임진강,29,32,61
<class,경인선,개봉,15494,14987,30481
<class,경인선,오류동,8825,7924,16749
<class,경인선,역곡,19102,18757,37859
<class,경인선,부천,27418,28548,55966
<class,경인선,송내,17455,16827,34282
<class,경인선,부평,26301,29525,55826
<class,경인선,백운,5036,4884,9920
<class,경인선,동암,11590,11885,23475
<class,경인선,주안,15013,12960,27973
<class,경인선,제물포,7032,6464,13496
<class,경인선,동인천,10573,10468,21041
<class,경인선,인천,3427,2798,6225
<class,경인선,구일,5958,5865,11823
<class,경인선,소사,7396,4702,12098
<class,경인선,부개,6033,5541,11574
<class,경인선,간석,4075,3965,8040
<class,경인선,도원,1766,1867,3633
<class,경인선,온수,4642,4198,8840
<class,경인선,중동,6336,6022,12358
<class,경인선,도화,2898,2705,5603
<class,경춘선,신내,1147,1066,2213
<class,경춘선,갈매,1901,1649,3550
<class,경춘선,별내,2292,2207,4499
<class,경춘선,퇴계원,2472,2143,4615
<class,경춘선,사릉,2109,2008,4117
<class,경춘선,금곡,1037,939,1976
<class,경춘선,평내호평,4256,4119,8375
<class,경춘선,천마산,1281,1224,2505
<class,경춘선,마석,2871,2771,5642
<class,경춘선,대성리,529,570,1099
<class,경춘선,청평,1352,1527,2879
<class,경춘선,상천,233,232,465
<class,경춘선,가평,1294,1623,2917
<class,경춘선,굴봉산,129,149,278
<class,경춘선,백양리,161,173,334
<class,경춘선,강촌,395,493,888
<class,경춘선,김유정,307,297,604
<class,경춘선,남춘천,2088,2241,4329
<class,경춘선,춘천,1325,1154,2479
<class,공항철도 1호선,서울역,7393,7614,15007
<class,공항철도 1호선,공덕,1515,2365,3880
<class,공항철도 1호선,홍대입구,10624,11214,21838
<class,공항철도 1호선,디지털미디어시티,5067,4864,9931
<class,공항철도 1호선,마곡나루,2937,3145,6082
<class,공항철도 1호선,김포공항,10765,5717,16482
<class,공항철도 1호선,계양,6779,6165,12944
<class,공항철도 1호선,검암,4378,4260,8638
<class,공항철도 1호선,청라국제도시,4008,3736,7744
<class,공항철도 1호선,운서,5547,5596,11143
<class,공항철도 1호선,공항화물청사,1293,1353,2646
<class,공항철도 1호선,인천공항1터미널,3460,3270,6730
<class,공항철도 1호선,인천공항2터미널,1999,1684,3683
<class,공항철도 1호선,영종,2640,2594,5234
<class,과천선,선바위,4996,4368,9364
<class,과천선,경마공원,6745,6708,13453
<class,과천선,대공원,3267,3514,6781
<class,과천선,과천,4148,3725,7873
<class,과천선,정부과천청사,5971,5778,11749
<class,과천선,인덕원,15894,15579,31473
<class,과천선,평촌,9007,8757,17764
<class,과천선,범계,19183,18982,38165
<class,분당선,선릉,5251,8172,13423
<class,분당선,한티,10047,10048,20095
<class,분당선,도곡,4372,4084,8456
<class,분당선,구룡,1638,1545,3183
<class,분당선,개포동,2504,2515,5019
<class,분당선,대모산입구,2908,2595,5503
<class,분당선,수서,10270,10508,20778
<class,분당선,복정,1,0,1
<class,분당선,수원,7314,6087,13401
<class,분당선,서울숲,7865,8383,16248
<class,분당선,압구정로데오,16779,20670,37449
<class,분당선,강남구청,5667,6876,12543
<class,분당선,선정릉,3321,3444,6765
<class,분당선,가천대,5202,5664,10866
<class,분당선,태평,10564,9757,20321
<class,분당선,모란,20465,21192,41657
<class,분당선,야탑,17949,18823,36772
<class,분당선,서현,18263,18419,36682
<class,분당선,수내,8633,8035,16668
<class,분당선,정자,10210,10453,20663
<class,분당선,미금,10479,10814,21293
<class,분당선,오리,7700,6357,14057
<class,분당선,이매,4110,4058,8168
<class,분당선,보정,1469,1429,2898
<class,분당선,죽전,9768,10929,20697
<class,분당선,구성,3233,3265,6498
<class,분당선,신갈,2745,2707,5452
<class,분당선,기흥,6445,6089,12534
<class,분당선,상갈,3640,3542,7182
<class,분당선,청명,2635,2588,5223
<class,분당선,영통,6727,6578,13305
<class,분당선,망포,9391,8304,17695
<class,분당선,매탄권선,3459,3186,6645
<class,분당선,수원시청,10935,12733,23668
<class,분당선,매교,1959,2062,4021
<class,수인선,고색,2508,2383,4891
<class,수인선,오목천,2137,1752,3889
<class,수인선,어천,713,583,1296
<class,수인선,야목,243,224,467
<class,수인선,사리,3255,2703,5958
<class,수인선,달월,55,63,118
<class,수인선,월곶,2019,1910,3929
<class,수인선,소래포구,4818,5025,9843
<class,수인선,호구포,2420,2269,4689
<class,수인선,남동인더스파크,912,830,1742
<class,수인선,원인재,3475,3555,7030
<class,수인선,연수,3486,3593,7079
<class,수인선,송도,1808,1758,3566
<class,수인선,인하대,4812,4057,8869
<class,수인선,숭의,2547,2374,4921
<class,수인선,신포,1298,1361,2659
<class,수인선,인천,943,1538,2481
<class,안산선,산본,11873,10656,22529
<class,안산선,대야미,3789,3213,7002
<class,안산선,반월,3262,2951,6213
<class,안산선,상록수,12071,12057,24128
<class,안산선,한대앞,7050,6943,13993
<class,안산선,중앙,14842,15722,30564
<class,안산선,고잔,6294,6193,12487
<class,안산선,초지,3232,3163,6395
<class,안산선,안산,8812,9064,17876
<class,안산선,신길온천,1401,1312,2713
<class,안산선,정왕,6356,6433,12789
<class,안산선,오이도,6855,6989,13844
<class,안산선,수리산,2794,2356,5150
<class,우이신설선,북한산우이,3495,3568,7063
<class,우이신설선,솔밭공원,1686,1464,3150
<class,우이신설선,4.19민주묘지,2167,1903,4070
<class,우이신설선,가오리,2766,2638,5404
<class,우이신설선,화계,2385,2223,4608
<class,우이신설선,삼양,1546,1563,3109
<class,우이신설선,삼양사거리,1855,1801,3656
<class,우이신설선,솔샘,3660,3219,6879
<class,우이신설선,북한산보국문,4503,3874,8377
<class,우이신설선,정릉,3457,2761,6218
<class,우이신설선,성신여대입구,2600,3050,5650
<class,우이신설선,보문,1059,1007,2066
<class,우이신설선,신설동,1408,1262,2670
<class,일산선,원흥,7435,6910,14345
<class,일산선,삼송,13464,12977,26441
<class,일산선,원당,8086,7553,15639
<class,일산선,화정,12226,12644,24870
<class,일산선,대곡,1243,1043,2286
<class,일산선,백석,7214,7310,14524
<class,일산선,마두,4746,4694,9440
<class,일산선,정발산,6305,6617,12922
<class,일산선,주엽,6161,6042,12203
<class,일산선,대화,10106,9141,19247
<class,장항선,봉명,706,644,1350
<class,장항선,쌍용,1571,1476,3047
<class,장항선,아산,2686,2764,5450
<class,장항선,탕정,387,335,722
<class,장항선,배방,967,958,1925
<class,장항선,온양온천,4283,4257,8540
<class,장항선,신창,1022,960,1982
<class,중앙선,회기,19937,18671,38608
<class,중앙선,중랑,4333,4038,8371
<class,중앙선,상봉,4660,4549,9209
<class,중앙선,망우,5991,5873,11864
<class,중앙선,양원,1285,1230,2515
<class,중앙선,구리,9917,10263,20180
<class,중앙선,도농,6923,6458,13381
<class,중앙선,양정,504,449,953
<class,중앙선,덕소,4255,4200,8455
<class,중앙선,도심,1486,1178,2664
<class,중앙선,팔당,980,1044,2024
<class,중앙선,운길산,792,803,1595
<class,중앙선,양수,1602,1693,3295
<class,중앙선,신원,175,150,325
<class,중앙선,국수,534,578,1112
<class,중앙선,아신,517,497,1014
<class,중앙선,오빈,236,256,492
<class,중앙선,양평,2180,2374,4554
<class,중앙선,원덕,303,311,614
<class,중앙선,용문,1440,1736,3176
<class,중앙선,지평,30,52,82
<class,2호선,홍대입구,42958,42457,85415
<class,2호선,신촌,20508,19859,40367
<class,2호선,이대,6571,6978,13549
<class,2호선,아현,4917,4896,9813
<class,2호선,충정로,3661,3842,7503
<class,과천선,선바위,3676,3324,7000
<class,1호선,시청,7976,7531,15507
<class,수인선,인천논현,2614,2710,5324
<class,수인선,호구포,1860,1980,3840
<class,수인선,남동인더스파크,516,538,1054
<class,수인선,원인재,2618,2721,5339
<class,수인선,연수,2769,2726,5495
<class,수인선,송도,1431,1413,2844
<class,수인선,인하대,4577,3603,8180
<class,수인선,숭의,1828,1624,3452
<class,수인선,신포,1052,1035,2087
<class,수인선,인천,860,1272,2132
<class,안산선,산본,8127,8831,16958
<class,안산선,대야미,2765,2484,5249
<class,안산선,반월,2393,2362,4755
<class,안산선,상록수,8731,8473,17204
<class,안산선,한대앞,5011,5050,10061
<class,3호선,종로3가,3352,4422,7774
<class,3호선,안국,9626,10524,20150
<class,3호선,경복궁,10751,11296,22047
<class,3호선,독립문,3752,4117,7869
<class,3호선,무악재,1706,1766,3472
<class,3호선,홍제,8515,8003,16518
<class,3호선,녹번,6927,6297,13224
<class,3호선,불광,8858,10074,18932
<class,3호선,연신내,19747,18667,38414
<class,3호선,구파발,10455,10529,20984
<class,3호선,지축,2039,1867,3906
<class,2호선,용두,1168,1161,2329
<class,2호선,신정네거리,4812,4841,9653
<class,2호선,양천구청,3153,3165,6318
<class,2호선,도림천,426,458,884
<class,2호선,신설동,2852,2940,5792
<class,2호선,신답,707,751,1458
<class,2호선,용답,1536,1583,3119
<class,안산선,중앙,11116,11049,22165
<class,안산선,고잔,4299,4104,8403
<class,안산선,초지,2217,2199,4416
<class,안산선,안산,8551,8084,16635
<class,안산선,신길온천,1063,986,2049
<class,안산선,정왕,4899,5378,10277
<class,안산선,오이도,5398,5201,10599
<class,2호선,건대입구,23408,24585,47993
<class,2호선,구의,10627,10605,21232
<class,2호선,강변,19483,18968,38451
<class,2호선,잠실나루,4680,4737,9417
<class,2호선,잠실,43381,40487,83868
<class,2호선,잠실새내,9764,10202,19966
<class,2호선,종합운동장,3537,4203,7740
<class,2호선,삼성,20147,19461,39608
<class,2호선,선릉,12601,10905,23506
<class,2호선,역삼,10857,11869,22726
<class,2호선,강남,32171,31549,63720
<class,2호선,교대,9664,10657,20321
<class,2호선,서초,10298,9554,19852
<class,2호선,방배,6324,6822,13146
<class,2호선,사당,20059,22629,42688
<class,2호선,낙성대,14572,14853,29425
<class,2호선,서울대입구,25432,26077,51509
<class,중앙선,지평,48,30,78
<class,중앙선,용문,3082,2752,5834
<class,중앙선,원덕,300,252,552
<class,중앙선,양평,1941,1788,3729
<class,중앙선,오빈,207,176,383
<class,중앙선,아신,431,449,880
<class,중앙선,국수,475,440,915
<class,중앙선,신원,200,145,345
<class,중앙선,양수,1383,1283,2666
<class,중앙선,운길산,952,850,1802
<class,중앙선,팔당,1239,1316,2555
<class,중앙선,도심,1085,962,2047
<class,중앙선,덕소,3153,3210,6363
<class,중앙선,양정,399,326,725
<class,중앙선,도농,4898,4740,9638
<class,중앙선,구리,7114,7373,14487
<class,중앙선,양원,1004,958,1962
<class,중앙선,망우,4724,4811,9535
<class,중앙선,상봉,3560,3590,7150
<class,중앙선,중랑,3146,3026,6172
<class,중앙선,회기,14582,14507,29089
<class,장항선,신창,807,1190,1997
<class,장항선,온양온천,2987,2996,5983
<class,장항선,배방,686,762,1448
<class,장항선,탕정,257,293,550
<class,장항선,아산,3080,2064,5144
<class,장항선,쌍용,1101,1135,2236
<class,장항선,봉명,495,476,971
<class,일산선,대화,7164,6837,14001
<class,일산선,주엽,4161,4104,8265
<class,일산선,정발산,4607,4624,9231
<class,일산선,마두,3189,3180,6369
<class,일산선,백석,5186,5109,10295
<class,일산선,대곡,945,827,1772
<class,일산선,화정,8926,9167,18093
<class,일산선,원당,5722,5422,11144
<class,일산선,삼송,9742,9697,19439
<class,일산선,원흥,5412,5182,10594
<class,우이신설선,신설동,1130,1147,2277
<class,우이신설선,보문,927,921,1848
<class,우이신설선,성신여대입구,1925,2298,4223
<class,우이신설선,정릉,2506,2187,4693
<class,우이신설선,북한산보국문,3331,2971,6302
<class,우이신설선,솔샘,2695,2525,5220
<class,우이신설선,삼양사거리,1474,1409,2883
<class,우이신설선,삼양,1137,1132,2269
<class,우이신설선,화계,2037,1917,3954
<class,우이신설선,가오리,2241,2077,4318
<class,우이신설선,4.19민주묘지,1882,1609,3491
<class,우이신설선,솔밭공원,1293,1277,2570
<class,우이신설선,북한산우이,2831,2897,5728
<class,안산선,수리산,1938,2017,3955
<class,2호선,봉천,11403,11036,22439
<class,2호선,신림,34547,34211,68758
<class,2호선,신대방,14025,13834,27859
<class,2호선,구로디지털단지,22857,22499,45356
<class,2호선,대림,13533,13617,27150
<class,2호선,신도림,26845,27166,54011
<class,2호선,문래,7785,8213,15998
<class,3호선,을지로3가,2979,2954,5933
<class,2호선,영등포구청,8652,8887,17539
<class,3호선,충무로,1,0,1
<class,3호선,동대입구,4356,4855,9211
<class,3호선,약수,6112,5905,12017
<class,3호선,금호,3883,3721,7604
<class,3호선,옥수,4435,4795,9230
<class,3호선,압구정,13246,14004,27250
<class,3호선,신사,13002,13392,26394
<class,3호선,잠원,2147,2108,4255
<class,3호선,고속터미널,36794,35346,72140
<class,3호선,교대,3922,2340,6262
<class,3호선,남부터미널,13651,14440,28091
<class,3호선,양재,13927,15816,29743
<class,3호선,매봉,3914,3818,7732
<class,3호선,도곡,1958,2143,4101
<class,3호선,대치,4207,4055,8262
<class,3호선,학여울,2806,3144,5950
<class,3호선,대청,3953,3768,7721
<class,3호선,일원,3060,3300,6360
<class,3호선,수서,9844,9640,19484
<class,3호선,가락시장,3502,3764,7266
<class,3호선,경찰병원,2544,2573,5117
<class,3호선,오금,2564,2593,5157
<class,4호선,수유,18918,18280,37198
<class,4호선,미아,7308,7108,14416
<class,4호선,미아사거리,14784,14178,28962
<class,4호선,길음,9351,9113,18464
<class,4호선,성신여대입구,11725,11055,22780
<class,4호선,한성대입구,7174,7286,14460
<class,4호선,혜화,19919,20981,40900
<class,4호선,동대문,6204,6965,13169
<class,4호선,동대문역사문화공원,8326,7959,16285
<class,4호선,충무로,7632,7644,15276
<class,4호선,명동,11705,11939,23644
<class,4호선,회현,8742,8754,17496
<class,4호선,서울역,4088,9483,13571
<class,4호선,숙대입구,6404,6171,12575
<class,4호선,삼각지,2367,3083,5450
<class,4호선,신용산,7723,7739,15462
<class,4호선,이촌,4117,4482,8599
<class,4호선,동작,878,927,1805
<class,4호선,총신대입구,9417,10367,19784
<class,4호선,사당,14223,13321,27544
<class,4호선,남태령,645,486,1131
<class,4호선,당고개,7185,6740,13925
<class,4호선,상계,9697,9025,18722
<class,4호선,노원,10817,11767,22584
<class,4호선,창동,13928,14647,28575
<class,4호선,쌍문,14695,13205,27900
<class,5호선,방화,3353,3312,6665
<class,5호선,개화산,2552,2605,5157
<class,5호선,김포공항,6426,5730,12156
<class,5호선,송정,3448,3396,6844
<class,5호선,마곡,3306,3463,6769
<class,5호선,발산,9209,9861,19070
<class,5호선,우장산,6289,6389,12678
<class,5호선,화곡,13312,12638,25950
<class,5호선,까치산,14755,14462,29217
<class,5호선,신정,5882,5339,11221
<class,5호선,목동,7219,7653,14872
<class,5호선,오목교,10162,10690,20852
<class,5호선,양평,2575,2646,5221
<class,5호선,영등포구청,1259,1232,2491
<class,5호선,영등포시장,5209,5563,10772
<class,5호선,신길,1735,1963,3698
<class,5호선,여의도,7084,7299,14383
<class,5호선,여의나루,5130,5872,11002
<class,5호선,마포,4408,4368,8776
<class,5호선,공덕,4596,4654,9250
<class,5호선,애오개,2502,2606,5108
<class,5호선,충정로,1335,1339,2674
<class,5호선,서대문,4874,4881,9755
<class,5호선,광화문,11556,11947,23503
<class,5호선,종로3가,7796,7112,14908
<class,5호선,을지로4가,1369,1475,2844
<class,5호선,동대문역사문화공원,639,773,1412
<class,5호선,청구,1566,1597,3163
<class,5호선,신금호,2738,2919,5657
<class,5호선,행당,3843,3540,7383
<class,5호선,왕십리,2385,2903,5288
<class,5호선,마장,2925,2761,5686
<class,5호선,답십리,6889,6415,13304
<class,5호선,장한평,7358,7339,14697
<class,5호선,군자,5772,6467,12239
<class,5호선,아차산,9329,9001,18330
<class,5호선,광나루,6861,6716,13577
<class,5호선,천호,11669,11165,22834
<class,5호선,강동,8283,8315,16598
<class,5호선,길동,3723,3850,7573
<class,5호선,굽은다리,5059,4818,9877
<class,5호선,명일,4497,4575,9072
<class,5호선,고덕,3987,4056,8043
<class,5호선,상일동,6304,6168,12472
<class,5호선,둔촌동,4157,4371,8528
<class,5호선,올림픽공원,2138,1946,4084
<class,5호선,방이,3679,3531,7210
<class,5호선,오금,1553,1419,2972
<class,5호선,개롱,2845,3110,5955
<class,5호선,거여,3953,3881,7834
<class,5호선,마천,3473,3712,7185
<class,5호선,강일,1836,1734,3570
<class,5호선,미사,7998,8129,16127
<class,5호선,하남풍산,1834,2058,3892
<class,5호선,하남시청,3438,3302,6740
<class,5호선,하남검단산,4039,3993,8032
<class,6호선,응암,8877,8740,17617
<class,6호선,역촌,1811,2076,3887
<class,6호선,불광,2815,2450,5265
<class,6호선,독바위,1327,1757,3084
<class,6호선,구산,3749,2819,6568
<class,6호선,새절,6040,5821,11861
<class,6호선,증산,5227,5239,10466
<class,6호선,디지털미디어시티,4808,5055,9863
<class,6호선,월드컵경기장,2896,2996,5892
<class,6호선,마포구청,6714,6172,12886
<class,6호선,망원,8439,9129,17568
<class,6호선,합정,8861,8162,17023
<class,6호선,상수,5833,6921,12754
<class,6호선,광흥창,3961,3789,7750
<class,6호선,대흥,3562,3634,7196
<class,6호선,공덕,6661,6432,13093
<class,6호선,효창공원앞,3202,2716,5918
<class,6호선,삼각지,3368,2595,5963
<class,6호선,녹사평,3548,3548,7096
<class,6호선,이태원,8741,7722,16463
<class,6호선,한강진,5943,7037,12980
<class,6호선,버티고개,932,1046,1978
<class,6호선,약수,1493,1509,3002
<class,6호선,청구,1585,1509,3094
<class,6호선,신당,4057,4715,8772
<class,6호선,동묘앞,5637,5604,11241
<class,6호선,창신,1521,1350,2871
<class,6호선,보문,3597,3454,7051
<class,6호선,안암,4480,4909,9389
<class,6호선,고려대,3789,3719,7508
<class,6호선,월곡,5253,5131,10384
<class,6호선,상월곡,2988,2673,5661
<class,6호선,돌곶이,4542,4228,8770
<class,6호선,석계,6128,6310,12438
<class,6호선,태릉입구,2870,3102,5972
<class,6호선,화랑대,5122,4454,9576
<class,6호선,봉화산,3672,3603,7275
<class,6호선,신내,1,0,1
<class,7호선,장암,1248,851,2099
<class,7호선,도봉산,4938,7136,12074
<class,7호선,수락산,7445,7363,14808
<class,7호선,마들,5648,5316,10964
<class,7호선,노원,10243,10310,20553
<class,7호선,중계,6381,5844,12225
<class,7호선,하계,8493,7893,16386
<class,7호선,공릉,6028,6057,12085
<class,7호선,태릉입구,4624,4223,8847
<class,7호선,먹골,5510,5312,10822
<class,7호선,중화,5243,5242,10485
<class,7호선,상봉,9254,8740,17994
<class,7호선,면목,7695,7649,15344
<class,7호선,사가정,8500,8228,16728
<class,7호선,용마산,3240,3440,6680
<class,7호선,중곡,4822,4729,9551
<class,7호선,군자,7100,5769,12869
<class,7호선,어린이대공원,6238,6320,12558
<class,7호선,건대입구,7308,7468,14776
<class,7호선,뚝섬유원지,4488,4235,8723
<class,7호선,청담,6282,7011,13293
<class,7호선,강남구청,5851,6327,12178
<class,7호선,학동,6461,6825,13286
<class,7호선,논현,5709,6239,11948
<class,7호선,반포,2801,2856,5657
<class,7호선,고속터미널,11749,7641,19390
<class,7호선,내방,4765,5057,9822
<class,7호선,이수,8014,7622,15636
<class,7호선,남성,5087,5009,10096
<class,7호선,숭실대입구,5300,5619,10919
<class,7호선,상도,4905,4935,9840
<class,7호선,장승배기,4790,4644,9434
<class,7호선,신대방삼거리,7734,7653,15387
<class,7호선,보라매,4420,4425,8845
<class,7호선,신풍,5670,5334,11004
<class,7호선,대림,6183,5843,12026
<class,7호선,남구로,6087,5959,12046
<class,7호선,가산디지털단지,10543,9756,20299
<class,7호선,철산,9681,9742,19423
<class,7호선,광명사거리,11852,11648,23500
<class,7호선,천왕,4784,4640,9424
<class,7호선,온수,3640,3747,7387
<class,7호선,까치울,3794,3750,7544
<class,7호선,부천종합운동장,2512,2315,4827
<class,7호선,춘의,3312,2955,6267
<class,7호선,신중동,6317,6371,12688
<class,7호선,부천시청,6429,6310,12739
<class,7호선,상동,7018,7054,14072
<class,7호선,삼산체육관,2489,2293,4782
<class,7호선,굴포천,4426,4409,8835
<class,7호선,부평구청,3395,3010,6405
<class,8호선,암사,8455,7890,16345
<class,8호선,천호,8446,9591,18037
<class,8호선,강동구청,4268,4379,8647
<class,8호선,몽촌토성,2981,3056,6037
<class,8호선,잠실,9249,10432,19681
<class,8호선,석촌,3902,4824,8726
<class,8호선,송파,3431,3546,6977
<class,8호선,가락시장,3046,3821,6867
<class,8호선,문정,5493,5943,11436
<class,8호선,장지,8528,8824,17352
<class,8호선,복정,4944,4670,9614
<class,8호선,산성,3067,3214,6281
<class,8호선,남한산성입구,6284,5844,12128
<class,8호선,단대오거리,5163,5039,10202
<class,8호선,신흥,2624,2781,5405
<class,8호선,수진,2750,2505,5255
<class,8호선,모란,2419,2049,4468
<class,9호선,개화,982,940,1922
<class,9호선,김포공항,6862,10315,17177
<class,9호선,공항시장,1735,1867,3602
<class,9호선,신방화,3274,3234,6508
<class,9호선,마곡나루,5319,5466,10785
<class,9호선,양천향교,4024,4301,8325
<class,9호선,가양,9633,9524,19157
<class,9호선,증미,2694,2836,5530
<class,9호선,등촌,4949,4986,9935
<class,9호선,염창,7952,7825,15777
<class,9호선,신목동,1645,1474,3119
<class,9호선,선유도,2630,2607,5237
<class,9호선,당산,8350,8324,16674
<class,9호선,국회의사당,4651,4387,9038
<class,9호선,여의도,7441,6795,14236
<class,9호선,샛강,1464,1598,3062
<class,9호선,노량진,12908,13644,26552
<class,9호선,노들,2361,2106,4467
<class,9호선,흑석,3998,4012,8010
<class,9호선,동작,1029,835,1864
<class,9호선,구반포,681,659,1340
<class,9호선,신반포,1455,1536,2991
<class,9호선,고속터미널,9077,12475,21552
<class,9호선,사평,1376,1431,2807
<class,9호선,신논현,14557,13836,28393
<class,9호선2~3단계,언주,3786,3895,7681
<class,9호선2~3단계,선정릉,2877,3163,6040
<class,9호선2~3단계,삼성중앙,1870,1952,3822
<class,9호선2~3단계,봉은사,7475,7752,15227
<class,9호선2~3단계,종합운동장,2019,1800,3819
<class,9호선2~3단계,삼전,3230,3293,6523
<class,9호선2~3단계,석촌고분,2790,2840,5630
<class,9호선2~3단계,석촌,4513,3744,8257
<class,9호선2~3단계,송파나루,2702,2998,5700
<class,9호선2~3단계,한성백제,1194,1142,2336
<class,9호선2~3단계,올림픽공원,4877,4993,9870
<class,9호선2~3단계,둔촌오륜,398,451,849
<class,9호선2~3단계,중앙보훈병원,3061,2928,5989
<class,경강선,판교,2305,2094,4399
<class,경강선,이매,631,415,1046
<class,경강선,삼동,1020,952,1972
<class,경강선,경기광주,3525,3373,6898
<class,경강선,초월,1487,1495,2982
<class,경강선,곤지암,1393,1538,2931
<class,경강선,신둔도예촌,842,849,1691
<class,경강선,이천,1848,2112,3960
<class,경강선,부발,1224,1930,3154
<class,경강선,세종대왕릉,245,239,484
<class,경강선,여주,1877,1902,3779
<class,경부선,서울역,7671,1567,9238
<class,경부선,남영,4255,4379,8634
<class,경부선,용산,31001,26993,57994
<class,경부선,노량진,5230,4966,10196
<class,경부선,대방,5453,5927,11380
<class,경부선,영등포,30686,29535,60221
<class,경부선,신도림,2074,2167,4241
<class,경부선,신길,4531,3980,8511
<class,경부선,구로,9166,9460,18626
<class,경부선,가산디지털단지,4541,6276,10817
<class,경부선,금천구청,5989,6051,12040
<class,경부선,석수,5044,4809,9853
<class,경부선,관악,4582,4184,8766
<class,경부선,안양,12643,12365,25008
<class,경부선,명학,3308,3153,6461
<class,경부선,금정,12880,13266,26146
<class,경부선,군포,2891,2711,5602
<class,경부선,의왕,3987,4031,8018
<class,경부선,성균관대,6913,7013,13926
<class,경부선,화서,3864,3749,7613
<class,경부선,수원,31007,29138,60145
<class,경부선,독산,5865,5898,11763
<class,경부선,세류,1841,1894,3735
<class,경부선,병점,8598,9334,17932
<class,경부선,세마,1566,1499,3065
<class,경부선,오산대,1885,1893,3778
<class,경부선,오산,7049,7512,14561
<class,경부선,진위,813,835,1648
<class,경부선,송탄,3459,4021,7480
<class,경부선,서정리,4123,5747,9870
<class,경부선,평택지제,2277,2269,4546
<class,경부선,평택,10517,11163,21680
<class,경부선,성환,2192,2717,4909
<class,경부선,직산,528,599,1127
<class,경부선,두정,3828,4308,8136
<class,경부선,천안,5363,5225,10588
<class,경부선,당정,2891,2758,5649
<class,경부선,서동탄,744,774,1518
<class,경부선,광명,2609,1854,4463
<class,경원선,이촌,1953,1564,3517
<class,경원선,서빙고,1177,1282,2459
<class,경원선,한남,1733,1728,3461
<class,경원선,옥수,46,14,60
<class,경원선,응봉,944,880,1824
<class,경원선,왕십리,9025,10285,19310
<class,경원선,청량리,13355,12174,25529
<class,경원선,외대앞,4546,4502,9048
<class,경원선,신이문,4374,4052,8426
<class,경원선,석계,4637,5075,9712
<class,경원선,광운대,3980,4148,8128
<class,경원선,월계,3762,3491,7253
<class,경원선,녹천,2353,2087,4440
<class,경원선,방학,5483,5350,10833
<class,경원선,도봉,3291,3048,6339
<class,경원선,도봉산,8023,5667,13690
<class,경원선,망월사,4150,4261,8411
<class,경원선,회룡,6936,7087,14023
<class,경원선,의정부,12928,13101,26029
<class,경원선,가능,3789,3571,7360
<class,경원선,녹양,2497,2305,4802
<class,경원선,양주,4649,4666,9315
<class,경원선,덕계,1646,1589,3235
<class,경원선,덕정,3112,3221,6333
<class,경원선,지행,3972,4006,7978
<class,경원선,동두천중앙,2124,2081,4205
<class,경원선,보산,1252,1338,2590
<class,경원선,동두천,1221,1519,2740
<class,경원선,소요산,3250,2732,5982
<class,경의선,서울역,1075,956,2031
<class,경의선,신촌,223,245,468
<class,경의선,효창공원앞,1188,1344,2532
<class,경의선,공덕,1872,1424,3296
<class,경의선,서강대,1211,1257,2468
<class,경의선,홍대입구,1486,1806,3292
<class,경의선,가좌,2586,2591,5177
<class,경의선,디지털미디어시티,1298,1233,2531
<class,경의선,수색,851,956,1807
<class,경의선,화전,750,778,1528
<class,경의선,강매,1413,1291,2704
<class,경의선,행신,4210,3896,8106
<class,경의선,능곡,2028,1955,3983
<class,경의선,곡산,316,283,599
<class,경의선,백마,2973,2898,5871
<class,경의선,풍산,3345,3068,6413
<class,경의선,일산,4256,4071,8327
<class,경의선,탄현,3808,3646,7454
<class,경의선,야당,3976,3953,7929
<class,경의선,운정,3352,3308,6660
<class,경의선,금릉,2509,2453,4962
<class,경의선,금촌,3652,3894,7546
<class,경의선,월롱,878,1750,2628
<class,경의선,파주,621,528,1149
<class,경의선,문산,2960,3154,6114
<class,경의선,임진강,33,25,58
<class,경인선,개봉,10845,10817,21662
<class,경인선,오류동,6664,6168,12832
<class,경인선,역곡,13361,13280,26641
<class,경인선,부천,20651,20265,40916
<class,경인선,송내,11928,11833,23761
<class,경인선,부평,19826,20382,40208
<class,경인선,백운,3504,3506,7010
<class,경인선,동암,8712,8631,17343
<class,경인선,주안,10931,9654,20585
<class,경인선,제물포,4957,4955,9912
<class,경인선,동인천,8023,7751,15774
<class,경인선,인천,3058,2393,5451
<class,경인선,구일,2977,2929,5906
<class,경인선,소사,5136,3220,8356
<class,경인선,부개,4380,4161,8541
<class,경인선,간석,2869,2780,5649
<class,경인선,도원,1375,1456,2831
<class,경인선,온수,3441,3181,6622
<class,경인선,중동,4565,4182,8747
<class,경인선,도화,2084,2037,4121
<class,경춘선,신내,826,850,1676
<class,경춘선,갈매,1332,1185,2517
<class,경춘선,별내,1809,1597,3406
<class,경춘선,퇴계원,1937,1720,3657
<class,경춘선,사릉,1528,1534,3062
<class,경춘선,금곡,796,762,1558
<class,경춘선,평내호평,3057,2919,5976
<class,경춘선,천마산,1039,987,2026
<class,경춘선,마석,2227,2189,4416
<class,경춘선,대성리,522,318,840
<class,경춘선,청평,1289,1030,2319
<class,경춘선,상천,307,281,588
<class,경춘선,가평,1528,1058,2586
<class,경춘선,굴봉산,157,172,329
<class,경춘선,백양리,179,161,340
<class,경춘선,강촌,520,358,878
<class,경춘선,김유정,339,308,647
<class,경춘선,남춘천,2019,2172,4191
<class,경춘선,춘천,1146,1220,2366
<class,공항철도 1호선,서울역,7410,6412,13822
<class,공항철도 1호선,공덕,1184,1816,3000
<class,공항철도 1호선,홍대입구,8774,7902,16676
<class,공항철도 1호선,디지털미디어시티,3517,3545,7062
<class,공항철도 1호선,마곡나루,2021,2322,4343
<class,공항철도 1호선,김포공항,10695,5417,16112
<class,공항철도 1호선,계양,4851,4642,9493
<class,공항철도 1호선,검암,3353,3382,6735
<class,공항철도 1호선,청라국제도시,2851,2793,5644
<class,공항철도 1호선,운서,4587,4987,9574
<class,공항철도 1호선,공항화물청사,1029,1098,2127
<class,공항철도 1호선,인천공항1터미널,3364,3256,6620
<class,공항철도 1호선,인천공항2터미널,1858,1680,3538
<class,공항철도 1호선,영종,2187,2105,4292
<class,과천선,경마공원,7446,7488,14934
<class,과천선,대공원,3192,3283,6475
<class,과천선,과천,3043,2939,5982
<class,과천선,정부과천청사,3939,4038,7977
<class,과천선,인덕원,11065,11221,22286
<class,과천선,평촌,5922,5801,11723
<class,과천선,범계,13546,13279,26825
<class,분당선,선릉,2826,4260,7086
<class,분당선,한티,6399,6513,12912
<class,분당선,도곡,2745,2627,5372
<class,분당선,구룡,1144,1217,2361
<class,분당선,개포동,1649,1709,3358
<class,분당선,대모산입구,2291,2202,4493
<class,분당선,수서,8012,7643,15655
<class,분당선,복정,1,0,1
<class,분당선,수원,5303,4544,9847
<class,분당선,서울숲,6100,6460,12560
<class,분당선,압구정로데오,9927,10960,20887
<class,분당선,강남구청,3636,4176,7812
<class,분당선,선정릉,2039,2147,4186
<class,분당선,가천대,3742,4493,8235
<class,분당선,태평,7720,7216,14936
<class,분당선,모란,10556,10883,21439
<class,분당선,야탑,12902,13141,26043
<class,분당선,서현,13506,13389,26895
<class,분당선,수내,5864,5578,11442
<class,분당선,정자,6854,7273,14127
<class,분당선,미금,7050,7511,14561
<class,분당선,오리,4999,4284,9283
<class,분당선,이매,2921,3174,6095
<class,분당선,보정,1021,1026,2047
<class,분당선,죽전,7332,8329,15661
<class,분당선,구성,2262,2505,4767
<class,분당선,신갈,1810,1887,3697
<class,분당선,기흥,4828,4606,9434
<class,분당선,상갈,2681,2784,5465
<class,분당선,청명,1933,1952,3885
<class,분당선,영통,4619,4688,9307
<class,분당선,망포,5827,6292,12119
<class,분당선,매탄권선,2431,2390,4821
<class,분당선,수원시청,7191,7260,14451
<class,분당선,매교,1485,1480,2965
<class,수인선,고색,1616,1701,3317
<class,수인선,오목천,1467,1488,2955
<class,수인선,어천,474,562,1036
<class,수인선,야목,184,139,323
<class,수인선,사리,2460,2081,4541
<class,수인선,달월,48,55,103
<class,수인선,월곶,1502,1423,2925
<class,수인선,소래포구,4105,4035,8140
<class,2호선,당산,8300,8957,17257
<class,1호선,서울역,27413,24385,51798
<class,1호선,동묘앞,11514,11472,22986
<class,1호선,종각,12964,11194,24158
<class,1호선,종로3가,13136,11530,24666
<class,1호선,종로5가,7791,7804,15595
<class,1호선,동대문,8509,8902,17411
<class,1호선,신설동,7118,6955,14073
<class,1호선,제기동,9075,9671,18746
<class,1호선,청량리,11730,11728,23458
<class,2호선,시청,5934,4624,10558
<class,2호선,을지로입구,16071,14541,30612
<class,2호선,을지로3가,7636,7179,14815
<class,2호선,합정,19927,21346,41273
<class,2호선,을지로4가,3111,2996,6107
<class,2호선,동대문역사문화공원,7436,8846,16282
<class,2호선,신당,7457,8134,15591
<class,2호선,상왕십리,6422,6392,12814
<class,2호선,왕십리,9066,7911,16977
<class,2호선,한양대,2503,2790,5293
<class,2호선,뚝섬,10364,10300,20664
<class,2호선,성수,12360,13445,25805
<class,수인선,소래포구,4760,4850,9610
<class,2호선,양천구청,4003,4015,8018
<class,2호선,도림천,681,720,1401
<class,2호선,신설동,3040,3006,6046
<class,2호선,신답,911,1011,1922
<class,2호선,용답,1908,1889,3797
<class,2호선,충정로,5406,5562,10968
<class,2호선,아현,6815,6389,13204
<class,2호선,이대,8842,9272,18114
<class,2호선,신촌,26888,27000,53888
<class,2호선,홍대입구,54580,60635,115215
<class,2호선,합정,25547,28545,54092
<class,2호선,당산,11809,13114,24923
<class,2호선,영등포구청,12860,13063,25923
<class,2호선,문래,11489,12275,23764
<class,2호선,신도림,37436,37861,75297
<class,2호선,대림,16626,17402,34028
<class,2호선,구로디지털단지,32565,31871,64436
<class,2호선,신대방,18930,17674,36604
<class,2호선,신림,47801,45203,93004
<class,2호선,봉천,16003,14262,30265
<class,2호선,서울대입구,36115,34304,70419
<class,2호선,낙성대,19794,18174,37968
<class,2호선,사당,28535,31885,60420
<class,2호선,방배,9443,9724,19167
<class,2호선,서초,9982,8524,18506
<class,2호선,교대,15495,17775,33270
<class,2호선,강남,55516,57470,112986
<class,2호선,역삼,17302,18917,36219
<class,2호선,선릉,23201,20399,43600
<class,2호선,삼성,30696,30856,61552
<class,2호선,종합운동장,4224,4675,8899
<class,2호선,잠실새내,15043,15703,30746
<class,2호선,잠실,57926,55816,113742
<class,2호선,잠실나루,6843,6521,13364
<class,2호선,강변,24413,23991,48404
<class,2호선,구의,15549,15027,30576
<class,2호선,건대입구,29670,32890,62560
<class,2호선,성수,17015,19689,36704
<class,2호선,뚝섬,14157,14188,28345
<class,2호선,한양대,3820,3962,7782
<class,2호선,왕십리,12300,10981,23281
<class,2호선,상왕십리,9304,8550,17854
<class,2호선,신당,10197,10764,20961
<class,2호선,동대문역사문화공원,10095,11249,21344
<class,2호선,을지로4가,6879,7016,13895
<class,2호선,을지로3가,10142,10463,20605
<class,2호선,을지로입구,21690,21326,43016
<class,2호선,시청,8328,7509,15837
<class,1호선,청량리,16260,16263,32523
<class,1호선,제기동,13589,13901,27490
<class,1호선,신설동,8807,8360,17167
<class,1호선,종로5가,16512,16192,32704
<class,1호선,종로3가,20286,19606,39892
<class,1호선,종각,17633,16969,34602
<class,1호선,시청,10761,11660,22421
<class,1호선,동묘앞,10138,10361,20499
<class,1호선,서울역,28810,29777,58587
<class,1호선,동대문,9946,9077,19023
<class,9호선2~3단계,올림픽공원,7516,7289,14805
<class,9호선2~3단계,한성백제,1641,1513,3154
<class,9호선2~3단계,송파나루,3764,4151,7915
<class,9호선2~3단계,석촌,6349,5294,11643
<class,9호선2~3단계,석촌고분,3995,3887,7882
<class,9호선2~3단계,삼전,4584,4401,8985
<class,9호선2~3단계,종합운동장,2672,2553,5225
<class,9호선2~3단계,봉은사,10921,11621,22542
<class,9호선2~3단계,삼성중앙,2846,2958,5804
<class,9호선2~3단계,선정릉,4570,5202,9772
<class,9호선2~3단계,언주,6090,6152,12242
<class,9호선,신논현,24313,25083,49396
<class,9호선,사평,2013,1894,3907
<class,9호선,고속터미널,11255,15600,26855
<class,9호선,신반포,2378,2265,4643
<class,9호선,구반포,1324,1294,2618
<class,9호선,동작,1365,1159,2524
<class,9호선,흑석,5108,5100,10208
<class,9호선,노들,2911,2419,5330
<class,9호선,노량진,19756,18702,38458
<class,9호선,샛강,2256,2278,4534
<class,9호선,여의도,10514,9829,20343
<class,9호선,국회의사당,4282,4454,8736
<class,9호선,당산,12103,11229,23332
<class,9호선,선유도,3710,3362,7072
<class,9호선,신목동,2204,1805,4009
<class,9호선,염창,11182,10081,21263
<class,9호선,등촌,6854,6652,13506
<class,9호선,증미,3757,3675,7432
<class,9호선,가양,13130,12191,25321
<class,9호선2~3단계,둔촌오륜,590,640,1230
<class,9호선2~3단계,중앙보훈병원,4250,3832,8082
<class,경강선,판교,2890,2892,5782
<class,경강선,이매,796,561,1357
<class,경강선,삼동,1388,1315,2703
<class,경강선,경기광주,5100,4849,9949
<class,경강선,초월,2064,1904,3968
<class,경강선,곤지암,1774,1833,3607
<class,경강선,신둔도예촌,1120,1072,2192
<class,경강선,이천,2634,2651,5285
<class,경강선,부발,1725,1472,3197
<class,경강선,세종대왕릉,234,281,515
<class,경강선,여주,1913,2127,4040
<class,경부선,서울역,6173,1820,7993
<class,경부선,남영,5196,5470,10666
<class,경부선,용산,30171,32523,62694
<class,경부선,노량진,7787,7344,15131
<class,경부선,대방,7468,7320,14788
<class,경부선,영등포,36044,38228,74272
<class,경부선,신도림,2742,2835,5577
<class,경부선,신길,5708,4703,10411
<class,경부선,구로,12643,13180,25823
<class,경부선,가산디지털단지,6222,8214,14436
<class,경부선,금천구청,7914,7797,15711
<class,경부선,석수,6501,5912,12413
<class,경부선,관악,5716,5277,10993
<class,경부선,안양,16402,16504,32906
<class,경부선,명학,5209,4846,10055
<class,경부선,금정,18199,17918,36117
<class,경부선,군포,4170,3773,7943
<class,경부선,의왕,5663,5540,11203
<class,경부선,성균관대,9999,9437,19436
<class,경부선,화서,5197,5081,10278
<class,경부선,수원,34074,37793,71867
<class,경부선,독산,8628,8391,17019
<class,경부선,세류,2423,2419,4842
<class,경부선,병점,11356,11152,22508
<class,경부선,세마,1997,1818,3815
<class,경부선,오산대,2549,2292,4841
<class,경부선,오산,8831,8178,17009
<class,경부선,진위,963,831,1794
<class,경부선,송탄,4501,3883,8384
<class,경부선,서정리,6626,5458,12084
<class,경부선,평택지제,3161,2861,6022
<class,경부선,평택,12528,11956,24484
<class,경부선,성환,2793,2535,5328
<class,경부선,직산,666,612,1278
<class,경부선,두정,4744,4764,9508
<class,경부선,천안,5535,5754,11289
<class,경부선,당정,3686,3437,7123
<class,경부선,서동탄,945,950,1895
<class,경부선,광명,2624,2497,5121
<class,경원선,이촌,2586,1897,4483
<class,경원선,서빙고,1381,1233,2614
<class,경원선,한남,2537,2525,5062
<class,경원선,옥수,42,26,68
<class,경원선,응봉,1240,1068,2308
<class,경원선,왕십리,11047,12573,23620
<class,경원선,청량리,14106,15272,29378
<class,경원선,외대앞,5513,5274,10787
<class,경원선,신이문,5736,5210,10946
<class,경원선,석계,6203,6618,12821
<class,경원선,광운대,5056,5078,10134
<class,경원선,월계,4497,4045,8542
<class,경원선,녹천,2992,2479,5471
<class,9호선,양천향교,5722,5367,11089
<class,경원선,방학,6948,6672,13620
<class,경원선,도봉,4173,3903,8076
<class,경원선,도봉산,7834,5266,13100
<class,경원선,망월사,5213,5236,10449
<class,경원선,회룡,8724,8650,17374
<class,경원선,의정부,16405,17363,33768
<class,경원선,가능,4964,4745,9709
<class,경원선,녹양,3337,3167,6504
<class,경원선,양주,5781,5425,11206
<class,경원선,덕계,2212,2003,4215
<class,경원선,덕정,4266,3943,8209
<class,경원선,지행,5142,4990,10132
<class,경원선,동두천중앙,2398,2350,4748
<class,경원선,보산,1523,1468,2991
<class,경원선,동두천,1556,1852,3408
<class,경원선,소요산,3140,2741,5881
<class,경의선,서울역,1181,1334,2515
<class,경의선,신촌,317,332,649
<class,경의선,효창공원앞,1695,1791,3486
<class,경의선,공덕,2499,1925,4424
<class,경의선,서강대,1561,1460,3021
<class,경의선,홍대입구,1683,2042,3725
<class,경의선,가좌,3521,3413,6934
<class,경의선,디지털미디어시티,1787,1564,3351
<class,경의선,수색,1390,1271,2661
<class,경의선,화전,942,865,1807
<class,경의선,강매,1866,1728,3594
<class,경의선,행신,4743,4842,9585
<class,경의선,능곡,2717,2530,5247
<class,경의선,곡산,368,377,745
<class,경의선,백마,4133,3842,7975
<class,경의선,풍산,4174,3848,8022
<class,경의선,일산,5822,5515,11337
<class,경의선,탄현,5150,4761,9911
<class,경의선,야당,5352,5412,10764
<class,경의선,운정,4815,4345,9160
<class,경의선,금릉,3615,3294,6909
<class,경의선,금촌,5443,5299,10742
<class,경의선,월롱,1455,1280,2735
<class,경의선,파주,838,619,1457
<class,경의선,문산,4196,4013,8209
<class,경의선,임진강,60,54,114
<class,경인선,개봉,15024,14561,29585
<class,경인선,오류동,8538,7602,16140
<class,경인선,역곡,18775,18103,36878
<class,경인선,부천,26253,27493,53746
<class,경인선,송내,16692,16258,32950
<class,경인선,부평,25992,29070,55062
<class,경인선,백운,5018,4894,9912
<class,경인선,동암,11099,11520,22619
<class,경인선,주안,14306,12427,26733
<class,경인선,제물포,6826,6529,13355
<class,경인선,동인천,10734,10481,21215
<class,경인선,인천,3099,2677,5776
<class,경인선,구일,3938,3743,7681
<class,경인선,소사,6982,6647,13629
<class,경인선,부개,5918,5586,11504
<class,경인선,간석,3920,3757,7677
<class,경인선,도원,1953,2025,3978
<class,경인선,온수,4546,4123,8669
<class,경인선,중동,6205,5770,11975
<class,경인선,도화,2988,2658,5646
<class,경춘선,신내,1086,1060,2146
<class,경춘선,갈매,1783,1574,3357
<class,경춘선,별내,2133,2101,4234
<class,경춘선,퇴계원,2369,2136,4505
<class,경춘선,사릉,2122,2103,4225
<class,경춘선,금곡,966,919,1885
<class,경춘선,평내호평,4021,3855,7876
<class,경춘선,천마산,1210,1183,2393
<class,경춘선,마석,2776,2696,5472
<class,경춘선,대성리,456,449,905
<class,경춘선,청평,1225,1409,2634
<class,경춘선,상천,251,288,539
<class,경춘선,가평,1333,1514,2847
<class,경춘선,굴봉산,127,174,301
<class,경춘선,백양리,250,235,485
<class,경춘선,강촌,405,506,911
<class,경춘선,김유정,373,403,776
<class,경춘선,남춘천,2115,2166,4281
<class,경춘선,춘천,1246,1135,2381
<class,공항철도 1호선,서울역,6853,7147,14000
<class,공항철도 1호선,공덕,1499,2375,3874
<class,공항철도 1호선,홍대입구,9890,10375,20265
<class,공항철도 1호선,디지털미디어시티,4976,4896,9872
<class,공항철도 1호선,마곡나루,2980,3087,6067
<class,공항철도 1호선,김포공항,10400,5506,15906
<class,공항철도 1호선,계양,6571,5993,12564
<class,공항철도 1호선,검암,4352,4298,8650
<class,공항철도 1호선,청라국제도시,3885,3642,7527
<class,공항철도 1호선,운서,5567,5668,11235
<class,공항철도 1호선,공항화물청사,1231,1327,2558
<class,공항철도 1호선,인천공항1터미널,3124,3309,6433
<class,공항철도 1호선,인천공항2터미널,1787,1536,3323
<class,공항철도 1호선,영종,2516,2462,4978
<class,과천선,선바위,5069,4420,9489
<class,과천선,경마공원,6895,6948,13843
<class,과천선,대공원,3498,3600,7098
<class,과천선,과천,3968,3655,7623
<class,과천선,정부과천청사,5557,5358,10915
<class,과천선,인덕원,14830,14593,29423
<class,과천선,평촌,8822,8547,17369
<class,과천선,범계,18680,17472,36152
<class,분당선,선릉,4976,7858,12834
<class,분당선,한티,9427,9306,18733
<class,분당선,도곡,4324,3855,8179
<class,분당선,구룡,1250,1079,2329
<class,분당선,개포동,2367,2266,4633
<class,분당선,대모산입구,2687,2375,5062
<class,분당선,수서,9553,9973,19526
<class,분당선,수원,6863,5902,12765
<class,분당선,서울숲,6784,7071,13855
<class,분당선,압구정로데오,17094,20599,37693
<class,분당선,강남구청,5283,6536,11819
<class,분당선,선정릉,3361,3396,6757
<class,분당선,가천대,5240,5710,10950
<class,분당선,태평,10203,9463,19666
<class,분당선,모란,15168,15514,30682
<class,분당선,야탑,16858,17563,34421
<class,분당선,서현,17745,17938,35683
<class,분당선,수내,8192,7538,15730
<class,분당선,정자,10032,10281,20313
<class,분당선,미금,10151,10416,20567
<class,분당선,오리,7638,6303,13941
<class,분당선,이매,3739,3786,7525
<class,분당선,보정,1479,1367,2846
<class,분당선,죽전,9471,10521,19992
<class,분당선,구성,3104,3216,6320
<class,분당선,신갈,2719,2616,5335
<class,분당선,기흥,6381,6055,12436
<class,분당선,상갈,3512,3455,6967
<class,분당선,청명,2511,2411,4922
<class,분당선,영통,6236,6127,12363
<class,분당선,망포,9028,8091,17119
<class,분당선,매탄권선,3413,3121,6534
<class,분당선,수원시청,10463,12057,22520
<class,분당선,매교,2035,2009,4044
<class,수인선,고색,2476,2359,4835
<class,수인선,오목천,2046,1737,3783
<class,수인선,어천,722,596,1318
<class,수인선,야목,227,211,438
<class,수인선,사리,3181,2623,5804
<class,수인선,달월,40,48,88
<class,수인선,월곶,1984,1933,3917
<class,2호선,신정네거리,6712,6639,13351
<class,수인선,인천논현,3920,4127,8047
<class,수인선,호구포,2386,2255,4641
<class,수인선,남동인더스파크,971,886,1857
<class,수인선,원인재,3391,3535,6926
<class,수인선,연수,3525,3573,7098
<class,수인선,송도,1930,1800,3730
<class,수인선,인하대,3855,3454,7309
<class,수인선,숭의,2472,2317,4789
<class,수인선,신포,1288,1305,2593
<class,수인선,인천,911,1485,2396
<class,안산선,산본,11521,10309,21830
<class,안산선,대야미,3781,3288,7069
<class,안산선,반월,3158,2903,6061
<class,안산선,상록수,11736,11561,23297
<class,안산선,한대앞,6678,6636,13314
<class,안산선,중앙,14364,15233,29597
<class,안산선,고잔,5994,5793,11787
<class,안산선,초지,3195,3101,6296
<class,안산선,안산,8780,9121,17901
<class,안산선,신길온천,1357,1287,2644
<class,안산선,정왕,6139,6166,12305
<class,안산선,오이도,6767,6930,13697
<class,안산선,수리산,2742,2449,5191
<class,우이신설선,북한산우이,2772,2803,5575
<class,우이신설선,솔밭공원,1729,1562,3291
<class,우이신설선,4.19민주묘지,2127,1829,3956
<class,우이신설선,가오리,2767,2608,5375
<class,우이신설선,화계,2329,2082,4411
<class,우이신설선,삼양,1475,1498,2973
<class,우이신설선,삼양사거리,1782,1755,3537
<class,우이신설선,솔샘,3591,3066,6657
<class,우이신설선,북한산보국문,4416,3825,8241
<class,우이신설선,정릉,3396,2696,6092
<class,우이신설선,성신여대입구,2370,2838,5208
<class,우이신설선,보문,964,962,1926
<class,우이신설선,신설동,1299,1277,2576
<class,일산선,원흥,7260,6804,14064
<class,일산선,삼송,12903,12411,25314
<class,일산선,원당,7791,7207,14998
<class,일산선,화정,11923,12157,24080
<class,일산선,대곡,1303,1104,2407
<class,일산선,백석,6915,7003,13918
<class,일산선,마두,4576,4700,9276
<class,일산선,정발산,6215,6530,12745
<class,일산선,주엽,5952,5928,11880
<class,일산선,대화,8219,7212,15431
<class,장항선,봉명,648,623,1271
<class,장항선,쌍용,1456,1292,2748
<class,장항선,아산,2695,2732,5427
<class,장항선,탕정,383,269,652
<class,장항선,배방,868,805,1673
<class,장항선,온양온천,3275,3339,6614
<class,장항선,신창,1179,948,2127
<class,중앙선,회기,18008,16848,34856
<class,중앙선,중랑,4182,3933,8115
<class,중앙선,상봉,4671,4569,9240
<class,중앙선,망우,5992,5740,11732
<class,중앙선,양원,1266,1261,2527
<class,중앙선,구리,9564,9771,19335
<class,중앙선,도농,6643,6174,12817
<class,중앙선,양정,492,426,918
<class,중앙선,덕소,3970,3972,7942
<class,중앙선,도심,1366,1158,2524
<class,중앙선,팔당,1085,1121,2206
<class,중앙선,운길산,994,986,1980
<class,중앙선,양수,1577,1640,3217
<class,중앙선,신원,179,173,352
<class,중앙선,국수,517,543,1060
<class,중앙선,아신,462,479,941
<class,중앙선,오빈,235,233,468
<class,중앙선,양평,2093,2239,4332
<class,중앙선,원덕,322,341,663
<class,중앙선,용문,1538,1720,3258
<class,중앙선,지평,38,54,92
<class,경원선,창동,1,0,1
<class,9호선,마곡나루,7530,7465,14995
<class,9호선,신방화,4390,4044,8434
<class,9호선,공항시장,2118,2220,4338
<class,9호선,김포공항,6810,11294,18104
<class,9호선,개화,1309,1179,2488
<class,8호선,모란,3233,2956,6189
<class,8호선,수진,3888,3481,7369
<class,8호선,신흥,3277,3499,6776
<class,8호선,단대오거리,7212,6588,13800
<class,8호선,남한산성입구,8685,7569,16254
<class,8호선,산성,4140,4034,8174
<class,8호선,복정,7083,5963,13046
<class,8호선,장지,11582,10486,22068
<class,8호선,문정,8376,8552,16928
<class,8호선,가락시장,5063,5211,10274
<class,8호선,송파,4517,4577,9094
<class,8호선,석촌,5547,6662,12209
<class,8호선,잠실,11346,13539,24885
<class,8호선,몽촌토성,4287,4254,8541
<class,8호선,강동구청,5789,5704,11493
<class,8호선,천호,11269,13535,24804
<class,8호선,암사,11781,10455,22236
<class,7호선,부평구청,4671,4114,8785
<class,7호선,굴포천,6154,6352,12506
<class,7호선,삼산체육관,3353,2987,6340
<class,7호선,상동,9959,10292,20251
<class,7호선,부천시청,9005,9020,18025
<class,7호선,신중동,9186,9194,18380
<class,7호선,춘의,4934,4648,9582
<class,7호선,부천종합운동장,3187,2902,6089
<class,7호선,까치울,5060,5105,10165
<class,7호선,온수,5367,5139,10506
<class,7호선,천왕,6476,6076,12552
<class,7호선,광명사거리,16345,16128,32473
<class,7호선,철산,14859,15286,30145
<class,7호선,가산디지털단지,14502,13059,27561
<class,7호선,남구로,7750,8064,15814
<class,7호선,대림,6348,6837,13185
<class,7호선,신풍,7409,7054,14463
<class,7호선,보라매,5759,5431,11190
<class,7호선,신대방삼거리,10843,10028,20871
<class,7호선,장승배기,6307,5988,12295
<class,7호선,상도,6776,6298,13074
<class,7호선,숭실대입구,8221,7816,16037
<class,7호선,남성,7397,6768,14165
<class,7호선,이수,11455,10590,22045
<class,7호선,내방,7416,7446,14862
<class,7호선,고속터미널,12744,10110,22854
<class,7호선,반포,4011,3793,7804
<class,7호선,논현,10668,12018,22686
<class,7호선,학동,10893,11723,22616
<class,7호선,강남구청,9315,10417,19732
<class,7호선,청담,10620,11685,22305
<class,7호선,뚝섬유원지,5605,5485,11090
<class,7호선,건대입구,9439,9829,19268
<class,7호선,어린이대공원,7772,7556,15328
<class,7호선,군자,10103,7761,17864
<class,7호선,중곡,6666,6291,12957
<class,7호선,용마산,4210,4024,8234
<class,7호선,사가정,11811,11394,23205
<class,7호선,면목,11404,10805,22209
<class,7호선,상봉,12561,12116,24677
<class,7호선,중화,7207,6883,14090
<class,7호선,먹골,7692,7382,15074
<class,7호선,태릉입구,6181,5633,11814
<class,7호선,공릉,7977,7826,15803
<class,7호선,하계,11204,10046,21250
<class,7호선,중계,8673,7659,16332
<class,7호선,노원,14465,15026,29491
<class,7호선,마들,8381,7745,16126
<class,7호선,수락산,9261,9034,18295
<class,7호선,도봉산,5918,8034,13952
<class,7호선,장암,1440,956,2396
<class,6호선,봉화산,5019,4712,9731
<class,6호선,화랑대,6468,5255,11723
<class,6호선,태릉입구,3867,4073,7940
<class,6호선,석계,8201,8175,16376
<class,6호선,돌곶이,5887,5243,11130
<class,6호선,상월곡,3787,3273,7060
<class,6호선,월곡,7171,6867,14038
<class,6호선,고려대,5035,4653,9688
<class,6호선,안암,5662,5373,11035
<class,6호선,보문,4829,4197,9026
<class,6호선,창신,2017,1632,3649
<class,6호선,동묘앞,7226,6699,13925
<class,6호선,신당,6010,5098,11108
<class,6호선,청구,2349,2228,4577
<class,6호선,약수,2431,2464,4895
<class,6호선,버티고개,1306,1355,2661
<class,6호선,한강진,8335,10065,18400
<class,6호선,이태원,10307,13048,23355
<class,6호선,녹사평,4221,4924,9145
<class,6호선,삼각지,4911,3878,8789
<class,6호선,효창공원앞,4374,3749,8123
<class,6호선,공덕,9768,9220,18988
<class,6호선,대흥,5116,5029,10145
<class,6호선,광흥창,4760,4355,9115
<class,6호선,상수,6924,8940,15864
<class,6호선,합정,10969,10642,21611
<class,6호선,망원,12367,13650,26017
<class,6호선,마포구청,9149,7988,17137
<class,6호선,월드컵경기장,3233,3459,6692
<class,6호선,디지털미디어시티,6734,6702,13436
<class,6호선,증산,6998,6709,13707
<class,6호선,새절,8054,7636,15690
<class,6호선,구산,5193,3780,8973
<class,6호선,연신내,1,0,1
<class,6호선,독바위,1851,2041,3892
<class,6호선,불광,3439,3122,6561
<class,6호선,역촌,2585,3011,5596
<class,6호선,응암,11737,11276,23013
<class,5호선,하남검단산,4514,4458,8972
<class,5호선,하남시청,4902,4688,9590
<class,5호선,하남풍산,2393,2395,4788
<class,5호선,미사,11116,10776,21892
<class,5호선,강일,2397,2282,4679
<class,5호선,마천,4581,4769,9350
<class,5호선,거여,5569,5239,10808
<class,5호선,개롱,3903,4021,7924
<class,5호선,오금,1895,1823,3718
<class,5호선,방이,4794,4846,9640
<class,5호선,올림픽공원,3393,3239,6632
<class,5호선,둔촌동,5890,5783,11673
<class,5호선,상일동,8945,8133,17078
<class,5호선,고덕,5862,5656,11518
<class,5호선,명일,5864,5863,11727
<class,5호선,굽은다리,6858,6368,13226
<class,5호선,길동,5666,5770,11436
<class,5호선,강동,12292,11662,23954
<class,5호선,천호,15476,15117,30593
<class,5호선,광나루,9466,9091,18557
<class,5호선,아차산,11734,11031,22765
<class,5호선,군자,7962,8683,16645
<class,5호선,장한평,10812,10437,21249
<class,5호선,답십리,9659,8801,18460
<class,5호선,마장,3711,3608,7319
<class,5호선,왕십리,3355,4055,7410
<class,5호선,행당,5070,4355,9425
<class,5호선,신금호,3877,3866,7743
<class,5호선,청구,2370,2179,4549
<class,5호선,동대문역사문화공원,939,1246,2185
<class,5호선,을지로4가,3180,3547,6727
<class,5호선,종로3가,10595,11246,21841
<class,5호선,광화문,14116,14906,29022
<class,5호선,서대문,6381,6278,12659
<class,5호선,충정로,1832,1671,3503
<class,5호선,애오개,3467,3347,6814
<class,5호선,공덕,6593,7029,13622
<class,5호선,마포,7103,7244,14347
<class,5호선,여의나루,5536,6434,11970
<class,5호선,여의도,10120,10911,21031
<class,5호선,신길,2378,2460,4838
<class,5호선,영등포시장,7464,7859,15323
<class,5호선,영등포구청,1858,1953,3811
<class,5호선,양평,3549,3263,6812
<class,5호선,오목교,14840,15583,30423
<class,5호선,목동,10826,10900,21726
<class,5호선,신정,8366,7149,15515
<class,5호선,까치산,19978,18766,38744
<class,5호선,화곡,19215,17213,36428
<class,5호선,우장산,8860,8802,17662
<class,5호선,발산,13400,14572,27972
<class,5호선,마곡,5172,5110,10282
<class,5호선,송정,4832,4674,9506
<class,5호선,김포공항,6548,6595,13143
<class,5호선,개화산,3592,3363,6955
<class,5호선,방화,4326,4134,8460
<class,4호선,쌍문,20119,17917,38036
<class,4호선,창동,18309,19236,37545
<class,4호선,노원,14505,16371,30876
<class,4호선,상계,13070,12185,25255
<class,4호선,당고개,9363,8536,17899
<class,4호선,남태령,926,662,1588
<class,4호선,사당,19917,17121,37038
<class,4호선,총신대입구,13421,14656,28077
<class,4호선,동작,1114,1189,2303
<class,4호선,이촌,5565,6123,11688
<class,4호선,신용산,9231,10116,19347
<class,4호선,삼각지,3108,4093,7201
<class,4호선,숙대입구,8317,8051,16368
<class,4호선,서울역,5077,12307,17384
<class,4호선,회현,17695,19316,37011
<class,4호선,명동,15830,18426,34256
<class,4호선,충무로,12459,13514,25973
<class,4호선,동대문역사문화공원,11383,9928,21311
<class,4호선,동대문,12603,12496,25099
<class,4호선,혜화,24588,25739,50327
<class,4호선,한성대입구,9878,9432,19310
<class,4호선,성신여대입구,15349,14479,29828
<class,4호선,길음,12966,12065,25031
<class,4호선,미아사거리,20494,19499,39993
<class,4호선,미아,10097,9469,19566
<class,4호선,수유,24733,24172,48905
<class,3호선,오금,3482,3132,6614
<class,3호선,경찰병원,3654,3620,7274
<class,3호선,가락시장,5788,5489,11277
<class,3호선,수서,12491,12307,24798
<class,3호선,일원,4376,4220,8596
<class,3호선,대청,5621,5025,10646
<class,3호선,학여울,1345,1402,2747
<class,3호선,대치,7001,6504,13505
<class,3호선,도곡,3141,3152,6293
<class,3호선,매봉,5642,5318,10960
<class,3호선,양재,20271,22109,42380
<class,3호선,남부터미널,18550,18540,37090
<class,3호선,교대,6452,3797,10249
<class,3호선,고속터미널,42249,43363,85612
<class,3호선,잠원,3209,3058,6267
<class,3호선,신사,23091,25144,48235
<class,3호선,압구정,23363,24832,48195
<class,3호선,옥수,6341,6501,12842
<class,3호선,금호,5430,4958,10388
<class,3호선,약수,8578,8032,16610
<class,3호선,동대입구,6757,7214,13971
<class,3호선,충무로,1,0,1
<class,3호선,을지로3가,4962,5224,10186
<class,3호선,종로3가,4987,7086,12073
<class,3호선,안국,13083,14888,27971
<class,3호선,경복궁,13488,13976,27464
<class,3호선,독립문,5168,5426,10594
<class,3호선,무악재,2543,2583,5126
<class,3호선,홍제,11856,11012,22868
<class,3호선,녹번,9709,8329,18038
<class,3호선,불광,11957,13438,25395
<class,3호선,연신내,27147,25466,52613
<class,3호선,구파발,13885,13839,27724
<class,3호선,지축,2868,2630,5498
<class,2호선,용두,1607,1574,3181
<class,1호선,서울역,26202,22072,48274
<class,1호선,동묘앞,10625,10619,21244
<class,1호선,시청,7329,6774,14103
<class,1호선,종각,10983,10017,21000
<class,1호선,종로3가,12030,10838,22868
<class,1호선,종로5가,8237,7918,16155
<class,1호선,동대문,8177,8706,16883
<class,1호선,신설동,6861,6825,13686
<class,1호선,제기동,8684,9034,17718
<class,1호선,청량리,11060,11369,22429
<class,2호선,시청,5574,4250,9824
<class,2호선,을지로입구,15876,14499,30375
<class,2호선,을지로3가,7371,7170,14541
<class,2호선,을지로4가,2979,2916,5895
<class,2호선,동대문역사문화공원,7426,9031,16457
<class,2호선,신당,7415,8225,15640
<class,2호선,상왕십리,6203,6391,12594
<class,2호선,왕십리,8848,7987,16835
<class,2호선,한양대,2277,2589,4866
<class,2호선,뚝섬,10816,10673,21489
<class,2호선,성수,12000,13076,25076
<class,2호선,건대입구,22520,23439,45959
<class,2호선,구의,10572,10823,21395
<class,2호선,강변,19058,18635,37693
<class,2호선,잠실나루,4560,4653,9213
<class,2호선,잠실,44408,41283,85691
<class,2호선,잠실새내,9668,10046,19714
<class,2호선,종합운동장,4002,4228,8230
<class,2호선,삼성,23213,22600,45813
<class,2호선,선릉,12816,11118,23934
<class,2호선,역삼,11175,11986,23161
<class,2호선,강남,32164,31683,63847
<class,2호선,교대,9481,10602,20083
<class,2호선,방배,6168,6489,12657
<class,2호선,사당,19485,21705,41190
<class,2호선,낙성대,13996,14666,28662
<class,2호선,서울대입구,25011,25899,50910
<class,2호선,봉천,11400,11013,22413
<class,2호선,신림,34503,34420,68923
<class,2호선,신대방,13756,13503,27259
<class,2호선,구로디지털단지,21822,21762,43584
<class,2호선,대림,13075,13285,26360
<class,2호선,신도림,25333,25803,51136
<class,2호선,문래,7126,7601,14727
<class,2호선,영등포구청,8377,8435,16812
<class,2호선,당산,7785,8671,16456
<class,2호선,합정,18432,19355,37787
<class,2호선,홍대입구,41697,41043,82740
<class,2호선,신촌,19455,18461,37916
<class,2호선,이대,6302,6735,13037
<class,2호선,아현,4579,4766,9345
<class,2호선,충정로,3603,3870,7473
<class,2호선,용답,1426,1476,2902
<class,2호선,신답,675,732,1407
<class,2호선,신설동,2888,2887,5775
<class,2호선,도림천,458,497,955
<class,2호선,양천구청,2868,2969,5837
<class,2호선,신정네거리,4526,4724,9250
<class,2호선,용두,1007,1019,2026
<class,3호선,지축,2001,1806,3807
<class,3호선,구파발,10072,10208,20280
<class,3호선,연신내,19450,18544,37994
<class,3호선,불광,8860,10042,18902
<class,3호선,녹번,6807,6230,13037
<class,3호선,홍제,8066,7721,15787
<class,3호선,무악재,1629,1756,3385
<class,3호선,독립문,3479,3766,7245
<class,3호선,경복궁,9941,9828,19769
<class,3호선,안국,9498,9930,19428
<class,3호선,종로3가,3408,4287,7695
<class,3호선,을지로3가,2879,2898,5777
<class,3호선,동대입구,5767,6230,11997
<class,3호선,약수,5974,5764,11738
<class,일산선,지축,1,0,1
<class,3호선,금호,3887,3651,7538
<class,3호선,옥수,4241,4496,8737
<class,3호선,압구정,12425,13129,25554
<class,3호선,신사,12697,12779,25476
<class,3호선,잠원,1779,1871,3650
<class,3호선,고속터미널,35647,33664,69311
<class,3호선,교대,3789,2290,6079
<class,3호선,남부터미널,12565,13347,25912
<class,3호선,양재,13291,15199,28490
<class,3호선,매봉,3760,3769,7529
<class,3호선,도곡,1645,1728,3373
<class,3호선,대치,4041,3798,7839
<class,3호선,학여울,777,756,1533
<class,3호선,대청,3804,3678,7482
<class,3호선,일원,2692,2964,5656
<class,3호선,수서,9681,9339,19020
<class,3호선,가락시장,3197,3358,6555
<class,3호선,경찰병원,2427,2479,4906
<class,3호선,오금,2460,2323,4783
<class,4호선,수유,18185,17698,35883
<class,4호선,미아,7238,7013,14251
<class,4호선,미아사거리,14857,14112,28969
<class,4호선,길음,9403,9432,18835
<class,4호선,성신여대입구,11282,10635,21917
<class,4호선,한성대입구,7127,7329,14456
<class,4호선,혜화,20207,20730,40937
<class,4호선,동대문,5950,6520,12470
<class,4호선,동대문역사문화공원,8815,8218,17033
<class,4호선,충무로,7717,7698,15415
<class,4호선,명동,12794,12891,25685
<class,4호선,회현,9760,9674,19434
<class,4호선,서울역,3757,9233,12990
<class,4호선,숙대입구,6176,5957,12133
<class,4호선,삼각지,2196,2835,5031
<class,4호선,신용산,7010,7043,14053
<class,4호선,이촌,3897,4239,8136
<class,4호선,동작,740,849,1589
<class,4호선,총신대입구,9200,10109,19309
<class,4호선,사당,13609,12726,26335
<class,4호선,남태령,642,452,1094
<class,4호선,당고개,7006,6730,13736
<class,4호선,상계,9336,8679,18015
<class,4호선,노원,10543,11623,22166
<class,4호선,창동,13591,14230,27821
<class,4호선,쌍문,14401,13165,27566
<class,5호선,방화,3211,3295,6506
<class,5호선,개화산,2511,2560,5071
<class,5호선,김포공항,6416,5719,12135
<class,5호선,송정,3561,3484,7045
<class,5호선,마곡,3291,3367,6658
<class,5호선,발산,9195,9604,18799
<class,5호선,우장산,6069,6256,12325
<class,5호선,화곡,12993,12234,25227
<class,5호선,까치산,14150,14010,28160
<class,5호선,신정,5681,5308,10989
<class,5호선,목동,7428,7612,15040
<class,5호선,오목교,10686,10812,21498
<class,5호선,양평,2407,2534,4941
<class,5호선,영등포구청,1194,1253,2447
<class,5호선,영등포시장,4825,5204,10029
<class,5호선,신길,1719,2002,3721
<class,5호선,여의도,7448,7613,15061
<class,5호선,여의나루,4574,5474,10048
<class,5호선,마포,4453,4709,9162
<class,5호선,공덕,4265,4313,8578
<class,5호선,애오개,2373,2427,4800
<class,5호선,충정로,1354,1405,2759
<class,5호선,서대문,4856,4862,9718
<class,5호선,광화문,9993,9970,19963
<class,5호선,종로3가,7896,7023,14919
<class,5호선,을지로4가,1283,1422,2705
<class,5호선,동대문역사문화공원,645,803,1448
<class,5호선,청구,1548,1425,2973
<class,5호선,신금호,2643,2849,5492
<class,5호선,행당,3514,3365,6879
<class,5호선,왕십리,2304,2584,4888
<class,5호선,마장,2563,2557,5120
<class,5호선,답십리,6908,6431,13339
<class,5호선,장한평,7067,7229,14296
<class,5호선,군자,5764,6265,12029
<class,5호선,아차산,9059,8866,17925
<class,5호선,광나루,7175,7375,14550
<class,5호선,천호,11558,10775,22333
<class,5호선,강동,8608,8548,17156
<class,5호선,길동,3863,3977,7840
<class,5호선,굽은다리,4855,4554,9409
<class,5호선,명일,4302,4386,8688
<class,5호선,고덕,3859,3715,7574
<class,5호선,상일동,6002,5822,11824
<class,5호선,둔촌동,4260,4285,8545
<class,5호선,올림픽공원,2520,2482,5002
<class,5호선,방이,3719,3448,7167
<class,5호선,오금,1371,1293,2664
<class,5호선,개롱,2866,3111,5977
<class,5호선,거여,3914,3750,7664
<class,5호선,마천,3131,3426,6557
<class,5호선,강일,1728,1608,3336
<class,5호선,미사,7626,7795,15421
<class,5호선,하남풍산,1876,1918,3794
<class,5호선,하남시청,3460,3331,6791
<class,5호선,하남검단산,4088,4022,8110
<class,6호선,응암,8139,8310,16449
<class,6호선,역촌,1801,2097,3898
<class,6호선,불광,2853,2447,5300
<class,6호선,독바위,1419,1693,3112
<class,6호선,구산,3471,2689,6160
<class,6호선,새절,5766,5658,11424
<class,6호선,증산,5038,5207,10245
<class,6호선,디지털미디어시티,4606,4889,9495
<class,6호선,월드컵경기장,2383,2535,4918
<class,6호선,마포구청,6517,5965,12482
<class,6호선,망원,8860,9381,18241
<class,6호선,합정,8221,7484,15705
<class,6호선,상수,5245,5945,11190
<class,6호선,광흥창,3640,3574,7214
<class,6호선,대흥,3263,3494,6757
<class,6호선,공덕,6290,5867,12157
<class,6호선,효창공원앞,2961,2602,5563
<class,6호선,삼각지,3152,2540,5692
<class,6호선,녹사평,3450,3380,6830
<class,6호선,이태원,8209,7486,15695
<class,6호선,한강진,6234,7035,13269
<class,6호선,버티고개,903,988,1891
<class,6호선,약수,1511,1536,3047
<class,6호선,청구,1555,1520,3075
<class,6호선,신당,4081,4504,8585
<class,6호선,동묘앞,5841,5678,11519
<class,6호선,창신,1526,1452,2978
<class,6호선,보문,3567,3324,6891
<class,6호선,안암,3916,4175,8091
<class,6호선,고려대,3290,3359,6649
<class,6호선,월곡,4894,4780,9674
<class,6호선,상월곡,2845,2697,5542
<class,6호선,돌곶이,4286,4215,8501
<class,6호선,석계,5856,6046,11902
<class,6호선,태릉입구,2863,3103,5966
<class,6호선,화랑대,4843,4093,8936
<class,6호선,봉화산,3539,3430,6969
<class,7호선,장암,1210,794,2004
<class,7호선,도봉산,4441,6712,11153
<class,7호선,수락산,7394,7235,14629
<class,7호선,마들,5290,5129,10419
<class,7호선,노원,10239,10070,20309
<class,7호선,중계,5927,5624,11551
<class,7호선,하계,8073,7664,15737
<class,7호선,공릉,5558,5730,11288
<class,7호선,태릉입구,4511,4064,8575
<class,7호선,먹골,5194,5209,10403
<class,7호선,중화,5071,4925,9996
<class,7호선,상봉,8523,7862,16385
<class,7호선,면목,7434,7434,14868
<class,7호선,사가정,8015,7732,15747
<class,7호선,용마산,2866,3072,5938
<class,7호선,중곡,4871,4715,9586
<class,7호선,군자,6904,5541,12445
<class,7호선,어린이대공원,5864,5969,11833
<class,7호선,건대입구,6950,6870,13820
<class,7호선,뚝섬유원지,4232,4087,8319
<class,7호선,청담,6457,6987,13444
<class,7호선,강남구청,5577,6131,11708
<class,7호선,학동,6339,6677,13016
<class,7호선,논현,5689,6206,11895
<class,7호선,반포,2535,2457,4992
<class,7호선,고속터미널,11004,7159,18163
<class,7호선,내방,4653,4953,9606
<class,7호선,이수,7575,7099,14674
<class,7호선,남성,5030,4921,9951
<class,7호선,숭실대입구,4986,5457,10443
<class,7호선,상도,4570,4633,9203
<class,7호선,장승배기,4425,4307,8732
<class,7호선,신대방삼거리,7418,7350,14768
<class,7호선,보라매,3871,3862,7733
<class,7호선,신풍,5491,5253,10744
<class,7호선,대림,6061,5681,11742
<class,7호선,남구로,6004,5901,11905
<class,7호선,가산디지털단지,10122,9331,19453
<class,7호선,철산,9953,10021,19974
<class,7호선,광명사거리,11472,11351,22823
<class,7호선,천왕,4353,4283,8636
<class,7호선,온수,3560,3663,7223
<class,7호선,까치울,3775,3692,7467
<class,7호선,부천종합운동장,2384,2166,4550
<class,7호선,춘의,3076,2996,6072
<class,7호선,신중동,6261,6286,12547
<class,7호선,부천시청,6344,6126,12470
<class,7호선,상동,6961,6791,13752
<class,7호선,삼산체육관,2315,2293,4608
<class,7호선,굴포천,4266,4358,8624
<class,7호선,부평구청,3187,2845,6032
<class,8호선,암사,8033,7677,15710
<class,8호선,천호,8456,9542,17998
<class,8호선,강동구청,4201,4451,8652
<class,8호선,몽촌토성,2973,3020,5993
<class,8호선,잠실,9195,10410,19605
<class,8호선,석촌,3813,4738,8551
<class,8호선,송파,3202,3537,6739
<class,8호선,가락시장,2720,3506,6226
<class,8호선,문정,5313,5613,10926
<class,8호선,장지,8214,8410,16624
<class,8호선,복정,4885,4636,9521
<class,8호선,산성,2820,3015,5835
<class,8호선,남한산성입구,6053,5665,11718
<class,8호선,단대오거리,4936,4947,9883
<class,8호선,신흥,2509,2595,5104
<class,8호선,수진,2820,2596,5416
<class,8호선,모란,2346,1942,4288
<class,9호선,개화,915,837,1752
<class,9호선,김포공항,6622,10078,16700
<class,9호선,공항시장,1586,1692,3278
<class,9호선,신방화,3123,3126,6249
<class,9호선,마곡나루,5200,5118,10318
<class,9호선,양천향교,3751,4062,7813
<class,9호선,가양,9002,8871,17873
<class,9호선,증미,2408,2415,4823
<class,9호선,등촌,4819,4988,9807
<class,9호선,염창,7546,7486,15032
<class,9호선,신목동,1478,1384,2862
<class,9호선,선유도,2555,2623,5178
<class,9호선,당산,8371,8249,16620
<class,9호선,국회의사당,4573,4325,8898
<class,9호선,여의도,7865,7073,14938
<class,9호선,샛강,1508,1614,3122
<class,9호선,노량진,13020,13882,26902
<class,9호선,노들,2271,1931,4202
<class,9호선,흑석,3231,3443,6674
<class,9호선,동작,1100,924,2024
<class,9호선,구반포,667,732,1399
<class,9호선,신반포,1395,1517,2912
<class,9호선,고속터미널,8717,11453,20170
<class,9호선,사평,1287,1458,2745
<class,9호선,신논현,14803,14189,28992
<class,9호선2~3단계,언주,4056,4042,8098
<class,9호선2~3단계,선정릉,2918,3447,6365
<class,9호선2~3단계,삼성중앙,1840,1932,3772
<class,9호선2~3단계,봉은사,8463,8842,17305
<class,9호선2~3단계,종합운동장,1971,1774,3745
<class,9호선2~3단계,삼전,3423,3419,6842
<class,9호선2~3단계,석촌고분,2836,2895,5731
<class,9호선2~3단계,석촌,4377,3762,8139
<class,9호선2~3단계,송파나루,3065,3348,6413
<class,9호선2~3단계,한성백제,1327,1173,2500
<class,9호선2~3단계,올림픽공원,6373,6300,12673
<class,9호선2~3단계,둔촌오륜,420,402,822
<class,9호선2~3단계,중앙보훈병원,3234,3075,6309
<class,경강선,판교,2362,2154,4516
<class,경강선,이매,590,411,1001
<class,경강선,삼동,890,916,1806
<class,경강선,경기광주,3438,3406,6844
<class,경강선,초월,1523,1446,2969
<class,경강선,곤지암,1354,1475,2829
<class,경강선,신둔도예촌,840,845,1685
<class,경강선,이천,1895,2227,4122
<class,경강선,부발,1207,1876,3083
<class,경강선,세종대왕릉,221,238,459
<class,경강선,여주,1766,1669,3435
<class,경부선,서울역,7124,1580,8704
<class,경부선,남영,3861,4076,7937
<class,경부선,용산,28960,24855,53815
<class,경부선,노량진,5108,5012,10120
<class,경부선,대방,5321,5828,11149
<class,경부선,영등포,30003,28730,58733
<class,경부선,신도림,1808,1987,3795
<class,경부선,신길,4207,3739,7946
<class,경부선,구로,9184,9228,18412
<class,경부선,가산디지털단지,4179,5953,10132
<class,경부선,금천구청,5745,5611,11356
<class,경부선,석수,4682,4272,8954
<class,경부선,관악,4490,4194,8684
<class,경부선,안양,12115,11799,23914
<class,경부선,명학,3149,3141,6290
<class,경부선,금정,12650,13098,25748
<class,경부선,군포,2855,2737,5592
<class,경부선,의왕,3728,3803,7531
<class,경부선,성균관대,6845,7018,13863
<class,경부선,화서,3714,3617,7331
<class,경부선,수원,29818,28594,58412
<class,경부선,독산,5666,5637,11303
<class,경부선,세류,1779,1820,3599
<class,경부선,병점,8210,9036,17246
<class,경부선,세마,1475,1430,2905
<class,경부선,오산대,1833,1819,3652
<class,경부선,오산,7028,7476,14504
<class,경부선,진위,760,783,1543
<class,경부선,송탄,3287,3679,6966
<class,경부선,서정리,4347,5875,10222
<class,경부선,평택지제,2266,2214,4480
<class,경부선,평택,10268,11008,21276
<class,경부선,성환,2092,2582,4674
<class,경부선,직산,541,587,1128
<class,경부선,두정,3837,4120,7957
<class,경부선,천안,5196,5182,10378
<class,경부선,당정,2749,2754,5503
<class,경부선,서동탄,606,677,1283
<class,경부선,광명,2632,1778,4410
<class,경원선,이촌,1822,1446,3268
<class,경원선,서빙고,1155,1039,2194
<class,경원선,한남,1575,1740,3315
<class,경원선,옥수,44,28,72
<class,경원선,응봉,842,814,1656
<class,2호선,서초,9905,9097,19002
<class,경원선,도봉산,7758,5409,13167
<class,경원선,왕십리,8298,9031,17329
<class,경원선,청량리,12944,11198,24142
<class,경원선,광운대,3405,3648,7053
<class,경원선,월계,3132,2945,6077
<class,경원선,녹천,2172,1876,4048
<class,경원선,방학,5350,5095,10445
<class,경원선,도봉,3155,3053,6208
<class,경원선,망월사,3976,4172,8148
<class,경원선,회룡,6676,6615,13291
<class,경원선,의정부,12921,13056,25977
<class,경원선,가능,3525,3359,6884
<class,경원선,녹양,2433,2293,4726
<class,경원선,양주,4492,4365,8857
<class,경원선,덕계,1487,1434,2921
<class,경원선,덕정,3026,3122,6148
<class,경원선,지행,4032,4006,8038
<class,경원선,동두천중앙,1903,1815,3718
<class,경원선,보산,1229,1247,2476
<class,경원선,동두천,1232,1535,2767
<class,경원선,소요산,3095,2572,5667
<class,경의선,서울역,1055,952,2007
<class,경의선,신촌,231,235,466
<class,경의선,효창공원앞,1157,1338,2495
<class,경의선,공덕,1753,1349,3102
<class,경의선,서강대,1032,1120,2152
<class,경의선,홍대입구,1291,1489,2780
<class,경의선,가좌,2487,2528,5015
<class,경의선,디지털미디어시티,1215,1106,2321
<class,경의선,수색,823,880,1703
<class,경의선,화전,677,722,1399
<class,경의선,강매,1359,1283,2642
<class,경의선,행신,3972,3718,7690
<class,경의선,능곡,2055,2010,4065
<class,경의선,곡산,289,277,566
<class,경의선,백마,2923,2857,5780
<class,경의선,풍산,3197,3086,6283
<class,경의선,일산,4008,3943,7951
<class,경의선,탄현,3658,3422,7080
<class,경의선,야당,3782,3720,7502
<class,경의선,운정,3248,3204,6452
<class,경의선,금릉,2530,2459,4989
<class,경의선,금촌,3631,3860,7491
<class,경의선,월롱,852,1723,2575
<class,경의선,파주,577,527,1104
<class,경의선,문산,2980,3072,6052
<class,경의선,임진강,61,70,131
<class,경인선,개봉,10446,10487,20933
<class,경인선,오류동,6343,5976,12319
<class,경인선,역곡,12653,12500,25153
<class,경인선,부천,19335,19098,38433
<class,경인선,송내,11569,11224,22793
<class,경인선,부평,19718,20438,40156
<class,경인선,백운,3362,3370,6732
<class,경인선,동암,8420,8357,16777
<class,경인선,주안,10274,9114,19388
<class,경인선,제물포,4864,4701,9565
<class,경인선,동인천,7915,7837,15752
<class,경인선,인천,2592,2098,4690
<class,경인선,구일,2792,2690,5482
<class,경인선,소사,5275,4941,10216
<class,경인선,부개,4125,3968,8093
<class,경인선,간석,2661,2668,5329
<class,경인선,도원,1333,1390,2723
<class,경인선,온수,3235,2971,6206
<class,경인선,중동,4352,4267,8619
<class,경인선,도화,2033,2000,4033
<class,경춘선,신내,805,780,1585
<class,경춘선,갈매,1297,1140,2437
<class,경춘선,별내,1677,1544,3221
<class,경춘선,퇴계원,1808,1660,3468
<class,경춘선,사릉,1476,1435,2911
<class,경춘선,금곡,779,756,1535
<class,경춘선,평내호평,2950,2808,5758
<class,경춘선,천마산,981,960,1941
<class,경춘선,마석,2204,2100,4304
<class,경춘선,대성리,490,384,874
<class,경춘선,청평,1257,1009,2266
<class,경춘선,상천,314,230,544
<class,경춘선,가평,1391,1028,2419
<class,경춘선,굴봉산,163,187,350
<class,경춘선,백양리,208,162,370
<class,경춘선,강촌,536,439,975
<class,경춘선,김유정,336,302,638
<class,경춘선,남춘천,2282,2469,4751
<class,경춘선,춘천,1134,1052,2186
<class,공항철도 1호선,서울역,7343,5982,13325
<class,공항철도 1호선,공덕,1120,1619,2739
<class,공항철도 1호선,홍대입구,8240,7808,16048
<class,공항철도 1호선,디지털미디어시티,3406,3364,6770
<class,공항철도 1호선,마곡나루,1840,2058,3898
<class,공항철도 1호선,김포공항,10670,5391,16061
<class,공항철도 1호선,계양,4745,4715,9460
<class,공항철도 1호선,검암,3117,3219,6336
<class,공항철도 1호선,청라국제도시,2713,2646,5359
<class,공항철도 1호선,운서,4478,4772,9250
<class,공항철도 1호선,공항화물청사,905,975,1880
<class,공항철도 1호선,인천공항1터미널,3310,3285,6595
<class,공항철도 1호선,인천공항2터미널,1636,1605,3241
<class,공항철도 1호선,영종,2035,2010,4045
<class,과천선,선바위,3385,3193,6578
<class,과천선,경마공원,7715,7749,15464
<class,과천선,대공원,2980,3095,6075
<class,과천선,과천,2933,2862,5795
<class,과천선,정부과천청사,3696,3808,7504
<class,과천선,인덕원,10650,11049,21699
<class,과천선,평촌,5903,5813,11716
<class,과천선,범계,13228,12798,26026
<class,분당선,선릉,2807,4158,6965
<class,분당선,한티,6249,6379,12628
<class,분당선,도곡,2211,2116,4327
<class,분당선,구룡,640,721,1361
<class,분당선,개포동,1733,1763,3496
<class,분당선,대모산입구,1764,1735,3499
<class,분당선,수서,7979,7609,15588
<class,분당선,수원,5185,4341,9526
<class,분당선,서울숲,4883,5064,9947
<class,분당선,압구정로데오,10007,11137,21144
<class,분당선,강남구청,3509,4095,7604
<class,분당선,선정릉,2023,2196,4219
<class,분당선,가천대,3405,4121,7526
<class,분당선,태평,7344,7038,14382
<class,분당선,모란,10433,10704,21137
<class,분당선,야탑,12395,12387,24782
<class,분당선,서현,13230,13314,26544
<class,분당선,수내,5564,5554,11118
<class,분당선,정자,6742,7019,13761
<class,분당선,미금,6836,7157,13993
<class,분당선,오리,5091,4401,9492
<class,분당선,이매,2956,3162,6118
<class,분당선,보정,954,932,1886
<class,분당선,죽전,6627,7685,14312
<class,분당선,구성,2129,2293,4422
<class,분당선,신갈,1725,1829,3554
<class,분당선,기흥,4482,4296,8778
<class,분당선,상갈,2451,2561,5012
<class,분당선,청명,1828,1871,3699
<class,분당선,영통,4158,4131,8289
<class,분당선,망포,5648,6111,11759
<class,분당선,매탄권선,2276,2202,4478
<class,분당선,수원시청,7226,7263,14489
<class,분당선,매교,1264,1315,2579
<class,수인선,고색,1533,1659,3192
<class,수인선,오목천,1343,1359,2702
<class,수인선,어천,448,543,991
<class,수인선,야목,175,142,317
<class,수인선,사리,2196,1928,4124
<class,수인선,달월,46,53,99
<class,수인선,월곶,1468,1409,2877
<class,수인선,소래포구,3810,3559,7369
<class,수인선,인천논현,2477,2616,5093
<class,수인선,호구포,1755,1832,3587
<class,수인선,남동인더스파크,471,489,960
<class,수인선,원인재,2492,2671,5163
<class,수인선,연수,2746,2700,5446
<class,수인선,송도,1294,1290,2584
<class,수인선,인하대,2521,2468,4989
<class,수인선,숭의,1726,1526,3252
<class,수인선,신포,922,963,1885
<class,수인선,인천,748,1087,1835
<class,안산선,산본,7787,8234,16021
<class,안산선,대야미,2626,2313,4939
<class,안산선,반월,2333,2286,4619
<class,안산선,상록수,8146,8127,16273
<class,안산선,한대앞,4780,4839,9619
<class,안산선,중앙,10229,10159,20388
<class,안산선,고잔,4187,4160,8347
<class,안산선,초지,2096,2024,4120
<class,안산선,안산,8415,7817,16232
<class,안산선,신길온천,1011,939,1950
<class,안산선,정왕,4567,5068,9635
<class,안산선,오이도,5068,4980,10048
<class,안산선,수리산,1904,1886,3790
<class,우이신설선,북한산우이,2607,2683,5290
<class,우이신설선,솔밭공원,1203,1186,2389
<class,우이신설선,4.19민주묘지,1747,1559,3306
<class,우이신설선,가오리,2129,2026,4155
<class,우이신설선,화계,1853,1730,3583
<class,우이신설선,삼양,1028,1034,2062
<class,우이신설선,삼양사거리,1380,1350,2730
<class,우이신설선,솔샘,2586,2400,4986
<class,우이신설선,북한산보국문,3314,3124,6438
<class,우이신설선,정릉,2471,2134,4605
<class,우이신설선,성신여대입구,1939,2272,4211
<class,우이신설선,보문,822,878,1700
<class,우이신설선,신설동,1037,1056,2093
<class,일산선,원흥,5238,4984,10222
<class,일산선,삼송,9491,9656,19147
<class,일산선,원당,5501,5302,10803
<class,일산선,화정,8503,8764,17267
<class,일산선,대곡,869,723,1592
<class,일산선,백석,5130,5075,10205
<class,일산선,마두,3142,3079,6221
<class,일산선,정발산,4514,4537,9051
<class,일산선,주엽,3997,3939,7936
<class,일산선,대화,5954,5457,11411
<class,장항선,봉명,433,449,882
<class,장항선,쌍용,1041,1116,2157
<class,장항선,아산,2998,2032,5030
<class,장항선,탕정,248,267,515
<class,장항선,배방,653,766,1419
<class,장항선,온양온천,2817,2789,5606
<class,장항선,신창,899,1063,1962
<class,중앙선,회기,13268,13495,26763
<class,중앙선,중랑,3137,3004,6141
<class,중앙선,상봉,3440,3417,6857
<class,중앙선,망우,4302,4225,8527
<class,중앙선,양원,857,907,1764
<class,중앙선,구리,6693,6995,13688
<class,중앙선,도농,4545,4493,9038
<class,중앙선,양정,414,326,740
<class,중앙선,덕소,2792,2903,5695
<class,중앙선,도심,999,851,1850
<class,중앙선,팔당,1025,1067,2092
<class,중앙선,운길산,794,626,1420
<class,중앙선,양수,1320,1222,2542
<class,중앙선,신원,211,142,353
<class,중앙선,국수,494,422,916
<class,중앙선,아신,363,391,754
<class,중앙선,오빈,169,154,323
<class,중앙선,양평,1887,1737,3624
<class,중앙선,원덕,296,263,559
<class,중앙선,용문,1507,1223,2730
<class,중앙선,지평,45,33,78
<class,경원선,외대앞,3975,3853,7828
<class,경원선,신이문,4093,3997,8090
<class,경원선,석계,4434,4762,9196
<class,1호선,종각,16261,14924,31185
<class,1호선,시청,10474,10273,20747
<class,1호선,동묘앞,7618,7786,15404
<class,1호선,서울역,29950,29731,59681
<class,1호선,종로5가,14899,14385,29284
<class,1호선,동대문,9011,8191,17202
<class,1호선,신설동,8156,7738,15894
<class,1호선,제기동,11161,11033,22194
<class,1호선,청량리,14392,14519,28911
<class,2호선,시청,8781,6998,15779
<class,2호선,을지로입구,22917,21909,44826
<class,2호선,을지로3가,10307,9747,20054
<class,2호선,을지로4가,6318,6214,12532
<class,2호선,동대문역사문화공원,9331,10166,19497
<class,2호선,신당,9898,10714,20612
<class,2호선,상왕십리,9330,9095,18425
<class,2호선,왕십리,12808,10859,23667
<class,2호선,한양대,3948,3919,7867
<class,경원선,월계,3933,3740,7673
<class,2호선,뚝섬,14157,14068,28225
<class,2호선,성수,17632,18280,35912
<class,2호선,건대입구,30754,31937,62691
<class,2호선,구의,15255,15252,30507
<class,2호선,강변,24210,24566,48776
<class,2호선,잠실나루,6933,6796,13729
<class,2호선,잠실,61401,57946,119347
<class,2호선,잠실새내,15647,15884,31531
<class,2호선,종합운동장,4990,5471,10461
<class,2호선,삼성,33263,32312,65575
<class,2호선,선릉,23041,19627,42668
<class,2호선,역삼,18907,19416,38323
<class,2호선,강남,58475,54861,113336
<class,2호선,교대,15684,17449,33133
<class,2호선,방배,9198,9579,18777
<class,2호선,사당,26566,29142,55708
<class,2호선,낙성대,19708,18671,38379
<class,2호선,서울대입구,34613,34267,68880
<class,2호선,봉천,15353,14713,30066
<class,2호선,신림,46263,45162,91425
<class,2호선,신대방,18054,18058,36112
<class,2호선,구로디지털단지,31531,31507,63038
<class,2호선,대림,15620,16432,32052
<class,2호선,신도림,37479,37437,74916
<class,2호선,문래,11467,11815,23282
<class,2호선,영등포구청,12545,12607,25152
<class,2호선,당산,10923,12156,23079
<class,2호선,합정,25133,26230,51363
<class,2호선,홍대입구,57138,57477,114615
<class,2호선,신촌,29979,28694,58673
<class,2호선,이대,9631,9971,19602
<class,2호선,아현,6910,6858,13768
<class,2호선,충정로,5508,5809,11317
<class,2호선,용답,1820,1851,3671
<class,2호선,신답,862,1037,1899
<class,2호선,신설동,3036,2977,6013
<class,2호선,도림천,730,728,1458
<class,2호선,양천구청,3894,4178,8072
<class,2호선,신정네거리,6592,6853,13445
<class,2호선,용두,1480,1487,2967
<class,3호선,지축,2513,2539,5052
<class,3호선,구파발,13548,13328,26876
<class,3호선,연신내,25141,24862,50003
<class,3호선,불광,10985,12458,23443
<class,3호선,녹번,9648,8700,18348
<class,3호선,홍제,11349,11396,22745
<class,3호선,무악재,2373,2568,4941
<class,3호선,독립문,4415,4467,8882
<class,3호선,경복궁,12221,11864,24085
<class,3호선,안국,11980,12450,24430
<class,3호선,종로3가,5256,6872,12128
<class,3호선,을지로3가,4889,4820,9709
<class,3호선,충무로,1,0,1
<class,3호선,동대입구,7319,7432,14751
<class,3호선,약수,8453,8179,16632
<class,3호선,금호,5330,5245,10575
<class,3호선,옥수,6300,6804,13104
<class,3호선,압구정,26977,26074,53051
<class,3호선,신사,25626,24549,50175
<class,3호선,잠원,3367,3348,6715
<class,3호선,고속터미널,44020,43855,87875
<class,3호선,교대,6063,3577,9640
<class,3호선,남부터미널,18849,18632,37481
<class,3호선,양재,20932,22197,43129
<class,3호선,매봉,5754,5614,11368
<class,3호선,도곡,3088,3127,6215
<class,3호선,대치,7388,7071,14459
<class,3호선,학여울,1508,1529,3037
<class,3호선,대청,5417,5028,10445
<class,3호선,일원,4446,4273,8719
<class,3호선,수서,12651,12802,25453
<class,3호선,가락시장,5498,5169,10667
<class,3호선,경찰병원,3800,3830,7630
<class,3호선,오금,3261,3122,6383
<class,4호선,수유,24092,24418,48510
<class,4호선,미아,9430,9292,18722
<class,4호선,미아사거리,20012,19742,39754
<class,4호선,길음,13029,12819,25848
<class,4호선,성신여대입구,15909,15282,31191
<class,4호선,한성대입구,9865,9647,19512
<class,4호선,혜화,25892,25881,51773
<class,4호선,동대문,11190,11033,22223
<class,4호선,동대문역사문화공원,11150,9350,20500
<class,4호선,충무로,12021,12704,24725
<class,4호선,명동,17592,19956,37548
<class,4호선,회현,18737,18974,37711
<class,4호선,서울역,5055,12745,17800
<class,4호선,숙대입구,9481,9015,18496
<class,4호선,삼각지,3181,4047,7228
<class,4호선,신용산,10799,11115,21914
<class,4호선,이촌,5569,6015,11584
<class,4호선,동작,822,940,1762
<class,4호선,총신대입구,12812,14028,26840
<class,4호선,사당,18570,16143,34713
<class,4호선,남태령,916,574,1490
<class,4호선,당고개,8455,8197,16652
<class,4호선,상계,12229,11748,23977
<class,4호선,노원,14546,15668,30214
<class,4호선,창동,17277,18460,35737
<class,4호선,쌍문,19269,18153,37422
<class,5호선,방화,4291,4167,8458
<class,5호선,개화산,3314,3320,6634
<class,5호선,김포공항,7891,7575,15466
<class,5호선,송정,4620,4643,9263
<class,5호선,마곡,5219,5199,10418
<class,5호선,발산,13717,13426,27143
<class,5호선,우장산,8854,9046,17900
<class,5호선,화곡,18797,18060,36857
<class,5호선,까치산,19153,19532,38685
<class,5호선,신정,8250,7571,15821
<class,5호선,목동,10897,11355,22252
<class,5호선,오목교,16476,16916,33392
<class,5호선,양평,3679,3639,7318
<class,5호선,영등포구청,1716,1778,3494
<class,5호선,영등포시장,7540,7754,15294
<class,5호선,신길,2461,2630,5091
<class,5호선,여의도,11666,11492,23158
<class,5호선,여의나루,5038,6002,11040
<class,5호선,마포,7315,7390,14705
<class,5호선,공덕,6599,6884,13483
<class,5호선,애오개,3660,3599,7259
<class,5호선,을지로4가,2759,2898,5657
<class,5호선,종로3가,9820,9758,19578
<class,5호선,광화문,14889,14989,29878
<class,5호선,서대문,6680,6518,13198
<class,중앙선,지평,36,56,92
<class,중앙선,용문,1241,1447,2688
<class,중앙선,원덕,261,264,525
<class,중앙선,양평,2367,2523,4890
<class,중앙선,오빈,204,218,422
<class,중앙선,아신,381,410,791
<class,중앙선,국수,473,527,1000
<class,중앙선,신원,131,120,251
<class,중앙선,양수,1309,1433,2742
<class,중앙선,운길산,560,569,1129
<class,중앙선,팔당,995,908,1903
<class,중앙선,도심,1325,1209,2534
<class,중앙선,덕소,3843,4077,7920
<class,중앙선,양정,444,363,807
<class,중앙선,도농,6183,6177,12360
<class,중앙선,구리,9202,9825,19027
<class,중앙선,양원,1144,1197,2341
<class,중앙선,망우,5588,5731,11319
<class,중앙선,상봉,4184,4265,8449
<class,중앙선,중랑,3863,3823,7686
<class,중앙선,회기,19327,18187,37514
<class,장항선,신창,882,794,1676
<class,장항선,온양온천,2764,3006,5770
<class,장항선,배방,821,745,1566
<class,장항선,탕정,297,248,545
<class,장항선,아산,2545,2509,5054
<class,장항선,쌍용,1301,1161,2462
<class,장항선,봉명,579,561,1140
<class,일산선,대화,7840,7276,15116
<class,일산선,주엽,5791,5739,11530
<class,일산선,정발산,6363,6545,12908
<class,일산선,마두,4632,4776,9408
<class,일산선,백석,7233,7361,14594
<class,일산선,대곡,1093,929,2022
<class,일산선,화정,11705,12258,23963
<class,일산선,원당,7112,7124,14236
<class,일산선,삼송,12715,9588,22303
<class,일산선,원흥,7027,6727,13754
<class,우이신설선,신설동,1217,1133,2350
<class,우이신설선,보문,1111,1100,2211
<class,우이신설선,성신여대입구,2730,3128,5858
<class,우이신설선,정릉,3161,2869,6030
<class,우이신설선,북한산보국문,4221,3999,8220
<class,우이신설선,솔샘,3531,3428,6959
<class,우이신설선,삼양사거리,1661,1671,3332
<class,우이신설선,삼양,1396,1532,2928
<class,우이신설선,가오리,2592,2575,5167
<class,우이신설선,4.19민주묘지,1875,1752,3627
<class,우이신설선,솔밭공원,1579,1520,3099
<class,우이신설선,북한산우이,2146,2088,4234
<class,안산선,수리산,2483,2160,4643
<class,안산선,오이도,6802,7215,14017
<class,안산선,정왕,6041,6275,12316
<class,안산선,신길온천,1196,1198,2394
<class,안산선,안산,8723,8912,17635
<class,안산선,초지,3107,3145,6252
<class,안산선,고잔,6061,5997,12058
<class,안산선,중앙,14948,15388,30336
<class,안산선,한대앞,6448,6673,13121
<class,안산선,상록수,11005,11662,22667
<class,안산선,반월,2913,2779,5692
<class,안산선,대야미,3197,2906,6103
<class,안산선,산본,10826,11619,22445
<class,수인선,인천,840,1355,2195
<class,수인선,신포,1417,1475,2892
<class,수인선,숭의,3266,3111,6377
<class,수인선,인하대,5290,4929,10219
<class,수인선,송도,2626,2750,5376
<class,수인선,연수,4233,4357,8590
<class,수인선,원인재,3658,4002,7660
<class,수인선,남동인더스파크,1254,978,2232
<class,수인선,호구포,3121,2983,6104
<class,수인선,인천논현,4914,5127,10041
<class,수인선,소래포구,4948,4855,9803
<class,수인선,월곶,2179,2186,4365
<class,수인선,달월,69,64,133
<class,수인선,사리,3053,2799,5852
<class,수인선,야목,209,178,387
<class,수인선,어천,559,524,1083
<class,수인선,오목천,2100,1939,4039
<class,수인선,고색,2463,2482,4945
<class,분당선,매교,1809,1964,3773
<class,분당선,수원시청,11277,11597,22874
<class,분당선,매탄권선,3349,3286,6635
<class,분당선,망포,9396,8836,18232
<class,분당선,영통,7631,6999,14630
<class,분당선,청명,2725,2741,5466
<class,분당선,상갈,3438,3542,6980
<class,분당선,기흥,6582,6524,13106
<class,분당선,신갈,2622,2705,5327
<class,분당선,구성,3071,3432,6503
<class,분당선,죽전,9943,11006,20949
<class,분당선,보정,1446,1334,2780
<class,분당선,이매,3905,3994,7899
<class,분당선,오리,7720,6282,14002
<class,분당선,미금,10465,10744,21209
<class,분당선,정자,10202,10640,20842
<class,분당선,수내,8542,8052,16594
<class,분당선,서현,18836,18425,37261
<class,분당선,야탑,17019,17753,34772
<class,분당선,모란,14572,14830,29402
<class,분당선,태평,9713,9612,19325
<class,분당선,가천대,4956,5453,10409
<class,분당선,선정릉,3526,3520,7046
<class,분당선,강남구청,5977,6956,12933
<class,분당선,압구정로데오,20460,20344,40804
<class,분당선,서울숲,6629,6746,13375
<class,분당선,수원,6971,6055,13026
<class,분당선,복정,2,0,2
<class,분당선,수서,9961,10579,20540
<class,분당선,대모산입구,2852,2669,5521
<class,분당선,개포동,2422,2432,4854
<class,분당선,구룡,1143,1057,2200
<class,분당선,도곡,4359,4044,8403
<class,분당선,한티,10788,10511,21299
<class,분당선,선릉,5196,7893,13089
<class,과천선,범계,18942,18430,37372
<class,과천선,평촌,9001,8917,17918
<class,과천선,인덕원,14589,15001,29590
<class,과천선,정부과천청사,5378,5408,10786
<class,과천선,과천,4004,3853,7857
<class,과천선,대공원,1877,1942,3819
<class,과천선,경마공원,6848,6680,13528
<class,과천선,선바위,4393,3917,8310
<class,공항철도 1호선,영종,2516,2708,5224
<class,공항철도 1호선,인천공항2터미널,2081,1995,4076
<class,공항철도 1호선,인천공항1터미널,3887,4067,7954
<class,공항철도 1호선,공항화물청사,1402,1321,2723
<class,공항철도 1호선,운서,5691,5697,11388
<class,공항철도 1호선,청라국제도시,3674,3775,7449
<class,공항철도 1호선,검암,3991,4008,7999
<class,공항철도 1호선,계양,6006,6018,12024
<class,공항철도 1호선,김포공항,11382,5883,17265
<class,공항철도 1호선,마곡나루,2571,2726,5297
<class,공항철도 1호선,디지털미디어시티,5441,4966,10407
<class,공항철도 1호선,홍대입구,10698,10595,21293
<class,공항철도 1호선,공덕,1437,2284,3721
<class,공항철도 1호선,서울역,7376,7327,14703
<class,경춘선,춘천,964,916,1880
<class,경춘선,남춘천,1900,2001,3901
<class,경춘선,김유정,231,254,485
<class,경춘선,강촌,344,353,697
<class,경춘선,백양리,242,195,437
<class,경춘선,굴봉산,109,156,265
<class,경춘선,가평,1234,1297,2531
<class,경춘선,상천,139,156,295
<class,경춘선,청평,1092,1254,2346
<class,경춘선,대성리,316,348,664
<class,경춘선,마석,2627,2809,5436
<class,경춘선,천마산,1046,1106,2152
<class,경춘선,평내호평,3786,3754,7540
<class,경춘선,금곡,888,832,1720
<class,경춘선,사릉,1931,2026,3957
<class,경춘선,퇴계원,2224,2095,4319
<class,경춘선,별내,2129,2119,4248
<class,경춘선,갈매,1792,1509,3301
<class,경춘선,신내,1067,1002,2069
<class,경인선,도화,3614,3513,7127
<class,경인선,중동,6433,6214,12647
<class,경인선,온수,4311,4072,8383
<class,경인선,도원,2155,1977,4132
<class,경인선,간석,4919,4575,9494
<class,경인선,부개,6230,5974,12204
<class,경인선,소사,7038,6867,13905
<class,경인선,구일,7655,8105,15760
<class,경인선,인천,2774,2098,4872
<class,경인선,동인천,11145,10953,22098
<class,경인선,제물포,8463,7990,16453
<class,경인선,주안,16283,14593,30876
<class,경인선,동암,11485,12698,24183
<class,경인선,백운,5564,5502,11066
<class,경인선,부평,28468,30318,58786
<class,경인선,송내,16905,16990,33895
<class,경인선,부천,27154,28077,55231
<class,경인선,역곡,19037,18939,37976
<class,경인선,오류동,8123,7830,15953
<class,경인선,개봉,14668,15101,29769
<class,경의선,임진강,52,51,103
<class,경의선,문산,3763,3655,7418
<class,경의선,파주,722,484,1206
<class,경의선,월롱,1408,1233,2641
<class,경의선,금촌,4883,4845,9728
<class,경의선,금릉,3391,3373,6764
<class,경의선,운정,4571,4435,9006
<class,경의선,야당,5409,5465,10874
<class,경의선,탄현,4936,5005,9941
<class,경의선,일산,5935,5950,11885
<class,경의선,풍산,3909,3809,7718
<class,경의선,백마,4044,4042,8086
<class,경의선,곡산,300,323,623
<class,경의선,능곡,2426,2417,4843
<class,경의선,행신,4874,5014,9888
<class,경의선,강매,1751,1717,3468
<class,경의선,화전,2422,2028,4450
<class,경의선,수색,1340,1305,2645
<class,경의선,디지털미디어시티,1672,1623,3295
<class,경의선,가좌,3442,3489,6931
<class,경의선,홍대입구,1625,2013,3638
<class,경의선,서강대,1597,1513,3110
<class,경의선,공덕,2635,1894,4529
<class,경의선,효창공원앞,1800,1852,3652
<class,경의선,신촌,341,413,754
<class,경의선,서울역,1233,1276,2509
<class,경원선,소요산,1991,1746,3737
<class,경원선,동두천,1290,1535,2825
<class,경원선,보산,1682,1666,3348
<class,경원선,동두천중앙,2092,2154,4246
<class,경원선,지행,4904,5017,9921
<class,경원선,덕정,3919,3762,7681
<class,경원선,덕계,2089,1897,3986
<class,경원선,양주,5347,5288,10635
<class,경원선,녹양,2997,2989,5986
<class,경원선,가능,4428,4344,8772
<class,경원선,의정부,16972,17384,34356
<class,경원선,회룡,8225,8125,16350
<class,경원선,망월사,4717,5046,9763
<class,경원선,도봉산,5736,3878,9614
<class,경원선,도봉,3819,3649,7468
<class,경원선,방학,6269,6316,12585
<class,경원선,창동,1,0,1
<class,경원선,녹천,2831,2387,5218
<class,경원선,광운대,4815,4795,9610
<class,경원선,석계,5540,6148,11688
<class,경원선,신이문,5376,5056,10432
<class,경원선,외대앞,5341,5199,10540
<class,경원선,청량리,14261,15346,29607
<class,경원선,왕십리,11697,13403,25100
<class,경원선,응봉,1146,1008,2154
<class,경원선,옥수,33,31,64
<class,경원선,한남,2617,2370,4987
<class,경원선,서빙고,1324,1261,2585
<class,경원선,이촌,2562,2023,4585
<class,경부선,광명,2803,2538,5341
<class,경부선,서동탄,817,891,1708
<class,경부선,당정,3572,3486,7058
<class,경부선,천안,4776,5025,9801
<class,경부선,두정,4481,4334,8815
<class,경부선,직산,550,523,1073
<class,경부선,성환,2360,2132,4492
<class,경부선,평택,11486,10949,22435
<class,경부선,평택지제,2907,2655,5562
<class,경부선,서정리,6109,5084,11193
<class,경부선,송탄,4302,3959,8261
<class,경부선,진위,872,833,1705
<class,경부선,오산,8100,7984,16084
<class,경부선,오산대,2282,2142,4424
<class,경부선,세마,1826,1652,3478
<class,경부선,병점,10879,11144,22023
<class,경부선,세류,2220,2252,4472
<class,경부선,독산,8286,8347,16633
<class,경부선,수원,34567,37045,71612
<class,경부선,화서,4752,4913,9665
<class,경부선,성균관대,9323,9474,18797
<class,경부선,의왕,5279,5339,10618
<class,경부선,군포,3843,3528,7371
<class,경부선,금정,16752,17093,33845
<class,경부선,명학,4669,4611,9280
<class,경부선,안양,15866,16079,31945
<class,경부선,관악,4866,4776,9642
<class,경부선,석수,5875,5496,11371
<class,경부선,금천구청,7226,7555,14781
<class,경부선,가산디지털단지,5738,7661,13399
<class,경부선,구로,13084,13105,26189
<class,경부선,신길,5560,4702,10262
<class,경부선,신도림,2506,2554,5060
<class,경부선,영등포,39435,39765,79200
<class,경부선,대방,7908,7645,15553
<class,경부선,노량진,7259,6855,14114
<class,경부선,용산,34565,36357,70922
<class,경부선,남영,5286,5728,11014
<class,경부선,서울역,6309,1972,8281
<class,경강선,여주,1755,1882,3637
<class,경강선,세종대왕릉,221,253,474
<class,경강선,부발,1722,1415,3137
<class,경강선,이천,2405,2571,4976
<class,경강선,신둔도예촌,986,964,1950
<class,경강선,곤지암,1613,1588,3201
<class,경강선,초월,2124,2135,4259
<class,경강선,경기광주,5117,5357,10474
<class,경강선,삼동,1491,1437,2928
<class,경강선,이매,724,566,1290
<class,경강선,판교,3075,2949,6024
<class,9호선2~3단계,중앙보훈병원,3970,3783,7753
<class,9호선2~3단계,둔촌오륜,630,609,1239
<class,9호선2~3단계,올림픽공원,10218,9569,19787
<class,9호선2~3단계,한성백제,1915,1626,3541
<class,9호선2~3단계,송파나루,4082,4557,8639
<class,9호선2~3단계,석촌,6181,5324,11505
<class,9호선2~3단계,석촌고분,4207,4204,8411
<class,9호선2~3단계,삼전,4943,4948,9891
<class,9호선2~3단계,종합운동장,2906,2673,5579
<class,9호선2~3단계,봉은사,13450,13656,27106
<class,9호선2~3단계,삼성중앙,3200,3242,6442
<class,9호선2~3단계,선정릉,4600,5174,9774
<class,9호선2~3단계,언주,6880,6711,13591
<class,9호선,신논현,25854,24234,50088
<class,9호선,사평,2311,2268,4579
<class,9호선,고속터미널,11373,15732,27105
<class,9호선,신반포,2509,2356,4865
<class,9호선,구반포,1377,1276,2653
<class,9호선,동작,1233,1021,2254
<class,9호선,흑석,5174,5376,10550
<class,9호선,노들,2966,2754,5720
<class,9호선,노량진,20094,18941,39035
<class,9호선,샛강,2449,2436,4885
<class,9호선,여의도,11942,10611,22553
<class,9호선,국회의사당,5079,5138,10217
<class,9호선,당산,12143,11503,23646
<class,9호선,선유도,4001,3860,7861
<class,9호선,신목동,2116,1983,4099
<class,9호선,염창,11023,10718,21741
<class,9호선,등촌,7295,7165,14460
<class,9호선,증미,3964,3926,7890
<class,9호선,가양,13359,12780,26139
<class,9호선,양천향교,5740,5626,11366
<class,9호선,마곡나루,7411,7304,14715
<class,9호선,신방화,4537,4517,9054
<class,9호선,공항시장,2078,2275,4353
<class,9호선,김포공항,8113,12698,20811
<class,9호선,개화,1208,945,2153
<class,8호선,남위례,2903,3235,6138
<class,8호선,모란,3448,3042,6490
<class,8호선,수진,4035,3697,7732
<class,8호선,신흥,3533,3805,7338
<class,8호선,단대오거리,7225,7032,14257
<class,8호선,남한산성입구,8445,7961,16406
<class,8호선,산성,3807,4033,7840
<class,8호선,복정,6136,5267,11403
<class,8호선,장지,12203,11517,23720
<class,8호선,문정,8835,8744,17579
<class,8호선,가락시장,5236,5291,10527
<class,8호선,송파,4958,5048,10006
<class,8호선,석촌,5913,6992,12905
<class,8호선,잠실,14260,15852,30112
<class,8호선,몽촌토성,4303,4330,8633
<class,8호선,강동구청,5990,6284,12274
<class,8호선,천호,11855,14105,25960
<class,8호선,암사,11730,11147,22877
<class,7호선,부평구청,4880,4567,9447
<class,7호선,굴포천,7133,7457,14590
<class,7호선,삼산체육관,3792,3660,7452
<class,7호선,상동,11561,11546,23107
<class,7호선,부천시청,10495,10170,20665
<class,7호선,신중동,10010,10105,20115
<class,7호선,춘의,5235,5029,10264
<class,7호선,부천종합운동장,3178,2900,6078
<class,7호선,까치울,4677,4975,9652
<class,7호선,온수,5008,5240,10248
<class,7호선,천왕,6141,6025,12166
<class,7호선,광명사거리,15249,15493,30742
<class,7호선,철산,14338,14627,28965
<class,7호선,가산디지털단지,14292,12470,26762
<class,7호선,남구로,7886,8303,16189
<class,7호선,대림,6289,6650,12939
<class,7호선,신풍,7062,7071,14133
<class,7호선,보라매,6068,5670,11738
<class,7호선,신대방삼거리,10698,10236,20934
<class,7호선,장승배기,6241,6032,12273
<class,7호선,상도,6735,6638,13373
<class,7호선,숭실대입구,7878,7939,15817
<class,7호선,남성,7342,7107,14449
<class,7호선,이수,11499,10776,22275
<class,7호선,내방,7477,7410,14887
<class,7호선,고속터미널,12594,9793,22387
<class,7호선,반포,4195,3880,8075
<class,7호선,논현,11577,11352,22929
<class,7호선,학동,11999,12036,24035
<class,7호선,강남구청,10304,10585,20889
<class,7호선,청담,11850,11942,23792
<class,7호선,뚝섬유원지,4958,4915,9873
<class,7호선,건대입구,10698,10791,21489
<class,7호선,어린이대공원,8961,8501,17462
<class,7호선,군자,9996,7809,17805
<class,7호선,중곡,6537,6453,12990
<class,7호선,용마산,3878,3991,7869
<class,7호선,사가정,10925,11063,21988
<class,7호선,면목,10034,10432,20466
<class,7호선,상봉,12557,12093,24650
<class,7호선,중화,6846,6949,13795
<class,7호선,먹골,7555,7601,15156
<class,7호선,태릉입구,5939,5504,11443
<class,7호선,공릉,8135,8064,16199
<class,7호선,하계,10842,10475,21317
<class,7호선,중계,8200,7697,15897
<class,7호선,노원,15007,15091,30098
<class,7호선,마들,7953,7759,15712
<class,7호선,수락산,8461,8455,16916
<class,7호선,도봉산,5689,7144,12833
<class,7호선,장암,1316,733,2049
<class,6호선,봉화산,4625,4692,9317
<class,6호선,화랑대,6273,5368,11641
<class,6호선,태릉입구,3688,3875,7563
<class,6호선,석계,7882,8132,16014
<class,6호선,돌곶이,5720,5470,11190
<class,6호선,상월곡,3819,3424,7243
<class,6호선,월곡,6956,6752,13708
<class,6호선,고려대,4979,4953,9932
<class,6호선,안암,6859,6071,12930
<class,6호선,보문,4963,4600,9563
<class,6호선,창신,1918,1796,3714
<class,6호선,동묘앞,6549,6290,12839
<class,6호선,신당,6778,5595,12373
<class,6호선,청구,2340,2201,4541
<class,6호선,약수,2244,2244,4488
<class,6호선,버티고개,1425,1488,2913
<class,6호선,한강진,9234,10065,19299
<class,6호선,이태원,10549,10732,21281
<class,6호선,녹사평,4315,4603,8918
<class,6호선,삼각지,4690,3592,8282
<class,6호선,효창공원앞,4562,4311,8873
<class,6호선,공덕,9419,8953,18372
<class,6호선,대흥,5098,5040,10138
<class,6호선,광흥창,4977,4839,9816
<class,6호선,상수,7777,8503,16280
<class,6호선,합정,11027,10034,21061
<class,6호선,망원,11595,12313,23908
<class,6호선,마포구청,8837,8191,17028
<class,6호선,월드컵경기장,3341,3549,6890
<class,6호선,디지털미디어시티,6576,6919,13495
<class,6호선,증산,6978,7103,14081
<class,6호선,새절,7816,7850,15666
<class,6호선,구산,4930,3888,8818
<class,6호선,연신내,2,0,2
<class,6호선,독바위,1724,2038,3762
<class,6호선,불광,3662,3247,6909
<class,6호선,역촌,2715,3069,5784
<class,6호선,응암,11552,11870,23422
<class,5호선,하남검단산,4486,4516,9002
<class,5호선,하남시청,4798,4846,9644
<class,5호선,하남풍산,2631,2773,5404
<class,5호선,미사,11721,11787,23508
<class,5호선,강일,2496,2524,5020
<class,5호선,마천,4210,4562,8772
<class,5호선,거여,5417,5276,10693
<class,5호선,개롱,3952,4220,8172
<class,5호선,오금,1917,1821,3738
<class,5호선,방이,4999,4920,9919
<class,5호선,올림픽공원,4138,3883,8021
<class,5호선,둔촌동,6108,6130,12238
<class,5호선,상일동,9236,9046,18282
<class,5호선,고덕,6239,6006,12245
<class,5호선,명일,6180,6118,12298
<class,5호선,굽은다리,7571,7253,14824
<class,5호선,길동,6136,6169,12305
<class,5호선,강동,12375,11865,24240
<class,5호선,천호,16308,14820,31128
<class,5호선,광나루,9111,8575,17686
<class,5호선,아차산,10201,10107,20308
<class,5호선,군자,7843,8983,16826
<class,5호선,장한평,10486,10861,21347
<class,5호선,답십리,9692,9349,19041
<class,5호선,마장,3732,3666,7398
<class,5호선,왕십리,3562,4044,7606
<class,5호선,행당,5024,4632,9656
<class,5호선,신금호,3975,4030,8005
<class,5호선,청구,2281,2288,4569
<class,5호선,동대문역사문화공원,1038,1376,2414
<class,2호선,서초,10322,8657,18979
<class,우이신설선,화계,2110,2099,4209
<class,5호선,충정로,1866,1811,3677
<class,1호선,종로3가,17272,16091,33363
<class,경인선,도원,1552,1624,3176
<class,5호선,둔촌동,4359,4464,8823
<class,1호선,서울역,26690,23988,50678
<class,1호선,동묘앞,8845,9053,17898
<class,1호선,시청,7696,6993,14689
<class,1호선,종각,10694,9479,20173
<class,1호선,종로3가,11456,10022,21478
<class,1호선,종로5가,7293,7106,14399
<class,1호선,동대문,7624,7964,15588
<class,1호선,신설동,6608,6428,13036
<class,1호선,제기동,7776,8105,15881
<class,1호선,청량리,10589,10678,21267
<class,2호선,시청,5725,4601,10326
<class,2호선,을지로입구,17811,16212,34023
<class,2호선,을지로3가,7746,7346,15092
<class,2호선,을지로4가,3289,3031,6320
<class,2호선,동대문역사문화공원,7251,8696,15947
<class,2호선,신당,7349,7846,15195
<class,2호선,상왕십리,6706,6613,13319
<class,2호선,왕십리,8986,8047,17033
<class,2호선,한양대,2240,2429,4669
<class,2호선,뚝섬,11079,10928,22007
<class,2호선,성수,12801,13829,26630
<class,2호선,건대입구,24240,25115,49355
<class,2호선,구의,10801,10907,21708
<class,2호선,강변,19317,19105,38422
<class,2호선,잠실나루,5007,5129,10136
<class,2호선,잠실,48123,45270,93393
<class,2호선,잠실새내,10239,10546,20785
<class,2호선,종합운동장,4379,4749,9128
<class,2호선,삼성,22864,22445,45309
<class,2호선,선릉,13206,11524,24730
<class,2호선,역삼,11544,12388,23932
<class,2호선,강남,33169,32132,65301
<class,2호선,교대,9672,10767,20439
<class,2호선,서초,10425,9813,20238
<class,2호선,방배,6514,6847,13361
<class,2호선,사당,19490,21753,41243
<class,2호선,낙성대,15021,15118,30139
<class,2호선,서울대입구,25606,26307,51913
<class,2호선,봉천,11186,10871,22057
<class,2호선,신림,35290,34804,70094
<class,2호선,신대방,14251,13982,28233
<class,2호선,구로디지털단지,22462,22648,45110
<class,2호선,대림,12715,12808,25523
<class,2호선,신도림,27456,27887,55343
<class,2호선,문래,7586,7901,15487
<class,2호선,영등포구청,8332,8838,17170
<class,2호선,당산,7883,8753,16636
<class,2호선,합정,18845,19633,38478
<class,2호선,홍대입구,44317,43782,88099
<class,2호선,신촌,20919,20267,41186
<class,2호선,이대,8677,8961,17638
<class,2호선,아현,4695,4700,9395
<class,2호선,충정로,3717,3986,7703
<class,2호선,용답,1513,1552,3065
<class,2호선,신답,671,746,1417
<class,2호선,신설동,2551,2717,5268
<class,2호선,도림천,428,434,862
<class,2호선,양천구청,2953,3136,6089
<class,2호선,신정네거리,4609,4773,9382
<class,2호선,용두,1060,1039,2099
<class,3호선,지축,1977,1894,3871
<class,3호선,구파발,10389,10577,20966
<class,3호선,연신내,19101,18069,37170
<class,3호선,불광,8673,9838,18511
<class,3호선,녹번,6980,6150,13130
<class,3호선,홍제,8078,7745,15823
<class,3호선,무악재,1656,1775,3431
<class,3호선,독립문,3281,3495,6776
<class,3호선,경복궁,9364,9514,18878
<class,3호선,안국,8939,9478,18417
<class,3호선,종로3가,3444,4477,7921
<class,3호선,을지로3가,3113,2946,6059
<class,3호선,충무로,1,0,1
<class,3호선,동대입구,5992,6374,12366
<class,3호선,약수,6014,5896,11910
<class,3호선,금호,3859,3793,7652
<class,3호선,옥수,4385,4728,9113
<class,3호선,압구정,13271,13943,27214
<class,3호선,신사,13305,13349,26654
<class,3호선,잠원,1881,2020,3901
<class,3호선,고속터미널,35916,34251,70167
<class,3호선,교대,3671,2275,5946
<class,3호선,남부터미널,12593,13252,25845
<class,3호선,양재,13584,15616,29200
<class,3호선,매봉,3956,4057,8013
<class,3호선,도곡,1879,2020,3899
<class,3호선,대치,4446,4198,8644
<class,3호선,학여울,1232,1309,2541
<class,3호선,대청,3968,3865,7833
<class,3호선,일원,3060,3272,6332
<class,3호선,수서,9858,9877,19735
<class,3호선,가락시장,3513,3557,7070
<class,3호선,경찰병원,2580,2655,5235
<class,3호선,오금,2516,2439,4955
<class,4호선,수유,18334,17883,36217
<class,4호선,미아,7124,6873,13997
<class,4호선,미아사거리,14956,14472,29428
<class,4호선,길음,9491,9369,18860
<class,4호선,성신여대입구,12131,11338,23469
<class,4호선,한성대입구,7084,7061,14145
<class,4호선,혜화,20064,20653,40717
<class,4호선,동대문,5590,6333,11923
<class,4호선,동대문역사문화공원,8493,7916,16409
<class,4호선,충무로,7835,8046,15881
<class,4호선,명동,15303,15299,30602
<class,4호선,회현,10217,10734,20951
<class,4호선,서울역,3994,9668,13662
<class,4호선,숙대입구,6411,6302,12713
<class,4호선,삼각지,2285,2943,5228
<class,4호선,신용산,8094,8303,16397
<class,4호선,이촌,4193,4532,8725
<class,4호선,동작,672,773,1445
<class,4호선,총신대입구,9058,10069,19127
<class,4호선,사당,13864,12959,26823
<class,4호선,남태령,645,490,1135
<class,4호선,당고개,6883,6577,13460
<class,4호선,상계,9163,8790,17953
<class,4호선,노원,10748,11810,22558
<class,4호선,창동,13913,14576,28489
<class,4호선,쌍문,14504,13217,27721
<class,5호선,방화,3310,3307,6617
<class,5호선,개화산,2471,2552,5023
<class,5호선,김포공항,7214,6834,14048
<class,5호선,송정,3318,3273,6591
<class,5호선,마곡,3363,3470,6833
<class,5호선,발산,8581,8932,17513
<class,5호선,우장산,6249,6472,12721
<class,5호선,화곡,13284,12634,25918
<class,5호선,까치산,14463,14296,28759
<class,5호선,신정,6039,5427,11466
<class,5호선,목동,7458,7606,15064
<class,5호선,오목교,11083,11652,22735
<class,5호선,양평,2655,2754,5409
<class,5호선,영등포구청,1192,1257,2449
<class,5호선,영등포시장,5061,5188,10249
<class,5호선,신길,1725,2016,3741
<class,5호선,여의도,7498,7543,15041
<class,5호선,여의나루,4275,5152,9427
<class,5호선,마포,4549,4566,9115
<class,5호선,공덕,4262,4450,8712
<class,5호선,애오개,2512,2501,5013
<class,5호선,충정로,1331,1308,2639
<class,5호선,서대문,4654,4598,9252
<class,5호선,광화문,10892,11123,22015
<class,5호선,종로3가,7320,6450,13770
<class,5호선,을지로4가,1367,1439,2806
<class,5호선,동대문역사문화공원,697,833,1530
<class,5호선,청구,1555,1548,3103
<class,5호선,신금호,2812,2992,5804
<class,5호선,행당,3692,3384,7076
<class,5호선,왕십리,2489,2922,5411
<class,5호선,마장,2638,2470,5108
<class,5호선,답십리,7014,6652,13666
<class,5호선,장한평,7466,7403,14869
<class,5호선,군자,5959,6614,12573
<class,5호선,아차산,8348,8135,16483
<class,5호선,광나루,7342,7042,14384
<class,5호선,천호,12337,11514,23851
<class,5호선,강동,8796,8779,17575
<class,5호선,길동,4058,4135,8193
<class,5호선,굽은다리,5824,5673,11497
<class,5호선,명일,4599,4595,9194
<class,5호선,고덕,4205,4421,8626
<class,5호선,상일동,6981,6597,13578
<class,5호선,올림픽공원,3023,2994,6017
<class,5호선,방이,3535,3587,7122
<class,5호선,오금,1497,1402,2899
<class,5호선,개롱,2833,3104,5937
<class,5호선,거여,3964,3858,7822
<class,5호선,마천,3422,3556,6978
<class,5호선,강일,1899,1844,3743
<class,5호선,미사,8594,8598,17192
<class,5호선,하남풍산,2139,2132,4271
<class,5호선,하남시청,3719,3643,7362
<class,5호선,하남검단산,4260,4200,8460
<class,6호선,응암,8885,8698,17583
<class,6호선,역촌,1881,2151,4032
<class,6호선,불광,2874,2555,5429
<class,6호선,독바위,1381,1666,3047
<class,6호선,구산,3558,2662,6220
<class,6호선,새절,5976,5790,11766
<class,6호선,증산,5264,5258,10522
<class,6호선,디지털미디어시티,4727,5072,9799
<class,6호선,월드컵경기장,2929,3100,6029
<class,6호선,마포구청,6945,6489,13434
<class,6호선,망원,8522,9197,17719
<class,6호선,합정,8627,7702,16329
<class,6호선,상수,5330,6146,11476
<class,6호선,광흥창,4174,4130,8304
<class,6호선,대흥,3629,3744,7373
<class,6호선,공덕,6529,6231,12760
<class,6호선,효창공원앞,3146,2897,6043
<class,6호선,삼각지,3322,2692,6014
<class,6호선,녹사평,3338,3271,6609
<class,6호선,이태원,8074,7602,15676
<class,6호선,한강진,6491,7166,13657
<class,6호선,버티고개,952,1034,1986
<class,6호선,약수,1543,1515,3058
<class,6호선,청구,1654,1512,3166
<class,6호선,신당,3827,4447,8274
<class,6호선,동묘앞,4842,4924,9766
<class,6호선,창신,1520,1313,2833
<class,6호선,보문,3696,3422,7118
<class,6호선,안암,5696,5860,11556
<class,6호선,고려대,4001,3711,7712
<class,6호선,월곡,5070,4977,10047
<class,6호선,상월곡,2911,2598,5509
<class,6호선,돌곶이,4584,4340,8924
<class,6호선,석계,5885,6180,12065
<class,6호선,태릉입구,2804,2970,5774
<class,6호선,화랑대,4912,4129,9041
<class,6호선,봉화산,3702,3484,7186
<class,7호선,장암,1031,644,1675
<class,7호선,도봉산,4934,6283,11217
<class,7호선,수락산,6992,6841,13833
<class,7호선,마들,5674,5299,10973
<class,7호선,노원,10507,10345,20852
<class,7호선,중계,5979,5641,11620
<class,7호선,하계,8578,8233,16811
<class,7호선,공릉,6144,6163,12307
<class,7호선,태릉입구,4393,4107,8500
<class,7호선,먹골,5142,5109,10251
<class,7호선,중화,5214,4971,10185
<class,7호선,상봉,8805,8536,17341
<class,7호선,면목,7292,7056,14348
<class,7호선,사가정,8098,8010,16108
<class,7호선,용마산,2959,2975,5934
<class,7호선,중곡,5041,4882,9923
<class,7호선,군자,7106,5640,12746
<class,7호선,어린이대공원,6752,6546,13298
<class,7호선,건대입구,7877,7989,15866
<class,7호선,뚝섬유원지,3861,3696,7557
<class,7호선,청담,6371,6901,13272
<class,7호선,강남구청,5578,6238,11816
<class,7호선,학동,6463,7014,13477
<class,7호선,논현,5630,6191,11821
<class,7호선,반포,2697,2634,5331
<class,7호선,고속터미널,10522,7234,17756
<class,7호선,내방,4920,4996,9916
<class,7호선,이수,8332,7930,16262
<class,7호선,남성,5088,5039,10127
<class,7호선,숭실대입구,5170,5438,10608
<class,7호선,상도,4928,4842,9770
<class,7호선,장승배기,4741,4785,9526
<class,7호선,신대방삼거리,7463,7420,14883
<class,7호선,보라매,4013,3959,7972
<class,7호선,신풍,5510,5254,10764
<class,7호선,대림,5778,5492,11270
<class,7호선,남구로,6156,5913,12069
<class,7호선,가산디지털단지,9874,9387,19261
<class,7호선,철산,9911,9788,19699
<class,7호선,광명사거리,11373,11366,22739
<class,7호선,천왕,4573,4497,9070
<class,7호선,온수,3671,3719,7390
<class,7호선,까치울,3645,3754,7399
<class,7호선,부천종합운동장,2461,2174,4635
<class,7호선,춘의,3394,3194,6588
<class,7호선,신중동,6755,6660,13415
<class,7호선,부천시청,7103,6872,13975
<class,7호선,상동,7352,7319,14671
<class,7호선,삼산체육관,2521,2347,4868
<class,7호선,굴포천,4720,4815,9535
<class,7호선,부평구청,3573,3165,6738
<class,8호선,암사,8763,8135,16898
<class,8호선,천호,8828,10325,19153
<class,8호선,강동구청,4800,4830,9630
<class,8호선,몽촌토성,3167,3227,6394
<class,8호선,잠실,11159,12707,23866
<class,8호선,석촌,4160,5117,9277
<class,8호선,송파,3586,3742,7328
<class,8호선,가락시장,3070,3942,7012
<class,8호선,문정,5624,5961,11585
<class,8호선,장지,9679,9877,19556
<class,8호선,복정,4426,4153,8579
<class,8호선,산성,2965,2895,5860
<class,8호선,남한산성입구,6396,5964,12360
<class,8호선,단대오거리,5349,5340,10689
<class,8호선,신흥,2669,2951,5620
<class,8호선,수진,3078,2845,5923
<class,8호선,모란,3427,2910,6337
<class,8호선,남위례,2178,2380,4558
<class,9호선,개화,850,861,1711
<class,9호선,김포공항,7588,11978,19566
<class,9호선,공항시장,1675,1829,3504
<class,9호선,신방화,3223,3269,6492
<class,9호선,마곡나루,5490,5350,10840
<class,9호선,양천향교,3849,4224,8073
<class,9호선,가양,9534,9456,18990
<class,9호선,증미,2894,2928,5822
<class,9호선,등촌,5029,5144,10173
<class,9호선,염창,7971,7928,15899
<class,9호선,신목동,1594,1481,3075
<class,9호선,선유도,2567,2601,5168
<class,9호선,당산,8510,8491,17001
<class,9호선,국회의사당,4247,4008,8255
<class,9호선,여의도,8382,7700,16082
<class,9호선,샛강,1495,1648,3143
<class,9호선,노량진,13508,14095,27603
<class,9호선,노들,2302,2019,4321
<class,9호선,흑석,3409,3540,6949
<class,9호선,동작,978,807,1785
<class,9호선,구반포,550,540,1090
<class,9호선,신반포,1588,1670,3258
<class,9호선,고속터미널,8945,12128,21073
<class,9호선,사평,1515,1590,3105
<class,9호선,신논현,15070,14395,29465
<class,9호선2~3단계,언주,4120,4204,8324
<class,9호선2~3단계,선정릉,2956,3352,6308
<class,9호선2~3단계,삼성중앙,1900,2015,3915
<class,9호선2~3단계,봉은사,9561,9524,19085
<class,9호선2~3단계,종합운동장,1997,1783,3780
<class,9호선2~3단계,삼전,3522,3466,6988
<class,9호선2~3단계,석촌고분,3050,2996,6046
<class,9호선2~3단계,석촌,4490,3749,8239
<class,9호선2~3단계,송파나루,2997,3238,6235
<class,9호선2~3단계,한성백제,1409,1286,2695
<class,9호선2~3단계,올림픽공원,7557,7348,14905
<class,9호선2~3단계,둔촌오륜,458,445,903
<class,9호선2~3단계,중앙보훈병원,3079,2911,5990
<class,경강선,판교,2416,2322,4738
<class,경강선,이매,579,468,1047
<class,경강선,삼동,979,968,1947
<class,경강선,경기광주,3704,3605,7309
<class,경강선,초월,1551,1534,3085
<class,경강선,곤지암,1335,1369,2704
<class,경강선,신둔도예촌,744,741,1485
<class,경강선,이천,1907,2090,3997
<class,경강선,부발,1259,1887,3146
<class,경강선,세종대왕릉,232,199,431
<class,경강선,여주,1683,1557,3240
<class,경부선,서울역,7250,1749,8999
<class,경부선,남영,4173,4366,8539
<class,경부선,용산,32037,28885,60922
<class,경부선,노량진,5117,4980,10097
<class,경부선,대방,5378,5852,11230
<class,경부선,영등포,32030,31265,63295
<class,경부선,신도림,1910,1960,3870
<class,경부선,신길,4218,3655,7873
<class,경부선,구로,9034,9219,18253
<class,경부선,가산디지털단지,4423,6109,10532
<class,경부선,금천구청,5482,5566,11048
<class,경부선,석수,4538,4375,8913
<class,경부선,관악,4057,3760,7817
<class,경부선,안양,12248,11839,24087
<class,경부선,명학,3310,3273,6583
<class,경부선,금정,12387,12828,25215
<class,경부선,군포,2665,2606,5271
<class,경부선,의왕,3908,4031,7939
<class,경부선,성균관대,7154,7639,14793
<class,경부선,화서,3758,3735,7493
<class,경부선,수원,32332,31020,63352
<class,경부선,독산,5780,5851,11631
<class,경부선,세류,1890,1844,3734
<class,경부선,병점,8571,9305,17876
<class,경부선,세마,1468,1435,2903
<class,경부선,오산대,1882,1794,3676
<class,경부선,오산,7005,7612,14617
<class,경부선,진위,788,785,1573
<class,경부선,송탄,3512,4025,7537
<class,경부선,서정리,4298,5847,10145
<class,경부선,평택지제,2439,2285,4724
<class,경부선,평택,10387,11194,21581
<class,경부선,성환,1941,2309,4250
<class,경부선,직산,449,512,961
<class,경부선,두정,3858,4335,8193
<class,경부선,천안,5131,4984,10115
<class,경부선,당정,2748,2761,5509
<class,경부선,서동탄,664,675,1339
<class,경부선,광명,2697,1931,4628
<class,경원선,이촌,1882,1474,3356
<class,경원선,서빙고,1134,1213,2347
<class,경원선,한남,1848,1831,3679
<class,경원선,옥수,48,20,68
<class,경원선,응봉,935,856,1791
<class,경원선,왕십리,9361,10385,19746
<class,경원선,청량리,13251,12022,25273
<class,경원선,외대앞,4143,3998,8141
<class,경원선,신이문,4169,3874,8043
<class,경원선,석계,4298,4705,9003
<class,경원선,광운대,3668,3817,7485
<class,경원선,월계,3356,3199,6555
<class,경원선,녹천,2177,1967,4144
<class,경원선,방학,5156,5058,10214
<class,경원선,도봉,3009,2854,5863
<class,경원선,도봉산,5905,4460,10365
<class,경원선,망월사,4047,4105,8152
<class,경원선,회룡,6449,6362,12811
<class,경원선,의정부,13405,13574,26979
<class,경원선,가능,3626,3325,6951
<class,경원선,녹양,2747,2567,5314
<class,경원선,양주,4223,4110,8333
<class,경원선,덕계,1480,1419,2899
<class,경원선,덕정,2957,3123,6080
<class,경원선,지행,3997,3965,7962
<class,경원선,동두천중앙,1789,1684,3473
<class,경원선,보산,1315,1517,2832
<class,경원선,동두천,1056,1317,2373
<class,경원선,소요산,2659,2206,4865
<class,경의선,서울역,1014,969,1983
<class,경의선,신촌,357,362,719
<class,경의선,효창공원앞,1295,1439,2734
<class,경의선,공덕,1883,1341,3224
<class,경의선,서강대,1098,1076,2174
<class,경의선,홍대입구,1463,1704,3167
<class,경의선,가좌,2476,2562,5038
<class,경의선,디지털미디어시티,1240,1196,2436
<class,경의선,수색,787,901,1688
<class,경의선,화전,648,698,1346
<class,경의선,강매,1356,1306,2662
<class,경의선,행신,4127,3811,7938
<class,경의선,능곡,1955,1839,3794
<class,경의선,곡산,280,257,537
<class,경의선,백마,3083,2909,5992
<class,경의선,풍산,3170,2975,6145
<class,경의선,일산,4113,3943,8056
<class,경의선,탄현,3790,3592,7382
<class,경의선,야당,4184,3947,8131
<class,경의선,운정,3265,3260,6525
<class,경의선,금릉,2624,2601,5225
<class,경의선,금촌,3696,3839,7535
<class,경의선,월롱,831,1760,2591
<class,경의선,파주,534,425,959
<class,경의선,문산,3151,3310,6461
<class,경의선,임진강,39,40,79
<class,경의선,검암,1,0,1
<class,경인선,개봉,10634,10512,21146
<class,경인선,오류동,6487,6068,12555
<class,경인선,역곡,13182,13108,26290
<class,경인선,부천,20312,19606,39918
<class,경인선,송내,12157,11989,24146
<class,경인선,부평,20826,21549,42375
<class,경인선,백운,3639,3494,7133
<class,경인선,동암,8896,8864,17760
<class,경인선,주안,11139,9814,20953
<class,경인선,제물포,5474,5318,10792
<class,경인선,동인천,8335,8124,16459
<class,경인선,인천,2580,2007,4587
<class,경인선,구일,6397,6634,13031
<class,경인선,소사,4967,4768,9735
<class,경인선,부개,4388,4148,8536
<class,경인선,간석,3068,2895,5963
<class,경인선,온수,3350,3112,6462
<class,경인선,중동,4617,4264,8881
<class,경인선,도화,2254,2103,4357
<class,경춘선,신내,782,790,1572
<class,경춘선,갈매,1314,1135,2449
<class,경춘선,별내,1719,1619,3338
<class,경춘선,퇴계원,1777,1661,3438
<class,경춘선,사릉,1483,1414,2897
<class,경춘선,금곡,696,704,1400
<class,경춘선,평내호평,2981,2789,5770
<class,경춘선,천마산,893,861,1754
<class,경춘선,마석,1998,1981,3979
<class,경춘선,대성리,415,265,680
<class,경춘선,청평,1241,940,2181
<class,경춘선,상천,218,208,426
<class,경춘선,가평,1266,1060,2326
<class,경춘선,굴봉산,155,139,294
<class,경춘선,백양리,279,228,507
<class,경춘선,강촌,396,353,749
<class,경춘선,김유정,256,262,518
<class,경춘선,남춘천,1944,2067,4011
<class,경춘선,춘천,1069,991,2060
<class,공항철도 1호선,서울역,7398,6174,13572
<class,공항철도 1호선,공덕,1203,1830,3033
<class,공항철도 1호선,홍대입구,9018,8206,17224
<class,공항철도 1호선,디지털미디어시티,3593,3680,7273
<class,공항철도 1호선,마곡나루,1920,2179,4099
<class,공항철도 1호선,김포공항,11170,5783,16953
<class,공항철도 1호선,계양,4867,4695,9562
<class,공항철도 1호선,검암,3211,3309,6520
<class,공항철도 1호선,청라국제도시,2891,2755,5646
<class,공항철도 1호선,운서,4769,4947,9716
<class,공항철도 1호선,공항화물청사,1047,1118,2165
<class,공항철도 1호선,인천공항1터미널,3635,3929,7564
<class,공항철도 1호선,인천공항2터미널,1836,1925,3761
<class,공항철도 1호선,영종,2215,2076,4291
<class,과천선,선바위,3518,3152,6670
<class,과천선,경마공원,7965,8112,16077
<class,과천선,대공원,2353,2525,4878
<class,과천선,과천,3175,3013,6188
<class,과천선,정부과천청사,3947,3995,7942
<class,과천선,인덕원,10630,10892,21522
<class,과천선,평촌,6087,6135,12222
<class,과천선,범계,13838,13365,27203
<class,분당선,선릉,2824,4361,7185
<class,분당선,한티,6634,6807,13441
<class,분당선,도곡,2529,2526,5055
<class,분당선,구룡,678,728,1406
<class,분당선,개포동,1713,1767,3480
<class,분당선,대모산입구,2129,1996,4125
<class,분당선,수서,8294,8081,16375
<class,분당선,수원,5591,4858,10449
<class,분당선,서울숲,5072,5266,10338
<class,분당선,압구정로데오,11238,12056,23294
<class,분당선,강남구청,3376,4087,7463
<class,분당선,선정릉,2128,2166,4294
<class,분당선,가천대,3694,4427,8121
<class,분당선,태평,7779,7296,15075
<class,분당선,모란,14171,14692,28863
<class,분당선,야탑,12928,13372,26300
<class,분당선,서현,14335,14235,28570
<class,분당선,수내,5892,5718,11610
<class,분당선,정자,7189,7511,14700
<class,분당선,미금,7515,7919,15434
<class,분당선,오리,5588,4833,10421
<class,분당선,이매,2991,3030,6021
<class,분당선,보정,1053,1005,2058
<class,분당선,죽전,8056,9087,17143
<class,분당선,구성,2303,2446,4749
<class,분당선,신갈,1877,1906,3783
<class,분당선,기흥,4998,4685,9683
<class,분당선,상갈,2660,2712,5372
<class,분당선,청명,1976,2025,4001
<class,분당선,영통,4862,4894,9756
<class,분당선,망포,6569,6774,13343
<class,분당선,매탄권선,2618,2494,5112
<class,분당선,수원시청,7484,7554,15038
<class,분당선,매교,1285,1336,2621
<class,수인선,고색,1773,1882,3655
<class,수인선,오목천,1499,1382,2881
<class,수인선,어천,457,549,1006
<class,수인선,야목,156,163,319
<class,수인선,사리,2547,2097,4644
<class,수인선,달월,44,56,100
<class,수인선,월곶,1578,1442,3020
<class,수인선,소래포구,3707,3649,7356
<class,수인선,인천논현,3118,3205,6323
<class,수인선,호구포,1924,2015,3939
<class,수인선,남동인더스파크,509,548,1057
<class,수인선,원인재,2714,2860,5574
<class,수인선,연수,3128,3023,6151
<class,수인선,송도,1500,1451,2951
<class,수인선,인하대,3238,3058,6296
<class,수인선,숭의,1899,1743,3642
<class,수인선,신포,1098,1078,2176
<class,수인선,인천,808,1226,2034
<class,안산선,산본,8083,8677,16760
<class,안산선,대야미,2514,2316,4830
<class,안산선,반월,2302,2198,4500
<class,안산선,상록수,8413,8200,16613
<class,안산선,한대앞,4909,4819,9728
<class,안산선,중앙,11246,10936,22182
<class,안산선,고잔,4552,4428,8980
<class,안산선,초지,2194,2219,4413
<class,안산선,안산,8261,7827,16088
<class,안산선,신길온천,985,998,1983
<class,안산선,정왕,4704,5179,9883
<class,안산선,오이도,5265,5232,10497
<class,안산선,수리산,1782,1698,3480
<class,우이신설선,북한산우이,2262,2318,4580
<class,우이신설선,솔밭공원,1166,1122,2288
<class,우이신설선,4.19민주묘지,1641,1474,3115
<class,우이신설선,가오리,2142,2000,4142
<class,우이신설선,화계,1859,1721,3580
<class,우이신설선,삼양,1132,1119,2251
<class,우이신설선,삼양사거리,1375,1305,2680
<class,우이신설선,솔샘,2665,2399,5064
<class,우이신설선,북한산보국문,3302,3003,6305
<class,우이신설선,정릉,2400,2066,4466
<class,우이신설선,성신여대입구,2023,2395,4418
<class,우이신설선,보문,824,839,1663
<class,우이신설선,신설동,911,949,1860
<class,일산선,원흥,5525,5277,10802
<class,일산선,지축,1,0,1
<class,일산선,삼송,10380,10300,20680
<class,일산선,원당,5583,5289,10872
<class,일산선,화정,8906,9206,18112
<class,일산선,대곡,837,716,1553
<class,일산선,백석,5574,5517,11091
<class,일산선,마두,3176,3151,6327
<class,일산선,정발산,5076,5093,10169
<class,일산선,주엽,4029,4125,8154
<class,일산선,대화,5866,5454,11320
<class,장항선,봉명,503,513,1016
<class,장항선,쌍용,1071,1139,2210
<class,장항선,아산,3118,2088,5206
<class,장항선,탕정,264,315,579
<class,장항선,배방,695,822,1517
<class,장항선,온양온천,3353,3428,6781
<class,장항선,신창,776,876,1652
<class,중앙선,회기,13500,13563,27063
<class,중앙선,중랑,2952,2816,5768
<class,중앙선,상봉,3387,3465,6852
<class,중앙선,망우,4476,4359,8835
<class,중앙선,양원,866,840,1706
<class,중앙선,구리,6978,7272,14250
<class,중앙선,도농,4694,4591,9285
<class,중앙선,양정,333,259,592
<class,중앙선,덕소,3095,3118,6213
<class,중앙선,도심,1058,897,1955
<class,중앙선,팔당,989,980,1969
<class,중앙선,운길산,735,668,1403
<class,중앙선,양수,1285,1245,2530
<class,중앙선,신원,174,124,298
<class,중앙선,국수,407,331,738
<class,중앙선,아신,371,331,702
<class,중앙선,오빈,187,160,347
<class,중앙선,양평,1685,1643,3328
<class,중앙선,원덕,226,198,424
<class,중앙선,용문,1424,1174,2598
<class,중앙선,지평,53,43,96
<class,경원선,이촌,1814,1432,3246
<class,경부선,광명,1835,1811,3646
<class,경부선,서동탄,725,778,1503
<class,경부선,당정,2964,2839,5803
<class,경부선,천안,4938,4911,9849
<class,경부선,두정,3888,3986,7874
<class,경부선,직산,438,438,876
<class,경부선,성환,2127,1992,4119
<class,경부선,평택,10704,10449,21153
<class,경부선,평택지제,2226,2119,4345
<class,경부선,서정리,5173,4409,9582
<class,경부선,송탄,3843,3471,7314
<class,경부선,진위,783,648,1431
<class,경부선,오산,7918,7508,15426
<class,경부선,오산대,2085,1907,3992
<class,경부선,세마,1745,1583,3328
<class,경부선,병점,9849,10095,19944
<class,경부선,세류,1840,1874,3714
<class,경부선,독산,6500,6348,12848
<class,경원선,창동,1,0,1
<class,중앙선,용문,1557,1699,3256
<class,중앙선,지평,27,29,56
<class,경부선,수원,34432,36726,71158
<class,경부선,화서,3636,3745,7381
<class,경부선,성균관대,7903,8006,15909
<class,경부선,의왕,4089,4072,8161
<class,경부선,군포,2982,2690,5672
<class,경부선,금정,13159,13538,26697
<class,경부선,명학,3159,3000,6159
<class,경부선,안양,13518,13587,27105
<class,경부선,관악,3786,3715,7501
<class,경부선,석수,4714,4450,9164
<class,경부선,금천구청,5928,5943,11871
<class,경부선,가산디지털단지,4276,6179,10455
<class,경부선,구로,9368,9592,18960
<class,경부선,신길,4369,3769,8138
<class,경부선,신도림,1843,1840,3683
<class,경부선,영등포,42133,41728,83861
<class,경부선,대방,5893,5930,11823
<class,경부선,노량진,6194,6102,12296
<class,경부선,용산,29683,31402,61085
<class,경부선,남영,4085,4394,8479
<class,경부선,서울역,4732,1796,6528
<class,경강선,여주,1825,1836,3661
<class,경강선,세종대왕릉,165,198,363
<class,경강선,부발,1514,1288,2802
<class,경강선,이천,2352,2394,4746
<class,경강선,신둔도예촌,781,766,1547
<class,경강선,곤지암,1439,1382,2821
<class,경강선,초월,1722,1526,3248
<class,경강선,경기광주,4467,4277,8744
<class,경강선,삼동,1010,998,2008
<class,경강선,이매,608,461,1069
<class,경강선,판교,2989,2879,5868
<class,9호선2~3단계,중앙보훈병원,3035,2791,5826
<class,9호선2~3단계,둔촌오륜,407,425,832
<class,9호선2~3단계,올림픽공원,6658,6266,12924
<class,9호선2~3단계,한성백제,1310,1181,2491
<class,9호선2~3단계,송파나루,4185,4418,8603
<class,9호선2~3단계,석촌,4750,4095,8845
<class,9호선2~3단계,석촌고분,3276,3365,6641
<class,9호선2~3단계,삼전,3849,3703,7552
<class,9호선2~3단계,종합운동장,2250,1927,4177
<class,9호선2~3단계,봉은사,15217,16641,31858
<class,9호선2~3단계,삼성중앙,2070,2048,4118
<class,9호선2~3단계,선정릉,2782,3096,5878
<class,9호선2~3단계,언주,3916,3960,7876
<class,9호선,신논현,17572,16342,33914
<class,9호선,사평,1560,1529,3089
<class,9호선,고속터미널,8505,12528,21033
<class,9호선,신반포,1497,1542,3039
<class,9호선,구반포,655,643,1298
<class,9호선,동작,997,736,1733
<class,9호선,흑석,3619,3921,7540
<class,9호선,노들,2388,2146,4534
<class,9호선,노량진,16448,15931,32379
<class,9호선,샛강,1718,1737,3455
<class,9호선,여의도,9913,8677,18590
<class,9호선,국회의사당,3766,3733,7499
<class,9호선,당산,8948,8571,17519
<class,9호선,선유도,2846,2698,5544
<class,9호선,신목동,1603,1404,3007
<class,9호선,염창,8497,8089,16586
<class,9호선,등촌,5440,5329,10769
<class,9호선,증미,3108,3299,6407
<class,9호선,가양,9989,9554,19543
<class,9호선,양천향교,4391,4158,8549
<class,9호선,마곡나루,5674,5465,11139
<class,9호선,신방화,3583,3526,7109
<class,9호선,공항시장,1799,1889,3688
<class,9호선,김포공항,7123,10893,18016
<class,9호선,개화,984,845,1829
<class,8호선,남위례,1820,1987,3807
<class,8호선,모란,3065,2623,5688
<class,8호선,수진,3324,3044,6368
<class,8호선,신흥,3147,3414,6561
<class,8호선,단대오거리,5963,5591,11554
<class,8호선,남한산성입구,6908,6283,13191
<class,8호선,산성,2952,2967,5919
<class,8호선,복정,4268,3584,7852
<class,8호선,장지,10004,9647,19651
<class,8호선,문정,5530,5618,11148
<class,8호선,가락시장,4186,4209,8395
<class,8호선,송파,3677,4013,7690
<class,8호선,석촌,4899,5793,10692
<class,8호선,잠실,15265,16788,32053
<class,8호선,몽촌토성,3418,3345,6763
<class,8호선,강동구청,4794,4885,9679
<class,8호선,천호,9704,11895,21599
<class,8호선,암사,9324,8629,17953
<class,7호선,부평구청,3512,3326,6838
<class,7호선,굴포천,4923,5318,10241
<class,7호선,삼산체육관,2703,2600,5303
<class,7호선,상동,7679,7602,15281
<class,7호선,부천시청,7971,7852,15823
<class,7호선,신중동,7238,7083,14321
<class,7호선,춘의,3530,3432,6962
<class,7호선,부천종합운동장,2223,1990,4213
<class,7호선,까치울,3714,3819,7533
<class,7호선,온수,3715,3764,7479
<class,7호선,천왕,4816,4667,9483
<class,7호선,광명사거리,12353,12265,24618
<class,7호선,철산,11017,11275,22292
<class,7호선,가산디지털단지,10964,9432,20396
<class,7호선,남구로,6315,6509,12824
<class,7호선,대림,5856,6025,11881
<class,7호선,신풍,5525,5315,10840
<class,7호선,보라매,4078,3902,7980
<class,7호선,신대방삼거리,8008,7752,15760
<class,7호선,장승배기,4552,4375,8927
<class,7호선,상도,5228,4877,10105
<class,7호선,숭실대입구,5308,5322,10630
<class,7호선,남성,5378,5126,10504
<class,7호선,이수,8228,7706,15934
<class,7호선,내방,5063,5078,10141
<class,7호선,고속터미널,8761,6943,15704
<class,7호선,반포,2786,2620,5406
<class,7호선,논현,5850,6416,12266
<class,7호선,학동,6031,6394,12425
<class,7호선,강남구청,5219,5743,10962
<class,7호선,청담,6517,7445,13962
<class,7호선,뚝섬유원지,3818,3664,7482
<class,7호선,건대입구,9928,10045,19973
<class,7호선,어린이대공원,6241,6015,12256
<class,7호선,군자,7891,6120,14011
<class,7호선,중곡,5426,5103,10529
<class,7호선,용마산,3156,3186,6342
<class,7호선,사가정,8820,8579,17399
<class,경원선,동두천,1167,1410,2577
<class,7호선,면목,8196,8059,16255
<class,7호선,상봉,10097,9610,19707
<class,7호선,중화,5584,5480,11064
<class,7호선,먹골,5677,5567,11244
<class,7호선,태릉입구,4553,4344,8897
<class,7호선,공릉,6813,6653,13466
<class,7호선,하계,8782,8403,17185
<class,7호선,중계,6463,6020,12483
<class,7호선,노원,12918,12837,25755
<class,7호선,마들,6306,6071,12377
<class,7호선,수락산,6911,6742,13653
<class,7호선,도봉산,4069,5697,9766
<class,7호선,장암,850,591,1441
<class,6호선,봉화산,3817,3759,7576
<class,6호선,화랑대,5342,4215,9557
<class,6호선,태릉입구,3122,3239,6361
<class,6호선,석계,6651,6704,13355
<class,6호선,돌곶이,4773,4485,9258
<class,6호선,상월곡,3109,2804,5913
<class,6호선,월곡,5554,5426,10980
<class,6호선,고려대,4101,4027,8128
<class,6호선,안암,4677,4339,9016
<class,6호선,보문,4007,3650,7657
<class,6호선,창신,1613,1385,2998
<class,6호선,동묘앞,5178,5135,10313
<class,6호선,신당,5183,4247,9430
<class,6호선,청구,1848,1722,3570
<class,6호선,약수,1598,1671,3269
<class,6호선,버티고개,1012,1103,2115
<class,6호선,한강진,8356,9449,17805
<class,6호선,이태원,12103,12490,24593
<class,6호선,녹사평,4013,4149,8162
<class,6호선,삼각지,3488,2740,6228
<class,6호선,효창공원앞,3116,2849,5965
<class,6호선,공덕,6711,6551,13262
<class,6호선,대흥,3584,3675,7259
<class,6호선,광흥창,4154,4052,8206
<class,6호선,상수,7833,8189,16022
<class,6호선,합정,9736,8671,18407
<class,6호선,망원,9776,10766,20542
<class,6호선,마포구청,7109,6460,13569
<class,6호선,월드컵경기장,2970,3112,6082
<class,6호선,디지털미디어시티,4824,5016,9840
<class,6호선,증산,5591,5574,11165
<class,6호선,새절,6202,6205,12407
<class,6호선,구산,3973,3054,7027
<class,6호선,독바위,1491,1681,3172
<class,6호선,불광,3224,2633,5857
<class,6호선,역촌,2225,2428,4653
<class,6호선,응암,9440,9494,18934
<class,5호선,하남검단산,4584,4554,9138
<class,5호선,하남시청,4011,3781,7792
<class,5호선,하남풍산,2131,2266,4397
<class,5호선,미사,9139,9120,18259
<class,5호선,강일,1905,1896,3801
<class,5호선,마천,3272,3447,6719
<class,5호선,거여,4152,4009,8161
<class,5호선,개롱,2701,2990,5691
<class,5호선,오금,1468,1448,2916
<class,5호선,방이,3772,3628,7400
<class,5호선,올림픽공원,2544,2509,5053
<class,5호선,둔촌동,4517,4612,9129
<class,5호선,상일동,6683,6507,13190
<class,5호선,고덕,4436,4460,8896
<class,5호선,명일,4579,4530,9109
<class,5호선,굽은다리,6007,5753,11760
<class,5호선,길동,4635,4870,9505
<class,5호선,강동,8952,8375,17327
<class,5호선,천호,13824,12750,26574
<class,5호선,광나루,6868,6522,13390
<class,5호선,아차산,9369,8980,18349
<class,5호선,군자,6360,7061,13421
<class,5호선,장한평,8085,8172,16257
<class,5호선,답십리,7804,7496,15300
<class,5호선,마장,3018,2987,6005
<class,5호선,왕십리,2621,3367,5988
<class,5호선,행당,3731,3396,7127
<class,5호선,신금호,3003,3181,6184
<class,5호선,청구,1826,1748,3574
<class,5호선,동대문역사문화공원,960,1302,2262
<class,5호선,을지로4가,2024,2326,4350
<class,5호선,종로3가,11883,11140,23023
<class,5호선,광화문,14635,14199,28834
<class,5호선,서대문,5038,4929,9967
<class,5호선,충정로,1558,1505,3063
<class,5호선,애오개,2517,2595,5112
<class,5호선,공덕,4597,4844,9441
<class,5호선,마포,5330,5292,10622
<class,5호선,여의나루,5434,7402,12836
<class,5호선,여의도,10065,9742,19807
<class,5호선,신길,1971,2128,4099
<class,5호선,영등포시장,5791,6047,11838
<class,5호선,영등포구청,1321,1270,2591
<class,5호선,양평,2629,2550,5179
<class,5호선,오목교,12420,12758,25178
<class,5호선,목동,7519,7871,15390
<class,5호선,신정,6609,5767,12376
<class,5호선,까치산,15959,15731,31690
<class,5호선,화곡,15404,14321,29725
<class,5호선,우장산,7005,7109,14114
<class,5호선,발산,9797,10187,19984
<class,5호선,마곡,3803,4003,7806
<class,5호선,송정,3805,3625,7430
<class,5호선,김포공항,7422,7132,14554
<class,5호선,개화산,2744,2742,5486
<class,5호선,방화,3406,3325,6731
<class,4호선,쌍문,16544,15219,31763
<class,4호선,창동,15003,15966,30969
<class,4호선,노원,13997,15067,29064
<class,4호선,상계,10363,9801,20164
<class,4호선,당고개,7456,7126,14582
<class,4호선,남태령,686,485,1171
<class,4호선,사당,14968,12753,27721
<class,4호선,총신대입구,9960,10684,20644
<class,4호선,동작,563,613,1176
<class,4호선,이촌,4071,4333,8404
<class,4호선,신용산,8509,9024,17533
<class,4호선,삼각지,2585,3379,5964
<class,4호선,숙대입구,7050,6828,13878
<class,4호선,서울역,5005,11114,16119
<class,4호선,회현,30079,29526,59605
<class,4호선,명동,36093,41115,77208
<class,4호선,충무로,10818,10538,21356
<class,4호선,동대문역사문화공원,11400,9647,21047
<class,4호선,동대문,9695,9791,19486
<class,4호선,혜화,30768,31021,61789
<class,4호선,한성대입구,7643,7471,15114
<class,4호선,성신여대입구,14912,14539,29451
<class,4호선,길음,10060,9846,19906
<class,4호선,미아사거리,17679,16902,34581
<class,4호선,미아,8237,7810,16047
<class,4호선,수유,21442,21229,42671
<class,3호선,오금,2480,2342,4822
<class,3호선,경찰병원,2744,2703,5447
<class,3호선,가락시장,4006,3864,7870
<class,3호선,수서,8925,9400,18325
<class,3호선,일원,2861,2977,5838
<class,3호선,대청,4059,3827,7886
<class,3호선,학여울,709,705,1414
<class,3호선,대치,5023,4728,9751
<class,3호선,도곡,1777,1762,3539
<class,3호선,매봉,4027,3902,7929
<class,3호선,양재,12924,14139,27063
<class,3호선,남부터미널,13762,13854,27616
<class,3호선,교대,3666,2196,5862
<class,3호선,고속터미널,36399,36608,73007
<class,3호선,잠원,2051,2078,4129
<class,3호선,신사,15375,15770,31145
<class,3호선,압구정,14964,15808,30772
<class,3호선,옥수,4327,4730,9057
<class,3호선,금호,4182,3901,8083
<class,3호선,약수,6551,6204,12755
<class,3호선,동대입구,5760,6129,11889
<class,3호선,을지로3가,5111,4848,9959
<class,3호선,종로3가,5107,7265,12372
<class,3호선,안국,10840,11473,22313
<class,3호선,경복궁,9838,10227,20065
<class,3호선,독립문,3397,3530,6927
<class,3호선,무악재,1913,1964,3877
<class,3호선,홍제,8988,8628,17616
<class,3호선,녹번,7349,6605,13954
<class,3호선,불광,9332,10704,20036
<class,3호선,연신내,21344,20788,42132
<class,3호선,구파발,10848,11086,21934
<class,3호선,지축,1998,1795,3793
<class,2호선,용두,1164,1207,2371
<class,2호선,신정네거리,5180,5237,10417
<class,2호선,양천구청,3109,3240,6349
<class,2호선,도림천,393,428,821
<class,2호선,신설동,2738,2666,5404
<class,2호선,신답,667,791,1458
<class,2호선,용답,1744,1704,3448
<class,2호선,충정로,3683,3974,7657
<class,2호선,아현,5306,5416,10722
<class,2호선,이대,7259,7841,15100
<class,2호선,신촌,25813,25505,51318
<class,2호선,홍대입구,63119,64892,128011
<class,2호선,합정,21250,22817,44067
<class,2호선,당산,8206,9324,17530
<class,2호선,영등포구청,8277,8676,16953
<class,2호선,문래,7951,8289,16240
<class,2호선,신도림,27061,27853,54914
<class,2호선,대림,12770,13673,26443
<class,2호선,구로디지털단지,25372,25162,50534
<class,2호선,신대방,15139,14713,29852
<class,2호선,신림,40232,38740,78972
<class,2호선,봉천,12458,11664,24122
<class,2호선,서울대입구,28375,27656,56031
<class,2호선,낙성대,15957,14952,30909
<class,2호선,사당,19937,21701,41638
<class,2호선,방배,6159,6545,12704
<class,2호선,서초,8731,7737,16468
<class,2호선,교대,9828,10847,20675
<class,2호선,강남,39794,38813,78607
<class,2호선,역삼,13151,14118,27269
<class,2호선,선릉,14148,12562,26710
<class,2호선,삼성,38331,36240,74571
<class,2호선,종합운동장,4123,4656,8779
<class,2호선,잠실새내,13203,14021,27224
<class,2호선,잠실,68897,64657,133554
<class,2호선,잠실나루,4979,4973,9952
<class,2호선,강변,20435,19992,40427
<class,2호선,구의,12338,12139,24477
<class,2호선,건대입구,30161,31459,61620
<class,2호선,성수,14682,16170,30852
<class,2호선,뚝섬,9589,9671,19260
<class,2호선,한양대,2076,2143,4219
<class,2호선,왕십리,10488,9372,19860
<class,2호선,상왕십리,7495,7345,14840
<class,2호선,신당,8147,8752,16899
<class,2호선,동대문역사문화공원,9096,10626,19722
<class,2호선,을지로4가,4928,4984,9912
<class,2호선,을지로3가,12021,10889,22910
<class,2호선,을지로입구,31788,26553,58341
<class,2호선,시청,10664,6222,16886
<class,1호선,청량리,12566,12392,24958
<class,1호선,제기동,8928,8894,17822
<class,1호선,신설동,6863,6500,13363
<class,1호선,동대문,8546,7852,16398
<class,1호선,종로5가,12710,12193,24903
<class,1호선,종로3가,14748,14395,29143
<class,1호선,종각,15257,13575,28832
<class,1호선,시청,12360,10532,22892
<class,1호선,동묘앞,7303,7270,14573
<class,1호선,서울역,24963,25027,49990
<class,중앙선,원덕,204,200,404
<class,중앙선,양평,1729,1829,3558
<class,중앙선,오빈,152,159,311
<class,중앙선,아신,292,312,604
<class,중앙선,국수,373,383,756
<class,중앙선,신원,112,61,173
<class,중앙선,양수,1066,1202,2268
<class,중앙선,운길산,441,456,897
<class,중앙선,팔당,899,979,1878
<class,중앙선,도심,1136,907,2043
<class,중앙선,덕소,3269,3353,6622
<class,중앙선,양정,335,284,619
<class,중앙선,도농,5022,4894,9916
<class,중앙선,구리,8019,8317,16336
<class,중앙선,양원,961,1013,1974
<class,중앙선,망우,4910,4843,9753
<class,중앙선,상봉,3670,3616,7286
<class,중앙선,중랑,3365,3157,6522
<class,중앙선,회기,15663,15146,30809
<class,장항선,신창,773,704,1477
<class,장항선,온양온천,2961,2941,5902
<class,장항선,배방,747,702,1449
<class,장항선,탕정,245,222,467
<class,장항선,아산,2230,2106,4336
<class,장항선,쌍용,1056,1012,2068
<class,장항선,봉명,401,430,831
<class,일산선,대화,6220,6025,12245
<class,일산선,주엽,4364,4541,8905
<class,일산선,정발산,6425,6536,12961
<class,일산선,마두,3467,3525,6992
<class,일산선,백석,5818,5845,11663
<class,일산선,대곡,865,803,1668
<class,일산선,화정,9862,10489,20351
<class,일산선,원당,6022,5961,11983
<class,일산선,삼송,12137,11783,23920
<class,일산선,원흥,5249,5018,10267
<class,우이신설선,신설동,946,919,1865
<class,우이신설선,보문,975,1031,2006
<class,우이신설선,성신여대입구,2521,2882,5403
<class,우이신설선,정릉,2555,2227,4782
<class,우이신설선,북한산보국문,3535,3257,6792
<class,우이신설선,솔샘,2988,2708,5696
<class,우이신설선,삼양사거리,1385,1340,2725
<class,우이신설선,삼양,1215,1315,2530
<class,우이신설선,화계,1851,1754,3605
<class,우이신설선,가오리,2181,2105,4286
<class,우이신설선,4.19민주묘지,1526,1355,2881
<class,우이신설선,솔밭공원,1289,1250,2539
<class,우이신설선,북한산우이,1797,1681,3478
<class,안산선,수리산,1938,1642,3580
<class,안산선,오이도,6454,6634,13088
<class,안산선,정왕,5086,5189,10275
<class,안산선,신길온천,1087,977,2064
<class,안산선,안산,7729,8099,15828
<class,안산선,초지,2425,2485,4910
<class,안산선,고잔,4426,4269,8695
<class,안산선,중앙,13397,13793,27190
<class,안산선,한대앞,5073,5147,10220
<class,안산선,상록수,9283,9499,18782
<class,안산선,반월,2380,2267,4647
<class,안산선,대야미,2525,2259,4784
<class,안산선,산본,9260,9799,19059
<class,수인선,인천,1080,1508,2588
<class,수인선,신포,1031,1097,2128
<class,수인선,숭의,1985,1801,3786
<class,수인선,인하대,3344,3170,6514
<class,수인선,송도,1526,1573,3099
<class,수인선,연수,3136,3197,6333
<class,수인선,원인재,2765,2985,5750
<class,수인선,남동인더스파크,602,510,1112
<class,수인선,호구포,1960,1800,3760
<class,수인선,인천논현,3309,3516,6825
<class,수인선,소래포구,3679,3765,7444
<class,수인선,월곶,1838,1708,3546
<class,수인선,달월,84,89,173
<class,수인선,사리,2740,2263,5003
<class,수인선,야목,133,125,258
<class,수인선,어천,468,386,854
<class,수인선,오목천,1567,1445,3012
<class,수인선,고색,1874,1829,3703
<class,분당선,매교,1436,1545,2981
<class,분당선,수원시청,8934,9659,18593
<class,분당선,매탄권선,2778,2562,5340
<class,분당선,망포,7287,6963,14250
<class,분당선,영통,5751,5758,11509
<class,분당선,청명,1890,1930,3820
<class,분당선,상갈,2950,3001,5951
<class,분당선,기흥,5772,5351,11123
<class,분당선,신갈,2060,2094,4154
<class,분당선,구성,2337,2488,4825
<class,분당선,죽전,9879,10670,20549
<class,분당선,보정,1122,1104,2226
<class,분당선,이매,3208,3325,6533
<class,분당선,오리,5969,4742,10711
<class,분당선,미금,7848,7865,15713
<class,분당선,정자,7595,7800,15395
<class,분당선,수내,6110,6066,12176
<class,분당선,서현,18790,18466,37256
<class,분당선,야탑,13299,13850,27149
<class,분당선,모란,12213,12749,24962
<class,분당선,태평,8318,8045,16363
<class,분당선,가천대,3525,3982,7507
<class,분당선,선정릉,2078,2085,4163
<class,분당선,강남구청,3198,3927,7125
<class,분당선,압구정로데오,14118,15411,29529
<class,분당선,서울숲,4822,5027,9849
<class,분당선,수원,6748,5562,12310
<class,분당선,수서,6947,7707,14654
<class,분당선,대모산입구,1909,1796,3705
<class,분당선,개포동,1586,1640,3226
<class,분당선,구룡,719,713,1432
<class,분당선,도곡,2645,2498,5143
<class,분당선,한티,7916,7753,15669
<class,분당선,선릉,2843,4218,7061
<class,과천선,범계,16446,15419,31865
<class,과천선,평촌,6317,6308,12625
<class,과천선,인덕원,11517,12030,23547
<class,과천선,정부과천청사,4131,4278,8409
<class,과천선,과천,3170,3038,6208
<class,과천선,대공원,2047,2076,4123
<class,과천선,경마공원,7303,7293,14596
<class,과천선,선바위,3610,3279,6889
<class,공항철도 1호선,영종,2140,2164,4304
<class,공항철도 1호선,인천공항2터미널,1732,1628,3360
<class,공항철도 1호선,인천공항1터미널,3576,3769,7345
<class,공항철도 1호선,공항화물청사,1084,1136,2220
<class,공항철도 1호선,운서,4933,4945,9878
<class,공항철도 1호선,청라국제도시,3095,3011,6106
<class,공항철도 1호선,검암,3230,3257,6487
<class,공항철도 1호선,계양,5138,5019,10157
<class,공항철도 1호선,김포공항,9338,5076,14414
<class,공항철도 1호선,마곡나루,1948,2142,4090
<class,공항철도 1호선,디지털미디어시티,3399,3173,6572
<class,공항철도 1호선,홍대입구,10580,10530,21110
<class,공항철도 1호선,공덕,1058,1625,2683
<class,공항철도 1호선,서울역,5659,5762,11421
<class,경춘선,춘천,1111,1022,2133
<class,경춘선,남춘천,2012,2089,4101
<class,경춘선,김유정,330,338,668
<class,경춘선,강촌,303,329,632
<class,경춘선,백양리,257,210,467
<class,경춘선,굴봉산,142,164,306
<class,경춘선,가평,1439,1439,2878
<class,경춘선,상천,177,149,326
<class,경춘선,청평,1231,1212,2443
<class,경춘선,대성리,336,310,646
<class,경춘선,마석,2265,2264,4529
<class,경춘선,천마산,939,906,1845
<class,경춘선,평내호평,3332,3253,6585
<class,경춘선,금곡,824,714,1538
<class,경춘선,사릉,1591,1551,3142
<class,경춘선,퇴계원,1909,1745,3654
<class,경춘선,별내,1694,1633,3327
<class,경춘선,갈매,1394,1239,2633
<class,경춘선,신내,806,855,1661
<class,경인선,도화,2313,2196,4509
<class,경인선,중동,4728,4364,9092
<class,경인선,온수,3667,3425,7092
<class,경인선,도원,1356,1371,2727
<class,경인선,간석,3186,3017,6203
<class,경인선,부개,4499,4278,8777
<class,경인선,소사,4632,4516,9148
<class,경인선,구일,3051,2890,5941
<class,경인선,인천,2924,2488,5412
<class,경인선,동인천,8889,8905,17794
<class,경인선,제물포,5337,5293,10630
<class,경인선,주안,12437,11016,23453
<class,경인선,동암,9025,9514,18539
<class,경인선,백운,3785,3816,7601
<class,경인선,부평,25346,27181,52527
<class,경인선,송내,12741,12613,25354
<class,경인선,부천,23435,24056,47491
<class,경인선,역곡,14751,14753,29504
<class,경인선,오류동,6837,6517,13354
<class,경인선,개봉,11750,11745,23495
<class,경의선,임진강,37,37,74
<class,경의선,문산,3228,3203,6431
<class,경의선,파주,687,417,1104
<class,경의선,월롱,1140,936,2076
<class,경의선,금촌,4139,4100,8239
<class,경의선,금릉,2986,2856,5842
<class,경의선,운정,3624,3510,7134
<class,경의선,야당,4750,4672,9422
<class,경의선,탄현,4110,3979,8089
<class,경의선,일산,4375,4270,8645
<class,경의선,풍산,3215,3063,6278
<class,경의선,백마,3134,3089,6223
<class,경의선,곡산,244,237,481
<class,경의선,능곡,1925,1867,3792
<class,경의선,행신,3895,3987,7882
<class,경의선,강매,1343,1315,2658
<class,경의선,화전,671,589,1260
<class,경의선,수색,744,818,1562
<class,경의선,디지털미디어시티,1284,1184,2468
<class,경의선,가좌,2628,2726,5354
<class,경의선,홍대입구,1745,2238,3983
<class,경의선,서강대,1169,1084,2253
<class,경의선,공덕,1831,1345,3176
<class,경의선,효창공원앞,1234,1382,2616
<class,경의선,신촌,318,332,650
<class,경의선,서울역,959,1032,1991
<class,경원선,소요산,1939,1551,3490
<class,경원선,보산,1086,1152,2238
<class,경원선,동두천중앙,1958,1950,3908
<class,경원선,지행,4364,4444,8808
<class,경원선,덕정,3294,3152,6446
<class,경원선,덕계,1661,1535,3196
<class,경원선,양주,4756,4454,9210
<class,경원선,녹양,2519,2420,4939
<class,경원선,가능,3607,3578,7185
<class,경원선,의정부,15537,15921,31458
<class,경원선,회룡,6949,7037,13986
<class,경원선,망월사,4060,4086,8146
<class,경원선,도봉산,5165,3339,8504
<class,경원선,도봉,3143,3082,6225
<class,경원선,방학,5419,5275,10694
<class,경원선,녹천,2140,1879,4019
<class,경원선,월계,3374,3177,6551
<class,경원선,광운대,4282,4346,8628
<class,경원선,석계,4886,5065,9951
<class,경원선,신이문,4535,4241,8776
<class,경원선,외대앞,5074,4868,9942
<class,경원선,청량리,12498,13427,25925
<class,경원선,왕십리,10767,11877,22644
<class,경원선,응봉,847,738,1585
<class,경원선,옥수,24,36,60
<class,경원선,한남,1873,1955,3828
<class,경원선,서빙고,1088,1137,2225
<class,3호선,경복궁,7063,7043,14106
<class,중앙선,신원,89,86,175
<class,중앙선,양수,984,888,1872
<class,중앙선,운길산,372,348,720
<class,중앙선,팔당,688,705,1393
<class,중앙선,도심,793,752,1545
<class,중앙선,덕소,2461,2640,5101
<class,중앙선,양정,247,227,474
<class,중앙선,도농,3753,3796,7549
<class,중앙선,구리,5864,6263,12127
<class,중앙선,양원,767,760,1527
<class,중앙선,망우,3624,3581,7205
<class,중앙선,상봉,2820,2843,5663
<class,중앙선,중랑,2576,2592,5168
<class,중앙선,지평,47,28,75
<class,중앙선,용문,1054,867,1921
<class,중앙선,원덕,189,152,341
<class,중앙선,양평,1344,1280,2624
<class,중앙선,오빈,125,134,259
<class,중앙선,아신,286,266,552
<class,중앙선,국수,333,272,605
<class,7호선,부천시청,5561,5278,10839
<class,중앙선,회기,12091,11895,23986
<class,장항선,신창,713,776,1489
<class,장항선,온양온천,2539,2585,5124
<class,장항선,배방,598,694,1292
<class,장항선,탕정,204,213,417
<class,장항선,아산,2793,1724,4517
<class,장항선,쌍용,887,897,1784
<class,장항선,봉명,428,405,833
<class,일산선,대화,5072,4662,9734
<class,일산선,주엽,3459,3474,6933
<class,일산선,정발산,4514,4357,8871
<class,일산선,마두,2689,2733,5422
<class,일산선,백석,4629,4512,9141
<class,일산선,대곡,705,591,1296
<class,일산선,화정,7436,7759,15195
<class,일산선,원당,4711,4694,9405
<class,일산선,삼송,8752,8719,17471
<class,일산선,원흥,4191,3981,8172
<class,우이신설선,신설동,824,790,1614
<class,우이신설선,보문,784,802,1586
<class,우이신설선,성신여대입구,1830,2020,3850
<class,우이신설선,정릉,2046,1832,3878
<class,우이신설선,북한산보국문,2919,2681,5600
<class,우이신설선,솔샘,2238,2129,4367
<class,우이신설선,삼양사거리,1169,1129,2298
<class,우이신설선,삼양,878,951,1829
<class,우이신설선,화계,1531,1499,3030
<class,우이신설선,가오리,1785,1744,3529
<class,우이신설선,4.19민주묘지,1245,1134,2379
<class,우이신설선,솔밭공원,993,963,1956
<class,우이신설선,북한산우이,1627,1683,3310
<class,안산선,수리산,1579,1444,3023
<class,안산선,오이도,4304,4303,8607
<class,안산선,정왕,4154,4545,8699
<class,안산선,신길온천,869,853,1722
<class,안산선,안산,7317,6568,13885
<class,안산선,초지,1822,1792,3614
<class,안산선,고잔,3474,3324,6798
<class,안산선,중앙,9536,9414,18950
<class,안산선,한대앞,4186,4158,8344
<class,안산선,상록수,7232,7279,14511
<class,안산선,반월,1864,1930,3794
<class,안산선,대야미,1974,1872,3846
<class,안산선,산본,6764,7215,13979
<class,수인선,인천,676,959,1635
<class,수인선,신포,847,786,1633
<class,수인선,숭의,1451,1394,2845
<class,수인선,인하대,2345,2188,4533
<class,수인선,송도,1135,1064,2199
<class,수인선,연수,2616,2570,5186
<class,수인선,원인재,2260,2328,4588
<class,수인선,남동인더스파크,423,458,881
<class,수인선,호구포,1558,1578,3136
<class,수인선,인천논현,2258,2377,4635
<class,수인선,소래포구,2547,2443,4990
<class,수인선,월곶,1267,1200,2467
<class,수인선,달월,43,39,82
<class,수인선,사리,2002,1711,3713
<class,수인선,야목,138,105,243
<class,수인선,어천,357,437,794
<class,수인선,오목천,1154,1175,2329
<class,수인선,고색,1383,1526,2909
<class,분당선,매교,1052,1126,2178
<class,분당선,수원시청,6580,5845,12425
<class,분당선,매탄권선,2063,2121,4184
<class,분당선,망포,5258,5753,11011
<class,분당선,영통,4162,4058,8220
<class,분당선,청명,1549,1653,3202
<class,분당선,상갈,2242,2378,4620
<class,분당선,기흥,4394,4042,8436
<class,분당선,신갈,1540,1667,3207
<class,분당선,구성,1873,2053,3926
<class,분당선,죽전,7404,7860,15264
<class,분당선,보정,894,868,1762
<class,분당선,이매,2734,2913,5647
<class,분당선,오리,4501,3955,8456
<class,분당선,미금,6119,6607,12726
<class,분당선,정자,6200,6471,12671
<class,분당선,수내,5009,4979,9988
<class,분당선,서현,13803,13452,27255
<class,분당선,야탑,11120,11260,22380
<class,분당선,모란,8986,9262,18248
<class,분당선,태평,6708,6436,13144
<class,분당선,가천대,2863,3566,6429
<class,분당선,선정릉,1673,1766,3439
<class,분당선,강남구청,2510,3005,5515
<class,분당선,압구정로데오,9236,9651,18887
<class,분당선,서울숲,3515,3581,7096
<class,분당선,수원,4973,4184,9157
<class,1호선,서울역,24089,21302,45391
<class,1호선,동묘앞,7040,6913,13953
<class,1호선,시청,6646,5945,12591
<class,1호선,종각,9264,8462,17726
<class,1호선,종로3가,9472,8516,17988
<class,1호선,종로5가,6335,6141,12476
<class,1호선,동대문,6566,6562,13128
<class,1호선,신설동,5464,5455,10919
<class,1호선,제기동,6299,6461,12760
<class,1호선,청량리,8676,8973,17649
<class,2호선,시청,5397,3640,9037
<class,2호선,을지로입구,16609,14939,31548
<class,2호선,을지로3가,7197,6653,13850
<class,2호선,을지로4가,2662,2305,4967
<class,2호선,동대문역사문화공원,6487,7482,13969
<class,2호선,신당,5978,6649,12627
<class,2호선,상왕십리,5587,5663,11250
<class,2호선,왕십리,7932,7085,15017
<class,2호선,한양대,1707,1909,3616
<class,2호선,뚝섬,6751,6901,13652
<class,2호선,성수,10201,10824,21025
<class,2호선,건대입구,21369,21862,43231
<class,2호선,구의,9247,9525,18772
<class,2호선,강변,17393,16725,34118
<class,2호선,잠실나루,3810,3943,7753
<class,2호선,잠실,42732,40278,83010
<class,2호선,잠실새내,9126,9530,18656
<class,2호선,종합운동장,2866,3267,6133
<class,2호선,삼성,27947,26454,54401
<class,2호선,선릉,11172,9504,20676
<class,2호선,역삼,10114,10621,20735
<class,2호선,강남,29494,28184,57678
<class,2호선,교대,8147,9128,17275
<class,2호선,서초,9269,8406,17675
<class,2호선,방배,5448,5803,11251
<class,2호선,사당,16394,18302,34696
<class,2호선,낙성대,12413,13262,25675
<class,2호선,서울대입구,21931,22637,44568
<class,2호선,봉천,9834,9863,19697
<class,2호선,신림,31465,31055,62520
<class,2호선,신대방,12040,12114,24154
<class,2호선,구로디지털단지,18975,18966,37941
<class,2호선,대림,10912,11172,22084
<class,2호선,신도림,20976,21441,42417
<class,2호선,문래,5578,5846,11424
<class,2호선,영등포구청,6345,6528,12873
<class,2호선,당산,6383,7068,13451
<class,2호선,합정,16532,17063,33595
<class,2호선,홍대입구,41179,40204,81383
<class,2호선,신촌,18577,17784,36361
<class,2호선,이대,5838,6260,12098
<class,2호선,아현,4067,4247,8314
<class,2호선,충정로,2906,3165,6071
<class,2호선,용답,1284,1413,2697
<class,2호선,신답,518,614,1132
<class,2호선,신설동,2435,2542,4977
<class,2호선,도림천,316,353,669
<class,2호선,양천구청,2496,2625,5121
<class,2호선,신정네거리,3997,4137,8134
<class,2호선,용두,725,799,1524
<class,3호선,지축,1521,1474,2995
<class,3호선,구파발,8608,8578,17186
<class,3호선,연신내,16556,16080,32636
<class,3호선,불광,7422,8430,15852
<class,3호선,녹번,5768,5249,11017
<class,3호선,홍제,6793,6786,13579
<class,3호선,무악재,1448,1586,3034
<class,3호선,독립문,2734,2813,5547
<class,3호선,안국,6893,7044,13937
<class,3호선,종로3가,3325,3942,7267
<class,3호선,을지로3가,2839,2674,5513
<class,3호선,동대입구,5092,5200,10292
<class,3호선,약수,5096,4924,10020
<class,3호선,금호,3305,3150,6455
<class,3호선,옥수,3436,3870,7306
<class,3호선,압구정,11546,11788,23334
<class,3호선,신사,11330,11245,22575
<class,3호선,잠원,1587,1704,3291
<class,3호선,고속터미널,34731,32312,67043
<class,3호선,교대,3268,2047,5315
<class,3호선,남부터미널,12378,12768,25146
<class,3호선,양재,10473,12136,22609
<class,3호선,매봉,3307,3456,6763
<class,3호선,도곡,1379,1506,2885
<class,3호선,대치,4049,3819,7868
<class,3호선,학여울,689,703,1392
<class,3호선,대청,3292,3150,6442
<class,3호선,일원,2509,2783,5292
<class,3호선,수서,9027,8636,17663
<class,3호선,가락시장,2841,3025,5866
<class,3호선,경찰병원,2279,2374,4653
<class,3호선,오금,2141,2176,4317
<class,4호선,수유,16169,15844,32013
<class,4호선,미아,6241,6107,12348
<class,4호선,미아사거리,12953,12556,25509
<class,4호선,길음,7861,8022,15883
<class,4호선,성신여대입구,10645,10121,20766
<class,4호선,한성대입구,5931,5990,11921
<class,4호선,혜화,19197,19321,38518
<class,4호선,동대문,4547,5295,9842
<class,4호선,동대문역사문화공원,7702,7052,14754
<class,4호선,충무로,6589,6670,13259
<class,4호선,명동,14355,13764,28119
<class,4호선,회현,11049,10797,21846
<class,4호선,서울역,3515,8942,12457
<class,4호선,숙대입구,5690,5512,11202
<class,4호선,삼각지,1902,2404,4306
<class,4호선,신용산,6803,6850,13653
<class,4호선,이촌,3320,3789,7109
<class,4호선,동작,395,432,827
<class,4호선,총신대입구,7834,8654,16488
<class,4호선,사당,12004,11129,23133
<class,4호선,남태령,514,358,872
<class,4호선,당고개,5592,5411,11003
<class,4호선,상계,7990,7629,15619
<class,4호선,노원,9965,10651,20616
<class,4호선,창동,11677,12449,24126
<class,4호선,쌍문,12699,11701,24400
<class,5호선,방화,2718,2816,5534
<class,5호선,개화산,2154,2209,4363
<class,5호선,김포공항,6314,6078,12392
<class,5호선,송정,2849,2997,5846
<class,5호선,마곡,2788,2840,5628
<class,5호선,발산,7467,7556,15023
<class,5호선,우장산,5314,5616,10930
<class,5호선,화곡,11582,10988,22570
<class,5호선,까치산,12560,12503,25063
<class,5호선,신정,5103,4871,9974
<class,5호선,목동,5869,6192,12061
<class,5호선,오목교,9497,9885,19382
<class,5호선,양평,2066,2090,4156
<class,5호선,영등포구청,944,1007,1951
<class,5호선,영등포시장,4229,4635,8864
<class,5호선,신길,1542,1782,3324
<class,5호선,여의도,6925,7021,13946
<class,5호선,여의나루,3505,4449,7954
<class,5호선,마포,3819,3960,7779
<class,5호선,공덕,3459,3566,7025
<class,5호선,애오개,2082,2189,4271
<class,5호선,충정로,1127,1252,2379
<class,5호선,서대문,4068,3991,8059
<class,5호선,광화문,9435,9331,18766
<class,5호선,종로3가,6947,5756,12703
<class,5호선,을지로4가,1059,1133,2192
<class,5호선,동대문역사문화공원,762,753,1515
<class,5호선,청구,1419,1272,2691
<class,5호선,신금호,2325,2599,4924
<class,5호선,행당,3049,2886,5935
<class,5호선,왕십리,2080,2374,4454
<class,5호선,마장,2279,2180,4459
<class,5호선,답십리,6262,5968,12230
<class,5호선,장한평,6239,6431,12670
<class,5호선,군자,5087,5518,10605
<class,5호선,아차산,7596,7622,15218
<class,5호선,광나루,5830,5714,11544
<class,5호선,천호,10376,9510,19886
<class,5호선,강동,7263,7241,14504
<class,5호선,길동,3456,3451,6907
<class,5호선,굽은다리,4526,4355,8881
<class,5호선,명일,3713,3778,7491
<class,5호선,고덕,3242,3262,6504
<class,5호선,상일동,5317,5372,10689
<class,5호선,둔촌동,3651,3767,7418
<class,5호선,올림픽공원,2134,2117,4251
<class,5호선,방이,3121,3105,6226
<class,5호선,오금,1257,1229,2486
<class,5호선,개롱,2405,2733,5138
<class,5호선,거여,3324,3302,6626
<class,5호선,마천,2684,2884,5568
<class,5호선,강일,1480,1496,2976
<class,5호선,미사,7068,7127,14195
<class,5호선,하남풍산,1775,1896,3671
<class,5호선,하남시청,3035,2950,5985
<class,5호선,하남검단산,3301,3278,6579
<class,6호선,응암,7179,7361,14540
<class,6호선,역촌,1587,1924,3511
<class,6호선,불광,2563,2193,4756
<class,6호선,독바위,1120,1326,2446
<class,6호선,연신내,1,0,1
<class,6호선,구산,3022,2340,5362
<class,6호선,새절,5008,5009,10017
<class,6호선,증산,4221,4441,8662
<class,6호선,디지털미디어시티,3808,4126,7934
<class,6호선,월드컵경기장,1743,1836,3579
<class,6호선,마포구청,5670,5524,11194
<class,6호선,망원,7169,7611,14780
<class,6호선,합정,7592,6624,14216
<class,6호선,상수,5267,5803,11070
<class,6호선,광흥창,3474,3436,6910
<class,6호선,대흥,3044,3301,6345
<class,6호선,공덕,5367,5065,10432
<class,6호선,효창공원앞,2605,2396,5001
<class,6호선,삼각지,2616,2161,4777
<class,6호선,녹사평,2664,2502,5166
<class,6호선,이태원,7300,6714,14014
<class,6호선,한강진,5427,5943,11370
<class,6호선,버티고개,793,875,1668
<class,6호선,약수,1258,1263,2521
<class,6호선,청구,1334,1331,2665
<class,6호선,신당,3693,4018,7711
<class,6호선,동묘앞,3904,4088,7992
<class,6호선,창신,1348,1210,2558
<class,6호선,보문,3285,3067,6352
<class,6호선,안암,3788,4078,7866
<class,6호선,고려대,3282,3277,6559
<class,6호선,월곡,3936,4060,7996
<class,6호선,상월곡,2480,2273,4753
<class,6호선,돌곶이,3922,3804,7726
<class,6호선,석계,4900,5185,10085
<class,6호선,태릉입구,2393,2497,4890
<class,6호선,화랑대,3940,3407,7347
<class,6호선,봉화산,3058,3012,6070
<class,6호선,신내,1,0,1
<class,7호선,장암,742,507,1249
<class,7호선,도봉산,3403,4866,8269
<class,7호선,수락산,5771,5691,11462
<class,7호선,마들,4701,4498,9199
<class,7호선,노원,9610,9274,18884
<class,7호선,중계,5276,4998,10274
<class,7호선,하계,7202,6966,14168
<class,7호선,공릉,5015,5263,10278
<class,7호선,태릉입구,3691,3421,7112
<class,7호선,먹골,4306,4383,8689
<class,7호선,중화,4507,4393,8900
<class,7호선,상봉,7434,6831,14265
<class,7호선,면목,6339,6437,12776
<class,7호선,사가정,6709,6792,13501
<class,7호선,용마산,2486,2640,5126
<class,7호선,중곡,4176,4323,8499
<class,7호선,군자,6073,4909,10982
<class,7호선,어린이대공원,4967,5098,10065
<class,7호선,건대입구,6565,6679,13244
<class,7호선,뚝섬유원지,3008,3001,6009
<class,7호선,청담,5554,6156,11710
<class,7호선,강남구청,4260,4495,8755
<class,7호선,학동,4857,5121,9978
<class,7호선,논현,4635,5038,9673
<class,7호선,반포,2225,2190,4415
<class,7호선,고속터미널,9838,6154,15992
<class,7호선,내방,4032,4364,8396
<class,7호선,이수,6589,6234,12823
<class,7호선,남성,4382,4361,8743
<class,7호선,숭실대입구,4314,4784,9098
<class,7호선,상도,4167,4207,8374
<class,7호선,장승배기,3841,3823,7664
<class,7호선,신대방삼거리,6383,6428,12811
<class,7호선,보라매,3274,3311,6585
<class,7호선,신풍,4601,4403,9004
<class,7호선,대림,5349,5023,10372
<class,7호선,남구로,5418,5235,10653
<class,7호선,가산디지털단지,8561,7501,16062
<class,7호선,철산,8012,8407,16419
<class,7호선,광명사거리,9438,9469,18907
<class,7호선,천왕,3793,3654,7447
<class,7호선,온수,2957,3095,6052
<class,7호선,까치울,2940,3071,6011
<class,7호선,부천종합운동장,1809,1665,3474
<class,7호선,춘의,2769,2723,5492
<class,7호선,신중동,5389,5360,10749
<class,분당선,수서,7712,7096,14808
<class,분당선,대모산입구,1568,1587,3155
<class,분당선,개포동,1531,1573,3104
<class,분당선,구룡,522,599,1121
<class,분당선,도곡,1964,1955,3919
<class,분당선,한티,6672,6475,13147
<class,분당선,선릉,2229,3387,5616
<class,과천선,범계,12118,11849,23967
<class,과천선,평촌,5039,4851,9890
<class,과천선,인덕원,9024,9416,18440
<class,과천선,정부과천청사,3223,3265,6488
<class,과천선,과천,2636,2537,5173
<class,과천선,대공원,1396,1470,2866
<class,과천선,경마공원,7953,7972,15925
<class,과천선,선바위,2772,2701,5473
<class,공항철도 1호선,영종,2015,1790,3805
<class,공항철도 1호선,인천공항2터미널,1623,1598,3221
<class,공항철도 1호선,인천공항1터미널,3209,3325,6534
<class,공항철도 1호선,공항화물청사,909,979,1888
<class,공항철도 1호선,운서,4129,4211,8340
<class,공항철도 1호선,청라국제도시,2486,2391,4877
<class,공항철도 1호선,검암,2759,2776,5535
<class,공항철도 1호선,계양,4068,4116,8184
<class,공항철도 1호선,김포공항,10015,5325,15340
<class,공항철도 1호선,마곡나루,1481,1603,3084
<class,공항철도 1호선,디지털미디어시티,2879,2847,5726
<class,공항철도 1호선,홍대입구,7954,7605,15559
<class,공항철도 1호선,공덕,869,1327,2196
<class,공항철도 1호선,서울역,6881,5701,12582
<class,경춘선,춘천,946,788,1734
<class,경춘선,남춘천,1755,1656,3411
<class,경춘선,김유정,230,217,447
<class,경춘선,강촌,308,238,546
<class,경춘선,백양리,196,200,396
<class,경춘선,굴봉산,107,111,218
<class,경춘선,가평,1144,854,1998
<class,경춘선,상천,138,117,255
<class,경춘선,청평,973,823,1796
<class,경춘선,대성리,301,205,506
<class,경춘선,마석,1756,1764,3520
<class,경춘선,천마산,730,665,1395
<class,경춘선,평내호평,2477,2319,4796
<class,경춘선,금곡,569,586,1155
<class,경춘선,사릉,1138,1200,2338
<class,경춘선,퇴계원,1432,1417,2849
<class,경춘선,별내,1371,1296,2667
<class,경춘선,갈매,1060,937,1997
<class,경춘선,신내,694,642,1336
<class,경인선,도화,1700,1707,3407
<class,경인선,중동,3677,3436,7113
<class,경인선,온수,2654,2644,5298
<class,경인선,도원,1081,1086,2167
<class,경인선,간석,2470,2376,4846
<class,경인선,부개,3615,3490,7105
<class,경인선,소사,3692,3655,7347
<class,경인선,구일,2212,2298,4510
<class,경인선,인천,2106,1474,3580
<class,경인선,동인천,7028,6857,13885
<class,경인선,제물포,4129,4159,8288
<class,경인선,주안,9703,8357,18060
<class,경인선,동암,7366,7222,14588
<class,경인선,백운,2840,2958,5798
<class,경인선,부평,18606,18353,36959
<class,경인선,송내,9906,9915,19821
<class,경인선,부천,16693,16223,32916
<class,경인선,역곡,10868,11043,21911
<class,경인선,오류동,5532,5122,10654
<class,경인선,개봉,8695,9022,17717
<class,경의선,임진강,19,21,40
<class,경의선,문산,2522,2702,5224
<class,경의선,파주,478,412,890
<class,경의선,월롱,656,1655,2311
<class,경의선,금촌,3175,3499,6674
<class,경의선,금릉,2204,2224,4428
<class,경의선,운정,2872,2764,5636
<class,경의선,야당,3683,3410,7093
<class,경의선,탄현,3263,3109,6372
<class,경의선,일산,3463,3372,6835
<class,경의선,풍산,2671,2536,5207
<class,경의선,백마,2464,2472,4936
<class,경의선,곡산,221,185,406
<class,경의선,능곡,1535,1567,3102
<class,경의선,행신,3607,3297,6904
<class,경의선,강매,1126,1049,2175
<class,경의선,화전,605,589,1194
<class,경의선,수색,628,722,1350
<class,경의선,디지털미디어시티,1114,1068,2182
<class,경의선,가좌,2083,2136,4219
<class,경의선,홍대입구,1227,1551,2778
<class,경의선,서강대,972,978,1950
<class,경의선,공덕,1435,1026,2461
<class,경의선,효창공원앞,964,1210,2174
<class,경의선,신촌,212,235,447
<class,경의선,서울역,864,749,1613
<class,경원선,소요산,1667,1373,3040
<class,경원선,동두천,981,1204,2185
<class,경원선,보산,1045,1009,2054
<class,경원선,동두천중앙,1507,1448,2955
<class,경원선,지행,3327,3280,6607
<class,경원선,덕정,2464,2715,5179
<class,경원선,덕계,1236,1243,2479
<class,경원선,양주,3560,3664,7224
<class,경원선,녹양,2098,1969,4067
<class,경원선,가능,2789,2729,5518
<class,경원선,의정부,11757,11495,23252
<class,경원선,회룡,5307,5233,10540
<class,경원선,망월사,3390,3439,6829
<class,경원선,도봉산,4614,3202,7816
<class,경원선,도봉,2435,2320,4755
<class,경원선,방학,4319,4228,8547
<class,경원선,녹천,1977,1766,3743
<class,경원선,월계,2559,2299,4858
<class,경원선,광운대,3094,3202,6296
<class,경원선,석계,3567,3949,7516
<class,경원선,신이문,3553,3450,7003
<class,경원선,외대앞,3892,3731,7623
<class,경원선,청량리,11802,10373,22175
<class,경원선,왕십리,7916,8630,16546
<class,경원선,응봉,688,651,1339
<class,경원선,옥수,63,20,83
<class,경원선,한남,1404,1418,2822
<class,경원선,서빙고,969,1060,2029
<class,경원선,이촌,1588,1266,2854
<class,경부선,광명,2258,1493,3751
<class,경부선,서동탄,536,532,1068
<class,경부선,당정,2145,2258,4403
<class,경부선,천안,4600,4641,9241
<class,경부선,두정,3527,3684,7211
<class,경부선,직산,430,467,897
<class,경부선,성환,1753,2135,3888
<class,경부선,평택,9297,9605,18902
<class,경부선,평택지제,2023,1964,3987
<class,경부선,서정리,3480,5305,8785
<class,경부선,송탄,3004,3675,6679
<class,경부선,진위,656,702,1358
<class,경부선,오산,6073,6686,12759
<class,경부선,오산대,1606,1542,3148
<class,경부선,세마,1352,1346,2698
<class,경부선,병점,7283,8129,15412
<class,경부선,세류,1611,1574,3185
<class,경부선,독산,4771,4901,9672
<class,경부선,수원,28096,27139,55235
<class,경부선,화서,2971,2931,5902
<class,경부선,성균관대,6119,6610,12729
<class,경부선,의왕,3078,3232,6310
<class,경부선,군포,2319,2258,4577
<class,경부선,금정,10644,11216,21860
<class,경부선,명학,2431,2334,4765
<class,경부선,안양,10266,10047,20313
<class,경부선,관악,3149,2943,6092
<class,경부선,석수,3568,3408,6976
<class,경부선,금천구청,4572,4406,8978
<class,경부선,가산디지털단지,3483,5006,8489
<class,경부선,구로,7575,7610,15185
<class,경부선,신길,3592,3196,6788
<class,경부선,신도림,1489,1446,2935
<class,경부선,영등포,29314,27097,56411
<class,경부선,대방,4460,4857,9317
<class,경부선,노량진,4309,4343,8652
<class,경부선,용산,29347,25430,54777
<class,경부선,남영,3230,3477,6707
<class,경부선,서울역,6819,1663,8482
<class,경강선,여주,1456,1438,2894
<class,경강선,세종대왕릉,180,172,352
<class,경강선,부발,1018,1721,2739
<class,경강선,이천,1720,1852,3572
<class,경강선,신둔도예촌,706,721,1427
<class,경강선,곤지암,1160,1225,2385
<class,경강선,초월,1243,1301,2544
<class,경강선,경기광주,3222,3251,6473
<class,경강선,삼동,779,805,1584
<class,경강선,이매,485,357,842
<class,경강선,판교,2187,2053,4240
<class,9호선2~3단계,중앙보훈병원,2637,2524,5161
<class,9호선2~3단계,둔촌오륜,373,384,757
<class,9호선2~3단계,올림픽공원,5974,5852,11826
<class,9호선2~3단계,한성백제,1026,987,2013
<class,9호선2~3단계,송파나루,2850,3033,5883
<class,9호선2~3단계,석촌,3660,3212,6872
<class,9호선2~3단계,석촌고분,2596,2632,5228
<class,9호선2~3단계,삼전,2922,3054,5976
<class,9호선2~3단계,종합운동장,1735,1530,3265
<class,9호선2~3단계,봉은사,11366,12442,23808
<class,9호선2~3단계,삼성중앙,1577,1732,3309
<class,9호선2~3단계,선정릉,2422,2657,5079
<class,9호선2~3단계,언주,3387,3335,6722
<class,9호선,신논현,13516,12405,25921
<class,9호선,사평,1235,1333,2568
<class,9호선,고속터미널,8216,10720,18936
<class,9호선,신반포,1237,1308,2545
<class,9호선,구반포,668,580,1248
<class,9호선,동작,840,672,1512
<class,9호선,흑석,3022,3241,6263
<class,9호선,노들,2038,1813,3851
<class,9호선,노량진,11927,12874,24801
<class,9호선,샛강,1279,1344,2623
<class,9호선,여의도,7666,6731,14397
<class,9호선,국회의사당,3788,3530,7318
<class,9호선,당산,7224,7372,14596
<class,9호선,선유도,2297,2369,4666
<class,9호선,신목동,1352,1209,2561
<class,9호선,염창,6852,6876,13728
<class,9호선,등촌,4190,4330,8520
<class,9호선,증미,2094,2093,4187
<class,9호선,가양,7910,7869,15779
<class,9호선,양천향교,3431,3652,7083
<class,9호선,마곡나루,4119,4047,8166
<class,9호선,신방화,2745,2799,5544
<class,9호선,공항시장,1450,1573,3023
<class,9호선,김포공항,6309,10568,16877
<class,9호선,개화,726,677,1403
<class,8호선,남위례,1411,1519,2930
<class,8호선,모란,2133,1732,3865
<class,8호선,수진,2605,2418,5023
<class,8호선,신흥,2239,2470,4709
<class,8호선,단대오거리,4438,4529,8967
<class,8호선,남한산성입구,5156,4933,10089
<class,8호선,산성,2285,2436,4721
<class,8호선,복정,3488,3256,6744
<class,8호선,장지,7875,8044,15919
<class,8호선,문정,4300,4472,8772
<class,8호선,가락시장,2390,3149,5539
<class,8호선,송파,2953,3131,6084
<class,8호선,석촌,3541,4351,7892
<class,8호선,잠실,9369,10511,19880
<class,8호선,몽촌토성,2619,2558,5177
<class,8호선,강동구청,3619,4010,7629
<class,8호선,천호,7434,8512,15946
<class,8호선,암사,7207,7005,14212
<class,7호선,부평구청,2769,2615,5384
<class,7호선,굴포천,3769,3821,7590
<class,7호선,삼산체육관,2072,2018,4090
<class,7호선,상동,5930,5652,11582
