사용일자,호선명,지하철역,승차총승객수,하차총승객수,승하차총승객수
20210101,9호선2~3단계,언주,1451,1365,2816
20210101,9호선2~3단계,중앙보훈병원,1448,1394,2842
20210101,9호선2~3단계,둔촌오륜,176,190,366
20210101,9호선2~3단계,올림픽공원,1229,1199,2428
20210101,9호선2~3단계,송파나루,1195,1153,2348
20210101,9호선2~3단계,석촌,1951,1645,3596
20210101,9호선2~3단계,한성백제,585,494,1079
20210101,9호선2~3단계,삼전,1817,1669,3486
20210101,9호선2~3단계,종합운동장,926,872,1798
20210101,9호선2~3단계,봉은사,3334,3292,6626
20210101,9호선2~3단계,삼성중앙,898,908,1806
20210101,9호선2~3단계,선정릉,1371,1379,2750
20210101,9호선2~3단계,석촌고분,1537,1443,2980
20210102,9호선2~3단계,종합운동장,1446,1400,2846
20210102,9호선2~3단계,언주,2723,2665,5388
20210102,9호선2~3단계,선정릉,2062,2321,4383
20210102,9호선2~3단계,삼성중앙,1575,1595,3170
20210102,9호선2~3단계,봉은사,4492,4367,8859
20210102,9호선2~3단계,삼전,2702,2621,5323
20210102,9호선2~3단계,올림픽공원,1915,1910,3825
20210102,9호선2~3단계,석촌,2824,2523,5347
20210102,9호선2~3단계,송파나루,1811,1899,3710
20210102,9호선2~3단계,한성백제,857,777,1634
20210102,9호선2~3단계,둔촌오륜,278,274,552
20210102,9호선2~3단계,중앙보훈병원,2199,1996,4195
20210102,9호선2~3단계,석촌고분,2227,2271,4498
20210103,9호선2~3단계,한성백제,628,663,1291
20210103,9호선2~3단계,선정릉,1527,1737,3264
20210103,9호선2~3단계,언주,1704,1822,3526
20210103,9호선2~3단계,중앙보훈병원,1723,1642,3365
20210103,9호선2~3단계,올림픽공원,1463,1473,2936
20210103,9호선2~3단계,송파나루,1332,1521,2853
20210103,9호선2~3단계,둔촌오륜,227,232,459
20210103,9호선2~3단계,석촌고분,1767,1890,3657
20210103,9호선2~3단계,삼전,2021,2132,4153
20210103,9호선2~3단계,석촌,2172,2041,4213
20210103,9호선2~3단계,종합운동장,1050,1101,2151
20210103,9호선2~3단계,봉은사,3390,3331,6721
20210103,9호선2~3단계,삼성중앙,1152,1214,2366
20210104,9호선2~3단계,선정릉,7720,8207,15927
20210104,9호선2~3단계,삼성중앙,5686,5736,11422
20210104,9호선2~3단계,봉은사,11899,11921,23820
20210104,9호선2~3단계,종합운동장,3271,3224,6495
20210104,9호선2~3단계,삼전,5354,5243,10597
20210104,9호선2~3단계,석촌고분,4695,4796,9491
20210104,9호선2~3단계,언주,8307,8337,16644
20210104,9호선2~3단계,송파나루,3396,3682,7078
20210104,9호선2~3단계,한성백제,1870,1730,3600
20210104,9호선2~3단계,올림픽공원,4174,4078,8252
20210104,9호선2~3단계,둔촌오륜,790,760,1550
20210104,9호선2~3단계,중앙보훈병원,8104,7247,15351
20210104,9호선2~3단계,석촌,5947,5456,11403
20210105,9호선2~3단계,언주,8336,8415,16751
20210105,9호선2~3단계,선정릉,7619,8237,15856
20210105,9호선2~3단계,삼성중앙,5730,5870,11600
20210105,9호선2~3단계,봉은사,12085,12032,24117
20210105,9호선2~3단계,종합운동장,3285,3190,6475
20210105,9호선2~3단계,삼전,5352,5305,10657
20210105,9호선2~3단계,석촌고분,4737,4867,9604
20210105,9호선2~3단계,송파나루,3583,3787,7370
20210105,9호선2~3단계,한성백제,1880,1774,3654
20210105,9호선2~3단계,올림픽공원,4084,4005,8089
20210105,9호선2~3단계,둔촌오륜,828,769,1597
20210105,9호선2~3단계,중앙보훈병원,8230,7197,15427
20210105,9호선2~3단계,석촌,6139,5379,11518
20210106,9호선2~3단계,삼전,5904,6414,12318
20210106,9호선2~3단계,언주,10125,8947,19072
20210106,9호선2~3단계,선정릉,8046,8455,16501
20210106,9호선2~3단계,삼성중앙,6928,6107,13035
20210106,9호선2~3단계,종합운동장,3646,3538,7184
20210106,9호선2~3단계,석촌고분,5060,5720,10780
20210106,9호선2~3단계,봉은사,13641,12248,25889
20210106,9호선2~3단계,송파나루,3963,4273,8236
20210106,9호선2~3단계,중앙보훈병원,8085,7375,15460
20210106,9호선2~3단계,둔촌오륜,846,830,1676
20210106,9호선2~3단계,석촌,6124,5670,11794
20210106,9호선2~3단계,한성백제,2084,1976,4060
20210106,9호선2~3단계,올림픽공원,4049,4204,8253
20210107,9호선2~3단계,언주,10306,10179,20485
20210107,9호선2~3단계,선정릉,8222,8679,16901
20210107,9호선2~3단계,삼성중앙,6587,6980,13567
20210107,9호선2~3단계,봉은사,13447,13655,27102
20210107,9호선2~3단계,삼전,6983,6623,13606
20210107,9호선2~3단계,석촌고분,6163,6045,12208
20210107,9호선2~3단계,종합운동장,4358,3953,8311
20210107,9호선2~3단계,송파나루,4542,4679,9221
20210107,9호선2~3단계,한성백제,2464,2299,4763
20210107,9호선2~3단계,올림픽공원,4651,4566,9217
20210107,9호선2~3단계,둔촌오륜,1088,898,1986
20210107,9호선2~3단계,중앙보훈병원,8592,7839,16431
20210107,9호선2~3단계,석촌,6356,5581,11937
20210108,9호선2~3단계,송파나루,4049,4201,8250
20210108,9호선2~3단계,중앙보훈병원,8114,6976,15090
20210108,9호선2~3단계,둔촌오륜,888,806,1694
20210108,9호선2~3단계,올림픽공원,4098,4013,8111
20210108,9호선2~3단계,한성백제,2079,1875,3954
20210108,9호선2~3단계,석촌,6221,5541,11762
20210108,9호선2~3단계,선정릉,7749,8231,15980
20210108,9호선2~3단계,삼전,6079,5793,11872
20210108,9호선2~3단계,종합운동장,3748,3498,7246
20210108,9호선2~3단계,봉은사,12648,12621,25269
20210108,9호선2~3단계,삼성중앙,5915,6114,12029
20210108,9호선2~3단계,언주,9204,9234,18438
20210108,9호선2~3단계,석촌고분,5402,5423,10825
20210109,9호선2~3단계,삼전,3534,3466,7000
20210109,9호선2~3단계,선정릉,2998,3159,6157
20210109,9호선2~3단계,삼성중앙,2156,2122,4278
20210109,9호선2~3단계,봉은사,5856,5914,11770
20210109,9호선2~3단계,종합운동장,1933,1811,3744
20210109,9호선2~3단계,언주,4213,4098,8311
20210109,9호선2~3단계,석촌고분,3049,2978,6027
20210109,9호선2~3단계,송파나루,2526,2616,5142
20210109,9호선2~3단계,한성백제,1228,1082,2310
20210109,9호선2~3단계,올림픽공원,2156,2116,4272
20210109,9호선2~3단계,둔촌오륜,449,411,860
20210109,9호선2~3단계,중앙보훈병원,2537,2287,4824
20210109,9호선2~3단계,석촌,3769,3175,6944
20210110,9호선2~3단계,선정릉,1871,2078,3949
20210110,9호선2~3단계,삼성중앙,1234,1325,2559
20210110,9호선2~3단계,봉은사,4184,4049,8233
20210110,9호선2~3단계,종합운동장,1178,1128,2306
20210110,9호선2~3단계,삼전,2402,2399,4801
20210110,9호선2~3단계,석촌고분,2028,2046,4074
20210110,9호선2~3단계,언주,2280,2272,4552
20210110,9호선2~3단계,송파나루,1675,1758,3433
20210110,9호선2~3단계,한성백제,799,693,1492
20210110,9호선2~3단계,올림픽공원,1546,1547,3093
20210110,9호선2~3단계,둔촌오륜,281,261,542
20210110,9호선2~3단계,중앙보훈병원,1782,1737,3519
20210110,9호선2~3단계,석촌,2588,2192,4780
20210111,9호선2~3단계,중앙보훈병원,8273,7402,15675
20210111,9호선2~3단계,둔촌오륜,873,782,1655
20210111,9호선2~3단계,올림픽공원,4263,4072,8335
20210111,9호선2~3단계,한성백제,1958,1863,3821
20210111,9호선2~3단계,송파나루,3709,3913,7622
20210111,9호선2~3단계,석촌,6219,5568,11787
20210111,9호선2~3단계,석촌고분,4942,5014,9956
20210111,9호선2~3단계,종합운동장,3399,3306,6705
20210111,9호선2~3단계,봉은사,12395,12308,24703
20210111,9호선2~3단계,삼성중앙,5771,6010,11781
20210111,9호선2~3단계,선정릉,7950,8401,16351
20210111,9호선2~3단계,언주,8856,8926,17782
20210111,9호선2~3단계,삼전,5720,5684,11404
20210112,9호선2~3단계,종합운동장,3703,3704,7407
20210112,9호선2~3단계,언주,10294,9224,19518
20210112,9호선2~3단계,선정릉,8529,8908,17437
20210112,9호선2~3단계,삼성중앙,6925,6605,13530
20210112,9호선2~3단계,봉은사,13921,12721,26642
20210112,9호선2~3단계,삼전,6086,6504,12590
20210112,9호선2~3단계,올림픽공원,4647,4556,9203
20210112,9호선2~3단계,석촌,6463,5921,12384
20210112,9호선2~3단계,송파나루,4100,4542,8642
20210112,9호선2~3단계,한성백제,2309,2089,4398
20210112,9호선2~3단계,석촌고분,5468,5899,11367
20210112,9호선2~3단계,둔촌오륜,1000,819,1819
20210112,9호선2~3단계,중앙보훈병원,8586,7508,16094
20210113,9호선2~3단계,선정릉,8167,8722,16889
20210113,9호선2~3단계,삼성중앙,5976,6342,12318
20210113,9호선2~3단계,봉은사,12925,13221,26146
20210113,9호선2~3단계,종합운동장,3549,3543,7092
20210113,9호선2~3단계,삼전,6060,5793,11853
20210113,9호선2~3단계,석촌고분,5266,5322,10588
20210113,9호선2~3단계,석촌,6576,5745,12321
20210113,9호선2~3단계,송파나루,3984,4083,8067
20210113,9호선2~3단계,한성백제,2206,2044,4250
20210113,9호선2~3단계,올림픽공원,4660,4602,9262
20210113,9호선2~3단계,둔촌오륜,904,840,1744
20210113,9호선2~3단계,중앙보훈병원,8689,7711,16400
20210113,9호선2~3단계,언주,8941,9260,18201
20210114,9호선2~3단계,둔촌오륜,873,784,1657
20210114,9호선2~3단계,올림픽공원,4584,4398,8982
20210114,9호선2~3단계,한성백제,2107,1931,4038
20210114,9호선2~3단계,송파나루,3837,4025,7862
20210114,9호선2~3단계,석촌,6464,5683,12147
20210114,9호선2~3단계,석촌고분,5088,5133,10221
20210114,9호선2~3단계,중앙보훈병원,8247,7219,15466
20210114,9호선2~3단계,종합운동장,3490,3461,6951
20210114,9호선2~3단계,봉은사,12675,12860,25535
20210114,9호선2~3단계,삼성중앙,5854,6155,12009
20210114,9호선2~3단계,선정릉,8230,8746,16976
20210114,9호선2~3단계,언주,8915,8994,17909
20210114,9호선2~3단계,삼전,5745,5593,11338
20210115,9호선2~3단계,둔촌오륜,894,811,1705
20210115,9호선2~3단계,올림픽공원,4426,4334,8760
20210115,9호선2~3단계,한성백제,2068,1932,4000
20210115,9호선2~3단계,송파나루,3977,4117,8094
20210115,9호선2~3단계,석촌,6748,5963,12711
20210115,9호선2~3단계,석촌고분,5145,5166,10311
20210115,9호선2~3단계,중앙보훈병원,8161,7149,15310
20210115,9호선2~3단계,종합운동장,3545,3535,7080
20210115,9호선2~3단계,봉은사,12848,12690,25538
20210115,9호선2~3단계,삼성중앙,5790,5951,11741
20210115,9호선2~3단계,선정릉,8305,8886,17191
20210115,9호선2~3단계,언주,9076,8967,18043
20210115,9호선2~3단계,삼전,5792,5655,11447
20210116,9호선2~3단계,중앙보훈병원,2913,2690,5603
20210116,9호선2~3단계,둔촌오륜,489,437,926
20210116,9호선2~3단계,올림픽공원,2650,2516,5166
20210116,9호선2~3단계,한성백제,1243,1121,2364
20210116,9호선2~3단계,송파나루,2664,2773,5437
20210116,9호선2~3단계,석촌,4242,3675,7917
20210116,9호선2~3단계,석촌고분,3225,3117,6342
20210116,9호선2~3단계,종합운동장,2037,1911,3948
20210116,9호선2~3단계,봉은사,6458,6577,13035
20210116,9호선2~3단계,삼성중앙,2302,2269,4571
20210116,9호선2~3단계,선정릉,3288,3625,6913
20210116,9호선2~3단계,언주,4444,4382,8826
20210116,9호선2~3단계,삼전,3799,3445,7244
20210117,9호선2~3단계,석촌,2780,2408,5188
20210117,9호선2~3단계,둔촌오륜,274,280,554
20210117,9호선2~3단계,올림픽공원,1751,1759,3510
20210117,9호선2~3단계,한성백제,794,783,1577
20210117,9호선2~3단계,송파나루,1784,1942,3726
20210117,9호선2~3단계,석촌고분,2122,2222,4344
20210117,9호선2~3단계,중앙보훈병원,1904,1850,3754
20210117,9호선2~3단계,종합운동장,1340,1239,2579
20210117,9호선2~3단계,봉은사,4496,4361,8857
20210117,9호선2~3단계,삼성중앙,1333,1394,2727
20210117,9호선2~3단계,삼전,2496,2537,5033
20210117,9호선2~3단계,언주,2524,2494,5018
20210117,9호선2~3단계,선정릉,2110,2310,4420
20210118,9호선2~3단계,언주,9564,9616,19180
20210118,9호선2~3단계,선정릉,8662,9212,17874
20210118,9호선2~3단계,삼성중앙,6382,6577,12959
20210118,9호선2~3단계,봉은사,13677,13702,27379
20210118,9호선2~3단계,종합운동장,3842,3698,7540
20210118,9호선2~3단계,삼전,6296,6193,12489
20210118,9호선2~3단계,둔촌오륜,903,878,1781
20210118,9호선2~3단계,석촌,6761,6009,12770
20210118,9호선2~3단계,송파나루,4166,4358,8524
20210118,9호선2~3단계,한성백제,2242,2025,4267
20210118,9호선2~3단계,올림픽공원,5010,4818,9828
20210118,9호선2~3단계,중앙보훈병원,8897,7841,16738
20210118,9호선2~3단계,석촌고분,5453,5451,10904
20210119,9호선2~3단계,중앙보훈병원,8430,7526,15956
20210119,9호선2~3단계,둔촌오륜,897,806,1703
20210119,9호선2~3단계,올림픽공원,4551,4542,9093
20210119,9호선2~3단계,한성백제,2122,1904,4026
20210119,9호선2~3단계,송파나루,3953,4202,8155
20210119,9호선2~3단계,석촌,6677,5970,12647
20210119,9호선2~3단계,석촌고분,5240,5271,10511
20210119,9호선2~3단계,종합운동장,3495,3514,7009
20210119,9호선2~3단계,봉은사,13261,13361,26622
20210119,9호선2~3단계,삼성중앙,6136,6401,12537
20210119,9호선2~3단계,언주,9128,9164,18292
20210119,9호선2~3단계,삼전,5892,5741,11633
20210119,9호선2~3단계,선정릉,8471,9060,17531
20210120,9호선2~3단계,언주,9173,9276,18449
20210120,9호선2~3단계,삼전,6020,5868,11888
20210120,9호선2~3단계,선정릉,8547,9326,17873
20210120,9호선2~3단계,삼성중앙,6343,6630,12973
20210120,9호선2~3단계,봉은사,13938,13912,27850
20210120,9호선2~3단계,종합운동장,3782,3775,7557
20210120,9호선2~3단계,석촌고분,5419,5477,10896
20210120,9호선2~3단계,한성백제,2144,1969,4113
20210120,9호선2~3단계,올림픽공원,4580,4631,9211
20210120,9호선2~3단계,둔촌오륜,917,845,1762
20210120,9호선2~3단계,중앙보훈병원,8752,7634,16386
20210120,9호선2~3단계,석촌,6769,6099,12868
20210120,9호선2~3단계,송파나루,4119,4382,8501
20210121,9호선2~3단계,선정릉,8519,9260,17779
20210121,9호선2~3단계,삼성중앙,6517,6630,13147
20210121,9호선2~3단계,봉은사,14072,13800,27872
20210121,9호선2~3단계,종합운동장,3796,3608,7404
20210121,9호선2~3단계,삼전,5938,6093,12031
20210121,9호선2~3단계,석촌고분,5351,5539,10890
20210121,9호선2~3단계,언주,9531,9376,18907
20210121,9호선2~3단계,송파나루,4311,4361,8672
20210121,9호선2~3단계,한성백제,2132,2000,4132
20210121,9호선2~3단계,올림픽공원,4623,4451,9074
20210121,9호선2~3단계,둔촌오륜,913,871,1784
20210121,9호선2~3단계,중앙보훈병원,8437,7478,15915
20210121,9호선2~3단계,석촌,6804,6026,12830
20210122,9호선2~3단계,언주,9289,9281,18570
20210122,9호선2~3단계,선정릉,8630,9196,17826
20210122,9호선2~3단계,삼성중앙,6460,6640,13100
20210122,9호선2~3단계,봉은사,13754,13723,27477
20210122,9호선2~3단계,종합운동장,4091,3784,7875
20210122,9호선2~3단계,삼전,6105,5950,12055
20210122,9호선2~3단계,석촌고분,5417,5375,10792
20210122,9호선2~3단계,송파나루,4162,4445,8607
20210122,9호선2~3단계,한성백제,2243,2023,4266
20210122,9호선2~3단계,올림픽공원,4862,4728,9590
20210122,9호선2~3단계,둔촌오륜,920,851,1771
20210122,9호선2~3단계,중앙보훈병원,8764,7407,16171
20210122,9호선2~3단계,석촌,7091,6224,13315
20210123,9호선2~3단계,석촌,4919,4200,9119
20210123,9호선2~3단계,중앙보훈병원,3229,3013,6242
20210123,9호선2~3단계,둔촌오륜,569,506,1075
20210123,9호선2~3단계,올림픽공원,3029,3074,6103
20210123,9호선2~3단계,송파나루,2940,3106,6046
20210123,9호선2~3단계,석촌고분,3383,3268,6651
20210123,9호선2~3단계,한성백제,1397,1184,2581
20210123,9호선2~3단계,종합운동장,2251,2093,4344
20210123,9호선2~3단계,봉은사,7412,7372,14784
20210123,9호선2~3단계,삼전,3947,3718,7665
20210123,9호선2~3단계,삼성중앙,2424,2398,4822
20210123,9호선2~3단계,선정릉,3833,4164,7997
20210123,9호선2~3단계,언주,4857,4879,9736
20210124,9호선2~3단계,중앙보훈병원,2334,2288,4622
20210124,9호선2~3단계,둔촌오륜,317,329,646
20210124,9호선2~3단계,올림픽공원,2241,2214,4455
20210124,9호선2~3단계,한성백제,1047,912,1959
20210124,9호선2~3단계,송파나루,2035,2228,4263
20210124,9호선2~3단계,석촌,3242,2948,6190
20210124,9호선2~3단계,석촌고분,2339,2328,4667
20210124,9호선2~3단계,삼전,2697,2667,5364
20210124,9호선2~3단계,종합운동장,1363,1335,2698
20210124,9호선2~3단계,봉은사,4877,4683,9560
20210124,9호선2~3단계,삼성중앙,1416,1513,2929
20210124,9호선2~3단계,선정릉,2363,2514,4877
20210124,9호선2~3단계,언주,2729,2722,5451
20210125,9호선2~3단계,둔촌오륜,910,868,1778
20210125,9호선2~3단계,올림픽공원,4922,4772,9694
20210125,9호선2~3단계,한성백제,2181,2022,4203
20210125,9호선2~3단계,송파나루,3991,4280,8271
20210125,9호선2~3단계,석촌,7043,6260,13303
20210125,9호선2~3단계,석촌고분,5209,5339,10548
20210125,9호선2~3단계,중앙보훈병원,8907,7906,16813
20210125,9호선2~3단계,종합운동장,3623,3665,7288
20210125,9호선2~3단계,봉은사,13471,13565,27036
20210125,9호선2~3단계,삼성중앙,6286,6528,12814
20210125,9호선2~3단계,선정릉,8829,9522,18351
20210125,9호선2~3단계,언주,9172,9421,18593
20210125,9호선2~3단계,삼전,5988,5870,11858
20210126,9호선2~3단계,둔촌오륜,967,863,1830
20210126,9호선2~3단계,올림픽공원,4718,4654,9372
20210126,9호선2~3단계,한성백제,2122,2022,4144
20210126,9호선2~3단계,송파나루,4181,4480,8661
20210126,9호선2~3단계,석촌,6961,6243,13204
20210126,9호선2~3단계,석촌고분,5204,5338,10542
20210126,9호선2~3단계,중앙보훈병원,8959,7845,16804
20210126,9호선2~3단계,종합운동장,3752,3710,7462
20210126,9호선2~3단계,봉은사,13759,13717,27476
20210126,9호선2~3단계,삼성중앙,6584,6807,13391
20210126,9호선2~3단계,선정릉,8780,9407,18187
20210126,9호선2~3단계,언주,9620,9542,19162
20210126,9호선2~3단계,삼전,6063,6061,12124
20210127,9호선2~3단계,중앙보훈병원,9096,8072,17168
20210127,9호선2~3단계,둔촌오륜,916,837,1753
20210127,9호선2~3단계,올림픽공원,4844,4821,9665
20210127,9호선2~3단계,한성백제,2310,2080,4390
20210127,9호선2~3단계,송파나루,4225,4459,8684
20210127,9호선2~3단계,석촌,7247,6332,13579
20210127,9호선2~3단계,석촌고분,5533,5563,11096
20210127,9호선2~3단계,종합운동장,3874,3762,7636
20210127,9호선2~3단계,봉은사,14505,14638,29143
20210127,9호선2~3단계,삼성중앙,6519,6791,13310
20210127,9호선2~3단계,선정릉,8882,9586,18468
20210127,9호선2~3단계,언주,9453,9441,18894
20210127,9호선2~3단계,삼전,6188,6159,12347
20210128,9호선2~3단계,석촌,7061,6248,13309
20210128,9호선2~3단계,둔촌오륜,918,857,1775
20210128,9호선2~3단계,올림픽공원,4866,4704,9570
20210128,9호선2~3단계,한성백제,2264,2044,4308
20210128,9호선2~3단계,송파나루,4368,4612,8980
20210128,9호선2~3단계,석촌고분,5517,5606,11123
20210128,9호선2~3단계,중앙보훈병원,8889,7790,16679
20210128,9호선2~3단계,종합운동장,3962,3686,7648
20210128,9호선2~3단계,언주,9694,9808,19502
20210128,9호선2~3단계,선정릉,8595,9516,18111
20210128,9호선2~3단계,삼전,6202,6273,12475
20210128,9호선2~3단계,봉은사,14251,14257,28508
20210128,9호선2~3단계,삼성중앙,6553,6850,13403
20210129,9호선2~3단계,둔촌오륜,866,838,1704
20210129,9호선2~3단계,올림픽공원,4688,4479,9167
20210129,9호선2~3단계,한성백제,2168,1977,4145
20210129,9호선2~3단계,송파나루,4239,4513,8752
20210129,9호선2~3단계,석촌,7032,6297,13329
20210129,9호선2~3단계,석촌고분,5372,5541,10913
20210129,9호선2~3단계,중앙보훈병원,8527,7392,15919
20210129,9호선2~3단계,종합운동장,3835,3797,7632
20210129,9호선2~3단계,봉은사,13932,13867,27799
20210129,9호선2~3단계,삼성중앙,6431,6600,13031
20210129,9호선2~3단계,선정릉,8785,9399,18184
20210129,9호선2~3단계,언주,9531,9460,18991
20210129,9호선2~3단계,삼전,6148,5931,12079
20210130,9호선2~3단계,중앙보훈병원,3267,2996,6263
20210130,9호선2~3단계,둔촌오륜,556,502,1058
20210130,9호선2~3단계,올림픽공원,2907,3055,5962
20210130,9호선2~3단계,한성백제,1462,1249,2711
20210130,9호선2~3단계,송파나루,3031,3276,6307
20210130,9호선2~3단계,석촌,4983,4178,9161
20210130,9호선2~3단계,석촌고분,3465,3335,6800
20210130,9호선2~3단계,종합운동장,2447,2139,4586
20210130,9호선2~3단계,봉은사,7705,7790,15495
20210130,9호선2~3단계,삼성중앙,2523,2551,5074
20210130,9호선2~3단계,언주,4816,4712,9528
20210130,9호선2~3단계,삼전,4044,3795,7839
20210130,9호선2~3단계,선정릉,3765,4198,7963
20210131,9호선2~3단계,중앙보훈병원,2148,2096,4244
20210131,9호선2~3단계,석촌,3393,2882,6275
20210131,9호선2~3단계,둔촌오륜,363,342,705
20210131,9호선2~3단계,올림픽공원,2283,2282,4565
20210131,9호선2~3단계,한성백제,1001,896,1897
20210131,9호선2~3단계,송파나루,1994,2320,4314
20210131,9호선2~3단계,석촌고분,2373,2368,4741
20210131,9호선2~3단계,종합운동장,1501,1391,2892
20210131,9호선2~3단계,봉은사,5303,5173,10476
20210131,9호선2~3단계,삼성중앙,1533,1627,3160
20210131,9호선2~3단계,선정릉,2348,2590,4938
20210131,9호선2~3단계,언주,2703,2800,5503
20210131,9호선2~3단계,삼전,2831,2902,5733
20210201,9호선2~3단계,선정릉,8858,9489,18347
20210201,9호선2~3단계,삼성중앙,6625,6843,13468
20210201,9호선2~3단계,봉은사,14219,14127,28346
20210201,9호선2~3단계,종합운동장,3763,3758,7521
20210201,9호선2~3단계,삼전,6112,6048,12160
20210201,9호선2~3단계,석촌고분,5296,5417,10713
20210201,9호선2~3단계,언주,9688,9682,19370
20210201,9호선2~3단계,송파나루,4227,4370,8597
20210201,9호선2~3단계,한성백제,2189,2050,4239
20210201,9호선2~3단계,올림픽공원,4840,4725,9565
20210201,9호선2~3단계,둔촌오륜,947,870,1817
20210201,9호선2~3단계,중앙보훈병원,9009,8002,17011
20210201,9호선2~3단계,석촌,6954,6235,13189
20210202,9호선2~3단계,언주,9670,9757,19427
20210202,9호선2~3단계,선정릉,8979,9541,18520
20210202,9호선2~3단계,삼성중앙,6820,7215,14035
20210202,9호선2~3단계,봉은사,14542,14577,29119
20210202,9호선2~3단계,종합운동장,3883,3819,7702
20210202,9호선2~3단계,삼전,6142,6004,12146
20210202,9호선2~3단계,석촌고분,5415,5621,11036
20210202,9호선2~3단계,송파나루,4307,4573,8880
20210202,9호선2~3단계,한성백제,2223,2157,4380
20210202,9호선2~3단계,올림픽공원,4722,4564,9286
20210202,9호선2~3단계,둔촌오륜,904,881,1785
20210202,9호선2~3단계,중앙보훈병원,9100,8063,17163
20210202,9호선2~3단계,석촌,6952,6259,13211
20210203,9호선2~3단계,석촌,7387,6656,14043
20210203,9호선2~3단계,둔촌오륜,1175,1086,2261
20210203,9호선2~3단계,올림픽공원,4981,4994,9975
20210203,9호선2~3단계,한성백제,2390,2159,4549
20210203,9호선2~3단계,송파나루,4475,4738,9213
20210203,9호선2~3단계,석촌고분,5662,5731,11393
20210203,9호선2~3단계,중앙보훈병원,9264,8296,17560
20210203,9호선2~3단계,종합운동장,4037,4070,8107
20210203,9호선2~3단계,언주,10132,9899,20031
20210203,9호선2~3단계,선정릉,9155,9765,18920
20210203,9호선2~3단계,삼전,6383,6501,12884
20210203,9호선2~3단계,봉은사,15743,15445,31188
20210203,9호선2~3단계,삼성중앙,7162,7327,14489
20210204,9호선2~3단계,중앙보훈병원,9291,8269,17560
20210204,9호선2~3단계,둔촌오륜,1166,1092,2258
20210204,9호선2~3단계,올림픽공원,5024,4974,9998
20210204,9호선2~3단계,한성백제,2353,2180,4533
20210204,9호선2~3단계,석촌,7445,6651,14096
20210204,9호선2~3단계,석촌고분,5899,5784,11683
20210204,9호선2~3단계,송파나루,4555,4772,9327
20210204,9호선2~3단계,종합운동장,4105,3960,8065
20210204,9호선2~3단계,봉은사,14813,14798,29611
20210204,9호선2~3단계,삼성중앙,6853,7289,14142
20210204,9호선2~3단계,선정릉,9082,9947,19029
20210204,9호선2~3단계,언주,10030,10419,20449
20210204,9호선2~3단계,삼전,6583,6420,13003
20210205,9호선2~3단계,종합운동장,4077,3985,8062
20210205,9호선2~3단계,선정릉,9260,9955,19215
20210205,9호선2~3단계,언주,10335,10289,20624
20210205,9호선2~3단계,삼성중앙,6656,7082,13738
20210205,9호선2~3단계,봉은사,14610,14432,29042
20210205,9호선2~3단계,삼전,6515,6328,12843
20210205,9호선2~3단계,둔촌오륜,1269,1110,2379
20210205,9호선2~3단계,석촌,7594,6685,14279
20210205,9호선2~3단계,송파나루,4529,4880,9409
20210205,9호선2~3단계,한성백제,2283,2110,4393
20210205,9호선2~3단계,올림픽공원,4953,4972,9925
20210205,9호선2~3단계,중앙보훈병원,8955,7917,16872
20210205,9호선2~3단계,석촌고분,5696,5753,11449
20210206,9호선2~3단계,중앙보훈병원,3514,3264,6778
20210206,9호선2~3단계,둔촌오륜,544,527,1071
20210206,9호선2~3단계,올림픽공원,3157,3089,6246
20210206,9호선2~3단계,한성백제,1438,1269,2707
20210206,9호선2~3단계,석촌,5380,4470,9850
20210206,9호선2~3단계,송파나루,3323,3521,6844
20210206,9호선2~3단계,석촌고분,3522,3356,6878
20210206,9호선2~3단계,종합운동장,2561,2269,4830
20210206,9호선2~3단계,봉은사,7456,7522,14978
20210206,9호선2~3단계,삼성중앙,2509,2499,5008
20210206,9호선2~3단계,선정릉,4022,4507,8529
20210206,9호선2~3단계,언주,5148,5087,10235
20210206,9호선2~3단계,삼전,4405,4008,8413
20210207,9호선2~3단계,선정릉,2510,2774,5284
20210207,9호선2~3단계,삼성중앙,1577,1644,3221
20210207,9호선2~3단계,봉은사,5295,5025,10320
20210207,9호선2~3단계,종합운동장,1721,1479,3200
20210207,9호선2~3단계,삼전,2895,2842,5737
20210207,9호선2~3단계,석촌고분,2451,2438,4889
20210207,9호선2~3단계,언주,2856,2762,5618
20210207,9호선2~3단계,송파나루,2370,2575,4945
20210207,9호선2~3단계,한성백제,1067,938,2005
20210207,9호선2~3단계,올림픽공원,2070,2110,4180
20210207,9호선2~3단계,둔촌오륜,377,346,723
20210207,9호선2~3단계,중앙보훈병원,2341,2171,4512
20210207,9호선2~3단계,석촌,3467,2950,6417
20210208,9호선2~3단계,중앙보훈병원,9230,8285,17515
20210208,9호선2~3단계,둔촌오륜,973,848,1821
20210208,9호선2~3단계,올림픽공원,5021,4806,9827
20210208,9호선2~3단계,한성백제,2312,2109,4421
20210208,9호선2~3단계,송파나루,4301,4604,8905
20210208,9호선2~3단계,석촌,7367,6487,13854
20210208,9호선2~3단계,석촌고분,5581,5649,11230
20210208,9호선2~3단계,종합운동장,3985,3897,7882
20210208,9호선2~3단계,봉은사,14605,14369,28974
20210208,9호선2~3단계,삼성중앙,6882,7162,14044
20210208,9호선2~3단계,선정릉,9228,9768,18996
20210208,9호선2~3단계,언주,10148,10124,20272
20210208,9호선2~3단계,삼전,6443,6338,12781
20210209,9호선2~3단계,언주,10142,10059,20201
20210209,9호선2~3단계,선정릉,9326,9916,19242
20210209,9호선2~3단계,삼성중앙,7033,7154,14187
20210209,9호선2~3단계,봉은사,14831,14692,29523
20210209,9호선2~3단계,종합운동장,3989,3957,7946
20210209,9호선2~3단계,삼전,6462,6319,12781
20210209,9호선2~3단계,석촌고분,5630,5663,11293
20210209,9호선2~3단계,송파나루,4410,4720,9130
20210209,9호선2~3단계,중앙보훈병원,9241,8203,17444
20210209,9호선2~3단계,둔촌오륜,983,876,1859
20210209,9호선2~3단계,석촌,7368,6677,14045
20210209,9호선2~3단계,한성백제,2318,2001,4319
20210209,9호선2~3단계,올림픽공원,5144,4995,10139
20210210,9호선2~3단계,둔촌오륜,801,757,1558
20210210,9호선2~3단계,올림픽공원,4658,4599,9257
20210210,9호선2~3단계,한성백제,2193,1889,4082
20210210,9호선2~3단계,송파나루,4190,4317,8507
20210210,9호선2~3단계,석촌,7357,6117,13474
20210210,9호선2~3단계,석촌고분,5349,5155,10504
20210210,9호선2~3단계,중앙보훈병원,8545,7350,15895
20210210,9호선2~3단계,종합운동장,3865,3659,7524
20210210,9호선2~3단계,봉은사,13278,12866,26144
20210210,9호선2~3단계,삼성중앙,6292,6264,12556
20210210,9호선2~3단계,선정릉,8497,8637,17134
20210210,9호선2~3단계,언주,8989,8683,17672
20210210,9호선2~3단계,삼전,6135,5599,11734
20210211,9호선2~3단계,언주,2192,1790,3982
20210211,9호선2~3단계,선정릉,2071,1839,3910
20210211,9호선2~3단계,삼성중앙,1430,1198,2628
20210211,9호선2~3단계,봉은사,4025,4046,8071
20210211,9호선2~3단계,종합운동장,1475,1148,2623
20210211,9호선2~3단계,삼전,2687,2009,4696
20210211,9호선2~3단계,석촌고분,2285,1849,4134
20210211,9호선2~3단계,송파나루,1878,1791,3669
20210211,9호선2~3단계,한성백제,912,663,1575
20210211,9호선2~3단계,올림픽공원,1886,1909,3795
20210211,9호선2~3단계,중앙보훈병원,1966,1851,3817
20210211,9호선2~3단계,석촌,3133,2241,5374
20210211,9호선2~3단계,둔촌오륜,268,270,538
20210212,9호선2~3단계,중앙보훈병원,1522,1469,2991
20210212,9호선2~3단계,석촌,2140,1895,4035
20210212,9호선2~3단계,둔촌오륜,170,166,336
20210212,9호선2~3단계,올림픽공원,1427,1499,2926
20210212,9호선2~3단계,한성백제,605,481,1086
20210212,9호선2~3단계,송파나루,1174,1230,2404
20210212,9호선2~3단계,석촌고분,1415,1444,2859
20210212,9호선2~3단계,종합운동장,917,834,1751
20210212,9호선2~3단계,봉은사,3905,4096,8001
20210212,9호선2~3단계,삼성중앙,865,838,1703
20210212,9호선2~3단계,선정릉,1252,1376,2628
20210212,9호선2~3단계,언주,1188,1289,2477
20210212,9호선2~3단계,삼전,1708,1681,3389
20210213,9호선2~3단계,둔촌오륜,273,299,572
20210213,9호선2~3단계,올림픽공원,2393,2354,4747
20210213,9호선2~3단계,한성백제,949,915,1864
20210213,9호선2~3단계,송파나루,1923,2418,4341
20210213,9호선2~3단계,석촌,3199,3049,6248
20210213,9호선2~3단계,석촌고분,2095,2311,4406
20210213,9호선2~3단계,중앙보훈병원,2462,2293,4755
20210213,9호선2~3단계,종합운동장,1465,1488,2953
20210213,9호선2~3단계,봉은사,5079,5373,10452
20210213,9호선2~3단계,삼성중앙,1372,1461,2833
20210213,9호선2~3단계,선정릉,1956,2391,4347
20210213,9호선2~3단계,언주,1895,2110,4005
20210213,9호선2~3단계,삼전,2536,2660,5196
20210214,9호선2~3단계,언주,2053,2320,4373
20210214,9호선2~3단계,선정릉,2031,2500,4531
20210214,9호선2~3단계,삼성중앙,1305,1504,2809
20210214,9호선2~3단계,봉은사,5424,5548,10972
20210214,9호선2~3단계,종합운동장,1514,1523,3037
20210214,9호선2~3단계,삼전,2578,2923,5501
20210214,9호선2~3단계,석촌고분,2270,2455,4725
20210214,9호선2~3단계,송파나루,2004,2503,4507
20210214,9호선2~3단계,한성백제,972,1028,2000
20210214,9호선2~3단계,올림픽공원,2311,2350,4661
20210214,9호선2~3단계,둔촌오륜,322,339,661
20210214,9호선2~3단계,중앙보훈병원,2325,2216,4541
20210214,9호선2~3단계,석촌,3219,3123,6342
20210215,9호선2~3단계,삼전,6093,6219,12312
20210215,9호선2~3단계,언주,9650,9640,19290
20210215,9호선2~3단계,선정릉,8557,9312,17869
20210215,9호선2~3단계,삼성중앙,6479,6806,13285
20210215,9호선2~3단계,종합운동장,3775,3712,7487
20210215,9호선2~3단계,석촌고분,5304,5452,10756
20210215,9호선2~3단계,봉은사,13751,13606,27357
20210215,9호선2~3단계,송파나루,4165,4466,8631
20210215,9호선2~3단계,중앙보훈병원,9116,7980,17096
20210215,9호선2~3단계,둔촌오륜,939,878,1817
20210215,9호선2~3단계,석촌,6950,6190,13140
20210215,9호선2~3단계,한성백제,2169,2044,4213
20210215,9호선2~3단계,올림픽공원,4800,4546,9346
20210216,9호선2~3단계,언주,9872,10137,20009
20210216,9호선2~3단계,선정릉,9356,9885,19241
20210216,9호선2~3단계,삼성중앙,6952,7258,14210
20210216,9호선2~3단계,봉은사,14682,14630,29312
20210216,9호선2~3단계,삼전,6436,6447,12883
20210216,9호선2~3단계,석촌고분,5591,5694,11285
20210216,9호선2~3단계,종합운동장,4055,3950,8005
20210216,9호선2~3단계,송파나루,4439,4721,9160
20210216,9호선2~3단계,한성백제,2341,2238,4579
20210216,9호선2~3단계,올림픽공원,5040,4879,9919
20210216,9호선2~3단계,둔촌오륜,1024,874,1898
20210216,9호선2~3단계,중앙보훈병원,9392,8211,17603
20210216,9호선2~3단계,석촌,7387,6570,13957
20210217,9호선2~3단계,송파나루,4494,4938,9432
20210217,9호선2~3단계,중앙보훈병원,9149,8231,17380
20210217,9호선2~3단계,둔촌오륜,908,888,1796
20210217,9호선2~3단계,올림픽공원,4790,4601,9391
20210217,9호선2~3단계,한성백제,2285,2124,4409
20210217,9호선2~3단계,석촌,7235,6401,13636
20210217,9호선2~3단계,선정릉,9061,9675,18736
20210217,9호선2~3단계,삼전,6374,6405,12779
20210217,9호선2~3단계,종합운동장,4078,4053,8131
20210217,9호선2~3단계,봉은사,14718,14643,29361
20210217,9호선2~3단계,삼성중앙,6757,7051,13808
20210217,9호선2~3단계,언주,10278,10211,20489
20210217,9호선2~3단계,석촌고분,5588,5704,11292
20210218,9호선2~3단계,봉은사,15193,15075,30268
20210218,9호선2~3단계,삼성중앙,6645,7005,13650
20210218,9호선2~3단계,종합운동장,4094,3982,8076
20210218,9호선2~3단계,언주,10189,10346,20535
20210218,9호선2~3단계,선정릉,9209,9941,19150
20210218,9호선2~3단계,삼전,6293,6222,12515
20210218,9호선2~3단계,석촌고분,5517,5647,11164
20210218,9호선2~3단계,석촌,7299,6569,13868
20210218,9호선2~3단계,송파나루,4605,4879,9484
20210218,9호선2~3단계,한성백제,2243,2076,4319
20210218,9호선2~3단계,올림픽공원,4821,4725,9546
20210218,9호선2~3단계,둔촌오륜,990,829,1819
20210218,9호선2~3단계,중앙보훈병원,9144,7986,17130
20210219,9호선2~3단계,중앙보훈병원,9350,8186,17536
20210219,9호선2~3단계,둔촌오륜,970,825,1795
20210219,9호선2~3단계,한성백제,2433,2122,4555
20210219,9호선2~3단계,송파나루,4667,4936,9603
20210219,9호선2~3단계,석촌,7594,6841,14435
20210219,9호선2~3단계,석촌고분,5791,5752,11543
20210219,9호선2~3단계,올림픽공원,5310,5377,10687
20210219,9호선2~3단계,종합운동장,4037,4071,8108
20210219,9호선2~3단계,봉은사,15100,15034,30134
20210219,9호선2~3단계,삼성중앙,6836,7032,13868
20210219,9호선2~3단계,선정릉,9435,10056,19491
20210219,9호선2~3단계,언주,10275,10583,20858
20210219,9호선2~3단계,삼전,6725,6500,13225
20210220,9호선2~3단계,언주,5632,5696,11328
20210220,9호선2~3단계,선정릉,4473,4878,9351
20210220,9호선2~3단계,삼성중앙,2777,2822,5599
20210220,9호선2~3단계,봉은사,9135,9292,18427
20210220,9호선2~3단계,종합운동장,2920,2631,5551
20210220,9호선2~3단계,삼전,4381,4081,8462
20210220,9호선2~3단계,송파나루,3392,3766,7158
20210220,9호선2~3단계,석촌,5879,4861,10740
20210220,9호선2~3단계,한성백제,1694,1449,3143
20210220,9호선2~3단계,올림픽공원,3554,3431,6985
20210220,9호선2~3단계,둔촌오륜,566,535,1101
20210220,9호선2~3단계,중앙보훈병원,3716,3464,7180
20210220,9호선2~3단계,석촌고분,3891,3739,7630
20210221,9호선2~3단계,봉은사,6017,5929,11946
20210221,9호선2~3단계,삼성중앙,1579,1622,3201
20210221,9호선2~3단계,종합운동장,1725,1600,3325
20210221,9호선2~3단계,언주,3311,3287,6598
20210221,9호선2~3단계,선정릉,2773,3020,5793
20210221,9호선2~3단계,삼전,2980,2997,5977
20210221,9호선2~3단계,둔촌오륜,385,392,777
20210221,9호선2~3단계,석촌,3878,3297,7175
20210221,9호선2~3단계,송파나루,2465,2690,5155
20210221,9호선2~3단계,한성백제,1300,1083,2383
20210221,9호선2~3단계,올림픽공원,2562,2634,5196
20210221,9호선2~3단계,석촌고분,2642,2535,5177
20210221,9호선2~3단계,중앙보훈병원,2608,2543,5151
20210222,9호선2~3단계,중앙보훈병원,9465,8384,17849
20210222,9호선2~3단계,둔촌오륜,1037,884,1921
20210222,9호선2~3단계,올림픽공원,5262,5017,10279
20210222,9호선2~3단계,한성백제,2339,2118,4457
20210222,9호선2~3단계,송파나루,4573,4767,9340
20210222,9호선2~3단계,석촌,7434,6679,14113
20210222,9호선2~3단계,석촌고분,5566,5705,11271
20210222,9호선2~3단계,삼전,6369,6266,12635
20210222,9호선2~3단계,종합운동장,4096,3973,8069
20210222,9호선2~3단계,봉은사,14451,14555,29006
20210222,9호선2~3단계,삼성중앙,6899,7000,13899
20210222,9호선2~3단계,선정릉,9040,9853,18893
20210222,9호선2~3단계,언주,9868,10070,19938
20210223,9호선2~3단계,선정릉,9334,10076,19410
20210223,9호선2~3단계,삼성중앙,7037,7263,14300
20210223,9호선2~3단계,봉은사,14921,14887,29808
20210223,9호선2~3단계,종합운동장,4077,3970,8047
20210223,9호선2~3단계,삼전,6585,6341,12926
20210223,9호선2~3단계,석촌고분,5704,5722,11426
20210223,9호선2~3단계,언주,9901,10069,19970
20210223,9호선2~3단계,송파나루,4597,4775,9372
20210223,9호선2~3단계,한성백제,2317,2181,4498
20210223,9호선2~3단계,올림픽공원,5221,5069,10290
20210223,9호선2~3단계,둔촌오륜,1053,942,1995
20210223,9호선2~3단계,중앙보훈병원,9366,8298,17664
20210223,9호선2~3단계,석촌,7501,6657,14158
20210224,9호선2~3단계,선정릉,9475,10337,19812
20210224,9호선2~3단계,삼성중앙,7061,7231,14292
20210224,9호선2~3단계,봉은사,15188,15291,30479
20210224,9호선2~3단계,종합운동장,4080,4040,8120
20210224,9호선2~3단계,삼전,6472,6348,12820
20210224,9호선2~3단계,석촌고분,5658,5716,11374
20210224,9호선2~3단계,언주,9852,10192,20044
20210224,9호선2~3단계,송파나루,4571,4802,9373
20210224,9호선2~3단계,한성백제,2354,2142,4496
20210224,9호선2~3단계,올림픽공원,5187,5173,10360
20210224,9호선2~3단계,둔촌오륜,1090,964,2054
20210224,9호선2~3단계,중앙보훈병원,9635,8445,18080
20210224,9호선2~3단계,석촌,7587,6767,14354
20210225,9호선2~3단계,중앙보훈병원,9248,8212,17460
20210225,9호선2~3단계,둔촌오륜,1127,989,2116
20210225,9호선2~3단계,올림픽공원,5307,5082,10389
20210225,9호선2~3단계,한성백제,2313,2058,4371
20210225,9호선2~3단계,송파나루,4488,4801,9289
20210225,9호선2~3단계,석촌,7612,6840,14452
20210225,9호선2~3단계,석촌고분,5790,5783,11573
20210225,9호선2~3단계,종합운동장,4127,4032,8159
20210225,9호선2~3단계,봉은사,15404,15616,31020
20210225,9호선2~3단계,삼성중앙,6826,7171,13997
20210225,9호선2~3단계,선정릉,9390,10216,19606
20210225,9호선2~3단계,언주,9758,9938,19696
20210225,9호선2~3단계,삼전,6457,6251,12708
20210226,9호선2~3단계,석촌,8070,7106,15176
20210226,9호선2~3단계,둔촌오륜,1051,923,1974
20210226,9호선2~3단계,올림픽공원,5560,5355,10915
20210226,9호선2~3단계,한성백제,2436,2163,4599
20210226,9호선2~3단계,송파나루,4668,5114,9782
20210226,9호선2~3단계,석촌고분,5901,5772,11673
20210226,9호선2~3단계,중앙보훈병원,9564,8283,17847
20210226,9호선2~3단계,종합운동장,4188,4224,8412
20210226,9호선2~3단계,봉은사,15802,16007,31809
20210226,9호선2~3단계,삼성중앙,6899,7116,14015
20210226,9호선2~3단계,선정릉,9810,10472,20282
20210226,9호선2~3단계,언주,10076,10093,20169
20210226,9호선2~3단계,삼전,6637,6450,13087
20210227,9호선2~3단계,중앙보훈병원,4012,3675,7687
20210227,9호선2~3단계,둔촌오륜,627,569,1196
20210227,9호선2~3단계,송파나루,3552,3813,7365
20210227,9호선2~3단계,올림픽공원,3845,3856,7701
20210227,9호선2~3단계,한성백제,1777,1444,3221
20210227,9호선2~3단계,석촌,5893,4900,10793
20210227,9호선2~3단계,선정릉,4944,5498,10442
20210227,9호선2~3단계,삼전,4700,4251,8951
20210227,9호선2~3단계,종합운동장,2727,2521,5248
20210227,9호선2~3단계,봉은사,9695,10084,19779
20210227,9호선2~3단계,삼성중앙,2841,2872,5713
20210227,9호선2~3단계,언주,5476,5365,10841
20210227,9호선2~3단계,석촌고분,3937,3719,7656
20210228,9호선2~3단계,중앙보훈병원,2803,2644,5447
20210228,9호선2~3단계,둔촌오륜,420,404,824
20210228,9호선2~3단계,올림픽공원,2736,2732,5468
20210228,9호선2~3단계,한성백제,1303,1042,2345
20210228,9호선2~3단계,송파나루,2553,2895,5448
20210228,9호선2~3단계,석촌,4196,3625,7821
20210228,9호선2~3단계,석촌고분,2839,2704,5543
20210228,9호선2~3단계,삼전,3199,3151,6350
20210228,9호선2~3단계,종합운동장,1926,1760,3686
20210228,9호선2~3단계,봉은사,7089,7138,14227
20210228,9호선2~3단계,삼성중앙,1730,1858,3588
20210228,9호선2~3단계,선정릉,3073,3308,6381
20210228,9호선2~3단계,언주,3265,3182,6447
20210301,9호선2~3단계,둔촌오륜,346,316,662
20210301,9호선2~3단계,올림픽공원,1807,1883,3690
20210301,9호선2~3단계,한성백제,849,871,1720
20210301,9호선2~3단계,송파나루,2188,2357,4545
20210301,9호선2~3단계,석촌,3113,2750,5863
20210301,9호선2~3단계,석촌고분,2531,2580,5111
20210301,9호선2~3단계,중앙보훈병원,2191,2086,4277
20210301,9호선2~3단계,종합운동장,1672,1530,3202
20210301,9호선2~3단계,봉은사,6040,5858,11898
20210301,9호선2~3단계,삼성중앙,1646,1765,3411
20210301,9호선2~3단계,선정릉,2288,2492,4780
20210301,9호선2~3단계,언주,3033,2984,6017
20210301,9호선2~3단계,삼전,2898,2951,5849
20210302,9호선2~3단계,선정릉,9291,10033,19324
20210302,9호선2~3단계,삼성중앙,6817,7059,13876
20210302,9호선2~3단계,봉은사,14577,14661,29238
20210302,9호선2~3단계,종합운동장,4024,4057,8081
20210302,9호선2~3단계,삼전,6533,6413,12946
20210302,9호선2~3단계,석촌고분,5739,5898,11637
20210302,9호선2~3단계,언주,9765,9986,19751
20210302,9호선2~3단계,송파나루,4533,4759,9292
20210302,9호선2~3단계,한성백제,2328,2179,4507
20210302,9호선2~3단계,올림픽공원,5147,5086,10233
20210302,9호선2~3단계,둔촌오륜,1285,1184,2469
20210302,9호선2~3단계,중앙보훈병원,9722,8562,18284
20210302,9호선2~3단계,석촌,7529,6658,14187
20210303,9호선2~3단계,중앙보훈병원,10166,9154,19320
20210303,9호선2~3단계,둔촌오륜,1271,1153,2424
20210303,9호선2~3단계,올림픽공원,5212,5378,10590
20210303,9호선2~3단계,한성백제,2404,2264,4668
20210303,9호선2~3단계,송파나루,4481,4772,9253
20210303,9호선2~3단계,석촌,7648,6843,14491
20210303,9호선2~3단계,석촌고분,5811,5748,11559
20210303,9호선2~3단계,종합운동장,4144,4190,8334
20210303,9호선2~3단계,봉은사,15125,15482,30607
20210303,9호선2~3단계,삼성중앙,7037,7206,14243
20210303,9호선2~3단계,선정릉,9375,10291,19666
20210303,9호선2~3단계,언주,9922,10037,19959
20210303,9호선2~3단계,삼전,6517,6327,12844
20210304,9호선2~3단계,석촌,7620,6917,14537
20210304,9호선2~3단계,둔촌오륜,1289,1127,2416
20210304,9호선2~3단계,올림픽공원,5201,5196,10397
20210304,9호선2~3단계,한성백제,2319,2168,4487
20210304,9호선2~3단계,송파나루,4555,4795,9350
20210304,9호선2~3단계,석촌고분,5746,5748,11494
20210304,9호선2~3단계,중앙보훈병원,9931,8906,18837
20210304,9호선2~3단계,종합운동장,4007,4003,8010
20210304,9호선2~3단계,언주,9804,9996,19800
20210304,9호선2~3단계,선정릉,9539,10327,19866
20210304,9호선2~3단계,삼전,6394,6386,12780
20210304,9호선2~3단계,봉은사,16162,16461,32623
20210304,9호선2~3단계,삼성중앙,6891,7313,14204
20210305,9호선2~3단계,선정릉,9680,10587,20267
20210305,9호선2~3단계,삼성중앙,7051,7293,14344
20210305,9호선2~3단계,봉은사,16567,16800,33367
20210305,9호선2~3단계,종합운동장,4229,4306,8535
20210305,9호선2~3단계,삼전,6680,6427,13107
20210305,9호선2~3단계,석촌고분,6062,6007,12069
20210305,9호선2~3단계,언주,10146,10267,20413
20210305,9호선2~3단계,송파나루,4676,5164,9840
20210305,9호선2~3단계,한성백제,2494,2265,4759
20210305,9호선2~3단계,올림픽공원,5568,5564,11132
20210305,9호선2~3단계,둔촌오륜,1317,1130,2447
20210305,9호선2~3단계,중앙보훈병원,10018,8751,18769
20210305,9호선2~3단계,석촌,8144,7324,15468
20210306,9호선2~3단계,중앙보훈병원,3990,3741,7731
20210306,9호선2~3단계,둔촌오륜,623,583,1206
20210306,9호선2~3단계,올림픽공원,3827,3802,7629
20210306,9호선2~3단계,한성백제,1700,1532,3232
20210306,9호선2~3단계,송파나루,3733,3951,7684
20210306,9호선2~3단계,석촌,5920,4883,10803
20210306,9호선2~3단계,석촌고분,4006,3850,7856
20210306,9호선2~3단계,종합운동장,2904,2530,5434
20210306,9호선2~3단계,봉은사,11411,11871,23282
20210306,9호선2~3단계,삼성중앙,2863,2879,5742
20210306,9호선2~3단계,언주,5661,5538,11199
20210306,9호선2~3단계,삼전,4593,4321,8914
20210306,9호선2~3단계,선정릉,4779,5244,10023
20210307,9호선2~3단계,언주,3298,3163,6461
20210307,9호선2~3단계,삼전,3070,3105,6175
20210307,9호선2~3단계,선정릉,2894,3272,6166
20210307,9호선2~3단계,삼성중앙,1839,1886,3725
20210307,9호선2~3단계,봉은사,7731,7738,15469
20210307,9호선2~3단계,종합운동장,1899,1738,3637
20210307,9호선2~3단계,석촌고분,2777,2774,5551
20210307,9호선2~3단계,송파나루,2468,2787,5255
20210307,9호선2~3단계,한성백제,1353,1094,2447
20210307,9호선2~3단계,올림픽공원,2643,2811,5454
20210307,9호선2~3단계,둔촌오륜,399,408,807
20210307,9호선2~3단계,중앙보훈병원,2863,2713,5576
20210307,9호선2~3단계,석촌,4006,3505,7511
20210308,9호선2~3단계,둔촌오륜,1249,1134,2383
20210308,9호선2~3단계,올림픽공원,5248,5292,10540
20210308,9호선2~3단계,한성백제,2387,2187,4574
20210308,9호선2~3단계,송파나루,4294,4636,8930
20210308,9호선2~3단계,석촌,7605,6746,14351
20210308,9호선2~3단계,석촌고분,5706,5738,11444
20210308,9호선2~3단계,중앙보훈병원,10104,9116,19220
20210308,9호선2~3단계,종합운동장,3964,3920,7884
20210308,9호선2~3단계,봉은사,14468,14450,28918
20210308,9호선2~3단계,삼성중앙,6811,7010,13821
20210308,9호선2~3단계,선정릉,9341,10063,19404
20210308,9호선2~3단계,언주,9696,10018,19714
20210308,9호선2~3단계,삼전,6335,6215,12550
20210309,9호선2~3단계,중앙보훈병원,10156,8939,19095
20210309,9호선2~3단계,둔촌오륜,1357,1154,2511
20210309,9호선2~3단계,올림픽공원,5287,5200,10487
20210309,9호선2~3단계,한성백제,2323,2161,4484
20210309,9호선2~3단계,송파나루,4521,4810,9331
20210309,9호선2~3단계,석촌,7792,6926,14718
20210309,9호선2~3단계,석촌고분,5786,5777,11563
20210309,9호선2~3단계,종합운동장,3890,3972,7862
20210309,9호선2~3단계,봉은사,14727,15011,29738
20210309,9호선2~3단계,삼성중앙,6931,7188,14119
20210309,9호선2~3단계,선정릉,9570,10376,19946
20210309,9호선2~3단계,언주,9859,10068,19927
20210309,9호선2~3단계,삼전,6474,6242,12716
20210310,9호선2~3단계,석촌,8007,7005,15012
20210310,9호선2~3단계,둔촌오륜,1328,1138,2466
20210310,9호선2~3단계,올림픽공원,5388,5393,10781
20210310,9호선2~3단계,한성백제,2408,2224,4632
20210310,9호선2~3단계,송파나루,4520,4848,9368
20210310,9호선2~3단계,중앙보훈병원,10198,9156,19354
20210310,9호선2~3단계,석촌고분,5864,5912,11776
20210310,9호선2~3단계,종합운동장,4057,4158,8215
20210310,9호선2~3단계,봉은사,15208,15288,30496
20210310,9호선2~3단계,삼성중앙,6965,7257,14222
20210310,9호선2~3단계,선정릉,9702,10536,20238
20210310,9호선2~3단계,언주,9919,10007,19926
20210310,9호선2~3단계,삼전,6514,6343,12857
20210311,9호선2~3단계,중앙보훈병원,9916,8958,18874
20210311,9호선2~3단계,둔촌오륜,1270,1112,2382
20210311,9호선2~3단계,올림픽공원,5332,5161,10493
20210311,9호선2~3단계,한성백제,2315,2171,4486
20210311,9호선2~3단계,송파나루,4530,4729,9259
20210311,9호선2~3단계,석촌,7723,6818,14541
20210311,9호선2~3단계,석촌고분,5794,5797,11591
20210311,9호선2~3단계,삼전,6547,6289,12836
20210311,9호선2~3단계,종합운동장,4104,4094,8198
20210311,9호선2~3단계,봉은사,15034,15244,30278
20210311,9호선2~3단계,삼성중앙,6960,7197,14157
20210311,9호선2~3단계,선정릉,9504,10300,19804
20210311,9호선2~3단계,언주,9798,10007,19805
20210312,9호선2~3단계,둔촌오륜,1338,1105,2443
20210312,9호선2~3단계,올림픽공원,5489,5224,10713
20210312,9호선2~3단계,한성백제,2340,2175,4515
20210312,9호선2~3단계,송파나루,4750,5151,9901
20210312,9호선2~3단계,석촌,8217,7190,15407
20210312,9호선2~3단계,석촌고분,5854,5999,11853
20210312,9호선2~3단계,중앙보훈병원,9920,8852,18772
20210312,9호선2~3단계,종합운동장,4224,4202,8426
20210312,9호선2~3단계,봉은사,15187,15200,30387
20210312,9호선2~3단계,삼성중앙,7000,7388,14388
20210312,9호선2~3단계,선정릉,9732,10432,20164
20210312,9호선2~3단계,언주,10008,10112,20120
20210312,9호선2~3단계,삼전,6760,6485,13245
20210313,9호선2~3단계,둔촌오륜,624,597,1221
20210313,9호선2~3단계,올림픽공원,3928,3916,7844
20210313,9호선2~3단계,한성백제,1748,1555,3303
20210313,9호선2~3단계,송파나루,3589,4004,7593
20210313,9호선2~3단계,석촌,6301,5143,11444
20210313,9호선2~3단계,석촌고분,3955,3843,7798
20210313,9호선2~3단계,중앙보훈병원,4305,3957,8262
20210313,9호선2~3단계,종합운동장,3009,2544,5553
20210313,9호선2~3단계,봉은사,10224,10585,20809
20210313,9호선2~3단계,삼성중앙,2994,3095,6089
20210313,9호선2~3단계,선정릉,4856,5282,10138
20210313,9호선2~3단계,언주,5763,5680,11443
20210313,9호선2~3단계,삼전,4752,4288,9040
20210314,9호선2~3단계,언주,3376,3309,6685
20210314,9호선2~3단계,선정릉,2795,3167,5962
20210314,9호선2~3단계,삼성중앙,1780,1814,3594
20210314,9호선2~3단계,봉은사,6986,6876,13862
20210314,9호선2~3단계,종합운동장,1815,1696,3511
20210314,9호선2~3단계,삼전,3173,3144,6317
20210314,9호선2~3단계,석촌고분,2699,2732,5431
20210314,9호선2~3단계,송파나루,2545,2751,5296
20210314,9호선2~3단계,한성백제,1215,1168,2383
20210314,9호선2~3단계,올림픽공원,2692,2757,5449
20210314,9호선2~3단계,둔촌오륜,431,446,877
20210314,9호선2~3단계,중앙보훈병원,2927,2733,5660
20210314,9호선2~3단계,석촌,4234,3613,7847
20210315,9호선2~3단계,석촌,7577,6731,14308
20210315,9호선2~3단계,둔촌오륜,1268,1110,2378
20210315,9호선2~3단계,올림픽공원,5275,5159,10434
20210315,9호선2~3단계,한성백제,2318,2191,4509
20210315,9호선2~3단계,송파나루,4371,4577,8948
20210315,9호선2~3단계,석촌고분,5455,5642,11097
20210315,9호선2~3단계,중앙보훈병원,10066,8790,18856
20210315,9호선2~3단계,종합운동장,3903,3969,7872
20210315,9호선2~3단계,언주,9643,9909,19552
20210315,9호선2~3단계,선정릉,9393,10225,19618
20210315,9호선2~3단계,삼전,6363,6126,12489
20210315,9호선2~3단계,봉은사,14644,14787,29431
20210315,9호선2~3단계,삼성중앙,6934,7154,14088
20210316,9호선2~3단계,둔촌오륜,1250,1079,2329
20210316,9호선2~3단계,올림픽공원,5398,5284,10682
20210316,9호선2~3단계,한성백제,2326,2163,4489
20210316,9호선2~3단계,송파나루,4499,4719,9218
20210316,9호선2~3단계,석촌,7810,6953,14763
20210316,9호선2~3단계,석촌고분,5753,5813,11566
20210316,9호선2~3단계,중앙보훈병원,10120,9126,19246
20210316,9호선2~3단계,종합운동장,4012,3999,8011
20210316,9호선2~3단계,봉은사,14959,14937,29896
20210316,9호선2~3단계,삼성중앙,6997,7313,14310
20210316,9호선2~3단계,선정릉,9583,10480,20063
20210316,9호선2~3단계,언주,9810,10047,19857
20210316,9호선2~3단계,삼전,6549,6503,13052
20210317,9호선2~3단계,중앙보훈병원,10034,8952,18986
20210317,9호선2~3단계,둔촌오륜,1289,1138,2427
20210317,9호선2~3단계,올림픽공원,5407,5492,10899
20210317,9호선2~3단계,한성백제,2365,2229,4594
20210317,9호선2~3단계,송파나루,4492,4812,9304
20210317,9호선2~3단계,석촌,7869,7134,15003
20210317,9호선2~3단계,석촌고분,5814,5861,11675
20210317,9호선2~3단계,종합운동장,4202,4226,8428
20210317,9호선2~3단계,봉은사,15132,15237,30369
20210317,9호선2~3단계,삼성중앙,6893,7205,14098
20210317,9호선2~3단계,언주,9651,9876,19527
20210317,9호선2~3단계,삼전,6597,6250,12847
20210317,9호선2~3단계,선정릉,9648,10431,20079
20210318,9호선2~3단계,언주,9807,10056,19863
20210318,9호선2~3단계,삼전,6404,6176,12580
20210318,9호선2~3단계,선정릉,9700,10420,20120
20210318,9호선2~3단계,삼성중앙,6904,7169,14073
20210318,9호선2~3단계,봉은사,16787,17109,33896
20210318,9호선2~3단계,종합운동장,4178,4068,8246
20210318,9호선2~3단계,석촌고분,5789,5805,11594
20210318,9호선2~3단계,송파나루,4498,4757,9255
20210318,9호선2~3단계,한성백제,2339,2167,4506
20210318,9호선2~3단계,올림픽공원,5574,5482,11056
20210318,9호선2~3단계,둔촌오륜,1297,1131,2428
20210318,9호선2~3단계,중앙보훈병원,10035,9006,19041
20210318,9호선2~3단계,석촌,7804,7012,14816
20210319,9호선2~3단계,둔촌오륜,1330,1096,2426
20210319,9호선2~3단계,올림픽공원,5693,5703,11396
20210319,9호선2~3단계,한성백제,2498,2291,4789
20210319,9호선2~3단계,송파나루,4804,5290,10094
20210319,9호선2~3단계,석촌,8348,7331,15679
20210319,9호선2~3단계,석촌고분,5994,5998,11992
20210319,9호선2~3단계,중앙보훈병원,10187,8875,19062
20210319,9호선2~3단계,종합운동장,4433,4436,8869
20210319,9호선2~3단계,봉은사,17415,17525,34940
20210319,9호선2~3단계,삼성중앙,6934,7144,14078
20210319,9호선2~3단계,선정릉,9764,10596,20360
20210319,9호선2~3단계,언주,10017,10128,20145
20210319,9호선2~3단계,삼전,6617,6397,13014
20210320,9호선2~3단계,중앙보훈병원,3808,3473,7281
20210320,9호선2~3단계,둔촌오륜,611,571,1182
20210320,9호선2~3단계,올림픽공원,3380,3249,6629
20210320,9호선2~3단계,한성백제,1490,1335,2825
20210320,9호선2~3단계,송파나루,3541,3845,7386
20210320,9호선2~3단계,석촌,5807,4834,10641
20210320,9호선2~3단계,석촌고분,3837,3661,7498
20210320,9호선2~3단계,종합운동장,3070,2648,5718
20210320,9호선2~3단계,봉은사,10875,11403,22278
20210320,9호선2~3단계,삼성중앙,2867,2880,5747
20210320,9호선2~3단계,선정릉,4751,5241,9992
20210320,9호선2~3단계,언주,6025,5797,11822
20210320,9호선2~3단계,삼전,4349,4111,8460
20210321,9호선2~3단계,석촌,4180,3645,7825
20210321,9호선2~3단계,둔촌오륜,397,415,812
20210321,9호선2~3단계,올림픽공원,2734,2700,5434
20210321,9호선2~3단계,한성백제,1258,1179,2437
20210321,9호선2~3단계,송파나루,2716,2958,5674
20210321,9호선2~3단계,석촌고분,2792,2758,5550
20210321,9호선2~3단계,중앙보훈병원,2912,2745,5657
20210321,9호선2~3단계,종합운동장,2002,1771,3773
20210321,9호선2~3단계,언주,3614,3589,7203
20210321,9호선2~3단계,선정릉,2954,3415,6369
20210321,9호선2~3단계,삼전,3298,3342,6640
20210321,9호선2~3단계,봉은사,7559,7613,15172
20210321,9호선2~3단계,삼성중앙,1723,1794,3517
20210322,9호선2~3단계,중앙보훈병원,10114,8865,18979
20210322,9호선2~3단계,둔촌오륜,1253,1115,2368
20210322,9호선2~3단계,올림픽공원,5371,5274,10645
20210322,9호선2~3단계,한성백제,2319,2149,4468
20210322,9호선2~3단계,석촌,7742,6924,14666
20210322,9호선2~3단계,석촌고분,5699,5766,11465
20210322,9호선2~3단계,송파나루,4351,4679,9030
20210322,9호선2~3단계,종합운동장,4083,4092,8175
20210322,9호선2~3단계,봉은사,14467,14613,29080
20210322,9호선2~3단계,삼성중앙,6939,7199,14138
20210322,9호선2~3단계,선정릉,9532,10230,19762
20210322,9호선2~3단계,언주,9941,10082,20023
20210322,9호선2~3단계,삼전,6446,6159,12605
20210323,9호선2~3단계,종합운동장,4089,4092,8181
20210323,9호선2~3단계,선정릉,9695,10495,20190
20210323,9호선2~3단계,언주,9943,10183,20126
20210323,9호선2~3단계,삼성중앙,6948,7250,14198
20210323,9호선2~3단계,봉은사,14979,14941,29920
20210323,9호선2~3단계,삼전,6497,6294,12791
20210323,9호선2~3단계,둔촌오륜,1325,1071,2396
20210323,9호선2~3단계,석촌,7827,7026,14853
20210323,9호선2~3단계,송파나루,4466,4869,9335
20210323,9호선2~3단계,한성백제,2360,2199,4559
20210323,9호선2~3단계,올림픽공원,5438,5453,10891
20210323,9호선2~3단계,중앙보훈병원,10239,9047,19286
20210323,9호선2~3단계,석촌고분,5857,5827,11684
20210324,9호선2~3단계,언주,9922,10183,20105
20210324,9호선2~3단계,선정릉,9712,10425,20137
20210324,9호선2~3단계,삼성중앙,6924,7253,14177
20210324,9호선2~3단계,봉은사,15664,15767,31431
20210324,9호선2~3단계,삼전,6439,6420,12859
20210324,9호선2~3단계,종합운동장,4152,4087,8239
20210324,9호선2~3단계,석촌고분,5746,5896,11642
20210324,9호선2~3단계,송파나루,4579,4855,9434
20210324,9호선2~3단계,한성백제,2377,2155,4532
20210324,9호선2~3단계,올림픽공원,5634,5522,11156
20210324,9호선2~3단계,둔촌오륜,1338,1090,2428
20210324,9호선2~3단계,중앙보훈병원,10249,9070,19319
20210324,9호선2~3단계,석촌,7824,7001,14825
20210325,9호선2~3단계,선정릉,9744,10490,20234
20210325,9호선2~3단계,삼성중앙,7138,7437,14575
20210325,9호선2~3단계,봉은사,16322,16452,32774
20210325,9호선2~3단계,종합운동장,4203,4136,8339
20210325,9호선2~3단계,삼전,6566,6353,12919
20210325,9호선2~3단계,석촌고분,5764,5893,11657
20210325,9호선2~3단계,언주,9843,10150,19993
20210325,9호선2~3단계,송파나루,4543,4870,9413
20210325,9호선2~3단계,한성백제,2434,2206,4640
20210325,9호선2~3단계,올림픽공원,5652,5552,11204
20210325,9호선2~3단계,둔촌오륜,1315,1191,2506
20210325,9호선2~3단계,중앙보훈병원,10023,9014,19037
20210325,9호선2~3단계,석촌,8062,7225,15287
20210326,9호선2~3단계,언주,10134,10282,20416
20210326,9호선2~3단계,선정릉,9881,10759,20640
20210326,9호선2~3단계,삼성중앙,7164,7395,14559
20210326,9호선2~3단계,봉은사,16609,16721,33330
20210326,9호선2~3단계,종합운동장,4322,4363,8685
20210326,9호선2~3단계,삼전,6644,6372,13016
20210326,9호선2~3단계,석촌고분,5943,5857,11800
20210326,9호선2~3단계,송파나루,4757,5308,10065
20210326,9호선2~3단계,한성백제,2506,2206,4712
20210326,9호선2~3단계,올림픽공원,5982,5685,11667
20210326,9호선2~3단계,둔촌오륜,1331,1144,2475
20210326,9호선2~3단계,중앙보훈병원,10027,8822,18849
20210326,9호선2~3단계,석촌,8423,7489,15912
20210327,9호선2~3단계,언주,5560,5556,11116
20210327,9호선2~3단계,선정릉,4534,5195,9729
20210327,9호선2~3단계,삼성중앙,2927,2928,5855
20210327,9호선2~3단계,봉은사,10134,10291,20425
20210327,9호선2~3단계,종합운동장,3340,2755,6095
20210327,9호선2~3단계,삼전,4475,4250,8725
20210327,9호선2~3단계,석촌고분,3929,3822,7751
20210327,9호선2~3단계,송파나루,3836,4011,7847
20210327,9호선2~3단계,중앙보훈병원,3923,3485,7408
20210327,9호선2~3단계,둔촌오륜,650,595,1245
20210327,9호선2~3단계,석촌,5737,4685,10422
20210327,9호선2~3단계,한성백제,1559,1371,2930
20210327,9호선2~3단계,올림픽공원,3295,3187,6482
20210328,9호선2~3단계,선정릉,2616,2854,5470
20210328,9호선2~3단계,삼성중앙,1742,1815,3557
20210328,9호선2~3단계,봉은사,6698,6445,13143
20210328,9호선2~3단계,종합운동장,1801,1661,3462
20210328,9호선2~3단계,삼전,3007,2935,5942
20210328,9호선2~3단계,석촌고분,2605,2654,5259
20210328,9호선2~3단계,언주,3122,3204,6326
20210328,9호선2~3단계,송파나루,2454,2693,5147
20210328,9호선2~3단계,한성백제,1105,1028,2133
20210328,9호선2~3단계,올림픽공원,2470,2459,4929
20210328,9호선2~3단계,둔촌오륜,351,362,713
20210328,9호선2~3단계,중앙보훈병원,2477,2327,4804
20210328,9호선2~3단계,석촌,4070,3519,7589
20210329,9호선2~3단계,언주,9882,10276,20158
20210329,9호선2~3단계,선정릉,9375,10323,19698
20210329,9호선2~3단계,삼성중앙,6968,7128,14096
20210329,9호선2~3단계,봉은사,14495,14479,28974
20210329,9호선2~3단계,종합운동장,3993,3965,7958
20210329,9호선2~3단계,삼전,6398,6298,12696
20210329,9호선2~3단계,석촌고분,5663,5692,11355
20210329,9호선2~3단계,송파나루,4448,4701,9149
20210329,9호선2~3단계,한성백제,2382,2147,4529
20210329,9호선2~3단계,올림픽공원,5219,5204,10423
20210329,9호선2~3단계,중앙보훈병원,9869,8750,18619
20210329,9호선2~3단계,석촌,7661,7038,14699
20210329,9호선2~3단계,둔촌오륜,1274,1110,2384
20210330,9호선2~3단계,중앙보훈병원,10062,8839,18901
20210330,9호선2~3단계,석촌,8131,7524,15655
20210330,9호선2~3단계,둔촌오륜,1215,1051,2266
20210330,9호선2~3단계,올림픽공원,5518,5541,11059
20210330,9호선2~3단계,한성백제,2403,2190,4593
20210330,9호선2~3단계,송파나루,4669,4958,9627
20210330,9호선2~3단계,석촌고분,5909,5884,11793
20210330,9호선2~3단계,종합운동장,4020,4001,8021
20210330,9호선2~3단계,봉은사,15192,15570,30762
20210330,9호선2~3단계,삼성중앙,7061,7338,14399
20210330,9호선2~3단계,선정릉,9785,10477,20262
20210330,9호선2~3단계,언주,9934,10266,20200
20210330,9호선2~3단계,삼전,6588,6328,12916
20210331,9호선2~3단계,둔촌오륜,1266,1094,2360
20210331,9호선2~3단계,올림픽공원,5806,5752,11558
20210331,9호선2~3단계,한성백제,2537,2254,4791
20210331,9호선2~3단계,송파나루,4722,5296,10018
20210331,9호선2~3단계,석촌,8655,7989,16644
20210331,9호선2~3단계,석촌고분,5981,5869,11850
20210331,9호선2~3단계,중앙보훈병원,10272,9089,19361
20210331,9호선2~3단계,종합운동장,4189,4120,8309
20210331,9호선2~3단계,봉은사,15321,15644,30965
20210331,9호선2~3단계,삼성중앙,6990,7279,14269
20210331,9호선2~3단계,선정릉,9558,10455,20013
20210331,9호선2~3단계,언주,9833,10137,19970
20210331,9호선2~3단계,삼전,6558,6170,12728
20210401,9호선2~3단계,언주,9826,10096,19922
20210401,9호선2~3단계,선정릉,9675,10452,20127
20210401,9호선2~3단계,삼성중앙,6828,7040,13868
20210401,9호선2~3단계,봉은사,15015,15309,30324
20210401,9호선2~3단계,종합운동장,4107,4127,8234
20210401,9호선2~3단계,삼전,6449,6109,12558
20210401,9호선2~3단계,석촌고분,5895,5790,11685
20210401,9호선2~3단계,송파나루,4581,4921,9502
20210401,9호선2~3단계,한성백제,2591,2356,4947
20210401,9호선2~3단계,올림픽공원,5929,6006,11935
20210401,9호선2~3단계,둔촌오륜,1217,1013,2230
20210401,9호선2~3단계,중앙보훈병원,10042,8822,18864
20210401,9호선2~3단계,석촌,8142,7124,15266
20210402,9호선2~3단계,종합운동장,4347,4238,8585
20210402,9호선2~3단계,언주,10077,10254,20331
20210402,9호선2~3단계,선정릉,9851,10663,20514
20210402,9호선2~3단계,삼성중앙,7007,7163,14170
20210402,9호선2~3단계,봉은사,15240,15253,30493
20210402,9호선2~3단계,삼전,6709,6372,13081
20210402,9호선2~3단계,올림픽공원,6231,6275,12506
20210402,9호선2~3단계,석촌,8337,7357,15694
20210402,9호선2~3단계,송파나루,4768,5221,9989
20210402,9호선2~3단계,한성백제,2559,2279,4838
20210402,9호선2~3단계,석촌고분,5955,6025,11980
20210402,9호선2~3단계,둔촌오륜,1236,999,2235
20210402,9호선2~3단계,중앙보훈병원,9779,8567,18346
20210403,9호선2~3단계,중앙보훈병원,3355,3026,6381
20210403,9호선2~3단계,둔촌오륜,521,525,1046
20210403,9호선2~3단계,올림픽공원,2973,2964,5937
20210403,9호선2~3단계,한성백제,1450,1305,2755
20210403,9호선2~3단계,송파나루,3545,3624,7169
20210403,9호선2~3단계,석촌,5363,4319,9682
20210403,9호선2~3단계,석촌고분,3667,3519,7186
20210403,9호선2~3단계,삼전,4214,3975,8189
20210403,9호선2~3단계,종합운동장,3041,2508,5549
20210403,9호선2~3단계,봉은사,9401,9698,19099
20210403,9호선2~3단계,삼성중앙,2840,2873,5713
20210403,9호선2~3단계,선정릉,4209,4619,8828
20210403,9호선2~3단계,언주,5670,5416,11086
20210404,9호선2~3단계,둔촌오륜,337,339,676
20210404,9호선2~3단계,올림픽공원,3206,3217,6423
20210404,9호선2~3단계,한성백제,1485,1305,2790
20210404,9호선2~3단계,송파나루,2660,2892,5552
20210404,9호선2~3단계,석촌,4099,3675,7774
20210404,9호선2~3단계,석촌고분,2742,2785,5527
20210404,9호선2~3단계,중앙보훈병원,2874,2661,5535
20210404,9호선2~3단계,종합운동장,2061,1832,3893
20210404,9호선2~3단계,봉은사,5839,5557,11396
20210404,9호선2~3단계,삼성중앙,1636,1734,3370
20210404,9호선2~3단계,선정릉,2780,3040,5820
20210404,9호선2~3단계,언주,3186,3053,6239
20210404,9호선2~3단계,삼전,3107,3193,6300
20210405,9호선2~3단계,선정릉,9417,10385,19802
20210405,9호선2~3단계,삼성중앙,6909,7219,14128
20210405,9호선2~3단계,봉은사,14617,14676,29293
20210405,9호선2~3단계,종합운동장,3963,4023,7986
20210405,9호선2~3단계,삼전,6430,6165,12595
20210405,9호선2~3단계,석촌고분,5750,5711,11461
20210405,9호선2~3단계,언주,9638,10130,19768
20210405,9호선2~3단계,송파나루,4391,4657,9048
20210405,9호선2~3단계,한성백제,2440,2222,4662
20210405,9호선2~3단계,올림픽공원,5753,5755,11508
20210405,9호선2~3단계,둔촌오륜,1254,1090,2344
20210405,9호선2~3단계,중앙보훈병원,10199,8969,19168
20210405,9호선2~3단계,석촌,7931,6987,14918
20210406,9호선2~3단계,언주,10027,10438,20465
20210406,9호선2~3단계,선정릉,9631,10630,20261
20210406,9호선2~3단계,삼성중앙,6954,7318,14272
20210406,9호선2~3단계,봉은사,14930,14966,29896
20210406,9호선2~3단계,종합운동장,4229,4226,8455
20210406,9호선2~3단계,삼전,6477,6233,12710
20210406,9호선2~3단계,석촌고분,5742,5759,11501
20210406,9호선2~3단계,송파나루,4625,4821,9446
20210406,9호선2~3단계,한성백제,2480,2255,4735
20210406,9호선2~3단계,올림픽공원,5756,5763,11519
20210406,9호선2~3단계,둔촌오륜,1248,1070,2318
20210406,9호선2~3단계,중앙보훈병원,10162,9076,19238
20210406,9호선2~3단계,석촌,8030,7158,15188
20210407,9호선2~3단계,삼전,6568,6340,12908
20210407,9호선2~3단계,선정릉,9625,10476,20101
20210407,9호선2~3단계,삼성중앙,6957,7184,14141
20210407,9호선2~3단계,봉은사,15489,15669,31158
20210407,9호선2~3단계,종합운동장,4180,4025,8205
20210407,9호선2~3단계,석촌고분,5672,5663,11335
20210407,9호선2~3단계,언주,9964,10105,20069
20210407,9호선2~3단계,송파나루,4499,4784,9283
20210407,9호선2~3단계,중앙보훈병원,10188,9001,19189
20210407,9호선2~3단계,둔촌오륜,1254,1101,2355
20210407,9호선2~3단계,석촌,8190,7196,15386
20210407,9호선2~3단계,한성백제,2517,2274,4791
20210407,9호선2~3단계,올림픽공원,5615,5796,11411
20210408,9호선2~3단계,선정릉,9581,10491,20072
20210408,9호선2~3단계,삼성중앙,6922,7189,14111
20210408,9호선2~3단계,봉은사,16263,16595,32858
20210408,9호선2~3단계,종합운동장,4086,4011,8097
20210408,9호선2~3단계,삼전,6511,6340,12851
20210408,9호선2~3단계,석촌고분,5814,5837,11651
20210408,9호선2~3단계,언주,9869,10225,20094
20210408,9호선2~3단계,송파나루,4532,4729,9261
20210408,9호선2~3단계,한성백제,2510,2241,4751
20210408,9호선2~3단계,올림픽공원,5750,5658,11408
20210408,9호선2~3단계,둔촌오륜,1263,1101,2364
20210408,9호선2~3단계,중앙보훈병원,9913,8729,18642
20210408,9호선2~3단계,석촌,7935,7083,15018
20210409,9호선2~3단계,중앙보훈병원,9973,8781,18754
20210409,9호선2~3단계,둔촌오륜,1275,1103,2378
20210409,9호선2~3단계,올림픽공원,6081,5984,12065
20210409,9호선2~3단계,한성백제,2596,2269,4865
20210409,9호선2~3단계,송파나루,4788,5177,9965
20210409,9호선2~3단계,석촌,8357,7476,15833
20210409,9호선2~3단계,석촌고분,5942,5897,11839
20210409,9호선2~3단계,종합운동장,4245,4224,8469
20210409,9호선2~3단계,봉은사,16284,16283,32567
20210409,9호선2~3단계,삼성중앙,6913,7163,14076
20210409,9호선2~3단계,언주,10222,10421,20643
20210409,9호선2~3단계,삼전,6762,6518,13280
20210409,9호선2~3단계,선정릉,9728,10474,20202
20210410,9호선2~3단계,언주,5564,5536,11100
20210410,9호선2~3단계,삼전,4796,4433,9229
20210410,9호선2~3단계,선정릉,4562,5393,9955
20210410,9호선2~3단계,삼성중앙,2918,2917,5835
20210410,9호선2~3단계,봉은사,10050,10455,20505
20210410,9호선2~3단계,종합운동장,3439,2829,6268
20210410,9호선2~3단계,석촌고분,3980,3794,7774
20210410,9호선2~3단계,송파나루,3652,3910,7562
20210410,9호선2~3단계,한성백제,1875,1533,3408
20210410,9호선2~3단계,올림픽공원,4383,4515,8898
20210410,9호선2~3단계,둔촌오륜,645,601,1246
20210410,9호선2~3단계,중앙보훈병원,4214,3962,8176
20210410,9호선2~3단계,석촌,6403,5466,11869
20210411,9호선2~3단계,선정릉,2930,3338,6268
20210411,9호선2~3단계,삼성중앙,1667,1781,3448
20210411,9호선2~3단계,봉은사,6915,7005,13920
20210411,9호선2~3단계,종합운동장,1934,1786,3720
20210411,9호선2~3단계,삼전,3337,3348,6685
20210411,9호선2~3단계,석촌고분,2687,2678,5365
20210411,9호선2~3단계,언주,3597,3608,7205
20210411,9호선2~3단계,송파나루,2603,2783,5386
20210411,9호선2~3단계,한성백제,1394,1249,2643
20210411,9호선2~3단계,올림픽공원,3086,3275,6361
20210411,9호선2~3단계,둔촌오륜,341,345,686
20210411,9호선2~3단계,중앙보훈병원,3362,3161,6523
20210411,9호선2~3단계,석촌,4230,3819,8049
20210412,9호선2~3단계,언주,10185,10169,20354
20210412,9호선2~3단계,선정릉,8972,9888,18860
20210412,9호선2~3단계,삼성중앙,6911,7009,13920
20210412,9호선2~3단계,봉은사,14748,14644,29392
20210412,9호선2~3단계,종합운동장,3950,3851,7801
20210412,9호선2~3단계,삼전,6350,6526,12876
20210412,9호선2~3단계,석촌고분,5578,5867,11445
20210412,9호선2~3단계,송파나루,4259,4607,8866
20210412,9호선2~3단계,한성백제,2237,2189,4426
20210412,9호선2~3단계,올림픽공원,5162,4950,10112
20210412,9호선2~3단계,둔촌오륜,1288,1088,2376
20210412,9호선2~3단계,중앙보훈병원,9853,8643,18496
20210412,9호선2~3단계,석촌,7369,6548,13917
20210413,9호선2~3단계,송파나루,4521,4807,9328
20210413,9호선2~3단계,중앙보훈병원,10174,9078,19252
20210413,9호선2~3단계,둔촌오륜,1187,1042,2229
20210413,9호선2~3단계,올림픽공원,5359,5369,10728
20210413,9호선2~3단계,한성백제,2470,2177,4647
20210413,9호선2~3단계,석촌,7794,6823,14617
20210413,9호선2~3단계,석촌고분,5843,5794,11637
20210413,9호선2~3단계,삼전,6441,6361,12802
20210413,9호선2~3단계,종합운동장,4104,3959,8063
20210413,9호선2~3단계,봉은사,14725,14904,29629
20210413,9호선2~3단계,삼성중앙,6828,7024,13852
20210413,9호선2~3단계,선정릉,9509,10396,19905
20210413,9호선2~3단계,언주,9973,10240,20213
20210414,9호선2~3단계,언주,9718,10056,19774
20210414,9호선2~3단계,선정릉,9648,10399,20047
20210414,9호선2~3단계,삼성중앙,6698,7152,13850
20210414,9호선2~3단계,봉은사,15100,15244,30344
20210414,9호선2~3단계,종합운동장,4187,4083,8270
20210414,9호선2~3단계,삼전,6490,6285,12775
20210414,9호선2~3단계,석촌고분,5914,5858,11772
20210414,9호선2~3단계,석촌,7922,7066,14988
20210414,9호선2~3단계,송파나루,4505,4903,9408
20210414,9호선2~3단계,한성백제,2415,2176,4591
20210414,9호선2~3단계,올림픽공원,5629,5594,11223
20210414,9호선2~3단계,둔촌오륜,1246,1076,2322
20210414,9호선2~3단계,중앙보훈병원,10203,9121,19324
20210415,9호선2~3단계,선정릉,9553,10474,20027
20210415,9호선2~3단계,삼성중앙,6682,7094,13776
20210415,9호선2~3단계,봉은사,15153,15359,30512
20210415,9호선2~3단계,종합운동장,4036,4069,8105
20210415,9호선2~3단계,삼전,6446,6133,12579
20210415,9호선2~3단계,석촌고분,5813,5855,11668
20210415,9호선2~3단계,언주,9814,10122,19936
20210415,9호선2~3단계,송파나루,4492,4783,9275
20210415,9호선2~3단계,한성백제,2467,2151,4618
20210415,9호선2~3단계,올림픽공원,5645,5603,11248
20210415,9호선2~3단계,둔촌오륜,1262,1103,2365
20210415,9호선2~3단계,중앙보훈병원,10071,8903,18974
20210415,9호선2~3단계,석촌,7966,6962,14928
20210416,9호선2~3단계,둔촌오륜,1232,1046,2278
20210416,9호선2~3단계,올림픽공원,5632,5424,11056
20210416,9호선2~3단계,한성백제,2348,2127,4475
20210416,9호선2~3단계,송파나루,4565,4864,9429
20210416,9호선2~3단계,석촌,7958,7060,15018
20210416,9호선2~3단계,석촌고분,5841,5631,11472
20210416,9호선2~3단계,중앙보훈병원,9810,8602,18412
20210416,9호선2~3단계,종합운동장,4084,4088,8172
20210416,9호선2~3단계,봉은사,14994,14922,29916
20210416,9호선2~3단계,삼성중앙,6597,6897,13494
20210416,9호선2~3단계,선정릉,9486,10165,19651
20210416,9호선2~3단계,언주,9826,9959,19785
20210416,9호선2~3단계,삼전,6565,6310,12875
20210417,9호선2~3단계,중앙보훈병원,3961,3705,7666
20210417,9호선2~3단계,둔촌오륜,576,554,1130
20210417,9호선2~3단계,올림픽공원,3652,3647,7299
20210417,9호선2~3단계,한성백제,1656,1410,3066
20210417,9호선2~3단계,송파나루,3537,3660,7197
20210417,9호선2~3단계,석촌,5969,4963,10932
20210417,9호선2~3단계,석촌고분,3824,3629,7453
20210417,9호선2~3단계,종합운동장,3149,2648,5797
20210417,9호선2~3단계,봉은사,9082,9435,18517
20210417,9호선2~3단계,삼성중앙,2831,2833,5664
20210417,9호선2~3단계,선정릉,4429,4914,9343
20210417,9호선2~3단계,언주,5324,5295,10619
20210417,9호선2~3단계,삼전,4454,4190,8644
20210418,9호선2~3단계,삼전,3229,3153,6382
20210418,9호선2~3단계,선정릉,2956,3298,6254
20210418,9호선2~3단계,삼성중앙,1731,1797,3528
20210418,9호선2~3단계,봉은사,6325,6265,12590
20210418,9호선2~3단계,종합운동장,1929,1692,3621
20210418,9호선2~3단계,석촌고분,2730,2710,5440
20210418,9호선2~3단계,언주,2872,2939,5811
20210418,9호선2~3단계,송파나루,2494,2791,5285
20210418,9호선2~3단계,중앙보훈병원,2906,2759,5665
20210418,9호선2~3단계,둔촌오륜,399,424,823
20210418,9호선2~3단계,석촌,4061,3620,7681
20210418,9호선2~3단계,한성백제,1316,1199,2515
20210418,9호선2~3단계,올림픽공원,3081,3126,6207
20210419,9호선2~3단계,석촌,7670,6906,14576
20210419,9호선2~3단계,석촌고분,5506,5548,11054
20210419,9호선2~3단계,삼전,6348,6107,12455
20210419,9호선2~3단계,종합운동장,3946,3992,7938
20210419,9호선2~3단계,봉은사,14346,14307,28653
20210419,9호선2~3단계,삼성중앙,6748,6990,13738
20210419,9호선2~3단계,송파나루,4315,4625,8940
20210419,9호선2~3단계,언주,9498,9821,19319
20210419,9호선2~3단계,중앙보훈병원,10174,8942,19116
20210419,9호선2~3단계,둔촌오륜,1176,1041,2217
20210419,9호선2~3단계,올림픽공원,5542,5581,11123
20210419,9호선2~3단계,한성백제,2292,2118,4410
20210419,9호선2~3단계,선정릉,9373,10270,19643
20210420,9호선2~3단계,언주,9768,9984,19752
20210420,9호선2~3단계,선정릉,9675,10566,20241
20210420,9호선2~3단계,삼성중앙,6751,7068,13819
20210420,9호선2~3단계,봉은사,14844,14974,29818
20210420,9호선2~3단계,종합운동장,3940,3961,7901
20210420,9호선2~3단계,삼전,6560,6230,12790
20210420,9호선2~3단계,석촌고분,5732,5688,11420
20210420,9호선2~3단계,송파나루,4367,4618,8985
20210420,9호선2~3단계,한성백제,2378,2206,4584
20210420,9호선2~3단계,올림픽공원,5458,5446,10904
20210420,9호선2~3단계,중앙보훈병원,10256,9126,19382
20210420,9호선2~3단계,석촌,7865,7122,14987
20210420,9호선2~3단계,둔촌오륜,1276,1094,2370
20210421,9호선2~3단계,언주,9646,9966,19612
20210421,9호선2~3단계,삼전,6461,6220,12681
20210421,9호선2~3단계,선정릉,9749,10470,20219
20210421,9호선2~3단계,삼성중앙,6760,7091,13851
20210421,9호선2~3단계,봉은사,15619,15922,31541
20210421,9호선2~3단계,종합운동장,4193,4045,8238
20210421,9호선2~3단계,석촌고분,5812,5692,11504
20210421,9호선2~3단계,송파나루,4379,4706,9085
20210421,9호선2~3단계,한성백제,2419,2199,4618
20210421,9호선2~3단계,올림픽공원,5555,5517,11072
20210421,9호선2~3단계,둔촌오륜,1252,1041,2293
20210421,9호선2~3단계,중앙보훈병원,10201,9120,19321
20210421,9호선2~3단계,석촌,7940,6878,14818
20210422,9호선2~3단계,선정릉,9604,10383,19987
20210422,9호선2~3단계,삼성중앙,6734,7102,13836
20210422,9호선2~3단계,봉은사,15691,15912,31603
20210422,9호선2~3단계,종합운동장,4067,4019,8086
20210422,9호선2~3단계,삼전,6418,6204,12622
20210422,9호선2~3단계,석촌고분,5720,5631,11351
20210422,9호선2~3단계,언주,9872,10143,20015
20210422,9호선2~3단계,송파나루,4364,4604,8968
20210422,9호선2~3단계,한성백제,2366,2158,4524
20210422,9호선2~3단계,올림픽공원,5518,5544,11062
20210422,9호선2~3단계,둔촌오륜,1250,1121,2371
20210422,9호선2~3단계,중앙보훈병원,10010,8807,18817
20210422,9호선2~3단계,석촌,7823,7061,14884
20210423,9호선2~3단계,중앙보훈병원,9780,8468,18248
20210423,9호선2~3단계,둔촌오륜,1305,1119,2424
20210423,9호선2~3단계,올림픽공원,5728,5739,11467
20210423,9호선2~3단계,한성백제,2449,2221,4670
20210423,9호선2~3단계,송파나루,4610,5049,9659
20210423,9호선2~3단계,석촌,8082,7130,15212
20210423,9호선2~3단계,석촌고분,5842,5760,11602
20210423,9호선2~3단계,종합운동장,4144,4278,8422
20210423,9호선2~3단계,봉은사,15804,16227,32031
20210423,9호선2~3단계,삼성중앙,6747,6956,13703
20210423,9호선2~3단계,선정릉,9884,10620,20504
20210423,9호선2~3단계,언주,10000,10327,20327
20210423,9호선2~3단계,삼전,6547,6263,12810
20210424,9호선2~3단계,삼전,4564,4163,8727
20210424,9호선2~3단계,선정릉,4693,5204,9897
20210424,9호선2~3단계,삼성중앙,2708,2775,5483
20210424,9호선2~3단계,봉은사,8735,9055,17790
20210424,9호선2~3단계,종합운동장,2797,2543,5340
20210424,9호선2~3단계,석촌고분,3911,3609,7520
20210424,9호선2~3단계,언주,5501,5390,10891
20210424,9호선2~3단계,송파나루,3413,3720,7133
20210424,9호선2~3단계,한성백제,1720,1454,3174
20210424,9호선2~3단계,올림픽공원,3882,3960,7842
20210424,9호선2~3단계,둔촌오륜,594,544,1138
20210424,9호선2~3단계,중앙보훈병원,4162,3818,7980
20210424,9호선2~3단계,석촌,6039,4985,11024
20210425,9호선2~3단계,언주,3055,3203,6258
20210425,9호선2~3단계,선정릉,2964,3317,6281
20210425,9호선2~3단계,삼성중앙,1756,1789,3545
20210425,9호선2~3단계,봉은사,6108,6069,12177
20210425,9호선2~3단계,종합운동장,1932,1762,3694
20210425,9호선2~3단계,삼전,3205,3192,6397
20210425,9호선2~3단계,석촌고분,2723,2702,5425
20210425,9호선2~3단계,석촌,4250,3700,7950
20210425,9호선2~3단계,송파나루,2543,2697,5240
20210425,9호선2~3단계,한성백제,1379,1227,2606
20210425,9호선2~3단계,올림픽공원,3091,3239,6330
20210425,9호선2~3단계,둔촌오륜,357,389,746
20210425,9호선2~3단계,중앙보훈병원,3131,2999,6130
20210426,9호선2~3단계,선정릉,9512,10445,19957
20210426,9호선2~3단계,삼성중앙,6665,6928,13593
20210426,9호선2~3단계,봉은사,14207,14227,28434
20210426,9호선2~3단계,종합운동장,4000,4035,8035
20210426,9호선2~3단계,삼전,6425,6200,12625
20210426,9호선2~3단계,석촌고분,5496,5561,11057
20210426,9호선2~3단계,언주,9648,9970,19618
20210426,9호선2~3단계,송파나루,4272,4631,8903
20210426,9호선2~3단계,한성백제,2266,2151,4417
20210426,9호선2~3단계,올림픽공원,5515,5569,11084
20210426,9호선2~3단계,둔촌오륜,1319,1093,2412
20210426,9호선2~3단계,중앙보훈병원,10051,8956,19007
20210426,9호선2~3단계,석촌,7613,6742,14355
20210427,9호선2~3단계,둔촌오륜,1324,1171,2495
20210427,9호선2~3단계,올림픽공원,5572,5549,11121
20210427,9호선2~3단계,한성백제,2425,2245,4670
20210427,9호선2~3단계,송파나루,4530,4795,9325
20210427,9호선2~3단계,석촌,7734,6842,14576
20210427,9호선2~3단계,석촌고분,5697,5756,11453
20210427,9호선2~3단계,중앙보훈병원,10182,9036,19218
20210427,9호선2~3단계,종합운동장,4044,4120,8164
20210427,9호선2~3단계,봉은사,14683,15013,29696
20210427,9호선2~3단계,삼성중앙,6759,7023,13782
20210427,9호선2~3단계,선정릉,9665,10473,20138
20210427,9호선2~3단계,언주,9913,10076,19989
20210427,9호선2~3단계,삼전,6335,6202,12537
20210428,9호선2~3단계,언주,9919,10087,20006
20210428,9호선2~3단계,선정릉,9726,10610,20336
20210428,9호선2~3단계,삼성중앙,6807,7090,13897
20210428,9호선2~3단계,봉은사,15140,15389,30529
20210428,9호선2~3단계,종합운동장,4177,4268,8445
20210428,9호선2~3단계,삼전,6468,6157,12625
20210428,9호선2~3단계,석촌고분,5797,5794,11591
20210428,9호선2~3단계,송파나루,4453,4848,9301
20210428,9호선2~3단계,한성백제,2433,2190,4623
20210428,9호선2~3단계,올림픽공원,5592,5674,11266
20210428,9호선2~3단계,둔촌오륜,1321,1120,2441
20210428,9호선2~3단계,중앙보훈병원,10265,9217,19482
20210428,9호선2~3단계,석촌,7943,7145,15088
20210429,9호선2~3단계,석촌,7928,7032,14960
20210429,9호선2~3단계,둔촌오륜,1318,1151,2469
20210429,9호선2~3단계,올림픽공원,5597,5606,11203
20210429,9호선2~3단계,한성백제,2501,2228,4729
20210429,9호선2~3단계,송파나루,4437,4876,9313
20210429,9호선2~3단계,석촌고분,5841,5933,11774
20210429,9호선2~3단계,중앙보훈병원,10071,8978,19049
20210429,9호선2~3단계,종합운동장,4146,4146,8292
20210429,9호선2~3단계,언주,9961,10302,20263
20210429,9호선2~3단계,선정릉,9569,10495,20064
20210429,9호선2~3단계,삼전,6559,6342,12901
20210429,9호선2~3단계,봉은사,15710,16032,31742
20210429,9호선2~3단계,삼성중앙,6739,7123,13862
20210430,9호선2~3단계,둔촌오륜,1300,1138,2438
20210430,9호선2~3단계,올림픽공원,5846,5714,11560
20210430,9호선2~3단계,한성백제,2490,2275,4765
20210430,9호선2~3단계,송파나루,4746,5147,9893
20210430,9호선2~3단계,석촌,8215,7197,15412
20210430,9호선2~3단계,석촌고분,6001,5807,11808
20210430,9호선2~3단계,중앙보훈병원,10215,9042,19257
20210430,9호선2~3단계,종합운동장,4380,4304,8684
20210430,9호선2~3단계,봉은사,16045,16374,32419
20210430,9호선2~3단계,삼성중앙,6849,7119,13968
20210430,9호선2~3단계,선정릉,9766,10606,20372
20210430,9호선2~3단계,언주,10061,10297,20358
20210430,9호선2~3단계,삼전,6710,6412,13122
20210501,9호선2~3단계,중앙보훈병원,3600,3386,6986
20210501,9호선2~3단계,둔촌오륜,508,485,993
20210501,9호선2~3단계,올림픽공원,3200,3267,6467
20210501,9호선2~3단계,한성백제,1461,1241,2702
20210501,9호선2~3단계,송파나루,3654,3745,7399
20210501,9호선2~3단계,석촌,5515,4623,10138
20210501,9호선2~3단계,석촌고분,3627,3588,7215
20210501,9호선2~3단계,종합운동장,3011,2657,5668
20210501,9호선2~3단계,봉은사,10199,10736,20935
20210501,9호선2~3단계,삼성중앙,2754,2782,5536
20210501,9호선2~3단계,언주,5248,5258,10506
20210501,9호선2~3단계,삼전,4199,4035,8234
20210501,9호선2~3단계,선정릉,4366,4930,9296
20210502,9호선2~3단계,중앙보훈병원,3227,3023,6250
20210502,9호선2~3단계,석촌,4251,3803,8054
20210502,9호선2~3단계,둔촌오륜,422,469,891
20210502,9호선2~3단계,올림픽공원,3228,3299,6527
20210502,9호선2~3단계,한성백제,1427,1207,2634
20210502,9호선2~3단계,송파나루,2792,2961,5753
20210502,9호선2~3단계,석촌고분,2845,2788,5633
20210502,9호선2~3단계,종합운동장,2071,1883,3954
20210502,9호선2~3단계,봉은사,6625,6678,13303
20210502,9호선2~3단계,삼성중앙,1678,1826,3504
20210502,9호선2~3단계,선정릉,2810,3166,5976
20210502,9호선2~3단계,언주,2982,2840,5822
20210502,9호선2~3단계,삼전,3244,3122,6366
20210503,9호선2~3단계,선정릉,9384,10313,19697
20210503,9호선2~3단계,삼성중앙,6656,6911,13567
20210503,9호선2~3단계,봉은사,14515,14582,29097
20210503,9호선2~3단계,종합운동장,3995,4002,7997
20210503,9호선2~3단계,삼전,6489,6223,12712
20210503,9호선2~3단계,석촌고분,5677,5708,11385
20210503,9호선2~3단계,언주,9867,10193,20060
20210503,9호선2~3단계,송파나루,4362,4679,9041
20210503,9호선2~3단계,한성백제,2328,2147,4475
20210503,9호선2~3단계,올림픽공원,5500,5614,11114
20210503,9호선2~3단계,둔촌오륜,1186,1021,2207
20210503,9호선2~3단계,중앙보훈병원,10085,9006,19091
20210503,9호선2~3단계,석촌,7710,6879,14589
20210504,9호선2~3단계,석촌고분,5881,6068,11949
20210504,9호선2~3단계,삼전,6518,6342,12860
20210504,9호선2~3단계,종합운동장,4165,4055,8220
20210504,9호선2~3단계,봉은사,15216,15211,30427
20210504,9호선2~3단계,삼성중앙,6955,7221,14176
20210504,9호선2~3단계,언주,10199,10299,20498
20210504,9호선2~3단계,선정릉,9338,10186,19524
20210504,9호선2~3단계,둔촌오륜,1259,1073,2332
20210504,9호선2~3단계,올림픽공원,5265,5193,10458
20210504,9호선2~3단계,한성백제,2336,2140,4476
20210504,9호선2~3단계,송파나루,4651,4950,9601
20210504,9호선2~3단계,석촌,7633,6689,14322
20210504,9호선2~3단계,중앙보훈병원,9958,8720,18678
20210505,9호선2~3단계,석촌,4911,4212,9123
20210505,9호선2~3단계,둔촌오륜,488,457,945
20210505,9호선2~3단계,올림픽공원,3649,3802,7451
20210505,9호선2~3단계,한성백제,1626,1386,3012
20210505,9호선2~3단계,송파나루,3162,3455,6617
20210505,9호선2~3단계,석촌고분,3243,3131,6374
20210505,9호선2~3단계,중앙보훈병원,3329,3242,6571
20210505,9호선2~3단계,종합운동장,2293,2079,4372
20210505,9호선2~3단계,언주,3101,3242,6343
20210505,9호선2~3단계,선정릉,3035,3413,6448
20210505,9호선2~3단계,삼전,3793,3566,7359
20210505,9호선2~3단계,봉은사,7791,7901,15692
20210505,9호선2~3단계,삼성중앙,2153,2127,4280
20210506,9호선2~3단계,중앙보훈병원,10112,9001,19113
20210506,9호선2~3단계,둔촌오륜,1215,1067,2282
20210506,9호선2~3단계,올림픽공원,5757,5772,11529
20210506,9호선2~3단계,한성백제,2456,2197,4653
20210506,9호선2~3단계,석촌,7956,7119,15075
20210506,9호선2~3단계,석촌고분,5779,5814,11593
20210506,9호선2~3단계,송파나루,4491,4765,9256
20210506,9호선2~3단계,종합운동장,4105,4111,8216
20210506,9호선2~3단계,봉은사,15099,15303,30402
20210506,9호선2~3단계,삼성중앙,6881,7210,14091
20210506,9호선2~3단계,선정릉,9748,10632,20380
20210506,9호선2~3단계,언주,9948,10163,20111
20210506,9호선2~3단계,삼전,6446,6263,12709
20210507,9호선2~3단계,송파나루,4728,5100,9828
20210507,9호선2~3단계,둔촌오륜,1231,1103,2334
20210507,9호선2~3단계,중앙보훈병원,9742,8588,18330
20210507,9호선2~3단계,올림픽공원,5750,5457,11207
20210507,9호선2~3단계,한성백제,2397,2095,4492
20210507,9호선2~3단계,석촌,8155,7067,15222
20210507,9호선2~3단계,선정릉,9559,10006,19565
20210507,9호선2~3단계,삼전,6751,6416,13167
20210507,9호선2~3단계,종합운동장,4276,4208,8484
20210507,9호선2~3단계,봉은사,15255,15193,30448
20210507,9호선2~3단계,삼성중앙,6834,6883,13717
20210507,9호선2~3단계,언주,9998,9996,19994
20210507,9호선2~3단계,석촌고분,6040,5976,12016
20210508,9호선2~3단계,중앙보훈병원,3639,3507,7146
20210508,9호선2~3단계,둔촌오륜,548,532,1080
20210508,9호선2~3단계,올림픽공원,3358,3479,6837
20210508,9호선2~3단계,한성백제,1386,1213,2599
20210508,9호선2~3단계,석촌,5425,4560,9985
20210508,9호선2~3단계,송파나루,3160,3240,6400
20210508,9호선2~3단계,석촌고분,3566,3352,6918
20210508,9호선2~3단계,종합운동장,2772,2407,5179
20210508,9호선2~3단계,봉은사,7598,7583,15181
20210508,9호선2~3단계,삼성중앙,2495,2491,4986
20210508,9호선2~3단계,선정릉,4158,4385,8543
20210508,9호선2~3단계,언주,4626,4606,9232
20210508,9호선2~3단계,삼전,4157,3779,7936
20210509,9호선2~3단계,선정릉,2673,3204,5877
20210509,9호선2~3단계,삼성중앙,1667,1757,3424
20210509,9호선2~3단계,봉은사,5958,5995,11953
20210509,9호선2~3단계,종합운동장,2087,1933,4020
20210509,9호선2~3단계,삼전,3067,3267,6334
20210509,9호선2~3단계,석촌고분,2621,2835,5456
20210509,9호선2~3단계,언주,3022,3126,6148
20210509,9호선2~3단계,송파나루,2608,2985,5593
20210509,9호선2~3단계,한성백제,1277,1154,2431
20210509,9호선2~3단계,올림픽공원,3203,3257,6460
20210509,9호선2~3단계,둔촌오륜,419,446,865
20210509,9호선2~3단계,중앙보훈병원,3255,3010,6265
20210509,9호선2~3단계,석촌,4231,3885,8116
20210510,9호선2~3단계,중앙보훈병원,10269,9161,19430
20210510,9호선2~3단계,둔촌오륜,1192,1034,2226
20210510,9호선2~3단계,올림픽공원,5367,5322,10689
20210510,9호선2~3단계,한성백제,2205,2134,4339
20210510,9호선2~3단계,송파나루,4318,4582,8900
20210510,9호선2~3단계,석촌,7585,6912,14497
20210510,9호선2~3단계,석촌고분,5693,5663,11356
20210510,9호선2~3단계,종합운동장,3808,3998,7806
20210510,9호선2~3단계,봉은사,14463,14579,29042
20210510,9호선2~3단계,삼성중앙,6609,7109,13718
20210510,9호선2~3단계,선정릉,9493,10304,19797
20210510,9호선2~3단계,언주,9742,10025,19767
20210510,9호선2~3단계,삼전,6377,6230,12607
20210511,9호선2~3단계,중앙보훈병원,10701,9613,20314
20210511,9호선2~3단계,둔촌오륜,1278,1125,2403
20210511,9호선2~3단계,올림픽공원,5848,5873,11721
20210511,9호선2~3단계,한성백제,2420,2272,4692
20210511,9호선2~3단계,송파나루,4563,4921,9484
20210511,9호선2~3단계,석촌,8022,7253,15275
20210511,9호선2~3단계,석촌고분,5866,5836,11702
20210511,9호선2~3단계,종합운동장,4029,4190,8219
20210511,9호선2~3단계,언주,10037,10294,20331
20210511,9호선2~3단계,선정릉,9747,10622,20369
20210511,9호선2~3단계,삼전,6618,6378,12996
20210511,9호선2~3단계,봉은사,15050,15202,30252
20210511,9호선2~3단계,삼성중앙,6794,7120,13914
20210512,9호선2~3단계,선정릉,9662,10628,20290
20210512,9호선2~3단계,삼성중앙,6866,7292,14158
20210512,9호선2~3단계,봉은사,16216,16306,32522
20210512,9호선2~3단계,종합운동장,4225,4177,8402
20210512,9호선2~3단계,삼전,6678,6539,13217
20210512,9호선2~3단계,석촌고분,5835,5831,11666
20210512,9호선2~3단계,언주,9994,10178,20172
20210512,9호선2~3단계,송파나루,4615,4942,9557
20210512,9호선2~3단계,한성백제,2462,2300,4762
20210512,9호선2~3단계,올림픽공원,5869,5890,11759
20210512,9호선2~3단계,둔촌오륜,1235,1067,2302
20210512,9호선2~3단계,중앙보훈병원,10550,9365,19915
20210512,9호선2~3단계,석촌,8025,7121,15146
20210513,9호선2~3단계,중앙보훈병원,10312,9246,19558
20210513,9호선2~3단계,둔촌오륜,1248,1092,2340
20210513,9호선2~3단계,올림픽공원,5923,5871,11794
20210513,9호선2~3단계,한성백제,2508,2355,4863
20210513,9호선2~3단계,송파나루,4625,5063,9688
20210513,9호선2~3단계,석촌,8153,7107,15260
20210513,9호선2~3단계,석촌고분,5822,5716,11538
20210513,9호선2~3단계,종합운동장,4208,4245,8453
20210513,9호선2~3단계,봉은사,15839,16075,31914
20210513,9호선2~3단계,삼성중앙,6771,7083,13854
20210513,9호선2~3단계,언주,10098,10305,20403
20210513,9호선2~3단계,삼전,6621,6398,13019
20210513,9호선2~3단계,선정릉,9803,10622,20425
20210514,9호선2~3단계,중앙보훈병원,10315,9076,19391
20210514,9호선2~3단계,석촌,8380,7614,15994
20210514,9호선2~3단계,둔촌오륜,1307,1125,2432
20210514,9호선2~3단계,올림픽공원,6152,6093,12245
20210514,9호선2~3단계,한성백제,2578,2340,4918
20210514,9호선2~3단계,송파나루,4901,5485,10386
20210514,9호선2~3단계,석촌고분,6125,5907,12032
20210514,9호선2~3단계,종합운동장,4427,4389,8816
20210514,9호선2~3단계,봉은사,16311,16428,32739
20210514,9호선2~3단계,삼성중앙,7061,7246,14307
20210514,9호선2~3단계,선정릉,10035,10915,20950
20210514,9호선2~3단계,언주,10203,10309,20512
20210514,9호선2~3단계,삼전,6918,6640,13558
20210515,9호선2~3단계,둔촌오륜,636,576,1212
20210515,9호선2~3단계,올림픽공원,3614,3550,7164
20210515,9호선2~3단계,한성백제,1581,1414,2995
20210515,9호선2~3단계,송파나루,3836,4075,7911
20210515,9호선2~3단계,석촌,5854,4966,10820
20210515,9호선2~3단계,석촌고분,3766,3770,7536
20210515,9호선2~3단계,중앙보훈병원,4341,4023,8364
20210515,9호선2~3단계,종합운동장,3221,2652,5873
20210515,9호선2~3단계,봉은사,9731,9935,19666
20210515,9호선2~3단계,삼성중앙,2897,2948,5845
20210515,9호선2~3단계,선정릉,4645,5129,9774
20210515,9호선2~3단계,언주,5677,5751,11428
20210515,9호선2~3단계,삼전,4477,4419,8896
20210516,9호선2~3단계,중앙보훈병원,2599,2518,5117
20210516,9호선2~3단계,둔촌오륜,345,361,706
20210516,9호선2~3단계,올림픽공원,2021,2011,4032
20210516,9호선2~3단계,한성백제,1067,955,2022
20210516,9호선2~3단계,송파나루,2474,2535,5009
20210516,9호선2~3단계,석촌,3400,3016,6416
20210516,9호선2~3단계,석촌고분,2485,2511,4996
20210516,9호선2~3단계,종합운동장,1629,1449,3078
20210516,9호선2~3단계,봉은사,7061,6988,14049
20210516,9호선2~3단계,삼성중앙,1620,1718,3338
20210516,9호선2~3단계,선정릉,2414,2692,5106
20210516,9호선2~3단계,언주,3009,3020,6029
20210516,9호선2~3단계,삼전,2763,2911,5674
20210517,9호선2~3단계,삼전,6393,6243,12636
20210517,9호선2~3단계,선정릉,9495,10196,19691
20210517,9호선2~3단계,삼성중앙,6600,6988,13588
20210517,9호선2~3단계,봉은사,15627,16000,31627
20210517,9호선2~3단계,종합운동장,4016,4068,8084
20210517,9호선2~3단계,석촌고분,5600,5688,11288
20210517,9호선2~3단계,언주,10038,10289,20327
20210517,9호선2~3단계,송파나루,4356,4559,8915
20210517,9호선2~3단계,중앙보훈병원,10165,9015,19180
20210517,9호선2~3단계,둔촌오륜,1224,1080,2304
20210517,9호선2~3단계,석촌,7617,6791,14408
20210517,9호선2~3단계,한성백제,2301,2234,4535
20210517,9호선2~3단계,올림픽공원,5400,5293,10693
20210518,9호선2~3단계,언주,10584,10562,21146
20210518,9호선2~3단계,선정릉,9945,11031,20976
20210518,9호선2~3단계,삼성중앙,7110,7475,14585
20210518,9호선2~3단계,봉은사,17385,17829,35214
20210518,9호선2~3단계,삼전,6763,6457,13220
20210518,9호선2~3단계,석촌고분,6062,5928,11990
20210518,9호선2~3단계,종합운동장,4418,4334,8752
20210518,9호선2~3단계,송파나루,4742,5152,9894
20210518,9호선2~3단계,한성백제,2571,2304,4875
20210518,9호선2~3단계,올림픽공원,6260,6185,12445
20210518,9호선2~3단계,둔촌오륜,1300,1108,2408
20210518,9호선2~3단계,중앙보훈병원,10636,9429,20065
20210518,9호선2~3단계,석촌,8356,7440,15796
20210519,9호선2~3단계,종합운동장,2459,2336,4795
20210519,9호선2~3단계,언주,3763,3612,7375
20210519,9호선2~3단계,선정릉,3632,4096,7728
20210519,9호선2~3단계,삼성중앙,2393,2286,4679
20210519,9호선2~3단계,봉은사,16401,17772,34173
20210519,9호선2~3단계,삼전,4291,4035,8326
20210519,9호선2~3단계,둔촌오륜,511,486,997
20210519,9호선2~3단계,석촌,5586,4920,10506
20210519,9호선2~3단계,송파나루,3436,3962,7398
20210519,9호선2~3단계,한성백제,1778,1478,3256
20210519,9호선2~3단계,올림픽공원,4523,4704,9227
20210519,9호선2~3단계,중앙보훈병원,3946,3783,7729
20210519,9호선2~3단계,석촌고분,3628,3459,7087
20210520,9호선2~3단계,석촌,7822,6970,14792
20210520,9호선2~3단계,선정릉,9498,10536,20034
20210520,9호선2~3단계,언주,10013,10429,20442
20210520,9호선2~3단계,올림픽공원,5633,5600,11233
20210520,9호선2~3단계,한성백제,2478,2264,4742
20210520,9호선2~3단계,석촌고분,5844,5887,11731
20210520,9호선2~3단계,송파나루,4505,4928,9433
20210520,9호선2~3단계,종합운동장,4073,4180,8253
20210520,9호선2~3단계,삼전,6513,6516,13029
20210520,9호선2~3단계,봉은사,15061,15122,30183
20210520,9호선2~3단계,삼성중앙,6883,7177,14060
20210520,9호선2~3단계,중앙보훈병원,9872,8894,18766
20210520,9호선2~3단계,둔촌오륜,1249,1116,2365
20210521,9호선2~3단계,선정릉,9799,10592,20391
20210521,9호선2~3단계,삼성중앙,6951,7307,14258
20210521,9호선2~3단계,봉은사,15038,15324,30362
20210521,9호선2~3단계,종합운동장,4329,4393,8722
20210521,9호선2~3단계,삼전,6820,6563,13383
20210521,9호선2~3단계,석촌고분,6031,5904,11935
20210521,9호선2~3단계,언주,10198,10457,20655
20210521,9호선2~3단계,송파나루,4757,5174,9931
20210521,9호선2~3단계,한성백제,2498,2342,4840
20210521,9호선2~3단계,올림픽공원,6143,5885,12028
20210521,9호선2~3단계,둔촌오륜,1280,1114,2394
20210521,9호선2~3단계,중앙보훈병원,9893,8754,18647
20210521,9호선2~3단계,석촌,8111,7217,15328
20210522,9호선2~3단계,언주,6002,6069,12071
20210522,9호선2~3단계,선정릉,5204,5712,10916
20210522,9호선2~3단계,삼성중앙,3020,3069,6089
20210522,9호선2~3단계,봉은사,9187,9495,18682
20210522,9호선2~3단계,종합운동장,3324,2923,6247
20210522,9호선2~3단계,삼전,4749,4377,9126
20210522,9호선2~3단계,석촌고분,4008,3756,7764
20210522,9호선2~3단계,송파나루,3794,4292,8086
20210522,9호선2~3단계,한성백제,1942,1699,3641
20210522,9호선2~3단계,올림픽공원,4794,4980,9774
20210522,9호선2~3단계,둔촌오륜,716,647,1363
20210522,9호선2~3단계,중앙보훈병원,4551,4299,8850
20210522,9호선2~3단계,석촌,6358,5526,11884
20210523,9호선2~3단계,송파나루,2612,2908,5520
20210523,9호선2~3단계,중앙보훈병원,3096,3048,6144
20210523,9호선2~3단계,둔촌오륜,405,415,820
20210523,9호선2~3단계,올림픽공원,3504,3683,7187
20210523,9호선2~3단계,한성백제,1443,1315,2758
20210523,9호선2~3단계,석촌,4269,3805,8074
20210523,9호선2~3단계,선정릉,3140,3501,6641
20210523,9호선2~3단계,삼전,3183,3216,6399
20210523,9호선2~3단계,종합운동장,2016,1841,3857
20210523,9호선2~3단계,봉은사,6337,6317,12654
20210523,9호선2~3단계,삼성중앙,1814,1856,3670
20210523,9호선2~3단계,석촌고분,2787,2732,5519
20210523,9호선2~3단계,언주,3337,3323,6660
20210524,9호선2~3단계,중앙보훈병원,10491,9310,19801
20210524,9호선2~3단계,둔촌오륜,1241,1077,2318
20210524,9호선2~3단계,올림픽공원,5938,5913,11851
20210524,9호선2~3단계,한성백제,2465,2268,4733
20210524,9호선2~3단계,송파나루,4342,4729,9071
20210524,9호선2~3단계,석촌,7810,6953,14763
20210524,9호선2~3단계,석촌고분,5738,5748,11486
20210524,9호선2~3단계,삼전,6683,6395,13078
20210524,9호선2~3단계,종합운동장,4105,4137,8242
20210524,9호선2~3단계,봉은사,14363,14556,28919
20210524,9호선2~3단계,삼성중앙,6785,7129,13914
20210524,9호선2~3단계,선정릉,9508,10375,19883
20210524,9호선2~3단계,언주,10121,10439,20560
20210525,9호선2~3단계,둔촌오륜,1285,1084,2369
20210525,9호선2~3단계,올림픽공원,5657,5741,11398
20210525,9호선2~3단계,한성백제,2452,2197,4649
20210525,9호선2~3단계,송파나루,4548,4779,9327
20210525,9호선2~3단계,석촌,7858,7082,14940
20210525,9호선2~3단계,석촌고분,5927,5829,11756
20210525,9호선2~3단계,중앙보훈병원,10408,9276,19684
20210525,9호선2~3단계,종합운동장,4114,4146,8260
20210525,9호선2~3단계,봉은사,14937,15353,30290
20210525,9호선2~3단계,삼성중앙,6919,7235,14154
20210525,9호선2~3단계,선정릉,9998,10629,20627
20210525,9호선2~3단계,언주,10117,10405,20522
20210525,9호선2~3단계,삼전,6709,6342,13051
20210526,9호선2~3단계,둔촌오륜,1311,1131,2442
20210526,9호선2~3단계,올림픽공원,6093,6190,12283
20210526,9호선2~3단계,한성백제,2526,2336,4862
20210526,9호선2~3단계,송파나루,4679,4996,9675
20210526,9호선2~3단계,석촌,8166,7313,15479
20210526,9호선2~3단계,석촌고분,5858,5861,11719
20210526,9호선2~3단계,중앙보훈병원,10508,9490,19998
20210526,9호선2~3단계,종합운동장,4204,4252,8456
20210526,9호선2~3단계,봉은사,16546,17016,33562
20210526,9호선2~3단계,삼성중앙,7091,7387,14478
20210526,9호선2~3단계,선정릉,9929,10651,20580
20210526,9호선2~3단계,언주,10216,10629,20845
20210526,9호선2~3단계,삼전,6722,6490,13212
20210527,9호선2~3단계,중앙보훈병원,10176,9009,19185
20210527,9호선2~3단계,둔촌오륜,1220,1102,2322
20210527,9호선2~3단계,올림픽공원,5529,5474,11003
20210527,9호선2~3단계,한성백제,2389,2255,4644
20210527,9호선2~3단계,송파나루,4543,4825,9368
20210527,9호선2~3단계,석촌,7686,6940,14626
20210527,9호선2~3단계,석촌고분,5912,5783,11695
20210527,9호선2~3단계,종합운동장,4071,4160,8231
20210527,9호선2~3단계,봉은사,16242,16660,32902
20210527,9호선2~3단계,삼성중앙,6836,7295,14131
20210527,9호선2~3단계,선정릉,9745,10403,20148
20210527,9호선2~3단계,언주,10070,10390,20460
20210527,9호선2~3단계,삼전,6621,6375,12996
20210528,9호선2~3단계,삼전,6705,6295,13000
20210528,9호선2~3단계,선정릉,9721,10352,20073
20210528,9호선2~3단계,삼성중앙,7023,7326,14349
20210528,9호선2~3단계,봉은사,16737,16925,33662
20210528,9호선2~3단계,종합운동장,4275,4360,8635
20210528,9호선2~3단계,석촌고분,6089,5725,11814
20210528,9호선2~3단계,언주,9941,10342,20283
20210528,9호선2~3단계,송파나루,4547,5024,9571
20210528,9호선2~3단계,한성백제,2515,2246,4761
20210528,9호선2~3단계,올림픽공원,6474,6609,13083
20210528,9호선2~3단계,둔촌오륜,1188,1025,2213
20210528,9호선2~3단계,중앙보훈병원,9806,8543,18349
20210528,9호선2~3단계,석촌,7853,7014,14867
20210529,9호선2~3단계,중앙보훈병원,4173,3789,7962
20210529,9호선2~3단계,둔촌오륜,741,667,1408
20210529,9호선2~3단계,올림픽공원,5159,5122,10281
20210529,9호선2~3단계,한성백제,1801,1520,3321
20210529,9호선2~3단계,송파나루,3790,3962,7752
20210529,9호선2~3단계,석촌,5993,4995,10988
20210529,9호선2~3단계,선정릉,4964,5550,10514
20210529,9호선2~3단계,삼전,4651,4309,8960
20210529,9호선2~3단계,종합운동장,2848,2691,5539
20210529,9호선2~3단계,봉은사,11497,12281,23778
20210529,9호선2~3단계,삼성중앙,2927,2968,5895
20210529,9호선2~3단계,석촌고분,4004,3852,7856
20210529,9호선2~3단계,언주,5899,5954,11853
20210530,9호선2~3단계,언주,3482,3560,7042
20210530,9호선2~3단계,선정릉,2935,3399,6334
20210530,9호선2~3단계,삼성중앙,1821,1821,3642
20210530,9호선2~3단계,봉은사,8287,8894,17181
20210530,9호선2~3단계,종합운동장,1988,1843,3831
20210530,9호선2~3단계,삼전,3265,3330,6595
20210530,9호선2~3단계,석촌고분,2846,2889,5735
20210530,9호선2~3단계,석촌,4358,3916,8274
20210530,9호선2~3단계,송파나루,2783,2994,5777
20210530,9호선2~3단계,한성백제,1585,1331,2916
20210530,9호선2~3단계,올림픽공원,4649,4733,9382
20210530,9호선2~3단계,둔촌오륜,455,491,946
20210530,9호선2~3단계,중앙보훈병원,3193,3212,6405
20210531,9호선2~3단계,선정릉,9423,10331,19754
20210531,9호선2~3단계,삼성중앙,6799,7101,13900
20210531,9호선2~3단계,봉은사,14495,14621,29116
20210531,9호선2~3단계,종합운동장,3829,3935,7764
20210531,9호선2~3단계,삼전,6435,6202,12637
20210531,9호선2~3단계,석촌고분,5657,5662,11319
20210531,9호선2~3단계,언주,9662,10069,19731
20210531,9호선2~3단계,송파나루,4205,4568,8773
20210531,9호선2~3단계,한성백제,2333,2219,4552
20210531,9호선2~3단계,올림픽공원,5549,5548,11097
20210531,9호선2~3단계,둔촌오륜,1219,1087,2306
20210531,9호선2~3단계,중앙보훈병원,10232,9094,19326
20210531,9호선2~3단계,석촌,7590,6754,14344
20210601,9호선2~3단계,둔촌오륜,1212,1048,2260
20210601,9호선2~3단계,올림픽공원,5729,5695,11424
20210601,9호선2~3단계,한성백제,2500,2315,4815
20210601,9호선2~3단계,송파나루,4337,4686,9023
20210601,9호선2~3단계,석촌,7827,6902,14729
20210601,9호선2~3단계,석촌고분,5743,5694,11437
20210601,9호선2~3단계,중앙보훈병원,10426,9281,19707
20210601,9호선2~3단계,종합운동장,4011,4120,8131
20210601,9호선2~3단계,봉은사,15021,15307,30328
20210601,9호선2~3단계,삼성중앙,6920,7230,14150
20210601,9호선2~3단계,선정릉,9776,10492,20268
20210601,9호선2~3단계,언주,10025,10193,20218
20210601,9호선2~3단계,삼전,6634,6366,13000
20210602,9호선2~3단계,중앙보훈병원,10477,9372,19849
20210602,9호선2~3단계,둔촌오륜,1244,1104,2348
20210602,9호선2~3단계,올림픽공원,5874,5921,11795
20210602,9호선2~3단계,한성백제,2513,2276,4789
20210602,9호선2~3단계,송파나루,4493,4840,9333
20210602,9호선2~3단계,석촌,8021,7027,15048
20210602,9호선2~3단계,삼전,6599,6310,12909
20210602,9호선2~3단계,종합운동장,4163,4214,8377
20210602,9호선2~3단계,봉은사,15114,15327,30441
20210602,9호선2~3단계,삼성중앙,6973,7296,14269
20210602,9호선2~3단계,선정릉,9726,10578,20304
20210602,9호선2~3단계,언주,9947,10256,20203
20210602,9호선2~3단계,석촌고분,5836,5802,11638
20210603,9호선2~3단계,송파나루,4574,4892,9466
20210603,9호선2~3단계,둔촌오륜,1318,1084,2402
20210603,9호선2~3단계,올림픽공원,6113,6194,12307
20210603,9호선2~3단계,한성백제,2415,2253,4668
20210603,9호선2~3단계,석촌,7601,6704,14305
20210603,9호선2~3단계,중앙보훈병원,10135,8894,19029
20210603,9호선2~3단계,석촌고분,5816,5993,11809
20210603,9호선2~3단계,언주,10432,10495,20927
20210603,9호선2~3단계,선정릉,9378,10304,19682
20210603,9호선2~3단계,삼전,6540,6627,13167
20210603,9호선2~3단계,봉은사,15765,15552,31317
20210603,9호선2~3단계,종합운동장,4185,3996,8181
20210603,9호선2~3단계,삼성중앙,7147,7374,14521
20210604,9호선2~3단계,둔촌오륜,1105,945,2050
20210604,9호선2~3단계,올림픽공원,6927,7178,14105
20210604,9호선2~3단계,한성백제,2724,2382,5106
20210604,9호선2~3단계,송파나루,4743,5129,9872
20210604,9호선2~3단계,석촌,8244,7316,15560
20210604,9호선2~3단계,석촌고분,6133,6005,12138
20210604,9호선2~3단계,중앙보훈병원,10264,9001,19265
20210604,9호선2~3단계,종합운동장,4468,4441,8909
20210604,9호선2~3단계,봉은사,15786,16012,31798
20210604,9호선2~3단계,삼성중앙,6994,7226,14220
20210604,9호선2~3단계,선정릉,9986,10867,20853
20210604,9호선2~3단계,언주,10237,10554,20791
20210604,9호선2~3단계,삼전,6986,6442,13428
20210605,9호선2~3단계,중앙보훈병원,4574,4289,8863
20210605,9호선2~3단계,둔촌오륜,840,796,1636
20210605,9호선2~3단계,올림픽공원,6741,6812,13553
20210605,9호선2~3단계,한성백제,1898,1571,3469
20210605,9호선2~3단계,송파나루,3757,4204,7961
20210605,9호선2~3단계,석촌,6360,5280,11640
20210605,9호선2~3단계,석촌고분,4004,3832,7836
20210605,9호선2~3단계,종합운동장,3300,2975,6275
20210605,9호선2~3단계,봉은사,10407,10940,21347
20210605,9호선2~3단계,삼성중앙,2941,2843,5784
20210605,9호선2~3단계,언주,5993,5930,11923
20210605,9호선2~3단계,삼전,4622,4273,8895
20210605,9호선2~3단계,선정릉,4744,5395,10139
20210606,9호선2~3단계,중앙보훈병원,3081,2984,6065
20210606,9호선2~3단계,석촌,4229,3673,7902
20210606,9호선2~3단계,둔촌오륜,391,451,842
20210606,9호선2~3단계,올림픽공원,5175,5111,10286
20210606,9호선2~3단계,한성백제,1471,1199,2670
20210606,9호선2~3단계,송파나루,2439,2848,5287
20210606,9호선2~3단계,삼전,3139,3142,6281
20210606,9호선2~3단계,종합운동장,2001,1805,3806
20210606,9호선2~3단계,봉은사,7443,7424,14867
20210606,9호선2~3단계,삼성중앙,1751,1843,3594
20210606,9호선2~3단계,선정릉,2977,3256,6233
20210606,9호선2~3단계,언주,3557,3572,7129
20210606,9호선2~3단계,석촌고분,2818,2813,5631
20210607,9호선2~3단계,선정릉,9502,10337,19839
20210607,9호선2~3단계,삼성중앙,6738,7096,13834
20210607,9호선2~3단계,봉은사,14506,14726,29232
20210607,9호선2~3단계,종합운동장,3941,4031,7972
20210607,9호선2~3단계,삼전,6399,6252,12651
20210607,9호선2~3단계,석촌고분,5693,5550,11243
20210607,9호선2~3단계,언주,9956,10277,20233
20210607,9호선2~3단계,송파나루,4272,4592,8864
20210607,9호선2~3단계,한성백제,2391,2176,4567
20210607,9호선2~3단계,올림픽공원,5579,5483,11062
20210607,9호선2~3단계,둔촌오륜,1153,1024,2177
20210607,9호선2~3단계,중앙보훈병원,10315,9106,19421
20210607,9호선2~3단계,석촌,7514,6820,14334
20210608,9호선2~3단계,중앙보훈병원,10516,9441,19957
20210608,9호선2~3단계,둔촌오륜,1221,1051,2272
20210608,9호선2~3단계,올림픽공원,5659,5813,11472
20210608,9호선2~3단계,한성백제,2470,2288,4758
20210608,9호선2~3단계,송파나루,4464,4779,9243
20210608,9호선2~3단계,석촌,7852,7122,14974
20210608,9호선2~3단계,석촌고분,6062,5913,11975
20210608,9호선2~3단계,종합운동장,4033,4083,8116
20210608,9호선2~3단계,봉은사,15145,15454,30599
20210608,9호선2~3단계,삼성중앙,6803,7227,14030
20210608,9호선2~3단계,선정릉,9782,10571,20353
20210608,9호선2~3단계,언주,10251,10313,20564
20210608,9호선2~3단계,삼전,6572,6313,12885
20210609,9호선2~3단계,중앙보훈병원,10526,9368,19894
20210609,9호선2~3단계,둔촌오륜,1264,1065,2329
20210609,9호선2~3단계,올림픽공원,5762,5758,11520
20210609,9호선2~3단계,한성백제,2510,2267,4777
20210609,9호선2~3단계,송파나루,4554,4901,9455
20210609,9호선2~3단계,석촌,7911,7193,15104
20210609,9호선2~3단계,석촌고분,5985,5958,11943
20210609,9호선2~3단계,종합운동장,4065,4058,8123
20210609,9호선2~3단계,봉은사,16658,16916,33574
20210609,9호선2~3단계,삼성중앙,6849,7281,14130
20210609,9호선2~3단계,선정릉,9630,10453,20083
20210609,9호선2~3단계,언주,10198,10330,20528
20210609,9호선2~3단계,삼전,6569,6402,12971
20210610,9호선2~3단계,언주,10243,10498,20741
20210610,9호선2~3단계,선정릉,9524,10387,19911
20210610,9호선2~3단계,삼성중앙,6973,7282,14255
20210610,9호선2~3단계,봉은사,17155,17186,34341
20210610,9호선2~3단계,종합운동장,4117,4043,8160
20210610,9호선2~3단계,삼전,6664,6715,13379
20210610,9호선2~3단계,석촌고분,6147,6214,12361
20210610,9호선2~3단계,석촌,7866,6984,14850
20210610,9호선2~3단계,송파나루,4934,5181,10115
20210610,9호선2~3단계,한성백제,2481,2372,4853
20210610,9호선2~3단계,올림픽공원,5657,5520,11177
20210610,9호선2~3단계,둔촌오륜,1238,1084,2322
20210610,9호선2~3단계,중앙보훈병원,10331,9210,19541
20210611,9호선2~3단계,선정릉,9597,10347,19944
20210611,9호선2~3단계,삼성중앙,6725,6970,13695
20210611,9호선2~3단계,봉은사,16940,17356,34296
20210611,9호선2~3단계,종합운동장,4192,4188,8380
20210611,9호선2~3단계,삼전,6634,6385,13019
20210611,9호선2~3단계,석촌고분,5914,5725,11639
20210611,9호선2~3단계,언주,9703,9916,19619
20210611,9호선2~3단계,송파나루,4532,5002,9534
20210611,9호선2~3단계,한성백제,2462,2183,4645
20210611,9호선2~3단계,올림픽공원,5673,5579,11252
20210611,9호선2~3단계,둔촌오륜,1208,997,2205
20210611,9호선2~3단계,중앙보훈병원,10182,8888,19070
20210611,9호선2~3단계,석촌,8060,7105,15165
20210612,9호선2~3단계,둔촌오륜,593,575,1168
20210612,9호선2~3단계,올림픽공원,4130,4174,8304
20210612,9호선2~3단계,한성백제,1741,1442,3183
20210612,9호선2~3단계,송파나루,3673,4130,7803
20210612,9호선2~3단계,석촌,5918,4913,10831
20210612,9호선2~3단계,석촌고분,3998,3847,7845
20210612,9호선2~3단계,중앙보훈병원,4208,3954,8162
20210612,9호선2~3단계,종합운동장,3091,2788,5879
20210612,9호선2~3단계,봉은사,10590,11184,21774
20210612,9호선2~3단계,삼성중앙,2852,2807,5659
20210612,9호선2~3단계,선정릉,4666,5246,9912
20210612,9호선2~3단계,언주,5722,5870,11592
20210612,9호선2~3단계,삼전,4662,4285,8947
20210613,9호선2~3단계,중앙보훈병원,2996,2979,5975
20210613,9호선2~3단계,둔촌오륜,418,476,894
20210613,9호선2~3단계,올림픽공원,3009,3058,6067
20210613,9호선2~3단계,한성백제,1372,1201,2573
20210613,9호선2~3단계,송파나루,2674,2992,5666
20210613,9호선2~3단계,석촌,4066,3721,7787
20210613,9호선2~3단계,석촌고분,2734,2796,5530
20210613,9호선2~3단계,종합운동장,2015,1789,3804
20210613,9호선2~3단계,봉은사,7138,7356,14494
20210613,9호선2~3단계,삼성중앙,1778,1946,3724
20210613,9호선2~3단계,선정릉,2723,3107,5830
20210613,9호선2~3단계,언주,3483,3569,7052
20210613,9호선2~3단계,삼전,3205,3087,6292
20210614,9호선2~3단계,삼전,6527,6341,12868
20210614,9호선2~3단계,선정릉,9521,10227,19748
20210614,9호선2~3단계,삼성중앙,6682,7150,13832
20210614,9호선2~3단계,봉은사,14664,14666,29330
20210614,9호선2~3단계,종합운동장,3908,4001,7909
20210614,9호선2~3단계,석촌고분,5779,5681,11460
20210614,9호선2~3단계,언주,10046,10469,20515
20210614,9호선2~3단계,송파나루,4442,4758,9200
20210614,9호선2~3단계,중앙보훈병원,10476,9279,19755
20210614,9호선2~3단계,둔촌오륜,1250,1113,2363
20210614,9호선2~3단계,석촌,7796,7004,14800
20210614,9호선2~3단계,한성백제,2359,2195,4554
20210614,9호선2~3단계,올림픽공원,5505,5521,11026
20210615,9호선2~3단계,선정릉,9614,10422,20036
20210615,9호선2~3단계,삼성중앙,6778,7029,13807
20210615,9호선2~3단계,봉은사,15228,15609,30837
20210615,9호선2~3단계,종합운동장,4032,4127,8159
20210615,9호선2~3단계,삼전,6561,6321,12882
20210615,9호선2~3단계,석촌고분,5794,5822,11616
20210615,9호선2~3단계,언주,10056,10332,20388
20210615,9호선2~3단계,송파나루,4430,4843,9273
20210615,9호선2~3단계,한성백제,2301,2193,4494
20210615,9호선2~3단계,올림픽공원,5386,5327,10713
20210615,9호선2~3단계,둔촌오륜,1264,1058,2322
20210615,9호선2~3단계,중앙보훈병원,10344,9246,19590
20210615,9호선2~3단계,석촌,7769,7100,14869
20210616,9호선2~3단계,언주,10195,10553,20748
20210616,9호선2~3단계,선정릉,9799,10612,20411
20210616,9호선2~3단계,삼성중앙,6772,7214,13986
20210616,9호선2~3단계,봉은사,16033,16426,32459
20210616,9호선2~3단계,종합운동장,4101,4217,8318
20210616,9호선2~3단계,삼전,6699,6603,13302
20210616,9호선2~3단계,석촌고분,5842,5890,11732
20210616,9호선2~3단계,송파나루,4650,5143,9793
20210616,9호선2~3단계,한성백제,2463,2270,4733
20210616,9호선2~3단계,올림픽공원,5715,5660,11375
20210616,9호선2~3단계,중앙보훈병원,10593,9354,19947
20210616,9호선2~3단계,석촌,8052,7182,15234
20210616,9호선2~3단계,둔촌오륜,1280,1104,2384
20210617,9호선2~3단계,중앙보훈병원,10527,9397,19924
20210617,9호선2~3단계,석촌,8056,7253,15309
20210617,9호선2~3단계,둔촌오륜,1250,1077,2327
20210617,9호선2~3단계,올림픽공원,5826,5849,11675
20210617,9호선2~3단계,한성백제,2434,2207,4641
20210617,9호선2~3단계,송파나루,4655,5018,9673
20210617,9호선2~3단계,석촌고분,5861,5880,11741
20210617,9호선2~3단계,종합운동장,4123,4133,8256
20210617,9호선2~3단계,봉은사,16990,17313,34303
20210617,9호선2~3단계,삼성중앙,6875,7231,14106
20210617,9호선2~3단계,선정릉,9854,10624,20478
20210617,9호선2~3단계,언주,10208,10491,20699
20210617,9호선2~3단계,삼전,6572,6435,13007
20210618,9호선2~3단계,둔촌오륜,1249,1043,2292
20210618,9호선2~3단계,올림픽공원,6623,6492,13115
20210618,9호선2~3단계,한성백제,2484,2284,4768
20210618,9호선2~3단계,송파나루,4798,5200,9998
20210618,9호선2~3단계,석촌,8071,7412,15483
20210618,9호선2~3단계,석촌고분,6028,5828,11856
20210618,9호선2~3단계,중앙보훈병원,10152,8807,18959
20210618,9호선2~3단계,종합운동장,4217,4168,8385
20210618,9호선2~3단계,봉은사,16785,17143,33928
20210618,9호선2~3단계,삼성중앙,6687,7061,13748
20210618,9호선2~3단계,선정릉,9775,10567,20342
20210618,9호선2~3단계,언주,10048,10408,20456
20210618,9호선2~3단계,삼전,6713,6366,13079
20210619,9호선2~3단계,중앙보훈병원,4429,4109,8538
20210619,9호선2~3단계,둔촌오륜,647,624,1271
20210619,9호선2~3단계,올림픽공원,5335,5370,10705
20210619,9호선2~3단계,한성백제,1806,1605,3411
20210619,9호선2~3단계,송파나루,3801,4226,8027
20210619,9호선2~3단계,석촌,6299,5276,11575
20210619,9호선2~3단계,석촌고분,4093,3893,7986
20210619,9호선2~3단계,종합운동장,3087,2841,5928
20210619,9호선2~3단계,봉은사,10519,11101,21620
20210619,9호선2~3단계,삼성중앙,2946,2967,5913
20210619,9호선2~3단계,선정릉,4985,5515,10500
20210619,9호선2~3단계,언주,5893,5847,11740
20210619,9호선2~3단계,삼전,4649,4249,8898
20210620,9호선2~3단계,삼전,3418,3288,6706
20210620,9호선2~3단계,선정릉,2993,3326,6319
20210620,9호선2~3단계,삼성중앙,1674,1824,3498
20210620,9호선2~3단계,봉은사,6724,6841,13565
20210620,9호선2~3단계,종합운동장,2101,1914,4015
20210620,9호선2~3단계,석촌고분,2755,2783,5538
20210620,9호선2~3단계,언주,3383,3324,6707
20210620,9호선2~3단계,송파나루,2623,2963,5586
20210620,9호선2~3단계,중앙보훈병원,3072,3063,6135
20210620,9호선2~3단계,둔촌오륜,429,494,923
20210620,9호선2~3단계,석촌,4313,3766,8079
20210620,9호선2~3단계,한성백제,1415,1291,2706
20210620,9호선2~3단계,올림픽공원,4090,4242,8332
20210621,9호선2~3단계,중앙보훈병원,10654,9560,20214
20210621,9호선2~3단계,둔촌오륜,1235,1052,2287
20210621,9호선2~3단계,올림픽공원,5832,5847,11679
20210621,9호선2~3단계,한성백제,2458,2351,4809
20210621,9호선2~3단계,석촌,7848,7170,15018
20210621,9호선2~3단계,석촌고분,5773,5723,11496
20210621,9호선2~3단계,송파나루,4621,4910,9531
20210621,9호선2~3단계,종합운동장,4143,4292,8435
20210621,9호선2~3단계,봉은사,15253,15589,30842
20210621,9호선2~3단계,삼성중앙,6993,7309,14302
20210621,9호선2~3단계,선정릉,9651,10575,20226
20210621,9호선2~3단계,언주,10175,10569,20744
20210621,9호선2~3단계,삼전,6761,6412,13173
20210622,9호선2~3단계,송파나루,4712,5102,9814
20210622,9호선2~3단계,둔촌오륜,1256,1070,2326
20210622,9호선2~3단계,중앙보훈병원,10696,9689,20385
20210622,9호선2~3단계,올림픽공원,5940,5833,11773
20210622,9호선2~3단계,한성백제,2614,2367,4981
20210622,9호선2~3단계,석촌,8100,7420,15520
20210622,9호선2~3단계,선정릉,10070,10945,21015
20210622,9호선2~3단계,삼전,6738,6543,13281
20210622,9호선2~3단계,종합운동장,4244,4311,8555
20210622,9호선2~3단계,봉은사,16123,16507,32630
20210622,9호선2~3단계,삼성중앙,6960,7455,14415
20210622,9호선2~3단계,언주,10512,10752,21264
20210622,9호선2~3단계,석촌고분,6027,6041,12068
20210623,9호선2~3단계,중앙보훈병원,10530,9352,19882
20210623,9호선2~3단계,둔촌오륜,1245,1089,2334
20210623,9호선2~3단계,올림픽공원,5876,5873,11749
20210623,9호선2~3단계,한성백제,2637,2439,5076
20210623,9호선2~3단계,석촌,8149,7333,15482
20210623,9호선2~3단계,송파나루,4676,5171,9847
20210623,9호선2~3단계,석촌고분,6140,6165,12305
20210623,9호선2~3단계,종합운동장,4315,4148,8463
20210623,9호선2~3단계,봉은사,16735,17058,33793
20210623,9호선2~3단계,삼성중앙,6979,7372,14351
20210623,9호선2~3단계,선정릉,10015,10837,20852
20210623,9호선2~3단계,언주,10548,10664,21212
20210623,9호선2~3단계,삼전,6836,6600,13436
20210624,9호선2~3단계,둔촌오륜,1260,1114,2374
20210624,9호선2~3단계,올림픽공원,5927,5943,11870
20210624,9호선2~3단계,한성백제,2564,2341,4905
20210624,9호선2~3단계,송파나루,4869,5278,10147
20210624,9호선2~3단계,석촌,8179,7320,15499
20210624,9호선2~3단계,석촌고분,6063,6031,12094
20210624,9호선2~3단계,중앙보훈병원,10785,9568,20353
20210624,9호선2~3단계,종합운동장,4375,4400,8775
20210624,9호선2~3단계,봉은사,17242,17531,34773
20210624,9호선2~3단계,삼성중앙,7035,7457,14492
20210624,9호선2~3단계,선정릉,9915,10973,20888
20210624,9호선2~3단계,언주,10517,10776,21293
20210624,9호선2~3단계,삼전,6782,6575,13357
20210625,9호선2~3단계,언주,10728,10805,21533
20210625,9호선2~3단계,선정릉,10131,10945,21076
20210625,9호선2~3단계,삼성중앙,7047,7465,14512
20210625,9호선2~3단계,봉은사,17177,17701,34878
20210625,9호선2~3단계,종합운동장,4443,4572,9015
20210625,9호선2~3단계,삼전,6954,6671,13625
20210625,9호선2~3단계,석촌고분,6152,6056,12208
20210625,9호선2~3단계,송파나루,4989,5563,10552
20210625,9호선2~3단계,한성백제,2682,2490,5172
20210625,9호선2~3단계,올림픽공원,6061,6165,12226
20210625,9호선2~3단계,둔촌오륜,1361,1135,2496
20210625,9호선2~3단계,중앙보훈병원,10422,9051,19473
20210625,9호선2~3단계,석촌,8603,7514,16117
20210626,9호선2~3단계,중앙보훈병원,4181,3871,8052
20210626,9호선2~3단계,둔촌오륜,593,599,1192
20210626,9호선2~3단계,올림픽공원,7228,6848,14076
20210626,9호선2~3단계,한성백제,1815,1599,3414
20210626,9호선2~3단계,송파나루,3707,4313,8020
20210626,9호선2~3단계,석촌,6240,5193,11433
20210626,9호선2~3단계,석촌고분,4043,3818,7861
20210626,9호선2~3단계,종합운동장,3330,2929,6259
20210626,9호선2~3단계,언주,5633,5738,11371
20210626,9호선2~3단계,선정릉,4473,5051,9524
20210626,9호선2~3단계,삼전,4583,4286,8869
20210626,9호선2~3단계,봉은사,10083,10417,20500
20210626,9호선2~3단계,삼성중앙,2936,3002,5938
20210627,9호선2~3단계,둔촌오륜,480,523,1003
20210627,9호선2~3단계,올림픽공원,6384,5949,12333
20210627,9호선2~3단계,한성백제,1525,1426,2951
20210627,9호선2~3단계,송파나루,2980,3317,6297
20210627,9호선2~3단계,석촌,4404,3878,8282
20210627,9호선2~3단계,석촌고분,2785,2842,5627
20210627,9호선2~3단계,중앙보훈병원,3274,3146,6420
20210627,9호선2~3단계,종합운동장,2066,2061,4127
20210627,9호선2~3단계,봉은사,7493,7543,15036
20210627,9호선2~3단계,삼성중앙,1869,1916,3785
20210627,9호선2~3단계,선정릉,3053,3391,6444
20210627,9호선2~3단계,언주,3336,3348,6684
20210627,9호선2~3단계,삼전,3363,3399,6762
20210628,9호선2~3단계,언주,10233,10566,20799
20210628,9호선2~3단계,선정릉,9881,10654,20535
20210628,9호선2~3단계,삼성중앙,6696,7161,13857
20210628,9호선2~3단계,봉은사,16112,16454,32566
20210628,9호선2~3단계,종합운동장,4019,4178,8197
20210628,9호선2~3단계,삼전,6716,6520,13236
20210628,9호선2~3단계,석촌고분,5749,5842,11591
20210628,9호선2~3단계,송파나루,4609,4981,9590
20210628,9호선2~3단계,한성백제,2490,2267,4757
20210628,9호선2~3단계,올림픽공원,5599,5614,11213
20210628,9호선2~3단계,중앙보훈병원,10670,9390,20060
20210628,9호선2~3단계,석촌,7882,7087,14969
20210628,9호선2~3단계,둔촌오륜,1361,1182,2543
20210629,9호선2~3단계,언주,10488,10815,21303
20210629,9호선2~3단계,삼전,6736,6567,13303
20210629,9호선2~3단계,선정릉,9882,10865,20747
20210629,9호선2~3단계,삼성중앙,6777,7178,13955
20210629,9호선2~3단계,봉은사,16684,17171,33855
20210629,9호선2~3단계,종합운동장,4311,4253,8564
20210629,9호선2~3단계,석촌고분,6178,6131,12309
20210629,9호선2~3단계,송파나루,4710,5268,9978
20210629,9호선2~3단계,한성백제,2537,2342,4879
20210629,9호선2~3단계,올림픽공원,5828,5776,11604
20210629,9호선2~3단계,둔촌오륜,1402,1158,2560
20210629,9호선2~3단계,중앙보훈병원,10843,9616,20459
20210629,9호선2~3단계,석촌,8070,7331,15401
20210630,9호선2~3단계,선정릉,9839,10659,20498
20210630,9호선2~3단계,삼성중앙,6657,7054,13711
20210630,9호선2~3단계,봉은사,16031,16165,32196
20210630,9호선2~3단계,종합운동장,4309,4346,8655
20210630,9호선2~3단계,삼전,6650,6554,13204
20210630,9호선2~3단계,석촌고분,6113,6025,12138
20210630,9호선2~3단계,언주,10447,10713,21160
20210630,9호선2~3단계,송파나루,4793,5238,10031
20210630,9호선2~3단계,한성백제,2563,2378,4941
20210630,9호선2~3단계,올림픽공원,5771,5706,11477
20210630,9호선2~3단계,둔촌오륜,1397,1237,2634
20210630,9호선2~3단계,중앙보훈병원,10824,9735,20559
20210630,9호선2~3단계,석촌,8082,7332,15414
20210701,9호선2~3단계,언주,10461,10722,21183
20210701,9호선2~3단계,선정릉,9854,10881,20735
20210701,9호선2~3단계,삼성중앙,6907,7200,14107
20210701,9호선2~3단계,봉은사,16543,16826,33369
20210701,9호선2~3단계,종합운동장,4351,4368,8719
20210701,9호선2~3단계,삼전,6802,6553,13355
20210701,9호선2~3단계,석촌고분,6300,6227,12527
20210701,9호선2~3단계,송파나루,4968,5444,10412
20210701,9호선2~3단계,한성백제,2659,2500,5159
20210701,9호선2~3단계,올림픽공원,5788,5833,11621
20210701,9호선2~3단계,둔촌오륜,1336,1183,2519
20210701,9호선2~3단계,중앙보훈병원,10599,9489,20088
20210701,9호선2~3단계,석촌,8280,7230,15510
20210702,9호선2~3단계,종합운동장,4447,4578,9025
20210702,9호선2~3단계,언주,10599,10665,21264
20210702,9호선2~3단계,선정릉,10190,11072,21262
20210702,9호선2~3단계,삼성중앙,6825,7121,13946
20210702,9호선2~3단계,봉은사,18160,18674,36834
20210702,9호선2~3단계,삼전,7039,6784,13823
20210702,9호선2~3단계,석촌고분,6270,6051,12321
20210702,9호선2~3단계,석촌,8609,7451,16060
20210702,9호선2~3단계,송파나루,4967,5617,10584
20210702,9호선2~3단계,한성백제,2674,2470,5144
20210702,9호선2~3단계,올림픽공원,8849,8911,17760
20210702,9호선2~3단계,둔촌오륜,1326,1197,2523
20210702,9호선2~3단계,중앙보훈병원,10553,9125,19678
20210703,9호선2~3단계,언주,5962,5937,11899
20210703,9호선2~3단계,선정릉,4724,5437,10161
20210703,9호선2~3단계,삼성중앙,2981,3064,6045
20210703,9호선2~3단계,봉은사,12877,13542,26419
20210703,9호선2~3단계,종합운동장,3279,2813,6092
20210703,9호선2~3단계,삼전,4620,4388,9008
20210703,9호선2~3단계,석촌고분,3814,3849,7663
20210703,9호선2~3단계,석촌,5643,4748,10391
20210703,9호선2~3단계,송파나루,3968,4284,8252
20210703,9호선2~3단계,한성백제,1681,1543,3224
20210703,9호선2~3단계,올림픽공원,8847,8652,17499
20210703,9호선2~3단계,둔촌오륜,557,602,1159
20210703,9호선2~3단계,중앙보훈병원,4075,3786,7861
20210704,9호선2~3단계,둔촌오륜,387,388,775
20210704,9호선2~3단계,올림픽공원,6872,7096,13968
20210704,9호선2~3단계,한성백제,1195,1100,2295
20210704,9호선2~3단계,송파나루,2431,2667,5098
20210704,9호선2~3단계,석촌,3851,3348,7199
20210704,9호선2~3단계,석촌고분,2550,2644,5194
20210704,9호선2~3단계,중앙보훈병원,2897,2755,5652
20210704,9호선2~3단계,종합운동장,2068,1776,3844
20210704,9호선2~3단계,봉은사,7741,8030,15771
20210704,9호선2~3단계,삼성중앙,1722,1749,3471
20210704,9호선2~3단계,선정릉,2744,2969,5713
20210704,9호선2~3단계,언주,3232,3166,6398
20210704,9호선2~3단계,삼전,2988,2944,5932
20210705,9호선2~3단계,선정릉,9557,10706,20263
20210705,9호선2~3단계,삼성중앙,6739,7173,13912
20210705,9호선2~3단계,봉은사,16081,16275,32356
20210705,9호선2~3단계,종합운동장,4219,4206,8425
20210705,9호선2~3단계,삼전,6736,6569,13305
20210705,9호선2~3단계,석촌고분,5955,5857,11812
20210705,9호선2~3단계,언주,10390,10798,21188
20210705,9호선2~3단계,송파나루,4533,4982,9515
20210705,9호선2~3단계,한성백제,2485,2381,4866
20210705,9호선2~3단계,올림픽공원,5859,5843,11702
20210705,9호선2~3단계,둔촌오륜,1310,1186,2496
20210705,9호선2~3단계,중앙보훈병원,10847,9661,20508
20210705,9호선2~3단계,석촌,7990,7153,15143
20210706,9호선2~3단계,언주,10509,10810,21319
20210706,9호선2~3단계,선정릉,10081,10838,20919
20210706,9호선2~3단계,삼성중앙,6774,7256,14030
20210706,9호선2~3단계,봉은사,16239,16580,32819
20210706,9호선2~3단계,종합운동장,4278,4291,8569
20210706,9호선2~3단계,삼전,6829,6557,13386
20210706,9호선2~3단계,석촌고분,6188,6138,12326
20210706,9호선2~3단계,송파나루,4835,5229,10064
20210706,9호선2~3단계,한성백제,2626,2449,5075
20210706,9호선2~3단계,올림픽공원,5974,5996,11970
20210706,9호선2~3단계,둔촌오륜,1321,1172,2493
20210706,9호선2~3단계,중앙보훈병원,10944,9852,20796
20210706,9호선2~3단계,석촌,8151,7407,15558
20210707,9호선2~3단계,석촌,7814,7024,14838
20210707,9호선2~3단계,둔촌오륜,1287,1204,2491
20210707,9호선2~3단계,올림픽공원,5639,5469,11108
20210707,9호선2~3단계,한성백제,2576,2386,4962
20210707,9호선2~3단계,송파나루,4674,5006,9680
20210707,9호선2~3단계,석촌고분,5976,5919,11895
20210707,9호선2~3단계,중앙보훈병원,10539,9431,19970
20210707,9호선2~3단계,종합운동장,4024,4087,8111
20210707,9호선2~3단계,언주,10352,10534,20886
20210707,9호선2~3단계,선정릉,9698,10411,20109
20210707,9호선2~3단계,삼전,6624,6486,13110
20210707,9호선2~3단계,봉은사,14475,14814,29289
20210707,9호선2~3단계,삼성중앙,6575,6912,13487
20210708,9호선2~3단계,둔촌오륜,1254,1155,2409
20210708,9호선2~3단계,올림픽공원,5393,5349,10742
20210708,9호선2~3단계,한성백제,2417,2245,4662
20210708,9호선2~3단계,송파나루,4567,4788,9355
20210708,9호선2~3단계,석촌,7590,6792,14382
20210708,9호선2~3단계,석촌고분,5831,5788,11619
20210708,9호선2~3단계,중앙보훈병원,10107,9099,19206
20210708,9호선2~3단계,종합운동장,3927,3916,7843
20210708,9호선2~3단계,봉은사,14358,14778,29136
20210708,9호선2~3단계,삼성중앙,6306,6609,12915
20210708,9호선2~3단계,선정릉,9226,9925,19151
20210708,9호선2~3단계,언주,10047,10388,20435
20210708,9호선2~3단계,삼전,6532,6226,12758
20210709,9호선2~3단계,중앙보훈병원,9848,8771,18619
20210709,9호선2~3단계,둔촌오륜,1225,1083,2308
20210709,9호선2~3단계,올림픽공원,5500,5226,10726
20210709,9호선2~3단계,한성백제,2412,2292,4704
20210709,9호선2~3단계,송파나루,4611,4979,9590
20210709,9호선2~3단계,석촌,7609,6756,14365
20210709,9호선2~3단계,석촌고분,5947,5809,11756
20210709,9호선2~3단계,종합운동장,3882,3885,7767
20210709,9호선2~3단계,봉은사,14141,14152,28293
20210709,9호선2~3단계,삼성중앙,6434,6659,13093
20210709,9호선2~3단계,언주,9995,10208,20203
20210709,9호선2~3단계,삼전,6462,6253,12715
20210709,9호선2~3단계,선정릉,9180,9955,19135
20210710,9호선2~3단계,중앙보훈병원,3716,3369,7085
20210710,9호선2~3단계,석촌,5058,4131,9189
20210710,9호선2~3단계,둔촌오륜,606,586,1192
20210710,9호선2~3단계,올림픽공원,3491,3499,6990
20210710,9호선2~3단계,한성백제,1430,1263,2693
20210710,9호선2~3단계,송파나루,3096,3281,6377
20210710,9호선2~3단계,석촌고분,3400,3219,6619
20210710,9호선2~3단계,종합운동장,2632,2361,4993
20210710,9호선2~3단계,봉은사,7656,7627,15283
20210710,9호선2~3단계,삼성중앙,2390,2414,4804
20210710,9호선2~3단계,선정릉,3630,3938,7568
20210710,9호선2~3단계,언주,4722,4643,9365
20210710,9호선2~3단계,삼전,3977,3771,7748
20210711,9호선2~3단계,둔촌오륜,338,384,722
20210711,9호선2~3단계,올림픽공원,2149,2208,4357
20210711,9호선2~3단계,한성백제,998,907,1905
20210711,9호선2~3단계,송파나루,2150,2328,4478
20210711,9호선2~3단계,석촌,3413,2937,6350
20210711,9호선2~3단계,석촌고분,2349,2397,4746
20210711,9호선2~3단계,중앙보훈병원,2426,2370,4796
20210711,9호선2~3단계,종합운동장,1697,1563,3260
20210711,9호선2~3단계,봉은사,4635,4541,9176
20210711,9호선2~3단계,삼성중앙,1417,1444,2861
20210711,9호선2~3단계,선정릉,2242,2571,4813
20210711,9호선2~3단계,언주,2677,2750,5427
20210711,9호선2~3단계,삼전,2718,2788,5506
20210712,9호선2~3단계,중앙보훈병원,9547,8482,18029
20210712,9호선2~3단계,둔촌오륜,1168,983,2151
20210712,9호선2~3단계,올림픽공원,4940,4811,9751
20210712,9호선2~3단계,한성백제,2195,2076,4271
20210712,9호선2~3단계,송파나루,3982,4342,8324
20210712,9호선2~3단계,석촌,6863,6271,13134
20210712,9호선2~3단계,석촌고분,5255,5241,10496
20210712,9호선2~3단계,종합운동장,3519,3600,7119
20210712,9호선2~3단계,봉은사,12037,12046,24083
20210712,9호선2~3단계,삼성중앙,5893,6171,12064
20210712,9호선2~3단계,선정릉,8500,9141,17641
20210712,9호선2~3단계,언주,9441,9688,19129
20210712,9호선2~3단계,삼전,5955,5904,11859
20210713,9호선2~3단계,종합운동장,3381,3487,6868
20210713,9호선2~3단계,언주,9345,9548,18893
20210713,9호선2~3단계,선정릉,8596,9023,17619
20210713,9호선2~3단계,삼성중앙,5734,6022,11756
20210713,9호선2~3단계,봉은사,12144,12250,24394
20210713,9호선2~3단계,삼전,6096,5938,12034
20210713,9호선2~3단계,석촌고분,5235,5367,10602
20210713,9호선2~3단계,석촌,6974,6202,13176
20210713,9호선2~3단계,송파나루,3981,4332,8313
20210713,9호선2~3단계,한성백제,2204,2044,4248
20210713,9호선2~3단계,올림픽공원,4863,4720,9583
20210713,9호선2~3단계,둔촌오륜,1169,1023,2192
20210713,9호선2~3단계,중앙보훈병원,9463,8582,18045
20210714,9호선2~3단계,언주,9284,9459,18743
20210714,9호선2~3단계,선정릉,8386,8823,17209
20210714,9호선2~3단계,삼성중앙,5714,5917,11631
20210714,9호선2~3단계,봉은사,13003,12984,25987
20210714,9호선2~3단계,종합운동장,3563,3668,7231
20210714,9호선2~3단계,삼전,5975,5851,11826
20210714,9호선2~3단계,석촌고분,5333,5398,10731
20210714,9호선2~3단계,석촌,6963,6340,13303
20210714,9호선2~3단계,송파나루,4102,4376,8478
20210714,9호선2~3단계,한성백제,2228,2096,4324
20210714,9호선2~3단계,올림픽공원,4834,4721,9555
20210714,9호선2~3단계,둔촌오륜,977,905,1882
20210714,9호선2~3단계,중앙보훈병원,9390,8297,17687
20210715,9호선2~3단계,선정릉,8200,8803,17003
20210715,9호선2~3단계,삼성중앙,5689,5944,11633
20210715,9호선2~3단계,봉은사,12636,12753,25389
20210715,9호선2~3단계,종합운동장,3449,3525,6974
20210715,9호선2~3단계,삼전,5903,5787,11690
20210715,9호선2~3단계,석촌고분,5275,5335,10610
20210715,9호선2~3단계,언주,9226,9389,18615
20210715,9호선2~3단계,송파나루,4057,4305,8362
20210715,9호선2~3단계,한성백제,2145,1999,4144
20210715,9호선2~3단계,올림픽공원,4647,4564,9211
20210715,9호선2~3단계,둔촌오륜,927,833,1760
20210715,9호선2~3단계,중앙보훈병원,9263,8234,17497
20210715,9호선2~3단계,석촌,6885,6039,12924
20210716,9호선2~3단계,둔촌오륜,963,861,1824
20210716,9호선2~3단계,중앙보훈병원,8817,7952,16769
20210716,9호선2~3단계,언주,9280,9194,18474
20210716,9호선2~3단계,선정릉,8325,8776,17101
20210716,9호선2~3단계,삼성중앙,5574,5817,11391
20210716,9호선2~3단계,봉은사,12535,12539,25074
20210716,9호선2~3단계,한성백제,2221,2031,4252
20210716,9호선2~3단계,삼전,6084,5903,11987
20210716,9호선2~3단계,석촌고분,5323,5332,10655
20210716,9호선2~3단계,석촌,6825,5997,12822
20210716,9호선2~3단계,송파나루,4256,4567,8823
20210716,9호선2~3단계,올림픽공원,4807,4660,9467
20210716,9호선2~3단계,종합운동장,3574,3606,7180
20210717,9호선2~3단계,언주,4124,3982,8106
20210717,9호선2~3단계,선정릉,3311,3526,6837
20210717,9호선2~3단계,삼성중앙,2350,2335,4685
20210717,9호선2~3단계,봉은사,6202,6387,12589
20210717,9호선2~3단계,종합운동장,2554,2313,4867
20210717,9호선2~3단계,삼전,3788,3556,7344
20210717,9호선2~3단계,석촌고분,3261,3065,6326
20210717,9호선2~3단계,송파나루,2944,3112,6056
20210717,9호선2~3단계,한성백제,1340,1216,2556
20210717,9호선2~3단계,올림픽공원,3180,3156,6336
20210717,9호선2~3단계,둔촌오륜,475,480,955
20210717,9호선2~3단계,중앙보훈병원,3201,3039,6240
20210717,9호선2~3단계,석촌,4673,4014,8687
20210718,9호선2~3단계,삼전,2559,2575,5134
20210718,9호선2~3단계,선정릉,2232,2405,4637
20210718,9호선2~3단계,삼성중앙,1463,1502,2965
20210718,9호선2~3단계,봉은사,4340,4514,8854
20210718,9호선2~3단계,종합운동장,1591,1504,3095
20210718,9호선2~3단계,석촌고분,2192,2284,4476
20210718,9호선2~3단계,언주,2357,2476,4833
20210718,9호선2~3단계,송파나루,2139,2457,4596
20210718,9호선2~3단계,중앙보훈병원,2324,2258,4582
20210718,9호선2~3단계,둔촌오륜,284,298,582
20210718,9호선2~3단계,석촌,3214,2780,5994
20210718,9호선2~3단계,한성백제,1007,894,1901
20210718,9호선2~3단계,올림픽공원,1989,2057,4046
20210719,9호선2~3단계,둔촌오륜,891,838,1729
20210719,9호선2~3단계,올림픽공원,4603,4572,9175
20210719,9호선2~3단계,한성백제,2094,2028,4122
20210719,9호선2~3단계,송파나루,3922,4261,8183
20210719,9호선2~3단계,석촌,6816,6077,12893
20210719,9호선2~3단계,석촌고분,5214,5231,10445
20210719,9호선2~3단계,중앙보훈병원,9214,8169,17383
20210719,9호선2~3단계,종합운동장,3416,3552,6968
20210719,9호선2~3단계,봉은사,12184,12354,24538
20210719,9호선2~3단계,삼성중앙,5639,6037,11676
20210719,9호선2~3단계,선정릉,8312,8869,17181
20210719,9호선2~3단계,언주,9411,9571,18982
20210719,9호선2~3단계,삼전,5913,5711,11624
20210720,9호선2~3단계,중앙보훈병원,9565,8597,18162
20210720,9호선2~3단계,둔촌오륜,919,830,1749
20210720,9호선2~3단계,올림픽공원,4667,4709,9376
20210720,9호선2~3단계,한성백제,2192,2081,4273
20210720,9호선2~3단계,송파나루,4235,4521,8756
20210720,9호선2~3단계,석촌,6952,6303,13255
20210720,9호선2~3단계,석촌고분,5258,5343,10601
20210720,9호선2~3단계,종합운동장,3535,3668,7203
20210720,9호선2~3단계,봉은사,12611,12549,25160
20210720,9호선2~3단계,삼성중앙,5879,6020,11899
20210720,9호선2~3단계,언주,9382,9493,18875
20210720,9호선2~3단계,삼전,5961,5773,11734
20210720,9호선2~3단계,선정릉,8441,8954,17395
20210721,9호선2~3단계,중앙보훈병원,9202,8169,17371
20210721,9호선2~3단계,석촌,6773,6063,12836
20210721,9호선2~3단계,둔촌오륜,945,825,1770
20210721,9호선2~3단계,올림픽공원,4761,4563,9324
20210721,9호선2~3단계,한성백제,2190,2069,4259
20210721,9호선2~3단계,송파나루,4201,4482,8683
20210721,9호선2~3단계,석촌고분,5170,5262,10432
20210721,9호선2~3단계,종합운동장,3497,3658,7155
20210721,9호선2~3단계,봉은사,12784,12832,25616
20210721,9호선2~3단계,삼성중앙,5794,6075,11869
20210721,9호선2~3단계,선정릉,8361,8909,17270
20210721,9호선2~3단계,언주,9178,9221,18399
20210721,9호선2~3단계,삼전,5986,5767,11753
20210722,9호선2~3단계,선정릉,8334,8895,17229
20210722,9호선2~3단계,삼성중앙,5695,5894,11589
20210722,9호선2~3단계,봉은사,13019,13053,26072
20210722,9호선2~3단계,종합운동장,3522,3647,7169
20210722,9호선2~3단계,삼전,5876,5657,11533
20210722,9호선2~3단계,석촌고분,5286,5432,10718
20210722,9호선2~3단계,언주,9191,9343,18534
20210722,9호선2~3단계,송파나루,4158,4405,8563
20210722,9호선2~3단계,한성백제,2166,2036,4202
20210722,9호선2~3단계,올림픽공원,4656,4555,9211
20210722,9호선2~3단계,둔촌오륜,900,842,1742
20210722,9호선2~3단계,중앙보훈병원,9231,8281,17512
20210722,9호선2~3단계,석촌,6855,6046,12901
20210723,9호선2~3단계,중앙보훈병원,9102,8119,17221
20210723,9호선2~3단계,둔촌오륜,941,862,1803
20210723,9호선2~3단계,올림픽공원,4700,4665,9365
20210723,9호선2~3단계,한성백제,2242,2063,4305
20210723,9호선2~3단계,송파나루,4250,4674,8924
20210723,9호선2~3단계,석촌,7101,6240,13341
20210723,9호선2~3단계,석촌고분,5366,5360,10726
20210723,9호선2~3단계,종합운동장,3650,3762,7412
20210723,9호선2~3단계,봉은사,13224,13008,26232
20210723,9호선2~3단계,삼성중앙,5756,5878,11634
20210723,9호선2~3단계,선정릉,8335,8803,17138
20210723,9호선2~3단계,언주,9584,9372,18956
20210723,9호선2~3단계,삼전,6025,5842,11867
20210724,9호선2~3단계,석촌,4677,3916,8593
20210724,9호선2~3단계,둔촌오륜,483,496,979
20210724,9호선2~3단계,올림픽공원,2683,2731,5414
20210724,9호선2~3단계,한성백제,1281,1208,2489
20210724,9호선2~3단계,송파나루,2975,3283,6258
20210724,9호선2~3단계,석촌고분,3212,3167,6379
20210724,9호선2~3단계,중앙보훈병원,3392,3247,6639
20210724,9호선2~3단계,종합운동장,2322,2187,4509
20210724,9호선2~3단계,봉은사,6733,6887,13620
20210724,9호선2~3단계,삼성중앙,2312,2384,4696
20210724,9호선2~3단계,선정릉,3213,3512,6725
20210724,9호선2~3단계,언주,3994,3955,7949
20210724,9호선2~3단계,삼전,3812,3565,7377
20210725,9호선2~3단계,중앙보훈병원,2281,2306,4587
20210725,9호선2~3단계,둔촌오륜,322,347,669
20210725,9호선2~3단계,올림픽공원,2035,1925,3960
20210725,9호선2~3단계,한성백제,928,894,1822
20210725,9호선2~3단계,송파나루,2201,2345,4546
20210725,9호선2~3단계,석촌,3037,2645,5682
20210725,9호선2~3단계,석촌고분,2245,2255,4500
20210725,9호선2~3단계,삼전,2508,2660,5168
20210725,9호선2~3단계,종합운동장,1701,1484,3185
20210725,9호선2~3단계,봉은사,4710,4675,9385
20210725,9호선2~3단계,삼성중앙,1439,1513,2952
20210725,9호선2~3단계,선정릉,2023,2297,4320
20210725,9호선2~3단계,언주,2245,2383,4628
20210726,9호선2~3단계,선정릉,8329,8885,17214
20210726,9호선2~3단계,삼성중앙,5822,6160,11982
20210726,9호선2~3단계,봉은사,12856,12800,25656
20210726,9호선2~3단계,종합운동장,3467,3497,6964
20210726,9호선2~3단계,삼전,5907,5818,11725
20210726,9호선2~3단계,석촌고분,5173,5309,10482
20210726,9호선2~3단계,언주,9406,9493,18899
20210726,9호선2~3단계,송파나루,3918,4329,8247
20210726,9호선2~3단계,한성백제,2188,2073,4261
20210726,9호선2~3단계,올림픽공원,4581,4515,9096
20210726,9호선2~3단계,둔촌오륜,897,854,1751
20210726,9호선2~3단계,중앙보훈병원,9276,8379,17655
20210726,9호선2~3단계,석촌,6832,6076,12908
20210727,9호선2~3단계,선정릉,8285,8953,17238
20210727,9호선2~3단계,삼성중앙,5907,6037,11944
20210727,9호선2~3단계,봉은사,13062,13064,26126
20210727,9호선2~3단계,종합운동장,3518,3515,7033
20210727,9호선2~3단계,삼전,5908,5777,11685
20210727,9호선2~3단계,석촌고분,5244,5336,10580
20210727,9호선2~3단계,언주,9343,9382,18725
20210727,9호선2~3단계,송파나루,4078,4533,8611
20210727,9호선2~3단계,한성백제,2194,2091,4285
20210727,9호선2~3단계,올림픽공원,4741,4605,9346
20210727,9호선2~3단계,둔촌오륜,920,830,1750
20210727,9호선2~3단계,중앙보훈병원,9471,8392,17863
20210727,9호선2~3단계,석촌,6807,6150,12957
20210728,9호선2~3단계,중앙보훈병원,9237,8226,17463
20210728,9호선2~3단계,둔촌오륜,858,812,1670
20210728,9호선2~3단계,올림픽공원,4786,4641,9427
20210728,9호선2~3단계,한성백제,2196,2038,4234
20210728,9호선2~3단계,송파나루,4214,4600,8814
20210728,9호선2~3단계,석촌,6817,6133,12950
20210728,9호선2~3단계,석촌고분,5118,5214,10332
20210728,9호선2~3단계,종합운동장,3449,3529,6978
20210728,9호선2~3단계,봉은사,13161,13169,26330
20210728,9호선2~3단계,삼성중앙,5762,6138,11900
20210728,9호선2~3단계,선정릉,8312,8856,17168
20210728,9호선2~3단계,언주,9141,9375,18516
20210728,9호선2~3단계,삼전,5879,5795,11674
20210729,9호선2~3단계,석촌,6873,6092,12965
20210729,9호선2~3단계,둔촌오륜,877,841,1718
20210729,9호선2~3단계,올림픽공원,4498,4522,9020
20210729,9호선2~3단계,한성백제,2147,2007,4154
20210729,9호선2~3단계,송파나루,4123,4506,8629
20210729,9호선2~3단계,석촌고분,5329,5300,10629
20210729,9호선2~3단계,중앙보훈병원,8999,7999,16998
20210729,9호선2~3단계,종합운동장,3428,3555,6983
20210729,9호선2~3단계,언주,8962,9137,18099
20210729,9호선2~3단계,선정릉,8197,9024,17221
20210729,9호선2~3단계,삼전,5875,5707,11582
20210729,9호선2~3단계,봉은사,13246,13096,26342
20210729,9호선2~3단계,삼성중앙,5675,5891,11566
20210730,9호선2~3단계,선정릉,8228,8719,16947
20210730,9호선2~3단계,삼성중앙,5783,5851,11634
20210730,9호선2~3단계,봉은사,13106,13024,26130
20210730,9호선2~3단계,종합운동장,3514,3533,7047
20210730,9호선2~3단계,삼전,5901,5705,11606
20210730,9호선2~3단계,석촌고분,5391,5275,10666
20210730,9호선2~3단계,언주,9123,9208,18331
20210730,9호선2~3단계,송파나루,4272,4597,8869
20210730,9호선2~3단계,한성백제,2175,2022,4197
20210730,9호선2~3단계,올림픽공원,4724,4637,9361
20210730,9호선2~3단계,둔촌오륜,878,810,1688
20210730,9호선2~3단계,중앙보훈병원,9032,7921,16953
20210730,9호선2~3단계,석촌,6949,6117,13066
20210731,9호선2~3단계,언주,4007,3985,7992
20210731,9호선2~3단계,선정릉,3234,3530,6764
20210731,9호선2~3단계,삼성중앙,2240,2245,4485
20210731,9호선2~3단계,봉은사,6873,7053,13926
20210731,9호선2~3단계,종합운동장,2251,2149,4400
20210731,9호선2~3단계,삼전,3755,3515,7270
20210731,9호선2~3단계,석촌고분,3152,3148,6300
20210731,9호선2~3단계,송파나루,3002,3246,6248
20210731,9호선2~3단계,한성백제,1278,1099,2377
20210731,9호선2~3단계,올림픽공원,2637,2635,5272
20210731,9호선2~3단계,중앙보훈병원,3393,3174,6567
20210731,9호선2~3단계,석촌,4628,3873,8501
20210731,9호선2~3단계,둔촌오륜,492,496,988
20210801,9호선2~3단계,언주,2220,2311,4531
20210801,9호선2~3단계,삼전,2595,2587,5182
20210801,9호선2~3단계,선정릉,2190,2254,4444
20210801,9호선2~3단계,삼성중앙,1372,1459,2831
20210801,9호선2~3단계,봉은사,5278,5282,10560
20210801,9호선2~3단계,종합운동장,1389,1365,2754
20210801,9호선2~3단계,석촌고분,2131,2234,4365
20210801,9호선2~3단계,송파나루,2139,2314,4453
20210801,9호선2~3단계,한성백제,884,875,1759
20210801,9호선2~3단계,올림픽공원,1828,1949,3777
20210801,9호선2~3단계,둔촌오륜,290,339,629
20210801,9호선2~3단계,중앙보훈병원,2376,2371,4747
20210801,9호선2~3단계,석촌,3065,2655,5720
20210802,9호선2~3단계,선정릉,7989,8592,16581
20210802,9호선2~3단계,삼성중앙,5580,5895,11475
20210802,9호선2~3단계,봉은사,12255,12419,24674
20210802,9호선2~3단계,종합운동장,3338,3406,6744
20210802,9호선2~3단계,삼전,5675,5530,11205
20210802,9호선2~3단계,석촌고분,4935,4961,9896
20210802,9호선2~3단계,언주,9025,9106,18131
20210802,9호선2~3단계,송파나루,3926,4223,8149
20210802,9호선2~3단계,한성백제,2124,1973,4097
20210802,9호선2~3단계,올림픽공원,4544,4508,9052
20210802,9호선2~3단계,둔촌오륜,812,762,1574
20210802,9호선2~3단계,중앙보훈병원,8945,8054,16999
20210802,9호선2~3단계,석촌,6543,5908,12451
20210803,9호선2~3단계,중앙보훈병원,9010,8165,17175
20210803,9호선2~3단계,둔촌오륜,781,754,1535
20210803,9호선2~3단계,올림픽공원,4770,4592,9362
20210803,9호선2~3단계,한성백제,2185,2038,4223
20210803,9호선2~3단계,송파나루,4027,4422,8449
20210803,9호선2~3단계,석촌,6799,6053,12852
20210803,9호선2~3단계,석촌고분,5061,5038,10099
20210803,9호선2~3단계,종합운동장,3435,3424,6859
20210803,9호선2~3단계,봉은사,12539,12489,25028
20210803,9호선2~3단계,삼성중앙,5563,5846,11409
20210803,9호선2~3단계,선정릉,8228,8747,16975
20210803,9호선2~3단계,언주,9123,9267,18390
20210803,9호선2~3단계,삼전,5634,5582,11216
20210804,9호선2~3단계,석촌,6968,6247,13215
20210804,9호선2~3단계,둔촌오륜,836,788,1624
20210804,9호선2~3단계,올림픽공원,4763,4586,9349
20210804,9호선2~3단계,한성백제,2143,2096,4239
20210804,9호선2~3단계,송파나루,4061,4410,8471
20210804,9호선2~3단계,석촌고분,5180,5196,10376
20210804,9호선2~3단계,중앙보훈병원,9122,8092,17214
20210804,9호선2~3단계,종합운동장,3486,3536,7022
20210804,9호선2~3단계,언주,8840,9088,17928
20210804,9호선2~3단계,선정릉,8065,8669,16734
20210804,9호선2~3단계,삼전,5729,5685,11414
20210804,9호선2~3단계,봉은사,12695,12820,25515
20210804,9호선2~3단계,삼성중앙,5724,5863,11587
20210805,9호선2~3단계,중앙보훈병원,9104,8107,17211
20210805,9호선2~3단계,둔촌오륜,803,747,1550
20210805,9호선2~3단계,올림픽공원,4758,4623,9381
20210805,9호선2~3단계,한성백제,2163,2035,4198
20210805,9호선2~3단계,석촌,6860,6181,13041
20210805,9호선2~3단계,석촌고분,5197,5288,10485
20210805,9호선2~3단계,송파나루,4064,4463,8527
20210805,9호선2~3단계,종합운동장,3575,3534,7109
20210805,9호선2~3단계,봉은사,13266,13234,26500
20210805,9호선2~3단계,삼성중앙,5672,5945,11617
20210805,9호선2~3단계,선정릉,8185,8920,17105
20210805,9호선2~3단계,언주,9162,9251,18413
20210805,9호선2~3단계,삼전,5729,5586,11315
20210806,9호선2~3단계,종합운동장,3628,3609,7237
20210806,9호선2~3단계,선정릉,8365,8706,17071
20210806,9호선2~3단계,언주,9148,9103,18251
20210806,9호선2~3단계,삼성중앙,5603,5813,11416
20210806,9호선2~3단계,봉은사,13467,13565,27032
20210806,9호선2~3단계,삼전,5870,5762,11632
20210806,9호선2~3단계,둔촌오륜,916,827,1743
20210806,9호선2~3단계,석촌,6935,6182,13117
20210806,9호선2~3단계,송파나루,4180,4570,8750
20210806,9호선2~3단계,한성백제,2281,2143,4424
20210806,9호선2~3단계,올림픽공원,4851,4689,9540
20210806,9호선2~3단계,중앙보훈병원,8953,8030,16983
20210806,9호선2~3단계,석촌고분,5202,5210,10412
20210807,9호선2~3단계,중앙보훈병원,3581,3407,6988
20210807,9호선2~3단계,둔촌오륜,502,507,1009
20210807,9호선2~3단계,올림픽공원,3367,3383,6750
20210807,9호선2~3단계,한성백제,1374,1257,2631
20210807,9호선2~3단계,석촌,4858,4139,8997
20210807,9호선2~3단계,송파나루,3228,3538,6766
20210807,9호선2~3단계,석촌고분,3293,3202,6495
20210807,9호선2~3단계,종합운동장,2302,2101,4403
20210807,9호선2~3단계,봉은사,8160,8410,16570
20210807,9호선2~3단계,삼성중앙,2466,2382,4848
20210807,9호선2~3단계,선정릉,3517,3696,7213
20210807,9호선2~3단계,언주,4157,4198,8355
20210807,9호선2~3단계,삼전,3980,3790,7770
20210808,9호선2~3단계,둔촌오륜,273,291,564
20210808,9호선2~3단계,올림픽공원,2665,2577,5242
20210808,9호선2~3단계,한성백제,1017,914,1931
20210808,9호선2~3단계,송파나루,2244,2618,4862
20210808,9호선2~3단계,석촌,3276,2862,6138
20210808,9호선2~3단계,석촌고분,2183,2245,4428
20210808,9호선2~3단계,중앙보훈병원,2494,2333,4827
20210808,9호선2~3단계,종합운동장,1542,1434,2976
20210808,9호선2~3단계,봉은사,6374,6717,13091
20210808,9호선2~3단계,삼성중앙,1401,1523,2924
20210808,9호선2~3단계,선정릉,2201,2454,4655
20210808,9호선2~3단계,언주,2471,2484,4955
20210808,9호선2~3단계,삼전,2666,2694,5360
20210809,9호선2~3단계,언주,9504,9508,19012
20210809,9호선2~3단계,선정릉,8383,9104,17487
20210809,9호선2~3단계,삼성중앙,6031,6314,12345
20210809,9호선2~3단계,봉은사,13331,13355,26686
20210809,9호선2~3단계,종합운동장,3470,3671,7141
20210809,9호선2~3단계,삼전,6094,5982,12076
20210809,9호선2~3단계,석촌고분,5323,5325,10648
20210809,9호선2~3단계,송파나루,4067,4411,8478
20210809,9호선2~3단계,한성백제,2228,2084,4312
20210809,9호선2~3단계,올림픽공원,4933,4824,9757
20210809,9호선2~3단계,둔촌오륜,883,842,1725
20210809,9호선2~3단계,중앙보훈병원,9625,8728,18353
20210809,9호선2~3단계,석촌,6979,6329,13308
20210810,9호선2~3단계,언주,9494,9616,19110
20210810,9호선2~3단계,선정릉,8504,9258,17762
20210810,9호선2~3단계,삼성중앙,5865,6203,12068
20210810,9호선2~3단계,봉은사,13804,13669,27473
20210810,9호선2~3단계,종합운동장,3592,3649,7241
20210810,9호선2~3단계,삼전,6096,5890,11986
20210810,9호선2~3단계,석촌고분,5403,5510,10913
20210810,9호선2~3단계,송파나루,4218,4682,8900
20210810,9호선2~3단계,중앙보훈병원,9664,8737,18401
20210810,9호선2~3단계,둔촌오륜,927,882,1809
20210810,9호선2~3단계,석촌,7286,6468,13754
20210810,9호선2~3단계,한성백제,2266,2078,4344
20210810,9호선2~3단계,올림픽공원,5008,4937,9945
20210811,9호선2~3단계,둔촌오륜,937,836,1773
20210811,9호선2~3단계,올림픽공원,5072,4919,9991
20210811,9호선2~3단계,한성백제,2233,2054,4287
20210811,9호선2~3단계,송파나루,4272,4550,8822
20210811,9호선2~3단계,석촌,7051,6512,13563
20210811,9호선2~3단계,석촌고분,5331,5379,10710
20210811,9호선2~3단계,중앙보훈병원,9625,8693,18318
20210811,9호선2~3단계,종합운동장,3681,3705,7386
20210811,9호선2~3단계,봉은사,13745,13694,27439
20210811,9호선2~3단계,삼성중앙,5894,6184,12078
20210811,9호선2~3단계,선정릉,8615,9320,17935
20210811,9호선2~3단계,언주,9284,9432,18716
20210811,9호선2~3단계,삼전,6025,5936,11961
20210812,9호선2~3단계,언주,9779,9567,19346
20210812,9호선2~3단계,선정릉,8419,9284,17703
20210812,9호선2~3단계,삼성중앙,6089,6156,12245
20210812,9호선2~3단계,봉은사,14311,14186,28497
20210812,9호선2~3단계,종합운동장,3631,3581,7212
20210812,9호선2~3단계,삼전,6089,5992,12081
20210812,9호선2~3단계,석촌고분,5437,5577,11014
20210812,9호선2~3단계,송파나루,4244,4657,8901
20210812,9호선2~3단계,한성백제,2271,2146,4417
20210812,9호선2~3단계,올림픽공원,5007,4864,9871
20210812,9호선2~3단계,중앙보훈병원,9573,8555,18128
20210812,9호선2~3단계,석촌,7172,6273,13445
20210812,9호선2~3단계,둔촌오륜,892,852,1744
20210813,9호선2~3단계,중앙보훈병원,9244,8306,17550
20210813,9호선2~3단계,석촌,7245,6480,13725
20210813,9호선2~3단계,둔촌오륜,841,819,1660
20210813,9호선2~3단계,올림픽공원,5826,5675,11501
20210813,9호선2~3단계,한성백제,2187,2072,4259
20210813,9호선2~3단계,송파나루,4188,4647,8835
20210813,9호선2~3단계,석촌고분,5464,5406,10870
20210813,9호선2~3단계,종합운동장,3624,3681,7305
20210813,9호선2~3단계,봉은사,13963,13991,27954
20210813,9호선2~3단계,삼성중앙,5664,5766,11430
20210813,9호선2~3단계,선정릉,8522,9061,17583
20210813,9호선2~3단계,언주,9421,9384,18805
20210813,9호선2~3단계,삼전,6170,5840,12010
20210814,9호선2~3단계,선정릉,3490,3723,7213
20210814,9호선2~3단계,삼성중앙,2341,2336,4677
20210814,9호선2~3단계,봉은사,8097,8453,16550
20210814,9호선2~3단계,종합운동장,2545,2122,4667
20210814,9호선2~3단계,삼전,3971,3734,7705
20210814,9호선2~3단계,석촌고분,3323,3192,6515
20210814,9호선2~3단계,언주,4241,4316,8557
20210814,9호선2~3단계,송파나루,3090,3447,6537
20210814,9호선2~3단계,한성백제,1559,1348,2907
20210814,9호선2~3단계,올림픽공원,4926,4514,9440
20210814,9호선2~3단계,둔촌오륜,505,518,1023
20210814,9호선2~3단계,중앙보훈병원,3720,3499,7219
20210814,9호선2~3단계,석촌,5020,4446,9466
20210815,9호선2~3단계,언주,2468,2451,4919
20210815,9호선2~3단계,선정릉,2292,2522,4814
20210815,9호선2~3단계,삼성중앙,1518,1557,3075
20210815,9호선2~3단계,봉은사,6055,6149,12204
20210815,9호선2~3단계,종합운동장,1654,1551,3205
20210815,9호선2~3단계,삼전,2823,2663,5486
20210815,9호선2~3단계,석촌고분,2378,2358,4736
20210815,9호선2~3단계,송파나루,2371,2695,5066
20210815,9호선2~3단계,한성백제,1074,969,2043
20210815,9호선2~3단계,올림픽공원,3247,3294,6541
20210815,9호선2~3단계,둔촌오륜,310,324,634
20210815,9호선2~3단계,중앙보훈병원,2621,2474,5095
20210815,9호선2~3단계,석촌,3593,3150,6743
20210816,9호선2~3단계,석촌,4474,3955,8429
20210816,9호선2~3단계,둔촌오륜,491,503,994
20210816,9호선2~3단계,올림픽공원,2888,2931,5819
20210816,9호선2~3단계,한성백제,1356,1206,2562
20210816,9호선2~3단계,송파나루,2779,3220,5999
20210816,9호선2~3단계,석촌고분,3101,3150,6251
20210816,9호선2~3단계,중앙보훈병원,5569,5387,10956
20210816,9호선2~3단계,종합운동장,2093,2061,4154
20210816,9호선2~3단계,언주,4020,4189,8209
20210816,9호선2~3단계,선정릉,3189,3564,6753
20210816,9호선2~3단계,삼전,3710,3693,7403
20210816,9호선2~3단계,봉은사,6103,6243,12346
20210816,9호선2~3단계,삼성중앙,2234,2370,4604
20210817,9호선2~3단계,중앙보훈병원,9761,8840,18601
20210817,9호선2~3단계,둔촌오륜,948,894,1842
20210817,9호선2~3단계,올림픽공원,5033,4894,9927
20210817,9호선2~3단계,한성백제,2253,2121,4374
20210817,9호선2~3단계,석촌,7193,6463,13656
20210817,9호선2~3단계,석촌고분,5395,5559,10954
20210817,9호선2~3단계,송파나루,4349,4626,8975
20210817,9호선2~3단계,종합운동장,3621,3757,7378
20210817,9호선2~3단계,봉은사,13510,13313,26823
20210817,9호선2~3단계,삼성중앙,6086,6222,12308
20210817,9호선2~3단계,선정릉,8510,9376,17886
20210817,9호선2~3단계,언주,9838,9860,19698
20210817,9호선2~3단계,삼전,6156,6203,12359
20210818,9호선2~3단계,종합운동장,3686,3715,7401
20210818,9호선2~3단계,언주,9435,9650,19085
20210818,9호선2~3단계,선정릉,8496,9172,17668
20210818,9호선2~3단계,삼성중앙,5900,6282,12182
20210818,9호선2~3단계,봉은사,13251,13262,26513
20210818,9호선2~3단계,삼전,6152,5946,12098
20210818,9호선2~3단계,둔촌오륜,1118,1013,2131
20210818,9호선2~3단계,석촌,7195,6547,13742
20210818,9호선2~3단계,송파나루,4432,4682,9114
20210818,9호선2~3단계,한성백제,2274,2058,4332
20210818,9호선2~3단계,올림픽공원,5190,4968,10158
20210818,9호선2~3단계,중앙보훈병원,9713,8783,18496
20210818,9호선2~3단계,석촌고분,5565,5576,11141
20210819,9호선2~3단계,석촌,7413,6631,14044
20210819,9호선2~3단계,중앙보훈병원,9978,9028,19006
20210819,9호선2~3단계,둔촌오륜,1124,1023,2147
20210819,9호선2~3단계,올림픽공원,5223,5208,10431
20210819,9호선2~3단계,한성백제,2349,2256,4605
20210819,9호선2~3단계,석촌고분,5571,5554,11125
20210819,9호선2~3단계,송파나루,4334,4683,9017
20210819,9호선2~3단계,종합운동장,3738,3764,7502
20210819,9호선2~3단계,삼전,6138,6043,12181
20210819,9호선2~3단계,봉은사,13988,14186,28174
20210819,9호선2~3단계,삼성중앙,5971,6219,12190
20210819,9호선2~3단계,선정릉,8788,9529,18317
20210819,9호선2~3단계,언주,9429,9456,18885
20210820,9호선2~3단계,둔촌오륜,1143,1009,2152
20210820,9호선2~3단계,올림픽공원,5276,5110,10386
20210820,9호선2~3단계,한성백제,2336,2183,4519
20210820,9호선2~3단계,송파나루,4465,4857,9322
20210820,9호선2~3단계,석촌,7551,6817,14368
20210820,9호선2~3단계,석촌고분,5475,5511,10986
20210820,9호선2~3단계,중앙보훈병원,9585,8597,18182
20210820,9호선2~3단계,종합운동장,3737,3809,7546
20210820,9호선2~3단계,봉은사,13773,13718,27491
20210820,9호선2~3단계,삼성중앙,5991,6170,12161
20210820,9호선2~3단계,선정릉,8781,9433,18214
20210820,9호선2~3단계,언주,9432,9608,19040
20210820,9호선2~3단계,삼전,6311,6150,12461
20210821,9호선2~3단계,둔촌오륜,441,455,896
20210821,9호선2~3단계,언주,4350,4284,8634
20210821,9호선2~3단계,선정릉,3370,3652,7022
20210821,9호선2~3단계,삼성중앙,2267,2256,4523
20210821,9호선2~3단계,봉은사,7270,7601,14871
20210821,9호선2~3단계,종합운동장,2525,2168,4693
20210821,9호선2~3단계,삼전,3868,3713,7581
20210821,9호선2~3단계,석촌,4674,4022,8696
20210821,9호선2~3단계,송파나루,3140,3403,6543
20210821,9호선2~3단계,한성백제,1374,1190,2564
20210821,9호선2~3단계,올림픽공원,2665,2705,5370
20210821,9호선2~3단계,중앙보훈병원,3311,3095,6406
20210821,9호선2~3단계,석촌고분,3200,3172,6372
20210822,9호선2~3단계,송파나루,2396,2694,5090
20210822,9호선2~3단계,중앙보훈병원,2752,2705,5457
20210822,9호선2~3단계,둔촌오륜,339,378,717
20210822,9호선2~3단계,올림픽공원,2506,2483,4989
20210822,9호선2~3단계,한성백제,1125,1052,2177
20210822,9호선2~3단계,석촌,3764,3271,7035
20210822,9호선2~3단계,선정릉,2568,2762,5330
20210822,9호선2~3단계,삼전,2848,2847,5695
20210822,9호선2~3단계,종합운동장,1617,1522,3139
20210822,9호선2~3단계,봉은사,6415,6510,12925
20210822,9호선2~3단계,삼성중앙,1518,1604,3122
20210822,9호선2~3단계,석촌고분,2466,2445,4911
20210822,9호선2~3단계,언주,2608,2611,5219
20210823,9호선2~3단계,중앙보훈병원,9815,8736,18551
20210823,9호선2~3단계,둔촌오륜,1183,1075,2258
20210823,9호선2~3단계,올림픽공원,4973,4901,9874
20210823,9호선2~3단계,한성백제,2322,2195,4517
20210823,9호선2~3단계,송파나루,4270,4526,8796
20210823,9호선2~3단계,석촌,7108,6471,13579
20210823,9호선2~3단계,석촌고분,5451,5620,11071
20210823,9호선2~3단계,삼전,6146,6125,12271
20210823,9호선2~3단계,종합운동장,3580,3583,7163
20210823,9호선2~3단계,봉은사,13450,13515,26965
20210823,9호선2~3단계,삼성중앙,6097,6363,12460
20210823,9호선2~3단계,선정릉,8502,9225,17727
20210823,9호선2~3단계,언주,9674,9668,19342
20210824,9호선2~3단계,선정릉,8722,9191,17913
20210824,9호선2~3단계,삼성중앙,6122,6334,12456
20210824,9호선2~3단계,봉은사,13666,13849,27515
20210824,9호선2~3단계,종합운동장,3544,3603,7147
20210824,9호선2~3단계,삼전,6097,6102,12199
20210824,9호선2~3단계,석촌고분,5398,5571,10969
20210824,9호선2~3단계,언주,9689,9751,19440
20210824,9호선2~3단계,송파나루,4361,4648,9009
20210824,9호선2~3단계,한성백제,2215,2105,4320
20210824,9호선2~3단계,올림픽공원,4919,4707,9626
20210824,9호선2~3단계,둔촌오륜,1150,1079,2229
20210824,9호선2~3단계,중앙보훈병원,9858,8915,18773
20210824,9호선2~3단계,석촌,7003,6392,13395
20210825,9호선2~3단계,선정릉,8804,9505,18309
20210825,9호선2~3단계,삼성중앙,6043,6239,12282
20210825,9호선2~3단계,봉은사,15242,15594,30836
20210825,9호선2~3단계,종합운동장,3702,3795,7497
20210825,9호선2~3단계,삼전,6307,6135,12442
20210825,9호선2~3단계,석촌고분,5636,5641,11277
20210825,9호선2~3단계,언주,9409,9504,18913
20210825,9호선2~3단계,송파나루,4493,4798,9291
20210825,9호선2~3단계,한성백제,2292,2173,4465
20210825,9호선2~3단계,올림픽공원,5188,5158,10346
20210825,9호선2~3단계,둔촌오륜,1186,1101,2287
20210825,9호선2~3단계,중앙보훈병원,10089,9010,19099
20210825,9호선2~3단계,석촌,7537,6800,14337
20210826,9호선2~3단계,중앙보훈병원,9807,8859,18666
20210826,9호선2~3단계,둔촌오륜,1162,1083,2245
20210826,9호선2~3단계,올림픽공원,5170,5090,10260
20210826,9호선2~3단계,한성백제,2284,2183,4467
20210826,9호선2~3단계,송파나루,4454,4773,9227
20210826,9호선2~3단계,석촌,7438,6709,14147
20210826,9호선2~3단계,석촌고분,5562,5522,11084
20210826,9호선2~3단계,종합운동장,3674,3707,7381
20210826,9호선2~3단계,봉은사,15210,15552,30762
20210826,9호선2~3단계,삼성중앙,5955,6244,12199
20210826,9호선2~3단계,선정릉,8667,9582,18249
20210826,9호선2~3단계,언주,9614,9606,19220
20210826,9호선2~3단계,삼전,6240,6024,12264
20210827,9호선2~3단계,석촌,7435,6566,14001
20210827,9호선2~3단계,둔촌오륜,1161,1079,2240
20210827,9호선2~3단계,올림픽공원,5223,4859,10082
20210827,9호선2~3단계,한성백제,2401,2169,4570
20210827,9호선2~3단계,송파나루,4376,4804,9180
20210827,9호선2~3단계,석촌고분,5616,5585,11201
20210827,9호선2~3단계,중앙보훈병원,9409,8359,17768
20210827,9호선2~3단계,종합운동장,3670,3706,7376
20210827,9호선2~3단계,봉은사,15230,15465,30695
20210827,9호선2~3단계,삼성중앙,5945,6130,12075
20210827,9호선2~3단계,선정릉,8707,9244,17951
20210827,9호선2~3단계,언주,9402,9347,18749
20210827,9호선2~3단계,삼전,6256,6066,12322
20210828,9호선2~3단계,중앙보훈병원,3997,3802,7799
20210828,9호선2~3단계,둔촌오륜,533,548,1081
20210828,9호선2~3단계,올림픽공원,3490,3518,7008
20210828,9호선2~3단계,한성백제,1605,1375,2980
20210828,9호선2~3단계,송파나루,3320,3691,7011
20210828,9호선2~3단계,석촌,5583,4840,10423
20210828,9호선2~3단계,선정릉,3919,4312,8231
20210828,9호선2~3단계,삼전,4360,4036,8396
20210828,9호선2~3단계,종합운동장,2417,2434,4851
20210828,9호선2~3단계,봉은사,9236,9727,18963
20210828,9호선2~3단계,삼성중앙,2455,2549,5004
20210828,9호선2~3단계,석촌고분,3679,3545,7224
20210828,9호선2~3단계,언주,4607,4637,9244
20210829,9호선2~3단계,중앙보훈병원,2773,2675,5448
20210829,9호선2~3단계,둔촌오륜,344,396,740
20210829,9호선2~3단계,올림픽공원,2577,2660,5237
20210829,9호선2~3단계,한성백제,1068,1000,2068
20210829,9호선2~3단계,송파나루,2316,2766,5082
20210829,9호선2~3단계,석촌,3801,3297,7098
20210829,9호선2~3단계,석촌고분,2542,2500,5042
20210829,9호선2~3단계,삼전,3015,2919,5934
20210829,9호선2~3단계,종합운동장,1685,1601,3286
20210829,9호선2~3단계,봉은사,5608,5606,11214
20210829,9호선2~3단계,삼성중앙,1602,1626,3228
20210829,9호선2~3단계,선정릉,2609,2821,5430
20210829,9호선2~3단계,언주,2601,2701,5302
20210830,9호선2~3단계,둔촌오륜,1174,1122,2296
20210830,9호선2~3단계,올림픽공원,5202,5171,10373
20210830,9호선2~3단계,한성백제,2338,2219,4557
20210830,9호선2~3단계,송파나루,4314,4557,8871
20210830,9호선2~3단계,석촌,7263,6553,13816
20210830,9호선2~3단계,석촌고분,5460,5528,10988
20210830,9호선2~3단계,중앙보훈병원,10029,9026,19055
20210830,9호선2~3단계,종합운동장,3564,3585,7149
20210830,9호선2~3단계,봉은사,13418,13416,26834
20210830,9호선2~3단계,삼성중앙,6121,6457,12578
20210830,9호선2~3단계,선정릉,8954,9533,18487
20210830,9호선2~3단계,언주,9458,9604,19062
20210830,9호선2~3단계,삼전,6151,6088,12239
20210831,9호선2~3단계,둔촌오륜,1264,1071,2335
20210831,9호선2~3단계,올림픽공원,4723,4718,9441
20210831,9호선2~3단계,한성백제,2359,2180,4539
20210831,9호선2~3단계,송파나루,4511,4764,9275
20210831,9호선2~3단계,석촌,7025,6285,13310
20210831,9호선2~3단계,석촌고분,5511,5738,11249
20210831,9호선2~3단계,중앙보훈병원,9971,8970,18941
20210831,9호선2~3단계,종합운동장,3685,3642,7327
20210831,9호선2~3단계,봉은사,14409,14262,28671
20210831,9호선2~3단계,삼성중앙,6360,6480,12840
20210831,9호선2~3단계,선정릉,8549,9273,17822
20210831,9호선2~3단계,언주,10042,9831,19873
20210831,9호선2~3단계,삼전,6096,6263,12359
20210901,9호선2~3단계,중앙보훈병원,10018,9053,19071
20210901,9호선2~3단계,둔촌오륜,1199,1060,2259
20210901,9호선2~3단계,올림픽공원,5247,4978,10225
20210901,9호선2~3단계,한성백제,2308,2151,4459
20210901,9호선2~3단계,송파나루,4321,4528,8849
20210901,9호선2~3단계,석촌,7315,6686,14001
20210901,9호선2~3단계,삼전,6300,6213,12513
20210901,9호선2~3단계,종합운동장,3711,3748,7459
20210901,9호선2~3단계,봉은사,14462,14616,29078
20210901,9호선2~3단계,삼성중앙,5997,6232,12229
20210901,9호선2~3단계,선정릉,8890,9524,18414
20210901,9호선2~3단계,언주,9387,9690,19077
20210901,9호선2~3단계,석촌고분,5503,5527,11030
20210902,9호선2~3단계,종합운동장,3641,3646,7287
20210902,9호선2~3단계,선정릉,9031,9469,18500
20210902,9호선2~3단계,삼성중앙,6212,6375,12587
20210902,9호선2~3단계,봉은사,14172,14313,28485
20210902,9호선2~3단계,삼전,6220,5993,12213
20210902,9호선2~3단계,언주,9686,9857,19543
20210902,9호선2~3단계,석촌고분,5567,5542,11109
20210902,9호선2~3단계,중앙보훈병원,9981,8863,18844
20210902,9호선2~3단계,둔촌오륜,1200,1099,2299
20210902,9호선2~3단계,석촌,7482,6699,14181
20210902,9호선2~3단계,한성백제,2360,2189,4549
20210902,9호선2~3단계,송파나루,4404,4611,9015
20210902,9호선2~3단계,올림픽공원,5304,5158,10462
20210903,9호선2~3단계,선정릉,9266,9887,19153
20210903,9호선2~3단계,삼성중앙,6218,6389,12607
20210903,9호선2~3단계,봉은사,14381,14560,28941
20210903,9호선2~3단계,종합운동장,3925,3857,7782
20210903,9호선2~3단계,삼전,6539,6228,12767
20210903,9호선2~3단계,석촌고분,5745,5818,11563
20210903,9호선2~3단계,언주,9779,9962,19741
20210903,9호선2~3단계,송파나루,4526,4888,9414
20210903,9호선2~3단계,한성백제,2488,2324,4812
20210903,9호선2~3단계,올림픽공원,5804,5698,11502
20210903,9호선2~3단계,둔촌오륜,1200,1017,2217
20210903,9호선2~3단계,중앙보훈병원,9975,8972,18947
20210903,9호선2~3단계,석촌,7717,7046,14763
20210904,9호선2~3단계,중앙보훈병원,4060,3784,7844
20210904,9호선2~3단계,둔촌오륜,574,551,1125
20210904,9호선2~3단계,올림픽공원,4977,4952,9929
20210904,9호선2~3단계,한성백제,1842,1573,3415
20210904,9호선2~3단계,송파나루,3480,3931,7411
20210904,9호선2~3단계,석촌,5749,4985,10734
20210904,9호선2~3단계,석촌고분,3726,3646,7372
20210904,9호선2~3단계,종합운동장,2666,2384,5050
20210904,9호선2~3단계,봉은사,8171,8409,16580
20210904,9호선2~3단계,삼성중앙,2572,2593,5165
20210904,9호선2~3단계,언주,4913,5018,9931
20210904,9호선2~3단계,삼전,4557,4302,8859
20210904,9호선2~3단계,선정릉,4291,4681,8972
20210905,9호선2~3단계,언주,2851,2853,5704
20210905,9호선2~3단계,삼전,3072,2989,6061
20210905,9호선2~3단계,선정릉,2577,2967,5544
20210905,9호선2~3단계,삼성중앙,1654,1716,3370
20210905,9호선2~3단계,봉은사,5711,5777,11488
20210905,9호선2~3단계,종합운동장,1722,1712,3434
20210905,9호선2~3단계,석촌,3989,3396,7385
20210905,9호선2~3단계,송파나루,2418,2807,5225
20210905,9호선2~3단계,한성백제,1239,1085,2324
20210905,9호선2~3단계,올림픽공원,3713,3703,7416
20210905,9호선2~3단계,둔촌오륜,354,380,734
20210905,9호선2~3단계,중앙보훈병원,2954,2853,5807
20210905,9호선2~3단계,석촌고분,2570,2618,5188
20210906,9호선2~3단계,둔촌오륜,1202,1105,2307
20210906,9호선2~3단계,올림픽공원,5265,5084,10349
20210906,9호선2~3단계,한성백제,2406,2235,4641
20210906,9호선2~3단계,송파나루,4435,4718,9153
20210906,9호선2~3단계,석촌,7375,6592,13967
20210906,9호선2~3단계,석촌고분,5619,5884,11503
20210906,9호선2~3단계,중앙보훈병원,10288,9260,19548
20210906,9호선2~3단계,종합운동장,3715,3690,7405
20210906,9호선2~3단계,봉은사,13816,13743,27559
20210906,9호선2~3단계,삼성중앙,6322,6554,12876
20210906,9호선2~3단계,선정릉,8935,9747,18682
20210906,9호선2~3단계,언주,10051,10088,20139
20210906,9호선2~3단계,삼전,6385,6438,12823
20210907,9호선2~3단계,중앙보훈병원,9976,9072,19048
20210907,9호선2~3단계,둔촌오륜,1221,1064,2285
20210907,9호선2~3단계,올림픽공원,4812,4716,9528
20210907,9호선2~3단계,한성백제,2256,2161,4417
20210907,9호선2~3단계,송파나루,4375,4496,8871
20210907,9호선2~3단계,석촌,7097,6413,13510
20210907,9호선2~3단계,석촌고분,5527,5674,11201
20210907,9호선2~3단계,종합운동장,3571,3579,7150
20210907,9호선2~3단계,봉은사,14022,14025,28047
20210907,9호선2~3단계,삼성중앙,6169,6436,12605
20210907,9호선2~3단계,선정릉,8797,9479,18276
20210907,9호선2~3단계,언주,9822,9930,19752
20210907,9호선2~3단계,삼전,6309,6293,12602
20210908,9호선2~3단계,중앙보훈병원,10293,9330,19623
20210908,9호선2~3단계,둔촌오륜,1276,1118,2394
20210908,9호선2~3단계,올림픽공원,5361,5395,10756
20210908,9호선2~3단계,한성백제,2488,2286,4774
20210908,9호선2~3단계,송파나루,4428,4750,9178
20210908,9호선2~3단계,석촌,7707,6960,14667
20210908,9호선2~3단계,석촌고분,5832,5876,11708
20210908,9호선2~3단계,종합운동장,3823,3861,7684
20210908,9호선2~3단계,봉은사,14702,14911,29613
20210908,9호선2~3단계,삼성중앙,6295,6503,12798
20210908,9호선2~3단계,선정릉,9203,9947,19150
20210908,9호선2~3단계,언주,9765,9868,19633
20210908,9호선2~3단계,삼전,6325,6190,12515
20210909,9호선2~3단계,중앙보훈병원,10234,9183,19417
20210909,9호선2~3단계,둔촌오륜,1221,1110,2331
20210909,9호선2~3단계,올림픽공원,5682,5453,11135
20210909,9호선2~3단계,한성백제,2490,2340,4830
20210909,9호선2~3단계,송파나루,4337,4663,9000
20210909,9호선2~3단계,석촌,7853,6877,14730
20210909,9호선2~3단계,석촌고분,5751,5773,11524
20210909,9호선2~3단계,삼전,6341,6113,12454
20210909,9호선2~3단계,종합운동장,3833,3796,7629
20210909,9호선2~3단계,봉은사,15004,15098,30102
20210909,9호선2~3단계,삼성중앙,6119,6548,12667
20210909,9호선2~3단계,선정릉,8982,9794,18776
20210909,9호선2~3단계,언주,9678,9802,19480
20210910,9호선2~3단계,선정릉,9195,9724,18919
20210910,9호선2~3단계,삼성중앙,6210,6378,12588
20210910,9호선2~3단계,봉은사,14784,14833,29617
20210910,9호선2~3단계,종합운동장,3942,3874,7816
20210910,9호선2~3단계,삼전,6585,6357,12942
20210910,9호선2~3단계,석촌고분,5898,5764,11662
20210910,9호선2~3단계,언주,9959,9998,19957
20210910,9호선2~3단계,송파나루,4639,5141,9780
20210910,9호선2~3단계,한성백제,2457,2334,4791
20210910,9호선2~3단계,올림픽공원,6594,6312,12906
20210910,9호선2~3단계,둔촌오륜,1199,1079,2278
20210910,9호선2~3단계,중앙보훈병원,9989,8985,18974
20210910,9호선2~3단계,석촌,8055,7008,15063
20210911,9호선2~3단계,둔촌오륜,591,619,1210
20210911,9호선2~3단계,올림픽공원,4896,4781,9677
20210911,9호선2~3단계,한성백제,1913,1671,3584
20210911,9호선2~3단계,송파나루,3514,4033,7547
20210911,9호선2~3단계,석촌,5770,4987,10757
20210911,9호선2~3단계,석촌고분,3833,3586,7419
20210911,9호선2~3단계,중앙보훈병원,4265,3941,8206
20210911,9호선2~3단계,종합운동장,2802,2393,5195
20210911,9호선2~3단계,봉은사,8364,8590,16954
20210911,9호선2~3단계,삼성중앙,2730,2651,5381
20210911,9호선2~3단계,선정릉,4535,5078,9613
20210911,9호선2~3단계,언주,4960,5070,10030
20210911,9호선2~3단계,삼전,4465,4213,8678
20210912,9호선2~3단계,언주,3244,3190,6434
20210912,9호선2~3단계,선정릉,2846,3189,6035
20210912,9호선2~3단계,삼성중앙,1727,1852,3579
20210912,9호선2~3단계,봉은사,6008,6251,12259
20210912,9호선2~3단계,종합운동장,1813,1749,3562
20210912,9호선2~3단계,삼전,3112,3087,6199
20210912,9호선2~3단계,석촌고분,2684,2698,5382
20210912,9호선2~3단계,송파나루,2602,2963,5565
20210912,9호선2~3단계,한성백제,1367,1181,2548
20210912,9호선2~3단계,올림픽공원,3646,3756,7402
20210912,9호선2~3단계,둔촌오륜,394,405,799
20210912,9호선2~3단계,중앙보훈병원,3103,3118,6221
20210912,9호선2~3단계,석촌,4246,3774,8020
20210913,9호선2~3단계,삼전,6394,6169,12563
20210913,9호선2~3단계,선정릉,9124,9923,19047
20210913,9호선2~3단계,삼성중앙,6284,6617,12901
20210913,9호선2~3단계,봉은사,13462,13703,27165
20210913,9호선2~3단계,종합운동장,3646,3771,7417
20210913,9호선2~3단계,석촌고분,5642,5725,11367
20210913,9호선2~3단계,언주,10041,10175,20216
20210913,9호선2~3단계,송파나루,4311,4605,8916
20210913,9호선2~3단계,중앙보훈병원,10395,9375,19770
20210913,9호선2~3단계,둔촌오륜,1259,1152,2411
20210913,9호선2~3단계,석촌,7534,6809,14343
20210913,9호선2~3단계,한성백제,2477,2281,4758
20210913,9호선2~3단계,올림픽공원,5505,5403,10908
20210914,9호선2~3단계,둔촌오륜,1191,1080,2271
20210914,9호선2~3단계,올림픽공원,5416,5328,10744
20210914,9호선2~3단계,한성백제,2430,2288,4718
20210914,9호선2~3단계,송파나루,4416,4792,9208
20210914,9호선2~3단계,석촌,7897,7103,15000
20210914,9호선2~3단계,석촌고분,5794,5804,11598
20210914,9호선2~3단계,중앙보훈병원,10603,9621,20224
20210914,9호선2~3단계,종합운동장,3848,3827,7675
20210914,9호선2~3단계,봉은사,14034,14100,28134
20210914,9호선2~3단계,삼성중앙,6392,6692,13084
20210914,9호선2~3단계,선정릉,9159,9981,19140
20210914,9호선2~3단계,언주,10173,10343,20516
20210914,9호선2~3단계,삼전,6426,6356,12782
20210915,9호선2~3단계,중앙보훈병원,10647,9539,20186
20210915,9호선2~3단계,둔촌오륜,1302,1191,2493
20210915,9호선2~3단계,올림픽공원,5663,5706,11369
20210915,9호선2~3단계,한성백제,2528,2325,4853
20210915,9호선2~3단계,송파나루,4636,4971,9607
20210915,9호선2~3단계,석촌,7981,7170,15151
20210915,9호선2~3단계,석촌고분,5930,5883,11813
20210915,9호선2~3단계,종합운동장,3806,3937,7743
20210915,9호선2~3단계,봉은사,15057,15060,30117
20210915,9호선2~3단계,삼성중앙,6647,6786,13433
20210915,9호선2~3단계,언주,10190,10386,20576
20210915,9호선2~3단계,삼전,6560,6389,12949
20210915,9호선2~3단계,선정릉,9524,10299,19823
20210916,9호선2~3단계,둔촌오륜,1219,1117,2336
20210916,9호선2~3단계,석촌고분,5817,5752,11569
20210916,9호선2~3단계,올림픽공원,5652,5519,11171
20210916,9호선2~3단계,한성백제,2470,2260,4730
20210916,9호선2~3단계,송파나루,4500,4774,9274
20210916,9호선2~3단계,석촌,8031,6967,14998
20210916,9호선2~3단계,삼전,6586,6362,12948
20210916,9호선2~3단계,봉은사,14902,15088,29990
20210916,9호선2~3단계,삼성중앙,6597,6795,13392
20210916,9호선2~3단계,선정릉,9208,10058,19266
20210916,9호선2~3단계,언주,10206,10247,20453
20210916,9호선2~3단계,중앙보훈병원,10614,9471,20085
20210916,9호선2~3단계,종합운동장,3902,3906,7808
20210917,9호선2~3단계,둔촌오륜,1288,1044,2332
20210917,9호선2~3단계,올림픽공원,5748,5569,11317
20210917,9호선2~3단계,한성백제,2419,2216,4635
20210917,9호선2~3단계,송파나루,4681,4940,9621
20210917,9호선2~3단계,석촌,8199,6979,15178
20210917,9호선2~3단계,석촌고분,5813,5505,11318
20210917,9호선2~3단계,중앙보훈병원,10112,9096,19208
20210917,9호선2~3단계,종합운동장,4063,3940,8003
20210917,9호선2~3단계,봉은사,14136,14056,28192
20210917,9호선2~3단계,삼성중앙,6074,6194,12268
20210917,9호선2~3단계,선정릉,9259,9648,18907
20210917,9호선2~3단계,언주,10119,9940,20059
20210917,9호선2~3단계,삼전,6722,6274,12996
20210918,9호선2~3단계,중앙보훈병원,3671,3507,7178
20210918,9호선2~3단계,둔촌오륜,464,480,944
20210918,9호선2~3단계,올림픽공원,4119,4205,8324
20210918,9호선2~3단계,한성백제,1607,1240,2847
20210918,9호선2~3단계,송파나루,3235,3450,6685
20210918,9호선2~3단계,석촌,5430,4329,9759
20210918,9호선2~3단계,석촌고분,3618,3153,6771
20210918,9호선2~3단계,종합운동장,2422,2134,4556
20210918,9호선2~3단계,봉은사,7457,7535,14992
20210918,9호선2~3단계,삼성중앙,2356,2246,4602
20210918,9호선2~3단계,선정릉,3677,3733,7410
20210918,9호선2~3단계,언주,4239,3915,8154
20210918,9호선2~3단계,삼전,4177,3555,7732
20210919,9호선2~3단계,삼전,2838,2355,5193
20210919,9호선2~3단계,선정릉,2268,2326,4594
20210919,9호선2~3단계,삼성중앙,1458,1401,2859
20210919,9호선2~3단계,봉은사,5222,5180,10402
20210919,9호선2~3단계,종합운동장,1550,1286,2836
20210919,9호선2~3단계,석촌고분,2503,2108,4611
20210919,9호선2~3단계,언주,2188,2028,4216
20210919,9호선2~3단계,송파나루,2270,2476,4746
20210919,9호선2~3단계,중앙보훈병원,2657,2467,5124
20210919,9호선2~3단계,둔촌오륜,339,335,674
20210919,9호선2~3단계,석촌,3709,2928,6637
20210919,9호선2~3단계,한성백제,1055,902,1957
20210919,9호선2~3단계,올림픽공원,3281,3226,6507
20210920,9호선2~3단계,중앙보훈병원,2147,2094,4241
20210920,9호선2~3단계,둔촌오륜,267,257,524
20210920,9호선2~3단계,올림픽공원,2435,2454,4889
20210920,9호선2~3단계,한성백제,865,720,1585
20210920,9호선2~3단계,석촌,2800,2177,4977
20210920,9호선2~3단계,석촌고분,1922,1711,3633
20210920,9호선2~3단계,송파나루,1843,1911,3754
20210920,9호선2~3단계,종합운동장,1229,1096,2325
20210920,9호선2~3단계,봉은사,4231,4180,8411
20210920,9호선2~3단계,삼성중앙,1193,1061,2254
20210920,9호선2~3단계,선정릉,1724,1638,3362
20210920,9호선2~3단계,언주,1853,1590,3443
20210920,9호선2~3단계,삼전,2321,1897,4218
20210921,9호선2~3단계,송파나루,1348,1596,2944
20210921,9호선2~3단계,둔촌오륜,212,186,398
20210921,9호선2~3단계,중앙보훈병원,1876,1877,3753
20210921,9호선2~3단계,올림픽공원,1928,1991,3919
20210921,9호선2~3단계,한성백제,716,684,1400
20210921,9호선2~3단계,석촌,2438,2239,4677
20210921,9호선2~3단계,선정릉,1209,1562,2771
20210921,9호선2~3단계,삼전,1782,1957,3739
20210921,9호선2~3단계,종합운동장,892,1008,1900
20210921,9호선2~3단계,봉은사,3964,4183,8147
20210921,9호선2~3단계,삼성중앙,842,882,1724
20210921,9호선2~3단계,언주,1247,1458,2705
20210921,9호선2~3단계,석촌고분,1495,1654,3149
20210922,9호선2~3단계,선정릉,2118,2644,4762
20210922,9호선2~3단계,언주,1919,2255,4174
20210922,9호선2~3단계,중앙보훈병원,2828,2718,5546
20210922,9호선2~3단계,둔촌오륜,300,332,632
20210922,9호선2~3단계,한성백제,1100,1086,2186
20210922,9호선2~3단계,올림픽공원,2968,3137,6105
20210922,9호선2~3단계,송파나루,2094,2586,4680
20210922,9호선2~3단계,석촌고분,2116,2419,4535
20210922,9호선2~3단계,삼전,2643,3025,5668
20210922,9호선2~3단계,종합운동장,1567,1711,3278
20210922,9호선2~3단계,봉은사,5196,5277,10473
20210922,9호선2~3단계,삼성중앙,1455,1677,3132
20210922,9호선2~3단계,석촌,3552,3578,7130
20210923,9호선2~3단계,둔촌오륜,1132,1057,2189
20210923,9호선2~3단계,올림픽공원,5322,5494,10816
20210923,9호선2~3단계,한성백제,2212,2063,4275
20210923,9호선2~3단계,송파나루,4150,4442,8592
20210923,9호선2~3단계,석촌,7085,6522,13607
20210923,9호선2~3단계,석촌고분,5163,5333,10496
20210923,9호선2~3단계,중앙보훈병원,9678,8665,18343
20210923,9호선2~3단계,종합운동장,3505,3603,7108
20210923,9호선2~3단계,봉은사,12487,12670,25157
20210923,9호선2~3단계,삼성중앙,5811,6138,11949
20210923,9호선2~3단계,선정릉,8195,8983,17178
20210923,9호선2~3단계,언주,8819,9284,18103
20210923,9호선2~3단계,삼전,6028,5950,11978
20210924,9호선2~3단계,중앙보훈병원,9860,8773,18633
20210924,9호선2~3단계,둔촌오륜,1193,1082,2275
20210924,9호선2~3단계,올림픽공원,5762,5706,11468
20210924,9호선2~3단계,한성백제,2406,2232,4638
20210924,9호선2~3단계,송파나루,4544,4943,9487
20210924,9호선2~3단계,석촌,7759,6996,14755
20210924,9호선2~3단계,석촌고분,5592,5539,11131
20210924,9호선2~3단계,종합운동장,3766,3801,7567
20210924,9호선2~3단계,봉은사,13463,13451,26914
20210924,9호선2~3단계,삼성중앙,6117,6244,12361
20210924,9호선2~3단계,선정릉,8605,9415,18020
20210924,9호선2~3단계,언주,9301,9569,18870
20210924,9호선2~3단계,삼전,6374,6086,12460
20210925,9호선2~3단계,언주,4991,5042,10033
20210925,9호선2~3단계,선정릉,4372,4720,9092
20210925,9호선2~3단계,삼성중앙,2577,2570,5147
20210925,9호선2~3단계,봉은사,8065,8352,16417
20210925,9호선2~3단계,종합운동장,2490,2346,4836
20210925,9호선2~3단계,삼전,4311,4110,8421
20210925,9호선2~3단계,석촌고분,3654,3604,7258
20210925,9호선2~3단계,송파나루,3331,3877,7208
20210925,9호선2~3단계,중앙보훈병원,4086,3913,7999
20210925,9호선2~3단계,둔촌오륜,568,593,1161
20210925,9호선2~3단계,석촌,5837,5084,10921
20210925,9호선2~3단계,한성백제,1759,1538,3297
20210925,9호선2~3단계,올림픽공원,4219,4642,8861
20210926,9호선2~3단계,선정릉,2668,2970,5638
20210926,9호선2~3단계,삼성중앙,1593,1657,3250
20210926,9호선2~3단계,봉은사,6068,6173,12241
20210926,9호선2~3단계,종합운동장,1683,1676,3359
20210926,9호선2~3단계,삼전,3067,2959,6026
20210926,9호선2~3단계,석촌고분,2579,2560,5139
20210926,9호선2~3단계,언주,3017,3133,6150
20210926,9호선2~3단계,송파나루,2435,2785,5220
20210926,9호선2~3단계,한성백제,1438,1157,2595
20210926,9호선2~3단계,올림픽공원,3685,3999,7684
20210926,9호선2~3단계,둔촌오륜,366,420,786
20210926,9호선2~3단계,중앙보훈병원,3004,2812,5816
20210926,9호선2~3단계,석촌,4013,3591,7604
20210927,9호선2~3단계,언주,9968,10330,20298
20210927,9호선2~3단계,선정릉,9169,10137,19306
20210927,9호선2~3단계,삼성중앙,6514,6756,13270
20210927,9호선2~3단계,봉은사,14044,14181,28225
20210927,9호선2~3단계,종합운동장,3753,3731,7484
20210927,9호선2~3단계,삼전,6389,6340,12729
20210927,9호선2~3단계,석촌고분,5661,5635,11296
20210927,9호선2~3단계,송파나루,4364,4610,8974
20210927,9호선2~3단계,한성백제,2519,2329,4848
20210927,9호선2~3단계,올림픽공원,5676,5739,11415
20210927,9호선2~3단계,중앙보훈병원,10830,9759,20589
20210927,9호선2~3단계,석촌,7669,6991,14660
20210927,9호선2~3단계,둔촌오륜,1246,1102,2348
20210928,9호선2~3단계,중앙보훈병원,10577,9556,20133
20210928,9호선2~3단계,석촌,7641,7014,14655
20210928,9호선2~3단계,둔촌오륜,1219,1106,2325
20210928,9호선2~3단계,올림픽공원,5630,5637,11267
20210928,9호선2~3단계,한성백제,2457,2259,4716
20210928,9호선2~3단계,송파나루,4574,4891,9465
20210928,9호선2~3단계,석촌고분,5715,5820,11535
20210928,9호선2~3단계,종합운동장,3785,3749,7534
20210928,9호선2~3단계,봉은사,14294,14394,28688
20210928,9호선2~3단계,삼성중앙,6516,6746,13262
20210928,9호선2~3단계,선정릉,9168,10130,19298
20210928,9호선2~3단계,언주,10267,10164,20431
20210928,9호선2~3단계,삼전,6415,6477,12892
20210929,9호선2~3단계,선정릉,9065,9811,18876
20210929,9호선2~3단계,삼성중앙,6287,6651,12938
20210929,9호선2~3단계,봉은사,13929,14259,28188
20210929,9호선2~3단계,종합운동장,3762,3771,7533
20210929,9호선2~3단계,삼전,6392,6195,12587
20210929,9호선2~3단계,석촌고분,5678,5703,11381
20210929,9호선2~3단계,언주,9880,10023,19903
20210929,9호선2~3단계,송파나루,4484,4782,9266
20210929,9호선2~3단계,한성백제,2295,2203,4498
20210929,9호선2~3단계,올림픽공원,5192,5095,10287
20210929,9호선2~3단계,둔촌오륜,1288,1146,2434
20210929,9호선2~3단계,중앙보훈병원,10409,9271,19680
20210929,9호선2~3단계,석촌,7703,6833,14536
20210930,9호선2~3단계,봉은사,14768,15040,29808
20210930,9호선2~3단계,삼성중앙,6389,6552,12941
20210930,9호선2~3단계,선정릉,9308,10135,19443
20210930,9호선2~3단계,언주,9859,10044,19903
20210930,9호선2~3단계,중앙보훈병원,10802,9731,20533
20210930,9호선2~3단계,둔촌오륜,1244,1083,2327
20210930,9호선2~3단계,올림픽공원,5939,6082,12021
20210930,9호선2~3단계,송파나루,4461,4791,9252
20210930,9호선2~3단계,석촌,8065,7122,15187
20210930,9호선2~3단계,석촌고분,5745,5789,11534
20210930,9호선2~3단계,삼전,6508,6376,12884
20210930,9호선2~3단계,종합운동장,3885,3957,7842
20210930,9호선2~3단계,한성백제,2527,2325,4852
20211001,9호선2~3단계,삼전,6619,6465,13084
20211001,9호선2~3단계,언주,10091,10191,20282
20211001,9호선2~3단계,선정릉,9306,10041,19347
20211001,9호선2~3단계,삼성중앙,6399,6669,13068
20211001,9호선2~3단계,종합운동장,3986,3969,7955
20211001,9호선2~3단계,석촌고분,5867,5858,11725
20211001,9호선2~3단계,봉은사,15137,15095,30232
20211001,9호선2~3단계,송파나루,4696,5050,9746
20211001,9호선2~3단계,한성백제,2604,2286,4890
20211001,9호선2~3단계,석촌,8333,7304,15637
20211001,9호선2~3단계,올림픽공원,6351,6234,12585
20211001,9호선2~3단계,둔촌오륜,1246,1105,2351
20211001,9호선2~3단계,중앙보훈병원,10432,9334,19766
20211002,9호선2~3단계,중앙보훈병원,4133,3891,8024
20211002,9호선2~3단계,둔촌오륜,620,626,1246
20211002,9호선2~3단계,올림픽공원,5912,6444,12356
20211002,9호선2~3단계,한성백제,2077,1705,3782
20211002,9호선2~3단계,송파나루,3558,3860,7418
20211002,9호선2~3단계,석촌,6251,5260,11511
20211002,9호선2~3단계,석촌고분,3731,3617,7348
20211002,9호선2~3단계,삼전,4566,4178,8744
20211002,9호선2~3단계,종합운동장,2911,2621,5532
20211002,9호선2~3단계,봉은사,8765,9180,17945
20211002,9호선2~3단계,삼성중앙,2730,2664,5394
20211002,9호선2~3단계,선정릉,4519,4988,9507
20211002,9호선2~3단계,언주,5401,5516,10917
20211003,9호선2~3단계,둔촌오륜,369,408,777
20211003,9호선2~3단계,올림픽공원,4021,4703,8724
20211003,9호선2~3단계,한성백제,1688,1406,3094
20211003,9호선2~3단계,송파나루,2787,3091,5878
20211003,9호선2~3단계,석촌,4355,3694,8049
20211003,9호선2~3단계,석촌고분,2783,2739,5522
20211003,9호선2~3단계,중앙보훈병원,3084,2964,6048
20211003,9호선2~3단계,종합운동장,1857,1659,3516
20211003,9호선2~3단계,봉은사,6754,6805,13559
20211003,9호선2~3단계,삼성중앙,1791,1836,3627
20211003,9호선2~3단계,선정릉,2819,3181,6000
20211003,9호선2~3단계,언주,3361,3461,6822
20211003,9호선2~3단계,삼전,3287,3000,6287
20211004,9호선2~3단계,둔촌오륜,519,561,1080
20211004,9호선2~3단계,올림픽공원,3505,3562,7067
20211004,9호선2~3단계,한성백제,1430,1319,2749
20211004,9호선2~3단계,송파나루,2891,3297,6188
20211004,9호선2~3단계,석촌,4745,4224,8969
20211004,9호선2~3단계,석촌고분,3206,3219,6425
20211004,9호선2~3단계,중앙보훈병원,3737,3509,7246
20211004,9호선2~3단계,종합운동장,2071,1969,4040
20211004,9호선2~3단계,봉은사,6511,6479,12990
20211004,9호선2~3단계,삼성중앙,2303,2473,4776
20211004,9호선2~3단계,선정릉,3438,3842,7280
20211004,9호선2~3단계,언주,4353,4395,8748
20211004,9호선2~3단계,삼전,3991,3892,7883
20211005,9호선2~3단계,언주,10080,10383,20463
20211005,9호선2~3단계,선정릉,9439,10323,19762
20211005,9호선2~3단계,삼성중앙,6582,7048,13630
20211005,9호선2~3단계,봉은사,14266,14591,28857
20211005,9호선2~3단계,종합운동장,3710,3904,7614
20211005,9호선2~3단계,삼전,6465,6263,12728
20211005,9호선2~3단계,석촌고분,5673,5743,11416
20211005,9호선2~3단계,송파나루,4475,4712,9187
20211005,9호선2~3단계,한성백제,2508,2346,4854
20211005,9호선2~3단계,올림픽공원,5920,5822,11742
20211005,9호선2~3단계,둔촌오륜,1280,1156,2436
20211005,9호선2~3단계,중앙보훈병원,11110,10016,21126
20211005,9호선2~3단계,석촌,7947,7137,15084
20211006,9호선2~3단계,삼전,6549,6431,12980
20211006,9호선2~3단계,선정릉,9329,10063,19392
20211006,9호선2~3단계,삼성중앙,6516,6964,13480
20211006,9호선2~3단계,봉은사,15080,15417,30497
20211006,9호선2~3단계,종합운동장,3911,3864,7775
20211006,9호선2~3단계,석촌고분,5851,5774,11625
20211006,9호선2~3단계,언주,10244,10455,20699
20211006,9호선2~3단계,송파나루,4547,4807,9354
20211006,9호선2~3단계,중앙보훈병원,10764,9662,20426
20211006,9호선2~3단계,둔촌오륜,1322,1155,2477
20211006,9호선2~3단계,석촌,7888,6978,14866
20211006,9호선2~3단계,한성백제,2480,2324,4804
20211006,9호선2~3단계,올림픽공원,5650,5495,11145
20211007,9호선2~3단계,선정릉,9478,10248,19726
20211007,9호선2~3단계,삼성중앙,6486,6859,13345
20211007,9호선2~3단계,봉은사,14383,14807,29190
20211007,9호선2~3단계,종합운동장,3876,3809,7685
20211007,9호선2~3단계,삼전,6369,6250,12619
20211007,9호선2~3단계,석촌고분,5727,5667,11394
20211007,9호선2~3단계,언주,10034,10353,20387
20211007,9호선2~3단계,둔촌오륜,1312,1152,2464
20211007,9호선2~3단계,올림픽공원,5802,5653,11455
20211007,9호선2~3단계,한성백제,2497,2330,4827
20211007,9호선2~3단계,송파나루,4501,4801,9302
20211007,9호선2~3단계,석촌,8035,7006,15041
20211007,9호선2~3단계,중앙보훈병원,10735,9559,20294
20211008,9호선2~3단계,언주,10545,10473,21018
20211008,9호선2~3단계,선정릉,9449,10070,19519
20211008,9호선2~3단계,삼성중앙,6511,6688,13199
20211008,9호선2~3단계,봉은사,14885,15111,29996
20211008,9호선2~3단계,종합운동장,3992,4023,8015
20211008,9호선2~3단계,삼전,6703,6477,13180
20211008,9호선2~3단계,석촌고분,5828,5808,11636
20211008,9호선2~3단계,송파나루,4787,5192,9979
20211008,9호선2~3단계,한성백제,2584,2293,4877
20211008,9호선2~3단계,올림픽공원,6686,6518,13204
20211008,9호선2~3단계,중앙보훈병원,10165,9094,19259
20211008,9호선2~3단계,석촌,8280,7358,15638
20211008,9호선2~3단계,둔촌오륜,1294,1119,2413
20211009,9호선2~3단계,중앙보훈병원,3921,3710,7631
20211009,9호선2~3단계,석촌,5832,4849,10681
20211009,9호선2~3단계,둔촌오륜,581,573,1154
20211009,9호선2~3단계,올림픽공원,5816,6259,12075
20211009,9호선2~3단계,한성백제,1979,1707,3686
20211009,9호선2~3단계,송파나루,3573,3955,7528
20211009,9호선2~3단계,석촌고분,3506,3383,6889
20211009,9호선2~3단계,종합운동장,2948,2539,5487
20211009,9호선2~3단계,봉은사,8685,9214,17899
20211009,9호선2~3단계,삼성중앙,2474,2520,4994
20211009,9호선2~3단계,선정릉,4056,4590,8646
20211009,9호선2~3단계,언주,4776,5002,9778
20211009,9호선2~3단계,삼전,4246,3874,8120
20211010,9호선2~3단계,선정릉,2760,3201,5961
20211010,9호선2~3단계,삼성중앙,1763,1906,3669
20211010,9호선2~3단계,봉은사,7555,7674,15229
20211010,9호선2~3단계,종합운동장,1856,1668,3524
20211010,9호선2~3단계,삼전,3057,3068,6125
20211010,9호선2~3단계,석촌고분,2583,2645,5228
20211010,9호선2~3단계,언주,3551,3609,7160
20211010,9호선2~3단계,송파나루,2863,2966,5829
20211010,9호선2~3단계,한성백제,1383,1200,2583
20211010,9호선2~3단계,올림픽공원,5319,5491,10810
20211010,9호선2~3단계,둔촌오륜,396,397,793
20211010,9호선2~3단계,중앙보훈병원,2920,2942,5862
20211010,9호선2~3단계,석촌,4108,3464,7572
20211011,9호선2~3단계,중앙보훈병원,3740,3636,7376
20211011,9호선2~3단계,둔촌오륜,611,620,1231
20211011,9호선2~3단계,올림픽공원,4450,5051,9501
20211011,9호선2~3단계,한성백제,1880,1665,3545
20211011,9호선2~3단계,송파나루,3131,3447,6578
20211011,9호선2~3단계,석촌,5065,4584,9649
20211011,9호선2~3단계,석촌고분,3394,3362,6756
20211011,9호선2~3단계,종합운동장,2194,2139,4333
20211011,9호선2~3단계,봉은사,6850,6681,13531
20211011,9호선2~3단계,삼성중앙,2390,2525,4915
20211011,9호선2~3단계,선정릉,3552,4159,7711
20211011,9호선2~3단계,언주,4405,4533,8938
20211011,9호선2~3단계,삼전,4062,4019,8081
20211012,9호선2~3단계,석촌,7960,7168,15128
20211012,9호선2~3단계,둔촌오륜,1291,1188,2479
20211012,9호선2~3단계,올림픽공원,5881,6077,11958
20211012,9호선2~3단계,한성백제,2556,2309,4865
20211012,9호선2~3단계,송파나루,4411,4648,9059
20211012,9호선2~3단계,석촌고분,5859,5877,11736
20211012,9호선2~3단계,중앙보훈병원,11354,10298,21652
20211012,9호선2~3단계,종합운동장,3943,3955,7898
20211012,9호선2~3단계,언주,10032,10397,20429
20211012,9호선2~3단계,선정릉,9607,10421,20028
20211012,9호선2~3단계,삼전,6497,6372,12869
20211012,9호선2~3단계,봉은사,14325,14682,29007
20211012,9호선2~3단계,삼성중앙,6607,6954,13561
20211013,9호선2~3단계,언주,10016,10271,20287
20211013,9호선2~3단계,선정릉,9668,10538,20206
20211013,9호선2~3단계,삼성중앙,6710,7028,13738
20211013,9호선2~3단계,봉은사,15530,15729,31259
20211013,9호선2~3단계,삼전,6682,6483,13165
20211013,9호선2~3단계,석촌고분,5843,5907,11750
20211013,9호선2~3단계,종합운동장,3784,3989,7773
20211013,9호선2~3단계,송파나루,4640,4870,9510
20211013,9호선2~3단계,한성백제,2607,2420,5027
20211013,9호선2~3단계,올림픽공원,6260,6464,12724
20211013,9호선2~3단계,둔촌오륜,1306,1132,2438
20211013,9호선2~3단계,중앙보훈병원,11302,10123,21425
20211013,9호선2~3단계,석촌,8176,7261,15437
20211014,9호선2~3단계,종합운동장,3933,3987,7920
20211014,9호선2~3단계,선정릉,9670,10544,20214
20211014,9호선2~3단계,언주,10092,10323,20415
20211014,9호선2~3단계,삼성중앙,6632,6866,13498
20211014,9호선2~3단계,봉은사,16073,16477,32550
20211014,9호선2~3단계,삼전,6589,6387,12976
20211014,9호선2~3단계,둔촌오륜,1257,1123,2380
20211014,9호선2~3단계,석촌,8076,7289,15365
20211014,9호선2~3단계,송파나루,4604,4855,9459
20211014,9호선2~3단계,한성백제,2769,2448,5217
20211014,9호선2~3단계,올림픽공원,6264,6224,12488
20211014,9호선2~3단계,중앙보훈병원,11074,9904,20978
20211014,9호선2~3단계,석촌고분,5795,5867,11662
20211015,9호선2~3단계,중앙보훈병원,10631,9579,20210
20211015,9호선2~3단계,둔촌오륜,1287,1119,2406
20211015,9호선2~3단계,올림픽공원,6817,6745,13562
20211015,9호선2~3단계,한성백제,2567,2429,4996
20211015,9호선2~3단계,석촌,8375,7419,15794
20211015,9호선2~3단계,송파나루,4742,5138,9880
20211015,9호선2~3단계,석촌고분,5885,5748,11633
20211015,9호선2~3단계,종합운동장,4043,3991,8034
20211015,9호선2~3단계,봉은사,16576,17132,33708
20211015,9호선2~3단계,삼성중앙,6471,6644,13115
20211015,9호선2~3단계,선정릉,9586,10268,19854
20211015,9호선2~3단계,언주,10112,10307,20419
20211015,9호선2~3단계,삼전,6751,6505,13256
20211016,9호선2~3단계,둔촌오륜,616,628,1244
20211016,9호선2~3단계,올림픽공원,5448,5979,11427
20211016,9호선2~3단계,한성백제,2307,1909,4216
20211016,9호선2~3단계,송파나루,4103,4129,8232
20211016,9호선2~3단계,석촌,6295,5254,11549
20211016,9호선2~3단계,석촌고분,3966,3802,7768
20211016,9호선2~3단계,중앙보훈병원,4337,4156,8493
20211016,9호선2~3단계,종합운동장,3142,2644,5786
20211016,9호선2~3단계,봉은사,11950,12374,24324
20211016,9호선2~3단계,삼성중앙,3024,3095,6119
20211016,9호선2~3단계,선정릉,4751,5544,10295
20211016,9호선2~3단계,언주,5901,5960,11861
20211016,9호선2~3단계,삼전,4937,4736,9673
20211017,9호선2~3단계,중앙보훈병원,3099,3129,6228
20211017,9호선2~3단계,둔촌오륜,426,451,877
20211017,9호선2~3단계,올림픽공원,4250,4668,8918
20211017,9호선2~3단계,한성백제,1551,1312,2863
20211017,9호선2~3단계,송파나루,2953,2965,5918
20211017,9호선2~3단계,석촌,4313,3634,7947
20211017,9호선2~3단계,석촌고분,2738,2692,5430
20211017,9호선2~3단계,종합운동장,1908,1693,3601
20211017,9호선2~3단계,봉은사,8174,8423,16597
20211017,9호선2~3단계,삼성중앙,1783,1871,3654
20211017,9호선2~3단계,선정릉,2929,3382,6311
20211017,9호선2~3단계,언주,3584,3594,7178
20211017,9호선2~3단계,삼전,3200,3159,6359
20211018,9호선2~3단계,중앙보훈병원,10649,9692,20341
20211018,9호선2~3단계,둔촌오륜,1237,1105,2342
20211018,9호선2~3단계,올림픽공원,5728,5768,11496
20211018,9호선2~3단계,한성백제,2462,2313,4775
20211018,9호선2~3단계,송파나루,4512,4735,9247
20211018,9호선2~3단계,석촌,7745,6845,14590
20211018,9호선2~3단계,석촌고분,5574,5748,11322
20211018,9호선2~3단계,종합운동장,3740,3729,7469
20211018,9호선2~3단계,언주,9972,10119,20091
20211018,9호선2~3단계,선정릉,9223,10063,19286
20211018,9호선2~3단계,삼전,6448,6373,12821
20211018,9호선2~3단계,봉은사,13997,14103,28100
20211018,9호선2~3단계,삼성중앙,6688,7024,13712
20211019,9호선2~3단계,둔촌오륜,1239,1127,2366
20211019,9호선2~3단계,올림픽공원,5749,5776,11525
20211019,9호선2~3단계,한성백제,2579,2270,4849
20211019,9호선2~3단계,송파나루,4557,4714,9271
20211019,9호선2~3단계,석촌,8001,7045,15046
20211019,9호선2~3단계,석촌고분,5785,5851,11636
20211019,9호선2~3단계,중앙보훈병원,10935,9901,20836
20211019,9호선2~3단계,종합운동장,3878,3809,7687
20211019,9호선2~3단계,봉은사,14206,14519,28725
20211019,9호선2~3단계,삼성중앙,6481,6846,13327
20211019,9호선2~3단계,선정릉,9416,10363,19779
20211019,9호선2~3단계,언주,10129,10532,20661
20211019,9호선2~3단계,삼전,6489,6410,12899
20211020,9호선2~3단계,중앙보훈병원,10984,9844,20828
20211020,9호선2~3단계,둔촌오륜,1277,1106,2383
20211020,9호선2~3단계,올림픽공원,5979,6042,12021
20211020,9호선2~3단계,한성백제,2602,2411,5013
20211020,9호선2~3단계,송파나루,4782,4941,9723
20211020,9호선2~3단계,석촌,8151,7302,15453
20211020,9호선2~3단계,석촌고분,5927,5862,11789
20211020,9호선2~3단계,종합운동장,3941,3953,7894
20211020,9호선2~3단계,봉은사,15527,15857,31384
20211020,9호선2~3단계,삼성중앙,6683,6998,13681
20211020,9호선2~3단계,언주,10258,10480,20738
20211020,9호선2~3단계,삼전,6802,6605,13407
20211020,9호선2~3단계,선정릉,9548,10388,19936
20211021,9호선2~3단계,중앙보훈병원,10883,9971,20854
20211021,9호선2~3단계,석촌,8191,7350,15541
20211021,9호선2~3단계,둔촌오륜,1260,1139,2399
20211021,9호선2~3단계,올림픽공원,5963,6075,12038
20211021,9호선2~3단계,한성백제,2655,2412,5067
20211021,9호선2~3단계,송파나루,4650,4906,9556
20211021,9호선2~3단계,석촌고분,5867,5773,11640
20211021,9호선2~3단계,종합운동장,3937,3906,7843
20211021,9호선2~3단계,봉은사,15639,15958,31597
20211021,9호선2~3단계,삼성중앙,6664,7045,13709
20211021,9호선2~3단계,선정릉,9615,10425,20040
20211021,9호선2~3단계,언주,10211,10424,20635
20211021,9호선2~3단계,삼전,6631,6521,13152
20211022,9호선2~3단계,선정릉,9586,10338,19924
20211022,9호선2~3단계,삼성중앙,6462,6684,13146
20211022,9호선2~3단계,봉은사,15724,15934,31658
20211022,9호선2~3단계,종합운동장,4151,4027,8178
20211022,9호선2~3단계,삼전,6697,6524,13221
20211022,9호선2~3단계,석촌고분,5876,5789,11665
20211022,9호선2~3단계,언주,10438,10690,21128
20211022,9호선2~3단계,송파나루,4959,5232,10191
20211022,9호선2~3단계,한성백제,2658,2439,5097
20211022,9호선2~3단계,올림픽공원,6380,6338,12718
20211022,9호선2~3단계,둔촌오륜,1315,1162,2477
20211022,9호선2~3단계,중앙보훈병원,10813,9630,20443
20211022,9호선2~3단계,석촌,8429,7482,15911
20211023,9호선2~3단계,언주,5979,6179,12158
20211023,9호선2~3단계,선정릉,4927,5635,10562
20211023,9호선2~3단계,삼성중앙,2994,2950,5944
20211023,9호선2~3단계,봉은사,10583,11286,21869
20211023,9호선2~3단계,종합운동장,3015,2663,5678
20211023,9호선2~3단계,삼전,4829,4471,9300
20211023,9호선2~3단계,석촌고분,4233,3970,8203
20211023,9호선2~3단계,한성백제,2260,1931,4191
20211023,9호선2~3단계,올림픽공원,7289,7646,14935
20211023,9호선2~3단계,둔촌오륜,597,627,1224
20211023,9호선2~3단계,중앙보훈병원,4711,4553,9264
20211023,9호선2~3단계,석촌,6613,5447,12060
20211023,9호선2~3단계,송파나루,3943,4289,8232
20211024,9호선2~3단계,송파나루,2824,3114,5938
20211024,9호선2~3단계,중앙보훈병원,3103,3169,6272
20211024,9호선2~3단계,둔촌오륜,443,440,883
20211024,9호선2~3단계,올림픽공원,6098,6567,12665
20211024,9호선2~3단계,한성백제,1851,1515,3366
20211024,9호선2~3단계,석촌,4598,3972,8570
20211024,9호선2~3단계,석촌고분,2932,2849,5781
20211024,9호선2~3단계,삼전,3374,3289,6663
20211024,9호선2~3단계,종합운동장,2010,1820,3830
20211024,9호선2~3단계,봉은사,6905,7025,13930
20211024,9호선2~3단계,삼성중앙,1886,1965,3851
20211024,9호선2~3단계,선정릉,2968,3391,6359
20211024,9호선2~3단계,언주,3609,3694,7303
20211025,9호선2~3단계,중앙보훈병원,10988,9876,20864
20211025,9호선2~3단계,둔촌오륜,1238,1134,2372
20211025,9호선2~3단계,올림픽공원,6058,6215,12273
20211025,9호선2~3단계,한성백제,2608,2355,4963
20211025,9호선2~3단계,송파나루,4688,4833,9521
20211025,9호선2~3단계,석촌,8071,7281,15352
20211025,9호선2~3단계,석촌고분,5783,5727,11510
20211025,9호선2~3단계,삼전,6682,6504,13186
20211025,9호선2~3단계,종합운동장,3877,3882,7759
20211025,9호선2~3단계,봉은사,14367,14527,28894
20211025,9호선2~3단계,삼성중앙,6629,6999,13628
20211025,9호선2~3단계,선정릉,9505,10435,19940
20211025,9호선2~3단계,언주,10162,10355,20517
20211026,9호선2~3단계,선정릉,9971,10836,20807
20211026,9호선2~3단계,삼성중앙,6672,7090,13762
20211026,9호선2~3단계,봉은사,15407,15729,31136
20211026,9호선2~3단계,종합운동장,4070,4141,8211
20211026,9호선2~3단계,삼전,6783,6563,13346
20211026,9호선2~3단계,석촌고분,5825,5991,11816
20211026,9호선2~3단계,언주,10301,10644,20945
20211026,9호선2~3단계,송파나루,4610,4953,9563
20211026,9호선2~3단계,한성백제,2753,2509,5262
20211026,9호선2~3단계,올림픽공원,6175,6340,12515
20211026,9호선2~3단계,둔촌오륜,1244,1110,2354
20211026,9호선2~3단계,중앙보훈병원,11296,10216,21512
20211026,9호선2~3단계,석촌,8362,7370,15732
20211027,9호선2~3단계,선정릉,9805,10748,20553
20211027,9호선2~3단계,삼성중앙,6715,7120,13835
20211027,9호선2~3단계,봉은사,16476,16935,33411
20211027,9호선2~3단계,종합운동장,3999,4029,8028
20211027,9호선2~3단계,삼전,6797,6649,13446
20211027,9호선2~3단계,석촌고분,6113,6030,12143
20211027,9호선2~3단계,언주,10289,10623,20912
20211027,9호선2~3단계,송파나루,4823,5205,10028
20211027,9호선2~3단계,한성백제,2789,2556,5345
20211027,9호선2~3단계,올림픽공원,6494,6620,13114
20211027,9호선2~3단계,둔촌오륜,1282,1096,2378
20211027,9호선2~3단계,중앙보훈병원,11086,9985,21071
20211027,9호선2~3단계,석촌,8413,7437,15850
20211028,9호선2~3단계,언주,10215,10488,20703
20211028,9호선2~3단계,선정릉,9749,10728,20477
20211028,9호선2~3단계,삼성중앙,6633,7099,13732
20211028,9호선2~3단계,봉은사,16184,16731,32915
20211028,9호선2~3단계,종합운동장,3992,3959,7951
20211028,9호선2~3단계,삼전,6633,6495,13128
20211028,9호선2~3단계,석촌고분,6091,5936,12027
20211028,9호선2~3단계,송파나루,4766,5187,9953
20211028,9호선2~3단계,한성백제,2784,2501,5285
20211028,9호선2~3단계,올림픽공원,6583,6650,13233
20211028,9호선2~3단계,둔촌오륜,1253,1097,2350
20211028,9호선2~3단계,중앙보훈병원,11002,9946,20948
20211028,9호선2~3단계,석촌,8380,7497,15877
20211029,9호선2~3단계,삼전,6813,6590,13403
20211029,9호선2~3단계,선정릉,9765,10467,20232
20211029,9호선2~3단계,삼성중앙,6578,6881,13459
20211029,9호선2~3단계,봉은사,16508,17000,33508
20211029,9호선2~3단계,종합운동장,4128,4119,8247
20211029,9호선2~3단계,석촌고분,6011,5859,11870
20211029,9호선2~3단계,언주,10079,10399,20478
20211029,9호선2~3단계,송파나루,4968,5389,10357
20211029,9호선2~3단계,중앙보훈병원,10371,9285,19656
20211029,9호선2~3단계,둔촌오륜,1229,1133,2362
20211029,9호선2~3단계,석촌,8721,7781,16502
20211029,9호선2~3단계,한성백제,2788,2506,5294
20211029,9호선2~3단계,올림픽공원,7701,7605,15306
20211030,9호선2~3단계,선정릉,5149,5956,11105
20211030,9호선2~3단계,삼성중앙,3010,2997,6007
20211030,9호선2~3단계,봉은사,9723,10346,20069
20211030,9호선2~3단계,종합운동장,3072,2682,5754
20211030,9호선2~3단계,삼전,4801,4551,9352
20211030,9호선2~3단계,석촌고분,4268,3909,8177
20211030,9호선2~3단계,언주,6454,6481,12935
20211030,9호선2~3단계,송파나루,4114,4416,8530
20211030,9호선2~3단계,한성백제,2563,2142,4705
20211030,9호선2~3단계,올림픽공원,7289,7825,15114
20211030,9호선2~3단계,둔촌오륜,655,621,1276
20211030,9호선2~3단계,중앙보훈병원,4704,4476,9180
20211030,9호선2~3단계,석촌,6962,5719,12681
20211031,9호선2~3단계,언주,3788,3745,7533
20211031,9호선2~3단계,선정릉,3082,3668,6750
20211031,9호선2~3단계,삼성중앙,1876,1986,3862
20211031,9호선2~3단계,봉은사,7225,7210,14435
20211031,9호선2~3단계,종합운동장,1983,1791,3774
20211031,9호선2~3단계,삼전,3610,3530,7140
20211031,9호선2~3단계,석촌고분,2936,2874,5810
20211031,9호선2~3단계,송파나루,3102,3330,6432
20211031,9호선2~3단계,한성백제,2024,1656,3680
20211031,9호선2~3단계,올림픽공원,6184,6615,12799
20211031,9호선2~3단계,중앙보훈병원,3411,3345,6756
20211031,9호선2~3단계,석촌,4794,4075,8869
20211031,9호선2~3단계,둔촌오륜,437,490,927
20211101,9호선2~3단계,언주,10108,10553,20661
20211101,9호선2~3단계,삼전,6602,6361,12963
20211101,9호선2~3단계,선정릉,9555,10571,20126
20211101,9호선2~3단계,삼성중앙,6645,7136,13781
20211101,9호선2~3단계,봉은사,14705,14829,29534
20211101,9호선2~3단계,종합운동장,3861,4092,7953
20211101,9호선2~3단계,석촌고분,5955,5920,11875
20211101,9호선2~3단계,송파나루,4494,4876,9370
20211101,9호선2~3단계,한성백제,2664,2407,5071
20211101,9호선2~3단계,올림픽공원,6241,6460,12701
20211101,9호선2~3단계,둔촌오륜,1035,1007,2042
20211101,9호선2~3단계,중앙보훈병원,10979,9856,20835
20211101,9호선2~3단계,석촌,8404,7388,15792
20211102,9호선2~3단계,둔촌오륜,1072,988,2060
20211102,9호선2~3단계,올림픽공원,6561,6684,13245
20211102,9호선2~3단계,한성백제,2686,2431,5117
20211102,9호선2~3단계,송파나루,4907,4993,9900
20211102,9호선2~3단계,석촌,8382,7470,15852
20211102,9호선2~3단계,석촌고분,6052,5838,11890
20211102,9호선2~3단계,중앙보훈병원,11100,9949,21049
20211102,9호선2~3단계,종합운동장,4015,4126,8141
20211102,9호선2~3단계,봉은사,14998,15310,30308
20211102,9호선2~3단계,삼성중앙,6814,7327,14141
20211102,9호선2~3단계,선정릉,9835,10952,20787
20211102,9호선2~3단계,언주,10512,10827,21339
20211102,9호선2~3단계,삼전,6751,6562,13313
20211103,9호선2~3단계,언주,10673,10936,21609
20211103,9호선2~3단계,선정릉,10054,10897,20951
20211103,9호선2~3단계,삼성중앙,6866,7335,14201
20211103,9호선2~3단계,봉은사,16032,16408,32440
20211103,9호선2~3단계,종합운동장,4121,4105,8226
20211103,9호선2~3단계,삼전,6952,6691,13643
20211103,9호선2~3단계,석촌고분,6127,6004,12131
20211103,9호선2~3단계,송파나루,4756,5146,9902
20211103,9호선2~3단계,한성백제,2813,2464,5277
20211103,9호선2~3단계,올림픽공원,6662,6640,13302
20211103,9호선2~3단계,둔촌오륜,1152,1125,2277
20211103,9호선2~3단계,중앙보훈병원,11066,9752,20818
20211103,9호선2~3단계,석촌,8631,7524,16155
20211104,9호선2~3단계,삼전,6808,6698,13506
20211104,9호선2~3단계,선정릉,9918,10947,20865
20211104,9호선2~3단계,삼성중앙,6895,7277,14172
20211104,9호선2~3단계,봉은사,16286,16845,33131
20211104,9호선2~3단계,종합운동장,4202,4318,8520
20211104,9호선2~3단계,석촌고분,6067,5887,11954
20211104,9호선2~3단계,언주,10561,10756,21317
20211104,9호선2~3단계,송파나루,4834,5187,10021
20211104,9호선2~3단계,중앙보훈병원,10915,9692,20607
20211104,9호선2~3단계,둔촌오륜,1145,1067,2212
20211104,9호선2~3단계,석촌,8666,7574,16240
20211104,9호선2~3단계,한성백제,2777,2518,5295
20211104,9호선2~3단계,올림픽공원,6597,6508,13105
20211105,9호선2~3단계,언주,10847,11330,22177
20211105,9호선2~3단계,선정릉,10058,10928,20986
20211105,9호선2~3단계,삼성중앙,6886,7204,14090
20211105,9호선2~3단계,봉은사,16764,17284,34048
20211105,9호선2~3단계,삼전,7033,6704,13737
20211105,9호선2~3단계,석촌고분,6240,5999,12239
20211105,9호선2~3단계,종합운동장,4343,4426,8769
20211105,9호선2~3단계,송파나루,5160,5500,10660
20211105,9호선2~3단계,한성백제,2882,2472,5354
20211105,9호선2~3단계,올림픽공원,6945,6979,13924
20211105,9호선2~3단계,둔촌오륜,1137,1019,2156
20211105,9호선2~3단계,중앙보훈병원,8701,7184,15885
20211105,9호선2~3단계,석촌,8799,7709,16508
20211106,9호선2~3단계,송파나루,4234,4799,9033
20211106,9호선2~3단계,둔촌오륜,655,664,1319
20211106,9호선2~3단계,중앙보훈병원,4663,4458,9121
20211106,9호선2~3단계,올림픽공원,7595,7937,15532
20211106,9호선2~3단계,한성백제,3232,2711,5943
20211106,9호선2~3단계,석촌,7040,5696,12736
20211106,9호선2~3단계,선정릉,5020,5524,10544
20211106,9호선2~3단계,삼전,5014,4585,9599
20211106,9호선2~3단계,종합운동장,3019,2689,5708
20211106,9호선2~3단계,봉은사,11173,11922,23095
20211106,9호선2~3단계,삼성중앙,3111,3192,6303
20211106,9호선2~3단계,언주,6595,6576,13171
20211106,9호선2~3단계,석촌고분,4317,3933,8250
20211107,9호선2~3단계,언주,3866,3867,7733
20211107,9호선2~3단계,선정릉,3209,3602,6811
20211107,9호선2~3단계,삼성중앙,1973,2049,4022
20211107,9호선2~3단계,봉은사,7802,7692,15494
20211107,9호선2~3단계,삼전,3449,3333,6782
20211107,9호선2~3단계,종합운동장,2662,2288,4950
20211107,9호선2~3단계,석촌고분,3101,3157,6258
20211107,9호선2~3단계,송파나루,3039,3345,6384
20211107,9호선2~3단계,한성백제,1972,1597,3569
20211107,9호선2~3단계,올림픽공원,6219,6749,12968
20211107,9호선2~3단계,둔촌오륜,511,498,1009
20211107,9호선2~3단계,중앙보훈병원,3673,3517,7190
20211107,9호선2~3단계,석촌,5017,4414,9431
20211108,9호선2~3단계,봉은사,14974,15141,30115
20211108,9호선2~3단계,삼성중앙,6705,7140,13845
20211108,9호선2~3단계,선정릉,9394,9987,19381
20211108,9호선2~3단계,언주,10569,10762,21331
20211108,9호선2~3단계,삼전,6765,6594,13359
20211108,9호선2~3단계,중앙보훈병원,10718,9460,20178
20211108,9호선2~3단계,종합운동장,4082,3947,8029
20211108,9호선2~3단계,올림픽공원,5237,5261,10498
20211108,9호선2~3단계,한성백제,2457,2306,4763
20211108,9호선2~3단계,송파나루,4628,4888,9516
20211108,9호선2~3단계,석촌,7787,6919,14706
20211108,9호선2~3단계,석촌고분,5923,5989,11912
20211108,9호선2~3단계,둔촌오륜,1168,1075,2243
20211109,9호선2~3단계,중앙보훈병원,11003,9744,20747
20211109,9호선2~3단계,둔촌오륜,1195,1097,2292
20211109,9호선2~3단계,올림픽공원,6178,6236,12414
20211109,9호선2~3단계,한성백제,2520,2355,4875
20211109,9호선2~3단계,송파나루,4817,5085,9902
20211109,9호선2~3단계,석촌,8142,7337,15479
20211109,9호선2~3단계,석촌고분,6049,5969,12018
20211109,9호선2~3단계,종합운동장,4084,4067,8151
20211109,9호선2~3단계,봉은사,15903,16234,32137
20211109,9호선2~3단계,삼성중앙,6889,7331,14220
20211109,9호선2~3단계,선정릉,9687,10560,20247
20211109,9호선2~3단계,언주,10594,10954,21548
20211109,9호선2~3단계,삼전,6968,6752,13720
20211110,9호선2~3단계,중앙보훈병원,11404,10029,21433
20211110,9호선2~3단계,둔촌오륜,1259,1144,2403
20211110,9호선2~3단계,올림픽공원,6314,6367,12681
20211110,9호선2~3단계,한성백제,2772,2539,5311
20211110,9호선2~3단계,송파나루,5099,5398,10497
20211110,9호선2~3단계,석촌,8594,7556,16150
20211110,9호선2~3단계,석촌고분,6247,6027,12274
20211110,9호선2~3단계,종합운동장,4324,4387,8711
20211110,9호선2~3단계,언주,10882,10963,21845
20211110,9호선2~3단계,선정릉,10052,10960,21012
20211110,9호선2~3단계,삼전,7024,6741,13765
20211110,9호선2~3단계,봉은사,18150,18895,37045
20211110,9호선2~3단계,삼성중앙,7090,7477,14567
20211111,9호선2~3단계,둔촌오륜,1057,993,2050
20211111,9호선2~3단계,올림픽공원,6427,6302,12729
20211111,9호선2~3단계,한성백제,2732,2456,5188
20211111,9호선2~3단계,송파나루,5008,5266,10274
20211111,9호선2~3단계,석촌,8508,7426,15934
20211111,9호선2~3단계,석촌고분,6105,6052,12157
20211111,9호선2~3단계,중앙보훈병원,11145,9814,20959
20211111,9호선2~3단계,종합운동장,4313,4208,8521
20211111,9호선2~3단계,봉은사,18741,19359,38100
20211111,9호선2~3단계,삼성중앙,6947,7502,14449
20211111,9호선2~3단계,선정릉,9877,11037,20914
20211111,9호선2~3단계,언주,10820,11031,21851
20211111,9호선2~3단계,삼전,6992,6755,13747
20211112,9호선2~3단계,중앙보훈병원,10904,9430,20334
20211112,9호선2~3단계,둔촌오륜,1049,967,2016
20211112,9호선2~3단계,올림픽공원,7478,7344,14822
20211112,9호선2~3단계,한성백제,2839,2527,5366
20211112,9호선2~3단계,송파나루,5242,5693,10935
20211112,9호선2~3단계,석촌,8877,7770,16647
20211112,9호선2~3단계,석촌고분,6330,6114,12444
20211112,9호선2~3단계,종합운동장,4359,4386,8745
20211112,9호선2~3단계,봉은사,19623,20198,39821
20211112,9호선2~3단계,삼성중앙,6986,7171,14157
20211112,9호선2~3단계,언주,10941,11238,22179
20211112,9호선2~3단계,삼전,7234,6666,13900
20211112,9호선2~3단계,선정릉,10088,10813,20901
20211113,9호선2~3단계,언주,6791,6956,13747
20211113,9호선2~3단계,삼전,5023,4588,9611
20211113,9호선2~3단계,선정릉,4836,5384,10220
20211113,9호선2~3단계,삼성중앙,3009,3015,6024
20211113,9호선2~3단계,봉은사,14518,15803,30321
20211113,9호선2~3단계,종합운동장,3156,2759,5915
20211113,9호선2~3단계,석촌고분,4256,3963,8219
20211113,9호선2~3단계,송파나루,4121,4475,8596
20211113,9호선2~3단계,한성백제,2080,1762,3842
20211113,9호선2~3단계,올림픽공원,6270,6255,12525
20211113,9호선2~3단계,둔촌오륜,688,654,1342
20211113,9호선2~3단계,중앙보훈병원,4745,4234,8979
20211113,9호선2~3단계,석촌,6720,5527,12247
20211114,9호선2~3단계,석촌고분,3072,3018,6090
20211114,9호선2~3단계,석촌,4680,3989,8669
20211114,9호선2~3단계,송파나루,2948,3296,6244
20211114,9호선2~3단계,한성백제,1576,1346,2922
20211114,9호선2~3단계,올림픽공원,4887,5055,9942
20211114,9호선2~3단계,둔촌오륜,457,469,926
20211114,9호선2~3단계,종합운동장,2161,1984,4145
20211114,9호선2~3단계,언주,4150,4085,8235
20211114,9호선2~3단계,선정릉,2949,3383,6332
20211114,9호선2~3단계,삼성중앙,1873,1994,3867
20211114,9호선2~3단계,봉은사,7690,7658,15348
20211114,9호선2~3단계,삼전,3592,3391,6983
20211114,9호선2~3단계,중앙보훈병원,3347,3230,6577
20211115,9호선2~3단계,중앙보훈병원,10354,9120,19474
20211115,9호선2~3단계,둔촌오륜,1025,1011,2036
20211115,9호선2~3단계,올림픽공원,5964,5974,11938
20211115,9호선2~3단계,한성백제,2693,2486,5179
20211115,9호선2~3단계,송파나루,4650,4905,9555
20211115,9호선2~3단계,석촌,8169,7199,15368
20211115,9호선2~3단계,석촌고분,5908,5744,11652
20211115,9호선2~3단계,종합운동장,3996,3974,7970
20211115,9호선2~3단계,봉은사,14866,15418,30284
20211115,9호선2~3단계,삼성중앙,6837,7279,14116
20211115,9호선2~3단계,선정릉,9698,10641,20339
20211115,9호선2~3단계,언주,10256,10702,20958
20211115,9호선2~3단계,삼전,6684,6460,13144
20211116,9호선2~3단계,송파나루,4793,5040,9833
20211116,9호선2~3단계,둔촌오륜,1032,956,1988
20211116,9호선2~3단계,올림픽공원,6152,6095,12247
20211116,9호선2~3단계,한성백제,2597,2420,5017
20211116,9호선2~3단계,중앙보훈병원,10764,9426,20190
20211116,9호선2~3단계,석촌,8480,7487,15967
20211116,9호선2~3단계,봉은사,15486,15737,31223
20211116,9호선2~3단계,삼전,6833,6597,13430
20211116,9호선2~3단계,종합운동장,4022,4057,8079
20211116,9호선2~3단계,삼성중앙,7051,7492,14543
20211116,9호선2~3단계,선정릉,9952,10947,20899
20211116,9호선2~3단계,언주,10789,11168,21957
20211116,9호선2~3단계,석촌고분,6067,6010,12077
20211117,9호선2~3단계,중앙보훈병원,10677,9432,20109
20211117,9호선2~3단계,둔촌오륜,1246,1170,2416
20211117,9호선2~3단계,올림픽공원,6547,6553,13100
20211117,9호선2~3단계,한성백제,2636,2418,5054
20211117,9호선2~3단계,송파나루,4965,5228,10193
20211117,9호선2~3단계,석촌,8569,7770,16339
20211117,9호선2~3단계,석촌고분,6233,6093,12326
20211117,9호선2~3단계,삼전,6981,6683,13664
20211117,9호선2~3단계,종합운동장,4168,4181,8349
20211117,9호선2~3단계,봉은사,16232,16826,33058
20211117,9호선2~3단계,삼성중앙,6921,7506,14427
20211117,9호선2~3단계,선정릉,10200,11110,21310
20211117,9호선2~3단계,언주,10710,10940,21650
20211118,9호선2~3단계,선정릉,9901,10864,20765
20211118,9호선2~3단계,삼성중앙,6961,7387,14348
20211118,9호선2~3단계,봉은사,17118,17825,34943
20211118,9호선2~3단계,종합운동장,4074,4037,8111
20211118,9호선2~3단계,삼전,6734,6475,13209
20211118,9호선2~3단계,석촌고분,6124,5933,12057
20211118,9호선2~3단계,언주,10454,10789,21243
20211118,9호선2~3단계,송파나루,4792,4991,9783
20211118,9호선2~3단계,한성백제,2595,2339,4934
20211118,9호선2~3단계,올림픽공원,6181,6188,12369
20211118,9호선2~3단계,둔촌오륜,1159,1018,2177
20211118,9호선2~3단계,중앙보훈병원,10492,9111,19603
20211118,9호선2~3단계,석촌,8449,7468,15917
20211119,9호선2~3단계,둔촌오륜,1078,1039,2117
20211119,9호선2~3단계,올림픽공원,8163,7963,16126
20211119,9호선2~3단계,한성백제,2754,2415,5169
20211119,9호선2~3단계,송파나루,5122,5516,10638
20211119,9호선2~3단계,석촌,9033,7790,16823
20211119,9호선2~3단계,석촌고분,6274,6056,12330
20211119,9호선2~3단계,중앙보훈병원,10357,8863,19220
20211119,9호선2~3단계,종합운동장,4386,4284,8670
20211119,9호선2~3단계,봉은사,18062,18932,36994
20211119,9호선2~3단계,삼성중앙,6848,7185,14033
20211119,9호선2~3단계,선정릉,9918,10850,20768
20211119,9호선2~3단계,언주,11000,11058,22058
20211119,9호선2~3단계,삼전,7064,6720,13784
20211120,9호선2~3단계,언주,6484,6413,12897
20211120,9호선2~3단계,선정릉,4945,5502,10447
20211120,9호선2~3단계,삼성중앙,3157,3184,6341
20211120,9호선2~3단계,봉은사,12728,13894,26622
20211120,9호선2~3단계,종합운동장,3289,2949,6238
20211120,9호선2~3단계,삼전,4861,4378,9239
20211120,9호선2~3단계,석촌고분,4362,3982,8344
20211120,9호선2~3단계,송파나루,4088,4627,8715
20211120,9호선2~3단계,한성백제,1973,1656,3629
20211120,9호선2~3단계,올림픽공원,4749,4919,9668
20211120,9호선2~3단계,둔촌오륜,634,610,1244
20211120,9호선2~3단계,중앙보훈병원,4607,4149,8756
20211120,9호선2~3단계,석촌,6747,5561,12308
20211121,9호선2~3단계,삼전,3506,3420,6926
20211121,9호선2~3단계,선정릉,3288,3782,7070
20211121,9호선2~3단계,삼성중앙,1938,1986,3924
20211121,9호선2~3단계,봉은사,9335,9913,19248
20211121,9호선2~3단계,종합운동장,2393,2258,4651
20211121,9호선2~3단계,석촌고분,2832,2900,5732
20211121,9호선2~3단계,언주,4239,4192,8431
20211121,9호선2~3단계,송파나루,2968,3202,6170
20211121,9호선2~3단계,중앙보훈병원,3254,3094,6348
20211121,9호선2~3단계,둔촌오륜,435,469,904
20211121,9호선2~3단계,석촌,4666,4088,8754
20211121,9호선2~3단계,한성백제,1325,1177,2502
20211121,9호선2~3단계,올림픽공원,4835,5168,10003
20211122,9호선2~3단계,둔촌오륜,1268,1193,2461
20211122,9호선2~3단계,올림픽공원,5719,5704,11423
20211122,9호선2~3단계,한성백제,2621,2427,5048
20211122,9호선2~3단계,송파나루,4721,5250,9971
20211122,9호선2~3단계,석촌,8301,7346,15647
20211122,9호선2~3단계,석촌고분,6066,6015,12081
20211122,9호선2~3단계,중앙보훈병원,10660,9356,20016
20211122,9호선2~3단계,종합운동장,4207,4063,8270
20211122,9호선2~3단계,봉은사,15867,16130,31997
20211122,9호선2~3단계,삼성중앙,7097,7513,14610
20211122,9호선2~3단계,선정릉,9846,10989,20835
20211122,9호선2~3단계,언주,10783,11111,21894
20211122,9호선2~3단계,삼전,6797,6564,13361
20211123,9호선2~3단계,언주,10928,11230,22158
20211123,9호선2~3단계,선정릉,10161,11249,21410
20211123,9호선2~3단계,삼성중앙,7041,7471,14512
20211123,9호선2~3단계,봉은사,15831,16242,32073
20211123,9호선2~3단계,종합운동장,4230,4134,8364
20211123,9호선2~3단계,삼전,6879,6796,13675
20211123,9호선2~3단계,석촌고분,6115,6140,12255
20211123,9호선2~3단계,송파나루,4898,5226,10124
20211123,9호선2~3단계,한성백제,2648,2339,4987
20211123,9호선2~3단계,올림픽공원,5966,5960,11926
20211123,9호선2~3단계,중앙보훈병원,10722,9495,20217
20211123,9호선2~3단계,석촌,8395,7261,15656
20211123,9호선2~3단계,둔촌오륜,1300,1116,2416
20211124,9호선2~3단계,중앙보훈병원,10910,9560,20470
20211124,9호선2~3단계,석촌,8538,7540,16078
20211124,9호선2~3단계,둔촌오륜,1202,1097,2299
20211124,9호선2~3단계,올림픽공원,6270,6094,12364
20211124,9호선2~3단계,한성백제,2602,2368,4970
20211124,9호선2~3단계,송파나루,4874,5165,10039
20211124,9호선2~3단계,석촌고분,6198,6043,12241
20211124,9호선2~3단계,종합운동장,4071,4253,8324
20211124,9호선2~3단계,봉은사,17292,17784,35076
20211124,9호선2~3단계,삼성중앙,7081,7467,14548
20211124,9호선2~3단계,선정릉,10026,11002,21028
20211124,9호선2~3단계,언주,11031,11164,22195
20211124,9호선2~3단계,삼전,7030,6813,13843
20211125,9호선2~3단계,선정릉,9955,11250,21205
20211125,9호선2~3단계,삼성중앙,7099,7556,14655
20211125,9호선2~3단계,봉은사,17643,18377,36020
20211125,9호선2~3단계,종합운동장,4224,4201,8425
20211125,9호선2~3단계,삼전,6938,6651,13589
20211125,9호선2~3단계,석촌고분,6132,6156,12288
20211125,9호선2~3단계,언주,10997,11304,22301
20211125,9호선2~3단계,송파나루,4794,5248,10042
20211125,9호선2~3단계,한성백제,2733,2462,5195
20211125,9호선2~3단계,올림픽공원,6204,6123,12327
20211125,9호선2~3단계,둔촌오륜,1329,1154,2483
20211125,9호선2~3단계,중앙보훈병원,10824,9489,20313
20211125,9호선2~3단계,석촌,8533,7525,16058
20211126,9호선2~3단계,중앙보훈병원,10801,9256,20057
20211126,9호선2~3단계,둔촌오륜,1312,1137,2449
20211126,9호선2~3단계,올림픽공원,7756,7836,15592
20211126,9호선2~3단계,한성백제,2694,2452,5146
20211126,9호선2~3단계,송파나루,5197,5701,10898
20211126,9호선2~3단계,석촌,8987,7854,16841
20211126,9호선2~3단계,석촌고분,6394,6122,12516
20211126,9호선2~3단계,종합운동장,4820,4917,9737
20211126,9호선2~3단계,봉은사,18230,18799,37029
20211126,9호선2~3단계,삼성중앙,7089,7465,14554
20211126,9호선2~3단계,선정릉,10223,11052,21275
20211126,9호선2~3단계,언주,11222,11336,22558
20211126,9호선2~3단계,삼전,7237,6855,14092
20211127,9호선2~3단계,석촌,6627,5389,12016
20211127,9호선2~3단계,둔촌오륜,647,648,1295
20211127,9호선2~3단계,올림픽공원,6894,6984,13878
20211127,9호선2~3단계,한성백제,1931,1604,3535
20211127,9호선2~3단계,송파나루,4027,4545,8572
20211127,9호선2~3단계,석촌고분,4093,3960,8053
20211127,9호선2~3단계,중앙보훈병원,4473,4161,8634
20211127,9호선2~3단계,종합운동장,3923,3483,7406
20211127,9호선2~3단계,언주,6569,6588,13157
20211127,9호선2~3단계,선정릉,4954,5644,10598
20211127,9호선2~3단계,삼전,5013,4522,9535
20211127,9호선2~3단계,봉은사,13205,14446,27651
20211127,9호선2~3단계,삼성중앙,3213,3255,6468
20211128,9호선2~3단계,중앙보훈병원,3369,3261,6630
20211128,9호선2~3단계,둔촌오륜,500,474,974
20211128,9호선2~3단계,올림픽공원,5003,5025,10028
20211128,9호선2~3단계,한성백제,1479,1377,2856
20211128,9호선2~3단계,석촌,4856,4144,9000
20211128,9호선2~3단계,석촌고분,3216,3063,6279
20211128,9호선2~3단계,송파나루,2946,3381,6327
20211128,9호선2~3단계,종합운동장,3201,2608,5809
20211128,9호선2~3단계,봉은사,8550,8638,17188
20211128,9호선2~3단계,삼성중앙,2011,2210,4221
20211128,9호선2~3단계,선정릉,3080,3531,6611
20211128,9호선2~3단계,언주,3887,3895,7782
20211128,9호선2~3단계,삼전,3620,3487,7107
20211129,9호선2~3단계,송파나루,4539,4787,9326
20211129,9호선2~3단계,둔촌오륜,1262,1204,2466
20211129,9호선2~3단계,중앙보훈병원,10746,9562,20308
20211129,9호선2~3단계,올림픽공원,5698,5673,11371
20211129,9호선2~3단계,한성백제,2594,2375,4969
20211129,9호선2~3단계,석촌,8246,7273,15519
20211129,9호선2~3단계,선정릉,9704,10693,20397
20211129,9호선2~3단계,삼전,6610,6479,13089
20211129,9호선2~3단계,종합운동장,4118,4045,8163
20211129,9호선2~3단계,봉은사,15354,15768,31122
20211129,9호선2~3단계,삼성중앙,6969,7468,14437
20211129,9호선2~3단계,언주,10508,10751,21259
20211129,9호선2~3단계,석촌고분,6114,6069,12183
20211130,9호선2~3단계,중앙보훈병원,10611,9262,19873
20211130,9호선2~3단계,둔촌오륜,1323,1183,2506
20211130,9호선2~3단계,올림픽공원,5228,5245,10473
20211130,9호선2~3단계,한성백제,2514,2336,4850
20211130,9호선2~3단계,석촌,7899,7106,15005
20211130,9호선2~3단계,송파나루,4765,4899,9664
20211130,9호선2~3단계,석촌고분,6218,6071,12289
20211130,9호선2~3단계,종합운동장,4051,4087,8138
20211130,9호선2~3단계,봉은사,15437,15861,31298
20211130,9호선2~3단계,삼성중앙,7091,7551,14642
20211130,9호선2~3단계,선정릉,9674,10691,20365
20211130,9호선2~3단계,언주,10719,11083,21802
20211130,9호선2~3단계,삼전,6813,6617,13430
20211201,9호선2~3단계,선정릉,9827,10856,20683
20211201,9호선2~3단계,삼성중앙,7049,7513,14562
20211201,9호선2~3단계,봉은사,16979,17406,34385
20211201,9호선2~3단계,종합운동장,4342,4203,8545
20211201,9호선2~3단계,삼전,7102,6787,13889
20211201,9호선2~3단계,석촌고분,6171,6126,12297
20211201,9호선2~3단계,언주,10860,11060,21920
20211201,9호선2~3단계,송파나루,4953,5164,10117
20211201,9호선2~3단계,한성백제,2645,2399,5044
20211201,9호선2~3단계,올림픽공원,5631,5473,11104
20211201,9호선2~3단계,둔촌오륜,1331,1161,2492
20211201,9호선2~3단계,중앙보훈병원,10683,9307,19990
20211201,9호선2~3단계,석촌,8189,7397,15586
20211202,9호선2~3단계,언주,10859,11165,22024
20211202,9호선2~3단계,선정릉,9823,10829,20652
20211202,9호선2~3단계,삼성중앙,7072,7451,14523
20211202,9호선2~3단계,봉은사,16686,17326,34012
20211202,9호선2~3단계,종합운동장,3977,4098,8075
20211202,9호선2~3단계,삼전,6907,6618,13525
20211202,9호선2~3단계,석촌고분,6173,6134,12307
20211202,9호선2~3단계,송파나루,4896,5059,9955
20211202,9호선2~3단계,한성백제,2549,2357,4906
20211202,9호선2~3단계,올림픽공원,5516,5615,11131
20211202,9호선2~3단계,둔촌오륜,1328,1155,2483
20211202,9호선2~3단계,중앙보훈병원,10756,9448,20204
20211202,9호선2~3단계,석촌,8267,7340,15607
20211203,9호선2~3단계,중앙보훈병원,10741,9137,19878
20211203,9호선2~3단계,둔촌오륜,1359,1183,2542
20211203,9호선2~3단계,올림픽공원,8085,7753,15838
20211203,9호선2~3단계,한성백제,2724,2379,5103
20211203,9호선2~3단계,송파나루,5169,5608,10777
20211203,9호선2~3단계,석촌,8731,7468,16199
20211203,9호선2~3단계,석촌고분,6456,6109,12565
20211203,9호선2~3단계,종합운동장,4464,4220,8684
20211203,9호선2~3단계,언주,11146,11397,22543
20211203,9호선2~3단계,선정릉,9876,10720,20596
20211203,9호선2~3단계,삼전,7234,6811,14045
20211203,9호선2~3단계,봉은사,16782,17202,33984
20211203,9호선2~3단계,삼성중앙,7100,7449,14549
20211204,9호선2~3단계,둔촌오륜,633,621,1254
20211204,9호선2~3단계,올림픽공원,6064,5895,11959
20211204,9호선2~3단계,한성백제,1711,1440,3151
20211204,9호선2~3단계,송파나루,4026,4410,8436
20211204,9호선2~3단계,석촌,6414,5348,11762
20211204,9호선2~3단계,석촌고분,4144,3972,8116
20211204,9호선2~3단계,중앙보훈병원,4439,4051,8490
20211204,9호선2~3단계,종합운동장,2939,2653,5592
20211204,9호선2~3단계,봉은사,10496,11011,21507
20211204,9호선2~3단계,삼성중앙,2940,3035,5975
20211204,9호선2~3단계,선정릉,4599,5056,9655
20211204,9호선2~3단계,언주,6377,6335,12712
20211204,9호선2~3단계,삼전,4768,4338,9106
20211205,9호선2~3단계,중앙보훈병원,3061,2928,5989
20211205,9호선2~3단계,둔촌오륜,398,451,849
20211205,9호선2~3단계,올림픽공원,4877,4993,9870
20211205,9호선2~3단계,한성백제,1194,1142,2336
20211205,9호선2~3단계,송파나루,2702,2998,5700
20211205,9호선2~3단계,석촌,4513,3744,8257
20211205,9호선2~3단계,석촌고분,2790,2840,5630
20211205,9호선2~3단계,종합운동장,2019,1800,3819
20211205,9호선2~3단계,봉은사,7475,7752,15227
20211205,9호선2~3단계,삼성중앙,1870,1952,3822
20211205,9호선2~3단계,언주,3786,3895,7681
20211205,9호선2~3단계,삼전,3230,3293,6523
20211205,9호선2~3단계,선정릉,2877,3163,6040
20211206,9호선2~3단계,언주,10410,10728,21138
20211206,9호선2~3단계,삼전,6674,6437,13111
20211206,9호선2~3단계,선정릉,9374,10560,19934
20211206,9호선2~3단계,삼성중앙,6793,7167,13960
20211206,9호선2~3단계,봉은사,14974,15358,30332
20211206,9호선2~3단계,종합운동장,3789,3953,7742
20211206,9호선2~3단계,석촌고분,5967,5986,11953
20211206,9호선2~3단계,송파나루,4455,4872,9327
20211206,9호선2~3단계,한성백제,2542,2340,4882
20211206,9호선2~3단계,올림픽공원,6120,5960,12080
20211206,9호선2~3단계,둔촌오륜,1156,1100,2256
20211206,9호선2~3단계,중앙보훈병원,10717,9432,20149
20211206,9호선2~3단계,석촌,7961,7133,15094
20211207,9호선2~3단계,둔촌오륜,1144,1134,2278
20211207,9호선2~3단계,올림픽공원,6154,5995,12149
20211207,9호선2~3단계,한성백제,2496,2291,4787
20211207,9호선2~3단계,송파나루,4597,4914,9511
20211207,9호선2~3단계,석촌,8183,7276,15459
20211207,9호선2~3단계,석촌고분,5946,5899,11845
20211207,9호선2~3단계,중앙보훈병원,10902,9638,20540
20211207,9호선2~3단계,종합운동장,4062,4034,8096
20211207,9호선2~3단계,봉은사,15116,15432,30548
20211207,9호선2~3단계,삼성중앙,6788,7217,14005
20211207,9호선2~3단계,선정릉,9817,10715,20532
20211207,9호선2~3단계,언주,10430,10839,21269
20211207,9호선2~3단계,삼전,6782,6597,13379
20211208,9호선2~3단계,언주,10551,10898,21449
20211208,9호선2~3단계,선정릉,9720,10687,20407
20211208,9호선2~3단계,삼성중앙,6677,7174,13851
20211208,9호선2~3단계,봉은사,15174,15798,30972
20211208,9호선2~3단계,종합운동장,3925,3880,7805
20211208,9호선2~3단계,삼전,6830,6578,13408
20211208,9호선2~3단계,석촌고분,6206,6159,12365
20211208,9호선2~3단계,송파나루,4738,4946,9684
20211208,9호선2~3단계,한성백제,2611,2345,4956
20211208,9호선2~3단계,올림픽공원,5843,5744,11587
20211208,9호선2~3단계,둔촌오륜,1126,1031,2157
20211208,9호선2~3단계,중앙보훈병원,10701,9544,20245
20211208,9호선2~3단계,석촌,8319,7359,15678
20211209,9호선2~3단계,송파나루,4767,4970,9737
20211209,9호선2~3단계,둔촌오륜,1107,1092,2199
20211209,9호선2~3단계,올림픽공원,5900,5795,11695
20211209,9호선2~3단계,한성백제,2574,2314,4888
20211209,9호선2~3단계,중앙보훈병원,10577,9257,19834
20211209,9호선2~3단계,석촌,8255,7301,15556
20211209,9호선2~3단계,봉은사,16503,17078,33581
20211209,9호선2~3단계,삼전,6700,6451,13151
20211209,9호선2~3단계,종합운동장,4018,3978,7996
20211209,9호선2~3단계,삼성중앙,6686,7080,13766
20211209,9호선2~3단계,선정릉,9629,10656,20285
20211209,9호선2~3단계,언주,10518,10809,21327
20211209,9호선2~3단계,석촌고분,6063,5979,12042
20211210,9호선2~3단계,중앙보훈병원,10403,9059,19462
20211210,9호선2~3단계,둔촌오륜,1281,1148,2429
20211210,9호선2~3단계,언주,10585,10815,21400
20211210,9호선2~3단계,선정릉,9607,10511,20118
20211210,9호선2~3단계,삼성중앙,6864,7164,14028
20211210,9호선2~3단계,봉은사,16173,16752,32925
20211210,9호선2~3단계,종합운동장,4096,4042,8138
20211210,9호선2~3단계,삼전,6960,6551,13511
20211210,9호선2~3단계,석촌고분,6236,5967,12203
20211210,9호선2~3단계,석촌,8446,7383,15829
20211210,9호선2~3단계,송파나루,4947,5463,10410
20211210,9호선2~3단계,한성백제,2534,2203,4737
20211210,9호선2~3단계,올림픽공원,6996,6726,13722
20211211,9호선2~3단계,둔촌오륜,590,640,1230
20211211,9호선2~3단계,언주,6090,6152,12242
20211211,9호선2~3단계,선정릉,4570,5202,9772
20211211,9호선2~3단계,삼성중앙,2846,2958,5804
20211211,9호선2~3단계,봉은사,10921,11621,22542
20211211,9호선2~3단계,종합운동장,2672,2553,5225
20211211,9호선2~3단계,중앙보훈병원,4250,3832,8082
20211211,9호선2~3단계,석촌고분,3995,3887,7882
20211211,9호선2~3단계,석촌,6349,5294,11643
20211211,9호선2~3단계,송파나루,3764,4151,7915
20211211,9호선2~3단계,한성백제,1641,1513,3154
20211211,9호선2~3단계,올림픽공원,7516,7289,14805
20211211,9호선2~3단계,삼전,4584,4401,8985
20211212,9호선2~3단계,둔촌오륜,420,402,822
20211212,9호선2~3단계,올림픽공원,6373,6300,12673
20211212,9호선2~3단계,한성백제,1327,1173,2500
20211212,9호선2~3단계,송파나루,3065,3348,6413
20211212,9호선2~3단계,석촌,4377,3762,8139
20211212,9호선2~3단계,석촌고분,2836,2895,5731
20211212,9호선2~3단계,중앙보훈병원,3234,3075,6309
20211212,9호선2~3단계,종합운동장,1971,1774,3745
20211212,9호선2~3단계,봉은사,8463,8842,17305
20211212,9호선2~3단계,삼성중앙,1840,1932,3772
20211212,9호선2~3단계,선정릉,2918,3447,6365
20211212,9호선2~3단계,언주,4056,4042,8098
20211212,9호선2~3단계,삼전,3423,3419,6842
20211213,9호선2~3단계,언주,10217,10531,20748
20211213,9호선2~3단계,선정릉,9219,10110,19329
20211213,9호선2~3단계,삼성중앙,6571,6951,13522
20211213,9호선2~3단계,봉은사,14720,14978,29698
20211213,9호선2~3단계,종합운동장,3818,3870,7688
20211213,9호선2~3단계,삼전,6620,6440,13060
20211213,9호선2~3단계,석촌고분,5835,5817,11652
20211213,9호선2~3단계,송파나루,4408,4775,9183
20211213,9호선2~3단계,한성백제,2460,2305,4765
20211213,9호선2~3단계,올림픽공원,5435,5333,10768
20211213,9호선2~3단계,둔촌오륜,1183,1109,2292
20211213,9호선2~3단계,중앙보훈병원,10192,9042,19234
20211213,9호선2~3단계,석촌,7715,6953,14668
20211214,9호선2~3단계,삼전,6791,6654,13445
20211214,9호선2~3단계,선정릉,9665,10589,20254
20211214,9호선2~3단계,삼성중앙,6791,7131,13922
20211214,9호선2~3단계,봉은사,14993,15315,30308
20211214,9호선2~3단계,종합운동장,3878,3867,7745
20211214,9호선2~3단계,석촌고분,5957,6019,11976
20211214,9호선2~3단계,언주,10519,10756,21275
20211214,9호선2~3단계,송파나루,4774,5076,9850
20211214,9호선2~3단계,중앙보훈병원,10515,9350,19865
20211214,9호선2~3단계,둔촌오륜,1213,1133,2346
20211214,9호선2~3단계,석촌,8037,7073,15110
20211214,9호선2~3단계,한성백제,2484,2214,4698
20211214,9호선2~3단계,올림픽공원,5631,5535,11166
20211215,9호선2~3단계,둔촌오륜,1178,1069,2247
20211215,9호선2~3단계,올림픽공원,5654,5437,11091
20211215,9호선2~3단계,한성백제,2547,2291,4838
20211215,9호선2~3단계,송파나루,4689,5072,9761
20211215,9호선2~3단계,석촌,8091,7090,15181
20211215,9호선2~3단계,석촌고분,6009,5907,11916
20211215,9호선2~3단계,중앙보훈병원,10378,9073,19451
20211215,9호선2~3단계,종합운동장,3825,3843,7668
20211215,9호선2~3단계,봉은사,15998,16530,32528
20211215,9호선2~3단계,삼성중앙,6754,7236,13990
20211215,9호선2~3단계,선정릉,9568,10597,20165
20211215,9호선2~3단계,언주,10481,10802,21283
20211215,9호선2~3단계,삼전,6827,6502,13329
20211216,9호선2~3단계,언주,10315,10764,21079
20211216,9호선2~3단계,선정릉,9620,10610,20230
20211216,9호선2~3단계,삼성중앙,6558,7086,13644
20211216,9호선2~3단계,봉은사,16123,17060,33183
20211216,9호선2~3단계,종합운동장,3944,3895,7839
20211216,9호선2~3단계,삼전,6702,6367,13069
20211216,9호선2~3단계,석촌고분,5887,5825,11712
20211216,9호선2~3단계,송파나루,4895,5093,9988
20211216,9호선2~3단계,한성백제,2509,2335,4844
20211216,9호선2~3단계,올림픽공원,5610,5464,11074
20211216,9호선2~3단계,중앙보훈병원,10428,9220,19648
20211216,9호선2~3단계,석촌,8143,7044,15187
20211216,9호선2~3단계,둔촌오륜,1126,1097,2223
20211217,9호선2~3단계,언주,11308,11231,22539
20211217,9호선2~3단계,삼전,6999,6627,13626
20211217,9호선2~3단계,선정릉,9327,10414,19741
20211217,9호선2~3단계,삼성중앙,6635,7054,13689
20211217,9호선2~3단계,봉은사,18020,18659,36679
20211217,9호선2~3단계,종합운동장,4317,4049,8366
20211217,9호선2~3단계,석촌고분,6045,5873,11918
20211217,9호선2~3단계,송파나루,5263,5714,10977
20211217,9호선2~3단계,한성백제,2513,2292,4805
20211217,9호선2~3단계,올림픽공원,8403,8407,16810
20211217,9호선2~3단계,둔촌오륜,1226,1086,2312
20211217,9호선2~3단계,중앙보훈병원,9973,8520,18493
20211217,9호선2~3단계,석촌,8316,7106,15422
20211218,9호선2~3단계,선정릉,4600,5174,9774
20211218,9호선2~3단계,삼성중앙,3200,3242,6442
20211218,9호선2~3단계,봉은사,13450,13656,27106
20211218,9호선2~3단계,종합운동장,2906,2673,5579
20211218,9호선2~3단계,삼전,4943,4948,9891
20211218,9호선2~3단계,석촌고분,4207,4204,8411
20211218,9호선2~3단계,언주,6880,6711,13591
20211218,9호선2~3단계,송파나루,4082,4557,8639
20211218,9호선2~3단계,한성백제,1915,1626,3541
20211218,9호선2~3단계,올림픽공원,10218,9569,19787
20211218,9호선2~3단계,둔촌오륜,630,609,1239
20211218,9호선2~3단계,중앙보훈병원,3970,3783,7753
20211218,9호선2~3단계,석촌,6181,5324,11505
20211219,9호선2~3단계,중앙보훈병원,3079,2911,5990
20211219,9호선2~3단계,둔촌오륜,458,445,903
20211219,9호선2~3단계,올림픽공원,7557,7348,14905
20211219,9호선2~3단계,한성백제,1409,1286,2695
20211219,9호선2~3단계,송파나루,2997,3238,6235
20211219,9호선2~3단계,석촌,4490,3749,8239
20211219,9호선2~3단계,석촌고분,3050,2996,6046
20211219,9호선2~3단계,종합운동장,1997,1783,3780
20211219,9호선2~3단계,봉은사,9561,9524,19085
20211219,9호선2~3단계,삼성중앙,1900,2015,3915
20211219,9호선2~3단계,선정릉,2956,3352,6308
20211219,9호선2~3단계,언주,4120,4204,8324
20211219,9호선2~3단계,삼전,3522,3466,6988
20211220,9호선2~3단계,석촌,7903,6972,14875
20211220,9호선2~3단계,둔촌오륜,1179,1105,2284
20211220,9호선2~3단계,올림픽공원,6405,5576,11981
20211220,9호선2~3단계,중앙보훈병원,10894,9228,20122
20211220,9호선2~3단계,송파나루,4628,4850,9478
20211220,9호선2~3단계,석촌고분,5805,5779,11584
20211220,9호선2~3단계,한성백제,2373,2211,4584
20211220,9호선2~3단계,종합운동장,4016,3976,7992
20211220,9호선2~3단계,봉은사,14932,15183,30115
20211220,9호선2~3단계,삼성중앙,6443,6808,13251
20211220,9호선2~3단계,선정릉,9487,10313,19800
20211220,9호선2~3단계,언주,10587,10862,21449
20211220,9호선2~3단계,삼전,6649,6488,13137
20211221,9호선2~3단계,둔촌오륜,1196,1085,2281
20211221,9호선2~3단계,올림픽공원,5974,5883,11857
20211221,9호선2~3단계,한성백제,2562,2317,4879
20211221,9호선2~3단계,송파나루,4981,5197,10178
20211221,9호선2~3단계,석촌,8188,7410,15598
20211221,9호선2~3단계,석촌고분,5918,5941,11859
20211221,9호선2~3단계,중앙보훈병원,10545,9409,19954
20211221,9호선2~3단계,종합운동장,4092,4069,8161
20211221,9호선2~3단계,봉은사,15993,16159,32152
20211221,9호선2~3단계,삼성중앙,6729,7153,13882
20211221,9호선2~3단계,선정릉,9810,10645,20455
20211221,9호선2~3단계,언주,10863,11181,22044
20211221,9호선2~3단계,삼전,6735,6606,13341
20211222,9호선2~3단계,중앙보훈병원,10574,9404,19978
20211222,9호선2~3단계,둔촌오륜,1156,1039,2195
20211222,9호선2~3단계,올림픽공원,6219,6068,12287
20211222,9호선2~3단계,한성백제,2541,2348,4889
20211222,9호선2~3단계,송파나루,5033,5468,10501
20211222,9호선2~3단계,석촌,8230,7500,15730
20211222,9호선2~3단계,석촌고분,6085,6080,12165
20211222,9호선2~3단계,종합운동장,4056,4085,8141
20211222,9호선2~3단계,봉은사,18670,19188,37858
20211222,9호선2~3단계,삼성중앙,6731,7117,13848
20211222,9호선2~3단계,선정릉,9915,10728,20643
20211222,9호선2~3단계,언주,10997,11133,22130
20211222,9호선2~3단계,삼전,6886,6768,13654
20211223,9호선2~3단계,종합운동장,4213,4104,8317
20211223,9호선2~3단계,언주,11029,11191,22220
20211223,9호선2~3단계,선정릉,9848,10757,20605
20211223,9호선2~3단계,삼성중앙,6855,7155,14010
20211223,9호선2~3단계,봉은사,19958,21023,40981
20211223,9호선2~3단계,삼전,6851,6673,13524
20211223,9호선2~3단계,석촌고분,6149,6116,12265
20211223,9호선2~3단계,석촌,8348,7341,15689
20211223,9호선2~3단계,송파나루,5178,5546,10724
20211223,9호선2~3단계,한성백제,2515,2291,4806
20211223,9호선2~3단계,올림픽공원,6160,5881,12041
20211223,9호선2~3단계,둔촌오륜,1152,1055,2207
20211223,9호선2~3단계,중앙보훈병원,10533,9322,19855
20211224,9호선2~3단계,둔촌오륜,1097,992,2089
20211224,9호선2~3단계,올림픽공원,7582,7539,15121
20211224,9호선2~3단계,한성백제,2589,2377,4966
20211224,9호선2~3단계,송파나루,5699,6015,11714
20211224,9호선2~3단계,석촌,8581,7666,16247
20211224,9호선2~3단계,석촌고분,6269,6081,12350
20211224,9호선2~3단계,중앙보훈병원,9701,8400,18101
20211224,9호선2~3단계,종합운동장,4278,3988,8266
20211224,9호선2~3단계,봉은사,19812,20661,40473
20211224,9호선2~3단계,삼성중앙,6431,6546,12977
20211224,9호선2~3단계,선정릉,9207,9898,19105
20211224,9호선2~3단계,언주,11097,10831,21928
20211224,9호선2~3단계,삼전,6934,6785,13719
20211225,9호선2~3단계,언주,3916,3960,7876
20211225,9호선2~3단계,선정릉,2782,3096,5878
20211225,9호선2~3단계,삼성중앙,2070,2048,4118
20211225,9호선2~3단계,봉은사,15217,16641,31858
20211225,9호선2~3단계,종합운동장,2250,1927,4177
20211225,9호선2~3단계,삼전,3849,3703,7552
20211225,9호선2~3단계,석촌고분,3276,3365,6641
20211225,9호선2~3단계,송파나루,4185,4418,8603
20211225,9호선2~3단계,한성백제,1310,1181,2491
20211225,9호선2~3단계,올림픽공원,6658,6266,12924
20211225,9호선2~3단계,둔촌오륜,407,425,832
20211225,9호선2~3단계,중앙보훈병원,3035,2791,5826
20211225,9호선2~3단계,석촌,4750,4095,8845
20211226,9호선2~3단계,종합운동장,1735,1530,3265
20211226,9호선2~3단계,선정릉,2422,2657,5079
20211226,9호선2~3단계,삼성중앙,1577,1732,3309
20211226,9호선2~3단계,봉은사,11366,12442,23808
20211226,9호선2~3단계,언주,3387,3335,6722
20211226,9호선2~3단계,삼전,2922,3054,5976
20211226,9호선2~3단계,한성백제,1026,987,2013
20211226,9호선2~3단계,석촌,3660,3212,6872
20211226,9호선2~3단계,송파나루,2850,3033,5883
20211226,9호선2~3단계,올림픽공원,5974,5852,11826
20211226,9호선2~3단계,둔촌오륜,373,384,757
20211226,9호선2~3단계,중앙보훈병원,2637,2524,5161
20211226,9호선2~3단계,석촌고분,2596,2632,5228
20211227,9호선2~3단계,둔촌오륜,1073,1001,2074
20211227,9호선2~3단계,올림픽공원,5264,5206,10470
20211227,9호선2~3단계,한성백제,2242,2023,4265
20211227,9호선2~3단계,송파나루,4668,5009,9677
20211227,9호선2~3단계,석촌,7582,6897,14479
20211227,9호선2~3단계,석촌고분,5612,5694,11306
20211227,9호선2~3단계,중앙보훈병원,9139,8163,17302
20211227,9호선2~3단계,종합운동장,3845,3827,7672
20211227,9호선2~3단계,봉은사,14446,14620,29066
20211227,9호선2~3단계,삼성중앙,6364,6662,13026
20211227,9호선2~3단계,선정릉,8832,9571,18403
20211227,9호선2~3단계,언주,10188,10485,20673
20211227,9호선2~3단계,삼전,6287,6278,12565
20211228,9호선2~3단계,언주,10822,10946,21768
20211228,9호선2~3단계,선정릉,9277,10171,19448
20211228,9호선2~3단계,삼성중앙,6665,7079,13744
20211228,9호선2~3단계,봉은사,14712,14897,29609
20211228,9호선2~3단계,종합운동장,3897,3873,7770
20211228,9호선2~3단계,삼전,6521,6378,12899
20211228,9호선2~3단계,석촌고분,5984,5992,11976
20211228,9호선2~3단계,송파나루,4976,5281,10257
20211228,9호선2~3단계,한성백제,2380,2203,4583
20211228,9호선2~3단계,올림픽공원,5527,5520,11047
20211228,9호선2~3단계,둔촌오륜,1113,1056,2169
20211228,9호선2~3단계,중앙보훈병원,10011,8916,18927
20211228,9호선2~3단계,석촌,8018,7122,15140
20211229,9호선2~3단계,송파나루,5183,5410,10593
20211229,9호선2~3단계,둔촌오륜,1155,1091,2246
20211229,9호선2~3단계,올림픽공원,5646,5662,11308
20211229,9호선2~3단계,한성백제,2341,2099,4440
20211229,9호선2~3단계,중앙보훈병원,9966,8856,18822
20211229,9호선2~3단계,석촌,8126,7289,15415
20211229,9호선2~3단계,봉은사,15432,15544,30976
20211229,9호선2~3단계,삼전,6627,6507,13134
20211229,9호선2~3단계,종합운동장,4098,4086,8184
20211229,9호선2~3단계,삼성중앙,6586,6990,13576
20211229,9호선2~3단계,선정릉,9260,10104,19364
20211229,9호선2~3단계,언주,10373,10640,21013
20211229,9호선2~3단계,석촌고분,6086,6116,12202
20211230,9호선2~3단계,중앙보훈병원,9732,8581,18313
20211230,9호선2~3단계,둔촌오륜,1086,988,2074
20211230,9호선2~3단계,올림픽공원,5440,5538,10978
20211230,9호선2~3단계,송파나루,5223,5440,10663
20211230,9호선2~3단계,석촌,8143,7024,15167
20211230,9호선2~3단계,석촌고분,5882,5832,11714
20211230,9호선2~3단계,한성백제,2330,2152,4482
20211230,9호선2~3단계,종합운동장,3853,3753,7606
20211230,9호선2~3단계,봉은사,15148,15455,30603
20211230,9호선2~3단계,삼성중앙,6395,6673,13068
20211230,9호선2~3단계,선정릉,8858,9655,18513
20211230,9호선2~3단계,언주,9849,10028,19877
20211230,9호선2~3단계,삼전,6598,6504,13102
20211231,9호선2~3단계,올림픽공원,7233,7385,14618
20211231,9호선2~3단계,한성백제,2099,1841,3940
20211231,9호선2~3단계,송파나루,5099,5268,10367
20211231,9호선2~3단계,석촌,7414,6447,13861
20211231,9호선2~3단계,석촌고분,5534,5349,10883
20211231,9호선2~3단계,봉은사,13774,13893,27667
20211231,9호선2~3단계,종합운동장,3584,3548,7132
20211231,9호선2~3단계,삼성중앙,5308,5423,10731
20211231,9호선2~3단계,선정릉,7239,7620,14859
20211231,9호선2~3단계,언주,8595,8242,16837
20211231,9호선2~3단계,둔촌오륜,734,778,1512
20211231,9호선2~3단계,삼전,6300,5821,12121
20211231,9호선2~3단계,중앙보훈병원,7979,7096,15075
