사용일자,호선명,지하철역,승차총승객수,하차총승객수,승하차총승객수
20210101,안산선,산본,4196,4530,8726
20210101,안산선,수리산,1062,968,2030
20210101,안산선,오이도,3185,3299,6484
20210101,안산선,정왕,2906,2759,5665
20210101,안산선,안산,4941,5147,10088
20210101,안산선,초지,1072,1214,2286
20210101,안산선,신길온천,525,499,1024
20210101,안산선,중앙,4962,5197,10159
20210101,안산선,한대앞,2416,2573,4989
20210101,안산선,상록수,4734,4921,9655
20210101,안산선,반월,1307,1311,2618
20210101,안산선,대야미,1445,1322,2767
20210101,안산선,고잔,2051,1879,3930
20210102,안산선,한대앞,3554,3474,7028
20210102,안산선,산본,6411,6840,13251
20210102,안산선,대야미,2139,1896,4035
20210102,안산선,반월,1901,1811,3712
20210102,안산선,상록수,6973,6779,13752
20210102,안산선,중앙,7328,7575,14903
20210102,안산선,정왕,3168,3394,6562
20210102,안산선,초지,1548,1589,3137
20210102,안산선,안산,6299,6274,12573
20210102,안산선,신길온천,719,710,1429
20210102,안산선,오이도,4031,4040,8071
20210102,안산선,수리산,1670,1570,3240
20210102,안산선,고잔,2905,2686,5591
20210103,안산선,초지,1168,1115,2283
20210103,안산선,수리산,1190,1164,2354
20210103,안산선,오이도,3068,3014,6082
20210103,안산선,정왕,2844,3227,6071
20210103,안산선,안산,6229,5181,11410
20210103,안산선,고잔,2318,2176,4494
20210103,안산선,신길온천,683,567,1250
20210103,안산선,한대앞,2776,2744,5520
20210103,안산선,상록수,5530,5287,10817
20210103,안산선,중앙,5838,5598,11436
20210103,안산선,반월,1410,1438,2848
20210103,안산선,대야미,1621,1523,3144
20210103,안산선,산본,4818,5052,9870
20210104,안산선,고잔,6987,6648,13635
20210104,안산선,산본,12625,13549,26174
20210104,안산선,대야미,3915,3653,7568
20210104,안산선,반월,3419,3295,6714
20210104,안산선,상록수,13086,13257,26343
20210104,안산선,한대앞,6587,6636,13223
20210104,안산선,중앙,12631,12890,25521
20210104,안산선,안산,10028,8952,18980
20210104,안산선,신길온천,1328,1226,2554
20210104,안산선,정왕,5993,6723,12716
20210104,안산선,오이도,6491,6135,12626
20210104,안산선,수리산,3503,2958,6461
20210104,안산선,초지,3496,3567,7063
20210105,안산선,산본,12497,13395,25892
20210105,안산선,대야미,3882,3557,7439
20210105,안산선,반월,3429,3260,6689
20210105,안산선,상록수,13068,13295,26363
20210105,안산선,한대앞,6488,6536,13024
20210105,안산선,중앙,12249,12628,24877
20210105,안산선,고잔,6936,6663,13599
20210105,안산선,안산,9797,8794,18591
20210105,안산선,신길온천,1254,1146,2400
20210105,안산선,정왕,5864,6207,12071
20210105,안산선,오이도,6402,6202,12604
20210105,안산선,수리산,3573,2951,6524
20210105,안산선,초지,3589,3674,7263
20210106,안산선,중앙,12659,13272,25931
20210106,안산선,산본,12728,14236,26964
20210106,안산선,대야미,3852,3603,7455
20210106,안산선,반월,3355,3355,6710
20210106,안산선,한대앞,6572,6809,13381
20210106,안산선,고잔,7163,6857,14020
20210106,안산선,상록수,12898,13724,26622
20210106,안산선,안산,10222,8980,19202
20210106,안산선,수리산,3487,3045,6532
20210106,안산선,오이도,6560,6788,13348
20210106,안산선,초지,3483,3641,7124
20210106,안산선,신길온천,1313,1223,2536
20210106,안산선,정왕,6192,6653,12845
20210107,안산선,산본,14573,15209,29782
20210107,안산선,대야미,4403,4043,8446
20210107,안산선,반월,3699,3631,7330
20210107,안산선,상록수,14392,14343,28735
20210107,안산선,중앙,14293,14545,28838
20210107,안산선,고잔,8193,7862,16055
20210107,안산선,한대앞,7576,7567,15143
20210107,안산선,안산,11556,11151,22707
20210107,안산선,신길온천,1435,1327,2762
20210107,안산선,정왕,7120,7991,15111
20210107,안산선,오이도,7731,7448,15179
20210107,안산선,수리산,3872,3258,7130
20210107,안산선,초지,4084,4120,8204
20210108,안산선,한대앞,6697,6727,13424
20210108,안산선,산본,12718,11943,24661
20210108,안산선,대야미,3930,3537,7467
20210108,안산선,반월,3377,3161,6538
20210108,안산선,상록수,13153,13178,26331
20210108,안산선,중앙,12724,13600,26324
20210108,안산선,오이도,6621,6486,13107
20210108,안산선,초지,3629,3687,7316
20210108,안산선,안산,10290,9431,19721
20210108,안산선,신길온천,1300,1200,2500
20210108,안산선,정왕,6342,6731,13073
20210108,안산선,수리산,3465,2613,6078
20210108,안산선,고잔,7188,6816,14004
20210109,안산선,중앙,8893,9288,18181
20210109,안산선,대야미,2363,2085,4448
20210109,안산선,반월,2205,2070,4275
20210109,안산선,상록수,8076,8160,16236
20210109,안산선,한대앞,4305,4433,8738
20210109,안산선,산본,7640,6908,14548
20210109,안산선,고잔,3717,3666,7383
20210109,안산선,안산,6399,6416,12815
20210109,안산선,신길온천,799,771,1570
20210109,안산선,정왕,3975,3985,7960
20210109,안산선,오이도,4153,4243,8396
20210109,안산선,수리산,1861,1655,3516
20210109,안산선,초지,1975,2020,3995
20210110,안산선,대야미,1680,1524,3204
20210110,안산선,반월,1424,1504,2928
20210110,안산선,상록수,5626,5510,11136
20210110,안산선,한대앞,3024,2981,6005
20210110,안산선,중앙,6295,6171,12466
20210110,안산선,고잔,2439,2333,4772
20210110,안산선,산본,4923,4359,9282
20210110,안산선,안산,6123,5547,11670
20210110,안산선,신길온천,604,560,1164
20210110,안산선,정왕,2969,3182,6151
20210110,안산선,오이도,3103,3024,6127
20210110,안산선,수리산,1258,1184,2442
20210110,안산선,초지,1309,1271,2580
20210111,안산선,초지,3620,3658,7278
20210111,안산선,안산,10185,9230,19415
20210111,안산선,신길온천,1297,1189,2486
20210111,안산선,정왕,6041,6720,12761
20210111,안산선,오이도,6583,6328,12911
20210111,안산선,수리산,3437,2847,6284
20210111,안산선,고잔,7180,6834,14014
20210111,안산선,한대앞,6705,6770,13475
20210111,안산선,상록수,13095,13287,26382
20210111,안산선,반월,3452,3252,6704
20210111,안산선,대야미,3905,3595,7500
20210111,안산선,산본,12664,11627,24291
20210111,안산선,중앙,13005,13367,26372
20210112,안산선,한대앞,7073,7353,14426
20210112,안산선,산본,13238,12477,25715
20210112,안산선,대야미,4063,3902,7965
20210112,안산선,반월,3530,3639,7169
20210112,안산선,상록수,13498,14493,27991
20210112,안산선,중앙,13655,14541,28196
20210112,안산선,정왕,7293,7033,14326
20210112,안산선,초지,3854,3943,7797
20210112,안산선,안산,11709,9415,21124
20210112,안산선,신길온천,1524,1310,2834
20210112,안산선,고잔,7677,7229,14906
20210112,안산선,오이도,7479,7369,14848
20210112,안산선,수리산,3714,3217,6931
20210113,안산선,수리산,3871,3082,6953
20210113,안산선,오이도,7424,7074,14498
20210113,안산선,정왕,6460,7592,14052
20210113,안산선,신길온천,1382,1377,2759
20210113,안산선,안산,10595,10158,20753
20210113,안산선,초지,3914,3978,7892
20210113,안산선,고잔,7750,7654,15404
20210113,안산선,중앙,13893,14387,28280
20210113,안산선,한대앞,7304,7249,14553
20210113,안산선,상록수,13977,13932,27909
20210113,안산선,반월,3725,3576,7301
20210113,안산선,대야미,4342,3827,8169
20210113,안산선,산본,14059,12181,26240
20210114,안산선,오이도,6859,6752,13611
20210114,안산선,정왕,6111,6720,12831
20210114,안산선,신길온천,1374,1304,2678
20210114,안산선,안산,10379,9329,19708
20210114,안산선,초지,3795,3888,7683
20210114,안산선,고잔,7372,7067,14439
20210114,안산선,수리산,3616,3031,6647
20210114,안산선,한대앞,7205,7124,14329
20210114,안산선,상록수,13622,13735,27357
20210114,안산선,반월,3606,3448,7054
20210114,안산선,대야미,4099,3752,7851
20210114,안산선,산본,13366,13557,26923
20210114,안산선,중앙,13355,13889,27244
20210115,안산선,오이도,7114,6851,13965
20210115,안산선,정왕,6780,7136,13916
20210115,안산선,신길온천,1456,1326,2782
20210115,안산선,안산,10603,9577,20180
20210115,안산선,초지,3920,3943,7863
20210115,안산선,고잔,7526,7151,14677
20210115,안산선,수리산,3544,2824,6368
20210115,안산선,한대앞,7310,7196,14506
20210115,안산선,상록수,13768,13959,27727
20210115,안산선,반월,3558,3437,6995
20210115,안산선,대야미,4194,3699,7893
20210115,안산선,산본,13389,14825,28214
20210115,안산선,중앙,13701,14830,28531
20210116,안산선,수리산,2149,1890,4039
20210116,안산선,오이도,5058,5266,10324
20210116,안산선,정왕,4333,4524,8857
20210116,안산선,신길온천,995,980,1975
20210116,안산선,안산,7713,8062,15775
20210116,안산선,초지,2130,2182,4312
20210116,안산선,고잔,4098,4038,8136
20210116,안산선,한대앞,4840,4840,9680
20210116,안산선,상록수,9119,9472,18591
20210116,안산선,반월,2564,2300,4864
20210116,안산선,대야미,2842,2455,5297
20210116,안산선,산본,8549,9301,17850
20210116,안산선,중앙,10054,10617,20671
20210117,안산선,중앙,7267,6990,14257
20210117,안산선,대야미,1915,1817,3732
20210117,안산선,반월,1637,1694,3331
20210117,안산선,상록수,6249,6255,12504
20210117,안산선,한대앞,3448,3368,6816
20210117,안산선,고잔,2776,2654,5430
20210117,안산선,산본,5826,6282,12108
20210117,안산선,안산,7113,6451,13564
20210117,안산선,수리산,1373,1372,2745
20210117,안산선,오이도,3786,3589,7375
20210117,안산선,초지,1439,1354,2793
20210117,안산선,신길온천,721,636,1357
20210117,안산선,정왕,3423,3749,7172
20210118,안산선,정왕,6839,7598,14437
20210118,안산선,신길온천,1497,1285,2782
20210118,안산선,수리산,3741,3062,6803
20210118,안산선,산본,14048,15268,29316
20210118,안산선,대야미,4209,3886,8095
20210118,안산선,반월,3714,3544,7258
20210118,안산선,오이도,7439,7054,14493
20210118,안산선,한대앞,7519,7427,14946
20210118,안산선,중앙,14565,14965,29530
20210118,안산선,고잔,8116,7666,15782
20210118,안산선,초지,3900,3955,7855
20210118,안산선,안산,11069,10307,21376
20210118,안산선,상록수,14174,14261,28435
20210119,안산선,수리산,3563,2917,6480
20210119,안산선,오이도,6698,6500,13198
20210119,안산선,정왕,6192,6589,12781
20210119,안산선,신길온천,1341,1226,2567
20210119,안산선,안산,10410,9112,19522
20210119,안산선,초지,3816,3853,7669
20210119,안산선,고잔,7247,6994,14241
20210119,안산선,한대앞,6826,6916,13742
20210119,안산선,상록수,13487,13732,27219
20210119,안산선,반월,3533,3426,6959
20210119,안산선,산본,13155,14135,27290
20210119,안산선,중앙,13597,14024,27621
20210119,안산선,대야미,3979,3641,7620
20210120,안산선,산본,14052,15129,29181
20210120,안산선,중앙,14518,15009,29527
20210120,안산선,대야미,4332,3950,8282
20210120,안산선,반월,3728,3615,7343
20210120,안산선,상록수,14196,14447,28643
20210120,안산선,한대앞,7284,7330,14614
20210120,안산선,고잔,7686,7362,15048
20210120,안산선,안산,10666,9571,20237
20210120,안산선,신길온천,1450,1312,2762
20210120,안산선,정왕,6513,7019,13532
20210120,안산선,오이도,7235,7000,14235
20210120,안산선,수리산,3812,3103,6915
20210120,안산선,초지,4042,4073,8115
20210121,안산선,대야미,4072,3722,7794
20210121,안산선,반월,3653,3524,7177
20210121,안산선,상록수,13766,13955,27721
20210121,안산선,한대앞,6920,6985,13905
20210121,안산선,중앙,13694,14219,27913
20210121,안산선,고잔,7363,7108,14471
20210121,안산선,산본,13626,14497,28123
20210121,안산선,안산,10071,9026,19097
20210121,안산선,신길온천,1373,1281,2654
20210121,안산선,정왕,6196,6687,12883
20210121,안산선,오이도,6825,6612,13437
20210121,안산선,수리산,3656,3001,6657
20210121,안산선,초지,3790,3872,7662
20210122,안산선,산본,14113,15238,29351
20210122,안산선,대야미,4440,3966,8406
20210122,안산선,반월,3830,3628,7458
20210122,안산선,상록수,14196,14536,28732
20210122,안산선,한대앞,7382,7542,14924
20210122,안산선,중앙,14587,15783,30370
20210122,안산선,고잔,7685,7374,15059
20210122,안산선,안산,10931,9833,20764
20210122,안산선,신길온천,1424,1304,2728
20210122,안산선,정왕,7592,7720,15312
20210122,안산선,오이도,7389,7173,14562
20210122,안산선,수리산,3709,2974,6683
20210122,안산선,초지,4021,4064,8085
20210123,안산선,초지,2405,2437,4842
20210123,안산선,수리산,2273,2131,4404
20210123,안산선,오이도,5600,5880,11480
20210123,안산선,정왕,4864,4816,9680
20210123,안산선,안산,8134,8291,16425
20210123,안산선,고잔,4779,4611,9390
20210123,안산선,신길온천,1083,1061,2144
20210123,안산선,한대앞,5359,5451,10810
20210123,안산선,상록수,9974,9951,19925
20210123,안산선,중앙,12526,12895,25421
20210123,안산선,반월,2643,2562,5205
20210123,안산선,대야미,3063,2665,5728
20210123,안산선,산본,9610,10334,19944
20210124,안산선,수리산,1604,1686,3290
20210124,안산선,오이도,4409,4458,8867
20210124,안산선,정왕,3656,3829,7485
20210124,안산선,신길온천,816,758,1574
20210124,안산선,안산,7820,7038,14858
20210124,안산선,초지,1597,1617,3214
20210124,안산선,고잔,3141,2977,6118
20210124,안산선,중앙,8869,8521,17390
20210124,안산선,한대앞,3835,3707,7542
20210124,안산선,상록수,7067,6953,14020
20210124,안산선,반월,1945,1910,3855
20210124,안산선,대야미,2309,2116,4425
20210124,안산선,산본,6508,6865,13373
20210125,안산선,오이도,7367,7065,14432
20210125,안산선,정왕,6616,7249,13865
20210125,안산선,신길온천,1455,1327,2782
20210125,안산선,안산,11096,9989,21085
20210125,안산선,초지,4068,4091,8159
20210125,안산선,고잔,8074,7730,15804
20210125,안산선,수리산,3872,3259,7131
20210125,안산선,한대앞,7695,7794,15489
20210125,안산선,상록수,14610,14689,29299
20210125,안산선,반월,3917,3749,7666
20210125,안산선,대야미,4458,4070,8528
20210125,안산선,산본,14499,15498,29997
20210125,안산선,중앙,15284,15410,30694
20210126,안산선,오이도,7214,6988,14202
20210126,안산선,정왕,6270,6824,13094
20210126,안산선,신길온천,1420,1315,2735
20210126,안산선,안산,10448,9303,19751
20210126,안산선,초지,3833,4006,7839
20210126,안산선,고잔,7554,7295,14849
20210126,안산선,수리산,3677,3052,6729
20210126,안산선,한대앞,7236,7317,14553
20210126,안산선,상록수,14067,14320,28387
20210126,안산선,반월,3677,3563,7240
20210126,안산선,대야미,4257,3786,8043
20210126,안산선,산본,13894,14311,28205
20210126,안산선,중앙,14568,14929,29497
20210127,안산선,수리산,3962,3245,7207
20210127,안산선,오이도,7520,7219,14739
20210127,안산선,정왕,6515,7096,13611
20210127,안산선,신길온천,1488,1403,2891
20210127,안산선,안산,11008,9782,20790
20210127,안산선,초지,3989,4056,8045
20210127,안산선,고잔,7852,7569,15421
20210127,안산선,한대앞,7597,7747,15344
20210127,안산선,상록수,14667,14752,29419
20210127,안산선,반월,3926,3762,7688
20210127,안산선,대야미,4404,4010,8414
20210127,안산선,산본,14816,15746,30562
20210127,안산선,중앙,15399,15822,31221
20210128,안산선,초지,3897,3984,7881
20210128,안산선,오이도,6986,6792,13778
20210128,안산선,정왕,6362,6863,13225
20210128,안산선,신길온천,1324,1235,2559
20210128,안산선,안산,10519,9420,19939
20210128,안산선,고잔,7587,7385,14972
20210128,안산선,수리산,3674,3029,6703
20210128,안산선,한대앞,7182,7245,14427
20210128,안산선,산본,14007,14871,28878
20210128,안산선,대야미,4257,3837,8094
20210128,안산선,중앙,14642,15094,29736
20210128,안산선,상록수,13914,14139,28053
20210128,안산선,반월,3673,3522,7195
20210129,안산선,오이도,7082,6928,14010
20210129,안산선,정왕,6507,6756,13263
20210129,안산선,신길온천,1402,1298,2700
20210129,안산선,안산,10369,9314,19683
20210129,안산선,초지,3802,3943,7745
20210129,안산선,고잔,7390,7092,14482
20210129,안산선,수리산,3599,2747,6346
20210129,안산선,한대앞,7222,7195,14417
20210129,안산선,상록수,13800,14098,27898
20210129,안산선,반월,3574,3441,7015
20210129,안산선,대야미,4157,3754,7911
20210129,안산선,산본,13899,14944,28843
20210129,안산선,중앙,14480,15398,29878
20210130,안산선,수리산,2266,2011,4277
20210130,안산선,오이도,5599,5720,11319
20210130,안산선,정왕,4719,4903,9622
20210130,안산선,신길온천,1091,1060,2151
20210130,안산선,안산,8090,8526,16616
20210130,안산선,초지,2517,2506,5023
20210130,안산선,고잔,4641,4606,9247
20210130,안산선,한대앞,5383,5393,10776
20210130,안산선,상록수,9997,10039,20036
20210130,안산선,반월,2769,2500,5269
20210130,안산선,산본,9758,10396,20154
20210130,안산선,중앙,11874,12467,24341
20210130,안산선,대야미,3129,2664,5793
20210131,안산선,수리산,1598,1613,3211
20210131,안산선,초지,1730,1663,3393
20210131,안산선,오이도,4297,4240,8537
20210131,안산선,정왕,3607,3867,7474
20210131,안산선,신길온천,888,791,1679
20210131,안산선,안산,7607,6960,14567
20210131,안산선,고잔,3159,3006,6165
20210131,안산선,한대앞,3852,3652,7504
20210131,안산선,상록수,7246,7166,14412
20210131,안산선,반월,1831,1852,3683
20210131,안산선,대야미,2363,2109,4472
20210131,안산선,산본,6767,7197,13964
20210131,안산선,중앙,8679,8532,17211
20210201,안산선,대야미,4377,3976,8353
20210201,안산선,반월,3906,3754,7660
20210201,안산선,상록수,14475,14629,29104
20210201,안산선,한대앞,7446,7493,14939
20210201,안산선,중앙,14994,15434,30428
20210201,안산선,고잔,7909,7431,15340
20210201,안산선,산본,14494,15511,30005
20210201,안산선,안산,11178,10119,21297
20210201,안산선,신길온천,1463,1335,2798
20210201,안산선,정왕,6607,7153,13760
20210201,안산선,오이도,7257,6960,14217
20210201,안산선,수리산,3851,3177,7028
20210201,안산선,초지,3954,4005,7959
20210202,안산선,산본,14234,15260,29494
20210202,안산선,대야미,4363,3947,8310
20210202,안산선,반월,3661,3503,7164
20210202,안산선,상록수,14000,14313,28313
20210202,안산선,한대앞,7427,7391,14818
20210202,안산선,중앙,14987,15287,30274
20210202,안산선,고잔,7757,7437,15194
20210202,안산선,안산,10597,9552,20149
20210202,안산선,신길온천,1457,1329,2786
20210202,안산선,정왕,6304,6747,13051
20210202,안산선,오이도,7172,6890,14062
20210202,안산선,수리산,3727,3168,6895
20210202,안산선,초지,4017,4076,8093
20210203,안산선,초지,4151,4159,8310
20210203,안산선,오이도,7648,7399,15047
20210203,안산선,정왕,6458,7180,13638
20210203,안산선,신길온천,1521,1409,2930
20210203,안산선,안산,10998,9908,20906
20210203,안산선,고잔,8054,7701,15755
20210203,안산선,수리산,3915,3255,7170
20210203,안산선,한대앞,7657,7825,15482
20210203,안산선,산본,14976,16140,31116
20210203,안산선,대야미,4583,4168,8751
20210203,안산선,중앙,15571,15850,31421
20210203,안산선,상록수,14598,15065,29663
20210203,안산선,반월,3992,3854,7846
20210204,안산선,대야미,4618,4162,8780
20210204,안산선,산본,15492,16219,31711
20210204,안산선,수리산,3976,3175,7151
20210204,안산선,오이도,7805,7418,15223
20210204,안산선,신길온천,1464,1370,2834
20210204,안산선,안산,11130,10371,21501
20210204,안산선,정왕,6874,7493,14367
20210204,안산선,고잔,8275,7974,16249
20210204,안산선,중앙,15622,15963,31585
20210204,안산선,한대앞,7956,7850,15806
20210204,안산선,상록수,15155,15031,30186
20210204,안산선,반월,3945,3822,7767
20210204,안산선,초지,4105,4171,8276
20210205,안산선,한대앞,7784,7811,15595
20210205,안산선,대야미,4635,4105,8740
20210205,안산선,산본,15041,16358,31399
20210205,안산선,반월,3948,3847,7795
20210205,안산선,상록수,15238,15524,30762
20210205,안산선,중앙,15855,16646,32501
20210205,안산선,오이도,7882,7643,15525
20210205,안산선,초지,4338,4647,8985
20210205,안산선,안산,11115,10104,21219
20210205,안산선,신길온천,1555,1430,2985
20210205,안산선,정왕,6910,7266,14176
20210205,안산선,수리산,3989,3136,7125
20210205,안산선,고잔,7930,7603,15533
20210206,안산선,산본,10250,11043,21293
20210206,안산선,대야미,3303,2819,6122
20210206,안산선,반월,2855,2635,5490
20210206,안산선,상록수,10431,10563,20994
20210206,안산선,중앙,12443,12908,25351
20210206,안산선,한대앞,5704,5660,11364
20210206,안산선,고잔,4847,4672,9519
20210206,안산선,안산,8255,8084,16339
20210206,안산선,신길온천,1117,1097,2214
20210206,안산선,정왕,5029,5019,10048
20210206,안산선,오이도,6178,6282,12460
20210206,안산선,수리산,2441,2122,4563
20210206,안산선,초지,2532,2715,5247
20210207,안산선,대야미,2183,2089,4272
20210207,안산선,반월,1908,1892,3800
20210207,안산선,상록수,7588,7429,15017
20210207,안산선,한대앞,4002,3960,7962
20210207,안산선,중앙,8859,8772,17631
20210207,안산선,고잔,3118,3042,6160
20210207,안산선,산본,6871,7195,14066
20210207,안산선,안산,7507,6985,14492
20210207,안산선,신길온천,840,829,1669
20210207,안산선,정왕,3945,4191,8136
20210207,안산선,오이도,4503,4371,8874
20210207,안산선,수리산,1653,1540,3193
20210207,안산선,초지,1718,1729,3447
20210208,안산선,수리산,3900,3154,7054
20210208,안산선,오이도,7475,7231,14706
20210208,안산선,신길온천,1489,1353,2842
20210208,안산선,안산,10778,9778,20556
20210208,안산선,초지,4034,4126,8160
20210208,안산선,고잔,7813,7504,15317
20210208,안산선,중앙,15293,15662,30955
20210208,안산선,상록수,14614,14714,29328
20210208,안산선,반월,3847,3700,7547
20210208,안산선,대야미,4390,3988,8378
20210208,안산선,산본,14908,15877,30785
20210208,안산선,정왕,6654,7274,13928
20210208,안산선,한대앞,7647,7492,15139
20210209,안산선,수리산,3922,3142,7064
20210209,안산선,오이도,7502,7227,14729
20210209,안산선,정왕,6562,7035,13597
20210209,안산선,신길온천,1500,1348,2848
20210209,안산선,안산,10711,9998,20709
20210209,안산선,초지,4048,4212,8260
20210209,안산선,고잔,7915,7523,15438
20210209,안산선,한대앞,7687,7743,15430
20210209,안산선,산본,15015,16079,31094
20210209,안산선,대야미,4546,4089,8635
20210209,안산선,중앙,15262,15760,31022
20210209,안산선,상록수,14641,14908,29549
20210209,안산선,반월,3888,3719,7607
20210210,안산선,초지,3853,4024,7877
20210210,안산선,고잔,7602,7384,14986
20210210,안산선,중앙,15260,16172,31432
20210210,안산선,한대앞,7639,7596,15235
20210210,안산선,상록수,14320,13940,28260
20210210,안산선,반월,3946,3588,7534
20210210,안산선,신길온천,1495,1404,2899
20210210,안산선,산본,14348,14723,29071
20210210,안산선,수리산,3765,2673,6438
20210210,안산선,오이도,7561,7287,14848
20210210,안산선,정왕,7310,7216,14526
20210210,안산선,안산,11720,11260,22980
20210210,안산선,대야미,4470,3568,8038
20210211,안산선,오이도,4291,4626,8917
20210211,안산선,산본,6275,6700,12975
20210211,안산선,대야미,2019,1760,3779
20210211,안산선,반월,1900,1881,3781
20210211,안산선,상록수,6992,7464,14456
20210211,안산선,한대앞,3683,3775,7458
20210211,안산선,중앙,7671,8600,16271
20210211,안산선,수리산,1537,1358,2895
20210211,안산선,정왕,4566,3916,8482
20210211,안산선,신길온천,797,822,1619
20210211,안산선,초지,1582,1793,3375
20210211,안산선,고잔,2956,3035,5991
20210211,안산선,안산,8767,9317,18084
20210212,안산선,수리산,1164,1109,2273
20210212,안산선,초지,1268,1301,2569
20210212,안산선,오이도,3670,3838,7508
20210212,안산선,정왕,3510,3645,7155
20210212,안산선,신길온천,642,610,1252
20210212,안산선,안산,7691,8065,15756
20210212,안산선,고잔,2390,2227,4617
20210212,안산선,한대앞,3018,2966,5984
20210212,안산선,상록수,5778,5742,11520
20210212,안산선,반월,1496,1380,2876
20210212,안산선,대야미,1547,1365,2912
20210212,안산선,산본,4350,4584,8934
20210212,안산선,중앙,6166,6304,12470
20210213,안산선,오이도,6377,6505,12882
20210213,안산선,정왕,4026,4601,8627
20210213,안산선,신길온천,950,902,1852
20210213,안산선,안산,9208,8977,18185
20210213,안산선,초지,1963,1838,3801
20210213,안산선,고잔,3518,3212,6730
20210213,안산선,수리산,1811,1788,3599
20210213,안산선,한대앞,4066,4028,8094
20210213,안산선,상록수,8034,7766,15800
20210213,안산선,반월,2148,1989,4137
20210213,안산선,대야미,2561,2196,4757
20210213,안산선,산본,7682,8164,15846
20210213,안산선,중앙,10417,10167,20584
20210214,안산선,수리산,1631,1541,3172
20210214,안산선,오이도,4987,4894,9881
20210214,안산선,정왕,4067,4506,8573
20210214,안산선,신길온천,922,817,1739
20210214,안산선,안산,8607,7395,16002
20210214,안산선,초지,1914,1765,3679
20210214,안산선,고잔,3327,3116,6443
20210214,안산선,한대앞,3951,3842,7793
20210214,안산선,상록수,7684,7313,14997
20210214,안산선,반월,1988,2047,4035
20210214,안산선,대야미,2288,2129,4417
20210214,안산선,산본,6802,7387,14189
20210214,안산선,중앙,9942,9468,19410
20210215,안산선,초지,3999,4087,8086
20210215,안산선,수리산,3659,3075,6734
20210215,안산선,오이도,7560,7182,14742
20210215,안산선,정왕,6501,7222,13723
20210215,안산선,안산,10602,9661,20263
20210215,안산선,고잔,7801,7453,15254
20210215,안산선,신길온천,1444,1315,2759
20210215,안산선,한대앞,7421,7505,14926
20210215,안산선,산본,14665,15638,30303
20210215,안산선,대야미,4318,3888,8206
20210215,안산선,중앙,15515,15822,31337
20210215,안산선,상록수,14460,14385,28845
20210215,안산선,반월,3764,3584,7348
20210216,안산선,수리산,3875,3180,7055
20210216,안산선,오이도,7418,7220,14638
20210216,안산선,정왕,6604,7175,13779
20210216,안산선,산본,14769,15810,30579
20210216,안산선,반월,3838,3690,7528
20210216,안산선,상록수,14492,14841,29333
20210216,안산선,대야미,4413,3992,8405
20210216,안산선,중앙,15384,15872,31256
20210216,안산선,고잔,8059,7667,15726
20210216,안산선,초지,4126,4180,8306
20210216,안산선,안산,10581,9561,20142
20210216,안산선,신길온천,1466,1333,2799
20210216,안산선,한대앞,7596,7599,15195
20210217,안산선,안산,10273,9230,19503
20210217,안산선,수리산,3759,3053,6812
20210217,안산선,오이도,7329,7092,14421
20210217,안산선,정왕,6436,7016,13452
20210217,안산선,신길온천,1395,1269,2664
20210217,안산선,초지,3944,4007,7951
20210217,안산선,대야미,4270,3911,8181
20210217,안산선,중앙,15164,15845,31009
20210217,안산선,한대앞,7310,7335,14645
20210217,안산선,상록수,14136,14353,28489
20210217,안산선,반월,3682,3505,7187
20210217,안산선,산본,14518,15554,30072
20210217,안산선,고잔,7663,7399,15062
20210218,안산선,신길온천,1451,1324,2775
20210218,안산선,정왕,6587,7043,13630
20210218,안산선,안산,10357,9177,19534
20210218,안산선,수리산,3820,3015,6835
20210218,안산선,오이도,7406,7204,14610
20210218,안산선,초지,4170,4201,8371
20210218,안산선,고잔,7718,7352,15070
20210218,안산선,중앙,15307,16090,31397
20210218,안산선,한대앞,7449,7438,14887
20210218,안산선,상록수,14546,14734,29280
20210218,안산선,반월,3681,3606,7287
20210218,안산선,대야미,4395,4002,8397
20210218,안산선,산본,14698,15694,30392
20210219,안산선,초지,4220,4334,8554
20210219,안산선,안산,11317,10219,21536
20210219,안산선,정왕,7614,7905,15519
20210219,안산선,오이도,8314,8058,16372
20210219,안산선,고잔,8153,7850,16003
20210219,안산선,중앙,16977,17886,34863
20210219,안산선,신길온천,1587,1454,3041
20210219,안산선,상록수,15441,15715,31156
20210219,안산선,반월,4016,3784,7800
20210219,안산선,대야미,4723,4153,8876
20210219,안산선,산본,15803,16939,32742
20210219,안산선,수리산,3881,3055,6936
20210219,안산선,한대앞,8166,8177,16343
20210220,안산선,수리산,2554,2241,4795
20210220,안산선,오이도,6802,6989,13791
20210220,안산선,정왕,5166,5306,10472
20210220,안산선,신길온천,1248,1199,2447
20210220,안산선,안산,8523,8558,17081
20210220,안산선,초지,2875,2931,5806
20210220,안산선,한대앞,6017,6061,12078
20210220,안산선,중앙,13995,14414,28409
20210220,안산선,상록수,11300,11250,22550
20210220,안산선,반월,2961,2756,5717
20210220,안산선,대야미,3698,3191,6889
20210220,안산선,산본,11243,11925,23168
20210220,안산선,고잔,5560,5398,10958
20210221,안산선,상록수,8112,7868,15980
20210221,안산선,반월,2188,2234,4422
20210221,안산선,한대앞,4513,4377,8890
20210221,안산선,산본,7684,8213,15897
20210221,안산선,대야미,2769,2453,5222
20210221,안산선,중앙,10416,10468,20884
20210221,안산선,오이도,5610,5463,11073
20210221,안산선,초지,1980,1994,3974
20210221,안산선,안산,8121,7419,15540
20210221,안산선,신길온천,951,947,1898
20210221,안산선,정왕,4021,4294,8315
20210221,안산선,고잔,3532,3584,7116
20210221,안산선,수리산,1828,1864,3692
20210222,안산선,수리산,3923,3210,7133
20210222,안산선,오이도,8043,7838,15881
20210222,안산선,정왕,7032,7548,14580
20210222,안산선,신길온천,1599,1397,2996
20210222,안산선,안산,11441,10375,21816
20210222,안산선,초지,4399,4520,8919
20210222,안산선,고잔,8259,7815,16074
20210222,안산선,중앙,16505,16926,33431
20210222,안산선,한대앞,7971,7970,15941
20210222,안산선,상록수,15360,15408,30768
20210222,안산선,반월,4044,3891,7935
20210222,안산선,대야미,4673,4220,8893
20210222,안산선,산본,15362,16360,31722
20210223,안산선,대야미,4579,4112,8691
20210223,안산선,반월,4025,3898,7923
20210223,안산선,상록수,15083,15158,30241
20210223,안산선,한대앞,7958,7917,15875
20210223,안산선,중앙,16234,16936,33170
20210223,안산선,고잔,8195,7896,16091
20210223,안산선,산본,15286,16326,31612
20210223,안산선,안산,11136,9902,21038
20210223,안산선,신길온천,1581,1457,3038
20210223,안산선,정왕,6920,7441,14361
20210223,안산선,오이도,7939,7703,15642
20210223,안산선,수리산,3985,3222,7207
20210223,안산선,초지,4419,4534,8953
20210224,안산선,대야미,4735,4225,8960
20210224,안산선,반월,4152,3987,8139
20210224,안산선,상록수,15278,15441,30719
20210224,안산선,한대앞,8027,7937,15964
20210224,안산선,중앙,16473,17035,33508
20210224,안산선,고잔,8248,8077,16325
20210224,안산선,산본,15494,16624,32118
20210224,안산선,안산,11251,9912,21163
20210224,안산선,신길온천,1618,1492,3110
20210224,안산선,정왕,6842,7499,14341
20210224,안산선,오이도,8139,7806,15945
20210224,안산선,수리산,4005,3225,7230
20210224,안산선,초지,4451,4596,9047
20210225,안산선,수리산,4035,3260,7295
20210225,안산선,오이도,7981,7806,15787
20210225,안산선,정왕,6739,7283,14022
20210225,안산선,신길온천,1657,1545,3202
20210225,안산선,안산,11127,9861,20988
20210225,안산선,초지,4313,4403,8716
20210225,안산선,고잔,8109,7697,15806
20210225,안산선,한대앞,7923,7920,15843
20210225,안산선,상록수,15411,15508,30919
20210225,안산선,반월,3989,3909,7898
20210225,안산선,대야미,4693,4218,8911
20210225,안산선,산본,15452,16443,31895
20210225,안산선,중앙,16386,17097,33483
20210226,안산선,초지,4475,4438,8913
20210226,안산선,오이도,8841,8760,17601
20210226,안산선,정왕,7326,7727,15053
20210226,안산선,신길온천,1631,1601,3232
20210226,안산선,안산,11722,10646,22368
20210226,안산선,고잔,8475,8175,16650
20210226,안산선,수리산,4160,3249,7409
20210226,안산선,한대앞,8410,8284,16694
20210226,안산선,상록수,15925,15912,31837
20210226,안산선,반월,4200,4033,8233
20210226,안산선,대야미,5018,4420,9438
20210226,안산선,산본,15892,17330,33222
20210226,안산선,중앙,17485,18582,36067
20210227,안산선,수리산,2630,2542,5172
20210227,안산선,오이도,7602,7938,15540
20210227,안산선,안산,9428,9569,18997
20210227,안산선,정왕,5633,5729,11362
20210227,안산선,신길온천,1304,1237,2541
20210227,안산선,초지,3045,3070,6115
20210227,안산선,대야미,3792,3214,7006
20210227,안산선,중앙,14970,15627,30597
20210227,안산선,한대앞,6394,6395,12789
20210227,안산선,상록수,11669,11750,23419
20210227,안산선,반월,3261,3066,6327
20210227,안산선,산본,11777,12421,24198
20210227,안산선,고잔,5973,5919,11892
20210228,안산선,수리산,2027,2030,4057
20210228,안산선,오이도,6531,6582,13113
20210228,안산선,정왕,4637,4782,9419
20210228,안산선,신길온천,1013,984,1997
20210228,안산선,안산,9284,8624,17908
20210228,안산선,초지,2238,2196,4434
20210228,안산선,고잔,3997,3994,7991
20210228,안산선,중앙,11403,11647,23050
20210228,안산선,한대앞,4803,4819,9622
20210228,안산선,상록수,8716,8689,17405
20210228,안산선,반월,2413,2294,4707
20210228,안산선,대야미,2838,2553,5391
20210228,안산선,산본,8403,8869,17272
20210301,안산선,오이도,3695,3567,7262
20210301,안산선,정왕,3296,3780,7076
20210301,안산선,신길온천,721,675,1396
20210301,안산선,안산,5663,5246,10909
20210301,안산선,초지,1632,1645,3277
20210301,안산선,고잔,2941,2818,5759
20210301,안산선,수리산,1426,1198,2624
20210301,안산선,한대앞,3635,3597,7232
20210301,안산선,상록수,6785,6862,13647
20210301,안산선,반월,1726,1722,3448
20210301,안산선,대야미,1876,1740,3616
20210301,안산선,산본,6287,6837,13124
20210301,안산선,중앙,7969,7719,15688
20210302,안산선,대야미,4670,4227,8897
20210302,안산선,반월,4130,3994,8124
20210302,안산선,상록수,15581,15551,31132
20210302,안산선,한대앞,8248,8312,16560
20210302,안산선,중앙,16690,17086,33776
20210302,안산선,고잔,8427,8040,16467
20210302,안산선,산본,15412,16460,31872
20210302,안산선,안산,11632,10521,22153
20210302,안산선,신길온천,1603,1477,3080
20210302,안산선,정왕,8487,9008,17495
20210302,안산선,오이도,7880,7717,15597
20210302,안산선,수리산,4127,3380,7507
20210302,안산선,초지,5197,5594,10791
20210303,안산선,수리산,4263,3450,7713
20210303,안산선,오이도,8058,7904,15962
20210303,안산선,정왕,8269,8738,17007
20210303,안산선,신길온천,1611,1510,3121
20210303,안산선,안산,11303,10288,21591
20210303,안산선,초지,5261,5722,10983
20210303,안산선,고잔,8628,8339,16967
20210303,안산선,한대앞,8374,8420,16794
20210303,안산선,상록수,15573,15787,31360
20210303,안산선,반월,4141,4001,8142
20210303,안산선,대야미,4898,4439,9337
20210303,안산선,산본,15761,16984,32745
20210303,안산선,중앙,16759,17241,34000
20210304,안산선,초지,5186,5587,10773
20210304,안산선,오이도,7965,7692,15657
20210304,안산선,정왕,8527,8898,17425
20210304,안산선,신길온천,1599,1559,3158
20210304,안산선,안산,11427,10281,21708
20210304,안산선,고잔,8522,8178,16700
20210304,안산선,수리산,4176,3366,7542
20210304,안산선,한대앞,8424,8495,16919
20210304,안산선,산본,15724,16799,32523
20210304,안산선,대야미,4910,4431,9341
20210304,안산선,중앙,16783,17338,34121
20210304,안산선,상록수,15830,15852,31682
20210304,안산선,반월,4222,4128,8350
20210305,안산선,대야미,5205,4537,9742
20210305,안산선,반월,4436,4131,8567
20210305,안산선,상록수,16368,16418,32786
20210305,안산선,한대앞,9107,9058,18165
20210305,안산선,중앙,18027,19198,37225
20210305,안산선,고잔,8845,8612,17457
20210305,안산선,산본,16147,17751,33898
20210305,안산선,안산,11925,10652,22577
20210305,안산선,신길온천,1682,1579,3261
20210305,안산선,정왕,9123,8908,18031
20210305,안산선,오이도,8558,8562,17120
20210305,안산선,수리산,4339,3444,7783
20210305,안산선,초지,5125,5425,10550
20210306,안산선,수리산,2685,2453,5138
20210306,안산선,오이도,6958,7387,14345
20210306,안산선,정왕,5715,5757,11472
20210306,안산선,신길온천,1321,1308,2629
20210306,안산선,안산,8961,8904,17865
20210306,안산선,초지,2950,3034,5984
20210306,안산선,고잔,5717,5775,11492
20210306,안산선,한대앞,6750,6705,13455
20210306,안산선,상록수,11958,11783,23741
20210306,안산선,반월,3154,2975,6129
20210306,안산선,산본,11745,12513,24258
20210306,안산선,중앙,14984,15492,30476
20210306,안산선,대야미,3827,3290,7117
20210307,안산선,산본,8026,8585,16611
20210307,안산선,중앙,10755,10571,21326
20210307,안산선,대야미,2897,2555,5452
20210307,안산선,반월,2243,2359,4602
20210307,안산선,상록수,8617,8380,16997
20210307,안산선,한대앞,4790,4663,9453
20210307,안산선,고잔,4077,3951,8028
20210307,안산선,안산,8451,7962,16413
20210307,안산선,신길온천,1043,1021,2064
20210307,안산선,정왕,4319,5034,9353
20210307,안산선,오이도,5534,5414,10948
20210307,안산선,수리산,1972,1981,3953
20210307,안산선,초지,2059,1955,4014
20210308,안산선,오이도,8416,8131,16547
20210308,안산선,정왕,9741,10426,20167
20210308,안산선,신길온천,1724,1532,3256
20210308,안산선,안산,11789,10623,22412
20210308,안산선,초지,5169,5474,10643
20210308,안산선,고잔,8793,8300,17093
20210308,안산선,수리산,4210,3390,7600
20210308,안산선,한대앞,8502,8546,17048
20210308,안산선,상록수,16003,16018,32021
20210308,안산선,반월,4185,4074,8259
20210308,안산선,대야미,4896,4426,9322
20210308,안산선,산본,15643,16713,32356
20210308,안산선,중앙,16882,17455,34337
20210309,안산선,수리산,4281,3566,7847
20210309,안산선,오이도,8406,8063,16469
20210309,안산선,정왕,9723,10152,19875
20210309,안산선,신길온천,1661,1596,3257
20210309,안산선,안산,11559,10371,21930
20210309,안산선,초지,5453,5857,11310
20210309,안산선,고잔,8485,8292,16777
20210309,안산선,한대앞,8549,8690,17239
20210309,안산선,상록수,16375,16569,32944
20210309,안산선,반월,4247,4075,8322
20210309,안산선,대야미,4991,4408,9399
20210309,안산선,산본,15730,16928,32658
20210309,안산선,중앙,17031,17648,34679
20210310,안산선,초지,5471,5880,11351
20210310,안산선,오이도,8439,8274,16713
20210310,안산선,정왕,9525,9903,19428
20210310,안산선,신길온천,1697,1578,3275
20210310,안산선,안산,11781,10426,22207
20210310,안산선,수리산,4237,3517,7754
20210310,안산선,고잔,8841,8487,17328
20210310,안산선,한대앞,8622,8790,17412
20210310,안산선,상록수,16554,16544,33098
20210310,안산선,반월,4273,4117,8390
20210310,안산선,대야미,4988,4561,9549
20210310,안산선,산본,15943,17201,33144
20210310,안산선,중앙,17119,18072,35191
20210311,안산선,수리산,4189,3398,7587
20210311,안산선,오이도,8455,8218,16673
20210311,안산선,정왕,9648,9924,19572
20210311,안산선,신길온천,1686,1560,3246
20210311,안산선,안산,11512,10298,21810
20210311,안산선,초지,5377,5707,11084
20210311,안산선,고잔,8649,8288,16937
20210311,안산선,중앙,17272,17869,35141
20210311,안산선,한대앞,8552,8810,17362
20210311,안산선,상록수,16055,16307,32362
20210311,안산선,반월,4235,4058,8293
20210311,안산선,대야미,4931,4333,9264
20210311,안산선,산본,15668,16742,32410
20210312,안산선,오이도,8504,8585,17089
20210312,안산선,정왕,9612,9332,18944
20210312,안산선,신길온천,1733,1609,3342
20210312,안산선,안산,11695,10532,22227
20210312,안산선,초지,5054,5186,10240
20210312,안산선,고잔,8763,8448,17211
20210312,안산선,수리산,4132,3154,7286
20210312,안산선,한대앞,9203,9082,18285
20210312,안산선,상록수,15961,16063,32024
20210312,안산선,반월,4358,4042,8400
20210312,안산선,대야미,4976,4346,9322
20210312,안산선,산본,16168,17520,33688
20210312,안산선,중앙,17930,19240,37170
20210313,안산선,오이도,7459,7716,15175
20210313,안산선,정왕,5990,5947,11937
20210313,안산선,신길온천,1450,1340,2790
20210313,안산선,안산,9426,9468,18894
20210313,안산선,초지,3149,3141,6290
20210313,안산선,고잔,5884,5847,11731
20210313,안산선,수리산,2798,2616,5414
20210313,안산선,한대앞,6762,6729,13491
20210313,안산선,상록수,11966,12158,24124
20210313,안산선,반월,3402,3124,6526
20210313,안산선,대야미,3912,3412,7324
20210313,안산선,산본,11851,12661,24512
20210313,안산선,중앙,15306,15767,31073
20210314,안산선,중앙,11335,11310,22645
20210314,안산선,상록수,8737,8589,17326
20210314,안산선,고잔,4038,3947,7985
20210314,안산선,초지,2243,2108,4351
20210314,안산선,안산,8945,8281,17226
20210314,안산선,신길온천,1029,964,1993
20210314,안산선,정왕,4649,5348,9997
20210314,안산선,수리산,1931,1935,3866
20210314,안산선,반월,2297,2313,4610
20210314,안산선,대야미,2923,2593,5516
20210314,안산선,산본,8367,8716,17083
20210314,안산선,한대앞,4776,4731,9507
20210314,안산선,오이도,5888,5766,11654
20210315,안산선,초지,5309,5661,10970
20210315,안산선,오이도,8403,7961,16364
20210315,안산선,정왕,9591,10298,19889
20210315,안산선,신길온천,1683,1514,3197
20210315,안산선,안산,11866,10694,22560
20210315,안산선,고잔,8746,8371,17117
20210315,안산선,수리산,4210,3499,7709
20210315,안산선,한대앞,8568,8608,17176
20210315,안산선,산본,15656,16773,32429
20210315,안산선,대야미,4887,4382,9269
20210315,안산선,중앙,17137,17907,35044
20210315,안산선,상록수,16308,16327,32635
20210315,안산선,반월,4288,4085,8373
20210316,안산선,오이도,8338,8073,16411
20210316,안산선,정왕,9722,10076,19798
20210316,안산선,신길온천,1643,1569,3212
20210316,안산선,안산,11705,10415,22120
20210316,안산선,초지,5326,5783,11109
20210316,안산선,고잔,8583,8326,16909
20210316,안산선,수리산,4236,3427,7663
20210316,안산선,한대앞,8752,8806,17558
20210316,안산선,상록수,16177,16526,32703
20210316,안산선,반월,4379,4181,8560
20210316,안산선,대야미,4965,4447,9412
20210316,안산선,산본,15782,16895,32677
20210316,안산선,중앙,17386,17781,35167
20210317,안산선,산본,16043,17157,33200
20210317,안산선,대야미,5035,4527,9562
20210317,안산선,반월,4396,4243,8639
20210317,안산선,상록수,16150,16207,32357
20210317,안산선,한대앞,8914,8994,17908
20210317,안산선,중앙,17462,18150,35612
20210317,안산선,고잔,8663,8350,17013
20210317,안산선,안산,11712,10441,22153
20210317,안산선,신길온천,1700,1627,3327
20210317,안산선,정왕,9584,9983,19567
20210317,안산선,수리산,4298,3528,7826
20210317,안산선,초지,5380,5813,11193
20210317,안산선,오이도,8646,8406,17052
20210318,안산선,산본,15777,16913,32690
20210318,안산선,중앙,17575,18241,35816
20210318,안산선,대야미,5045,4517,9562
20210318,안산선,반월,4400,4245,8645
20210318,안산선,상록수,16376,16315,32691
20210318,안산선,한대앞,8749,8821,17570
20210318,안산선,고잔,8794,8505,17299
20210318,안산선,안산,11588,10247,21835
20210318,안산선,신길온천,1721,1609,3330
20210318,안산선,정왕,9727,9998,19725
20210318,안산선,오이도,8543,8357,16900
20210318,안산선,수리산,4279,3456,7735
20210318,안산선,초지,5251,5682,10933
20210319,안산선,정왕,9980,9695,19675
20210319,안산선,신길온천,1842,1652,3494
20210319,안산선,안산,12055,11026,23081
20210319,안산선,초지,5150,5480,10630
20210319,안산선,고잔,9127,8845,17972
20210319,안산선,중앙,18854,20069,38923
20210319,안산선,오이도,9045,9035,18080
20210319,안산선,상록수,16866,16902,33768
20210319,안산선,반월,4548,4367,8915
20210319,안산선,대야미,5270,4637,9907
20210319,안산선,산본,16679,18195,34874
20210319,안산선,수리산,4419,3443,7862
20210319,안산선,한대앞,9505,9417,18922
20210320,안산선,산본,10813,11545,22358
20210320,안산선,대야미,3357,2899,6256
20210320,안산선,반월,3002,2735,5737
20210320,안산선,상록수,10991,10924,21915
20210320,안산선,한대앞,6216,6355,12571
20210320,안산선,중앙,13771,14313,28084
20210320,안산선,고잔,5607,5629,11236
20210320,안산선,안산,8489,8894,17383
20210320,안산선,신길온천,1178,1160,2338
20210320,안산선,정왕,5575,5711,11286
20210320,안산선,오이도,6323,6467,12790
20210320,안산선,수리산,2503,2120,4623
20210320,안산선,초지,2827,2875,5702
20210321,안산선,초지,2093,2045,4138
20210321,안산선,오이도,5551,5548,11099
20210321,안산선,정왕,4687,5280,9967
20210321,안산선,신길온천,1030,951,1981
20210321,안산선,안산,9334,8344,17678
20210321,안산선,고잔,4191,4106,8297
20210321,안산선,수리산,1983,1959,3942
20210321,안산선,한대앞,4883,4801,9684
20210321,안산선,산본,8104,8560,16664
20210321,안산선,대야미,2830,2601,5431
20210321,안산선,중앙,11369,11230,22599
20210321,안산선,상록수,8611,8538,17149
20210321,안산선,반월,2278,2327,4605
20210322,안산선,대야미,4866,4400,9266
20210322,안산선,산본,15634,16698,32332
20210322,안산선,수리산,4158,3512,7670
20210322,안산선,오이도,8411,8000,16411
20210322,안산선,신길온천,1663,1537,3200
20210322,안산선,안산,11787,10543,22330
20210322,안산선,정왕,9525,10355,19880
20210322,안산선,고잔,8788,8388,17176
20210322,안산선,중앙,17287,17901,35188
20210322,안산선,한대앞,8609,8700,17309
20210322,안산선,상록수,16313,16282,32595
20210322,안산선,반월,4277,4162,8439
20210322,안산선,초지,5180,5539,10719
20210323,안산선,안산,11668,10343,22011
20210323,안산선,오이도,8481,8262,16743
20210323,안산선,수리산,4302,3532,7834
20210323,안산선,정왕,9572,10056,19628
20210323,안산선,신길온천,1665,1570,3235
20210323,안산선,초지,5337,5721,11058
20210323,안산선,대야미,5099,4606,9705
20210323,안산선,중앙,17621,18229,35850
20210323,안산선,한대앞,8852,8963,17815
20210323,안산선,상록수,16451,16725,33176
20210323,안산선,반월,4498,4340,8838
20210323,안산선,산본,15783,16912,32695
20210323,안산선,고잔,8897,8488,17385
20210324,안산선,중앙,17615,18430,36045
20210324,안산선,고잔,8995,8570,17565
20210324,안산선,초지,5330,5787,11117
20210324,안산선,안산,11617,10341,21958
20210324,안산선,정왕,9363,9791,19154
20210324,안산선,신길온천,1682,1578,3260
20210324,안산선,오이도,8604,8385,16989
20210324,안산선,산본,16127,17055,33182
20210324,안산선,대야미,5060,4575,9635
20210324,안산선,반월,4519,4300,8819
20210324,안산선,상록수,15987,16250,32237
20210324,안산선,한대앞,8724,8840,17564
20210324,안산선,수리산,4359,3489,7848
20210325,안산선,대야미,5167,4601,9768
20210325,안산선,반월,4514,4329,8843
20210325,안산선,상록수,15983,16188,32171
20210325,안산선,한대앞,8879,8989,17868
20210325,안산선,중앙,17854,18306,36160
20210325,안산선,고잔,8837,8472,17309
20210325,안산선,산본,16210,17265,33475
20210325,안산선,안산,11490,10271,21761
20210325,안산선,신길온천,1698,1612,3310
20210325,안산선,정왕,9816,9988,19804
20210325,안산선,오이도,8555,8396,16951
20210325,안산선,수리산,4363,3587,7950
20210325,안산선,초지,5466,5910,11376
20210326,안산선,산본,16817,18019,34836
20210326,안산선,대야미,5262,4639,9901
20210326,안산선,반월,4555,4346,8901
20210326,안산선,상록수,16735,16560,33295
20210326,안산선,한대앞,9573,9405,18978
20210326,안산선,중앙,18796,20019,38815
20210326,안산선,고잔,9062,8773,17835
20210326,안산선,안산,12098,11098,23196
20210326,안산선,신길온천,1749,1655,3404
20210326,안산선,정왕,9874,9561,19435
20210326,안산선,오이도,9163,9126,18289
20210326,안산선,수리산,4400,3463,7863
20210326,안산선,초지,5095,5482,10577
20210327,안산선,산본,10904,11476,22380
20210327,안산선,대야미,3359,2970,6329
20210327,안산선,반월,2987,2794,5781
20210327,안산선,상록수,10866,10925,21791
20210327,안산선,한대앞,6197,6114,12311
20210327,안산선,중앙,13702,14001,27703
20210327,안산선,고잔,5585,5556,11141
20210327,안산선,안산,8199,8570,16769
20210327,안산선,수리산,2412,2121,4533
20210327,안산선,오이도,6199,6385,12584
20210327,안산선,초지,2823,2878,5701
20210327,안산선,신길온천,1105,1107,2212
20210327,안산선,정왕,5380,5519,10899
20210328,안산선,오이도,4645,4649,9294
20210328,안산선,정왕,4455,5113,9568
20210328,안산선,신길온천,957,823,1780
20210328,안산선,안산,8374,7656,16030
20210328,안산선,초지,1956,1872,3828
20210328,안산선,고잔,3920,3905,7825
20210328,안산선,수리산,1673,1527,3200
20210328,안산선,한대앞,4425,4409,8834
20210328,안산선,상록수,7940,7855,15795
20210328,안산선,반월,2061,2068,4129
20210328,안산선,대야미,2445,2206,4651
20210328,안산선,산본,7195,7875,15070
20210328,안산선,중앙,10322,10336,20658
20210329,안산선,수리산,4271,3442,7713
20210329,안산선,오이도,8232,7854,16086
20210329,안산선,정왕,9611,10314,19925
20210329,안산선,신길온천,1630,1492,3122
20210329,안산선,안산,11643,10417,22060
20210329,안산선,초지,5041,5284,10325
20210329,안산선,고잔,8639,8274,16913
20210329,안산선,한대앞,8659,8649,17308
20210329,안산선,상록수,16072,16145,32217
20210329,안산선,반월,4399,4202,8601
20210329,안산선,산본,15603,16707,32310
20210329,안산선,중앙,17374,17779,35153
20210329,안산선,대야미,4894,4422,9316
20210330,안산선,산본,15970,17037,33007
20210330,안산선,중앙,17344,18088,35432
20210330,안산선,대야미,5152,4656,9808
20210330,안산선,반월,4471,4229,8700
20210330,안산선,상록수,16343,16428,32771
20210330,안산선,한대앞,8944,8866,17810
20210330,안산선,고잔,8797,8541,17338
20210330,안산선,안산,11551,10412,21963
20210330,안산선,신길온천,1700,1560,3260
20210330,안산선,정왕,9664,10021,19685
20210330,안산선,오이도,8406,8197,16603
20210330,안산선,수리산,4366,3552,7918
20210330,안산선,초지,5259,5621,10880
20210331,안산선,오이도,8800,8459,17259
20210331,안산선,정왕,9541,10082,19623
20210331,안산선,신길온천,1717,1643,3360
20210331,안산선,안산,11545,10373,21918
20210331,안산선,초지,5326,5724,11050
20210331,안산선,고잔,8925,8557,17482
20210331,안산선,수리산,4409,3626,8035
20210331,안산선,한대앞,8933,9064,17997
20210331,안산선,상록수,16488,16470,32958
20210331,안산선,반월,4491,4351,8842
20210331,안산선,대야미,5288,4717,10005
20210331,안산선,산본,16396,17452,33848
20210331,안산선,중앙,17783,18419,36202
20210401,안산선,산본,16441,17328,33769
20210401,안산선,대야미,5217,4684,9901
20210401,안산선,반월,4517,4297,8814
20210401,안산선,상록수,16485,16582,33067
20210401,안산선,한대앞,9023,9062,18085
20210401,안산선,중앙,17730,18325,36055
20210401,안산선,고잔,8822,8640,17462
20210401,안산선,안산,11484,10427,21911
20210401,안산선,신길온천,1714,1613,3327
20210401,안산선,정왕,9882,10206,20088
20210401,안산선,오이도,8629,8416,17045
20210401,안산선,수리산,4373,3604,7977
20210401,안산선,초지,5266,5773,11039
20210402,안산선,한대앞,9759,9651,19410
20210402,안산선,산본,16652,17990,34642
20210402,안산선,대야미,5421,4677,10098
20210402,안산선,반월,4563,4287,8850
20210402,안산선,상록수,16833,16887,33720
20210402,안산선,중앙,18711,19940,38651
20210402,안산선,정왕,10086,9755,19841
20210402,안산선,초지,5002,5370,10372
20210402,안산선,안산,12155,11069,23224
20210402,안산선,신길온천,1778,1689,3467
20210402,안산선,고잔,9262,8929,18191
20210402,안산선,오이도,9019,8926,17945
20210402,안산선,수리산,4464,3532,7996
20210403,안산선,산본,9638,10329,19967
20210403,안산선,대야미,2900,2591,5491
20210403,안산선,반월,2559,2421,4980
20210403,안산선,상록수,9862,9986,19848
20210403,안산선,한대앞,5525,5486,11011
20210403,안산선,중앙,12468,12832,25300
20210403,안산선,고잔,5042,4975,10017
20210403,안산선,초지,2533,2626,5159
20210403,안산선,안산,7452,7770,15222
20210403,안산선,신길온천,1009,978,1987
20210403,안산선,정왕,5097,5201,10298
20210403,안산선,오이도,5544,5782,11326
20210403,안산선,수리산,2159,1857,4016
20210404,안산선,대야미,2947,2703,5650
20210404,안산선,반월,2438,2418,4856
20210404,안산선,상록수,8539,8393,16932
20210404,안산선,한대앞,4873,4793,9666
20210404,안산선,중앙,10966,10909,21875
20210404,안산선,고잔,4033,3779,7812
20210404,안산선,산본,7987,8664,16651
20210404,안산선,안산,9311,8583,17894
20210404,안산선,신길온천,994,917,1911
20210404,안산선,정왕,4836,5552,10388
20210404,안산선,오이도,5267,5138,10405
20210404,안산선,수리산,1884,1768,3652
20210404,안산선,초지,2081,2098,4179
20210405,안산선,안산,11994,11005,22999
20210405,안산선,신길온천,1759,1613,3372
20210405,안산선,정왕,9815,10612,20427
20210405,안산선,오이도,8645,8254,16899
20210405,안산선,수리산,4383,3630,8013
20210405,안산선,산본,16120,17070,33190
20210405,안산선,초지,5345,5645,10990
20210405,안산선,반월,4437,4257,8694
20210405,안산선,상록수,16597,16506,33103
20210405,안산선,한대앞,8773,8711,17484
20210405,안산선,중앙,17905,18435,36340
20210405,안산선,고잔,8954,8620,17574
20210405,안산선,대야미,5286,4744,10030
20210406,안산선,산본,16107,17315,33422
20210406,안산선,대야미,5229,4746,9975
20210406,안산선,반월,4519,4323,8842
20210406,안산선,상록수,17026,17069,34095
20210406,안산선,한대앞,8721,8755,17476
20210406,안산선,중앙,17678,18438,36116
20210406,안산선,고잔,9156,8886,18042
20210406,안산선,안산,11768,10718,22486
20210406,안산선,신길온천,1786,1624,3410
20210406,안산선,정왕,9778,10181,19959
20210406,안산선,오이도,8674,8333,17007
20210406,안산선,수리산,4375,3563,7938
20210406,안산선,초지,5322,5803,11125
20210407,안산선,중앙,17824,18604,36428
20210407,안산선,대야미,5275,4846,10121
20210407,안산선,반월,4549,4322,8871
20210407,안산선,상록수,16677,16726,33403
20210407,안산선,한대앞,8702,8615,17317
20210407,안산선,고잔,9083,8722,17805
20210407,안산선,산본,16247,17245,33492
20210407,안산선,안산,11722,10769,22491
20210407,안산선,수리산,4396,3588,7984
20210407,안산선,오이도,8659,8421,17080
20210407,안산선,초지,5269,5759,11028
20210407,안산선,신길온천,1815,1634,3449
20210407,안산선,정왕,9667,10055,19722
20210408,안산선,오이도,8513,8330,16843
20210408,안산선,정왕,9775,9828,19603
20210408,안산선,신길온천,1809,1652,3461
20210408,안산선,안산,11570,10648,22218
20210408,안산선,초지,5332,5740,11072
20210408,안산선,고잔,8951,8654,17605
20210408,안산선,수리산,4367,3645,8012
20210408,안산선,한대앞,8660,8582,17242
20210408,안산선,상록수,16544,16630,33174
20210408,안산선,반월,4425,4342,8767
20210408,안산선,대야미,5272,4763,10035
20210408,안산선,산본,16234,17197,33431
20210408,안산선,중앙,17514,18217,35731
20210409,안산선,수리산,4336,3575,7911
20210409,안산선,오이도,9013,9065,18078
20210409,안산선,정왕,9720,9593,19313
20210409,안산선,신길온천,1780,1642,3422
20210409,안산선,안산,12152,11225,23377
20210409,안산선,초지,5058,5394,10452
20210409,안산선,고잔,9165,8678,17843
20210409,안산선,한대앞,9030,8886,17916
20210409,안산선,상록수,16705,16722,33427
20210409,안산선,반월,4579,4286,8865
20210409,안산선,산본,16729,18076,34805
20210409,안산선,중앙,18458,19929,38387
20210409,안산선,대야미,5476,4753,10229
20210410,안산선,산본,11888,12675,24563
20210410,안산선,중앙,15579,16074,31653
20210410,안산선,대야미,4211,3697,7908
20210410,안산선,반월,3396,3131,6527
20210410,안산선,상록수,12364,12245,24609
20210410,안산선,한대앞,6941,6998,13939
20210410,안산선,고잔,6396,6501,12897
20210410,안산선,안산,10157,10221,20378
20210410,안산선,신길온천,1401,1411,2812
20210410,안산선,정왕,6382,6520,12902
20210410,안산선,오이도,7870,8296,16166
20210410,안산선,수리산,3041,2817,5858
20210410,안산선,초지,3346,3383,6729
20210411,안산선,오이도,6260,6009,12269
20210411,안산선,정왕,5432,6005,11437
20210411,안산선,신길온천,1239,1146,2385
20210411,안산선,안산,10180,9396,19576
20210411,안산선,초지,2341,2310,4651
20210411,안산선,고잔,4484,4376,8860
20210411,안산선,수리산,2400,2547,4947
20210411,안산선,한대앞,5204,5039,10243
20210411,안산선,상록수,8904,8878,17782
20210411,안산선,반월,2522,2557,5079
20210411,안산선,대야미,3267,2959,6226
20210411,안산선,산본,8269,8790,17059
20210411,안산선,중앙,11542,11472,23014
20210412,안산선,수리산,4044,3321,7365
20210412,안산선,오이도,8000,7390,15390
20210412,안산선,정왕,9566,10148,19714
20210412,안산선,신길온천,1642,1417,3059
20210412,안산선,안산,11461,10670,22131
20210412,안산선,초지,4925,5268,10193
20210412,안산선,고잔,8437,7962,16399
20210412,안산선,한대앞,8195,8316,16511
20210412,안산선,상록수,15658,15646,31304
20210412,안산선,반월,4062,3883,7945
20210412,안산선,대야미,4603,4221,8824
20210412,안산선,산본,14873,15763,30636
20210412,안산선,중앙,16195,16506,32701
20210413,안산선,안산,11608,10424,22032
20210413,안산선,수리산,4363,3564,7927
20210413,안산선,오이도,8232,8071,16303
20210413,안산선,정왕,8396,8869,17265
20210413,안산선,신길온천,1726,1561,3287
20210413,안산선,초지,5239,5589,10828
20210413,안산선,고잔,8714,8352,17066
20210413,안산선,중앙,17072,17730,34802
20210413,안산선,한대앞,8790,8738,17528
20210413,안산선,상록수,16244,16607,32851
20210413,안산선,반월,4288,4104,8392
20210413,안산선,대야미,4880,4476,9356
20210413,안산선,산본,15553,16689,32242
20210414,안산선,수리산,4624,3892,8516
20210414,안산선,오이도,8465,8197,16662
20210414,안산선,정왕,9440,9992,19432
20210414,안산선,신길온천,1739,1580,3319
20210414,안산선,안산,11758,10515,22273
20210414,안산선,초지,5004,5421,10425
20210414,안산선,고잔,8938,8570,17508
20210414,안산선,중앙,17074,17712,34786
20210414,안산선,한대앞,8917,8906,17823
20210414,안산선,상록수,16276,16441,32717
20210414,안산선,반월,4348,4175,8523
20210414,안산선,대야미,5174,4607,9781
20210414,안산선,산본,16114,17268,33382
20210415,안산선,중앙,17357,17795,35152
20210415,안산선,고잔,8719,8481,17200
20210415,안산선,상록수,16403,16542,32945
20210415,안산선,반월,4433,4242,8675
20210415,안산선,대야미,5299,4729,10028
20210415,안산선,산본,15904,16883,32787
20210415,안산선,한대앞,8849,8837,17686
20210415,안산선,안산,11797,10686,22483
20210415,안산선,신길온천,1768,1654,3422
20210415,안산선,정왕,9731,9807,19538
20210415,안산선,오이도,8474,8374,16848
20210415,안산선,수리산,4495,3861,8356
20210415,안산선,초지,5082,5495,10577
20210416,안산선,안산,11623,10591,22214
20210416,안산선,초지,4653,4897,9550
20210416,안산선,고잔,8855,8360,17215
20210416,안산선,중앙,16977,18174,35151
20210416,안산선,한대앞,9033,8855,17888
20210416,안산선,상록수,15713,15918,31631
20210416,안산선,신길온천,1619,1581,3200
20210416,안산선,대야미,4873,4345,9218
20210416,안산선,산본,15532,16840,32372
20210416,안산선,수리산,4077,3204,7281
20210416,안산선,오이도,8259,8063,16322
20210416,안산선,정왕,9364,9481,18845
20210416,안산선,반월,4234,4015,8249
20210417,안산선,수리산,2944,2776,5720
20210417,안산선,오이도,7128,7343,14471
20210417,안산선,정왕,6065,6245,12310
20210417,안산선,신길온천,1353,1305,2658
20210417,안산선,안산,9407,9857,19264
20210417,안산선,초지,3018,3150,6168
20210417,안산선,고잔,5872,5961,11833
20210417,안산선,한대앞,6689,6578,13267
20210417,안산선,상록수,11433,11455,22888
20210417,안산선,반월,3115,2923,6038
20210417,안산선,대야미,3817,3404,7221
20210417,안산선,산본,11366,11976,23342
20210417,안산선,중앙,14732,15000,29732
20210418,안산선,중앙,10381,10263,20644
20210418,안산선,대야미,3283,2740,6023
20210418,안산선,반월,2387,2353,4740
20210418,안산선,상록수,8539,8369,16908
20210418,안산선,한대앞,4783,4772,9555
20210418,안산선,고잔,4138,4121,8259
20210418,안산선,산본,8110,8556,16666
20210418,안산선,안산,9430,8753,18183
20210418,안산선,수리산,2427,2913,5340
20210418,안산선,오이도,5417,5451,10868
20210418,안산선,초지,2247,2197,4444
20210418,안산선,신길온천,1131,1018,2149
20210418,안산선,정왕,4687,5175,9862
20210419,안산선,대야미,4994,4574,9568
20210419,안산선,반월,4459,4283,8742
20210419,안산선,상록수,16226,16237,32463
20210419,안산선,한대앞,9004,9066,18070
20210419,안산선,중앙,16503,17153,33656
20210419,안산선,고잔,8833,8315,17148
20210419,안산선,산본,15693,16782,32475
20210419,안산선,안산,11756,10731,22487
20210419,안산선,신길온천,1700,1563,3263
20210419,안산선,정왕,9373,9978,19351
20210419,안산선,오이도,8404,8050,16454
20210419,안산선,수리산,4503,3888,8391
20210419,안산선,초지,5012,5389,10401
20210420,안산선,산본,16003,17066,33069
20210420,안산선,대야미,5223,4737,9960
20210420,안산선,반월,4586,4380,8966
20210420,안산선,상록수,16903,17028,33931
20210420,안산선,한대앞,9706,9896,19602
20210420,안산선,중앙,17055,17697,34752
20210420,안산선,고잔,9045,8535,17580
20210420,안산선,안산,11991,10744,22735
20210420,안산선,신길온천,1713,1630,3343
20210420,안산선,정왕,10230,10682,20912
20210420,안산선,수리산,4656,4054,8710
20210420,안산선,초지,5655,6205,11860
20210420,안산선,오이도,8686,8419,17105
20210421,안산선,산본,16096,17264,33360
20210421,안산선,중앙,16705,17434,34139
20210421,안산선,대야미,5294,4733,10027
20210421,안산선,반월,4472,4341,8813
20210421,안산선,상록수,16628,16854,33482
20210421,안산선,한대앞,9473,9538,19011
20210421,안산선,고잔,8999,8689,17688
20210421,안산선,안산,11810,10671,22481
20210421,안산선,신길온천,1756,1656,3412
20210421,안산선,정왕,9906,10289,20195
20210421,안산선,오이도,8839,8623,17462
20210421,안산선,수리산,4543,3846,8389
20210421,안산선,초지,5356,5828,11184
20210422,안산선,대야미,5275,4790,10065
20210422,안산선,반월,4441,4231,8672
20210422,안산선,상록수,16684,16922,33606
20210422,안산선,한대앞,9919,9869,19788
20210422,안산선,중앙,16785,17322,34107
20210422,안산선,고잔,8913,8554,17467
20210422,안산선,산본,15928,17070,32998
20210422,안산선,안산,11535,10501,22036
20210422,안산선,신길온천,1742,1605,3347
20210422,안산선,정왕,9868,10128,19996
20210422,안산선,오이도,8608,8392,17000
20210422,안산선,수리산,4550,3896,8446
20210422,안산선,초지,5305,5758,11063
20210423,안산선,수리산,4495,3662,8157
20210423,안산선,오이도,8799,8759,17558
20210423,안산선,정왕,10024,9929,19953
20210423,안산선,신길온천,1770,1647,3417
20210423,안산선,안산,12067,10880,22947
20210423,안산선,초지,4890,5178,10068
20210423,안산선,고잔,9139,8866,18005
20210423,안산선,한대앞,9642,9483,19125
20210423,안산선,상록수,16858,16867,33725
20210423,안산선,반월,4617,4357,8974
20210423,안산선,대야미,5193,4573,9766
20210423,안산선,산본,16360,17900,34260
20210423,안산선,중앙,17615,18815,36430
20210424,안산선,중앙,14511,14983,29494
20210424,안산선,대야미,4165,3563,7728
20210424,안산선,반월,3316,3087,6403
20210424,안산선,상록수,11914,11846,23760
20210424,안산선,한대앞,6950,6781,13731
20210424,안산선,고잔,6229,6229,12458
20210424,안산선,산본,11544,12328,23872
20210424,안산선,안산,9464,9806,19270
20210424,안산선,신길온천,1414,1348,2762
20210424,안산선,정왕,6319,6456,12775
20210424,안산선,오이도,7528,7724,15252
20210424,안산선,수리산,3267,3373,6640
20210424,안산선,초지,3120,3135,6255
20210425,안산선,수리산,2606,2973,5579
20210425,안산선,오이도,5823,5726,11549
20210425,안산선,정왕,4945,5500,10445
20210425,안산선,신길온천,1131,1030,2161
20210425,안산선,안산,9618,8937,18555
20210425,안산선,산본,8161,8634,16795
20210425,안산선,대야미,3311,2963,6274
20210425,안산선,반월,2402,2367,4769
20210425,안산선,상록수,8766,8647,17413
20210425,안산선,한대앞,5148,5069,10217
20210425,안산선,중앙,10812,10336,21148
20210425,안산선,고잔,4339,4172,8511
20210425,안산선,초지,2403,2375,4778
20210426,안산선,대야미,5058,4630,9688
20210426,안산선,반월,4561,4351,8912
20210426,안산선,상록수,16620,16650,33270
20210426,안산선,한대앞,9392,9436,18828
20210426,안산선,중앙,17009,17471,34480
20210426,안산선,고잔,9075,8527,17602
20210426,안산선,산본,15973,17065,33038
20210426,안산선,안산,12028,10942,22970
20210426,안산선,신길온천,1767,1559,3326
20210426,안산선,정왕,10147,10814,20961
20210426,안산선,오이도,8659,8268,16927
20210426,안산선,수리산,4556,3905,8461
20210426,안산선,초지,5155,5575,10730
20210427,안산선,대야미,5112,4629,9741
20210427,안산선,반월,4510,4348,8858
20210427,안산선,상록수,16279,16529,32808
20210427,안산선,한대앞,9479,9296,18775
20210427,안산선,중앙,16601,17476,34077
20210427,안산선,고잔,8850,8457,17307
20210427,안산선,산본,15811,17039,32850
20210427,안산선,안산,11594,10532,22126
20210427,안산선,신길온천,1723,1620,3343
20210427,안산선,정왕,9760,10109,19869
20210427,안산선,오이도,8375,8145,16520
20210427,안산선,수리산,4471,3741,8212
20210427,안산선,초지,4886,5135,10021
20210428,안산선,수리산,4390,3637,8027
20210428,안산선,오이도,8467,8267,16734
20210428,안산선,정왕,9695,10058,19753
20210428,안산선,신길온천,1669,1573,3242
20210428,안산선,안산,11584,10444,22028
20210428,안산선,초지,4737,4979,9716
20210428,안산선,고잔,8909,8506,17415
20210428,안산선,한대앞,9045,9116,18161
20210428,안산선,상록수,16125,16391,32516
20210428,안산선,반월,4427,4290,8717
20210428,안산선,대야미,5184,4692,9876
20210428,안산선,산본,16177,17216,33393
20210428,안산선,중앙,16890,17641,34531
20210429,안산선,초지,4734,4861,9595
20210429,안산선,오이도,8523,8304,16827
20210429,안산선,정왕,9650,9897,19547
20210429,안산선,신길온천,1702,1565,3267
20210429,안산선,안산,11329,10259,21588
20210429,안산선,고잔,8795,8464,17259
20210429,안산선,수리산,4319,3649,7968
20210429,안산선,한대앞,9199,9188,18387
20210429,안산선,산본,15766,16866,32632
20210429,안산선,대야미,5115,4532,9647
20210429,안산선,중앙,16902,17687,34589
20210429,안산선,상록수,16237,16391,32628
20210429,안산선,반월,4391,4236,8627
20210430,안산선,대야미,5162,4534,9696
20210430,안산선,반월,4463,4222,8685
20210430,안산선,상록수,16363,16539,32902
20210430,안산선,한대앞,9608,9501,19109
20210430,안산선,중앙,17893,19141,37034
20210430,안산선,수리산,4305,3429,7734
20210430,안산선,산본,16137,17562,33699
20210430,안산선,정왕,10215,9728,19943
20210430,안산선,신길온천,1708,1609,3317
20210430,안산선,안산,12027,11490,23517
20210430,안산선,초지,4716,5019,9735
20210430,안산선,고잔,9002,8653,17655
20210430,안산선,오이도,8813,8892,17705
20210501,안산선,산본,10865,11558,22423
20210501,안산선,대야미,3549,3139,6688
20210501,안산선,반월,2890,2782,5672
20210501,안산선,상록수,10869,10850,21719
20210501,안산선,한대앞,6323,6343,12666
20210501,안산선,중앙,14597,14933,29530
20210501,안산선,고잔,5545,5820,11365
20210501,안산선,안산,9375,9784,19159
20210501,안산선,신길온천,1327,1268,2595
20210501,안산선,정왕,5887,5859,11746
20210501,안산선,오이도,6639,7034,13673
20210501,안산선,초지,2961,2930,5891
20210501,안산선,수리산,2681,2366,5047
20210502,안산선,오이도,6042,6069,12111
20210502,안산선,초지,2171,2167,4338
20210502,안산선,수리산,2164,2425,4589
20210502,안산선,정왕,4892,5637,10529
20210502,안산선,신길온천,1127,1051,2178
20210502,안산선,안산,9781,8663,18444
20210502,안산선,고잔,4166,3984,8150
20210502,안산선,한대앞,5147,5091,10238
20210502,안산선,상록수,8729,8609,17338
20210502,안산선,반월,2411,2374,4785
20210502,안산선,대야미,3203,2816,6019
20210502,안산선,산본,8193,8643,16836
20210502,안산선,중앙,11240,11073,22313
20210503,안산선,오이도,8818,8323,17141
20210503,안산선,정왕,9734,10407,20141
20210503,안산선,신길온천,1836,1653,3489
20210503,안산선,안산,11879,11043,22922
20210503,안산선,초지,4719,4813,9532
20210503,안산선,고잔,9150,8646,17796
20210503,안산선,수리산,4420,3637,8057
20210503,안산선,한대앞,9213,9111,18324
20210503,안산선,상록수,16871,16924,33795
20210503,안산선,반월,4588,4334,8922
20210503,안산선,대야미,5042,4624,9666
20210503,안산선,산본,15926,17049,32975
20210503,안산선,중앙,17613,18277,35890
20210504,안산선,반월,4173,3959,8132
20210504,안산선,상록수,15925,15958,31883
20210504,안산선,한대앞,8869,8777,17646
20210504,안산선,중앙,16518,17428,33946
20210504,안산선,고잔,8588,8296,16884
20210504,안산선,초지,4613,4781,9394
20210504,안산선,안산,11023,10080,21103
20210504,안산선,정왕,9593,9775,19368
20210504,안산선,오이도,7982,7687,15669
20210504,안산선,수리산,4065,3251,7316
20210504,안산선,산본,15174,16293,31467
20210504,안산선,대야미,4722,4182,8904
20210504,안산선,신길온천,1558,1487,3045
20210505,안산선,초지,2647,2670,5317
20210505,안산선,오이도,7120,7427,14547
20210505,안산선,정왕,5271,5420,10691
20210505,안산선,신길온천,1232,1188,2420
20210505,안산선,안산,7876,7427,15303
20210505,안산선,고잔,4761,4579,9340
20210505,안산선,수리산,2485,2491,4976
20210505,안산선,한대앞,5947,5923,11870
20210505,안산선,산본,10045,10689,20734
20210505,안산선,대야미,3500,3051,6551
20210505,안산선,중앙,12740,13076,25816
20210505,안산선,상록수,10392,10333,20725
20210505,안산선,반월,2781,2711,5492
20210506,안산선,산본,16402,17625,34027
20210506,안산선,대야미,5199,4747,9946
20210506,안산선,반월,4490,4258,8748
20210506,안산선,상록수,16513,16522,33035
20210506,안산선,중앙,17670,18263,35933
20210506,안산선,고잔,9147,8648,17795
20210506,안산선,한대앞,9178,9274,18452
20210506,안산선,안산,11604,10621,22225
20210506,안산선,신길온천,1740,1584,3324
20210506,안산선,정왕,9950,10146,20096
20210506,안산선,오이도,8823,8525,17348
20210506,안산선,수리산,4432,3562,7994
20210506,안산선,초지,4659,4876,9535
20210507,안산선,안산,11839,10833,22672
20210507,안산선,오이도,8549,8534,17083
20210507,안산선,수리산,4208,3263,7471
20210507,안산선,정왕,9635,9379,19014
20210507,안산선,신길온천,1646,1554,3200
20210507,안산선,초지,4589,4831,9420
20210507,안산선,대야미,4973,4392,9365
20210507,안산선,중앙,18039,19523,37562
20210507,안산선,한대앞,9278,9143,18421
20210507,안산선,상록수,16208,16341,32549
20210507,안산선,반월,4365,4177,8542
20210507,안산선,산본,16037,17635,33672
20210507,안산선,고잔,8863,8564,17427
20210508,안산선,수리산,2541,2258,4799
20210508,안산선,오이도,6483,6553,13036
20210508,안산선,정왕,5951,5970,11921
20210508,안산선,신길온천,1254,1260,2514
20210508,안산선,초지,2632,2819,5451
20210508,안산선,안산,9137,9290,18427
20210508,안산선,고잔,5264,5289,10553
20210508,안산선,한대앞,6219,6285,12504
20210508,안산선,상록수,11163,11277,22440
20210508,안산선,반월,3002,2883,5885
20210508,안산선,대야미,3403,2974,6377
20210508,안산선,산본,10335,11358,21693
20210508,안산선,중앙,12876,13794,26670
20210509,안산선,대야미,3180,2829,6009
20210509,안산선,반월,2578,2454,5032
20210509,안산선,상록수,8900,8627,17527
20210509,안산선,한대앞,5317,5071,10388
20210509,안산선,중앙,11386,11237,22623
20210509,안산선,고잔,4419,4095,8514
20210509,안산선,산본,8362,8854,17216
20210509,안산선,안산,9261,8501,17762
20210509,안산선,신길온천,1121,1015,2136
20210509,안산선,정왕,4639,5576,10215
20210509,안산선,오이도,6137,5910,12047
20210509,안산선,수리산,2136,2275,4411
20210509,안산선,초지,2399,2188,4587
20210510,안산선,산본,15067,16013,31080
20210510,안산선,대야미,4583,4203,8786
20210510,안산선,반월,4131,4034,8165
20210510,안산선,상록수,15621,15754,31375
20210510,안산선,한대앞,8415,8494,16909
20210510,안산선,중앙,16172,16740,32912
20210510,안산선,고잔,8483,8045,16528
20210510,안산선,안산,11300,10170,21470
20210510,안산선,신길온천,1535,1413,2948
20210510,안산선,정왕,8877,9851,18728
20210510,안산선,오이도,7889,7429,15318
20210510,안산선,수리산,4066,3233,7299
20210510,안산선,초지,4559,4630,9189
20210511,안산선,수리산,4440,3703,8143
20210511,안산선,오이도,8782,8417,17199
20210511,안산선,정왕,9960,10341,20301
20210511,안산선,신길온천,1748,1615,3363
20210511,안산선,안산,11837,10590,22427
20210511,안산선,초지,4963,5177,10140
20210511,안산선,고잔,9282,8873,18155
20210511,안산선,한대앞,9248,9385,18633
20210511,안산선,산본,16417,17662,34079
20210511,안산선,대야미,5368,4921,10289
20210511,안산선,중앙,17711,18461,36172
20210511,안산선,상록수,16860,17084,33944
20210511,안산선,반월,4665,4410,9075
20210512,안산선,오이도,8805,8518,17323
20210512,안산선,정왕,9562,10082,19644
20210512,안산선,신길온천,1796,1667,3463
20210512,안산선,안산,12043,10840,22883
20210512,안산선,초지,4819,5186,10005
20210512,안산선,고잔,9276,8914,18190
20210512,안산선,수리산,4514,3684,8198
20210512,안산선,한대앞,9226,9279,18505
20210512,안산선,상록수,16527,16801,33328
20210512,안산선,반월,4534,4329,8863
20210512,안산선,대야미,5305,4724,10029
20210512,안산선,산본,16373,17538,33911
20210512,안산선,중앙,17751,18440,36191
20210513,안산선,수리산,4269,3420,7689
20210513,안산선,오이도,8717,8653,17370
20210513,안산선,정왕,9877,10088,19965
20210513,안산선,신길온천,1709,1594,3303
20210513,안산선,안산,11813,10636,22449
20210513,안산선,초지,4767,4899,9666
20210513,안산선,고잔,9132,8804,17936
20210513,안산선,한대앞,9447,9240,18687
20210513,안산선,상록수,16530,16626,33156
20210513,안산선,반월,4468,4283,8751
20210513,안산선,산본,15824,16813,32637
20210513,안산선,중앙,17605,18453,36058
20210513,안산선,대야미,5049,4597,9646
20210514,안산선,수리산,4375,3440,7815
20210514,안산선,초지,4752,5000,9752
20210514,안산선,오이도,9154,9109,18263
20210514,안산선,정왕,10090,9835,19925
20210514,안산선,신길온천,1772,1657,3429
20210514,안산선,안산,12256,11169,23425
20210514,안산선,고잔,9384,8951,18335
20210514,안산선,한대앞,10012,9710,19722
20210514,안산선,상록수,16737,16886,33623
20210514,안산선,반월,4644,4384,9028
20210514,안산선,대야미,5109,4510,9619
20210514,안산선,산본,16713,18058,34771
20210514,안산선,중앙,18780,20012,38792
20210515,안산선,오이도,6650,6904,13554
20210515,안산선,정왕,5736,6021,11757
20210515,안산선,신길온천,1266,1220,2486
20210515,안산선,안산,9042,9634,18676
20210515,안산선,초지,3151,3181,6332
20210515,안산선,고잔,5662,5614,11276
20210515,안산선,수리산,2589,2256,4845
20210515,안산선,한대앞,6521,6503,13024
20210515,안산선,상록수,11408,11403,22811
20210515,안산선,반월,3102,2879,5981
20210515,안산선,대야미,3645,3177,6822
20210515,안산선,산본,10808,11544,22352
20210515,안산선,중앙,14456,14665,29121
20210516,안산선,수리산,1551,1332,2883
20210516,안산선,오이도,4112,4101,8213
20210516,안산선,정왕,3898,4602,8500
20210516,안산선,신길온천,790,729,1519
20210516,안산선,안산,8031,7063,15094
20210516,안산선,초지,1796,1742,3538
20210516,안산선,고잔,3201,3129,6330
20210516,안산선,한대앞,4087,4046,8133
20210516,안산선,상록수,7117,7032,14149
20210516,안산선,대야미,1957,1907,3864
20210516,안산선,산본,6386,6749,13135
20210516,안산선,반월,1871,1936,3807
20210516,안산선,중앙,9084,8920,18004
20210517,안산선,초지,4583,4716,9299
20210517,안산선,오이도,8006,7605,15611
20210517,안산선,정왕,9334,10048,19382
20210517,안산선,신길온천,1635,1441,3076
20210517,안산선,안산,11850,10596,22446
20210517,안산선,고잔,8690,8213,16903
20210517,안산선,수리산,4143,3336,7479
20210517,안산선,한대앞,8750,8745,17495
20210517,안산선,산본,15300,16316,31616
20210517,안산선,대야미,4709,4419,9128
20210517,안산선,중앙,16556,17240,33796
20210517,안산선,상록수,16073,16057,32130
20210517,안산선,반월,4245,4027,8272
20210518,안산선,산본,16823,17964,34787
20210518,안산선,대야미,5419,4866,10285
20210518,안산선,반월,4570,4358,8928
20210518,안산선,상록수,17464,17335,34799
20210518,안산선,중앙,18624,19671,38295
20210518,안산선,고잔,9574,9234,18808
20210518,안산선,한대앞,9806,9723,19529
20210518,안산선,안산,12358,11187,23545
20210518,안산선,신길온천,1790,1678,3468
20210518,안산선,정왕,10434,10775,21209
20210518,안산선,오이도,9107,9037,18144
20210518,안산선,수리산,4468,3602,8070
20210518,안산선,초지,5305,5808,11113
20210519,안산선,한대앞,6167,6249,12416
20210519,안산선,산본,10819,11213,22032
20210519,안산선,대야미,3943,3594,7537
20210519,안산선,반월,2984,2900,5884
20210519,안산선,상록수,11188,11105,22293
20210519,안산선,중앙,13384,13618,27002
20210519,안산선,오이도,7786,7920,15706
20210519,안산선,초지,2696,2746,5442
20210519,안산선,안산,8342,7829,16171
20210519,안산선,신길온천,1288,1221,2509
20210519,안산선,정왕,5451,5775,11226
20210519,안산선,수리산,2660,2720,5380
20210519,안산선,고잔,5193,4990,10183
20210520,안산선,중앙,17064,17540,34604
20210520,안산선,산본,15560,16591,32151
20210520,안산선,대야미,4828,4387,9215
20210520,안산선,반월,4307,4061,8368
20210520,안산선,상록수,15943,16240,32183
20210520,안산선,고잔,8959,8527,17486
20210520,안산선,한대앞,9024,8887,17911
20210520,안산선,안산,11289,10285,21574
20210520,안산선,초지,5122,5442,10564
20210520,안산선,신길온천,1624,1509,3133
20210520,안산선,정왕,9593,9839,19432
20210520,안산선,오이도,8170,7852,16022
20210520,안산선,수리산,4184,3471,7655
20210521,안산선,대야미,4955,4422,9377
20210521,안산선,반월,4301,4069,8370
20210521,안산선,상록수,16090,16150,32240
20210521,안산선,한대앞,9141,9156,18297
20210521,안산선,중앙,17933,18937,36870
20210521,안산선,고잔,9102,8701,17803
20210521,안산선,산본,15921,17373,33294
20210521,안산선,안산,11836,10745,22581
20210521,안산선,신길온천,1671,1543,3214
20210521,안산선,정왕,9723,9423,19146
20210521,안산선,오이도,8524,8433,16957
20210521,안산선,수리산,4257,3360,7617
20210521,안산선,초지,4881,5319,10200
20210522,안산선,산본,12305,13321,25626
20210522,안산선,대야미,4311,3712,8023
20210522,안산선,반월,3528,3225,6753
20210522,안산선,상록수,12560,12541,25101
20210522,안산선,한대앞,7197,7134,14331
20210522,안산선,중앙,15843,16432,32275
20210522,안산선,고잔,6731,6617,13348
20210522,안산선,안산,9982,10328,20310
20210522,안산선,신길온천,1430,1413,2843
20210522,안산선,정왕,6398,6347,12745
20210522,안산선,오이도,7925,8194,16119
20210522,안산선,수리산,2891,2739,5630
20210522,안산선,초지,3256,3291,6547
20210523,안산선,안산,9906,8845,18751
20210523,안산선,수리산,2181,2275,4456
20210523,안산선,오이도,6085,5968,12053
20210523,안산선,정왕,4990,5696,10686
20210523,안산선,신길온천,1090,981,2071
20210523,안산선,초지,2341,2210,4551
20210523,안산선,대야미,3186,2763,5949
20210523,안산선,중앙,11384,11366,22750
20210523,안산선,한대앞,5313,5175,10488
20210523,안산선,상록수,8877,8698,17575
20210523,안산선,반월,2438,2451,4889
20210523,안산선,고잔,4243,4295,8538
20210523,안산선,산본,8055,8554,16609
20210524,안산선,산본,15897,16987,32884
20210524,안산선,대야미,5090,4709,9799
20210524,안산선,반월,4599,4311,8910
20210524,안산선,수리산,4341,3593,7934
20210524,안산선,오이도,8485,8128,16613
20210524,안산선,정왕,9743,10522,20265
20210524,안산선,신길온천,1758,1599,3357
20210524,안산선,안산,12075,10810,22885
20210524,안산선,초지,5036,5554,10590
20210524,안산선,고잔,9167,8726,17893
20210524,안산선,중앙,17320,17915,35235
20210524,안산선,한대앞,9285,9259,18544
20210524,안산선,상록수,16668,16610,33278
20210525,안산선,오이도,8204,7928,16132
20210525,안산선,정왕,9633,10075,19708
20210525,안산선,신길온천,1731,1561,3292
20210525,안산선,안산,11528,10403,21931
20210525,안산선,초지,5199,5573,10772
20210525,안산선,고잔,8828,8600,17428
20210525,안산선,수리산,4268,3496,7764
20210525,안산선,한대앞,9063,9157,18220
20210525,안산선,상록수,16346,16450,32796
20210525,안산선,반월,4338,4150,8488
20210525,안산선,대야미,4957,4523,9480
20210525,안산선,산본,15672,16840,32512
20210525,안산선,중앙,17363,17843,35206
20210526,안산선,대야미,5312,4816,10128
20210526,안산선,반월,4466,4314,8780
20210526,안산선,상록수,16190,16403,32593
20210526,안산선,한대앞,9363,9421,18784
20210526,안산선,중앙,17990,18502,36492
20210526,안산선,고잔,9153,8925,18078
20210526,안산선,산본,16364,17452,33816
20210526,안산선,안산,11804,10606,22410
20210526,안산선,신길온천,1826,1704,3530
20210526,안산선,정왕,9560,10234,19794
20210526,안산선,오이도,8793,8506,17299
20210526,안산선,수리산,4494,3701,8195
20210526,안산선,초지,5264,5758,11022
20210527,안산선,수리산,4126,3234,7360
20210527,안산선,오이도,7915,7712,15627
20210527,안산선,정왕,9452,9757,19209
20210527,안산선,신길온천,1629,1482,3111
20210527,안산선,안산,11251,10139,21390
20210527,안산선,초지,4987,5473,10460
20210527,안산선,고잔,8661,8382,17043
20210527,안산선,한대앞,8687,8596,17283
20210527,안산선,상록수,15647,15922,31569
20210527,안산선,반월,4162,3932,8094
20210527,안산선,대야미,4697,4400,9097
20210527,안산선,산본,15371,16344,31715
20210527,안산선,중앙,16807,17443,34250
20210528,안산선,초지,4723,5150,9873
20210528,안산선,오이도,8017,8076,16093
20210528,안산선,정왕,9461,9263,18724
20210528,안산선,신길온천,1585,1476,3061
20210528,안산선,안산,11534,10354,21888
20210528,안산선,고잔,8740,8458,17198
20210528,안산선,수리산,4195,3277,7472
20210528,안산선,한대앞,9174,8867,18041
20210528,안산선,상록수,15575,15663,31238
20210528,안산선,반월,4253,4050,8303
20210528,안산선,대야미,4776,4326,9102
20210528,안산선,산본,15635,16923,32558
20210528,안산선,중앙,17304,18271,35575
20210529,안산선,수리산,2858,2623,5481
20210529,안산선,오이도,7421,7699,15120
20210529,안산선,정왕,6216,6281,12497
20210529,안산선,신길온천,1421,1324,2745
20210529,안산선,안산,9563,9940,19503
20210529,안산선,초지,3098,3175,6273
20210529,안산선,대야미,4154,3534,7688
20210529,안산선,중앙,15226,15712,30938
20210529,안산선,한대앞,7127,7058,14185
20210529,안산선,상록수,12146,12016,24162
20210529,안산선,반월,3442,3188,6630
20210529,안산선,고잔,6351,6465,12816
20210529,안산선,산본,11739,12583,24322
20210530,안산선,산본,8220,8684,16904
20210530,안산선,대야미,3011,2757,5768
20210530,안산선,반월,2447,2339,4786
20210530,안산선,상록수,8677,8632,17309
20210530,안산선,한대앞,5130,5046,10176
20210530,안산선,중앙,10904,10761,21665
20210530,안산선,고잔,4410,4346,8756
20210530,안산선,초지,2339,2190,4529
20210530,안산선,안산,9512,8825,18337
20210530,안산선,신길온천,1152,1064,2216
20210530,안산선,정왕,4728,5415,10143
20210530,안산선,오이도,5801,5703,11504
20210530,안산선,수리산,2147,2192,4339
20210531,안산선,대야미,4898,4540,9438
20210531,안산선,반월,4361,4161,8522
20210531,안산선,상록수,16006,16143,32149
20210531,안산선,한대앞,8790,8835,17625
20210531,안산선,중앙,16916,17404,34320
20210531,안산선,고잔,8900,8417,17317
20210531,안산선,산본,15489,16517,32006
20210531,안산선,안산,11761,10567,22328
20210531,안산선,신길온천,1716,1588,3304
20210531,안산선,정왕,9382,10179,19561
20210531,안산선,오이도,8222,7836,16058
20210531,안산선,수리산,4296,3573,7869
20210531,안산선,초지,4749,5056,9805
20210601,안산선,오이도,8331,8044,16375
20210601,안산선,정왕,9558,10075,19633
20210601,안산선,신길온천,1659,1551,3210
20210601,안산선,안산,11696,10442,22138
20210601,안산선,초지,5045,5373,10418
20210601,안산선,고잔,9098,8658,17756
20210601,안산선,수리산,4379,3641,8020
20210601,안산선,한대앞,8917,9070,17987
20210601,안산선,상록수,16491,16745,33236
20210601,안산선,반월,4434,4191,8625
20210601,안산선,대야미,5059,4623,9682
20210601,안산선,산본,15892,15070,30962
20210601,안산선,중앙,17026,17709,34735
20210602,안산선,수리산,4398,3631,8029
20210602,안산선,오이도,8499,8202,16701
20210602,안산선,정왕,9469,9895,19364
20210602,안산선,신길온천,1721,1609,3330
20210602,안산선,안산,11770,10562,22332
20210602,안산선,초지,4921,5387,10308
20210602,안산선,중앙,17022,17983,35005
20210602,안산선,한대앞,9028,9131,18159
20210602,안산선,상록수,16373,16465,32838
20210602,안산선,반월,4392,4200,8592
20210602,안산선,대야미,5090,4629,9719
20210602,안산선,산본,16109,14441,30550
20210602,안산선,고잔,8955,8438,17393
20210603,안산선,안산,10942,9987,20929
20210603,안산선,오이도,7453,7308,14761
20210603,안산선,정왕,8990,9327,18317
20210603,안산선,신길온천,1581,1454,3035
20210603,안산선,초지,4931,5301,10232
20210603,안산선,수리산,4128,3367,7495
20210603,안산선,고잔,8458,7985,16443
20210603,안산선,산본,15037,16010,31047
20210603,안산선,대야미,4673,4250,8923
20210603,안산선,중앙,16155,16531,32686
20210603,안산선,상록수,15373,15419,30792
20210603,안산선,한대앞,8505,8420,16925
20210603,안산선,반월,4092,3899,7991
20210604,안산선,오이도,8802,8789,17591
20210604,안산선,정왕,9503,9547,19050
20210604,안산선,신길온천,1743,1630,3373
20210604,안산선,안산,12157,11167,23324
20210604,안산선,초지,4922,5254,10176
20210604,안산선,고잔,9099,8775,17874
20210604,안산선,수리산,4417,3494,7911
20210604,안산선,한대앞,9495,9366,18861
20210604,안산선,상록수,16498,16626,33124
20210604,안산선,반월,4661,4403,9064
20210604,안산선,대야미,5398,4751,10149
20210604,안산선,산본,16717,18048,34765
20210604,안산선,중앙,18483,19463,37946
20210605,안산선,수리산,2930,2580,5510
20210605,안산선,오이도,7477,7836,15313
20210605,안산선,정왕,6194,6375,12569
20210605,안산선,신길온천,1409,1384,2793
20210605,안산선,안산,9858,10168,20026
20210605,안산선,초지,3256,3343,6599
20210605,안산선,고잔,6380,6212,12592
20210605,안산선,한대앞,7184,7150,14334
20210605,안산선,상록수,12213,12143,24356
20210605,안산선,반월,3471,3313,6784
20210605,안산선,산본,12246,12965,25211
20210605,안산선,중앙,15569,16178,31747
20210605,안산선,대야미,4100,3615,7715
20210606,안산선,수리산,1985,2073,4058
20210606,안산선,초지,2156,2165,4321
20210606,안산선,오이도,5725,5754,11479
20210606,안산선,정왕,4726,5238,9964
20210606,안산선,신길온천,1142,1059,2201
20210606,안산선,안산,9749,8759,18508
20210606,안산선,중앙,10800,10738,21538
20210606,안산선,한대앞,5011,4872,9883
20210606,안산선,상록수,8838,8631,17469
20210606,안산선,반월,2473,2475,4948
20210606,안산선,대야미,2959,2729,5688
20210606,안산선,산본,8006,8461,16467
20210606,안산선,고잔,4317,4334,8651
20210607,안산선,대야미,5062,4612,9674
20210607,안산선,반월,4330,4187,8517
20210607,안산선,상록수,16044,16084,32128
20210607,안산선,한대앞,8960,8891,17851
20210607,안산선,중앙,17016,17488,34504
20210607,안산선,고잔,9024,8566,17590
20210607,안산선,산본,15680,16899,32579
20210607,안산선,안산,11821,10745,22566
20210607,안산선,신길온천,1719,1573,3292
20210607,안산선,정왕,9329,10051,19380
20210607,안산선,오이도,8192,7711,15903
20210607,안산선,수리산,4322,3583,7905
20210607,안산선,초지,4983,5374,10357
20210608,안산선,수리산,4343,3549,7892
20210608,안산선,오이도,8409,8198,16607
20210608,안산선,정왕,10050,10451,20501
20210608,안산선,신길온천,1748,1590,3338
20210608,안산선,안산,11564,10539,22103
20210608,안산선,초지,5103,5503,10606
20210608,안산선,고잔,8959,8579,17538
20210608,안산선,한대앞,9141,9223,18364
20210608,안산선,상록수,16650,16754,33404
20210608,안산선,반월,4319,4169,8488
20210608,안산선,대야미,5072,4638,9710
20210608,안산선,산본,15864,16879,32743
20210608,안산선,중앙,17128,17651,34779
20210609,안산선,수리산,4405,3582,7987
20210609,안산선,오이도,8542,8269,16811
20210609,안산선,정왕,9768,10310,20078
20210609,안산선,신길온천,1762,1613,3375
20210609,안산선,안산,11637,10382,22019
20210609,안산선,초지,5158,5704,10862
20210609,안산선,고잔,8939,8584,17523
20210609,안산선,한대앞,9049,9227,18276
20210609,안산선,상록수,16771,16800,33571
20210609,안산선,반월,4393,4158,8551
20210609,안산선,대야미,5084,4619,9703
20210609,안산선,산본,15916,17174,33090
20210609,안산선,중앙,17061,17778,34839
20210610,안산선,산본,15881,16963,32844
20210610,안산선,대야미,5008,4533,9541
20210610,안산선,반월,4274,4108,8382
20210610,안산선,상록수,16767,16921,33688
20210610,안산선,한대앞,9171,9295,18466
20210610,안산선,중앙,17120,17519,34639
20210610,안산선,고잔,8830,8426,17256
20210610,안산선,초지,5185,5616,10801
20210610,안산선,안산,11450,10486,21936
20210610,안산선,신길온천,1690,1571,3261
20210610,안산선,정왕,10008,10362,20370
20210610,안산선,오이도,8171,7972,16143
20210610,안산선,수리산,4400,3618,8018
20210611,안산선,대야미,4981,4485,9466
20210611,안산선,반월,4431,4181,8612
20210611,안산선,상록수,16629,16662,33291
20210611,안산선,한대앞,9385,9270,18655
20210611,안산선,중앙,18109,19078,37187
20210611,안산선,고잔,8770,8412,17182
20210611,안산선,산본,16093,17471,33564
20210611,안산선,안산,11859,10804,22663
20210611,안산선,신길온천,1750,1672,3422
20210611,안산선,정왕,10260,10075,20335
20210611,안산선,오이도,8429,8475,16904
20210611,안산선,수리산,4317,3319,7636
20210611,안산선,초지,4760,5154,9914
20210612,안산선,오이도,7341,7759,15100
20210612,안산선,수리산,2814,2457,5271
20210612,안산선,신길온천,1444,1340,2784
20210612,안산선,안산,10029,10332,20361
20210612,안산선,초지,3048,3069,6117
20210612,안산선,고잔,5988,5803,11791
20210612,안산선,정왕,6369,6412,12781
20210612,안산선,한대앞,6864,6852,13716
20210612,안산선,상록수,11888,11644,23532
20210612,안산선,반월,3320,3060,6380
20210612,안산선,대야미,3826,3371,7197
20210612,안산선,산본,11469,12329,23798
20210612,안산선,중앙,14853,15344,30197
20210613,안산선,수리산,2008,2046,4054
20210613,안산선,오이도,5786,5675,11461
20210613,안산선,정왕,4887,5208,10095
20210613,안산선,신길온천,1077,1026,2103
20210613,안산선,안산,9797,9056,18853
20210613,안산선,초지,2195,2189,4384
20210613,안산선,고잔,4287,4122,8409
20210613,안산선,한대앞,4956,4879,9835
20210613,안산선,상록수,8563,8475,17038
20210613,안산선,반월,2431,2412,4843
20210613,안산선,대야미,2824,2624,5448
20210613,안산선,산본,7780,8191,15971
20210613,안산선,중앙,10655,10332,20987
20210614,안산선,중앙,17169,17827,34996
20210614,안산선,대야미,4906,4549,9455
20210614,안산선,반월,4346,4185,8531
20210614,안산선,상록수,16318,16328,32646
20210614,안산선,한대앞,9594,9559,19153
20210614,안산선,고잔,8844,8351,17195
20210614,안산선,산본,15680,16889,32569
20210614,안산선,안산,11965,10881,22846
20210614,안산선,수리산,4399,3541,7940
20210614,안산선,오이도,8628,8106,16734
20210614,안산선,초지,5015,5407,10422
20210614,안산선,신길온천,1786,1638,3424
20210614,안산선,정왕,9330,10024,19354
20210615,안산선,대야미,4899,4495,9394
20210615,안산선,반월,4313,4128,8441
20210615,안산선,상록수,15782,15950,31732
20210615,안산선,한대앞,9921,9921,19842
20210615,안산선,중앙,17151,17835,34986
20210615,안산선,고잔,8739,8382,17121
20210615,안산선,산본,15531,16685,32216
20210615,안산선,안산,11607,10387,21994
20210615,안산선,신길온천,1640,1568,3208
20210615,안산선,정왕,9065,9465,18530
20210615,안산선,오이도,8393,7988,16381
20210615,안산선,수리산,4258,3402,7660
20210615,안산선,초지,4958,5465,10423
20210616,안산선,수리산,4502,3649,8151
20210616,안산선,오이도,9038,8623,17661
20210616,안산선,정왕,9476,9927,19403
20210616,안산선,신길온천,1699,1579,3278
20210616,안산선,안산,11667,10642,22309
20210616,안산선,초지,4638,4886,9524
20210616,안산선,고잔,8952,8482,17434
20210616,안산선,한대앞,9725,9648,19373
20210616,안산선,상록수,16208,16326,32534
20210616,안산선,반월,4449,4269,8718
20210616,안산선,산본,16265,17489,33754
20210616,안산선,중앙,17901,18700,36601
20210616,안산선,대야미,5096,4714,9810
20210617,안산선,한대앞,9656,9625,19281
20210617,안산선,고잔,8980,8485,17465
20210617,안산선,상록수,15749,15891,31640
20210617,안산선,반월,4388,4233,8621
20210617,안산선,대야미,5030,4488,9518
20210617,안산선,중앙,17768,18422,36190
20210617,안산선,초지,4909,5243,10152
20210617,안산선,신길온천,1691,1606,3297
20210617,안산선,정왕,8845,6386,15231
20210617,안산선,오이도,8727,8354,17081
20210617,안산선,수리산,4357,3498,7855
20210617,안산선,산본,16080,17310,33390
20210617,안산선,안산,11385,10373,21758
20210618,안산선,대야미,4891,4355,9246
20210618,안산선,반월,4245,3983,8228
20210618,안산선,상록수,15798,15782,31580
20210618,안산선,한대앞,9676,9458,19134
20210618,안산선,중앙,18233,19206,37439
20210618,안산선,고잔,8984,8762,17746
20210618,안산선,산본,15797,17073,32870
20210618,안산선,안산,11691,10632,22323
20210618,안산선,신길온천,1596,1511,3107
20210618,안산선,정왕,8806,8909,17715
20210618,안산선,오이도,8647,8539,17186
20210618,안산선,수리산,4251,3261,7512
20210618,안산선,초지,4620,4881,9501
20210619,안산선,수리산,2927,2568,5495
20210619,안산선,오이도,7881,8151,16032
20210619,안산선,정왕,6450,6545,12995
20210619,안산선,신길온천,1498,1381,2879
20210619,안산선,안산,9907,10528,20435
20210619,안산선,초지,3220,3268,6488
20210619,안산선,고잔,6297,6435,12732
20210619,안산선,대야미,3997,3466,7463
20210619,안산선,반월,3372,3223,6595
20210619,안산선,상록수,12307,12108,24415
20210619,안산선,한대앞,7341,7302,14643
20210619,안산선,중앙,15887,16340,32227
20210619,안산선,산본,12161,12940,25101
20210620,안산선,중앙,11011,11189,22200
20210620,안산선,대야미,3055,2817,5872
20210620,안산선,반월,2424,2377,4801
20210620,안산선,상록수,8652,8413,17065
20210620,안산선,한대앞,5137,4946,10083
20210620,안산선,고잔,4379,4231,8610
20210620,안산선,산본,8267,8969,17236
20210620,안산선,안산,9926,8954,18880
20210620,안산선,수리산,2092,2102,4194
20210620,안산선,오이도,6088,6034,12122
20210620,안산선,초지,2223,2226,4449
20210620,안산선,신길온천,1156,1127,2283
20210620,안산선,정왕,5067,5472,10539
20210621,안산선,산본,16176,17340,33516
20210621,안산선,대야미,5159,4736,9895
20210621,안산선,반월,4467,4212,8679
20210621,안산선,상록수,15957,15892,31849
20210621,안산선,중앙,17779,18128,35907
20210621,안산선,고잔,9048,8666,17714
20210621,안산선,한대앞,9403,9404,18807
20210621,안산선,안산,12024,10894,22918
20210621,안산선,신길온천,1796,1579,3375
20210621,안산선,정왕,8989,9687,18676
20210621,안산선,오이도,8965,8394,17359
20210621,안산선,수리산,4380,3587,7967
20210621,안산선,초지,4608,4636,9244
20210622,안산선,초지,4533,4593,9126
20210622,안산선,정왕,8799,9283,18082
20210622,안산선,오이도,8786,8420,17206
20210622,안산선,신길온천,1761,1637,3398
20210622,안산선,안산,11574,10475,22049
20210622,안산선,고잔,9204,8614,17818
20210622,안산선,산본,16252,17233,33485
20210622,안산선,한대앞,9162,8958,18120
20210622,안산선,상록수,15844,16073,31917
20210622,안산선,반월,4398,4230,8628
20210622,안산선,대야미,5090,4660,9750
20210622,안산선,수리산,4401,3595,7996
20210622,안산선,중앙,17494,18186,35680
20210623,안산선,수리산,4391,3584,7975
20210623,안산선,오이도,8607,8284,16891
20210623,안산선,정왕,8760,9245,18005
20210623,안산선,신길온천,1725,1605,3330
20210623,안산선,초지,4364,4556,8920
20210623,안산선,안산,11640,10552,22192
20210623,안산선,고잔,9217,8771,17988
20210623,안산선,한대앞,8782,8831,17613
20210623,안산선,상록수,15875,16040,31915
20210623,안산선,반월,4378,4202,8580
20210623,안산선,대야미,5037,4629,9666
20210623,안산선,산본,16199,17401,33600
20210623,안산선,중앙,16999,17824,34823
20210624,안산선,오이도,8906,8627,17533
20210624,안산선,정왕,8738,9200,17938
20210624,안산선,신길온천,1742,1619,3361
20210624,안산선,안산,11604,10465,22069
20210624,안산선,초지,4493,4646,9139
20210624,안산선,고잔,9219,8904,18123
20210624,안산선,수리산,4431,3585,8016
20210624,안산선,한대앞,9005,8997,18002
20210624,안산선,상록수,16001,16061,32062
20210624,안산선,반월,4534,4283,8817
20210624,안산선,대야미,5126,4606,9732
20210624,안산선,산본,16419,17489,33908
20210624,안산선,중앙,17655,18083,35738
20210625,안산선,산본,17069,18360,35429
20210625,안산선,대야미,5372,4790,10162
20210625,안산선,반월,4570,4325,8895
20210625,안산선,상록수,16351,16455,32806
20210625,안산선,한대앞,9344,9318,18662
20210625,안산선,중앙,18652,19694,38346
20210625,안산선,고잔,9229,8872,18101
20210625,안산선,안산,12065,11094,23159
20210625,안산선,신길온천,1836,1718,3554
20210625,안산선,정왕,8978,9121,18099
20210625,안산선,오이도,9532,9326,18858
20210625,안산선,수리산,4522,3547,8069
20210625,안산선,초지,4661,4827,9488
20210626,안산선,한대앞,6792,6727,13519
20210626,안산선,상록수,11852,11877,23729
20210626,안산선,반월,3342,3130,6472
20210626,안산선,대야미,3781,3359,7140
20210626,안산선,산본,11543,12317,23860
20210626,안산선,중앙,15097,15762,30859
20210626,안산선,고잔,5964,5876,11840
20210626,안산선,안산,9665,10166,19831
20210626,안산선,수리산,2845,2536,5381
20210626,안산선,오이도,7691,7735,15426
20210626,안산선,초지,2952,2985,5937
20210626,안산선,신길온천,1343,1390,2733
20210626,안산선,정왕,6227,6316,12543
20210627,안산선,수리산,2129,2170,4299
20210627,안산선,오이도,6265,6005,12270
20210627,안산선,산본,8261,8817,17078
20210627,안산선,대야미,3046,2818,5864
20210627,안산선,반월,2382,2385,4767
20210627,안산선,상록수,8785,8525,17310
20210627,안산선,정왕,5020,5442,10462
20210627,안산선,중앙,11113,11001,22114
20210627,안산선,고잔,4334,4221,8555
20210627,안산선,초지,2244,2189,4433
20210627,안산선,안산,9503,8679,18182
20210627,안산선,신길온천,1114,1038,2152
20210627,안산선,한대앞,5057,4996,10053
20210628,안산선,산본,15612,16745,32357
20210628,안산선,대야미,4883,4465,9348
20210628,안산선,반월,4334,4103,8437
20210628,안산선,상록수,15519,15606,31125
20210628,안산선,한대앞,8667,8602,17269
20210628,안산선,중앙,17007,17376,34383
20210628,안산선,고잔,8750,8332,17082
20210628,안산선,안산,11654,10581,22235
20210628,안산선,신길온천,1720,1518,3238
20210628,안산선,정왕,7768,8407,16175
20210628,안산선,수리산,4322,3422,7744
20210628,안산선,초지,4288,4485,8773
20210628,안산선,오이도,8474,8139,16613
20210629,안산선,산본,16274,17372,33646
20210629,안산선,중앙,17066,17687,34753
20210629,안산선,대야미,5048,4606,9654
20210629,안산선,반월,4409,4234,8643
20210629,안산선,상록수,15906,16004,31910
20210629,안산선,한대앞,8849,8757,17606
20210629,안산선,고잔,9077,8751,17828
20210629,안산선,안산,11414,10358,21772
20210629,안산선,신길온천,1670,1557,3227
20210629,안산선,정왕,7626,8190,15816
20210629,안산선,오이도,8693,8198,16891
20210629,안산선,수리산,4341,3592,7933
20210629,안산선,초지,4441,4470,8911
20210630,안산선,오이도,8754,8372,17126
20210630,안산선,정왕,7600,8262,15862
20210630,안산선,신길온천,1730,1587,3317
20210630,안산선,안산,11477,10607,22084
20210630,안산선,초지,4520,4518,9038
20210630,안산선,고잔,8806,8418,17224
20210630,안산선,수리산,4362,3541,7903
20210630,안산선,한대앞,8684,8730,17414
20210630,안산선,상록수,15800,15888,31688
20210630,안산선,반월,4404,4253,8657
20210630,안산선,대야미,5227,4704,9931
20210630,안산선,산본,16518,17590,34108
20210630,안산선,중앙,17263,17985,35248
20210701,안산선,수리산,4414,3571,7985
20210701,안산선,오이도,8941,8628,17569
20210701,안산선,정왕,7467,8108,15575
20210701,안산선,신길온천,1701,1552,3253
20210701,안산선,안산,11459,10427,21886
20210701,안산선,초지,4415,4606,9021
20210701,안산선,고잔,8805,8464,17269
20210701,안산선,한대앞,8768,8681,17449
20210701,안산선,상록수,15801,15915,31716
20210701,안산선,반월,4281,4131,8412
20210701,안산선,대야미,5110,4647,9757
20210701,안산선,산본,16266,17357,33623
20210701,안산선,중앙,17354,17888,35242
20210702,안산선,한대앞,9163,9281,18444
20210702,안산선,산본,16794,18299,35093
20210702,안산선,대야미,5275,4691,9966
20210702,안산선,반월,4507,4326,8833
20210702,안산선,상록수,16369,16346,32715
20210702,안산선,중앙,18471,19681,38152
20210702,안산선,고잔,9116,8759,17875
20210702,안산선,초지,4598,4659,9257
20210702,안산선,안산,12044,11080,23124
20210702,안산선,신길온천,1757,1703,3460
20210702,안산선,정왕,8231,8438,16669
20210702,안산선,오이도,9333,9234,18567
20210702,안산선,수리산,4560,3562,8122
20210703,안산선,수리산,2534,2247,4781
20210703,안산선,오이도,6484,6530,13014
20210703,안산선,정왕,5366,5670,11036
20210703,안산선,신길온천,1202,1139,2341
20210703,안산선,안산,8321,8983,17304
20210703,안산선,초지,2778,2773,5551
20210703,안산선,고잔,5579,5553,11132
20210703,안산선,중앙,13621,14116,27737
20210703,안산선,산본,10770,11516,22286
20210703,안산선,대야미,3485,3134,6619
20210703,안산선,반월,3034,2809,5843
20210703,안산선,상록수,10557,10792,21349
20210703,안산선,한대앞,6153,6109,12262
20210704,안산선,오이도,4596,4608,9204
20210704,안산선,정왕,4222,4507,8729
20210704,안산선,신길온천,895,852,1747
20210704,안산선,안산,8017,7311,15328
20210704,안산선,초지,1850,1844,3694
20210704,안산선,고잔,3599,3417,7016
20210704,안산선,수리산,1679,1487,3166
20210704,안산선,한대앞,4327,4154,8481
20210704,안산선,상록수,7639,7426,15065
20210704,안산선,반월,2027,2026,4053
20210704,안산선,대야미,2272,2154,4426
20210704,안산선,산본,7128,7730,14858
20210704,안산선,중앙,9549,9461,19010
20210705,안산선,대야미,5108,4658,9766
20210705,안산선,반월,4452,4278,8730
20210705,안산선,상록수,15677,15731,31408
20210705,안산선,한대앞,8709,8717,17426
20210705,안산선,중앙,17590,17816,35406
20210705,안산선,고잔,8949,8388,17337
20210705,안산선,산본,16230,17185,33415
20210705,안산선,안산,11816,10920,22736
20210705,안산선,신길온천,1728,1597,3325
20210705,안산선,정왕,7816,8622,16438
20210705,안산선,오이도,8673,8251,16924
20210705,안산선,수리산,4345,3550,7895
20210705,안산선,초지,4470,4556,9026
20210706,안산선,수리산,4282,3565,7847
20210706,안산선,오이도,8703,8345,17048
20210706,안산선,정왕,7570,8202,15772
20210706,안산선,신길온천,1729,1567,3296
20210706,안산선,안산,11760,10566,22326
20210706,안산선,초지,4443,4579,9022
20210706,안산선,고잔,8890,8563,17453
20210706,안산선,한대앞,8841,8782,17623
20210706,안산선,상록수,15743,15936,31679
20210706,안산선,반월,4360,4260,8620
20210706,안산선,대야미,5202,4683,9885
20210706,안산선,산본,16647,17615,34262
20210706,안산선,중앙,17411,17908,35319
20210707,안산선,초지,4299,4415,8714
20210707,안산선,오이도,8443,8066,16509
20210707,안산선,정왕,7326,8066,15392
20210707,안산선,신길온천,1694,1581,3275
20210707,안산선,안산,11452,10328,21780
20210707,안산선,고잔,8646,8233,16879
20210707,안산선,수리산,4261,3528,7789
20210707,안산선,한대앞,8394,8532,16926
20210707,안산선,산본,15832,17070,32902
20210707,안산선,대야미,4958,4505,9463
20210707,안산선,중앙,16554,17213,33767
20210707,안산선,상록수,15193,15464,30657
20210707,안산선,반월,4377,4142,8519
20210708,안산선,오이도,8047,7750,15797
20210708,안산선,정왕,7169,7702,14871
20210708,안산선,신길온천,1610,1517,3127
20210708,안산선,안산,11141,9956,21097
20210708,안산선,초지,4145,4355,8500
20210708,안산선,고잔,8721,8296,17017
20210708,안산선,수리산,4205,3391,7596
20210708,안산선,한대앞,8320,8254,16574
20210708,안산선,상록수,15121,15376,30497
20210708,안산선,반월,4275,4131,8406
20210708,안산선,대야미,4824,4385,9209
20210708,안산선,산본,15490,16723,32213
20210708,안산선,중앙,16155,17070,33225
20210709,안산선,수리산,4200,3346,7546
20210709,안산선,오이도,8284,8106,16390
20210709,안산선,정왕,7856,8200,16056
20210709,안산선,신길온천,1690,1613,3303
20210709,안산선,안산,11478,10610,22088
20210709,안산선,초지,4213,4408,8621
20210709,안산선,고잔,8511,8392,16903
20210709,안산선,한대앞,8720,8645,17365
20210709,안산선,상록수,15292,15326,30618
20210709,안산선,반월,4281,4060,8341
20210709,안산선,산본,15438,16782,32220
20210709,안산선,중앙,16669,17830,34499
20210709,안산선,대야미,4999,4428,9427
20210710,안산선,산본,10234,10852,21086
20210710,안산선,중앙,12097,12690,24787
20210710,안산선,대야미,3407,3013,6420
20210710,안산선,반월,2771,2605,5376
20210710,안산선,상록수,10227,10215,20442
20210710,안산선,한대앞,5730,5837,11567
20210710,안산선,고잔,4833,4713,9546
20210710,안산선,안산,8251,8858,17109
20210710,안산선,신길온천,1202,1189,2391
20210710,안산선,정왕,5558,5660,11218
20210710,안산선,오이도,6034,6302,12336
20210710,안산선,수리산,2537,2156,4693
20210710,안산선,초지,2524,2606,5130
20210711,안산선,오이도,4543,4367,8910
20210711,안산선,정왕,4140,4607,8747
20210711,안산선,신길온천,932,861,1793
20210711,안산선,안산,7821,7034,14855
20210711,안산선,초지,1724,1556,3280
20210711,안산선,고잔,3336,3184,6520
20210711,안산선,수리산,1636,1532,3168
20210711,안산선,한대앞,4078,4098,8176
20210711,안산선,상록수,6943,6994,13937
20210711,안산선,반월,1948,1972,3920
20210711,안산선,대야미,2282,2116,4398
20210711,안산선,산본,6377,6913,13290
20210711,안산선,중앙,8855,8564,17419
20210712,안산선,수리산,3780,3092,6872
20210712,안산선,오이도,7543,7220,14763
20210712,안산선,정왕,7005,7515,14520
20210712,안산선,신길온천,1576,1447,3023
20210712,안산선,안산,10873,9968,20841
20210712,안산선,초지,3873,3957,7830
20210712,안산선,고잔,8022,7620,15642
20210712,안산선,한대앞,7708,7660,15368
20210712,안산선,상록수,13977,13924,27901
20210712,안산선,반월,3782,3661,7443
20210712,안산선,대야미,4428,4077,8505
20210712,안산선,산본,14141,15147,29288
20210712,안산선,중앙,14643,15040,29683
20210713,안산선,한대앞,7489,7633,15122
20210713,안산선,산본,13887,15130,29017
20210713,안산선,대야미,4311,3965,8276
20210713,안산선,반월,3746,3664,7410
20210713,안산선,상록수,13917,14103,28020
20210713,안산선,중앙,14508,15003,29511
20210713,안산선,고잔,7911,7455,15366
20210713,안산선,초지,3795,3968,7763
20210713,안산선,안산,10629,9497,20126
20210713,안산선,신길온천,1455,1378,2833
20210713,안산선,정왕,6681,7174,13855
20210713,안산선,오이도,7343,6997,14340
20210713,안산선,수리산,3754,3103,6857
20210714,안산선,산본,13952,15015,28967
20210714,안산선,대야미,4457,4066,8523
20210714,안산선,반월,3746,3636,7382
20210714,안산선,상록수,13686,13705,27391
20210714,안산선,한대앞,7458,7566,15024
20210714,안산선,중앙,14553,15138,29691
20210714,안산선,고잔,7813,7372,15185
20210714,안산선,초지,3815,3898,7713
20210714,안산선,안산,10487,9417,19904
20210714,안산선,신길온천,1455,1351,2806
20210714,안산선,정왕,6569,7122,13691
20210714,안산선,오이도,7458,7227,14685
20210714,안산선,수리산,3722,3036,6758
20210715,안산선,대야미,4254,3910,8164
20210715,안산선,반월,3551,3463,7014
20210715,안산선,상록수,13468,13562,27030
20210715,안산선,한대앞,7386,7333,14719
20210715,안산선,중앙,14087,14682,28769
20210715,안산선,고잔,7627,7237,14864
20210715,안산선,산본,13422,14665,28087
20210715,안산선,안산,10332,9293,19625
20210715,안산선,신길온천,1439,1320,2759
20210715,안산선,정왕,6496,7082,13578
20210715,안산선,오이도,7274,7014,14288
20210715,안산선,수리산,3685,2948,6633
20210715,안산선,초지,3796,3848,7644
20210716,안산선,대야미,4342,3844,8186
20210716,안산선,반월,3670,3486,7156
20210716,안산선,상록수,13552,13760,27312
20210716,안산선,한대앞,7547,7680,15227
20210716,안산선,중앙,14470,15396,29866
20210716,안산선,고잔,7710,7301,15011
20210716,안산선,산본,13740,14909,28649
20210716,안산선,안산,10454,9621,20075
20210716,안산선,신길온천,1480,1349,2829
20210716,안산선,정왕,6880,7152,14032
20210716,안산선,오이도,7643,7533,15176
20210716,안산선,수리산,3743,2963,6706
20210716,안산선,초지,3767,3884,7651
20210717,안산선,반월,2462,2409,4871
20210717,안산선,대야미,2929,2638,5567
20210717,안산선,산본,8916,9641,18557
20210717,안산선,상록수,8995,9019,18014
20210717,안산선,한대앞,5099,5163,10262
20210717,안산선,중앙,10772,11189,21961
20210717,안산선,고잔,4166,4106,8272
20210717,안산선,안산,7582,8187,15769
20210717,안산선,신길온천,1027,1041,2068
20210717,안산선,정왕,4941,5093,10034
20210717,안산선,오이도,5784,5970,11754
20210717,안산선,수리산,2283,2070,4353
20210717,안산선,초지,2144,2246,4390
20210718,안산선,중앙,7965,7667,15632
20210718,안산선,대야미,2135,2041,4176
20210718,안산선,반월,1715,1789,3504
20210718,안산선,상록수,6482,6347,12829
20210718,안산선,한대앞,3746,3810,7556
20210718,안산선,고잔,3077,2877,5954
20210718,안산선,산본,6125,6473,12598
20210718,안산선,안산,7525,6757,14282
20210718,안산선,수리산,1537,1492,3029
20210718,안산선,오이도,4556,4702,9258
20210718,안산선,초지,1580,1526,3106
20210718,안산선,신길온천,858,774,1632
20210718,안산선,정왕,3864,4202,8066
20210719,안산선,대야미,4276,3909,8185
20210719,안산선,반월,3701,3588,7289
20210719,안산선,상록수,13789,13885,27674
20210719,안산선,한대앞,7570,7600,15170
20210719,안산선,중앙,14754,14957,29711
20210719,안산선,고잔,7839,7451,15290
20210719,안산선,산본,13455,14607,28062
20210719,안산선,안산,10772,9830,20602
20210719,안산선,신길온천,1505,1374,2879
20210719,안산선,정왕,6697,7309,14006
20210719,안산선,오이도,7418,7042,14460
20210719,안산선,수리산,3664,2972,6636
20210719,안산선,초지,3804,3864,7668
20210720,안산선,산본,13729,14972,28701
20210720,안산선,대야미,4404,4011,8415
20210720,안산선,반월,3662,3567,7229
20210720,안산선,상록수,13770,14009,27779
20210720,안산선,한대앞,7363,7482,14845
20210720,안산선,중앙,14508,14988,29496
20210720,안산선,고잔,7798,7266,15064
20210720,안산선,안산,10681,9486,20167
20210720,안산선,신길온천,1491,1403,2894
20210720,안산선,정왕,6531,7109,13640
20210720,안산선,수리산,3767,3064,6831
20210720,안산선,초지,3803,3917,7720
20210720,안산선,오이도,7386,7164,14550
20210721,안산선,수리산,3636,2922,6558
20210721,안산선,초지,3749,3781,7530
20210721,안산선,오이도,7510,7267,14777
20210721,안산선,정왕,6427,7000,13427
20210721,안산선,신길온천,1446,1392,2838
20210721,안산선,안산,10291,9318,19609
20210721,안산선,고잔,7665,7322,14987
20210721,안산선,한대앞,7378,7386,14764
20210721,안산선,상록수,13387,13624,27011
20210721,안산선,반월,3715,3560,7275
20210721,안산선,대야미,4265,3875,8140
20210721,안산선,산본,13584,14560,28144
20210721,안산선,중앙,14105,14646,28751
20210722,안산선,대야미,4232,3901,8133
20210722,안산선,반월,3474,3361,6835
20210722,안산선,상록수,13191,13470,26661
20210722,안산선,한대앞,7210,7277,14487
20210722,안산선,중앙,14176,14635,28811
20210722,안산선,고잔,7386,7119,14505
20210722,안산선,산본,13383,14346,27729
20210722,안산선,안산,10168,9110,19278
20210722,안산선,신길온천,1456,1363,2819
20210722,안산선,정왕,6365,6867,13232
20210722,안산선,오이도,7386,7161,14547
20210722,안산선,수리산,3598,2895,6493
20210722,안산선,초지,3680,3833,7513
20210723,안산선,수리산,3646,2848,6494
20210723,안산선,오이도,7629,7594,15223
20210723,안산선,정왕,6900,7216,14116
20210723,안산선,신길온천,1499,1394,2893
20210723,안산선,안산,10570,9672,20242
20210723,안산선,초지,3780,3820,7600
20210723,안산선,고잔,7607,7145,14752
20210723,안산선,한대앞,7531,7595,15126
20210723,안산선,상록수,13673,13892,27565
20210723,안산선,반월,3671,3522,7193
20210723,안산선,대야미,4266,3860,8126
20210723,안산선,산본,13582,15002,28584
20210723,안산선,중앙,14630,15436,30066
20210724,안산선,중앙,10699,11217,21916
20210724,안산선,대야미,2880,2643,5523
20210724,안산선,반월,2568,2396,4964
20210724,안산선,상록수,9003,8873,17876
20210724,안산선,한대앞,5137,5253,10390
20210724,안산선,고잔,4062,4019,8081
20210724,안산선,산본,8745,9469,18214
20210724,안산선,안산,7527,7843,15370
20210724,안산선,신길온천,992,1047,2039
20210724,안산선,정왕,4730,4939,9669
20210724,안산선,오이도,5860,5983,11843
20210724,안산선,수리산,2217,1931,4148
20210724,안산선,초지,2220,2298,4518
20210725,안산선,수리산,1487,1416,2903
20210725,안산선,오이도,4681,4580,9261
20210725,안산선,정왕,3603,3984,7587
20210725,안산선,신길온천,772,749,1521
20210725,안산선,안산,7096,6434,13530
20210725,안산선,초지,1569,1529,3098
20210725,안산선,고잔,2868,2772,5640
20210725,안산선,중앙,7924,7645,15569
20210725,안산선,한대앞,3667,3681,7348
20210725,안산선,상록수,6353,6390,12743
20210725,안산선,반월,1672,1681,3353
20210725,안산선,대야미,2060,1921,3981
20210725,안산선,산본,5917,6324,12241
20210726,안산선,상록수,13523,13571,27094
20210726,안산선,반월,3621,3488,7109
20210726,안산선,수리산,3608,2833,6441
20210726,안산선,오이도,7599,7235,14834
20210726,안산선,정왕,6581,7106,13687
20210726,안산선,신길온천,1482,1363,2845
20210726,안산선,안산,10403,9357,19760
20210726,안산선,산본,13633,15116,28749
20210726,안산선,초지,3712,3774,7486
20210726,안산선,고잔,7516,6985,14501
20210726,안산선,중앙,14242,14627,28869
20210726,안산선,한대앞,7284,7264,14548
20210726,안산선,대야미,4186,3741,7927
20210727,안산선,오이도,7464,7187,14651
20210727,안산선,정왕,6421,6973,13394
20210727,안산선,신길온천,1444,1313,2757
20210727,안산선,안산,10125,9053,19178
20210727,안산선,초지,3650,3716,7366
20210727,안산선,고잔,7302,6934,14236
20210727,안산선,수리산,3657,2924,6581
20210727,안산선,한대앞,7279,7324,14603
20210727,안산선,상록수,13426,13629,27055
20210727,안산선,반월,3520,3410,6930
20210727,안산선,산본,13320,14410,27730
20210727,안산선,대야미,4142,3801,7943
20210727,안산선,중앙,14116,14607,28723
20210728,안산선,수리산,3515,2842,6357
20210728,안산선,오이도,7464,7144,14608
20210728,안산선,정왕,6391,6989,13380
20210728,안산선,신길온천,1415,1336,2751
20210728,안산선,안산,9956,9144,19100
20210728,안산선,초지,3662,3720,7382
20210728,안산선,고잔,7450,7018,14468
20210728,안산선,한대앞,7135,7184,14319
20210728,안산선,상록수,13310,13525,26835
20210728,안산선,반월,3503,3376,6879
20210728,안산선,대야미,4100,3787,7887
20210728,안산선,산본,13249,14325,27574
20210728,안산선,중앙,14001,14405,28406
20210729,안산선,중앙,13832,14305,28137
20210729,안산선,대야미,4043,3733,7776
20210729,안산선,반월,3439,3329,6768
20210729,안산선,상록수,13123,13252,26375
20210729,안산선,한대앞,7133,7226,14359
20210729,안산선,고잔,7273,6915,14188
20210729,안산선,산본,13143,14174,27317
20210729,안산선,안산,9938,9007,18945
20210729,안산선,수리산,3496,2862,6358
20210729,안산선,오이도,7225,6977,14202
20210729,안산선,초지,3502,3622,7124
20210729,안산선,신길온천,1422,1313,2735
20210729,안산선,정왕,6379,6830,13209
20210730,안산선,정왕,6819,7025,13844
20210730,안산선,오이도,7477,7422,14899
20210730,안산선,수리산,3527,2790,6317
20210730,안산선,산본,13580,14718,28298
20210730,안산선,대야미,4189,3764,7953
20210730,안산선,반월,3583,3381,6964
20210730,안산선,신길온천,1474,1410,2884
20210730,안산선,한대앞,7254,7318,14572
20210730,안산선,중앙,14311,15022,29333
20210730,안산선,고잔,7279,6907,14186
20210730,안산선,초지,3624,3754,7378
20210730,안산선,안산,10123,9488,19611
20210730,안산선,상록수,13230,13324,26554
20210731,안산선,수리산,2101,1814,3915
20210731,안산선,오이도,5862,6020,11882
20210731,안산선,정왕,4801,4864,9665
20210731,안산선,신길온천,1003,954,1957
20210731,안산선,안산,7684,7959,15643
20210731,안산선,초지,2183,2174,4357
20210731,안산선,고잔,3867,3792,7659
20210731,안산선,한대앞,4853,4981,9834
20210731,안산선,상록수,8544,8723,17267
20210731,안산선,반월,2481,2317,4798
20210731,안산선,산본,8701,9503,18204
20210731,안산선,중앙,10372,10868,21240
20210731,안산선,대야미,2712,2413,5125
20210801,안산선,산본,5806,6205,12011
20210801,안산선,중앙,7336,7269,14605
20210801,안산선,대야미,1960,1859,3819
20210801,안산선,반월,1681,1669,3350
20210801,안산선,상록수,6169,5903,12072
20210801,안산선,한대앞,3676,3589,7265
20210801,안산선,고잔,2828,2604,5432
20210801,안산선,안산,6721,6363,13084
20210801,안산선,신길온천,782,740,1522
20210801,안산선,정왕,3703,3807,7510
20210801,안산선,오이도,4417,4225,8642
20210801,안산선,수리산,1449,1292,2741
20210801,안산선,초지,1478,1452,2930
20210802,안산선,대야미,3820,3563,7383
20210802,안산선,반월,3330,3216,6546
20210802,안산선,상록수,12242,12043,24285
20210802,안산선,한대앞,6739,6704,13443
20210802,안산선,중앙,13601,13717,27318
20210802,안산선,고잔,7147,6751,13898
20210802,안산선,산본,12599,13559,26158
20210802,안산선,안산,9969,9647,19616
20210802,안산선,신길온천,1357,1203,2560
20210802,안산선,정왕,5907,6237,12144
20210802,안산선,오이도,6656,6526,13182
20210802,안산선,수리산,3257,2668,5925
20210802,안산선,초지,3193,3198,6391
20210803,안산선,산본,12696,13776,26472
20210803,안산선,대야미,3952,3652,7604
20210803,안산선,반월,3288,3246,6534
20210803,안산선,상록수,12289,12303,24592
20210803,안산선,한대앞,6512,6603,13115
20210803,안산선,중앙,13628,13867,27495
20210803,안산선,고잔,7014,6701,13715
20210803,안산선,안산,9533,9095,18628
20210803,안산선,신길온천,1285,1145,2430
20210803,안산선,정왕,5932,6283,12215
20210803,안산선,오이도,7002,6840,13842
20210803,안산선,수리산,3293,2699,5992
20210803,안산선,초지,3182,3211,6393
20210804,안산선,초지,3319,3373,6692
20210804,안산선,오이도,6998,6813,13811
20210804,안산선,정왕,5826,6316,12142
20210804,안산선,신길온천,1345,1256,2601
20210804,안산선,안산,9359,8876,18235
20210804,안산선,고잔,6918,6581,13499
20210804,안산선,수리산,3307,2725,6032
20210804,안산선,한대앞,6683,6663,13346
20210804,안산선,산본,12894,13974,26868
20210804,안산선,대야미,3904,3620,7524
20210804,안산선,중앙,13823,14093,27916
20210804,안산선,상록수,12518,12489,25007
20210804,안산선,반월,3327,3259,6586
20210805,안산선,수리산,3412,2787,6199
20210805,안산선,오이도,7314,7089,14403
20210805,안산선,정왕,6178,6528,12706
20210805,안산선,신길온천,1411,1263,2674
20210805,안산선,초지,3587,3676,7263
20210805,안산선,고잔,7102,6747,13849
20210805,안산선,안산,9537,8749,18286
20210805,안산선,한대앞,7043,7052,14095
20210805,안산선,상록수,12963,12902,25865
20210805,안산선,반월,3427,3304,6731
20210805,안산선,대야미,4144,3826,7970
20210805,안산선,산본,13190,14140,27330
20210805,안산선,중앙,13988,14572,28560
20210806,안산선,한대앞,7121,7263,14384
20210806,안산선,대야미,4182,3786,7968
20210806,안산선,산본,13491,14692,28183
20210806,안산선,반월,3527,3438,6965
20210806,안산선,상록수,13116,13175,26291
20210806,안산선,중앙,14446,15241,29687
20210806,안산선,오이도,7378,7371,14749
20210806,안산선,초지,3527,3720,7247
20210806,안산선,안산,9821,9150,18971
20210806,안산선,신길온천,1370,1221,2591
20210806,안산선,정왕,6437,6644,13081
20210806,안산선,수리산,3401,2679,6080
20210806,안산선,고잔,7215,6846,14061
20210807,안산선,수리산,2296,1966,4262
20210807,안산선,오이도,6244,6436,12680
20210807,안산선,정왕,4827,5066,9893
20210807,안산선,신길온천,1055,1027,2082
20210807,안산선,초지,2261,2428,4689
20210807,안산선,안산,7510,7558,15068
20210807,안산선,고잔,4173,4052,8225
20210807,안산선,한대앞,5352,5327,10679
20210807,안산선,상록수,9356,9494,18850
20210807,안산선,반월,2511,2453,4964
20210807,안산선,대야미,2945,2691,5636
20210807,안산선,산본,9360,10146,19506
20210807,안산선,중앙,11571,11888,23459
20210808,안산선,대야미,2174,1986,4160
20210808,안산선,반월,1785,1785,3570
20210808,안산선,상록수,6653,6568,13221
20210808,안산선,한대앞,3853,3831,7684
20210808,안산선,중앙,7880,7683,15563
20210808,안산선,고잔,3014,2919,5933
20210808,안산선,산본,6363,6961,13324
20210808,안산선,안산,6622,6164,12786
20210808,안산선,신길온천,781,823,1604
20210808,안산선,정왕,3702,3944,7646
20210808,안산선,오이도,4853,4830,9683
20210808,안산선,수리산,1555,1495,3050
20210808,안산선,초지,1585,1527,3112
20210809,안산선,초지,3830,3899,7729
20210809,안산선,안산,10482,9723,20205
20210809,안산선,신길온천,1530,1351,2881
20210809,안산선,수리산,3669,3011,6680
20210809,안산선,오이도,7785,7470,15255
20210809,안산선,정왕,6671,7096,13767
20210809,안산선,고잔,7735,7212,14947
20210809,안산선,대야미,4358,4006,8364
20210809,안산선,반월,3714,3611,7325
20210809,안산선,상록수,13955,13963,27918
20210809,안산선,한대앞,7638,7594,15232
20210809,안산선,중앙,14748,15070,29818
20210809,안산선,산본,13935,15024,28959
20210810,안산선,산본,13814,14893,28707
20210810,안산선,대야미,4279,3969,8248
20210810,안산선,반월,3719,3573,7292
20210810,안산선,상록수,13733,13943,27676
20210810,안산선,한대앞,7479,7559,15038
20210810,안산선,중앙,14756,15105,29861
20210810,안산선,고잔,7629,7341,14970
20210810,안산선,안산,10392,9350,19742
20210810,안산선,수리산,3655,2996,6651
20210810,안산선,오이도,7640,7277,14917
20210810,안산선,초지,3787,3996,7783
20210810,안산선,신길온천,1516,1388,2904
20210810,안산선,정왕,6579,7057,13636
20210811,안산선,오이도,7623,7367,14990
20210811,안산선,정왕,6578,6998,13576
20210811,안산선,신길온천,1495,1339,2834
20210811,안산선,안산,10238,9214,19452
20210811,안산선,초지,3877,3961,7838
20210811,안산선,고잔,7624,7272,14896
20210811,안산선,수리산,3702,2960,6662
20210811,안산선,한대앞,7453,7577,15030
20210811,안산선,상록수,13631,13884,27515
20210811,안산선,반월,3681,3591,7272
20210811,안산선,대야미,4471,4064,8535
20210811,안산선,산본,13918,15069,28987
20210811,안산선,중앙,14766,15326,30092
20210812,안산선,산본,13953,15167,29120
20210812,안산선,대야미,4384,3919,8303
20210812,안산선,반월,3655,3514,7169
20210812,안산선,상록수,13597,13676,27273
20210812,안산선,한대앞,7431,7457,14888
20210812,안산선,중앙,14602,15161,29763
20210812,안산선,고잔,7639,7228,14867
20210812,안산선,안산,10063,9133,19196
20210812,안산선,신길온천,1459,1327,2786
20210812,안산선,정왕,6501,6936,13437
20210812,안산선,수리산,3728,3045,6773
20210812,안산선,초지,3847,3962,7809
20210812,안산선,오이도,7442,7227,14669
20210813,안산선,수리산,3756,3022,6778
20210813,안산선,초지,3833,3979,7812
20210813,안산선,오이도,7658,7511,15169
20210813,안산선,정왕,7022,7226,14248
20210813,안산선,신길온천,1453,1368,2821
20210813,안산선,안산,10545,9607,20152
20210813,안산선,고잔,7703,7280,14983
20210813,안산선,한대앞,7744,7741,15485
20210813,안산선,상록수,13853,13876,27729
20210813,안산선,반월,3778,3599,7377
20210813,안산선,대야미,4461,4092,8553
20210813,안산선,산본,14174,15330,29504
20210813,안산선,중앙,15012,15828,30840
20210814,안산선,대야미,3070,2769,5839
20210814,안산선,반월,2676,2607,5283
20210814,안산선,상록수,9778,9918,19696
20210814,안산선,한대앞,5437,5572,11009
20210814,안산선,중앙,11485,12024,23509
20210814,안산선,고잔,4656,4474,9130
20210814,안산선,산본,9702,10412,20114
20210814,안산선,안산,7961,8124,16085
20210814,안산선,신길온천,1116,1038,2154
20210814,안산선,정왕,5120,5286,10406
20210814,안산선,오이도,6283,6493,12776
20210814,안산선,수리산,2304,2046,4350
20210814,안산선,초지,2498,2529,5027
20210815,안산선,산본,7084,7576,14660
20210815,안산선,대야미,2301,2112,4413
20210815,안산선,반월,1988,2039,4027
20210815,안산선,상록수,7216,7166,14382
20210815,안산선,한대앞,4113,4091,8204
20210815,안산선,중앙,8987,8985,17972
20210815,안산선,고잔,3380,3289,6669
20210815,안산선,안산,7427,6904,14331
20210815,안산선,신길온천,881,836,1717
20210815,안산선,정왕,4181,4193,8374
20210815,안산선,오이도,5792,5700,11492
20210815,안산선,수리산,1696,1724,3420
20210815,안산선,초지,1796,1826,3622
20210816,안산선,초지,2303,2215,4518
20210816,안산선,오이도,6302,6125,12427
20210816,안산선,정왕,4562,5096,9658
20210816,안산선,신길온천,1095,1037,2132
20210816,안산선,안산,7170,7003,14173
20210816,안산선,고잔,4162,3841,8003
20210816,안산선,수리산,2226,1987,4213
20210816,안산선,한대앞,5253,5193,10446
20210816,안산선,산본,9155,9947,19102
20210816,안산선,대야미,3054,2774,5828
20210816,안산선,중앙,10962,10741,21703
20210816,안산선,상록수,9432,9351,18783
20210816,안산선,반월,2632,2548,5180
20210817,안산선,수리산,3762,3160,6922
20210817,안산선,오이도,7498,7152,14650
20210817,안산선,정왕,6672,7274,13946
20210817,안산선,신길온천,1503,1353,2856
20210817,안산선,초지,3938,3963,7901
20210817,안산선,고잔,7839,7422,15261
20210817,안산선,안산,10082,9387,19469
20210817,안산선,한대앞,7687,7725,15412
20210817,안산선,상록수,13632,13839,27471
20210817,안산선,반월,3776,3616,7392
20210817,안산선,대야미,4324,3997,8321
20210817,안산선,산본,14159,15266,29425
20210817,안산선,중앙,14770,14999,29769
20210818,안산선,한대앞,7511,7605,15116
20210818,안산선,산본,13933,14972,28905
20210818,안산선,대야미,4387,4061,8448
20210818,안산선,반월,3595,3498,7093
20210818,안산선,상록수,13439,13800,27239
20210818,안산선,중앙,14426,14937,29363
20210818,안산선,오이도,7131,6854,13985
20210818,안산선,초지,3916,3975,7891
20210818,안산선,안산,10310,9266,19576
20210818,안산선,신길온천,1406,1346,2752
20210818,안산선,정왕,6509,7030,13539
20210818,안산선,수리산,3638,2910,6548
20210818,안산선,고잔,7506,7167,14673
20210819,안산선,초지,4027,4109,8136
20210819,안산선,수리산,3889,3212,7101
20210819,안산선,오이도,7729,7421,15150
20210819,안산선,정왕,6854,7245,14099
20210819,안산선,신길온천,1588,1475,3063
20210819,안산선,고잔,7940,7570,15510
20210819,안산선,안산,10504,9449,19953
20210819,안산선,한대앞,7698,7775,15473
20210819,안산선,중앙,14971,15570,30541
20210819,안산선,상록수,14174,14394,28568
20210819,안산선,반월,3853,3796,7649
20210819,안산선,대야미,4603,4203,8806
20210819,안산선,산본,14291,15477,29768
20210820,안산선,오이도,7908,7710,15618
20210820,안산선,정왕,7107,7487,14594
20210820,안산선,신길온천,1523,1498,3021
20210820,안산선,안산,10807,9881,20688
20210820,안산선,초지,4016,4347,8363
20210820,안산선,중앙,15391,16385,31776
20210820,안산선,수리산,3873,3162,7035
20210820,안산선,상록수,14535,14710,29245
20210820,안산선,반월,3961,3884,7845
20210820,안산선,대야미,4726,4226,8952
20210820,안산선,산본,14356,15620,29976
20210820,안산선,고잔,7928,7735,15663
20210820,안산선,한대앞,7894,8011,15905
20210821,안산선,산본,8640,9339,17979
20210821,안산선,대야미,2684,2449,5133
20210821,안산선,반월,2389,2309,4698
20210821,안산선,상록수,8873,8939,17812
20210821,안산선,한대앞,4954,4911,9865
20210821,안산선,중앙,10250,10690,20940
20210821,안산선,고잔,4110,3995,8105
20210821,안산선,안산,6684,6926,13610
20210821,안산선,신길온천,986,932,1918
20210821,안산선,정왕,4452,4667,9119
20210821,안산선,오이도,4973,5084,10057
20210821,안산선,수리산,2071,1716,3787
20210821,안산선,초지,2243,2217,4460
20210822,안산선,안산,7503,6989,14492
20210822,안산선,수리산,1741,1646,3387
20210822,안산선,오이도,5154,5027,10181
20210822,안산선,정왕,4091,4325,8416
20210822,안산선,신길온천,953,917,1870
20210822,안산선,초지,1819,1803,3622
20210822,안산선,대야미,2525,2369,4894
20210822,안산선,중앙,9169,9177,18346
20210822,안산선,한대앞,4312,4207,8519
20210822,안산선,상록수,7511,7301,14812
20210822,안산선,반월,2046,2053,4099
20210822,안산선,고잔,3462,3322,6784
20210822,안산선,산본,7152,7487,14639
20210823,안산선,수리산,3682,3119,6801
20210823,안산선,오이도,7286,6895,14181
20210823,안산선,정왕,6688,7250,13938
20210823,안산선,신길온천,1467,1325,2792
20210823,안산선,안산,10273,9487,19760
20210823,안산선,초지,3795,3972,7767
20210823,안산선,고잔,7803,7265,15068
20210823,안산선,중앙,14323,14618,28941
20210823,안산선,한대앞,7608,7542,15150
20210823,안산선,상록수,13860,13885,27745
20210823,안산선,반월,3842,3705,7547
20210823,안산선,대야미,4308,3958,8266
20210823,안산선,산본,13818,14836,28654
20210824,안산선,대야미,4309,3951,8260
20210824,안산선,반월,3695,3664,7359
20210824,안산선,상록수,13766,13933,27699
20210824,안산선,한대앞,7441,7548,14989
20210824,안산선,중앙,14357,14873,29230
20210824,안산선,고잔,7755,7403,15158
20210824,안산선,산본,13721,14863,28584
20210824,안산선,안산,10313,9250,19563
20210824,안산선,신길온천,1452,1334,2786
20210824,안산선,정왕,6540,7123,13663
20210824,안산선,오이도,7210,6883,14093
20210824,안산선,수리산,3707,2960,6667
20210824,안산선,초지,3844,4001,7845
20210825,안산선,대야미,4652,4239,8891
20210825,안산선,반월,4025,4001,8026
20210825,안산선,상록수,14443,14591,29034
20210825,안산선,한대앞,7861,7788,15649
20210825,안산선,중앙,15186,15794,30980
20210825,안산선,고잔,7970,7715,15685
20210825,안산선,산본,14614,15762,30376
20210825,안산선,안산,10660,9600,20260
20210825,안산선,신길온천,1590,1470,3060
20210825,안산선,정왕,6996,7429,14425
20210825,안산선,오이도,7598,7367,14965
20210825,안산선,수리산,3892,3165,7057
20210825,안산선,초지,4007,4264,8271
20210826,안산선,수리산,3976,3287,7263
20210826,안산선,오이도,7863,7558,15421
20210826,안산선,정왕,6789,7305,14094
20210826,안산선,신길온천,1639,1495,3134
20210826,안산선,안산,10581,9442,20023
20210826,안산선,초지,3967,4163,8130
20210826,안산선,고잔,8115,7691,15806
20210826,안산선,한대앞,7929,7882,15811
20210826,안산선,상록수,14339,14696,29035
20210826,안산선,반월,4131,3946,8077
20210826,안산선,대야미,4618,4133,8751
20210826,안산선,산본,14508,15592,30100
20210826,안산선,중앙,14850,15730,30580
20210827,안산선,초지,3978,4222,8200
20210827,안산선,오이도,7752,7542,15294
20210827,안산선,정왕,7046,7464,14510
20210827,안산선,신길온천,1493,1451,2944
20210827,안산선,안산,10637,9693,20330
20210827,안산선,고잔,7830,7533,15363
20210827,안산선,수리산,3855,3093,6948
20210827,안산선,한대앞,7852,7869,15721
20210827,안산선,상록수,14179,14378,28557
20210827,안산선,반월,3965,3848,7813
20210827,안산선,대야미,4445,3930,8375
20210827,안산선,산본,14352,15617,29969
20210827,안산선,중앙,15186,16091,31277
20210828,안산선,수리산,2619,2351,4970
20210828,안산선,정왕,5322,5486,10808
20210828,안산선,신길온천,1211,1210,2421
20210828,안산선,안산,8172,8384,16556
20210828,안산선,초지,2764,2800,5564
20210828,안산선,고잔,5213,5068,10281
20210828,안산선,산본,10668,11599,22267
20210828,안산선,한대앞,6042,6023,12065
20210828,안산선,상록수,10467,10589,21056
20210828,안산선,반월,2996,2806,5802
20210828,안산선,대야미,3528,3146,6674
20210828,안산선,중앙,13009,13478,26487
20210828,안산선,오이도,6823,6880,13703
20210829,안산선,수리산,1739,1644,3383
20210829,안산선,오이도,5126,5052,10178
20210829,안산선,정왕,4317,4672,8989
20210829,안산선,신길온천,856,871,1727
20210829,안산선,안산,7655,6928,14583
20210829,안산선,초지,2010,1856,3866
20210829,안산선,고잔,3575,3506,7081
20210829,안산선,중앙,9400,9533,18933
20210829,안산선,한대앞,4487,4247,8734
20210829,안산선,상록수,7554,7335,14889
20210829,안산선,반월,2046,2056,4102
20210829,안산선,대야미,2541,2315,4856
20210829,안산선,산본,7248,7643,14891
20210830,안산선,산본,14729,15881,30610
20210830,안산선,대야미,4609,4261,8870
20210830,안산선,반월,4127,4000,8127
20210830,안산선,상록수,14666,14892,29558
20210830,안산선,한대앞,8086,8108,16194
20210830,안산선,중앙,15396,15961,31357
20210830,안산선,안산,10972,9805,20777
20210830,안산선,초지,4594,4969,9563
20210830,안산선,신길온천,1614,1464,3078
20210830,안산선,정왕,7255,7784,15039
20210830,안산선,오이도,8100,7672,15772
20210830,안산선,수리산,4066,3348,7414
20210830,안산선,고잔,8358,7848,16206
20210831,안산선,수리산,3738,3084,6822
20210831,안산선,오이도,7096,6750,13846
20210831,안산선,정왕,6642,7275,13917
20210831,안산선,안산,10013,9181,19194
20210831,안산선,초지,4310,4639,8949
20210831,안산선,고잔,7665,7438,15103
20210831,안산선,신길온천,1399,1318,2717
20210831,안산선,한대앞,7447,7445,14892
20210831,안산선,상록수,13786,14071,27857
20210831,안산선,반월,3654,3578,7232
20210831,안산선,대야미,4233,3776,8009
20210831,안산선,산본,13607,14641,28248
20210831,안산선,중앙,14232,14640,28872
20210901,안산선,수리산,3898,3175,7073
20210901,안산선,오이도,7531,7150,14681
20210901,안산선,정왕,7928,8348,16276
20210901,안산선,신길온천,1556,1436,2992
20210901,안산선,안산,10630,9504,20134
20210901,안산선,초지,4527,4947,9474
20210901,안산선,중앙,15056,15687,30743
20210901,안산선,한대앞,7630,7756,15386
20210901,안산선,상록수,14127,14414,28541
20210901,안산선,반월,3917,3820,7737
20210901,안산선,대야미,4575,4208,8783
20210901,안산선,산본,14514,15647,30161
20210901,안산선,고잔,8056,7753,15809
20210902,안산선,한대앞,8050,8004,16054
20210902,안산선,대야미,4725,4219,8944
20210902,안산선,반월,4166,3999,8165
20210902,안산선,상록수,14571,14879,29450
20210902,안산선,중앙,15348,16008,31356
20210902,안산선,산본,14716,15770,30486
20210902,안산선,고잔,8116,7662,15778
20210902,안산선,수리산,3949,3303,7252
20210902,안산선,오이도,7788,7589,15377
20210902,안산선,초지,4541,4817,9358
20210902,안산선,신길온천,1634,1489,3123
20210902,안산선,안산,10630,9591,20221
20210902,안산선,정왕,8035,8301,16336
20210903,안산선,대야미,4921,4417,9338
20210903,안산선,반월,4339,4208,8547
20210903,안산선,상록수,15176,15380,30556
20210903,안산선,한대앞,8577,8462,17039
20210903,안산선,중앙,16466,17622,34088
20210903,안산선,고잔,8383,8079,16462
20210903,안산선,산본,15352,16574,31926
20210903,안산선,안산,11121,10201,21322
20210903,안산선,신길온천,1666,1623,3289
20210903,안산선,정왕,8260,8217,16477
20210903,안산선,오이도,8343,8133,16476
20210903,안산선,수리산,4129,3303,7432
20210903,안산선,초지,4374,4625,8999
20210904,안산선,수리산,2695,2461,5156
20210904,안산선,오이도,7322,7576,14898
20210904,안산선,정왕,5609,5761,11370
20210904,안산선,신길온천,1202,1246,2448
20210904,안산선,안산,8449,8497,16946
20210904,안산선,초지,2761,3012,5773
20210904,안산선,고잔,5535,5435,10970
20210904,안산선,한대앞,6508,6355,12863
20210904,안산선,상록수,10909,11010,21919
20210904,안산선,반월,3041,2927,5968
20210904,안산선,산본,10950,11772,22722
20210904,안산선,중앙,13528,13997,27525
20210904,안산선,대야미,3636,3172,6808
20210905,안산선,산본,7664,8204,15868
20210905,안산선,중앙,9738,9824,19562
20210905,안산선,대야미,2761,2510,5271
20210905,안산선,반월,2217,2141,4358
20210905,안산선,상록수,8020,7814,15834
20210905,안산선,한대앞,4805,4728,9533
20210905,안산선,초지,2197,2074,4271
20210905,안산선,안산,8016,7478,15494
20210905,안산선,신길온천,1003,921,1924
20210905,안산선,정왕,4626,5080,9706
20210905,안산선,오이도,5795,5568,11363
20210905,안산선,수리산,1919,1968,3887
20210905,안산선,고잔,4181,3957,8138
20210906,안산선,오이도,7888,7373,15261
20210906,안산선,정왕,8019,8675,16694
20210906,안산선,신길온천,1615,1434,3049
20210906,안산선,안산,10856,10132,20988
20210906,안산선,초지,4518,4893,9411
20210906,안산선,고잔,8070,7619,15689
20210906,안산선,수리산,4027,3446,7473
20210906,안산선,한대앞,7982,8063,16045
20210906,안산선,상록수,14737,14885,29622
20210906,안산선,반월,4102,3925,8027
20210906,안산선,대야미,4745,4279,9024
20210906,안산선,산본,14706,15845,30551
20210906,안산선,중앙,15220,15690,30910
20210907,안산선,수리산,3786,3047,6833
20210907,안산선,오이도,7084,6884,13968
20210907,안산선,신길온천,1470,1361,2831
20210907,안산선,안산,10488,9327,19815
20210907,안산선,초지,4189,4492,8681
20210907,안산선,고잔,7854,7402,15256
20210907,안산선,중앙,14333,14876,29209
20210907,안산선,상록수,13859,14326,28185
20210907,안산선,반월,3774,3636,7410
20210907,안산선,대야미,4248,3899,8147
20210907,안산선,산본,13744,14836,28580
20210907,안산선,정왕,7557,7921,15478
20210907,안산선,한대앞,7442,7543,14985
20210908,안산선,산본,15276,16441,31717
20210908,안산선,대야미,4884,4411,9295
20210908,안산선,반월,4207,4081,8288
20210908,안산선,상록수,14955,15190,30145
20210908,안산선,한대앞,8289,8347,16636
20210908,안산선,중앙,15884,16746,32630
20210908,안산선,고잔,8537,8072,16609
20210908,안산선,안산,10968,10009,20977
20210908,안산선,신길온천,1682,1553,3235
20210908,안산선,정왕,8214,8594,16808
20210908,안산선,오이도,7936,7848,15784
20210908,안산선,수리산,4088,3372,7460
20210908,안산선,초지,4548,4906,9454
20210909,안산선,수리산,4185,3406,7591
20210909,안산선,오이도,8006,7744,15750
20210909,안산선,정왕,8209,8530,16739
20210909,안산선,신길온천,1663,1540,3203
20210909,안산선,안산,10927,9910,20837
20210909,안산선,초지,4594,4938,9532
20210909,안산선,고잔,8478,8101,16579
20210909,안산선,중앙,15867,16627,32494
20210909,안산선,한대앞,8302,8350,16652
20210909,안산선,상록수,14715,15037,29752
20210909,안산선,반월,4167,4058,8225
20210909,안산선,대야미,4906,4418,9324
20210909,안산선,산본,15145,16070,31215
20210910,안산선,대야미,4901,4466,9367
20210910,안산선,반월,4323,4142,8465
20210910,안산선,상록수,15302,15453,30755
20210910,안산선,한대앞,8409,8540,16949
20210910,안산선,중앙,16610,17756,34366
20210910,안산선,고잔,8454,8232,16686
20210910,안산선,산본,15393,16822,32215
20210910,안산선,안산,11191,10239,21430
20210910,안산선,신길온천,1670,1558,3228
20210910,안산선,정왕,8409,8312,16721
20210910,안산선,오이도,8400,8348,16748
20210910,안산선,수리산,4120,3273,7393
20210910,안산선,초지,4439,4662,9101
20210911,안산선,오이도,7325,7585,14910
20210911,안산선,정왕,5765,5807,11572
20210911,안산선,신길온천,1284,1322,2606
20210911,안산선,안산,8712,8940,17652
20210911,안산선,초지,2909,2987,5896
20210911,안산선,고잔,5536,5478,11014
20210911,안산선,수리산,2701,2464,5165
20210911,안산선,한대앞,6567,6572,13139
20210911,안산선,상록수,11243,11312,22555
20210911,안산선,반월,3160,2968,6128
20210911,안산선,대야미,3713,3296,7009
20210911,안산선,산본,11201,12154,23355
20210911,안산선,중앙,14297,14546,28843
20210912,안산선,산본,8066,8577,16643
20210912,안산선,대야미,2791,2618,5409
20210912,안산선,반월,2297,2274,4571
20210912,안산선,상록수,8420,8164,16584
20210912,안산선,한대앞,4920,4861,9781
20210912,안산선,중앙,10460,10519,20979
20210912,안산선,고잔,4126,3944,8070
20210912,안산선,안산,8162,7612,15774
20210912,안산선,신길온천,1082,1014,2096
20210912,안산선,정왕,4466,5164,9630
20210912,안산선,오이도,5714,5647,11361
20210912,안산선,수리산,2011,2019,4030
20210912,안산선,초지,2168,2065,4233
20210913,안산선,중앙,16265,16652,32917
20210913,안산선,대야미,4805,4421,9226
20210913,안산선,반월,4304,4152,8456
20210913,안산선,상록수,15292,15505,30797
20210913,안산선,한대앞,8245,8209,16454
20210913,안산선,고잔,8362,7937,16299
20210913,안산선,산본,15300,16074,31374
20210913,안산선,안산,11173,10129,21302
20210913,안산선,수리산,4071,3390,7461
20210913,안산선,오이도,8177,7803,15980
20210913,안산선,초지,4541,4872,9413
20210913,안산선,신길온천,1674,1479,3153
20210913,안산선,정왕,8229,8922,17151
20210914,안산선,대야미,4807,4386,9193
20210914,안산선,반월,4222,4028,8250
20210914,안산선,상록수,15356,15558,30914
20210914,안산선,한대앞,8251,8305,16556
20210914,안산선,중앙,15986,16624,32610
20210914,안산선,고잔,8361,8053,16414
20210914,안산선,산본,15123,16257,31380
20210914,안산선,안산,10963,9842,20805
20210914,안산선,신길온천,1583,1470,3053
20210914,안산선,정왕,8139,8625,16764
20210914,안산선,오이도,7984,7702,15686
20210914,안산선,수리산,4080,3347,7427
20210914,안산선,초지,4470,4859,9329
20210915,안산선,산본,15460,16551,32011
20210915,안산선,대야미,4880,4359,9239
20210915,안산선,반월,4279,4088,8367
20210915,안산선,상록수,15403,15739,31142
20210915,안산선,한대앞,8390,8226,16616
20210915,안산선,중앙,16388,17116,33504
20210915,안산선,고잔,8528,8189,16717
20210915,안산선,안산,10889,9932,20821
20210915,안산선,신길온천,1655,1499,3154
20210915,안산선,정왕,8152,8570,16722
20210915,안산선,수리산,4158,3449,7607
20210915,안산선,초지,4601,4930,9531
20210915,안산선,오이도,7978,7695,15673
20210916,안산선,수리산,4132,3480,7612
20210916,안산선,초지,4530,4758,9288
20210916,안산선,오이도,8029,7921,15950
20210916,안산선,정왕,8360,8535,16895
20210916,안산선,신길온천,1630,1647,3277
20210916,안산선,안산,10960,10061,21021
20210916,안산선,고잔,8423,8197,16620
20210916,안산선,한대앞,8403,8441,16844
20210916,안산선,상록수,15460,15855,31315
20210916,안산선,반월,4257,4184,8441
20210916,안산선,대야미,4803,4479,9282
20210916,안산선,산본,14962,16419,31381
20210916,안산선,중앙,16169,17019,33188
20210917,안산선,오이도,8279,8309,16588
20210917,안산선,정왕,8542,8189,16731
20210917,안산선,신길온천,1700,1622,3322
20210917,안산선,안산,11317,10869,22186
20210917,안산선,초지,4303,4565,8868
20210917,안산선,고잔,8327,8037,16364
20210917,안산선,수리산,4179,3287,7466
20210917,안산선,한대앞,8663,8649,17312
20210917,안산선,상록수,15593,15619,31212
20210917,안산선,반월,4273,4175,8448
20210917,안산선,대야미,4980,4454,9434
20210917,안산선,산본,15564,17086,32650
20210917,안산선,중앙,16730,17962,34692
20210918,안산선,수리산,2599,2245,4844
20210918,안산선,오이도,6698,7170,13868
20210918,안산선,정왕,6005,5630,11635
20210918,안산선,신길온천,1263,1185,2448
20210918,안산선,안산,9419,10096,19515
20210918,안산선,초지,2626,2726,5352
20210918,안산선,고잔,4835,4559,9394
20210918,안산선,한대앞,6381,6343,12724
20210918,안산선,상록수,10506,10454,20960
20210918,안산선,반월,3039,2968,6007
20210918,안산선,대야미,3479,3087,6566
20210918,안산선,산본,10709,11600,22309
20210918,안산선,중앙,12702,13698,26400
20210919,안산선,중앙,9329,9587,18916
20210919,안산선,대야미,2671,2320,4991
20210919,안산선,반월,2379,2229,4608
20210919,안산선,상록수,7990,7942,15932
20210919,안산선,한대앞,4695,4799,9494
20210919,안산선,고잔,3386,3401,6787
20210919,안산선,산본,7586,8035,15621
20210919,안산선,안산,9978,10726,20704
20210919,안산선,수리산,1901,1770,3671
20210919,안산선,오이도,5738,5856,11594
20210919,안산선,초지,1962,1991,3953
20210919,안산선,신길온천,1094,1016,2110
20210919,안산선,정왕,5007,4830,9837
20210920,안산선,산본,6167,6685,12852
20210920,안산선,대야미,2036,1887,3923
20210920,안산선,반월,1887,1924,3811
20210920,안산선,상록수,6912,7072,13984
20210920,안산선,중앙,7913,8178,16091
20210920,안산선,고잔,2938,3020,5958
20210920,안산선,한대앞,4013,3973,7986
20210920,안산선,안산,10066,9951,20017
20210920,안산선,신길온천,981,910,1891
20210920,안산선,정왕,4738,4475,9213
20210920,안산선,오이도,5630,5808,11438
20210920,안산선,수리산,1597,1471,3068
20210920,안산선,초지,1615,1852,3467
20210921,안산선,한대앞,3602,3455,7057
20210921,안산선,대야미,1613,1581,3194
20210921,안산선,산본,4817,5137,9954
20210921,안산선,반월,1577,1586,3163
20210921,안산선,상록수,6443,6280,12723
20210921,안산선,중앙,6913,6576,13489
20210921,안산선,오이도,4659,4660,9319
20210921,안산선,초지,1575,1434,3009
20210921,안산선,안산,8654,8264,16918
20210921,안산선,신길온천,870,836,1706
20210921,안산선,정왕,3964,4589,8553
20210921,안산선,수리산,1244,1082,2326
20210921,안산선,고잔,2686,2592,5278
20210922,안산선,산본,7297,7897,15194
20210922,안산선,대야미,2554,2270,4824
20210922,안산선,반월,2231,2135,4366
20210922,안산선,상록수,7896,7470,15366
20210922,안산선,중앙,10286,9603,19889
20210922,안산선,한대앞,4457,4250,8707
20210922,안산선,고잔,3745,3363,7108
20210922,안산선,안산,8687,7511,16198
20210922,안산선,신길온천,1128,993,2121
20210922,안산선,정왕,4581,5517,10098
20210922,안산선,오이도,6229,5836,12065
20210922,안산선,수리산,1740,1733,3473
20210922,안산선,초지,2078,1790,3868
20210923,안산선,오이도,7945,7535,15480
20210923,안산선,정왕,7908,8399,16307
20210923,안산선,신길온천,1595,1493,3088
20210923,안산선,안산,10719,9833,20552
20210923,안산선,초지,4296,4463,8759
20210923,안산선,고잔,7941,7495,15436
20210923,안산선,수리산,3776,3248,7024
20210923,안산선,한대앞,7837,7733,15570
20210923,안산선,상록수,14462,14483,28945
20210923,안산선,반월,4124,3907,8031
20210923,안산선,대야미,4535,4151,8686
20210923,안산선,산본,14446,15505,29951
20210923,안산선,중앙,15660,16004,31664
20210924,안산선,수리산,4054,3291,7345
20210924,안산선,오이도,8091,7914,16005
20210924,안산선,정왕,7956,8164,16120
20210924,안산선,신길온천,1653,1530,3183
20210924,안산선,안산,10996,9957,20953
20210924,안산선,초지,4257,4410,8667
20210924,안산선,고잔,8383,8038,16421
20210924,안산선,한대앞,8330,8175,16505
20210924,안산선,상록수,14963,15163,30126
20210924,안산선,반월,4285,4088,8373
20210924,안산선,대야미,4805,4316,9121
20210924,안산선,산본,15390,16816,32206
20210924,안산선,중앙,16344,17210,33554
20210925,안산선,산본,11249,10509,21758
20210925,안산선,대야미,3839,3320,7159
20210925,안산선,반월,3179,2987,6166
20210925,안산선,상록수,10859,11048,21907
20210925,안산선,한대앞,6398,6310,12708
20210925,안산선,중앙,13598,14002,27600
20210925,안산선,고잔,5503,5514,11017
20210925,안산선,안산,7913,8056,15969
20210925,안산선,수리산,2698,2604,5302
20210925,안산선,오이도,7077,7152,14229
20210925,안산선,초지,2992,2954,5946
20210925,안산선,신길온천,1308,1274,2582
20210925,안산선,정왕,5414,5576,10990
20210926,안산선,대야미,2821,2574,5395
20210926,안산선,반월,2250,2312,4562
20210926,안산선,상록수,7725,7710,15435
20210926,안산선,한대앞,4684,4582,9266
20210926,안산선,중앙,9730,9821,19551
20210926,안산선,고잔,3989,3944,7933
20210926,안산선,산본,7719,6756,14475
20210926,안산선,안산,7560,7021,14581
20210926,안산선,신길온천,1000,974,1974
20210926,안산선,정왕,4420,4857,9277
20210926,안산선,오이도,5581,5429,11010
20210926,안산선,수리산,1936,1961,3897
20210926,안산선,초지,2061,2048,4109
20210927,안산선,대야미,4875,4419,9294
20210927,안산선,산본,15146,13599,28745
20210927,안산선,수리산,4154,3476,7630
20210927,안산선,오이도,8149,7692,15841
20210927,안산선,정왕,8640,9264,17904
20210927,안산선,신길온천,1721,1565,3286
20210927,안산선,안산,11135,10058,21193
20210927,안산선,고잔,8603,8073,16676
20210927,안산선,중앙,15932,16581,32513
20210927,안산선,한대앞,8123,8212,16335
20210927,안산선,반월,4294,4138,8432
20210927,안산선,초지,4665,4988,9653
20210927,안산선,상록수,15412,15517,30929
20210928,안산선,수리산,4164,3453,7617
20210928,안산선,초지,4586,4860,9446
20210928,안산선,오이도,7864,7462,15326
20210928,안산선,정왕,8439,8861,17300
20210928,안산선,신길온천,1597,1461,3058
20210928,안산선,안산,10768,9812,20580
20210928,안산선,고잔,8420,8016,16436
20210928,안산선,한대앞,8151,8158,16309
20210928,안산선,상록수,15182,15428,30610
20210928,안산선,반월,4215,4086,8301
20210928,안산선,대야미,4823,4386,9209
20210928,안산선,산본,14843,16114,30957
20210928,안산선,중앙,15801,16397,32198
20210929,안산선,오이도,7372,7063,14435
20210929,안산선,정왕,8177,8714,16891
20210929,안산선,신길온천,1470,1381,2851
20210929,안산선,안산,10790,9472,20262
20210929,안산선,초지,4491,4809,9300
20210929,안산선,고잔,7976,7722,15698
20210929,안산선,수리산,3920,3174,7094
20210929,안산선,한대앞,7830,7910,15740
20210929,안산선,상록수,14555,15001,29556
20210929,안산선,반월,3926,3779,7705
20210929,안산선,대야미,4599,4162,8761
20210929,안산선,산본,14386,15678,30064
20210929,안산선,중앙,15326,15950,31276
20210930,안산선,산본,15402,16432,31834
20210930,안산선,대야미,4986,4570,9556
20210930,안산선,반월,4309,4106,8415
20210930,안산선,상록수,15392,15636,31028
20210930,안산선,한대앞,8341,8314,16655
20210930,안산선,중앙,16167,16743,32910
20210930,안산선,고잔,8589,8319,16908
20210930,안산선,안산,11023,9981,21004
20210930,안산선,신길온천,1694,1570,3264
20210930,안산선,정왕,8754,9028,17782
20210930,안산선,오이도,8174,8020,16194
20210930,안산선,수리산,4182,3446,7628
20210930,안산선,초지,4746,5044,9790
20211001,안산선,중앙,17107,18223,35330
20211001,안산선,산본,15804,17131,32935
20211001,안산선,대야미,5040,4476,9516
20211001,안산선,반월,4401,4220,8621
20211001,안산선,한대앞,9005,8986,17991
20211001,안산선,고잔,8635,8368,17003
20211001,안산선,상록수,15567,15833,31400
20211001,안산선,안산,11417,10462,21879
20211001,안산선,신길온천,1692,1582,3274
20211001,안산선,초지,4595,4688,9283
20211001,안산선,정왕,8995,8845,17840
20211001,안산선,오이도,8421,8343,16764
20211001,안산선,수리산,4260,3437,7697
20211002,안산선,한대앞,6906,6715,13621
20211002,안산선,중앙,13932,14541,28473
20211002,안산선,고잔,5711,5635,11346
20211002,안산선,초지,3036,3042,6078
20211002,안산선,안산,8606,8893,17499
20211002,안산선,신길온천,1327,1284,2611
20211002,안산선,정왕,5808,5937,11745
20211002,안산선,오이도,7631,7970,15601
20211002,안산선,수리산,2749,2590,5339
20211002,안산선,상록수,11213,11315,22528
20211002,안산선,반월,3319,3121,6440
20211002,안산선,대야미,3876,3468,7344
20211002,안산선,산본,11689,12169,23858
20211003,안산선,대야미,2986,2704,5690
20211003,안산선,반월,2374,2433,4807
20211003,안산선,상록수,8682,8416,17098
20211003,안산선,한대앞,5269,5222,10491
20211003,안산선,중앙,10789,10945,21734
20211003,안산선,고잔,4308,4170,8478
20211003,안산선,산본,8195,8850,17045
20211003,안산선,안산,8679,8127,16806
20211003,안산선,신길온천,1086,1101,2187
20211003,안산선,정왕,4810,4879,9689
20211003,안산선,오이도,6711,6762,13473
20211003,안산선,수리산,2150,2195,4345
20211003,안산선,초지,2248,2217,4465
20211004,안산선,오이도,6241,5856,12097
20211004,안산선,정왕,4939,5803,10742
20211004,안산선,신길온천,1201,1130,2331
20211004,안산선,안산,7439,7155,14594
20211004,안산선,초지,2489,2538,5027
20211004,안산선,고잔,4521,4313,8834
20211004,안산선,수리산,2401,2239,4640
20211004,안산선,한대앞,5812,5797,11609
20211004,안산선,상록수,9857,9852,19709
20211004,안산선,반월,2751,2629,5380
20211004,안산선,대야미,3248,2901,6149
20211004,안산선,산본,9486,10192,19678
20211004,안산선,중앙,11318,11414,22732
20211005,안산선,산본,15350,16492,31842
20211005,안산선,대야미,4830,4491,9321
20211005,안산선,반월,4281,4091,8372
20211005,안산선,상록수,15749,16015,31764
20211005,안산선,한대앞,9135,9044,18179
20211005,안산선,중앙,16443,17018,33461
20211005,안산선,고잔,8831,8361,17192
20211005,안산선,안산,11366,10269,21635
20211005,안산선,신길온천,1750,1560,3310
20211005,안산선,정왕,8590,9199,17789
20211005,안산선,오이도,7977,7645,15622
20211005,안산선,수리산,4246,3421,7667
20211005,안산선,초지,4826,5141,9967
20211006,안산선,중앙,16207,16677,32884
20211006,안산선,오이도,7808,7515,15323
20211006,안산선,정왕,8518,8880,17398
20211006,안산선,신길온천,1542,1431,2973
20211006,안산선,고잔,8493,8076,16569
20211006,안산선,한대앞,8845,8998,17843
20211006,안산선,수리산,4129,3300,7429
20211006,안산선,반월,4164,4012,8176
20211006,안산선,초지,4580,4947,9527
20211006,안산선,안산,11046,9973,21019
20211006,안산선,상록수,15393,15634,31027
20211006,안산선,대야미,4920,4386,9306
20211006,안산선,산본,14869,16231,31100
20211007,안산선,오이도,7974,7737,15711
20211007,안산선,정왕,8532,8767,17299
20211007,안산선,신길온천,1629,1513,3142
20211007,안산선,안산,11142,10021,21163
20211007,안산선,초지,4644,4989,9633
20211007,안산선,고잔,8704,8289,16993
20211007,안산선,수리산,4142,3354,7496
20211007,안산선,한대앞,9102,9082,18184
20211007,안산선,상록수,15373,15661,31034
20211007,안산선,반월,4182,3984,8166
20211007,안산선,대야미,4866,4430,9296
20211007,안산선,산본,15316,16516,31832
20211007,안산선,중앙,16243,16708,32951
20211008,안산선,산본,15733,17098,32831
20211008,안산선,대야미,4903,4307,9210
20211008,안산선,반월,4320,4092,8412
20211008,안산선,상록수,15564,15792,31356
20211008,안산선,한대앞,9236,9217,18453
20211008,안산선,중앙,17028,18154,35182
20211008,안산선,고잔,8683,8336,17019
20211008,안산선,안산,11312,10387,21699
20211008,안산선,신길온천,1677,1563,3240
20211008,안산선,정왕,8841,8782,17623
20211008,안산선,수리산,4162,3262,7424
20211008,안산선,초지,4448,4672,9120
20211008,안산선,오이도,8463,8408,16871
20211009,안산선,수리산,2685,2366,5051
20211009,안산선,초지,2970,3036,6006
20211009,안산선,오이도,7620,8040,15660
20211009,안산선,정왕,5698,5723,11421
20211009,안산선,신길온천,1252,1248,2500
20211009,안산선,안산,8692,9066,17758
20211009,안산선,고잔,5576,5627,11203
20211009,안산선,한대앞,6518,6403,12921
20211009,안산선,상록수,11111,10960,22071
20211009,안산선,반월,3094,2921,6015
20211009,안산선,대야미,3544,3184,6728
20211009,안산선,산본,10714,11350,22064
20211009,안산선,중앙,13531,14146,27677
20211010,안산선,대야미,2560,2381,4941
20211010,안산선,반월,2291,2366,4657
20211010,안산선,상록수,8336,8332,16668
20211010,안산선,한대앞,4818,4823,9641
20211010,안산선,중앙,10080,10236,20316
20211010,안산선,고잔,4276,4405,8681
20211010,안산선,산본,7528,7997,15525
20211010,안산선,안산,8192,7431,15623
20211010,안산선,신길온천,940,920,1860
20211010,안산선,정왕,4467,4707,9174
20211010,안산선,오이도,5668,5633,11301
20211010,안산선,수리산,1945,1861,3806
20211010,안산선,초지,2111,2114,4225
20211011,안산선,수리산,2490,2316,4806
20211011,안산선,오이도,6843,6615,13458
20211011,안산선,정왕,5388,6097,11485
20211011,안산선,신길온천,1282,1164,2446
20211011,안산선,안산,8037,7576,15613
20211011,안산선,초지,2557,2522,5079
20211011,안산선,고잔,4867,4539,9406
20211011,안산선,한대앞,6021,6063,12084
20211011,안산선,상록수,10406,10310,20716
20211011,안산선,반월,2995,2866,5861
20211011,안산선,대야미,3357,3063,6420
20211011,안산선,산본,10199,10951,21150
20211011,안산선,중앙,12360,12396,24756
20211012,안산선,초지,4915,5242,10157
20211012,안산선,오이도,8273,7968,16241
20211012,안산선,정왕,9186,9622,18808
20211012,안산선,신길온천,1685,1592,3277
20211012,안산선,안산,11289,10369,21658
20211012,안산선,고잔,8946,8459,17405
20211012,안산선,수리산,4214,3507,7721
20211012,안산선,한대앞,9399,9442,18841
20211012,안산선,산본,15505,16726,32231
20211012,안산선,대야미,5011,4633,9644
20211012,안산선,중앙,16637,17110,33747
20211012,안산선,상록수,16137,16382,32519
20211012,안산선,반월,4382,4187,8569
20211013,안산선,산본,15835,17056,32891
20211013,안산선,대야미,5065,4652,9717
20211013,안산선,반월,4384,4185,8569
20211013,안산선,상록수,15938,16198,32136
20211013,안산선,중앙,17133,17912,35045
20211013,안산선,고잔,8771,8327,17098
20211013,안산선,한대앞,9283,9200,18483
20211013,안산선,안산,11597,10381,21978
20211013,안산선,신길온천,1732,1634,3366
20211013,안산선,정왕,9070,9520,18590
20211013,안산선,오이도,8455,8318,16773
20211013,안산선,수리산,4428,3609,8037
20211013,안산선,초지,4807,5125,9932
20211014,안산선,안산,11422,10336,21758
20211014,안산선,오이도,8480,8224,16704
20211014,안산선,수리산,4342,3634,7976
20211014,안산선,정왕,8910,9219,18129
20211014,안산선,신길온천,1691,1614,3305
20211014,안산선,초지,4829,5124,9953
20211014,안산선,대야미,5162,4727,9889
20211014,안산선,중앙,16920,17718,34638
20211014,안산선,한대앞,9425,9441,18866
20211014,안산선,상록수,16069,16217,32286
20211014,안산선,반월,4377,4220,8597
20211014,안산선,산본,15797,16962,32759
20211014,안산선,고잔,8899,8482,17381
20211015,안산선,수리산,4361,3478,7839
20211015,안산선,오이도,8560,8466,17026
20211015,안산선,정왕,9230,9158,18388
20211015,안산선,신길온천,1792,1696,3488
20211015,안산선,초지,4749,5001,9750
20211015,안산선,안산,11537,10635,22172
20211015,안산선,고잔,8839,8507,17346
20211015,안산선,한대앞,9753,9617,19370
20211015,안산선,상록수,15853,16048,31901
20211015,안산선,반월,4403,4221,8624
20211015,안산선,대야미,5180,4626,9806
20211015,안산선,산본,15910,17242,33152
20211015,안산선,중앙,17517,18786,36303
20211016,안산선,오이도,7223,7608,14831
20211016,안산선,정왕,6016,6262,12278
20211016,안산선,신길온천,1408,1351,2759
20211016,안산선,안산,9129,9491,18620
20211016,안산선,초지,3099,3169,6268
20211016,안산선,고잔,6455,6483,12938
20211016,안산선,수리산,2885,2558,5443
20211016,안산선,한대앞,7040,6746,13786
20211016,안산선,상록수,11844,11844,23688
20211016,안산선,반월,3219,3065,6284
20211016,안산선,대야미,3877,3505,7382
20211016,안산선,산본,11643,12449,24092
20211016,안산선,중앙,15947,16184,32131
20211017,안산선,대야미,2766,2524,5290
20211017,안산선,산본,7734,8482,16216
20211017,안산선,수리산,1931,1856,3787
20211017,안산선,오이도,5437,5215,10652
20211017,안산선,정왕,4831,5195,10026
20211017,안산선,신길온천,1028,992,2020
20211017,안산선,안산,9143,8618,17761
20211017,안산선,고잔,4302,4350,8652
20211017,안산선,중앙,11233,10957,22190
20211017,안산선,한대앞,4996,4970,9966
20211017,안산선,상록수,8462,8263,16725
20211017,안산선,반월,2197,2202,4399
20211017,안산선,초지,2139,2111,4250
20211018,안산선,수리산,4142,3467,7609
20211018,안산선,오이도,8356,7855,16211
20211018,안산선,정왕,8651,9436,18087
20211018,안산선,신길온천,1721,1522,3243
20211018,안산선,안산,11477,10367,21844
20211018,안산선,초지,4996,5518,10514
20211018,안산선,고잔,8674,8167,16841
20211018,안산선,한대앞,9320,9488,18808
20211018,안산선,산본,15367,16607,31974
20211018,안산선,대야미,4969,4486,9455
20211018,안산선,중앙,17186,17469,34655
20211018,안산선,상록수,16110,16227,32337
20211018,안산선,반월,4186,4046,8232
20211019,안산선,오이도,8235,8049,16284
20211019,안산선,정왕,9142,9488,18630
20211019,안산선,신길온천,1674,1571,3245
20211019,안산선,안산,11264,10148,21412
20211019,안산선,초지,5131,5578,10709
20211019,안산선,고잔,8773,8338,17111
20211019,안산선,수리산,4260,3478,7738
20211019,안산선,한대앞,9300,9374,18674
20211019,안산선,상록수,16455,16689,33144
20211019,안산선,반월,4330,4143,8473
20211019,안산선,대야미,4900,4559,9459
20211019,안산선,산본,15475,16698,32173
20211019,안산선,중앙,17291,17872,35163
20211020,안산선,수리산,4268,3561,7829
20211020,안산선,오이도,8532,8381,16913
20211020,안산선,정왕,9425,9815,19240
20211020,안산선,신길온천,1739,1603,3342
20211020,안산선,안산,11607,10519,22126
20211020,안산선,초지,5169,5493,10662
20211020,안산선,고잔,8928,8547,17475
20211020,안산선,한대앞,9624,9722,19346
20211020,안산선,상록수,16705,16943,33648
20211020,안산선,반월,4347,4233,8580
20211020,안산선,산본,15927,17137,33064
20211020,안산선,중앙,18017,18465,36482
20211020,안산선,대야미,5127,4609,9736
20211021,안산선,반월,4462,4210,8672
20211021,안산선,초지,4939,5443,10382
20211021,안산선,상록수,16610,16739,33349
20211021,안산선,한대앞,9718,9668,19386
20211021,안산선,중앙,17995,18512,36507
20211021,안산선,고잔,8850,8466,17316
20211021,안산선,안산,11190,10195,21385
20211021,안산선,정왕,9489,9805,19294
20211021,안산선,오이도,8755,8453,17208
20211021,안산선,수리산,4292,3470,7762
20211021,안산선,산본,15892,17115,33007
20211021,안산선,대야미,5066,4637,9703
20211021,안산선,신길온천,1723,1613,3336
20211022,안산선,대야미,5184,4528,9712
20211022,안산선,반월,4441,4219,8660
20211022,안산선,상록수,16392,16409,32801
20211022,안산선,한대앞,9980,10127,20107
20211022,안산선,중앙,18682,19556,38238
20211022,안산선,고잔,8869,8562,17431
20211022,안산선,산본,16298,17409,33707
20211022,안산선,안산,11730,10851,22581
20211022,안산선,신길온천,1746,1658,3404
20211022,안산선,정왕,10270,10125,20395
20211022,안산선,오이도,8843,8812,17655
20211022,안산선,수리산,4343,3431,7774
20211022,안산선,초지,4871,5261,10132
20211023,안산선,산본,12417,13184,25601
20211023,안산선,대야미,4052,3534,7586
20211023,안산선,반월,3507,3262,6769
20211023,안산선,상록수,12528,12291,24819
20211023,안산선,한대앞,7342,7304,14646
20211023,안산선,중앙,16451,16898,33349
20211023,안산선,고잔,6568,6691,13259
20211023,안산선,안산,9477,9915,19392
20211023,안산선,신길온천,1489,1399,2888
20211023,안산선,정왕,6361,6450,12811
20211023,안산선,오이도,8217,8390,16607
20211023,안산선,수리산,2926,2812,5738
20211023,안산선,초지,3330,3365,6695
20211024,안산선,정왕,5090,5493,10583
20211024,안산선,산본,8515,8933,17448
20211024,안산선,대야미,3078,2760,5838
20211024,안산선,수리산,2136,2128,4264
20211024,안산선,오이도,6447,6452,12899
20211024,안산선,반월,2494,2488,4982
20211024,안산선,상록수,9000,8935,17935
20211024,안산선,한대앞,5175,5183,10358
20211024,안산선,중앙,11667,11589,23256
20211024,안산선,고잔,4820,4646,9466
20211024,안산선,초지,2366,2256,4622
20211024,안산선,안산,9362,8742,18104
20211024,안산선,신길온천,1167,1090,2257
20211025,안산선,수리산,4332,3639,7971
20211025,안산선,오이도,8633,8233,16866
20211025,안산선,정왕,9632,10314,19946
20211025,안산선,신길온천,1791,1604,3395
20211025,안산선,안산,11818,10695,22513
20211025,안산선,초지,5014,5355,10369
20211025,안산선,고잔,8991,8357,17348
20211025,안산선,중앙,17281,17672,34953
20211025,안산선,한대앞,9691,9872,19563
20211025,안산선,상록수,16160,16379,32539
20211025,안산선,반월,4393,4210,8603
20211025,안산선,대야미,5013,4539,9552
20211025,안산선,산본,15874,17024,32898
20211026,안산선,대야미,5138,4676,9814
20211026,안산선,반월,4446,4240,8686
20211026,안산선,상록수,16555,16926,33481
20211026,안산선,한대앞,10097,10009,20106
20211026,안산선,중앙,17623,18333,35956
20211026,안산선,고잔,9053,8529,17582
20211026,안산선,산본,16246,16844,33090
20211026,안산선,안산,11554,10510,22064
20211026,안산선,신길온천,1725,1614,3339
20211026,안산선,정왕,9962,10412,20374
20211026,안산선,오이도,8849,8527,17376
20211026,안산선,수리산,4371,3615,7986
20211026,안산선,초지,4940,5355,10295
20211027,안산선,대야미,5197,4702,9899
20211027,안산선,반월,4479,4313,8792
20211027,안산선,상록수,16448,16621,33069
20211027,안산선,한대앞,9786,9888,19674
20211027,안산선,중앙,18115,18716,36831
20211027,안산선,고잔,9118,8725,17843
20211027,안산선,산본,16228,17203,33431
20211027,안산선,안산,11827,10708,22535
20211027,안산선,신길온천,1779,1693,3472
20211027,안산선,정왕,9713,9933,19646
20211027,안산선,오이도,8809,8483,17292
20211027,안산선,수리산,4291,3591,7882
20211027,안산선,초지,4990,5435,10425
20211028,안산선,정왕,9610,9714,19324
20211028,안산선,오이도,8724,8659,17383
20211028,안산선,수리산,4324,3554,7878
20211028,안산선,신길온천,1707,1639,3346
20211028,안산선,산본,16136,17313,33449
20211028,안산선,대야미,5122,4678,9800
20211028,안산선,반월,4382,4274,8656
20211028,안산선,한대앞,9685,9666,19351
20211028,안산선,중앙,17738,18209,35947
20211028,안산선,고잔,8988,8602,17590
20211028,안산선,초지,4974,5285,10259
20211028,안산선,안산,11530,10434,21964
20211028,안산선,상록수,16416,16624,33040
20211029,안산선,초지,4737,4900,9637
20211029,안산선,오이도,9017,8934,17951
20211029,안산선,정왕,9840,9521,19361
20211029,안산선,신길온천,1784,1699,3483
20211029,안산선,안산,11837,10787,22624
20211029,안산선,고잔,8917,8718,17635
20211029,안산선,수리산,4442,3592,8034
20211029,안산선,한대앞,9962,9886,19848
20211029,안산선,산본,16545,18060,34605
20211029,안산선,대야미,5262,4602,9864
20211029,안산선,중앙,18569,19893,38462
20211029,안산선,상록수,16662,16778,33440
20211029,안산선,반월,4579,4377,8956
20211030,안산선,오이도,7924,8201,16125
20211030,안산선,정왕,6490,6565,13055
20211030,안산선,신길온천,1521,1393,2914
20211030,안산선,안산,9590,9790,19380
20211030,안산선,초지,3540,3539,7079
20211030,안산선,고잔,6666,6669,13335
20211030,안산선,수리산,3036,2897,5933
20211030,안산선,한대앞,7616,7467,15083
20211030,안산선,상록수,12462,12443,24905
20211030,안산선,반월,3416,3324,6740
20211030,안산선,대야미,4157,3674,7831
20211030,안산선,산본,13094,13663,26757
20211030,안산선,중앙,16297,16651,32948
20211031,안산선,대야미,3152,2806,5958
20211031,안산선,산본,9300,9653,18953
20211031,안산선,수리산,2155,2225,4380
20211031,안산선,오이도,6435,6254,12689
20211031,안산선,정왕,5186,5756,10942
20211031,안산선,신길온천,1135,1130,2265
20211031,안산선,안산,9417,8731,18148
20211031,안산선,고잔,4789,4589,9378
20211031,안산선,중앙,11969,11788,23757
20211031,안산선,한대앞,5316,5485,10801
20211031,안산선,반월,2629,2578,5207
20211031,안산선,초지,2473,2425,4898
20211031,안산선,상록수,9297,9093,18390
20211101,안산선,산본,15954,17181,33135
20211101,안산선,중앙,17274,17974,35248
20211101,안산선,대야미,5023,4549,9572
20211101,안산선,반월,4475,4220,8695
20211101,안산선,상록수,16052,16185,32237
20211101,안산선,한대앞,9699,9885,19584
20211101,안산선,고잔,8829,8387,17216
20211101,안산선,안산,11821,10771,22592
20211101,안산선,신길온천,1769,1560,3329
20211101,안산선,정왕,9147,9980,19127
20211101,안산선,오이도,8284,7991,16275
20211101,안산선,수리산,4305,3580,7885
20211101,안산선,초지,5157,5351,10508
20211102,안산선,오이도,8564,8220,16784
20211102,안산선,정왕,9464,9845,19309
20211102,안산선,신길온천,1817,1647,3464
20211102,안산선,안산,11525,10532,22057
20211102,안산선,초지,5079,5503,10582
20211102,안산선,고잔,9025,8507,17532
20211102,안산선,수리산,4458,3658,8116
20211102,안산선,한대앞,9915,10084,19999
20211102,안산선,상록수,16787,16954,33741
20211102,안산선,반월,4520,4321,8841
20211102,안산선,대야미,5149,4578,9727
20211102,안산선,산본,16065,17415,33480
20211102,안산선,중앙,17670,18230,35900
20211103,안산선,산본,16416,17719,34135
20211103,안산선,대야미,5289,4644,9933
20211103,안산선,반월,4576,4350,8926
20211103,안산선,상록수,16397,16529,32926
20211103,안산선,한대앞,9727,9786,19513
20211103,안산선,중앙,17944,18876,36820
20211103,안산선,고잔,9175,8717,17892
20211103,안산선,안산,11586,10480,22066
20211103,안산선,신길온천,1813,1620,3433
20211103,안산선,정왕,9425,9776,19201
20211103,안산선,오이도,8695,8462,17157
20211103,안산선,수리산,4513,3706,8219
20211103,안산선,초지,5097,5499,10596
20211104,안산선,수리산,4370,3621,7991
20211104,안산선,안산,11354,10314,21668
20211104,안산선,신길온천,1741,1594,3335
20211104,안산선,정왕,9422,9700,19122
20211104,안산선,오이도,8532,8310,16842
20211104,안산선,고잔,9030,8592,17622
20211104,안산선,초지,5133,5566,10699
20211104,안산선,한대앞,9836,9878,19714
20211104,안산선,산본,16113,17207,33320
20211104,안산선,대야미,5209,4648,9857
20211104,안산선,중앙,17502,18406,35908
20211104,안산선,상록수,16480,16592,33072
20211104,안산선,반월,4367,4186,8553
20211105,안산선,산본,17042,18452,35494
20211105,안산선,대야미,5442,4709,10151
20211105,안산선,반월,4665,4415,9080
20211105,안산선,상록수,17099,16902,34001
20211105,안산선,중앙,18982,20781,39763
20211105,안산선,고잔,9343,8989,18332
20211105,안산선,한대앞,10567,10261,20828
20211105,안산선,안산,12089,11001,23090
20211105,안산선,신길온천,1820,1687,3507
20211105,안산선,정왕,9961,9653,19614
20211105,안산선,오이도,9058,9189,18247
20211105,안산선,수리산,4511,3498,8009
20211105,안산선,초지,5162,5301,10463
20211106,안산선,한대앞,8065,7702,15767
20211106,안산선,대야미,4321,3791,8112
20211106,안산선,산본,13474,14185,27659
20211106,안산선,반월,3551,3376,6927
20211106,안산선,상록수,13117,12919,26036
20211106,안산선,중앙,16932,17903,34835
20211106,안산선,오이도,8274,8321,16595
20211106,안산선,초지,3669,3625,7294
20211106,안산선,안산,9870,10097,19967
20211106,안산선,신길온천,1630,1464,3094
20211106,안산선,정왕,6874,6776,13650
20211106,안산선,수리산,3164,2915,6079
20211106,안산선,고잔,7088,6913,14001
20211107,안산선,산본,9313,9999,19312
20211107,안산선,대야미,3253,2786,6039
20211107,안산선,반월,2679,2593,5272
20211107,안산선,상록수,9607,9590,19197
20211107,안산선,중앙,12183,12246,24429
20211107,안산선,한대앞,5675,5553,11228
20211107,안산선,고잔,5036,4792,9828
20211107,안산선,안산,9702,9133,18835
20211107,안산선,신길온천,1192,1139,2331
20211107,안산선,정왕,5490,6178,11668
20211107,안산선,오이도,6439,6217,12656
20211107,안산선,수리산,2249,2360,4609
20211107,안산선,초지,2483,2466,4949
20211108,안산선,오이도,7589,7233,14822
20211108,안산선,정왕,8665,9235,17900
20211108,안산선,신길온천,1480,1317,2797
20211108,안산선,안산,10884,9959,20843
20211108,안산선,초지,4835,5203,10038
20211108,안산선,고잔,8196,7651,15847
20211108,안산선,수리산,4020,3284,7304
20211108,안산선,한대앞,9097,9170,18267
20211108,안산선,상록수,15048,15259,30307
20211108,안산선,반월,3923,3748,7671
20211108,안산선,대야미,4515,4100,8615
20211108,안산선,산본,14662,15777,30439
20211108,안산선,중앙,16070,16518,32588
20211109,안산선,수리산,4244,3327,7571
20211109,안산선,오이도,7833,7531,15364
20211109,안산선,정왕,8902,9415,18317
20211109,안산선,안산,10927,10024,20951
20211109,안산선,초지,5058,5266,10324
20211109,안산선,고잔,8637,8119,16756
20211109,안산선,중앙,16582,17314,33896
20211109,안산선,상록수,15909,16107,32016
20211109,안산선,반월,4119,3944,8063
20211109,안산선,대야미,4636,4209,8845
20211109,안산선,산본,15327,16528,31855
20211109,안산선,신길온천,1547,1414,2961
20211109,안산선,한대앞,9413,9570,18983
20211110,안산선,수리산,4450,3522,7972
20211110,안산선,오이도,8291,7973,16264
20211110,안산선,정왕,9812,10174,19986
20211110,안산선,신길온천,1744,1604,3348
20211110,안산선,안산,11426,10275,21701
20211110,안산선,초지,5176,5575,10751
20211110,안산선,고잔,9059,8593,17652
20211110,안산선,한대앞,9597,9552,19149
20211110,안산선,산본,16231,17608,33839
20211110,안산선,대야미,5115,4554,9669
20211110,안산선,중앙,17856,18616,36472
20211110,안산선,상록수,16459,16604,33063
20211110,안산선,반월,4405,4199,8604
20211111,안산선,오이도,8286,8075,16361
20211111,안산선,정왕,9904,10172,20076
20211111,안산선,신길온천,1725,1616,3341
20211111,안산선,안산,11459,10441,21900
20211111,안산선,초지,5019,5367,10386
20211111,안산선,고잔,9238,8867,18105
20211111,안산선,수리산,4443,3488,7931
20211111,안산선,한대앞,9841,9804,19645
20211111,안산선,상록수,16430,16410,32840
20211111,안산선,반월,4337,4107,8444
20211111,안산선,대야미,5101,4493,9594
20211111,안산선,산본,16130,17389,33519
20211111,안산선,중앙,18317,19171,37488
20211112,안산선,수리산,4339,3343,7682
20211112,안산선,오이도,8944,8865,17809
20211112,안산선,정왕,10459,10012,20471
20211112,안산선,신길온천,1808,1668,3476
20211112,안산선,안산,11657,10716,22373
20211112,안산선,초지,4889,5206,10095
20211112,안산선,고잔,9158,8719,17877
20211112,안산선,한대앞,10282,9905,20187
20211112,안산선,상록수,16772,16774,33546
20211112,안산선,반월,4465,4191,8656
20211112,안산선,산본,16516,17971,34487
20211112,안산선,중앙,18733,20335,39068
20211112,안산선,대야미,5254,4490,9744
20211113,안산선,수리산,2962,2658,5620
20211113,안산선,초지,3555,3547,7102
20211113,안산선,오이도,7804,7942,15746
20211113,안산선,정왕,6615,6498,13113
20211113,안산선,신길온천,1483,1441,2924
20211113,안산선,안산,9711,9949,19660
20211113,안산선,고잔,6939,6848,13787
20211113,안산선,한대앞,7465,7289,14754
20211113,안산선,상록수,12887,12449,25336
20211113,안산선,반월,3473,3302,6775
20211113,안산선,대야미,3997,3524,7521
20211113,안산선,산본,12490,13346,25836
20211113,안산선,중앙,15925,17017,32942
20211114,안산선,대야미,3056,2703,5759
20211114,안산선,반월,2599,2581,5180
20211114,안산선,상록수,9396,9211,18607
20211114,안산선,한대앞,5576,5546,11122
20211114,안산선,중앙,11823,11745,23568
20211114,안산선,고잔,4936,4939,9875
20211114,안산선,산본,8837,9419,18256
20211114,안산선,안산,10046,9334,19380
20211114,안산선,신길온천,1190,1072,2262
20211114,안산선,정왕,5509,6278,11787
20211114,안산선,오이도,6142,5881,12023
20211114,안산선,수리산,2081,2051,4132
20211114,안산선,초지,2503,2514,5017
20211115,안산선,초지,5255,5538,10793
20211115,안산선,수리산,4343,3576,7919
20211115,안산선,오이도,8420,7974,16394
20211115,안산선,정왕,9707,10375,20082
20211115,안산선,신길온천,1798,1600,3398
20211115,안산선,안산,11856,10780,22636
20211115,안산선,고잔,8943,8363,17306
20211115,안산선,한대앞,9726,9845,19571
20211115,안산선,상록수,16064,16360,32424
20211115,안산선,반월,4441,4177,8618
20211115,안산선,대야미,5012,4616,9628
20211115,안산선,산본,15900,17068,32968
20211115,안산선,중앙,17701,18378,36079
20211116,안산선,한대앞,9968,9914,19882
20211116,안산선,대야미,5211,4675,9886
20211116,안산선,반월,4419,4213,8632
20211116,안산선,상록수,16446,16712,33158
20211116,안산선,산본,16215,17585,33800
20211116,안산선,중앙,17999,18707,36706
20211116,안산선,신길온천,1739,1588,3327
20211116,안산선,초지,5091,5461,10552
20211116,안산선,안산,11647,10488,22135
20211116,안산선,정왕,10021,10283,20304
20211116,안산선,오이도,8547,8231,16778
20211116,안산선,수리산,4462,3592,8054
20211116,안산선,고잔,9208,8743,17951
20211117,안산선,안산,11533,10448,21981
20211117,안산선,초지,5204,5423,10627
20211117,안산선,고잔,9124,8683,17807
20211117,안산선,중앙,18226,18667,36893
20211117,안산선,한대앞,9781,9870,19651
20211117,안산선,상록수,16392,16106,32498
20211117,안산선,반월,4504,4124,8628
20211117,안산선,대야미,5268,4481,9749
20211117,안산선,산본,16235,15292,31527
20211117,안산선,신길온천,1779,1637,3416
20211117,안산선,정왕,9850,10161,20011
20211117,안산선,오이도,8590,8255,16845
20211117,안산선,수리산,4359,3377,7736
20211118,안산선,대야미,5090,4583,9673
20211118,안산선,반월,4268,4099,8367
20211118,안산선,상록수,16341,16448,32789
20211118,안산선,한대앞,9851,9832,19683
20211118,안산선,중앙,18406,19181,37587
20211118,안산선,고잔,9018,8609,17627
20211118,안산선,산본,15962,16256,32218
20211118,안산선,안산,11602,10477,22079
20211118,안산선,신길온천,1768,1649,3417
20211118,안산선,정왕,9882,10051,19933
20211118,안산선,오이도,8501,8332,16833
20211118,안산선,수리산,4316,3393,7709
20211118,안산선,초지,5044,5346,10390
20211119,안산선,오이도,8931,8867,17798
20211119,안산선,정왕,10627,10022,20649
20211119,안산선,신길온천,1807,1699,3506
20211119,안산선,안산,11969,10871,22840
20211119,안산선,초지,5036,5109,10145
20211119,안산선,고잔,9248,8914,18162
20211119,안산선,수리산,4395,3438,7833
20211119,안산선,한대앞,10473,10291,20764
20211119,안산선,상록수,16717,16578,33295
20211119,안산선,반월,4398,4058,8456
20211119,안산선,대야미,5376,4563,9939
20211119,안산선,산본,16695,18030,34725
20211119,안산선,중앙,19169,20607,39776
20211120,안산선,수리산,2851,2535,5386
20211120,안산선,오이도,7769,7963,15732
20211120,안산선,정왕,6851,6760,13611
20211120,안산선,신길온천,1515,1446,2961
20211120,안산선,안산,9589,9789,19378
20211120,안산선,초지,3551,3607,7158
20211120,안산선,고잔,6892,6979,13871
20211120,안산선,한대앞,7999,7493,15492
20211120,안산선,상록수,12974,12791,25765
20211120,안산선,반월,3428,3212,6640
20211120,안산선,대야미,3856,3366,7222
20211120,안산선,산본,12438,13172,25610
20211120,안산선,중앙,16041,17351,33392
20211121,안산선,중앙,11469,11496,22965
20211121,안산선,산본,8655,9283,17938
20211121,안산선,반월,2446,2436,4882
20211121,안산선,상록수,9146,8955,18101
20211121,안산선,한대앞,5223,5310,10533
20211121,안산선,고잔,4758,4480,9238
20211121,안산선,대야미,2912,2650,5562
20211121,안산선,안산,9488,8686,18174
20211121,안산선,수리산,2035,2097,4132
20211121,안산선,오이도,5820,5591,11411
20211121,안산선,초지,2470,2245,4715
20211121,안산선,신길온천,1134,1090,2224
20211121,안산선,정왕,5254,5977,11231
20211122,안산선,오이도,8389,7724,16113
20211122,안산선,정왕,9570,10352,19922
20211122,안산선,신길온천,1700,1535,3235
20211122,안산선,안산,11586,10449,22035
20211122,안산선,초지,5052,5418,10470
20211122,안산선,고잔,8796,8363,17159
20211122,안산선,수리산,4275,3496,7771
20211122,안산선,한대앞,9675,9862,19537
20211122,안산선,상록수,15961,16031,31992
20211122,안산선,반월,4306,4149,8455
20211122,안산선,대야미,4861,4460,9321
20211122,안산선,산본,15621,16746,32367
20211122,안산선,중앙,17356,18061,35417
20211123,안산선,한대앞,9676,9845,19521
20211123,안산선,중앙,17545,18381,35926
20211123,안산선,고잔,8892,8631,17523
20211123,안산선,초지,5037,5229,10266
20211123,안산선,안산,11284,10180,21464
20211123,안산선,신길온천,1719,1517,3236
20211123,안산선,정왕,9608,10080,19688
20211123,안산선,수리산,4403,3536,7939
20211123,안산선,산본,15999,17128,33127
20211123,안산선,대야미,4944,4562,9506
20211123,안산선,상록수,16301,16646,32947
20211123,안산선,오이도,8391,8071,16462
20211123,안산선,반월,4335,4144,8479
20211124,안산선,산본,16055,17447,33502
20211124,안산선,중앙,17632,18432,36064
20211124,안산선,대야미,5128,4619,9747
20211124,안산선,반월,4302,4123,8425
20211124,안산선,상록수,16063,16389,32452
20211124,안산선,한대앞,9604,9511,19115
20211124,안산선,고잔,9137,8636,17773
20211124,안산선,안산,11323,10301,21624
20211124,안산선,신길온천,1679,1583,3262
20211124,안산선,정왕,9656,10057,19713
20211124,안산선,오이도,8482,8107,16589
20211124,안산선,수리산,4367,3540,7907
20211124,안산선,초지,5012,5363,10375
20211125,안산선,오이도,8475,8189,16664
20211125,안산선,정왕,9967,10292,20259
20211125,안산선,신길온천,1748,1605,3353
20211125,안산선,안산,11462,10403,21865
20211125,안산선,초지,5122,5527,10649
20211125,안산선,고잔,9242,8671,17913
20211125,안산선,수리산,4465,3661,8126
20211125,안산선,한대앞,9761,9863,19624
20211125,안산선,상록수,16259,16595,32854
20211125,안산선,반월,4429,4199,8628
20211125,안산선,대야미,5188,4633,9821
20211125,안산선,산본,16397,17223,33620
20211125,안산선,중앙,18123,18912,37035
20211126,안산선,안산,11829,10733,22562
20211126,안산선,초지,4906,5069,9975
20211126,안산선,고잔,9343,8942,18285
20211126,안산선,중앙,18786,20343,39129
20211126,안산선,한대앞,10597,10337,20934
20211126,안산선,상록수,16646,16600,33246
20211126,안산선,반월,4593,4382,8975
20211126,안산선,산본,16479,17822,34301
20211126,안산선,신길온천,1778,1638,3416
20211126,안산선,정왕,10643,10037,20680
20211126,안산선,오이도,8943,8785,17728
20211126,안산선,수리산,4528,3565,8093
20211126,안산선,대야미,5306,4645,9951
20211127,안산선,초지,3381,3231,6612
20211127,안산선,오이도,7520,7700,15220
20211127,안산선,정왕,6586,6600,13186
20211127,안산선,신길온천,1430,1350,2780
20211127,안산선,안산,9529,9722,19251
20211127,안산선,고잔,6690,6778,13468
20211127,안산선,수리산,2962,2559,5521
20211127,안산선,한대앞,7303,6979,14282
20211127,안산선,산본,12483,13304,25787
20211127,안산선,대야미,3958,3539,7497
20211127,안산선,중앙,15731,16871,32602
20211127,안산선,상록수,13272,13103,26375
20211127,안산선,반월,3462,3073,6535
20211128,안산선,산본,8646,9337,17983
20211128,안산선,대야미,2905,2575,5480
20211128,안산선,반월,2449,2435,4884
20211128,안산선,상록수,9293,9190,18483
20211128,안산선,중앙,11649,11725,23374
20211128,안산선,고잔,4897,4689,9586
20211128,안산선,한대앞,5470,5398,10868
20211128,안산선,안산,9289,8545,17834
20211128,안산선,신길온천,1060,1054,2114
20211128,안산선,정왕,5582,6044,11626
20211128,안산선,오이도,5930,5675,11605
20211128,안산선,수리산,2132,2076,4208
20211128,안산선,초지,2421,2293,4714
20211129,안산선,안산,11639,10606,22245
20211129,안산선,오이도,8385,7956,16341
20211129,안산선,수리산,4387,3628,8015
20211129,안산선,정왕,9575,10178,19753
20211129,안산선,신길온천,1702,1503,3205
20211129,안산선,초지,5116,5429,10545
20211129,안산선,대야미,5142,4622,9764
20211129,안산선,중앙,17733,18093,35826
20211129,안산선,한대앞,9556,9828,19384
20211129,안산선,상록수,16271,16285,32556
20211129,안산선,반월,4399,4312,8711
20211129,안산선,산본,15932,17228,33160
20211129,안산선,고잔,8959,8349,17308
20211130,안산선,수리산,4063,3320,7383
20211130,안산선,오이도,7587,7264,14851
20211130,안산선,정왕,8831,9234,18065
20211130,안산선,신길온천,1523,1381,2904
20211130,안산선,초지,4837,5049,9886
20211130,안산선,안산,10844,9675,20519
20211130,안산선,고잔,8303,7933,16236
20211130,안산선,한대앞,9053,9068,18121
20211130,안산선,상록수,15528,15554,31082
20211130,안산선,반월,3958,3779,7737
20211130,안산선,대야미,4639,4105,8744
20211130,안산선,산본,14635,15897,30532
20211130,안산선,중앙,16316,16976,33292
20211201,안산선,오이도,8005,7769,15774
20211201,안산선,정왕,9126,9563,18689
20211201,안산선,신길온천,1660,1490,3150
20211201,안산선,안산,11143,10207,21350
20211201,안산선,초지,4913,5260,10173
20211201,안산선,고잔,8712,8266,16978
20211201,안산선,수리산,4316,3522,7838
20211201,안산선,한대앞,9131,9267,18398
20211201,안산선,상록수,15894,15969,31863
20211201,안산선,반월,4310,4120,8430
20211201,안산선,대야미,4924,4454,9378
20211201,안산선,산본,15729,16829,32558
20211201,안산선,중앙,17182,18169,35351
20211202,안산선,산본,15733,16771,32504
20211202,안산선,대야미,4880,4440,9320
20211202,안산선,반월,4279,4069,8348
20211202,안산선,상록수,15848,15979,31827
20211202,안산선,한대앞,9353,9446,18799
20211202,안산선,중앙,17290,18092,35382
20211202,안산선,고잔,8790,8241,17031
20211202,안산선,안산,11182,10171,21353
20211202,안산선,신길온천,1659,1521,3180
20211202,안산선,정왕,9274,9354,18628
20211202,안산선,오이도,8128,7872,16000
20211202,안산선,수리산,4335,3532,7867
20211202,안산선,초지,4888,5303,10191
20211203,안산선,초지,4804,5070,9874
20211203,안산선,고잔,8882,8521,17403
20211203,안산선,중앙,18151,19666,37817
20211203,안산선,한대앞,9915,9669,19584
20211203,안산선,상록수,16478,16264,32742
20211203,안산선,반월,4365,4163,8528
20211203,안산선,대야미,5102,4310,9412
20211203,안산선,수리산,4384,3412,7796
20211203,안산선,안산,11814,10576,22390
20211203,안산선,신길온천,1693,1565,3258
20211203,안산선,산본,16087,16715,32802
20211203,안산선,오이도,8549,8489,17038
20211203,안산선,정왕,9560,9373,18933
20211204,안산선,오이도,6855,6989,13844
20211204,안산선,정왕,6356,6433,12789
20211204,안산선,신길온천,1401,1312,2713
20211204,안산선,안산,8812,9064,17876
20211204,안산선,초지,3232,3163,6395
20211204,안산선,고잔,6294,6193,12487
20211204,안산선,수리산,2794,2356,5150
20211204,안산선,한대앞,7050,6943,13993
20211204,안산선,상록수,12071,12057,24128
20211204,안산선,반월,3262,2951,6213
20211204,안산선,대야미,3789,3213,7002
20211204,안산선,산본,11873,10656,22529
20211204,안산선,중앙,14842,15722,30564
20211205,안산선,수리산,1938,2017,3955
20211205,안산선,오이도,5398,5201,10599
20211205,안산선,정왕,4899,5378,10277
20211205,안산선,신길온천,1063,986,2049
20211205,안산선,안산,8551,8084,16635
20211205,안산선,초지,2217,2199,4416
20211205,안산선,고잔,4299,4104,8403
20211205,안산선,한대앞,5011,5050,10061
20211205,안산선,상록수,8731,8473,17204
20211205,안산선,반월,2393,2362,4755
20211205,안산선,산본,8127,8831,16958
20211205,안산선,중앙,11116,11049,22165
20211205,안산선,대야미,2765,2484,5249
20211206,안산선,안산,11576,10446,22022
20211206,안산선,한대앞,9481,9544,19025
20211206,안산선,산본,15560,16663,32223
20211206,안산선,대야미,4852,4514,9366
20211206,안산선,반월,4361,4153,8514
20211206,안산선,상록수,16045,16156,32201
20211206,안산선,중앙,17049,17672,34721
20211206,안산선,초지,4871,5165,10036
20211206,안산선,수리산,4367,3528,7895
20211206,안산선,오이도,8193,7743,15936
20211206,안산선,정왕,9114,9655,18769
20211206,안산선,신길온천,1741,1581,3322
20211206,안산선,고잔,8639,8100,16739
20211207,안산선,고잔,9023,8424,17447
20211207,안산선,중앙,17034,17881,34915
20211207,안산선,한대앞,9505,9556,19061
20211207,안산선,상록수,16306,16549,32855
20211207,안산선,반월,4246,4130,8376
20211207,안산선,대야미,4964,4453,9417
20211207,안산선,안산,11422,10261,21683
20211207,안산선,수리산,4370,3623,7993
20211207,안산선,오이도,8310,8074,16384
20211207,안산선,정왕,9048,9465,18513
20211207,안산선,신길온천,1695,1567,3262
20211207,안산선,초지,5005,5443,10448
20211207,안산선,산본,15725,16861,32586
20211208,안산선,산본,15464,15323,30787
20211208,안산선,대야미,5010,4484,9494
20211208,안산선,반월,4410,4179,8589
20211208,안산선,상록수,16067,16394,32461
20211208,안산선,한대앞,9267,9431,18698
20211208,안산선,중앙,17085,17799,34884
20211208,안산선,고잔,8995,8552,17547
20211208,안산선,안산,11311,10343,21654
20211208,안산선,신길온천,1730,1656,3386
20211208,안산선,정왕,9264,9536,18800
20211208,안산선,오이도,8228,7829,16057
20211208,안산선,수리산,4329,3576,7905
20211208,안산선,초지,4918,5185,10103
20211209,안산선,안산,11028,9943,20971
20211209,안산선,오이도,8166,7842,16008
20211209,안산선,정왕,9059,9368,18427
20211209,안산선,신길온천,1630,1528,3158
20211209,안산선,수리산,4259,3503,7762
20211209,안산선,초지,4872,5266,10138
20211209,안산선,상록수,15901,15960,31861
20211209,안산선,중앙,16984,17771,34755
20211209,안산선,한대앞,9347,9520,18867
20211209,안산선,반월,4190,4063,8253
20211209,안산선,대야미,4930,4390,9320
20211209,안산선,산본,15596,13925,29521
20211209,안산선,고잔,8849,8320,17169
20211210,안산선,수리산,4278,3292,7570
20211210,안산선,오이도,8318,8183,16501
20211210,안산선,정왕,10055,9777,19832
20211210,안산선,신길온천,1729,1564,3293
20211210,안산선,안산,11593,10398,21991
20211210,안산선,초지,4794,5069,9863
20211210,안산선,고잔,8654,8354,17008
20211210,안산선,중앙,17838,19255,37093
20211210,안산선,한대앞,9699,9486,19185
20211210,안산선,상록수,15941,16007,31948
20211210,안산선,반월,4315,4057,8372
20211210,안산선,대야미,5025,4308,9333
20211210,안산선,산본,15803,14397,30200
20211211,안산선,오이도,6767,6930,13697
20211211,안산선,정왕,6139,6166,12305
20211211,안산선,신길온천,1357,1287,2644
20211211,안산선,안산,8780,9121,17901
20211211,안산선,초지,3195,3101,6296
20211211,안산선,고잔,5994,5793,11787
20211211,안산선,수리산,2742,2449,5191
20211211,안산선,한대앞,6678,6636,13314
20211211,안산선,상록수,11736,11561,23297
20211211,안산선,반월,3158,2903,6061
20211211,안산선,대야미,3781,3288,7069
20211211,안산선,산본,11521,10309,21830
20211211,안산선,중앙,14364,15233,29597
20211212,안산선,오이도,5068,4980,10048
20211212,안산선,정왕,4567,5068,9635
20211212,안산선,신길온천,1011,939,1950
20211212,안산선,안산,8415,7817,16232
20211212,안산선,초지,2096,2024,4120
20211212,안산선,고잔,4187,4160,8347
20211212,안산선,수리산,1904,1886,3790
20211212,안산선,한대앞,4780,4839,9619
20211212,안산선,상록수,8146,8127,16273
20211212,안산선,반월,2333,2286,4619
20211212,안산선,대야미,2626,2313,4939
20211212,안산선,산본,7787,8234,16021
20211212,안산선,중앙,10229,10159,20388
20211213,안산선,산본,14986,16072,31058
20211213,안산선,대야미,4635,4208,8843
20211213,안산선,반월,4091,3940,8031
20211213,안산선,상록수,14981,15075,30056
20211213,안산선,한대앞,9018,9100,18118
20211213,안산선,중앙,15933,16677,32610
20211213,안산선,고잔,8342,7729,16071
20211213,안산선,안산,11271,10044,21315
20211213,안산선,신길온천,1625,1486,3111
20211213,안산선,정왕,9136,9631,18767
20211213,안산선,오이도,7651,7280,14931
20211213,안산선,수리산,4124,3400,7524
20211213,안산선,초지,4616,4840,9456
20211214,안산선,중앙,16311,17212,33523
20211214,안산선,대야미,4803,4270,9073
20211214,안산선,반월,4083,3931,8014
20211214,안산선,상록수,15077,15338,30415
20211214,안산선,한대앞,9197,9159,18356
20211214,안산선,고잔,8458,8082,16540
20211214,안산선,산본,15106,16127,31233
20211214,안산선,안산,10937,9817,20754
20211214,안산선,수리산,4248,3506,7754
20211214,안산선,오이도,7778,7476,15254
20211214,안산선,초지,4525,4712,9237
20211214,안산선,신길온천,1658,1562,3220
20211214,안산선,정왕,9201,9466,18667
20211215,안산선,오이도,7922,7765,15687
20211215,안산선,정왕,9030,9372,18402
20211215,안산선,신길온천,1706,1569,3275
20211215,안산선,안산,11281,10068,21349
20211215,안산선,초지,4588,4824,9412
20211215,안산선,고잔,8673,8184,16857
20211215,안산선,수리산,4197,3381,7578
20211215,안산선,한대앞,9392,9562,18954
20211215,안산선,상록수,15155,15370,30525
20211215,안산선,반월,4233,4056,8289
20211215,안산선,대야미,4927,4362,9289
20211215,안산선,산본,15460,16507,31967
20211215,안산선,중앙,17517,18196,35713
20211216,안산선,수리산,4290,3491,7781
20211216,안산선,오이도,8062,7854,15916
20211216,안산선,정왕,8976,9218,18194
20211216,안산선,신길온천,1694,1568,3262
20211216,안산선,안산,11175,9964,21139
20211216,안산선,초지,4532,4671,9203
20211216,안산선,고잔,8676,8226,16902
20211216,안산선,한대앞,9353,9413,18766
20211216,안산선,상록수,15076,15352,30428
20211216,안산선,반월,4194,3997,8191
20211216,안산선,산본,15538,16572,32110
20211216,안산선,중앙,17291,18188,35479
20211216,안산선,대야미,4922,4405,9327
20211217,안산선,산본,15654,16838,32492
20211217,안산선,중앙,17177,18613,35790
20211217,안산선,대야미,4827,4159,8986
20211217,안산선,반월,4149,3943,8092
20211217,안산선,상록수,15165,15062,30227
20211217,안산선,한대앞,9325,9132,18457
20211217,안산선,고잔,8685,8287,16972
20211217,안산선,안산,11015,10106,21121
20211217,안산선,신길온천,1628,1477,3105
20211217,안산선,정왕,8838,8820,17658
20211217,안산선,오이도,8163,7962,16125
20211217,안산선,수리산,4172,3262,7434
20211217,안산선,초지,4429,4580,9009
20211218,안산선,대야미,3197,2906,6103
20211218,안산선,반월,2913,2779,5692
20211218,안산선,상록수,11005,11662,22667
20211218,안산선,한대앞,6448,6673,13121
20211218,안산선,중앙,14948,15388,30336
20211218,안산선,고잔,6061,5997,12058
20211218,안산선,산본,10826,11619,22445
20211218,안산선,안산,8723,8912,17635
20211218,안산선,신길온천,1196,1198,2394
20211218,안산선,정왕,6041,6275,12316
20211218,안산선,오이도,6802,7215,14017
20211218,안산선,수리산,2483,2160,4643
20211218,안산선,초지,3107,3145,6252
20211219,안산선,수리산,1782,1698,3480
20211219,안산선,오이도,5265,5232,10497
20211219,안산선,정왕,4704,5179,9883
20211219,안산선,신길온천,985,998,1983
20211219,안산선,안산,8261,7827,16088
20211219,안산선,초지,2194,2219,4413
20211219,안산선,고잔,4552,4428,8980
20211219,안산선,한대앞,4909,4819,9728
20211219,안산선,상록수,8413,8200,16613
20211219,안산선,반월,2302,2198,4500
20211219,안산선,대야미,2514,2316,4830
20211219,안산선,산본,8083,8677,16760
20211219,안산선,중앙,11246,10936,22182
20211220,안산선,중앙,16727,17222,33949
20211220,안산선,대야미,4750,4327,9077
20211220,안산선,반월,4214,4075,8289
20211220,안산선,산본,15236,16503,31739
20211220,안산선,한대앞,9105,9196,18301
20211220,안산선,고잔,8592,8027,16619
20211220,안산선,상록수,14941,15271,30212
20211220,안산선,안산,11342,10118,21460
20211220,안산선,신길온천,1686,1521,3207
20211220,안산선,정왕,8565,9044,17609
20211220,안산선,오이도,7862,7485,15347
20211220,안산선,수리산,4157,3472,7629
20211220,안산선,초지,4347,4549,8896
20211221,안산선,오이도,8094,7787,15881
20211221,안산선,정왕,8933,9256,18189
20211221,안산선,신길온천,1710,1593,3303
20211221,안산선,안산,11241,10167,21408
20211221,안산선,초지,4381,4516,8897
20211221,안산선,고잔,8778,8370,17148
20211221,안산선,수리산,4241,3515,7756
20211221,안산선,한대앞,9492,9452,18944
20211221,안산선,산본,15705,16747,32452
20211221,안산선,상록수,15092,15409,30501
20211221,안산선,반월,4151,4002,8153
20211221,안산선,대야미,4904,4375,9279
20211221,안산선,중앙,17006,17442,34448
20211222,안산선,수리산,4164,3499,7663
20211222,안산선,오이도,8150,7973,16123
20211222,안산선,정왕,7775,7894,15669
20211222,안산선,신길온천,1706,1525,3231
20211222,안산선,안산,11143,10165,21308
20211222,안산선,초지,4328,4467,8795
20211222,안산선,고잔,8843,8357,17200
20211222,안산선,한대앞,8760,8756,17516
20211222,안산선,상록수,15217,15717,30934
20211222,안산선,반월,4258,4121,8379
20211222,안산선,대야미,4956,4428,9384
20211222,안산선,산본,15573,16780,32353
20211222,안산선,중앙,17169,17685,34854
20211223,안산선,한대앞,8762,8788,17550
20211223,안산선,산본,15628,16872,32500
20211223,안산선,대야미,4860,4364,9224
20211223,안산선,반월,4288,4186,8474
20211223,안산선,상록수,15198,15446,30644
20211223,안산선,중앙,17312,18064,35376
20211223,안산선,고잔,8901,8412,17313
20211223,안산선,초지,4323,4450,8773
20211223,안산선,안산,11141,9905,21046
20211223,안산선,신길온천,1725,1601,3326
20211223,안산선,정왕,7342,7714,15056
20211223,안산선,오이도,8080,7890,15970
20211223,안산선,수리산,4203,3411,7614
20211224,안산선,대야미,4981,4334,9315
20211224,안산선,반월,4277,4056,8333
20211224,안산선,상록수,15453,15591,31044
20211224,안산선,한대앞,8765,8868,17633
20211224,안산선,중앙,17885,19028,36913
20211224,안산선,고잔,8510,8167,16677
20211224,안산선,산본,15836,17458,33294
20211224,안산선,안산,11720,10684,22404
20211224,안산선,신길온천,1743,1692,3435
20211224,안산선,정왕,8070,8271,16341
20211224,안산선,오이도,8398,8465,16863
20211224,안산선,수리산,4177,3287,7464
20211224,안산선,초지,4312,4428,8740
20211225,안산선,산본,9260,9799,19059
20211225,안산선,대야미,2525,2259,4784
20211225,안산선,반월,2380,2267,4647
20211225,안산선,상록수,9283,9499,18782
20211225,안산선,한대앞,5073,5147,10220
20211225,안산선,중앙,13397,13793,27190
20211225,안산선,고잔,4426,4269,8695
20211225,안산선,안산,7729,8099,15828
20211225,안산선,신길온천,1087,977,2064
20211225,안산선,정왕,5086,5189,10275
20211225,안산선,오이도,6454,6634,13088
20211225,안산선,수리산,1938,1642,3580
20211225,안산선,초지,2425,2485,4910
20211226,안산선,한대앞,4186,4158,8344
20211226,안산선,대야미,1974,1872,3846
20211226,안산선,반월,1864,1930,3794
20211226,안산선,상록수,7232,7279,14511
20211226,안산선,산본,6764,7215,13979
20211226,안산선,중앙,9536,9414,18950
20211226,안산선,신길온천,869,853,1722
20211226,안산선,초지,1822,1792,3614
20211226,안산선,안산,7317,6568,13885
20211226,안산선,정왕,4154,4545,8699
20211226,안산선,오이도,4304,4303,8607
20211226,안산선,수리산,1579,1444,3023
20211226,안산선,고잔,3474,3324,6798
20211227,안산선,대야미,4433,4073,8506
20211227,안산선,반월,3830,3689,7519
20211227,안산선,상록수,13971,14218,28189
20211227,안산선,한대앞,7761,7845,15606
20211227,안산선,중앙,15810,16112,31922
20211227,안산선,고잔,7888,7317,15205
20211227,안산선,산본,14072,15337,29409
20211227,안산선,안산,10485,9394,19879
20211227,안산선,신길온천,1509,1378,2887
20211227,안산선,정왕,6852,7364,14216
20211227,안산선,오이도,7211,7015,14226
20211227,안산선,수리산,3834,3114,6948
20211227,안산선,초지,4011,4184,8195
20211228,안산선,산본,14961,16116,31077
20211228,안산선,대야미,4705,4316,9021
20211228,안산선,반월,4039,3840,7879
20211228,안산선,상록수,14560,15026,29586
20211228,안산선,한대앞,8149,8278,16427
20211228,안산선,중앙,16325,16775,33100
20211228,안산선,고잔,8383,7844,16227
20211228,안산선,안산,10597,9682,20279
20211228,안산선,신길온천,1593,1423,3016
20211228,안산선,정왕,6870,7226,14096
20211228,안산선,오이도,7647,7320,14967
20211228,안산선,수리산,4029,3203,7232
20211228,안산선,초지,4234,4294,8528
20211229,안산선,안산,10816,9642,20458
20211229,안산선,오이도,7964,7745,15709
20211229,안산선,정왕,7048,7563,14611
20211229,안산선,신길온천,1675,1531,3206
20211229,안산선,수리산,4081,3347,7428
20211229,안산선,초지,4252,4394,8646
20211229,안산선,상록수,14686,15052,29738
20211229,안산선,중앙,16669,17299,33968
20211229,안산선,한대앞,8230,8357,16587
20211229,안산선,반월,4073,3936,8009
20211229,안산선,대야미,4841,4407,9248
20211229,안산선,산본,15287,16417,31704
20211229,안산선,고잔,8225,7921,16146
20211230,안산선,수리산,4048,3265,7313
20211230,안산선,오이도,7721,7648,15369
20211230,안산선,정왕,7266,7596,14862
20211230,안산선,안산,10610,9680,20290
20211230,안산선,초지,4186,4280,8466
20211230,안산선,고잔,8222,7819,16041
20211230,안산선,신길온천,1607,1487,3094
20211230,안산선,한대앞,8112,8146,16258
20211230,안산선,상록수,14864,15009,29873
20211230,안산선,반월,4040,3783,7823
20211230,안산선,대야미,4617,4135,8752
20211230,안산선,산본,15278,16316,31594
20211230,안산선,중앙,16674,17417,34091
20211231,안산선,정왕,7525,7763,15288
20211231,안산선,신길온천,1526,1491,3017
20211231,안산선,안산,11077,10990,22067
20211231,안산선,초지,3908,4122,8030
20211231,안산선,고잔,7556,7270,14826
20211231,안산선,상록수,13950,14495,28445
20211231,안산선,한대앞,7884,7963,15847
20211231,안산선,반월,3964,3675,7639
20211231,안산선,대야미,4329,3847,8176
20211231,안산선,산본,14447,15185,29632
20211231,안산선,오이도,7797,8099,15896
20211231,안산선,중앙,16262,17577,33839
20211231,안산선,수리산,3608,2735,6343
