,사용일자,호선명,지하철역,승차총승객수,하차총승객수,승하차총승객수
0,2020-01-01,3호선,대화,6456,5901,12357
1,2020-01-01,3호선,주엽,4213,4264,8477
2,2020-01-01,3호선,정발산,4468,4495,8963
3,2020-01-01,3호선,마두,3643,3685,7328
4,2020-01-01,3호선,백석,5630,5479,11109
5,2020-01-01,3호선,대곡,732,569,1301
6,2020-01-01,3호선,화정,9733,9958,19691
7,2020-01-01,3호선,원당,5402,5402,10804
8,2020-01-01,3호선,삼송,9788,9860,19648
9,2020-01-01,3호선,원흥,3944,3886,7830
10,2020-01-01,3호선,오금,2215,2210,4425
11,2020-01-01,3호선,경찰병원,2689,2816,5505
12,2020-01-01,3호선,가락시장,3711,3584,7295
13,2020-01-01,3호선,수서,9190,9114,18304
14,2020-01-01,3호선,일원,3016,3423,6439
15,2020-01-01,3호선,대청,3906,3658,7564
16,2020-01-01,3호선,학여울,595,625,1220
17,2020-01-01,3호선,대치,5074,4656,9730
18,2020-01-01,3호선,도곡,1708,1802,3510
19,2020-01-01,3호선,매봉,3265,3225,6490
20,2020-01-01,3호선,양재,10750,11705,22455
21,2020-01-01,3호선,남부터미널,14564,15123,29687
22,2020-01-01,3호선,교대,3299,1977,5276
23,2020-01-01,3호선,고속터미널,39526,34867,74393
24,2020-01-01,3호선,잠원,2373,2355,4728
25,2020-01-01,3호선,신사,14593,13688,28281
26,2020-01-01,3호선,압구정,9788,10110,19898
27,2020-01-01,3호선,옥수,4370,4673,9043
28,2020-01-01,3호선,금호,3846,3735,7581
29,2020-01-01,3호선,약수,5909,5812,11721
30,2020-01-01,3호선,동대입구,5490,6806,12296
31,2020-01-01,3호선,을지로3가,3686,3543,7229
32,2020-01-01,3호선,종로3가,4173,6053,10226
33,2020-01-01,3호선,안국,11837,12378,24215
34,2020-01-01,3호선,경복궁,12647,13381,26028
35,2020-01-01,3호선,독립문,3791,4020,7811
36,2020-01-01,3호선,무악재,1740,1986,3726
37,2020-01-01,3호선,홍제,8618,8389,17007
38,2020-01-01,3호선,녹번,5554,5275,10829
39,2020-01-01,3호선,불광,8935,10408,19343
40,2020-01-01,3호선,연신내,21529,21007,42536
41,2020-01-01,3호선,구파발,11160,11563,22723
42,2020-01-01,3호선,지축,795,856,1651
43,2020-01-02,3호선,지축,1989,2097,4086
44,2020-01-02,3호선,구파발,23882,22075,45957
45,2020-01-02,3호선,연신내,43744,41453,85197
46,2020-01-02,3호선,불광,18451,20089,38540
47,2020-01-02,3호선,녹번,15120,13308,28428
48,2020-01-02,3호선,홍제,19458,18524,37982
49,2020-01-02,3호선,무악재,4386,4476,8862
50,2020-01-02,3호선,독립문,8030,8249,16279
51,2020-01-02,3호선,경복궁,24304,24658,48962
52,2020-01-02,3호선,안국,26607,27464,54071
53,2020-01-02,3호선,종로3가,12265,14862,27127
54,2020-01-02,3호선,을지로3가,12998,13470,26468
55,2020-01-02,3호선,충무로,1,0,1
56,2020-01-02,3호선,동대입구,10099,11550,21649
57,2020-01-02,3호선,약수,14495,14270,28765
58,2020-01-02,3호선,금호,9308,8683,17991
59,2020-01-02,3호선,옥수,10222,10659,20881
60,2020-01-02,3호선,압구정,38379,41515,79894
61,2020-01-02,3호선,신사,36170,39068,75238
62,2020-01-02,3호선,잠원,6764,6637,13401
63,2020-01-02,3호선,고속터미널,55884,51160,107044
64,2020-01-02,3호선,교대,16689,10798,27487
65,2020-01-02,3호선,남부터미널,35067,35037,70104
66,2020-01-02,3호선,양재,43164,46934,90098
67,2020-01-02,3호선,매봉,13108,12524,25632
68,2020-01-02,3호선,도곡,6240,6160,12400
69,2020-01-02,3호선,대치,13874,13476,27350
70,2020-01-02,3호선,학여울,1917,2010,3927
71,2020-01-02,3호선,대청,10965,10082,21047
72,2020-01-02,3호선,일원,11275,11140,22415
73,2020-01-02,3호선,수서,18957,18996,37953
74,2020-01-02,3호선,가락시장,10396,10228,20624
75,2020-01-02,3호선,경찰병원,9095,9184,18279
76,2020-01-02,3호선,오금,7294,6404,13698
77,2020-01-02,3호선,원흥,10126,9646,19772
78,2020-01-02,3호선,삼송,19681,18748,38429
79,2020-01-02,3호선,원당,12336,11764,24100
80,2020-01-02,3호선,화정,20439,21091,41530
81,2020-01-02,3호선,대곡,1725,1247,2972
82,2020-01-02,3호선,백석,11836,11787,23623
83,2020-01-02,3호선,마두,9311,9568,18879
84,2020-01-02,3호선,정발산,8566,8970,17536
85,2020-01-02,3호선,주엽,10735,11018,21753
86,2020-01-02,3호선,대화,16529,12550,29079
87,2020-01-03,3호선,지축,2136,2225,4361
88,2020-01-03,3호선,구파발,24746,22782,47528
89,2020-01-03,3호선,연신내,46449,44268,90717
90,2020-01-03,3호선,불광,19376,20773,40149
91,2020-01-03,3호선,녹번,16068,13844,29912
92,2020-01-03,3호선,홍제,20597,19358,39955
93,2020-01-03,3호선,무악재,4562,4571,9133
94,2020-01-03,3호선,독립문,8531,8636,17167
95,2020-01-03,3호선,경복궁,27754,27280,55034
96,2020-01-03,3호선,안국,28369,29379,57748
97,2020-01-03,3호선,종로3가,12961,16385,29346
98,2020-01-03,3호선,을지로3가,13798,14521,28319
99,2020-01-03,3호선,충무로,1,0,1
100,2020-01-03,3호선,동대입구,10670,11699,22369
101,2020-01-03,3호선,약수,15542,14912,30454
102,2020-01-03,3호선,금호,9831,8920,18751
103,2020-01-03,3호선,옥수,10817,10921,21738
104,2020-01-03,3호선,압구정,41656,45086,86742
105,2020-01-03,3호선,신사,39476,43942,83418
106,2020-01-03,3호선,잠원,7302,6887,14189
107,2020-01-03,3호선,고속터미널,62892,63136,126028
108,2020-01-03,3호선,교대,16935,11032,27967
109,2020-01-03,3호선,남부터미널,37616,37595,75211
110,2020-01-03,3호선,양재,47845,50358,98203
111,2020-01-03,3호선,매봉,13639,13162,26801
112,2020-01-03,3호선,도곡,6615,6466,13081
113,2020-01-03,3호선,대치,14743,14319,29062
114,2020-01-03,3호선,학여울,2600,2635,5235
115,2020-01-03,3호선,대청,11658,10619,22277
116,2020-01-03,3호선,일원,11640,11129,22769
117,2020-01-03,3호선,수서,21576,20813,42389
118,2020-01-03,3호선,가락시장,11701,11430,23131
119,2020-01-03,3호선,경찰병원,9217,9217,18434
120,2020-01-03,3호선,오금,7610,6610,14220
121,2020-01-03,3호선,원흥,10678,9606,20284
122,2020-01-03,3호선,삼송,20853,19462,40315
123,2020-01-03,3호선,원당,12940,12289,25229
124,2020-01-03,3호선,화정,21456,22314,43770
125,2020-01-03,3호선,대곡,1880,1347,3227
126,2020-01-03,3호선,백석,12510,12663,25173
127,2020-01-03,3호선,마두,9545,9901,19446
128,2020-01-03,3호선,정발산,9481,10424,19905
129,2020-01-03,3호선,주엽,11100,11382,22482
130,2020-01-03,3호선,대화,16778,12870,29648
131,2020-01-04,3호선,오금,4725,4208,8933
132,2020-01-04,3호선,지축,1533,1615,3148
133,2020-01-04,3호선,구파발,18029,17398,35427
134,2020-01-04,3호선,연신내,35604,34264,69868
135,2020-01-04,3호선,불광,15324,17348,32672
136,2020-01-04,3호선,녹번,10789,9216,20005
137,2020-01-04,3호선,홍제,15700,15112,30812
138,2020-01-04,3호선,무악재,3159,3220,6379
139,2020-01-04,3호선,독립문,7398,7539,14937
140,2020-01-04,3호선,경복궁,26351,22669,49020
141,2020-01-04,3호선,안국,20711,22650,43361
142,2020-01-04,3호선,종로3가,8103,12359,20462
143,2020-01-04,3호선,을지로3가,6931,7364,14295
144,2020-01-04,3호선,충무로,1,0,1
145,2020-01-04,3호선,동대입구,8627,9756,18383
146,2020-01-04,3호선,약수,10907,10291,21198
147,2020-01-04,3호선,금호,7030,6290,13320
148,2020-01-04,3호선,옥수,8027,7987,16014
149,2020-01-04,3호선,압구정,30384,32219,62603
150,2020-01-04,3호선,신사,30453,33081,63534
151,2020-01-04,3호선,잠원,4821,4461,9282
152,2020-01-04,3호선,고속터미널,68676,67117,135793
153,2020-01-04,3호선,교대,8774,5246,14020
154,2020-01-04,3호선,남부터미널,29137,28329,57466
155,2020-01-04,3호선,양재,25516,27259,52775
156,2020-01-04,3호선,매봉,6504,5984,12488
157,2020-01-04,3호선,도곡,4199,4169,8368
158,2020-01-04,3호선,대치,11563,10373,21936
159,2020-01-04,3호선,학여울,2090,2122,4212
160,2020-01-04,3호선,대청,7040,6412,13452
161,2020-01-04,3호선,일원,5905,5822,11727
162,2020-01-04,3호선,수서,15711,15384,31095
163,2020-01-04,3호선,가락시장,7622,7266,14888
164,2020-01-04,3호선,경찰병원,4840,4756,9596
165,2020-01-04,3호선,원당,9947,9177,19124
166,2020-01-04,3호선,원흥,7241,6579,13820
167,2020-01-04,3호선,삼송,15413,14156,29569
168,2020-01-04,3호선,화정,16054,16395,32449
169,2020-01-04,3호선,대곡,1249,1130,2379
170,2020-01-04,3호선,백석,9805,9797,19602
171,2020-01-04,3호선,마두,6434,6478,12912
172,2020-01-04,3호선,정발산,8294,9391,17685
173,2020-01-04,3호선,주엽,7939,7933,15872
174,2020-01-04,3호선,대화,11371,9656,21027
175,2020-01-05,3호선,지축,1127,1171,2298
176,2020-01-05,3호선,구파발,13763,13946,27709
177,2020-01-05,3호선,연신내,26339,24829,51168
178,2020-01-05,3호선,불광,11326,13497,24823
179,2020-01-05,3호선,녹번,7510,6650,14160
180,2020-01-05,3호선,홍제,11184,10684,21868
181,2020-01-05,3호선,무악재,2157,2326,4483
182,2020-01-05,3호선,독립문,5360,5717,11077
183,2020-01-05,3호선,경복궁,13690,14125,27815
184,2020-01-05,3호선,안국,12912,13868,26780
185,2020-01-05,3호선,종로3가,4817,6875,11692
186,2020-01-05,3호선,을지로3가,4417,4439,8856
187,2020-01-05,3호선,동대입구,6890,7949,14839
188,2020-01-05,3호선,약수,8215,7899,16114
189,2020-01-05,3호선,금호,5256,4964,10220
190,2020-01-05,3호선,옥수,5658,6124,11782
191,2020-01-05,3호선,압구정,17776,18210,35986
192,2020-01-05,3호선,신사,17917,18149,36066
193,2020-01-05,3호선,잠원,3200,3253,6453
194,2020-01-05,3호선,고속터미널,55120,52535,107655
195,2020-01-05,3호선,교대,5042,3011,8053
196,2020-01-05,3호선,남부터미널,18505,19554,38059
197,2020-01-05,3호선,양재,17568,19256,36824
198,2020-01-05,3호선,매봉,4415,4297,8712
199,2020-01-05,3호선,도곡,2568,2658,5226
200,2020-01-05,3호선,대치,7254,6482,13736
201,2020-01-05,3호선,학여울,1368,1443,2811
202,2020-01-05,3호선,대청,4921,4691,9612
203,2020-01-05,3호선,일원,4287,4679,8966
204,2020-01-05,3호선,수서,11647,11825,23472
205,2020-01-05,3호선,가락시장,4659,4845,9504
206,2020-01-05,3호선,경찰병원,3464,3410,6874
207,2020-01-05,3호선,오금,3410,3277,6687
208,2020-01-05,3호선,원흥,5440,5323,10763
209,2020-01-05,3호선,삼송,11369,11220,22589
210,2020-01-05,3호선,원당,7132,6922,14054
211,2020-01-05,3호선,화정,13195,13567,26762
212,2020-01-05,3호선,대곡,1050,850,1900
213,2020-01-05,3호선,백석,7453,7176,14629
214,2020-01-05,3호선,마두,4458,4401,8859
215,2020-01-05,3호선,정발산,7192,7037,14229
216,2020-01-05,3호선,주엽,5244,5690,10934
217,2020-01-05,3호선,대화,8437,7600,16037
218,2020-01-06,3호선,지축,2063,2156,4219
219,2020-01-06,3호선,구파발,24253,22488,46741
220,2020-01-06,3호선,연신내,43966,42042,86008
221,2020-01-06,3호선,불광,18763,20299,39062
222,2020-01-06,3호선,녹번,15558,13850,29408
223,2020-01-06,3호선,홍제,19907,19029,38936
224,2020-01-06,3호선,무악재,4477,4594,9071
225,2020-01-06,3호선,독립문,7754,7977,15731
226,2020-01-06,3호선,경복궁,23002,23363,46365
227,2020-01-06,3호선,안국,25770,26599,52369
228,2020-01-06,3호선,종로3가,12645,14579,27224
229,2020-01-06,3호선,을지로3가,13638,13882,27520
230,2020-01-06,3호선,충무로,1,0,1
231,2020-01-06,3호선,동대입구,10432,11162,21594
232,2020-01-06,3호선,약수,15443,15045,30488
233,2020-01-06,3호선,금호,9441,8865,18306
234,2020-01-06,3호선,옥수,10442,10911,21353
235,2020-01-06,3호선,압구정,39011,42644,81655
236,2020-01-06,3호선,신사,36355,38647,75002
237,2020-01-06,3호선,잠원,7289,7111,14400
238,2020-01-06,3호선,고속터미널,54701,51591,106292
239,2020-01-06,3호선,교대,17323,11352,28675
240,2020-01-06,3호선,남부터미널,35316,35716,71032
241,2020-01-06,3호선,양재,45889,49667,95556
242,2020-01-06,3호선,매봉,13919,13205,27124
243,2020-01-06,3호선,도곡,6562,6613,13175
244,2020-01-06,3호선,대치,14193,13984,28177
245,2020-01-06,3호선,학여울,2108,2149,4257
246,2020-01-06,3호선,대청,11506,10390,21896
247,2020-01-06,3호선,일원,11826,12177,24003
248,2020-01-06,3호선,수서,19558,19935,39493
249,2020-01-06,3호선,가락시장,11243,10904,22147
250,2020-01-06,3호선,경찰병원,9636,9726,19362
251,2020-01-06,3호선,오금,7551,6602,14153
252,2020-01-06,3호선,원흥,10239,9599,19838
253,2020-01-06,3호선,삼송,20043,19100,39143
254,2020-01-06,3호선,원당,12447,11668,24115
255,2020-01-06,3호선,화정,20864,21720,42584
256,2020-01-06,3호선,대곡,1805,1242,3047
257,2020-01-06,3호선,백석,11992,12200,24192
258,2020-01-06,3호선,마두,9232,9668,18900
259,2020-01-06,3호선,정발산,8566,8759,17325
260,2020-01-06,3호선,주엽,11119,11281,22400
261,2020-01-06,3호선,대화,16544,12766,29310
262,2020-01-07,3호선,지축,1930,2058,3988
263,2020-01-07,3호선,구파발,23350,21562,44912
264,2020-01-07,3호선,연신내,42117,40569,82686
265,2020-01-07,3호선,불광,18006,19458,37464
266,2020-01-07,3호선,녹번,15209,13758,28967
267,2020-01-07,3호선,홍제,19371,18398,37769
268,2020-01-07,3호선,무악재,4332,4610,8942
269,2020-01-07,3호선,독립문,7635,7794,15429
270,2020-01-07,3호선,경복궁,22466,21742,44208
271,2020-01-07,3호선,안국,25352,25711,51063
272,2020-01-07,3호선,종로3가,12433,14350,26783
273,2020-01-07,3호선,을지로3가,13297,13699,26996
274,2020-01-07,3호선,충무로,2,0,2
275,2020-01-07,3호선,동대입구,10794,11392,22186
276,2020-01-07,3호선,약수,15128,14670,29798
277,2020-01-07,3호선,금호,9108,8604,17712
278,2020-01-07,3호선,옥수,10258,10704,20962
279,2020-01-07,3호선,압구정,38236,41272,79508
280,2020-01-07,3호선,신사,35580,37931,73511
281,2020-01-07,3호선,잠원,7098,6964,14062
282,2020-01-07,3호선,고속터미널,52659,50550,103209
283,2020-01-07,3호선,교대,17132,10965,28097
284,2020-01-07,3호선,남부터미널,34322,34670,68992
285,2020-01-07,3호선,양재,46677,50246,96923
286,2020-01-07,3호선,매봉,13551,13028,26579
287,2020-01-07,3호선,도곡,6692,6590,13282
288,2020-01-07,3호선,대치,14257,13910,28167
289,2020-01-07,3호선,학여울,2007,2075,4082
290,2020-01-07,3호선,대청,11460,10416,21876
291,2020-01-07,3호선,일원,12060,12261,24321
292,2020-01-07,3호선,수서,19280,19378,38658
293,2020-01-07,3호선,가락시장,10844,10490,21334
294,2020-01-07,3호선,경찰병원,9463,9363,18826
295,2020-01-07,3호선,오금,7354,6549,13903
296,2020-01-07,3호선,원흥,9750,9214,18964
297,2020-01-07,3호선,삼송,19182,18190,37372
298,2020-01-07,3호선,원당,11920,11301,23221
299,2020-01-07,3호선,화정,19643,20606,40249
300,2020-01-07,3호선,대곡,1710,1170,2880
301,2020-01-07,3호선,백석,11610,11553,23163
302,2020-01-07,3호선,마두,8905,9264,18169
303,2020-01-07,3호선,정발산,8074,8373,16447
304,2020-01-07,3호선,주엽,10531,10873,21404
305,2020-01-07,3호선,대화,16153,12666,28819
306,2020-01-08,3호선,지축,2189,2218,4407
307,2020-01-08,3호선,구파발,24588,22740,47328
308,2020-01-08,3호선,연신내,44828,42768,87596
309,2020-01-08,3호선,불광,19142,20539,39681
310,2020-01-08,3호선,녹번,15915,14205,30120
311,2020-01-08,3호선,홍제,20469,19369,39838
312,2020-01-08,3호선,무악재,4634,4578,9212
313,2020-01-08,3호선,독립문,8247,8527,16774
314,2020-01-08,3호선,경복궁,23939,24334,48273
315,2020-01-08,3호선,안국,26412,27881,54293
316,2020-01-08,3호선,종로3가,12523,14895,27418
317,2020-01-08,3호선,을지로3가,13726,14233,27959
318,2020-01-08,3호선,충무로,4,0,4
319,2020-01-08,3호선,동대입구,10803,11427,22230
320,2020-01-08,3호선,약수,15482,14999,30481
321,2020-01-08,3호선,금호,9660,8856,18516
322,2020-01-08,3호선,옥수,10708,11033,21741
323,2020-01-08,3호선,압구정,38850,42043,80893
324,2020-01-08,3호선,신사,36436,38931,75367
325,2020-01-08,3호선,잠원,7214,7022,14236
326,2020-01-08,3호선,고속터미널,53961,51851,105812
327,2020-01-08,3호선,교대,18017,11536,29553
328,2020-01-08,3호선,남부터미널,35635,35815,71450
329,2020-01-08,3호선,양재,48325,52303,100628
330,2020-01-08,3호선,매봉,14099,13447,27546
331,2020-01-08,3호선,도곡,6683,6653,13336
332,2020-01-08,3호선,대치,14483,14199,28682
333,2020-01-08,3호선,학여울,2147,2179,4326
334,2020-01-08,3호선,대청,11961,10738,22699
335,2020-01-08,3호선,일원,12448,12584,25032
336,2020-01-08,3호선,수서,20017,20051,40068
337,2020-01-08,3호선,가락시장,11433,11096,22529
338,2020-01-08,3호선,경찰병원,9351,9438,18789
339,2020-01-08,3호선,오금,7762,6952,14714
340,2020-01-08,3호선,원흥,10351,9632,19983
341,2020-01-08,3호선,삼송,19850,18978,38828
342,2020-01-08,3호선,원당,12575,12088,24663
343,2020-01-08,3호선,화정,21290,22015,43305
344,2020-01-08,3호선,대곡,1794,1315,3109
345,2020-01-08,3호선,백석,11888,11808,23696
346,2020-01-08,3호선,마두,9804,10157,19961
347,2020-01-08,3호선,정발산,8799,9185,17984
348,2020-01-08,3호선,주엽,10953,11301,22254
349,2020-01-08,3호선,대화,16941,12962,29903
350,2020-01-09,3호선,지축,2187,2266,4453
351,2020-01-09,3호선,구파발,25276,23530,48806
352,2020-01-09,3호선,연신내,45242,43232,88474
353,2020-01-09,3호선,불광,19548,21038,40586
354,2020-01-09,3호선,녹번,16023,14191,30214
355,2020-01-09,3호선,홍제,20698,19558,40256
356,2020-01-09,3호선,무악재,4658,4724,9382
357,2020-01-09,3호선,독립문,8309,8635,16944
358,2020-01-09,3호선,경복궁,24899,24889,49788
359,2020-01-09,3호선,안국,26951,28539,55490
360,2020-01-09,3호선,종로3가,12892,15417,28309
361,2020-01-09,3호선,을지로3가,13777,14150,27927
362,2020-01-09,3호선,동대입구,11380,12329,23709
363,2020-01-09,3호선,약수,15812,15479,31291
364,2020-01-09,3호선,금호,9673,8917,18590
365,2020-01-09,3호선,옥수,10793,11080,21873
366,2020-01-09,3호선,압구정,39926,43481,83407
367,2020-01-09,3호선,신사,37854,40867,78721
368,2020-01-09,3호선,잠원,7182,6969,14151
369,2020-01-09,3호선,고속터미널,55859,54515,110374
370,2020-01-09,3호선,교대,18310,11708,30018
371,2020-01-09,3호선,남부터미널,36964,37342,74306
372,2020-01-09,3호선,양재,49007,52970,101977
373,2020-01-09,3호선,매봉,14072,13474,27546
374,2020-01-09,3호선,도곡,6745,6820,13565
375,2020-01-09,3호선,대치,14576,14119,28695
376,2020-01-09,3호선,학여울,2159,2200,4359
377,2020-01-09,3호선,대청,11697,10660,22357
378,2020-01-09,3호선,일원,12415,12329,24744
379,2020-01-09,3호선,수서,20551,20517,41068
380,2020-01-09,3호선,가락시장,11730,11413,23143
381,2020-01-09,3호선,경찰병원,9450,9432,18882
382,2020-01-09,3호선,오금,8072,7146,15218
383,2020-01-09,3호선,원흥,10472,9854,20326
384,2020-01-09,3호선,삼송,20250,19374,39624
385,2020-01-09,3호선,원당,13130,12392,25522
386,2020-01-09,3호선,화정,21394,21904,43298
387,2020-01-09,3호선,대곡,1810,1264,3074
388,2020-01-09,3호선,백석,12632,12788,25420
389,2020-01-09,3호선,마두,9701,10026,19727
390,2020-01-09,3호선,정발산,8945,9314,18259
391,2020-01-09,3호선,주엽,11019,11411,22430
392,2020-01-09,3호선,대화,17484,13567,31051
393,2020-01-10,3호선,지축,2237,2261,4498
394,2020-01-10,3호선,구파발,25440,23298,48738
395,2020-01-10,3호선,연신내,46987,45485,92472
396,2020-01-10,3호선,불광,20164,21572,41736
397,2020-01-10,3호선,녹번,16320,14325,30645
398,2020-01-10,3호선,홍제,21494,20062,41556
399,2020-01-10,3호선,무악재,4679,4720,9399
400,2020-01-10,3호선,독립문,8734,8875,17609
401,2020-01-10,3호선,경복궁,25844,26345,52189
402,2020-01-10,3호선,안국,27700,29247,56947
403,2020-01-10,3호선,종로3가,13205,16182,29387
404,2020-01-10,3호선,을지로3가,14135,14502,28637
405,2020-01-10,3호선,충무로,3,0,3
406,2020-01-10,3호선,동대입구,11484,12390,23874
407,2020-01-10,3호선,약수,16354,15615,31969
408,2020-01-10,3호선,금호,9930,9235,19165
409,2020-01-10,3호선,옥수,11283,11398,22681
410,2020-01-10,3호선,압구정,41781,45616,87397
411,2020-01-10,3호선,신사,39918,44161,84079
412,2020-01-10,3호선,잠원,7652,7177,14829
413,2020-01-10,3호선,고속터미널,65813,66587,132400
414,2020-01-10,3호선,교대,18792,11979,30771
415,2020-01-10,3호선,남부터미널,40827,40226,81053
416,2020-01-10,3호선,양재,51602,53686,105288
417,2020-01-10,3호선,매봉,14175,13630,27805
418,2020-01-10,3호선,도곡,7044,6988,14032
419,2020-01-10,3호선,대치,15091,14741,29832
420,2020-01-10,3호선,학여울,2927,2935,5862
421,2020-01-10,3호선,대청,11884,10700,22584
422,2020-01-10,3호선,일원,12083,11884,23967
423,2020-01-10,3호선,수서,22940,21827,44767
424,2020-01-10,3호선,가락시장,12183,12185,24368
425,2020-01-10,3호선,경찰병원,9617,9555,19172
426,2020-01-10,3호선,오금,8278,7199,15477
427,2020-01-10,3호선,원흥,10806,9757,20563
428,2020-01-10,3호선,삼송,20824,19383,40207
429,2020-01-10,3호선,원당,13341,12582,25923
430,2020-01-10,3호선,화정,22163,22934,45097
431,2020-01-10,3호선,대곡,1877,1352,3229
432,2020-01-10,3호선,백석,12847,13107,25954
433,2020-01-10,3호선,마두,9999,10301,20300
434,2020-01-10,3호선,정발산,9541,10420,19961
435,2020-01-10,3호선,주엽,11542,11730,23272
436,2020-01-10,3호선,대화,17488,13543,31031
437,2020-01-11,3호선,지축,1565,1681,3246
438,2020-01-11,3호선,구파발,19056,18379,37435
439,2020-01-11,3호선,연신내,38171,36184,74355
440,2020-01-11,3호선,불광,15964,18206,34170
441,2020-01-11,3호선,녹번,11627,10073,21700
442,2020-01-11,3호선,홍제,16755,16081,32836
443,2020-01-11,3호선,무악재,3362,3527,6889
444,2020-01-11,3호선,독립문,7761,8027,15788
445,2020-01-11,3호선,경복궁,27756,26755,54511
446,2020-01-11,3호선,안국,22094,23885,45979
447,2020-01-11,3호선,종로3가,9055,13456,22511
448,2020-01-11,3호선,을지로3가,7276,8027,15303
449,2020-01-11,3호선,충무로,2,0,2
450,2020-01-11,3호선,동대입구,10190,11441,21631
451,2020-01-11,3호선,약수,11546,10660,22206
452,2020-01-11,3호선,금호,7486,6648,14134
453,2020-01-11,3호선,옥수,8407,8588,16995
454,2020-01-11,3호선,압구정,32258,34679,66937
455,2020-01-11,3호선,신사,33286,35882,69168
456,2020-01-11,3호선,잠원,5108,4867,9975
457,2020-01-11,3호선,고속터미널,74941,74985,149926
458,2020-01-11,3호선,교대,9851,5848,15699
459,2020-01-11,3호선,남부터미널,32084,31125,63209
460,2020-01-11,3호선,양재,29816,31233,61049
461,2020-01-11,3호선,매봉,7252,6830,14082
462,2020-01-11,3호선,도곡,4434,4505,8939
463,2020-01-11,3호선,대치,11802,10609,22411
464,2020-01-11,3호선,학여울,2448,2501,4949
465,2020-01-11,3호선,대청,7591,6914,14505
466,2020-01-11,3호선,일원,6448,6548,12996
467,2020-01-11,3호선,수서,17036,16657,33693
468,2020-01-11,3호선,가락시장,8384,7948,16332
469,2020-01-11,3호선,경찰병원,5210,4987,10197
470,2020-01-11,3호선,오금,5098,4699,9797
471,2020-01-11,3호선,원흥,7407,6741,14148
472,2020-01-11,3호선,삼송,16211,15048,31259
473,2020-01-11,3호선,원당,10269,9538,19807
474,2020-01-11,3호선,화정,16942,17380,34322
475,2020-01-11,3호선,대곡,1442,1192,2634
476,2020-01-11,3호선,백석,10422,10445,20867
477,2020-01-11,3호선,마두,6846,6972,13818
478,2020-01-11,3호선,정발산,8673,9726,18399
479,2020-01-11,3호선,주엽,8830,8676,17506
480,2020-01-11,3호선,대화,12374,10534,22908
481,2020-01-12,3호선,지축,1142,1194,2336
482,2020-01-12,3호선,구파발,13937,13819,27756
483,2020-01-12,3호선,연신내,26954,25803,52757
484,2020-01-12,3호선,불광,11920,13714,25634
485,2020-01-12,3호선,녹번,7587,6764,14351
486,2020-01-12,3호선,홍제,11294,10993,22287
487,2020-01-12,3호선,무악재,2252,2498,4750
488,2020-01-12,3호선,독립문,5699,5847,11546
489,2020-01-12,3호선,경복궁,15312,15862,31174
490,2020-01-12,3호선,안국,14523,15009,29532
491,2020-01-12,3호선,종로3가,5364,7534,12898
492,2020-01-12,3호선,을지로3가,4877,4817,9694
493,2020-01-12,3호선,동대입구,7680,8675,16355
494,2020-01-12,3호선,약수,8573,8217,16790
495,2020-01-12,3호선,금호,5267,5068,10335
496,2020-01-12,3호선,옥수,5809,6320,12129
497,2020-01-12,3호선,압구정,18457,18800,37257
498,2020-01-12,3호선,신사,19599,19642,39241
499,2020-01-12,3호선,잠원,3229,3338,6567
500,2020-01-12,3호선,고속터미널,58310,57631,115941
501,2020-01-12,3호선,교대,5831,3406,9237
502,2020-01-12,3호선,남부터미널,20644,22176,42820
503,2020-01-12,3호선,양재,18870,20520,39390
504,2020-01-12,3호선,매봉,4619,4558,9177
505,2020-01-12,3호선,도곡,2463,2594,5057
506,2020-01-12,3호선,대치,7556,6887,14443
507,2020-01-12,3호선,학여울,1828,1975,3803
508,2020-01-12,3호선,대청,4957,4755,9712
509,2020-01-12,3호선,일원,4423,4706,9129
510,2020-01-12,3호선,수서,12318,12535,24853
511,2020-01-12,3호선,가락시장,4671,5035,9706
512,2020-01-12,3호선,경찰병원,3671,3727,7398
513,2020-01-12,3호선,오금,3510,3367,6877
514,2020-01-12,3호선,원흥,5251,5158,10409
515,2020-01-12,3호선,삼송,11963,11741,23704
516,2020-01-12,3호선,원당,7430,7414,14844
517,2020-01-12,3호선,화정,13402,13734,27136
518,2020-01-12,3호선,대곡,1015,831,1846
519,2020-01-12,3호선,백석,7591,7392,14983
520,2020-01-12,3호선,마두,4430,4482,8912
521,2020-01-12,3호선,정발산,7139,6940,14079
522,2020-01-12,3호선,주엽,5758,5912,11670
523,2020-01-12,3호선,대화,8906,8017,16923
524,2020-01-13,3호선,지축,2224,2274,4498
525,2020-01-13,3호선,구파발,24645,22523,47168
526,2020-01-13,3호선,연신내,44370,42512,86882
527,2020-01-13,3호선,불광,19157,20578,39735
528,2020-01-13,3호선,녹번,15815,14054,29869
529,2020-01-13,3호선,홍제,20428,19286,39714
530,2020-01-13,3호선,무악재,4518,4563,9081
531,2020-01-13,3호선,독립문,8059,8193,16252
532,2020-01-13,3호선,경복궁,24252,24388,48640
533,2020-01-13,3호선,안국,26343,27157,53500
534,2020-01-13,3호선,종로3가,12632,15021,27653
535,2020-01-13,3호선,을지로3가,13555,14056,27611
536,2020-01-13,3호선,충무로,1,0,1
537,2020-01-13,3호선,동대입구,10194,10989,21183
538,2020-01-13,3호선,약수,15388,15087,30475
539,2020-01-13,3호선,금호,9458,8786,18244
540,2020-01-13,3호선,옥수,10753,11107,21860
541,2020-01-13,3호선,압구정,39255,42799,82054
542,2020-01-13,3호선,신사,37213,39404,76617
543,2020-01-13,3호선,잠원,7191,6865,14056
544,2020-01-13,3호선,고속터미널,55448,53223,108671
545,2020-01-13,3호선,교대,17944,11700,29644
546,2020-01-13,3호선,남부터미널,35653,36116,71769
547,2020-01-13,3호선,양재,46691,51221,97912
548,2020-01-13,3호선,매봉,13995,13292,27287
549,2020-01-13,3호선,도곡,6653,6714,13367
550,2020-01-13,3호선,대치,14653,14057,28710
551,2020-01-13,3호선,학여울,2137,2201,4338
552,2020-01-13,3호선,대청,11479,10393,21872
553,2020-01-13,3호선,일원,12290,12401,24691
554,2020-01-13,3호선,수서,20025,20321,40346
555,2020-01-13,3호선,가락시장,11747,11463,23210
556,2020-01-13,3호선,경찰병원,9465,9432,18897
557,2020-01-13,3호선,오금,7543,6714,14257
558,2020-01-13,3호선,원흥,10346,9781,20127
559,2020-01-13,3호선,삼송,20035,19090,39125
560,2020-01-13,3호선,원당,12795,12213,25008
561,2020-01-13,3호선,화정,21255,21839,43094
562,2020-01-13,3호선,대곡,1860,1302,3162
563,2020-01-13,3호선,백석,12378,12368,24746
564,2020-01-13,3호선,마두,9392,9848,19240
565,2020-01-13,3호선,정발산,8619,8900,17519
566,2020-01-13,3호선,주엽,11197,11509,22706
567,2020-01-13,3호선,대화,17222,13259,30481
568,2020-01-14,3호선,대화,17007,13254,30261
569,2020-01-14,3호선,주엽,11153,11409,22562
570,2020-01-14,3호선,정발산,8631,9220,17851
571,2020-01-14,3호선,마두,9399,9831,19230
572,2020-01-14,3호선,백석,12450,12375,24825
573,2020-01-14,3호선,대곡,1896,1319,3215
574,2020-01-14,3호선,화정,21549,22243,43792
575,2020-01-14,3호선,원당,13049,12349,25398
576,2020-01-14,3호선,삼송,20018,19272,39290
577,2020-01-14,3호선,원흥,10407,9745,20152
578,2020-01-14,3호선,오금,7804,6935,14739
579,2020-01-14,3호선,경찰병원,9421,9516,18937
580,2020-01-14,3호선,가락시장,11905,11573,23478
581,2020-01-14,3호선,수서,20276,20227,40503
582,2020-01-14,3호선,일원,12387,12365,24752
583,2020-01-14,3호선,대청,11580,10541,22121
584,2020-01-14,3호선,학여울,2294,2360,4654
585,2020-01-14,3호선,대치,14688,14261,28949
586,2020-01-14,3호선,도곡,6730,6775,13505
587,2020-01-14,3호선,매봉,14225,13578,27803
588,2020-01-14,3호선,양재,48868,52556,101424
589,2020-01-14,3호선,남부터미널,37083,37468,74551
590,2020-01-14,3호선,교대,18617,11916,30533
591,2020-01-14,3호선,고속터미널,55611,53555,109166
592,2020-01-14,3호선,잠원,7295,7080,14375
593,2020-01-14,3호선,신사,37687,40245,77932
594,2020-01-14,3호선,압구정,39632,42935,82567
595,2020-01-14,3호선,옥수,10849,11219,22068
596,2020-01-14,3호선,금호,9530,8797,18327
597,2020-01-14,3호선,약수,15622,15363,30985
598,2020-01-14,3호선,동대입구,10899,11768,22667
599,2020-01-14,3호선,충무로,2,0,2
600,2020-01-14,3호선,을지로3가,13594,13981,27575
601,2020-01-14,3호선,종로3가,12877,15095,27972
602,2020-01-14,3호선,안국,27153,28268,55421
603,2020-01-14,3호선,경복궁,23318,23212,46530
604,2020-01-14,3호선,독립문,8748,8920,17668
605,2020-01-14,3호선,무악재,4619,4670,9289
606,2020-01-14,3호선,홍제,20339,19430,39769
607,2020-01-14,3호선,녹번,15912,14121,30033
608,2020-01-14,3호선,불광,19384,21004,40388
609,2020-01-14,3호선,연신내,44547,42434,86981
610,2020-01-14,3호선,구파발,24764,22889,47653
611,2020-01-14,3호선,지축,2317,2364,4681
612,2020-01-15,3호선,지축,2265,2341,4606
613,2020-01-15,3호선,구파발,25053,23113,48166
614,2020-01-15,3호선,연신내,45300,43279,88579
615,2020-01-15,3호선,불광,19511,20987,40498
616,2020-01-15,3호선,녹번,16140,14191,30331
617,2020-01-15,3호선,홍제,20505,19572,40077
618,2020-01-15,3호선,무악재,4638,4619,9257
619,2020-01-15,3호선,독립문,8585,8956,17541
620,2020-01-15,3호선,경복궁,25642,25822,51464
621,2020-01-15,3호선,안국,27423,28701,56124
622,2020-01-15,3호선,종로3가,13160,15591,28751
623,2020-01-15,3호선,을지로3가,13793,14270,28063
624,2020-01-15,3호선,동대입구,10782,11616,22398
625,2020-01-15,3호선,약수,15673,15034,30707
626,2020-01-15,3호선,금호,9848,9161,19009
627,2020-01-15,3호선,옥수,10818,11010,21828
628,2020-01-15,3호선,압구정,39837,43386,83223
629,2020-01-15,3호선,신사,37879,40447,78326
630,2020-01-15,3호선,잠원,7315,7105,14420
631,2020-01-15,3호선,고속터미널,55935,54187,110122
632,2020-01-15,3호선,교대,18711,12027,30738
633,2020-01-15,3호선,남부터미널,37812,38197,76009
634,2020-01-15,3호선,양재,48614,52301,100915
635,2020-01-15,3호선,매봉,14212,13532,27744
636,2020-01-15,3호선,도곡,6788,6912,13700
637,2020-01-15,3호선,대치,14474,14171,28645
638,2020-01-15,3호선,학여울,2349,2488,4837
639,2020-01-15,3호선,대청,11675,10543,22218
640,2020-01-15,3호선,일원,12133,12184,24317
641,2020-01-15,3호선,수서,20226,19985,40211
642,2020-01-15,3호선,가락시장,11999,11758,23757
643,2020-01-15,3호선,경찰병원,9596,9556,19152
644,2020-01-15,3호선,오금,7696,6889,14585
645,2020-01-15,3호선,원흥,10454,9747,20201
646,2020-01-15,3호선,삼송,20377,19370,39747
647,2020-01-15,3호선,원당,12832,12224,25056
648,2020-01-15,3호선,화정,22030,22749,44779
649,2020-01-15,3호선,대곡,1854,1333,3187
650,2020-01-15,3호선,백석,12435,12472,24907
651,2020-01-15,3호선,마두,9769,10110,19879
652,2020-01-15,3호선,정발산,8862,9253,18115
653,2020-01-15,3호선,주엽,11145,11519,22664
654,2020-01-15,3호선,대화,17122,13268,30390
655,2020-01-16,3호선,대화,17270,13372,30642
656,2020-01-16,3호선,주엽,11200,11449,22649
657,2020-01-16,3호선,정발산,8869,9244,18113
658,2020-01-16,3호선,마두,9838,10229,20067
659,2020-01-16,3호선,백석,12708,12508,25216
660,2020-01-16,3호선,대곡,1841,1366,3207
661,2020-01-16,3호선,화정,21144,22066,43210
662,2020-01-16,3호선,원당,12978,12337,25315
663,2020-01-16,3호선,삼송,20428,19476,39904
664,2020-01-16,3호선,원흥,10770,9972,20742
665,2020-01-16,3호선,오금,7833,6876,14709
666,2020-01-16,3호선,경찰병원,9711,9622,19333
667,2020-01-16,3호선,가락시장,12059,11783,23842
668,2020-01-16,3호선,수서,20358,20366,40724
669,2020-01-16,3호선,일원,12490,12314,24804
670,2020-01-16,3호선,대청,12165,11009,23174
671,2020-01-16,3호선,학여울,2838,2867,5705
672,2020-01-16,3호선,대치,14674,14410,29084
673,2020-01-16,3호선,도곡,6729,6710,13439
674,2020-01-16,3호선,매봉,14264,13687,27951
675,2020-01-16,3호선,양재,49622,54147,103769
676,2020-01-16,3호선,남부터미널,37909,38385,76294
677,2020-01-16,3호선,교대,19043,11999,31042
678,2020-01-16,3호선,고속터미널,57267,54944,112211
679,2020-01-16,3호선,잠원,7347,7042,14389
680,2020-01-16,3호선,신사,38552,41525,80077
681,2020-01-16,3호선,압구정,39919,43534,83453
682,2020-01-16,3호선,옥수,11053,11341,22394
683,2020-01-16,3호선,금호,9767,9040,18807
684,2020-01-16,3호선,약수,15809,15093,30902
685,2020-01-16,3호선,동대입구,13707,15178,28885
686,2020-01-16,3호선,충무로,3,0,3
687,2020-01-16,3호선,을지로3가,13584,14339,27923
688,2020-01-16,3호선,종로3가,13422,15826,29248
689,2020-01-16,3호선,안국,27222,29021,56243
690,2020-01-16,3호선,경복궁,25324,25442,50766
691,2020-01-16,3호선,독립문,8555,8833,17388
692,2020-01-16,3호선,무악재,4683,4645,9328
693,2020-01-16,3호선,홍제,20324,19195,39519
694,2020-01-16,3호선,녹번,16304,14242,30546
695,2020-01-16,3호선,불광,19346,21121,40467
696,2020-01-16,3호선,연신내,45344,43393,88737
697,2020-01-16,3호선,구파발,24815,22845,47660
698,2020-01-16,3호선,지축,2366,2362,4728
699,2020-01-17,3호선,지축,2432,2384,4816
700,2020-01-17,3호선,구파발,25481,23260,48741
701,2020-01-17,3호선,연신내,46920,44864,91784
702,2020-01-17,3호선,불광,20079,21673,41752
703,2020-01-17,3호선,녹번,16589,14249,30838
704,2020-01-17,3호선,홍제,21296,19760,41056
705,2020-01-17,3호선,무악재,4758,4736,9494
706,2020-01-17,3호선,독립문,8821,8939,17760
707,2020-01-17,3호선,경복궁,26220,26475,52695
708,2020-01-17,3호선,안국,28013,29364,57377
709,2020-01-17,3호선,종로3가,13687,16962,30649
710,2020-01-17,3호선,을지로3가,14009,15080,29089
711,2020-01-17,3호선,충무로,2,0,2
712,2020-01-17,3호선,동대입구,10907,11894,22801
713,2020-01-17,3호선,약수,16467,15907,32374
714,2020-01-17,3호선,금호,10357,9548,19905
715,2020-01-17,3호선,옥수,11384,11527,22911
716,2020-01-17,3호선,압구정,42755,46843,89598
717,2020-01-17,3호선,신사,41071,45464,86535
718,2020-01-17,3호선,잠원,7771,7364,15135
719,2020-01-17,3호선,고속터미널,66462,65405,131867
720,2020-01-17,3호선,교대,19706,12821,32527
721,2020-01-17,3호선,남부터미널,42638,41629,84267
722,2020-01-17,3호선,양재,52607,55071,107678
723,2020-01-17,3호선,매봉,14028,13507,27535
724,2020-01-17,3호선,도곡,6787,7109,13896
725,2020-01-17,3호선,대치,15011,14517,29528
726,2020-01-17,3호선,학여울,2762,2884,5646
727,2020-01-17,3호선,대청,11815,10793,22608
728,2020-01-17,3호선,일원,12191,11636,23827
729,2020-01-17,3호선,수서,22789,21931,44720
730,2020-01-17,3호선,가락시장,12609,12490,25099
731,2020-01-17,3호선,경찰병원,9966,9819,19785
732,2020-01-17,3호선,오금,7861,6894,14755
733,2020-01-17,3호선,원흥,10856,9903,20759
734,2020-01-17,3호선,삼송,21038,19612,40650
735,2020-01-17,3호선,원당,13363,12574,25937
736,2020-01-17,3호선,화정,22046,22842,44888
737,2020-01-17,3호선,대곡,1838,1377,3215
738,2020-01-17,3호선,백석,13006,13089,26095
739,2020-01-17,3호선,마두,10009,10336,20345
740,2020-01-17,3호선,정발산,9611,10537,20148
741,2020-01-17,3호선,주엽,11475,11843,23318
742,2020-01-17,3호선,대화,17667,13585,31252
743,2020-01-18,3호선,지축,1705,1735,3440
744,2020-01-18,3호선,구파발,18435,18132,36567
745,2020-01-18,3호선,연신내,37597,35534,73131
746,2020-01-18,3호선,불광,16189,18492,34681
747,2020-01-18,3호선,녹번,11619,9760,21379
748,2020-01-18,3호선,홍제,16703,15807,32510
749,2020-01-18,3호선,무악재,3349,3462,6811
750,2020-01-18,3호선,독립문,7779,8211,15990
751,2020-01-18,3호선,경복궁,25236,23868,49104
752,2020-01-18,3호선,안국,22907,24476,47383
753,2020-01-18,3호선,종로3가,9037,13111,22148
754,2020-01-18,3호선,을지로3가,7516,8185,15701
755,2020-01-18,3호선,충무로,1,0,1
756,2020-01-18,3호선,동대입구,9013,10311,19324
757,2020-01-18,3호선,약수,11699,11029,22728
758,2020-01-18,3호선,금호,7298,6651,13949
759,2020-01-18,3호선,옥수,8624,8595,17219
760,2020-01-18,3호선,압구정,32502,34824,67326
761,2020-01-18,3호선,신사,32899,35561,68460
762,2020-01-18,3호선,잠원,5118,4896,10014
763,2020-01-18,3호선,고속터미널,73140,71346,144486
764,2020-01-18,3호선,교대,9842,5758,15600
765,2020-01-18,3호선,남부터미널,33497,32652,66149
766,2020-01-18,3호선,양재,28382,30057,58439
767,2020-01-18,3호선,매봉,7220,6778,13998
768,2020-01-18,3호선,도곡,4944,4934,9878
769,2020-01-18,3호선,대치,11839,10564,22403
770,2020-01-18,3호선,학여울,2051,2032,4083
771,2020-01-18,3호선,대청,7833,6966,14799
772,2020-01-18,3호선,일원,6620,6634,13254
773,2020-01-18,3호선,수서,16938,17047,33985
774,2020-01-18,3호선,가락시장,8459,8208,16667
775,2020-01-18,3호선,경찰병원,5365,5267,10632
776,2020-01-18,3호선,오금,4991,4491,9482
777,2020-01-18,3호선,원흥,7479,6915,14394
778,2020-01-18,3호선,삼송,16508,15296,31804
779,2020-01-18,3호선,원당,10401,9693,20094
780,2020-01-18,3호선,화정,16736,17440,34176
781,2020-01-18,3호선,대곡,1486,1267,2753
782,2020-01-18,3호선,백석,9918,10012,19930
783,2020-01-18,3호선,마두,6844,6738,13582
784,2020-01-18,3호선,정발산,8421,9358,17779
785,2020-01-18,3호선,주엽,8510,8424,16934
786,2020-01-18,3호선,대화,12280,10436,22716
787,2020-01-19,3호선,약수,8495,7827,16322
788,2020-01-19,3호선,지축,1272,1285,2557
789,2020-01-19,3호선,구파발,13655,13920,27575
790,2020-01-19,3호선,연신내,26659,25087,51746
791,2020-01-19,3호선,불광,11576,13258,24834
792,2020-01-19,3호선,녹번,7772,6818,14590
793,2020-01-19,3호선,홍제,11204,10764,21968
794,2020-01-19,3호선,무악재,2175,2357,4532
795,2020-01-19,3호선,독립문,5664,6024,11688
796,2020-01-19,3호선,경복궁,14083,14376,28459
797,2020-01-19,3호선,안국,13206,13853,27059
798,2020-01-19,3호선,종로3가,5162,7119,12281
799,2020-01-19,3호선,을지로3가,4590,4679,9269
800,2020-01-19,3호선,동대입구,8943,9854,18797
801,2020-01-19,3호선,금호,5240,4947,10187
802,2020-01-19,3호선,옥수,5666,6114,11780
803,2020-01-19,3호선,압구정,18860,19506,38366
804,2020-01-19,3호선,신사,18761,18912,37673
805,2020-01-19,3호선,잠원,3230,3394,6624
806,2020-01-19,3호선,고속터미널,53784,54963,108747
807,2020-01-19,3호선,교대,5522,3373,8895
808,2020-01-19,3호선,남부터미널,20745,22364,43109
809,2020-01-19,3호선,양재,18752,21019,39771
810,2020-01-19,3호선,매봉,4554,4490,9044
811,2020-01-19,3호선,도곡,2638,2770,5408
812,2020-01-19,3호선,대치,7464,6697,14161
813,2020-01-19,3호선,학여울,1203,1265,2468
814,2020-01-19,3호선,대청,4943,4838,9781
815,2020-01-19,3호선,일원,4418,4700,9118
816,2020-01-19,3호선,수서,12165,12370,24535
817,2020-01-19,3호선,가락시장,5367,5406,10773
818,2020-01-19,3호선,경찰병원,3662,3811,7473
819,2020-01-19,3호선,오금,3586,3367,6953
820,2020-01-19,3호선,원흥,5390,5125,10515
821,2020-01-19,3호선,삼송,11901,11801,23702
822,2020-01-19,3호선,원당,7302,7263,14565
823,2020-01-19,3호선,화정,13501,13804,27305
824,2020-01-19,3호선,대곡,1053,793,1846
825,2020-01-19,3호선,백석,7503,7380,14883
826,2020-01-19,3호선,마두,4508,4524,9032
827,2020-01-19,3호선,정발산,6900,6802,13702
828,2020-01-19,3호선,주엽,5673,5739,11412
829,2020-01-19,3호선,대화,9259,8288,17547
830,2020-01-20,3호선,대화,17303,13233,30536
831,2020-01-20,3호선,주엽,11403,11700,23103
832,2020-01-20,3호선,정발산,8839,9094,17933
833,2020-01-20,3호선,마두,9618,9929,19547
834,2020-01-20,3호선,백석,12452,12603,25055
835,2020-01-20,3호선,대곡,1879,1363,3242
836,2020-01-20,3호선,화정,21408,22000,43408
837,2020-01-20,3호선,원당,12908,12265,25173
838,2020-01-20,3호선,삼송,20574,19610,40184
839,2020-01-20,3호선,원흥,10694,9977,20671
840,2020-01-20,3호선,오금,7715,6749,14464
841,2020-01-20,3호선,경찰병원,9762,9767,19529
842,2020-01-20,3호선,가락시장,12229,11898,24127
843,2020-01-20,3호선,수서,20134,20743,40877
844,2020-01-20,3호선,일원,12021,11965,23986
845,2020-01-20,3호선,대청,11790,10757,22547
846,2020-01-20,3호선,학여울,2164,2206,4370
847,2020-01-20,3호선,대치,14690,14316,29006
848,2020-01-20,3호선,도곡,6742,6847,13589
849,2020-01-20,3호선,매봉,14225,13656,27881
850,2020-01-20,3호선,양재,47763,52309,100072
851,2020-01-20,3호선,남부터미널,36377,37260,73637
852,2020-01-20,3호선,교대,18023,11678,29701
853,2020-01-20,3호선,고속터미널,55697,54306,110003
854,2020-01-20,3호선,잠원,7405,7145,14550
855,2020-01-20,3호선,신사,37567,40006,77573
856,2020-01-20,3호선,압구정,39987,43316,83303
857,2020-01-20,3호선,옥수,10672,11035,21707
858,2020-01-20,3호선,금호,9652,9070,18722
859,2020-01-20,3호선,약수,15747,15240,30987
860,2020-01-20,3호선,동대입구,9902,10763,20665
861,2020-01-20,3호선,충무로,3,0,3
862,2020-01-20,3호선,을지로3가,13449,14030,27479
863,2020-01-20,3호선,종로3가,13071,15507,28578
864,2020-01-20,3호선,안국,26372,27326,53698
865,2020-01-20,3호선,경복궁,24136,24660,48796
866,2020-01-20,3호선,독립문,7995,8214,16209
867,2020-01-20,3호선,무악재,4624,4617,9241
868,2020-01-20,3호선,홍제,20523,19480,40003
869,2020-01-20,3호선,녹번,16112,14203,30315
870,2020-01-20,3호선,불광,19161,20829,39990
871,2020-01-20,3호선,연신내,45052,42852,87904
872,2020-01-20,3호선,구파발,25054,22853,47907
873,2020-01-20,3호선,지축,2378,2450,4828
874,2020-01-21,3호선,지축,2395,2393,4788
875,2020-01-21,3호선,구파발,25272,23095,48367
876,2020-01-21,3호선,연신내,45627,43517,89144
877,2020-01-21,3호선,불광,20057,21820,41877
878,2020-01-21,3호선,녹번,16152,15145,31297
879,2020-01-21,3호선,홍제,20521,19640,40161
880,2020-01-21,3호선,무악재,4603,4596,9199
881,2020-01-21,3호선,독립문,8610,8726,17336
882,2020-01-21,3호선,경복궁,23512,23205,46717
883,2020-01-21,3호선,안국,26795,27820,54615
884,2020-01-21,3호선,종로3가,13284,15540,28824
885,2020-01-21,3호선,을지로3가,13390,13898,27288
886,2020-01-21,3호선,충무로,2,0,2
887,2020-01-21,3호선,동대입구,11198,11620,22818
888,2020-01-21,3호선,약수,15795,15488,31283
889,2020-01-21,3호선,금호,9829,8971,18800
890,2020-01-21,3호선,옥수,10825,11116,21941
891,2020-01-21,3호선,압구정,40551,43660,84211
892,2020-01-21,3호선,신사,38189,40733,78922
893,2020-01-21,3호선,잠원,7424,7097,14521
894,2020-01-21,3호선,고속터미널,55817,57254,113071
895,2020-01-21,3호선,교대,18789,11685,30474
896,2020-01-21,3호선,남부터미널,37479,38891,76370
897,2020-01-21,3호선,양재,48800,52381,101181
898,2020-01-21,3호선,매봉,14364,13782,28146
899,2020-01-21,3호선,도곡,6767,6777,13544
900,2020-01-21,3호선,대치,15111,14682,29793
901,2020-01-21,3호선,학여울,2148,2120,4268
902,2020-01-21,3호선,대청,11918,10903,22821
903,2020-01-21,3호선,일원,12360,12113,24473
904,2020-01-21,3호선,수서,20129,20299,40428
905,2020-01-21,3호선,가락시장,12308,12375,24683
906,2020-01-21,3호선,경찰병원,9346,9319,18665
907,2020-01-21,3호선,오금,7735,6801,14536
908,2020-01-21,3호선,원흥,10377,9631,20008
909,2020-01-21,3호선,삼송,20198,19602,39800
910,2020-01-21,3호선,원당,12961,12248,25209
911,2020-01-21,3호선,화정,21329,22097,43426
912,2020-01-21,3호선,대곡,1911,1333,3244
913,2020-01-21,3호선,백석,12574,12627,25201
914,2020-01-21,3호선,마두,9222,9576,18798
915,2020-01-21,3호선,정발산,8924,9270,18194
916,2020-01-21,3호선,주엽,11217,11540,22757
917,2020-01-21,3호선,대화,16665,12892,29557
918,2020-01-22,3호선,지축,2408,2411,4819
919,2020-01-22,3호선,구파발,24808,22571,47379
920,2020-01-22,3호선,연신내,46047,43633,89680
921,2020-01-22,3호선,불광,19646,21194,40840
922,2020-01-22,3호선,녹번,16096,14123,30219
923,2020-01-22,3호선,홍제,20944,19383,40327
924,2020-01-22,3호선,무악재,4590,4574,9164
925,2020-01-22,3호선,독립문,8661,8708,17369
926,2020-01-22,3호선,경복궁,24769,24470,49239
927,2020-01-22,3호선,안국,25829,26703,52532
928,2020-01-22,3호선,종로3가,12861,15242,28103
929,2020-01-22,3호선,을지로3가,13468,13965,27433
930,2020-01-22,3호선,충무로,3,0,3
931,2020-01-22,3호선,동대입구,9635,10202,19837
932,2020-01-22,3호선,약수,15850,15120,30970
933,2020-01-22,3호선,금호,9932,9100,19032
934,2020-01-22,3호선,옥수,10793,11025,21818
935,2020-01-22,3호선,압구정,40252,43283,83535
936,2020-01-22,3호선,신사,37663,40050,77713
937,2020-01-22,3호선,잠원,7315,7111,14426
938,2020-01-22,3호선,고속터미널,54285,64702,118987
939,2020-01-22,3호선,교대,18128,11604,29732
940,2020-01-22,3호선,남부터미널,37820,41117,78937
941,2020-01-22,3호선,양재,47858,51511,99369
942,2020-01-22,3호선,매봉,13920,13201,27121
943,2020-01-22,3호선,도곡,6533,6486,13019
944,2020-01-22,3호선,대치,14625,14148,28773
945,2020-01-22,3호선,학여울,2061,2110,4171
946,2020-01-22,3호선,대청,11638,10433,22071
947,2020-01-22,3호선,일원,12032,11790,23822
948,2020-01-22,3호선,수서,19817,20513,40330
949,2020-01-22,3호선,가락시장,12355,12022,24377
950,2020-01-22,3호선,경찰병원,9458,9324,18782
951,2020-01-22,3호선,오금,7704,6760,14464
952,2020-01-22,3호선,원흥,10452,9428,19880
953,2020-01-22,3호선,삼송,20425,19369,39794
954,2020-01-22,3호선,원당,12839,12227,25066
955,2020-01-22,3호선,화정,21633,22529,44162
956,2020-01-22,3호선,대곡,1821,1330,3151
957,2020-01-22,3호선,백석,12328,12658,24986
958,2020-01-22,3호선,마두,9578,9860,19438
959,2020-01-22,3호선,정발산,8829,9201,18030
960,2020-01-22,3호선,주엽,11061,11284,22345
961,2020-01-22,3호선,대화,16833,12973,29806
962,2020-01-23,3호선,지축,2312,2240,4552
963,2020-01-23,3호선,구파발,23572,20982,44554
964,2020-01-23,3호선,연신내,44684,42443,87127
965,2020-01-23,3호선,불광,18803,20122,38925
966,2020-01-23,3호선,녹번,15293,12617,27910
967,2020-01-23,3호선,홍제,19753,18040,37793
968,2020-01-23,3호선,무악재,4399,4160,8559
969,2020-01-23,3호선,독립문,8192,7874,16066
970,2020-01-23,3호선,경복궁,22144,21259,43403
971,2020-01-23,3호선,안국,19832,20866,40698
972,2020-01-23,3호선,종로3가,11673,14468,26141
973,2020-01-23,3호선,을지로3가,12037,12441,24478
974,2020-01-23,3호선,충무로,3,0,3
975,2020-01-23,3호선,동대입구,8841,9238,18079
976,2020-01-23,3호선,약수,15027,13652,28679
977,2020-01-23,3호선,금호,9518,8406,17924
978,2020-01-23,3호선,옥수,10522,10456,20978
979,2020-01-23,3호선,압구정,37237,39778,77015
980,2020-01-23,3호선,신사,35753,38232,73985
981,2020-01-23,3호선,잠원,6783,6380,13163
982,2020-01-23,3호선,고속터미널,56454,96688,153142
983,2020-01-23,3호선,교대,15263,9687,24950
984,2020-01-23,3호선,남부터미널,36600,45800,82400
985,2020-01-23,3호선,양재,43985,44179,88164
986,2020-01-23,3호선,매봉,12572,11514,24086
987,2020-01-23,3호선,도곡,5942,6030,11972
988,2020-01-23,3호선,대치,14114,13519,27633
989,2020-01-23,3호선,학여울,1933,1886,3819
990,2020-01-23,3호선,대청,10920,9451,20371
991,2020-01-23,3호선,일원,11397,10802,22199
992,2020-01-23,3호선,수서,18874,20910,39784
993,2020-01-23,3호선,가락시장,11655,11321,22976
994,2020-01-23,3호선,경찰병원,8801,8278,17079
995,2020-01-23,3호선,오금,7149,5891,13040
996,2020-01-23,3호선,원흥,9850,8668,18518
997,2020-01-23,3호선,삼송,19854,18384,38238
998,2020-01-23,3호선,원당,12229,11515,23744
999,2020-01-23,3호선,화정,20184,21096,41280
1000,2020-01-23,3호선,대곡,1666,1235,2901
1001,2020-01-23,3호선,백석,12243,12635,24878
1002,2020-01-23,3호선,마두,9221,9462,18683
1003,2020-01-23,3호선,정발산,8836,9688,18524
1004,2020-01-23,3호선,주엽,10258,10373,20631
1005,2020-01-23,3호선,대화,15517,12067,27584
1006,2020-01-24,3호선,대화,6462,5730,12192
1007,2020-01-24,3호선,주엽,4078,4135,8213
1008,2020-01-24,3호선,정발산,4250,4330,8580
1009,2020-01-24,3호선,마두,3607,3549,7156
1010,2020-01-24,3호선,백석,5811,5935,11746
1011,2020-01-24,3호선,대곡,798,615,1413
1012,2020-01-24,3호선,화정,8665,9013,17678
1013,2020-01-24,3호선,원당,5712,5646,11358
1014,2020-01-24,3호선,삼송,10432,9989,20421
1015,2020-01-24,3호선,원흥,3942,3350,7292
1016,2020-01-24,3호선,오금,2615,1958,4573
1017,2020-01-24,3호선,경찰병원,2786,2294,5080
1018,2020-01-24,3호선,가락시장,4566,4160,8726
1019,2020-01-24,3호선,수서,8290,10985,19275
1020,2020-01-24,3호선,일원,2961,2786,5747
1021,2020-01-24,3호선,대청,3979,3083,7062
1022,2020-01-24,3호선,학여울,577,542,1119
1023,2020-01-24,3호선,대치,5428,4486,9914
1024,2020-01-24,3호선,도곡,1814,1659,3473
1025,2020-01-24,3호선,매봉,3188,2664,5852
1026,2020-01-24,3호선,양재,9425,9087,18512
1027,2020-01-24,3호선,남부터미널,15661,24268,39929
1028,2020-01-24,3호선,교대,3248,1749,4997
1029,2020-01-24,3호선,고속터미널,31403,65199,96602
1030,2020-01-24,3호선,잠원,2471,2181,4652
1031,2020-01-24,3호선,신사,12762,13077,25839
1032,2020-01-24,3호선,압구정,13710,13890,27600
1033,2020-01-24,3호선,옥수,4477,4111,8588
1034,2020-01-24,3호선,금호,4082,3506,7588
1035,2020-01-24,3호선,약수,5980,5048,11028
1036,2020-01-24,3호선,동대입구,4431,4768,9199
1037,2020-01-24,3호선,을지로3가,2634,2582,5216
1038,2020-01-24,3호선,종로3가,3477,5179,8656
1039,2020-01-24,3호선,안국,9525,9845,19370
1040,2020-01-24,3호선,경복궁,10654,11574,22228
1041,2020-01-24,3호선,독립문,3824,3493,7317
1042,2020-01-24,3호선,무악재,1788,1678,3466
1043,2020-01-24,3호선,홍제,8926,8069,16995
1044,2020-01-24,3호선,녹번,6188,4950,11138
1045,2020-01-24,3호선,불광,8706,9484,18190
1046,2020-01-24,3호선,연신내,22045,19669,41714
1047,2020-01-24,3호선,구파발,10691,10217,20908
1048,2020-01-24,3호선,지축,954,993,1947
1049,2020-01-25,3호선,지축,913,923,1836
1050,2020-01-25,3호선,구파발,9653,9332,18985
1051,2020-01-25,3호선,연신내,18520,18501,37021
1052,2020-01-25,3호선,불광,7104,7828,14932
1053,2020-01-25,3호선,녹번,5537,4879,10416
1054,2020-01-25,3호선,홍제,8213,7991,16204
1055,2020-01-25,3호선,무악재,1619,1694,3313
1056,2020-01-25,3호선,독립문,3058,3103,6161
1057,2020-01-25,3호선,경복궁,15808,18693,34501
1058,2020-01-25,3호선,안국,11877,11894,23771
1059,2020-01-25,3호선,종로3가,3084,5025,8109
1060,2020-01-25,3호선,을지로3가,2216,1967,4183
1061,2020-01-25,3호선,동대입구,5578,6737,12315
1062,2020-01-25,3호선,약수,5147,4907,10054
1063,2020-01-25,3호선,금호,3598,3497,7095
1064,2020-01-25,3호선,옥수,3612,3794,7406
1065,2020-01-25,3호선,압구정,5622,6060,11682
1066,2020-01-25,3호선,신사,6173,7244,13417
1067,2020-01-25,3호선,잠원,1732,1894,3626
1068,2020-01-25,3호선,고속터미널,32956,28370,61326
1069,2020-01-25,3호선,교대,1644,1079,2723
1070,2020-01-25,3호선,남부터미널,14255,12845,27100
1071,2020-01-25,3호선,양재,6568,7397,13965
1072,2020-01-25,3호선,매봉,2038,1998,4036
1073,2020-01-25,3호선,도곡,1119,1148,2267
1074,2020-01-25,3호선,대치,3212,3104,6316
1075,2020-01-25,3호선,학여울,476,478,954
1076,2020-01-25,3호선,대청,2945,2903,5848
1077,2020-01-25,3호선,일원,2409,2475,4884
1078,2020-01-25,3호선,수서,9477,8585,18062
1079,2020-01-25,3호선,가락시장,2659,2580,5239
1080,2020-01-25,3호선,경찰병원,2163,2161,4324
1081,2020-01-25,3호선,오금,1984,1928,3912
1082,2020-01-25,3호선,원흥,3103,2934,6037
1083,2020-01-25,3호선,삼송,9845,9280,19125
1084,2020-01-25,3호선,원당,5543,5259,10802
1085,2020-01-25,3호선,화정,6992,7569,14561
1086,2020-01-25,3호선,대곡,772,582,1354
1087,2020-01-25,3호선,백석,4697,4418,9115
1088,2020-01-25,3호선,마두,2630,2619,5249
1089,2020-01-25,3호선,정발산,3593,4027,7620
1090,2020-01-25,3호선,주엽,3462,3407,6869
1091,2020-01-25,3호선,대화,5720,5035,10755
1092,2020-01-26,3호선,지축,1055,1054,2109
1093,2020-01-26,3호선,구파발,11926,12295,24221
1094,2020-01-26,3호선,연신내,23242,23115,46357
1095,2020-01-26,3호선,불광,9872,11906,21778
1096,2020-01-26,3호선,녹번,6236,5793,12029
1097,2020-01-26,3호선,홍제,9329,9091,18420
1098,2020-01-26,3호선,무악재,1798,2069,3867
1099,2020-01-26,3호선,독립문,4464,4736,9200
1100,2020-01-26,3호선,경복궁,15254,18252,33506
1101,2020-01-26,3호선,안국,12795,13947,26742
1102,2020-01-26,3호선,종로3가,4105,6728,10833
1103,2020-01-26,3호선,을지로3가,3900,3704,7604
1104,2020-01-26,3호선,동대입구,6923,8773,15696
1105,2020-01-26,3호선,약수,6438,6579,13017
1106,2020-01-26,3호선,금호,4420,4305,8725
1107,2020-01-26,3호선,옥수,4640,5026,9666
1108,2020-01-26,3호선,압구정,10915,11770,22685
1109,2020-01-26,3호선,신사,12266,14135,26401
1110,2020-01-26,3호선,잠원,2525,2427,4952
1111,2020-01-26,3호선,고속터미널,59992,36321,96313
1112,2020-01-26,3호선,교대,3221,2119,5340
1113,2020-01-26,3호선,남부터미널,20628,14972,35600
1114,2020-01-26,3호선,양재,10575,12261,22836
1115,2020-01-26,3호선,매봉,3114,3176,6290
1116,2020-01-26,3호선,도곡,1731,1762,3493
1117,2020-01-26,3호선,대치,4473,4476,8949
1118,2020-01-26,3호선,학여울,589,646,1235
1119,2020-01-26,3호선,대청,3802,3830,7632
1120,2020-01-26,3호선,일원,3186,3325,6511
1121,2020-01-26,3호선,수서,11296,8210,19506
1122,2020-01-26,3호선,가락시장,3401,3482,6883
1123,2020-01-26,3호선,경찰병원,2602,2969,5571
1124,2020-01-26,3호선,오금,2687,2731,5418
1125,2020-01-26,3호선,원흥,4333,4104,8437
1126,2020-01-26,3호선,삼송,11518,11036,22554
1127,2020-01-26,3호선,원당,6422,6180,12602
1128,2020-01-26,3호선,화정,11300,11841,23141
1129,2020-01-26,3호선,대곡,868,719,1587
1130,2020-01-26,3호선,백석,6567,6359,12926
1131,2020-01-26,3호선,마두,3877,3924,7801
1132,2020-01-26,3호선,정발산,5502,6123,11625
1133,2020-01-26,3호선,주엽,4453,4768,9221
1134,2020-01-26,3호선,대화,7118,6360,13478
1135,2020-01-27,3호선,지축,1065,1026,2091
1136,2020-01-27,3호선,구파발,11673,12512,24185
1137,2020-01-27,3호선,연신내,23534,23065,46599
1138,2020-01-27,3호선,불광,10124,12213,22337
1139,2020-01-27,3호선,녹번,6159,5711,11870
1140,2020-01-27,3호선,홍제,9359,9413,18772
1141,2020-01-27,3호선,무악재,2031,2156,4187
1142,2020-01-27,3호선,독립문,4114,4464,8578
1143,2020-01-27,3호선,경복궁,12337,13326,25663
1144,2020-01-27,3호선,안국,11764,12387,24151
1145,2020-01-27,3호선,종로3가,4434,6638,11072
1146,2020-01-27,3호선,을지로3가,3480,3213,6693
1147,2020-01-27,3호선,동대입구,4417,5357,9774
1148,2020-01-27,3호선,약수,6426,6619,13045
1149,2020-01-27,3호선,금호,4461,4293,8754
1150,2020-01-27,3호선,옥수,4894,5469,10363
1151,2020-01-27,3호선,압구정,14373,15375,29748
1152,2020-01-27,3호선,신사,16098,17206,33304
1153,2020-01-27,3호선,잠원,2769,2888,5657
1154,2020-01-27,3호선,고속터미널,64244,39980,104224
1155,2020-01-27,3호선,교대,4065,2689,6754
1156,2020-01-27,3호선,남부터미널,23046,18404,41450
1157,2020-01-27,3호선,양재,11748,14358,26106
1158,2020-01-27,3호선,매봉,3583,3620,7203
1159,2020-01-27,3호선,도곡,2035,2252,4287
1160,2020-01-27,3호선,대치,5640,5289,10929
1161,2020-01-27,3호선,학여울,655,667,1322
1162,2020-01-27,3호선,대청,4025,4140,8165
1163,2020-01-27,3호선,일원,3224,3686,6910
1164,2020-01-27,3호선,수서,12244,9235,21479
1165,2020-01-27,3호선,가락시장,4086,4358,8444
1166,2020-01-27,3호선,경찰병원,2997,3200,6197
1167,2020-01-27,3호선,오금,2668,2565,5233
1168,2020-01-27,3호선,원흥,4182,4102,8284
1169,2020-01-27,3호선,삼송,10536,10431,20967
1170,2020-01-27,3호선,원당,6185,5956,12141
1171,2020-01-27,3호선,화정,10061,10438,20499
1172,2020-01-27,3호선,대곡,957,733,1690
1173,2020-01-27,3호선,백석,6819,6530,13349
1174,2020-01-27,3호선,마두,4031,4062,8093
1175,2020-01-27,3호선,정발산,5022,5276,10298
1176,2020-01-27,3호선,주엽,4720,4629,9349
1177,2020-01-27,3호선,대화,7203,6333,13536
1178,2020-01-28,3호선,지축,2298,2258,4556
1179,2020-01-28,3호선,구파발,22157,20664,42821
1180,2020-01-28,3호선,연신내,41591,39632,81223
1181,2020-01-28,3호선,불광,17648,19211,36859
1182,2020-01-28,3호선,녹번,14264,12932,27196
1183,2020-01-28,3호선,홍제,18523,17815,36338
1184,2020-01-28,3호선,무악재,4093,4151,8244
1185,2020-01-28,3호선,독립문,7300,7563,14863
1186,2020-01-28,3호선,경복궁,20100,19910,40010
1187,2020-01-28,3호선,안국,22423,23408,45831
1188,2020-01-28,3호선,종로3가,11587,13732,25319
1189,2020-01-28,3호선,을지로3가,11636,12082,23718
1190,2020-01-28,3호선,동대입구,8025,8741,16766
1191,2020-01-28,3호선,약수,13795,13511,27306
1192,2020-01-28,3호선,금호,8654,8166,16820
1193,2020-01-28,3호선,옥수,9528,9956,19484
1194,2020-01-28,3호선,압구정,34755,37853,72608
1195,2020-01-28,3호선,신사,32493,34874,67367
1196,2020-01-28,3호선,잠원,6232,6029,12261
1197,2020-01-28,3호선,고속터미널,52376,42944,95320
1198,2020-01-28,3호선,교대,14669,9854,24523
1199,2020-01-28,3호선,남부터미널,34530,33074,67604
1200,2020-01-28,3호선,양재,40274,44207,84481
1201,2020-01-28,3호선,매봉,12581,11938,24519
1202,2020-01-28,3호선,도곡,5709,5803,11512
1203,2020-01-28,3호선,대치,12615,12327,24942
1204,2020-01-28,3호선,학여울,1831,1841,3672
1205,2020-01-28,3호선,대청,10406,9720,20126
1206,2020-01-28,3호선,일원,10409,10568,20977
1207,2020-01-28,3호선,수서,18095,17328,35423
1208,2020-01-28,3호선,가락시장,9761,9606,19367
1209,2020-01-28,3호선,경찰병원,8379,8572,16951
1210,2020-01-28,3호선,오금,6942,6154,13096
1211,2020-01-28,3호선,원흥,9020,8691,17711
1212,2020-01-28,3호선,삼송,18079,17510,35589
1213,2020-01-28,3호선,원당,11417,10796,22213
1214,2020-01-28,3호선,화정,18779,19411,38190
1215,2020-01-28,3호선,대곡,1677,1191,2868
1216,2020-01-28,3호선,백석,10932,10885,21817
1217,2020-01-28,3호선,마두,8082,8477,16559
1218,2020-01-28,3호선,정발산,7803,8105,15908
1219,2020-01-28,3호선,주엽,9380,9606,18986
1220,2020-01-28,3호선,대화,14778,11371,26149
1221,2020-01-29,3호선,지축,2364,2445,4809
1222,2020-01-29,3호선,구파발,23615,22076,45691
1223,2020-01-29,3호선,연신내,43144,41133,84277
1224,2020-01-29,3호선,불광,18538,19990,38528
1225,2020-01-29,3호선,녹번,15256,13662,28918
1226,2020-01-29,3호선,홍제,19511,18562,38073
1227,2020-01-29,3호선,무악재,4351,4338,8689
1228,2020-01-29,3호선,독립문,8025,8103,16128
1229,2020-01-29,3호선,경복궁,23199,23213,46412
1230,2020-01-29,3호선,안국,24716,25993,50709
1231,2020-01-29,3호선,종로3가,12332,14416,26748
1232,2020-01-29,3호선,을지로3가,12744,13231,25975
1233,2020-01-29,3호선,충무로,1,0,1
1234,2020-01-29,3호선,동대입구,9745,10525,20270
1235,2020-01-29,3호선,약수,14626,14196,28822
1236,2020-01-29,3호선,금호,9171,8496,17667
1237,2020-01-29,3호선,옥수,10074,10361,20435
1238,2020-01-29,3호선,압구정,35980,38951,74931
1239,2020-01-29,3호선,신사,34331,36927,71258
1240,2020-01-29,3호선,잠원,6715,6358,13073
1241,2020-01-29,3호선,고속터미널,46965,43772,90737
1242,2020-01-29,3호선,교대,16474,10985,27459
1243,2020-01-29,3호선,남부터미널,36241,36553,72794
1244,2020-01-29,3호선,양재,43884,47684,91568
1245,2020-01-29,3호선,매봉,13241,12736,25977
1246,2020-01-29,3호선,도곡,6171,6281,12452
1247,2020-01-29,3호선,대치,12879,12686,25565
1248,2020-01-29,3호선,학여울,2088,2140,4228
1249,2020-01-29,3호선,대청,11050,10097,21147
1250,2020-01-29,3호선,일원,10950,11050,22000
1251,2020-01-29,3호선,수서,18280,18455,36735
1252,2020-01-29,3호선,가락시장,10398,10099,20497
1253,2020-01-29,3호선,경찰병원,9068,9093,18161
1254,2020-01-29,3호선,오금,7245,6315,13560
1255,2020-01-29,3호선,원흥,9914,9224,19138
1256,2020-01-29,3호선,삼송,19001,18246,37247
1257,2020-01-29,3호선,원당,11843,11258,23101
1258,2020-01-29,3호선,화정,20006,20684,40690
1259,2020-01-29,3호선,대곡,1684,1221,2905
1260,2020-01-29,3호선,백석,10971,10975,21946
1261,2020-01-29,3호선,마두,8698,8985,17683
1262,2020-01-29,3호선,정발산,7989,8272,16261
1263,2020-01-29,3호선,주엽,9737,10062,19799
1264,2020-01-29,3호선,대화,15377,11884,27261
1265,2020-01-30,3호선,대화,15156,11657,26813
1266,2020-01-30,3호선,주엽,9761,9951,19712
1267,2020-01-30,3호선,정발산,7936,8109,16045
1268,2020-01-30,3호선,마두,8814,9013,17827
1269,2020-01-30,3호선,백석,11185,11089,22274
1270,2020-01-30,3호선,대곡,1717,1248,2965
1271,2020-01-30,3호선,화정,19211,19949,39160
1272,2020-01-30,3호선,원당,12070,11428,23498
1273,2020-01-30,3호선,삼송,18829,18105,36934
1274,2020-01-30,3호선,원흥,9883,9240,19123
1275,2020-01-30,3호선,오금,7388,6244,13632
1276,2020-01-30,3호선,경찰병원,9040,8959,17999
1277,2020-01-30,3호선,가락시장,10782,10627,21409
1278,2020-01-30,3호선,수서,18765,18889,37654
1279,2020-01-30,3호선,일원,11123,10876,21999
1280,2020-01-30,3호선,대청,11664,10467,22131
1281,2020-01-30,3호선,학여울,2049,2067,4116
1282,2020-01-30,3호선,대치,13405,13346,26751
1283,2020-01-30,3호선,도곡,6237,6358,12595
1284,2020-01-30,3호선,매봉,13430,12900,26330
1285,2020-01-30,3호선,양재,45133,48693,93826
1286,2020-01-30,3호선,남부터미널,35597,36004,71601
1287,2020-01-30,3호선,교대,16862,11028,27890
1288,2020-01-30,3호선,고속터미널,46824,44865,91689
1289,2020-01-30,3호선,잠원,6599,6370,12969
1290,2020-01-30,3호선,신사,35221,37930,73151
1291,2020-01-30,3호선,압구정,36114,39080,75194
1292,2020-01-30,3호선,옥수,10159,10586,20745
1293,2020-01-30,3호선,금호,9151,8508,17659
1294,2020-01-30,3호선,약수,14938,14587,29525
1295,2020-01-30,3호선,동대입구,8658,9475,18133
1296,2020-01-30,3호선,충무로,3,0,3
1297,2020-01-30,3호선,을지로3가,12925,13379,26304
1298,2020-01-30,3호선,종로3가,12103,14247,26350
1299,2020-01-30,3호선,안국,24658,25950,50608
1300,2020-01-30,3호선,경복궁,22529,22646,45175
1301,2020-01-30,3호선,독립문,7816,8025,15841
1302,2020-01-30,3호선,무악재,4385,4487,8872
1303,2020-01-30,3호선,홍제,19389,18518,37907
1304,2020-01-30,3호선,녹번,15178,13641,28819
1305,2020-01-30,3호선,불광,18497,20054,38551
1306,2020-01-30,3호선,연신내,44083,41588,85671
1307,2020-01-30,3호선,구파발,23665,21734,45399
1308,2020-01-30,3호선,지축,2443,2460,4903
1309,2020-01-31,3호선,지축,2480,2530,5010
1310,2020-01-31,3호선,구파발,23677,21650,45327
1311,2020-01-31,3호선,연신내,44285,42198,86483
1312,2020-01-31,3호선,불광,18682,20028,38710
1313,2020-01-31,3호선,녹번,15321,13171,28492
1314,2020-01-31,3호선,홍제,19579,18364,37943
1315,2020-01-31,3호선,무악재,4292,4370,8662
1316,2020-01-31,3호선,독립문,7835,8036,15871
1317,2020-01-31,3호선,경복궁,22457,22878,45335
1318,2020-01-31,3호선,안국,25464,26268,51732
1319,2020-01-31,3호선,종로3가,12215,14790,27005
1320,2020-01-31,3호선,을지로3가,13053,13719,26772
1321,2020-01-31,3호선,동대입구,8778,9411,18189
1322,2020-01-31,3호선,약수,15005,14466,29471
1323,2020-01-31,3호선,금호,9447,8678,18125
1324,2020-01-31,3호선,옥수,10195,10294,20489
1325,2020-01-31,3호선,압구정,36564,40008,76572
1326,2020-01-31,3호선,신사,36076,39449,75525
1327,2020-01-31,3호선,잠원,6757,6404,13161
1328,2020-01-31,3호선,고속터미널,50449,50455,100904
1329,2020-01-31,3호선,교대,17260,11312,28572
1330,2020-01-31,3호선,남부터미널,37568,37716,75284
1331,2020-01-31,3호선,양재,47892,50351,98243
1332,2020-01-31,3호선,매봉,13227,12695,25922
1333,2020-01-31,3호선,도곡,5999,6303,12302
1334,2020-01-31,3호선,대치,13783,13563,27346
1335,2020-01-31,3호선,학여울,4182,4095,8277
1336,2020-01-31,3호선,대청,11635,10409,22044
1337,2020-01-31,3호선,일원,10826,10582,21408
1338,2020-01-31,3호선,수서,20620,20035,40655
1339,2020-01-31,3호선,가락시장,11122,10875,21997
1340,2020-01-31,3호선,경찰병원,9012,8859,17871
1341,2020-01-31,3호선,오금,7300,6260,13560
1342,2020-01-31,3호선,원흥,9936,9127,19063
1343,2020-01-31,3호선,삼송,19287,18034,37321
1344,2020-01-31,3호선,원당,11984,11359,23343
1345,2020-01-31,3호선,화정,19495,20290,39785
1346,2020-01-31,3호선,대곡,1717,1273,2990
1347,2020-01-31,3호선,백석,11207,11380,22587
1348,2020-01-31,3호선,마두,8526,8812,17338
1349,2020-01-31,3호선,정발산,8251,9008,17259
1350,2020-01-31,3호선,주엽,9775,9952,19727
1351,2020-01-31,3호선,대화,15322,11800,27122
1352,2020-02-01,3호선,지축,1553,1574,3127
1353,2020-02-01,3호선,구파발,14928,14550,29478
1354,2020-02-01,3호선,연신내,32166,30646,62812
1355,2020-02-01,3호선,불광,13336,15168,28504
1356,2020-02-01,3호선,녹번,9152,8002,17154
1357,2020-02-01,3호선,홍제,13876,13251,27127
1358,2020-02-01,3호선,무악재,2635,2750,5385
1359,2020-02-01,3호선,독립문,5647,5867,11514
1360,2020-02-01,3호선,경복궁,16031,15026,31057
1361,2020-02-01,3호선,안국,15077,16920,31997
1362,2020-02-01,3호선,종로3가,6521,9262,15783
1363,2020-02-01,3호선,을지로3가,5533,5986,11519
1364,2020-02-01,3호선,동대입구,6015,6637,12652
1365,2020-02-01,3호선,약수,9443,8926,18369
1366,2020-02-01,3호선,금호,5941,5413,11354
1367,2020-02-01,3호선,옥수,6476,6507,12983
1368,2020-02-01,3호선,압구정,24392,25842,50234
1369,2020-02-01,3호선,신사,25918,27611,53529
1370,2020-02-01,3호선,잠원,3911,3785,7696
1371,2020-02-01,3호선,고속터미널,48285,47465,95750
1372,2020-02-01,3호선,교대,7547,4459,12006
1373,2020-02-01,3호선,남부터미널,24385,24269,48654
1374,2020-02-01,3호선,양재,23310,24924,48234
1375,2020-02-01,3호선,매봉,5510,5148,10658
1376,2020-02-01,3호선,도곡,3285,3226,6511
1377,2020-02-01,3호선,대치,9720,8781,18501
1378,2020-02-01,3호선,학여울,3224,3291,6515
1379,2020-02-01,3호선,대청,6211,5703,11914
1380,2020-02-01,3호선,일원,4802,4791,9593
1381,2020-02-01,3호선,수서,12764,12555,25319
1382,2020-02-01,3호선,가락시장,6367,6038,12405
1383,2020-02-01,3호선,경찰병원,4350,4134,8484
1384,2020-02-01,3호선,오금,3877,3357,7234
1385,2020-02-01,3호선,원흥,6031,5513,11544
1386,2020-02-01,3호선,삼송,12539,11597,24136
1387,2020-02-01,3호선,원당,8109,7498,15607
1388,2020-02-01,3호선,화정,13309,13872,27181
1389,2020-02-01,3호선,대곡,1140,930,2070
1390,2020-02-01,3호선,백석,7603,7684,15287
1391,2020-02-01,3호선,마두,4958,5033,9991
1392,2020-02-01,3호선,정발산,6116,6743,12859
1393,2020-02-01,3호선,주엽,6259,6033,12292
1394,2020-02-01,3호선,대화,9006,7708,16714
1395,2020-02-02,3호선,지축,1035,1116,2151
1396,2020-02-02,3호선,구파발,11179,11177,22356
1397,2020-02-02,3호선,연신내,23048,21836,44884
1398,2020-02-02,3호선,불광,9699,11253,20952
1399,2020-02-02,3호선,녹번,6214,5476,11690
1400,2020-02-02,3호선,홍제,9456,9089,18545
1401,2020-02-02,3호선,무악재,1804,1977,3781
1402,2020-02-02,3호선,독립문,3999,4268,8267
1403,2020-02-02,3호선,경복궁,11016,11023,22039
1404,2020-02-02,3호선,안국,9801,10486,20287
1405,2020-02-02,3호선,종로3가,3833,5043,8876
1406,2020-02-02,3호선,을지로3가,3619,3519,7138
1407,2020-02-02,3호선,충무로,1,0,1
1408,2020-02-02,3호선,동대입구,5279,5620,10899
1409,2020-02-02,3호선,약수,7030,6657,13687
1410,2020-02-02,3호선,금호,4303,4087,8390
1411,2020-02-02,3호선,옥수,4508,4740,9248
1412,2020-02-02,3호선,압구정,13656,14020,27676
1413,2020-02-02,3호선,신사,14615,14805,29420
1414,2020-02-02,3호선,잠원,2554,2646,5200
1415,2020-02-02,3호선,고속터미널,36088,35775,71863
1416,2020-02-02,3호선,교대,4442,2755,7197
1417,2020-02-02,3호선,남부터미널,15999,17297,33296
1418,2020-02-02,3호선,양재,14885,16903,31788
1419,2020-02-02,3호선,매봉,3639,3565,7204
1420,2020-02-02,3호선,도곡,2150,2289,4439
1421,2020-02-02,3호선,대치,6099,5374,11473
1422,2020-02-02,3호선,학여울,2518,2454,4972
1423,2020-02-02,3호선,대청,4204,3902,8106
1424,2020-02-02,3호선,일원,3428,3702,7130
1425,2020-02-02,3호선,수서,9549,9488,19037
1426,2020-02-02,3호선,가락시장,3905,4199,8104
1427,2020-02-02,3호선,경찰병원,2800,2824,5624
1428,2020-02-02,3호선,오금,2935,2705,5640
1429,2020-02-02,3호선,원흥,4434,4183,8617
1430,2020-02-02,3호선,삼송,9050,8867,17917
1431,2020-02-02,3호선,원당,5840,5775,11615
1432,2020-02-02,3호선,화정,10502,10926,21428
1433,2020-02-02,3호선,대곡,836,715,1551
1434,2020-02-02,3호선,백석,5541,5347,10888
1435,2020-02-02,3호선,마두,3373,3522,6895
1436,2020-02-02,3호선,정발산,5229,5291,10520
1437,2020-02-02,3호선,주엽,4060,4153,8213
1438,2020-02-02,3호선,대화,6349,5886,12235
1439,2020-02-03,3호선,지축,2388,2443,4831
1440,2020-02-03,3호선,구파발,22291,20735,43026
1441,2020-02-03,3호선,연신내,41554,39424,80978
1442,2020-02-03,3호선,불광,17362,18267,35629
1443,2020-02-03,3호선,녹번,14403,12947,27350
1444,2020-02-03,3호선,홍제,18228,17486,35714
1445,2020-02-03,3호선,무악재,4134,4215,8349
1446,2020-02-03,3호선,독립문,7540,7688,15228
1447,2020-02-03,3호선,경복궁,20792,20682,41474
1448,2020-02-03,3호선,안국,23145,23963,47108
1449,2020-02-03,3호선,종로3가,11354,13269,24623
1450,2020-02-03,3호선,을지로3가,12355,12677,25032
1451,2020-02-03,3호선,동대입구,6869,7363,14232
1452,2020-02-03,3호선,약수,14196,13760,27956
1453,2020-02-03,3호선,금호,8776,8205,16981
1454,2020-02-03,3호선,옥수,9481,9859,19340
1455,2020-02-03,3호선,압구정,33694,36149,69843
1456,2020-02-03,3호선,신사,32444,34445,66889
1457,2020-02-03,3호선,잠원,6311,6217,12528
1458,2020-02-03,3호선,고속터미널,40831,38708,79539
1459,2020-02-03,3호선,교대,15511,10317,25828
1460,2020-02-03,3호선,남부터미널,30820,31755,62575
1461,2020-02-03,3호선,양재,41884,45563,87447
1462,2020-02-03,3호선,매봉,12897,12311,25208
1463,2020-02-03,3호선,도곡,5767,5868,11635
1464,2020-02-03,3호선,대치,12309,12291,24600
1465,2020-02-03,3호선,학여울,2995,3100,6095
1466,2020-02-03,3호선,대청,10978,9970,20948
1467,2020-02-03,3호선,일원,10728,10651,21379
1468,2020-02-03,3호선,수서,17466,18025,35491
1469,2020-02-03,3호선,가락시장,10021,9808,19829
1470,2020-02-03,3호선,경찰병원,8803,8891,17694
1471,2020-02-03,3호선,오금,7180,6161,13341
1472,2020-02-03,3호선,원흥,9389,8881,18270
1473,2020-02-03,3호선,삼송,17808,17201,35009
1474,2020-02-03,3호선,원당,11233,10756,21989
1475,2020-02-03,3호선,화정,18153,18786,36939
1476,2020-02-03,3호선,대곡,1623,1175,2798
1477,2020-02-03,3호선,백석,10306,10372,20678
1478,2020-02-03,3호선,마두,7778,7958,15736
1479,2020-02-03,3호선,정발산,6997,7188,14185
1480,2020-02-03,3호선,주엽,8896,9072,17968
1481,2020-02-03,3호선,대화,14589,11316,25905
1482,2020-02-04,3호선,지축,2378,2473,4851
1483,2020-02-04,3호선,구파발,23156,21464,44620
1484,2020-02-04,3호선,연신내,41738,39651,81389
1485,2020-02-04,3호선,불광,17691,18936,36627
1486,2020-02-04,3호선,녹번,14654,13253,27907
1487,2020-02-04,3호선,홍제,18686,18011,36697
1488,2020-02-04,3호선,무악재,4289,4374,8663
1489,2020-02-04,3호선,독립문,8101,8172,16273
1490,2020-02-04,3호선,경복궁,20443,19988,40431
1491,2020-02-04,3호선,안국,24460,24870,49330
1492,2020-02-04,3호선,종로3가,11686,13309,24995
1493,2020-02-04,3호선,을지로3가,12762,12818,25580
1494,2020-02-04,3호선,충무로,2,0,2
1495,2020-02-04,3호선,동대입구,7017,7435,14452
1496,2020-02-04,3호선,약수,14506,13938,28444
1497,2020-02-04,3호선,금호,8862,8350,17212
1498,2020-02-04,3호선,옥수,9695,10177,19872
1499,2020-02-04,3호선,압구정,34232,36950,71182
1500,2020-02-04,3호선,신사,33537,35550,69087
1501,2020-02-04,3호선,잠원,6365,6312,12677
1502,2020-02-04,3호선,고속터미널,40058,38177,78235
1503,2020-02-04,3호선,교대,15633,10210,25843
1504,2020-02-04,3호선,남부터미널,32259,33162,65421
1505,2020-02-04,3호선,양재,43625,46692,90317
1506,2020-02-04,3호선,매봉,12623,12100,24723
1507,2020-02-04,3호선,도곡,6009,5998,12007
1508,2020-02-04,3호선,대치,12585,12502,25087
1509,2020-02-04,3호선,학여울,1870,1965,3835
1510,2020-02-04,3호선,대청,11120,10217,21337
1511,2020-02-04,3호선,일원,10694,10828,21522
1512,2020-02-04,3호선,수서,17893,17981,35874
1513,2020-02-04,3호선,가락시장,10005,9767,19772
1514,2020-02-04,3호선,경찰병원,8591,8574,17165
1515,2020-02-04,3호선,오금,7087,6446,13533
1516,2020-02-04,3호선,원흥,9259,8738,17997
1517,2020-02-04,3호선,삼송,17839,17202,35041
1518,2020-02-04,3호선,원당,11277,10889,22166
1519,2020-02-04,3호선,화정,18217,19087,37304
1520,2020-02-04,3호선,대곡,1672,1179,2851
1521,2020-02-04,3호선,백석,10415,10310,20725
1522,2020-02-04,3호선,마두,7836,8248,16084
1523,2020-02-04,3호선,정발산,7169,7439,14608
1524,2020-02-04,3호선,주엽,8938,9128,18066
1525,2020-02-04,3호선,대화,14701,11590,26291
1526,2020-02-05,3호선,지축,2294,2374,4668
1527,2020-02-05,3호선,구파발,22182,20439,42621
1528,2020-02-05,3호선,연신내,40574,38585,79159
1529,2020-02-05,3호선,불광,16723,17898,34621
1530,2020-02-05,3호선,녹번,14418,12668,27086
1531,2020-02-05,3호선,홍제,17896,17209,35105
1532,2020-02-05,3호선,무악재,4085,4116,8201
1533,2020-02-05,3호선,독립문,7282,7533,14815
1534,2020-02-05,3호선,경복궁,21062,21059,42121
1535,2020-02-05,3호선,안국,23078,23801,46879
1536,2020-02-05,3호선,종로3가,11228,12823,24051
1537,2020-02-05,3호선,을지로3가,12394,12847,25241
1538,2020-02-05,3호선,충무로,2,0,2
1539,2020-02-05,3호선,동대입구,8144,8612,16756
1540,2020-02-05,3호선,약수,13929,13586,27515
1541,2020-02-05,3호선,금호,8615,8008,16623
1542,2020-02-05,3호선,옥수,9199,9691,18890
1543,2020-02-05,3호선,압구정,32984,35511,68495
1544,2020-02-05,3호선,신사,32329,34530,66859
1545,2020-02-05,3호선,잠원,6134,5947,12081
1546,2020-02-05,3호선,고속터미널,40045,38165,78210
1547,2020-02-05,3호선,교대,15349,9959,25308
1548,2020-02-05,3호선,남부터미널,32278,32918,65196
1549,2020-02-05,3호선,양재,42147,45273,87420
1550,2020-02-05,3호선,매봉,12630,12065,24695
1551,2020-02-05,3호선,도곡,5898,5863,11761
1552,2020-02-05,3호선,대치,12090,12072,24162
1553,2020-02-05,3호선,학여울,1749,1751,3500
1554,2020-02-05,3호선,대청,10636,10029,20665
1555,2020-02-05,3호선,일원,10407,10209,20616
1556,2020-02-05,3호선,수서,17483,17520,35003
1557,2020-02-05,3호선,가락시장,9807,9533,19340
1558,2020-02-05,3호선,경찰병원,8385,8325,16710
1559,2020-02-05,3호선,오금,6993,6108,13101
1560,2020-02-05,3호선,원흥,9103,8422,17525
1561,2020-02-05,3호선,삼송,17506,16661,34167
1562,2020-02-05,3호선,원당,10725,10294,21019
1563,2020-02-05,3호선,화정,18192,18969,37161
1564,2020-02-05,3호선,대곡,1579,1132,2711
1565,2020-02-05,3호선,백석,9939,9937,19876
1566,2020-02-05,3호선,마두,7683,8080,15763
1567,2020-02-05,3호선,정발산,6870,7119,13989
1568,2020-02-05,3호선,주엽,8255,8556,16811
1569,2020-02-05,3호선,대화,14476,11303,25779
1570,2020-02-06,3호선,지축,2381,2461,4842
1571,2020-02-06,3호선,구파발,21551,19847,41398
1572,2020-02-06,3호선,연신내,40734,38527,79261
1573,2020-02-06,3호선,불광,16644,17571,34215
1574,2020-02-06,3호선,녹번,14157,12343,26500
1575,2020-02-06,3호선,홍제,17588,16769,34357
1576,2020-02-06,3호선,무악재,4044,4028,8072
1577,2020-02-06,3호선,독립문,6961,7209,14170
1578,2020-02-06,3호선,경복궁,20630,20284,40914
1579,2020-02-06,3호선,안국,22625,23578,46203
1580,2020-02-06,3호선,종로3가,11219,12742,23961
1581,2020-02-06,3호선,을지로3가,11956,12598,24554
1582,2020-02-06,3호선,충무로,3,0,3
1583,2020-02-06,3호선,동대입구,6944,7377,14321
1584,2020-02-06,3호선,약수,13869,13441,27310
1585,2020-02-06,3호선,금호,8323,7769,16092
1586,2020-02-06,3호선,옥수,9225,9584,18809
1587,2020-02-06,3호선,압구정,32269,34856,67125
1588,2020-02-06,3호선,신사,32235,34693,66928
1589,2020-02-06,3호선,잠원,6048,5791,11839
1590,2020-02-06,3호선,고속터미널,39941,38833,78774
1591,2020-02-06,3호선,교대,15312,10086,25398
1592,2020-02-06,3호선,남부터미널,31101,31597,62698
1593,2020-02-06,3호선,양재,42171,45822,87993
1594,2020-02-06,3호선,매봉,12462,11938,24400
1595,2020-02-06,3호선,도곡,5653,5732,11385
1596,2020-02-06,3호선,대치,12214,12158,24372
1597,2020-02-06,3호선,학여울,1789,1759,3548
1598,2020-02-06,3호선,대청,10654,9731,20385
1599,2020-02-06,3호선,일원,10194,10105,20299
1600,2020-02-06,3호선,수서,17178,17250,34428
1601,2020-02-06,3호선,가락시장,9223,9045,18268
1602,2020-02-06,3호선,경찰병원,8004,8100,16104
1603,2020-02-06,3호선,오금,6772,5864,12636
1604,2020-02-06,3호선,삼송,17240,16518,33758
1605,2020-02-06,3호선,원흥,9054,8529,17583
1606,2020-02-06,3호선,원당,10607,10138,20745
1607,2020-02-06,3호선,화정,17431,17973,35404
1608,2020-02-06,3호선,대곡,1580,1127,2707
1609,2020-02-06,3호선,백석,9950,9834,19784
1610,2020-02-06,3호선,마두,7706,7994,15700
1611,2020-02-06,3호선,정발산,6913,7257,14170
1612,2020-02-06,3호선,주엽,8375,8662,17037
1613,2020-02-06,3호선,대화,13929,10821,24750
1614,2020-02-07,3호선,지축,2473,2527,5000
1615,2020-02-07,3호선,구파발,22287,19884,42171
1616,2020-02-07,3호선,연신내,42640,40898,83538
1617,2020-02-07,3호선,불광,17782,18932,36714
1618,2020-02-07,3호선,녹번,14552,12705,27257
1619,2020-02-07,3호선,홍제,18423,17399,35822
1620,2020-02-07,3호선,무악재,4240,4084,8324
1621,2020-02-07,3호선,독립문,7451,7799,15250
1622,2020-02-07,3호선,경복궁,21710,21618,43328
1623,2020-02-07,3호선,안국,23292,24168,47460
1624,2020-02-07,3호선,종로3가,11489,13701,25190
1625,2020-02-07,3호선,을지로3가,12517,13075,25592
1626,2020-02-07,3호선,충무로,1,0,1
1627,2020-02-07,3호선,동대입구,8230,8646,16876
1628,2020-02-07,3호선,약수,14427,14267,28694
1629,2020-02-07,3호선,금호,8980,8259,17239
1630,2020-02-07,3호선,옥수,9646,9863,19509
1631,2020-02-07,3호선,압구정,34878,37931,72809
1632,2020-02-07,3호선,신사,34561,38102,72663
1633,2020-02-07,3호선,잠원,6238,6133,12371
1634,2020-02-07,3호선,고속터미널,45957,47438,93395
1635,2020-02-07,3호선,교대,15586,10360,25946
1636,2020-02-07,3호선,남부터미널,34049,34481,68530
1637,2020-02-07,3호선,양재,45093,46667,91760
1638,2020-02-07,3호선,매봉,12520,11936,24456
1639,2020-02-07,3호선,도곡,5849,5876,11725
1640,2020-02-07,3호선,대치,12454,12219,24673
1641,2020-02-07,3호선,학여울,2084,2106,4190
1642,2020-02-07,3호선,대청,10662,9734,20396
1643,2020-02-07,3호선,일원,10051,9900,19951
1644,2020-02-07,3호선,수서,19065,18769,37834
1645,2020-02-07,3호선,가락시장,9832,9558,19390
1646,2020-02-07,3호선,경찰병원,8078,8009,16087
1647,2020-02-07,3호선,오금,6970,6142,13112
1648,2020-02-07,3호선,원흥,9595,8788,18383
1649,2020-02-07,3호선,삼송,17936,16877,34813
1650,2020-02-07,3호선,원당,11226,10673,21899
1651,2020-02-07,3호선,화정,18343,19348,37691
1652,2020-02-07,3호선,대곡,1620,1207,2827
1653,2020-02-07,3호선,백석,10609,10548,21157
1654,2020-02-07,3호선,마두,8125,8447,16572
1655,2020-02-07,3호선,정발산,7779,8400,16179
1656,2020-02-07,3호선,주엽,8834,9175,18009
1657,2020-02-07,3호선,대화,14405,10999,25404
1658,2020-02-08,3호선,지축,1585,1653,3238
1659,2020-02-08,3호선,구파발,14389,14145,28534
1660,2020-02-08,3호선,연신내,30916,29405,60321
1661,2020-02-08,3호선,불광,12698,14211,26909
1662,2020-02-08,3호선,녹번,9060,7739,16799
1663,2020-02-08,3호선,홍제,12759,12191,24950
1664,2020-02-08,3호선,무악재,2492,2681,5173
1665,2020-02-08,3호선,독립문,5229,5221,10450
1666,2020-02-08,3호선,경복궁,15656,14698,30354
1667,2020-02-08,3호선,안국,13687,15099,28786
1668,2020-02-08,3호선,종로3가,6171,8458,14629
1669,2020-02-08,3호선,을지로3가,5197,5722,10919
1670,2020-02-08,3호선,동대입구,5962,6659,12621
1671,2020-02-08,3호선,약수,9060,8423,17483
1672,2020-02-08,3호선,금호,5735,5209,10944
1673,2020-02-08,3호선,옥수,6401,6399,12800
1674,2020-02-08,3호선,압구정,24112,25521,49633
1675,2020-02-08,3호선,신사,24898,26827,51725
1676,2020-02-08,3호선,잠원,3875,3741,7616
1677,2020-02-08,3호선,고속터미널,45894,45634,91528
1678,2020-02-08,3호선,교대,7063,4261,11324
1679,2020-02-08,3호선,남부터미널,23193,23187,46380
1680,2020-02-08,3호선,양재,22077,23495,45572
1681,2020-02-08,3호선,매봉,5355,5050,10405
1682,2020-02-08,3호선,도곡,3258,3391,6649
1683,2020-02-08,3호선,대치,9697,8675,18372
1684,2020-02-08,3호선,학여울,1051,1028,2079
1685,2020-02-08,3호선,대청,5910,5353,11263
1686,2020-02-08,3호선,일원,4781,4681,9462
1687,2020-02-08,3호선,수서,11680,11431,23111
1688,2020-02-08,3호선,가락시장,5695,5295,10990
1689,2020-02-08,3호선,경찰병원,3715,3561,7276
1690,2020-02-08,3호선,오금,3620,3305,6925
1691,2020-02-08,3호선,원흥,6252,5630,11882
1692,2020-02-08,3호선,삼송,12067,11320,23387
1693,2020-02-08,3호선,원당,7774,7297,15071
1694,2020-02-08,3호선,화정,13041,13453,26494
1695,2020-02-08,3호선,대곡,1114,931,2045
1696,2020-02-08,3호선,백석,7562,7556,15118
1697,2020-02-08,3호선,마두,4896,5018,9914
1698,2020-02-08,3호선,정발산,6254,6828,13082
1699,2020-02-08,3호선,주엽,5933,5962,11895
1700,2020-02-08,3호선,대화,8790,7569,16359
1701,2020-02-09,3호선,지축,1098,1105,2203
1702,2020-02-09,3호선,구파발,11296,11155,22451
1703,2020-02-09,3호선,연신내,22565,21358,43923
1704,2020-02-09,3호선,불광,9368,11037,20405
1705,2020-02-09,3호선,녹번,6116,5509,11625
1706,2020-02-09,3호선,홍제,8982,8569,17551
1707,2020-02-09,3호선,무악재,1801,1933,3734
1708,2020-02-09,3호선,독립문,3937,4079,8016
1709,2020-02-09,3호선,경복궁,10467,10523,20990
1710,2020-02-09,3호선,안국,9277,9931,19208
1711,2020-02-09,3호선,종로3가,3666,5047,8713
1712,2020-02-09,3호선,을지로3가,3264,3193,6457
1713,2020-02-09,3호선,동대입구,5922,6475,12397
1714,2020-02-09,3호선,약수,6775,6487,13262
1715,2020-02-09,3호선,금호,4239,4021,8260
1716,2020-02-09,3호선,옥수,4475,4780,9255
1717,2020-02-09,3호선,압구정,13555,14182,27737
1718,2020-02-09,3호선,신사,15426,15456,30882
1719,2020-02-09,3호선,잠원,2629,2625,5254
1720,2020-02-09,3호선,고속터미널,38085,36400,74485
1721,2020-02-09,3호선,교대,4326,2693,7019
1722,2020-02-09,3호선,남부터미널,15618,16795,32413
1723,2020-02-09,3호선,양재,14071,15914,29985
1724,2020-02-09,3호선,매봉,3749,3801,7550
1725,2020-02-09,3호선,도곡,1961,2055,4016
1726,2020-02-09,3호선,대치,6486,5829,12315
1727,2020-02-09,3호선,학여울,732,674,1406
1728,2020-02-09,3호선,대청,3979,3830,7809
1729,2020-02-09,3호선,일원,3191,3517,6708
1730,2020-02-09,3호선,수서,9137,9210,18347
1731,2020-02-09,3호선,가락시장,3378,3591,6969
1732,2020-02-09,3호선,경찰병원,2733,2745,5478
1733,2020-02-09,3호선,오금,2904,2747,5651
1734,2020-02-09,3호선,원흥,4405,4266,8671
1735,2020-02-09,3호선,삼송,9206,9047,18253
1736,2020-02-09,3호선,원당,5849,5519,11368
1737,2020-02-09,3호선,화정,10776,11132,21908
1738,2020-02-09,3호선,대곡,804,630,1434
1739,2020-02-09,3호선,백석,5680,5559,11239
1740,2020-02-09,3호선,마두,3488,3535,7023
1741,2020-02-09,3호선,정발산,5366,5466,10832
1742,2020-02-09,3호선,주엽,4045,4148,8193
1743,2020-02-09,3호선,대화,6391,5806,12197
1744,2020-02-10,3호선,지축,2587,2716,5303
1745,2020-02-10,3호선,구파발,22606,20907,43513
1746,2020-02-10,3호선,연신내,40931,39073,80004
1747,2020-02-10,3호선,불광,17319,18680,35999
1748,2020-02-10,3호선,녹번,14252,12769,27021
1749,2020-02-10,3호선,홍제,18129,17228,35357
1750,2020-02-10,3호선,무악재,3983,4106,8089
1751,2020-02-10,3호선,독립문,7153,7144,14297
1752,2020-02-10,3호선,경복궁,20591,20478,41069
1753,2020-02-10,3호선,안국,22010,22765,44775
1754,2020-02-10,3호선,종로3가,11456,13589,25045
1755,2020-02-10,3호선,을지로3가,12078,12662,24740
1756,2020-02-10,3호선,충무로,1,0,1
1757,2020-02-10,3호선,동대입구,7846,8412,16258
1758,2020-02-10,3호선,약수,13928,13658,27586
1759,2020-02-10,3호선,금호,8658,8087,16745
1760,2020-02-10,3호선,옥수,9414,9819,19233
1761,2020-02-10,3호선,압구정,33320,35885,69205
1762,2020-02-10,3호선,신사,33601,35898,69499
1763,2020-02-10,3호선,잠원,6302,6153,12455
1764,2020-02-10,3호선,고속터미널,37782,35128,72910
1765,2020-02-10,3호선,교대,15024,9985,25009
1766,2020-02-10,3호선,남부터미널,30561,31567,62128
1767,2020-02-10,3호선,양재,41475,45297,86772
1768,2020-02-10,3호선,매봉,12487,11975,24462
1769,2020-02-10,3호선,도곡,5798,5793,11591
1770,2020-02-10,3호선,대치,12300,11943,24243
1771,2020-02-10,3호선,학여울,1795,1825,3620
1772,2020-02-10,3호선,대청,10340,9522,19862
1773,2020-02-10,3호선,일원,10177,10099,20276
1774,2020-02-10,3호선,수서,17029,17114,34143
1775,2020-02-10,3호선,가락시장,9704,9377,19081
1776,2020-02-10,3호선,경찰병원,8385,8489,16874
1777,2020-02-10,3호선,오금,6767,6032,12799
1778,2020-02-10,3호선,원흥,9420,8848,18268
1779,2020-02-10,3호선,삼송,18008,17305,35313
1780,2020-02-10,3호선,원당,11366,10821,22187
1781,2020-02-10,3호선,화정,18306,18990,37296
1782,2020-02-10,3호선,대곡,1679,1146,2825
1783,2020-02-10,3호선,백석,10528,10426,20954
1784,2020-02-10,3호선,마두,7927,8198,16125
1785,2020-02-10,3호선,정발산,6919,7203,14122
1786,2020-02-10,3호선,주엽,8806,9263,18069
1787,2020-02-10,3호선,대화,14452,11043,25495
1788,2020-02-11,3호선,지축,2686,2782,5468
1789,2020-02-11,3호선,구파발,23170,21324,44494
1790,2020-02-11,3호선,연신내,42315,40104,82419
1791,2020-02-11,3호선,불광,17756,19219,36975
1792,2020-02-11,3호선,녹번,14554,12922,27476
1793,2020-02-11,3호선,홍제,18728,17711,36439
1794,2020-02-11,3호선,무악재,4177,4194,8371
1795,2020-02-11,3호선,독립문,7343,7526,14869
1796,2020-02-11,3호선,경복궁,20908,20464,41372
1797,2020-02-11,3호선,안국,22638,23841,46479
1798,2020-02-11,3호선,종로3가,11682,13628,25310
1799,2020-02-11,3호선,을지로3가,12508,13018,25526
1800,2020-02-11,3호선,동대입구,8123,8827,16950
1801,2020-02-11,3호선,약수,14438,13968,28406
1802,2020-02-11,3호선,금호,8951,8379,17330
1803,2020-02-11,3호선,옥수,9927,10182,20109
1804,2020-02-11,3호선,압구정,34800,37522,72322
1805,2020-02-11,3호선,신사,34661,37193,71854
1806,2020-02-11,3호선,잠원,6489,6269,12758
1807,2020-02-11,3호선,고속터미널,43394,41968,85362
1808,2020-02-11,3호선,교대,15999,10430,26429
1809,2020-02-11,3호선,남부터미널,31937,32851,64788
1810,2020-02-11,3호선,양재,43115,46612,89727
1811,2020-02-11,3호선,매봉,12894,12298,25192
1812,2020-02-11,3호선,도곡,5783,5900,11683
1813,2020-02-11,3호선,대치,12791,12442,25233
1814,2020-02-11,3호선,학여울,1842,1894,3736
1815,2020-02-11,3호선,대청,10643,9979,20622
1816,2020-02-11,3호선,일원,10622,10510,21132
1817,2020-02-11,3호선,수서,17216,17474,34690
1818,2020-02-11,3호선,가락시장,9911,9714,19625
1819,2020-02-11,3호선,경찰병원,8575,8525,17100
1820,2020-02-11,3호선,오금,6981,6114,13095
1821,2020-02-11,3호선,원흥,9622,9004,18626
1822,2020-02-11,3호선,삼송,18647,17673,36320
1823,2020-02-11,3호선,원당,11708,11313,23021
1824,2020-02-11,3호선,화정,19000,19639,38639
1825,2020-02-11,3호선,대곡,1766,1243,3009
1826,2020-02-11,3호선,백석,10893,11068,21961
1827,2020-02-11,3호선,마두,8133,8354,16487
1828,2020-02-11,3호선,정발산,7720,8154,15874
1829,2020-02-11,3호선,주엽,9206,9459,18665
1830,2020-02-11,3호선,대화,14932,11255,26187
1831,2020-02-12,3호선,지축,2497,2639,5136
1832,2020-02-12,3호선,구파발,22559,20786,43345
1833,2020-02-12,3호선,연신내,40242,38421,78663
1834,2020-02-12,3호선,불광,16924,18286,35210
1835,2020-02-12,3호선,녹번,14274,12625,26899
1836,2020-02-12,3호선,홍제,18133,17102,35235
1837,2020-02-12,3호선,무악재,4032,4078,8110
1838,2020-02-12,3호선,독립문,6877,7093,13970
1839,2020-02-12,3호선,경복궁,20493,20214,40707
1840,2020-02-12,3호선,안국,21527,22189,43716
1841,2020-02-12,3호선,종로3가,11704,13392,25096
1842,2020-02-12,3호선,을지로3가,12701,12889,25590
1843,2020-02-12,3호선,동대입구,7955,8237,16192
1844,2020-02-12,3호선,약수,13701,13444,27145
1845,2020-02-12,3호선,금호,8547,8120,16667
1846,2020-02-12,3호선,옥수,9450,9851,19301
1847,2020-02-12,3호선,압구정,33300,35922,69222
1848,2020-02-12,3호선,신사,33004,35435,68439
1849,2020-02-12,3호선,잠원,6265,6105,12370
1850,2020-02-12,3호선,고속터미널,42389,40638,83027
1851,2020-02-12,3호선,교대,15583,10227,25810
1852,2020-02-12,3호선,남부터미널,31781,32437,64218
1853,2020-02-12,3호선,양재,42230,45366,87596
1854,2020-02-12,3호선,매봉,12685,12106,24791
1855,2020-02-12,3호선,도곡,5682,5789,11471
1856,2020-02-12,3호선,대치,12296,12186,24482
1857,2020-02-12,3호선,학여울,1798,1834,3632
1858,2020-02-12,3호선,대청,10534,9711,20245
1859,2020-02-12,3호선,일원,10180,10134,20314
1860,2020-02-12,3호선,수서,17060,17207,34267
1861,2020-02-12,3호선,가락시장,9589,9356,18945
1862,2020-02-12,3호선,경찰병원,8531,8522,17053
1863,2020-02-12,3호선,오금,6812,5906,12718
1864,2020-02-12,3호선,원흥,9184,8701,17885
1865,2020-02-12,3호선,삼송,17859,16884,34743
1866,2020-02-12,3호선,원당,10969,10464,21433
1867,2020-02-12,3호선,화정,18386,19261,37647
1868,2020-02-12,3호선,대곡,1612,1169,2781
1869,2020-02-12,3호선,백석,10255,10275,20530
1870,2020-02-12,3호선,마두,8111,8494,16605
1871,2020-02-12,3호선,정발산,7115,7471,14586
1872,2020-02-12,3호선,주엽,8865,9046,17911
1873,2020-02-12,3호선,대화,14530,11200,25730
1874,2020-02-13,3호선,지축,2724,2752,5476
1875,2020-02-13,3호선,구파발,23402,21507,44909
1876,2020-02-13,3호선,연신내,42516,40377,82893
1877,2020-02-13,3호선,불광,17861,19143,37004
1878,2020-02-13,3호선,녹번,14700,13137,27837
1879,2020-02-13,3호선,홍제,18653,17584,36237
1880,2020-02-13,3호선,무악재,4129,4194,8323
1881,2020-02-13,3호선,독립문,7393,7474,14867
1882,2020-02-13,3호선,경복궁,23140,22931,46071
1883,2020-02-13,3호선,안국,22945,23916,46861
1884,2020-02-13,3호선,종로3가,11673,13884,25557
1885,2020-02-13,3호선,을지로3가,12463,13242,25705
1886,2020-02-13,3호선,충무로,3,0,3
1887,2020-02-13,3호선,동대입구,9759,10877,20636
1888,2020-02-13,3호선,약수,14361,13855,28216
1889,2020-02-13,3호선,금호,9125,8376,17501
1890,2020-02-13,3호선,옥수,9866,10265,20131
1891,2020-02-13,3호선,압구정,34554,37497,72051
1892,2020-02-13,3호선,신사,35369,38166,73535
1893,2020-02-13,3호선,잠원,6590,6360,12950
1894,2020-02-13,3호선,고속터미널,46505,44726,91231
1895,2020-02-13,3호선,교대,16164,10580,26744
1896,2020-02-13,3호선,남부터미널,33294,34254,67548
1897,2020-02-13,3호선,양재,43062,46940,90002
1898,2020-02-13,3호선,매봉,12886,12414,25300
1899,2020-02-13,3호선,도곡,5858,5864,11722
1900,2020-02-13,3호선,대치,13116,12849,25965
1901,2020-02-13,3호선,학여울,1955,1977,3932
1902,2020-02-13,3호선,대청,10629,9638,20267
1903,2020-02-13,3호선,일원,10422,10322,20744
1904,2020-02-13,3호선,수서,17990,18085,36075
1905,2020-02-13,3호선,가락시장,10231,9955,20186
1906,2020-02-13,3호선,경찰병원,8729,8695,17424
1907,2020-02-13,3호선,오금,7198,6284,13482
1908,2020-02-13,3호선,원흥,9766,8996,18762
1909,2020-02-13,3호선,삼송,18695,17917,36612
1910,2020-02-13,3호선,원당,11903,11253,23156
1911,2020-02-13,3호선,화정,19223,19750,38973
1912,2020-02-13,3호선,대곡,1774,1254,3028
1913,2020-02-13,3호선,백석,10875,11018,21893
1914,2020-02-13,3호선,마두,8538,8772,17310
1915,2020-02-13,3호선,정발산,7859,8272,16131
1916,2020-02-13,3호선,주엽,9333,9498,18831
1917,2020-02-13,3호선,대화,15116,11422,26538
1918,2020-02-14,3호선,지축,2853,2883,5736
1919,2020-02-14,3호선,구파발,24144,21831,45975
1920,2020-02-14,3호선,연신내,45022,42652,87674
1921,2020-02-14,3호선,불광,18822,20272,39094
1922,2020-02-14,3호선,녹번,15232,13078,28310
1923,2020-02-14,3호선,홍제,19793,18308,38101
1924,2020-02-14,3호선,무악재,4397,4268,8665
1925,2020-02-14,3호선,독립문,7726,7905,15631
1926,2020-02-14,3호선,경복궁,23422,23275,46697
1927,2020-02-14,3호선,안국,23873,24810,48683
1928,2020-02-14,3호선,종로3가,11743,14473,26216
1929,2020-02-14,3호선,을지로3가,12778,13650,26428
1930,2020-02-14,3호선,충무로,3,0,3
1931,2020-02-14,3호선,동대입구,8587,9217,17804
1932,2020-02-14,3호선,약수,15048,14616,29664
1933,2020-02-14,3호선,금호,9837,9017,18854
1934,2020-02-14,3호선,옥수,10241,10562,20803
1935,2020-02-14,3호선,압구정,38068,41279,79347
1936,2020-02-14,3호선,신사,38461,42376,80837
1937,2020-02-14,3호선,잠원,6844,6502,13346
1938,2020-02-14,3호선,고속터미널,54910,56984,111894
1939,2020-02-14,3호선,교대,16541,10769,27310
1940,2020-02-14,3호선,남부터미널,36791,37263,74054
1941,2020-02-14,3호선,양재,46346,48278,94624
1942,2020-02-14,3호선,매봉,13141,12394,25535
1943,2020-02-14,3호선,도곡,6076,6070,12146
1944,2020-02-14,3호선,대치,13845,13516,27361
1945,2020-02-14,3호선,학여울,2086,2036,4122
1946,2020-02-14,3호선,대청,10864,9955,20819
1947,2020-02-14,3호선,일원,10721,10323,21044
1948,2020-02-14,3호선,수서,20070,19540,39610
1949,2020-02-14,3호선,가락시장,10821,10609,21430
1950,2020-02-14,3호선,경찰병원,8817,8760,17577
1951,2020-02-14,3호선,오금,7324,6336,13660
1952,2020-02-14,3호선,원흥,10170,9253,19423
1953,2020-02-14,3호선,삼송,19605,18266,37871
1954,2020-02-14,3호선,원당,12311,11671,23982
1955,2020-02-14,3호선,화정,20492,21293,41785
1956,2020-02-14,3호선,대곡,1809,1316,3125
1957,2020-02-14,3호선,백석,11804,11893,23697
1958,2020-02-14,3호선,마두,8817,9214,18031
1959,2020-02-14,3호선,정발산,8955,9893,18848
1960,2020-02-14,3호선,주엽,9797,10073,19870
1961,2020-02-14,3호선,대화,15381,11909,27290
1962,2020-02-15,3호선,지축,1863,1836,3699
1963,2020-02-15,3호선,구파발,16272,15495,31767
1964,2020-02-15,3호선,연신내,33302,31446,64748
1965,2020-02-15,3호선,불광,13831,15790,29621
1966,2020-02-15,3호선,녹번,9844,8488,18332
1967,2020-02-15,3호선,홍제,14524,13661,28185
1968,2020-02-15,3호선,무악재,2887,3172,6059
1969,2020-02-15,3호선,독립문,5783,6088,11871
1970,2020-02-15,3호선,경복궁,17190,16015,33205
1971,2020-02-15,3호선,안국,14766,16335,31101
1972,2020-02-15,3호선,종로3가,7207,10229,17436
1973,2020-02-15,3호선,을지로3가,5659,6191,11850
1974,2020-02-15,3호선,동대입구,6668,7311,13979
1975,2020-02-15,3호선,약수,10057,9411,19468
1976,2020-02-15,3호선,금호,6455,5858,12313
1977,2020-02-15,3호선,옥수,7125,7265,14390
1978,2020-02-15,3호선,압구정,27140,28877,56017
1979,2020-02-15,3호선,신사,28006,29978,57984
1980,2020-02-15,3호선,잠원,4260,4013,8273
1981,2020-02-15,3호선,고속터미널,55262,54961,110223
1982,2020-02-15,3호선,교대,7579,4506,12085
1983,2020-02-15,3호선,남부터미널,25635,25519,51154
1984,2020-02-15,3호선,양재,23969,25686,49655
1985,2020-02-15,3호선,매봉,5797,5501,11298
1986,2020-02-15,3호선,도곡,4017,4095,8112
1987,2020-02-15,3호선,대치,9947,9073,19020
1988,2020-02-15,3호선,학여울,1737,1759,3496
1989,2020-02-15,3호선,대청,6516,5927,12443
1990,2020-02-15,3호선,일원,4969,4894,9863
1991,2020-02-15,3호선,수서,13858,13767,27625
1992,2020-02-15,3호선,가락시장,6867,6591,13458
1993,2020-02-15,3호선,경찰병원,4475,4259,8734
1994,2020-02-15,3호선,오금,4319,3973,8292
1995,2020-02-15,3호선,원흥,6663,5969,12632
1996,2020-02-15,3호선,삼송,13602,12915,26517
1997,2020-02-15,3호선,원당,8705,8066,16771
1998,2020-02-15,3호선,화정,14498,15123,29621
1999,2020-02-15,3호선,대곡,1222,1062,2284
2000,2020-02-15,3호선,백석,8563,8671,17234
2001,2020-02-15,3호선,마두,5725,5736,11461
2002,2020-02-15,3호선,정발산,7119,7814,14933
2003,2020-02-15,3호선,주엽,6731,6691,13422
2004,2020-02-15,3호선,대화,9801,8278,18079
2005,2020-02-16,3호선,지축,1239,1271,2510
2006,2020-02-16,3호선,구파발,11806,12054,23860
2007,2020-02-16,3호선,연신내,23450,22156,45606
2008,2020-02-16,3호선,녹번,6439,5691,12130
2009,2020-02-16,3호선,홍제,9493,9142,18635
2010,2020-02-16,3호선,무악재,1994,2118,4112
2011,2020-02-16,3호선,독립문,3949,4032,7981
2012,2020-02-16,3호선,경복궁,10234,10322,20556
2013,2020-02-16,3호선,안국,9108,9681,18789
2014,2020-02-16,3호선,종로3가,4181,5535,9716
2015,2020-02-16,3호선,을지로3가,3550,3561,7111
2016,2020-02-16,3호선,동대입구,5044,5503,10547
2017,2020-02-16,3호선,약수,7117,6715,13832
2018,2020-02-16,3호선,금호,4442,4308,8750
2019,2020-02-16,3호선,옥수,4781,5031,9812
2020,2020-02-16,3호선,압구정,15851,16348,32199
2021,2020-02-16,3호선,신사,16056,16056,32112
2022,2020-02-16,3호선,잠원,2710,2838,5548
2023,2020-02-16,3호선,고속터미널,44074,41850,85924
2024,2020-02-16,3호선,교대,4339,2792,7131
2025,2020-02-16,3호선,남부터미널,16915,17790,34705
2026,2020-02-16,3호선,양재,15489,17389,32878
2027,2020-02-16,3호선,매봉,3753,3748,7501
2028,2020-02-16,3호선,도곡,2128,2198,4326
2029,2020-02-16,3호선,대치,6568,5853,12421
2030,2020-02-16,3호선,학여울,1139,1224,2363
2031,2020-02-16,3호선,대청,4157,4021,8178
2032,2020-02-16,3호선,일원,3718,4019,7737
2033,2020-02-16,3호선,수서,10684,10561,21245
2034,2020-02-16,3호선,가락시장,3976,4238,8214
2035,2020-02-16,3호선,경찰병원,3212,3289,6501
2036,2020-02-16,3호선,오금,3135,2984,6119
2037,2020-02-16,3호선,원흥,4608,4393,9001
2038,2020-02-16,3호선,삼송,9798,9554,19352
2039,2020-02-16,3호선,원당,6130,5960,12090
2040,2020-02-16,3호선,화정,11410,11765,23175
2041,2020-02-16,3호선,대곡,839,690,1529
2042,2020-02-16,3호선,백석,6268,6206,12474
2043,2020-02-16,3호선,마두,3909,3870,7779
2044,2020-02-16,3호선,정발산,5816,5736,11552
2045,2020-02-16,3호선,주엽,4397,4425,8822
2046,2020-02-16,3호선,대화,6911,6285,13196
2047,2020-02-16,3호선,불광,9882,11461,21343
2048,2020-02-17,3호선,지축,2746,2861,5607
2049,2020-02-17,3호선,구파발,23178,20985,44163
2050,2020-02-17,3호선,연신내,41100,38731,79831
2051,2020-02-17,3호선,불광,17215,18678,35893
2052,2020-02-17,3호선,녹번,14361,12869,27230
2053,2020-02-17,3호선,홍제,18295,17502,35797
2054,2020-02-17,3호선,무악재,4226,4251,8477
2055,2020-02-17,3호선,독립문,6882,6851,13733
2056,2020-02-17,3호선,경복궁,21358,21555,42913
2057,2020-02-17,3호선,안국,21776,22510,44286
2058,2020-02-17,3호선,종로3가,11618,13548,25166
2059,2020-02-17,3호선,을지로3가,12393,12927,25320
2060,2020-02-17,3호선,충무로,2,0,2
2061,2020-02-17,3호선,동대입구,7914,8513,16427
2062,2020-02-17,3호선,약수,14085,13684,27769
2063,2020-02-17,3호선,금호,8948,8248,17196
2064,2020-02-17,3호선,옥수,9620,10096,19716
2065,2020-02-17,3호선,압구정,34508,37442,71950
2066,2020-02-17,3호선,신사,34023,36487,70510
2067,2020-02-17,3호선,잠원,6769,6371,13140
2068,2020-02-17,3호선,고속터미널,44911,42764,87675
2069,2020-02-17,3호선,교대,15687,10408,26095
2070,2020-02-17,3호선,남부터미널,32431,33002,65433
2071,2020-02-17,3호선,양재,42528,46154,88682
2072,2020-02-17,3호선,매봉,13215,12499,25714
2073,2020-02-17,3호선,도곡,6014,6098,12112
2074,2020-02-17,3호선,대치,13278,13106,26384
2075,2020-02-17,3호선,학여울,1911,1959,3870
2076,2020-02-17,3호선,대청,10646,9830,20476
2077,2020-02-17,3호선,일원,11219,11238,22457
2078,2020-02-17,3호선,수서,18479,19005,37484
2079,2020-02-17,3호선,가락시장,10380,10105,20485
2080,2020-02-17,3호선,경찰병원,9515,9342,18857
2081,2020-02-17,3호선,오금,7418,6455,13873
2082,2020-02-17,3호선,원흥,9361,8853,18214
2083,2020-02-17,3호선,삼송,18248,17932,36180
2084,2020-02-17,3호선,원당,11545,11132,22677
2085,2020-02-17,3호선,화정,18970,19712,38682
2086,2020-02-17,3호선,대곡,1834,1231,3065
2087,2020-02-17,3호선,백석,11079,11271,22350
2088,2020-02-17,3호선,마두,8410,8808,17218
2089,2020-02-17,3호선,정발산,7674,8213,15887
2090,2020-02-17,3호선,주엽,9236,9487,18723
2091,2020-02-17,3호선,대화,15462,11840,27302
2092,2020-02-18,3호선,지축,2840,2815,5655
2093,2020-02-18,3호선,구파발,23001,21181,44182
2094,2020-02-18,3호선,연신내,41045,39151,80196
2095,2020-02-18,3호선,불광,17595,19066,36661
2096,2020-02-18,3호선,녹번,14502,12853,27355
2097,2020-02-18,3호선,홍제,18445,17439,35884
2098,2020-02-18,3호선,무악재,4227,4183,8410
2099,2020-02-18,3호선,독립문,7076,7213,14289
2100,2020-02-18,3호선,경복궁,21104,20513,41617
2101,2020-02-18,3호선,안국,21851,22920,44771
2102,2020-02-18,3호선,종로3가,11552,13475,25027
2103,2020-02-18,3호선,을지로3가,12408,12846,25254
2104,2020-02-18,3호선,충무로,1,0,1
2105,2020-02-18,3호선,동대입구,8588,9205,17793
2106,2020-02-18,3호선,약수,14473,13877,28350
2107,2020-02-18,3호선,금호,8864,8263,17127
2108,2020-02-18,3호선,옥수,9858,10155,20013
2109,2020-02-18,3호선,압구정,34764,37571,72335
2110,2020-02-18,3호선,신사,34857,37331,72188
2111,2020-02-18,3호선,잠원,6497,6267,12764
2112,2020-02-18,3호선,고속터미널,44601,42587,87188
2113,2020-02-18,3호선,교대,15880,10393,26273
2114,2020-02-18,3호선,남부터미널,32453,33386,65839
2115,2020-02-18,3호선,양재,43022,46405,89427
2116,2020-02-18,3호선,매봉,13059,12480,25539
2117,2020-02-18,3호선,도곡,5725,5790,11515
2118,2020-02-18,3호선,대치,13138,12747,25885
2119,2020-02-18,3호선,학여울,1948,1947,3895
2120,2020-02-18,3호선,대청,10602,9882,20484
2121,2020-02-18,3호선,일원,10706,10548,21254
2122,2020-02-18,3호선,수서,17727,17811,35538
2123,2020-02-18,3호선,가락시장,10044,9865,19909
2124,2020-02-18,3호선,경찰병원,8693,8904,17597
2125,2020-02-18,3호선,오금,7180,6293,13473
2126,2020-02-18,3호선,원흥,9091,8677,17768
2127,2020-02-18,3호선,삼송,18246,17312,35558
2128,2020-02-18,3호선,원당,11566,11032,22598
2129,2020-02-18,3호선,화정,19095,19859,38954
2130,2020-02-18,3호선,대곡,1729,1257,2986
2131,2020-02-18,3호선,백석,10743,10632,21375
2132,2020-02-18,3호선,마두,8006,8411,16417
2133,2020-02-18,3호선,정발산,7585,7998,15583
2134,2020-02-18,3호선,주엽,9227,9407,18634
2135,2020-02-18,3호선,대화,14726,11424,26150
2136,2020-02-19,3호선,지축,2940,2917,5857
2137,2020-02-19,3호선,구파발,23192,21383,44575
2138,2020-02-19,3호선,연신내,42438,40558,82996
2139,2020-02-19,3호선,불광,17966,19321,37287
2140,2020-02-19,3호선,녹번,14678,12992,27670
2141,2020-02-19,3호선,홍제,18761,17959,36720
2142,2020-02-19,3호선,무악재,4235,4227,8462
2143,2020-02-19,3호선,독립문,7387,7629,15016
2144,2020-02-19,3호선,경복궁,22518,22771,45289
2145,2020-02-19,3호선,안국,22275,22976,45251
2146,2020-02-19,3호선,종로3가,11541,13408,24949
2147,2020-02-19,3호선,을지로3가,12965,13150,26115
2148,2020-02-19,3호선,충무로,2,0,2
2149,2020-02-19,3호선,동대입구,8313,8950,17263
2150,2020-02-19,3호선,약수,14156,14002,28158
2151,2020-02-19,3호선,금호,8951,8295,17246
2152,2020-02-19,3호선,옥수,9558,9991,19549
2153,2020-02-19,3호선,압구정,34876,37901,72777
2154,2020-02-19,3호선,신사,34860,37367,72227
2155,2020-02-19,3호선,잠원,6618,6269,12887
2156,2020-02-19,3호선,고속터미널,44234,42470,86704
2157,2020-02-19,3호선,교대,15919,10491,26410
2158,2020-02-19,3호선,남부터미널,33645,34444,68089
2159,2020-02-19,3호선,양재,43365,46994,90359
2160,2020-02-19,3호선,매봉,12963,12431,25394
2161,2020-02-19,3호선,도곡,5785,5889,11674
2162,2020-02-19,3호선,대치,12940,12542,25482
2163,2020-02-19,3호선,학여울,2062,2019,4081
2164,2020-02-19,3호선,대청,10518,9733,20251
2165,2020-02-19,3호선,일원,10592,10559,21151
2166,2020-02-19,3호선,수서,18035,17880,35915
2167,2020-02-19,3호선,가락시장,10000,9906,19906
2168,2020-02-19,3호선,경찰병원,8737,8809,17546
2169,2020-02-19,3호선,오금,7159,6201,13360
2170,2020-02-19,3호선,원흥,9431,8909,18340
2171,2020-02-19,3호선,삼송,18856,18176,37032
2172,2020-02-19,3호선,원당,11898,11301,23199
2173,2020-02-19,3호선,화정,19086,19742,38828
2174,2020-02-19,3호선,대곡,1790,1305,3095
2175,2020-02-19,3호선,백석,11059,10934,21993
2176,2020-02-19,3호선,마두,8529,8992,17521
2177,2020-02-19,3호선,정발산,7876,8254,16130
2178,2020-02-19,3호선,주엽,9457,9753,19210
2179,2020-02-19,3호선,대화,15246,11587,26833
2180,2020-02-20,3호선,지축,3000,2937,5937
2181,2020-02-20,3호선,구파발,22751,21001,43752
2182,2020-02-20,3호선,연신내,41355,39210,80565
2183,2020-02-20,3호선,불광,17196,18677,35873
2184,2020-02-20,3호선,녹번,14427,12719,27146
2185,2020-02-20,3호선,홍제,18423,17397,35820
2186,2020-02-20,3호선,무악재,4190,4283,8473
2187,2020-02-20,3호선,독립문,7151,7453,14604
2188,2020-02-20,3호선,경복궁,21154,21187,42341
2189,2020-02-20,3호선,안국,21810,22928,44738
2190,2020-02-20,3호선,종로3가,11434,13194,24628
2191,2020-02-20,3호선,을지로3가,12315,12930,25245
2192,2020-02-20,3호선,충무로,4,0,4
2193,2020-02-20,3호선,동대입구,8599,9419,18018
2194,2020-02-20,3호선,약수,14052,13649,27701
2195,2020-02-20,3호선,금호,8625,7994,16619
2196,2020-02-20,3호선,옥수,9570,9735,19305
2197,2020-02-20,3호선,압구정,33993,36739,70732
2198,2020-02-20,3호선,신사,34689,37521,72210
2199,2020-02-20,3호선,잠원,6413,6218,12631
2200,2020-02-20,3호선,고속터미널,43829,42658,86487
2201,2020-02-20,3호선,교대,16323,10588,26911
2202,2020-02-20,3호선,남부터미널,32531,33232,65763
2203,2020-02-20,3호선,양재,43295,47009,90304
2204,2020-02-20,3호선,매봉,12719,12185,24904
2205,2020-02-20,3호선,도곡,5611,5762,11373
2206,2020-02-20,3호선,대치,12683,12356,25039
2207,2020-02-20,3호선,학여울,2056,2089,4145
2208,2020-02-20,3호선,대청,10370,9544,19914
2209,2020-02-20,3호선,일원,10408,10181,20589
2210,2020-02-20,3호선,수서,18033,18010,36043
2211,2020-02-20,3호선,가락시장,10061,9777,19838
2212,2020-02-20,3호선,경찰병원,8423,8368,16791
2213,2020-02-20,3호선,오금,7131,6219,13350
2214,2020-02-20,3호선,원흥,9422,8747,18169
2215,2020-02-20,3호선,삼송,18562,17705,36267
2216,2020-02-20,3호선,원당,11801,11210,23011
2217,2020-02-20,3호선,화정,18618,19197,37815
2218,2020-02-20,3호선,대곡,1810,1277,3087
2219,2020-02-20,3호선,백석,10974,10990,21964
2220,2020-02-20,3호선,마두,8398,8649,17047
2221,2020-02-20,3호선,정발산,7847,8205,16052
2222,2020-02-20,3호선,주엽,9299,9454,18753
2223,2020-02-20,3호선,대화,15116,11663,26779
2224,2020-02-21,3호선,지축,2794,2770,5564
2225,2020-02-21,3호선,구파발,20158,18068,38226
2226,2020-02-21,3호선,연신내,40000,37700,77700
2227,2020-02-21,3호선,불광,16622,17704,34326
2228,2020-02-21,3호선,녹번,13932,12186,26118
2229,2020-02-21,3호선,홍제,17908,16675,34583
2230,2020-02-21,3호선,무악재,4026,3964,7990
2231,2020-02-21,3호선,독립문,6639,6812,13451
2232,2020-02-21,3호선,경복궁,19451,19312,38763
2233,2020-02-21,3호선,안국,20666,20946,41612
2234,2020-02-21,3호선,종로3가,11019,12765,23784
2235,2020-02-21,3호선,을지로3가,11905,12200,24105
2236,2020-02-21,3호선,충무로,1,0,1
2237,2020-02-21,3호선,동대입구,8304,8919,17223
2238,2020-02-21,3호선,약수,13823,13644,27467
2239,2020-02-21,3호선,금호,8629,7782,16411
2240,2020-02-21,3호선,옥수,9307,9477,18784
2241,2020-02-21,3호선,압구정,34277,37056,71333
2242,2020-02-21,3호선,신사,34554,37593,72147
2243,2020-02-21,3호선,잠원,6292,6013,12305
2244,2020-02-21,3호선,고속터미널,44955,46750,91705
2245,2020-02-21,3호선,교대,15374,10172,25546
2246,2020-02-21,3호선,남부터미널,33590,33870,67460
2247,2020-02-21,3호선,양재,42796,45031,87827
2248,2020-02-21,3호선,매봉,12246,11738,23984
2249,2020-02-21,3호선,도곡,5614,5625,11239
2250,2020-02-21,3호선,대치,12369,12200,24569
2251,2020-02-21,3호선,학여울,1829,1820,3649
2252,2020-02-21,3호선,대청,10036,9283,19319
2253,2020-02-21,3호선,일원,9807,9485,19292
2254,2020-02-21,3호선,수서,18486,18098,36584
2255,2020-02-21,3호선,가락시장,9924,9599,19523
2256,2020-02-21,3호선,경찰병원,8174,8104,16278
2257,2020-02-21,3호선,오금,6747,5949,12696
2258,2020-02-21,3호선,원흥,9071,8403,17474
2259,2020-02-21,3호선,삼송,17490,16608,34098
2260,2020-02-21,3호선,원당,11141,10687,21828
2261,2020-02-21,3호선,화정,17306,18017,35323
2262,2020-02-21,3호선,대곡,1711,1237,2948
2263,2020-02-21,3호선,백석,10528,10621,21149
2264,2020-02-21,3호선,마두,7950,8251,16201
2265,2020-02-21,3호선,정발산,7498,8041,15539
2266,2020-02-21,3호선,주엽,8689,9023,17712
2267,2020-02-21,3호선,대화,14085,10864,24949
2268,2020-02-22,3호선,지축,1516,1576,3092
2269,2020-02-22,3호선,구파발,11014,10670,21684
2270,2020-02-22,3호선,연신내,26107,24773,50880
2271,2020-02-22,3호선,불광,10550,11824,22374
2272,2020-02-22,3호선,녹번,7602,6608,14210
2273,2020-02-22,3호선,홍제,11092,10677,21769
2274,2020-02-22,3호선,무악재,2178,2219,4397
2275,2020-02-22,3호선,독립문,4291,4356,8647
2276,2020-02-22,3호선,경복궁,11496,10820,22316
2277,2020-02-22,3호선,안국,9491,10536,20027
2278,2020-02-22,3호선,종로3가,5064,6549,11613
2279,2020-02-22,3호선,을지로3가,4275,4552,8827
2280,2020-02-22,3호선,충무로,2,0,2
2281,2020-02-22,3호선,동대입구,5321,5783,11104
2282,2020-02-22,3호선,약수,8094,7701,15795
2283,2020-02-22,3호선,금호,5021,4509,9530
2284,2020-02-22,3호선,옥수,5488,5608,11096
2285,2020-02-22,3호선,압구정,21832,22969,44801
2286,2020-02-22,3호선,신사,22722,24326,47048
2287,2020-02-22,3호선,잠원,3576,3346,6922
2288,2020-02-22,3호선,고속터미널,38955,38984,77939
2289,2020-02-22,3호선,교대,5720,3597,9317
2290,2020-02-22,3호선,남부터미널,20116,20010,40126
2291,2020-02-22,3호선,양재,18954,20080,39034
2292,2020-02-22,3호선,매봉,4432,4285,8717
2293,2020-02-22,3호선,도곡,3007,3250,6257
2294,2020-02-22,3호선,대치,8320,7509,15829
2295,2020-02-22,3호선,학여울,886,898,1784
2296,2020-02-22,3호선,대청,5102,4760,9862
2297,2020-02-22,3호선,일원,3942,3867,7809
2298,2020-02-22,3호선,수서,9978,9756,19734
2299,2020-02-22,3호선,가락시장,5356,4918,10274
2300,2020-02-22,3호선,경찰병원,3629,3487,7116
2301,2020-02-22,3호선,오금,3718,3302,7020
2302,2020-02-22,3호선,원흥,5010,4728,9738
2303,2020-02-22,3호선,삼송,10143,9694,19837
2304,2020-02-22,3호선,원당,6772,6420,13192
2305,2020-02-22,3호선,화정,10782,11136,21918
2306,2020-02-22,3호선,대곡,922,782,1704
2307,2020-02-22,3호선,백석,6637,6681,13318
2308,2020-02-22,3호선,마두,4220,4307,8527
2309,2020-02-22,3호선,정발산,5375,5789,11164
2310,2020-02-22,3호선,주엽,4810,4870,9680
2311,2020-02-22,3호선,대화,7182,6345,13527
2312,2020-02-23,3호선,지축,1006,1002,2008
2313,2020-02-23,3호선,구파발,8177,8202,16379
2314,2020-02-23,3호선,연신내,16974,15934,32908
2315,2020-02-23,3호선,불광,7535,8755,16290
2316,2020-02-23,3호선,녹번,4900,4292,9192
2317,2020-02-23,3호선,홍제,7002,6807,13809
2318,2020-02-23,3호선,무악재,1394,1514,2908
2319,2020-02-23,3호선,독립문,3000,3250,6250
2320,2020-02-23,3호선,경복궁,7765,7687,15452
2321,2020-02-23,3호선,안국,6442,6800,13242
2322,2020-02-23,3호선,종로3가,2671,3464,6135
2323,2020-02-23,3호선,을지로3가,2466,2483,4949
2324,2020-02-23,3호선,동대입구,5868,6522,12390
2325,2020-02-23,3호선,약수,5507,5344,10851
2326,2020-02-23,3호선,금호,3333,3285,6618
2327,2020-02-23,3호선,옥수,3688,3887,7575
2328,2020-02-23,3호선,압구정,11157,11592,22749
2329,2020-02-23,3호선,신사,12655,12686,25341
2330,2020-02-23,3호선,잠원,1904,1986,3890
2331,2020-02-23,3호선,고속터미널,26816,25718,52534
2332,2020-02-23,3호선,교대,3401,2124,5525
2333,2020-02-23,3호선,남부터미널,12188,13072,25260
2334,2020-02-23,3호선,양재,10677,12396,23073
2335,2020-02-23,3호선,매봉,2655,2651,5306
2336,2020-02-23,3호선,도곡,1597,1695,3292
2337,2020-02-23,3호선,대치,4874,4243,9117
2338,2020-02-23,3호선,학여울,612,583,1195
2339,2020-02-23,3호선,대청,3153,2994,6147
2340,2020-02-23,3호선,일원,2466,2759,5225
2341,2020-02-23,3호선,수서,7168,7071,14239
2342,2020-02-23,3호선,가락시장,2765,3032,5797
2343,2020-02-23,3호선,경찰병원,2110,2224,4334
2344,2020-02-23,3호선,오금,2304,2166,4470
2345,2020-02-23,3호선,원흥,3318,3255,6573
2346,2020-02-23,3호선,삼송,6984,6881,13865
2347,2020-02-23,3호선,원당,4639,4421,9060
2348,2020-02-23,3호선,화정,7257,7540,14797
2349,2020-02-23,3호선,대곡,693,588,1281
2350,2020-02-23,3호선,백석,4631,4515,9146
2351,2020-02-23,3호선,마두,2549,2499,5048
2352,2020-02-23,3호선,정발산,3692,3781,7473
2353,2020-02-23,3호선,주엽,3160,3086,6246
2354,2020-02-23,3호선,대화,4959,4420,9379
2355,2020-02-24,3호선,지축,2480,2567,5047
2356,2020-02-24,3호선,구파발,17187,15662,32849
2357,2020-02-24,3호선,연신내,33427,31554,64981
2358,2020-02-24,3호선,불광,14290,15374,29664
2359,2020-02-24,3호선,녹번,12323,11131,23454
2360,2020-02-24,3호선,홍제,15472,14572,30044
2361,2020-02-24,3호선,무악재,3436,3470,6906
2362,2020-02-24,3호선,독립문,5918,5945,11863
2363,2020-02-24,3호선,경복궁,16015,16098,32113
2364,2020-02-24,3호선,안국,18196,18327,36523
2365,2020-02-24,3호선,종로3가,9767,11144,20911
2366,2020-02-24,3호선,을지로3가,10692,10971,21663
2367,2020-02-24,3호선,충무로,3,0,3
2368,2020-02-24,3호선,동대입구,6929,7367,14296
2369,2020-02-24,3호선,약수,11830,11631,23461
2370,2020-02-24,3호선,금호,7457,7003,14460
2371,2020-02-24,3호선,옥수,7793,8095,15888
2372,2020-02-24,3호선,압구정,28291,30559,58850
2373,2020-02-24,3호선,신사,27791,29596,57387
2374,2020-02-24,3호선,잠원,4887,4926,9813
2375,2020-02-24,3호선,고속터미널,29411,27791,57202
2376,2020-02-24,3호선,교대,13362,8912,22274
2377,2020-02-24,3호선,남부터미널,25219,26120,51339
2378,2020-02-24,3호선,양재,35358,38601,73959
2379,2020-02-24,3호선,매봉,10683,10207,20890
2380,2020-02-24,3호선,도곡,4632,4640,9272
2381,2020-02-24,3호선,대치,9379,9178,18557
2382,2020-02-24,3호선,학여울,1525,1554,3079
2383,2020-02-24,3호선,대청,8679,8035,16714
2384,2020-02-24,3호선,일원,8020,8047,16067
2385,2020-02-24,3호선,수서,13471,13708,27179
2386,2020-02-24,3호선,가락시장,7916,7778,15694
2387,2020-02-24,3호선,경찰병원,7265,7199,14464
2388,2020-02-24,3호선,오금,5973,5293,11266
2389,2020-02-24,3호선,원흥,7976,7559,15535
2390,2020-02-24,3호선,삼송,15159,14566,29725
2391,2020-02-24,3호선,원당,9737,9397,19134
2392,2020-02-24,3호선,화정,14638,14880,29518
2393,2020-02-24,3호선,대곡,1451,1014,2465
2394,2020-02-24,3호선,백석,8522,8554,17076
2395,2020-02-24,3호선,마두,6199,6516,12715
2396,2020-02-24,3호선,정발산,5898,6113,12011
2397,2020-02-24,3호선,주엽,7173,7480,14653
2398,2020-02-24,3호선,대화,12201,9057,21258
2399,2020-02-25,3호선,지축,2251,2321,4572
2400,2020-02-25,3호선,구파발,15961,14385,30346
2401,2020-02-25,3호선,연신내,31262,29466,60728
2402,2020-02-25,3호선,불광,13059,14001,27060
2403,2020-02-25,3호선,녹번,11521,10388,21909
2404,2020-02-25,3호선,홍제,14109,13447,27556
2405,2020-02-25,3호선,무악재,3270,3218,6488
2406,2020-02-25,3호선,독립문,5134,5157,10291
2407,2020-02-25,3호선,경복궁,15426,14979,30405
2408,2020-02-25,3호선,안국,16450,16756,33206
2409,2020-02-25,3호선,종로3가,8500,9653,18153
2410,2020-02-25,3호선,을지로3가,10007,10529,20536
2411,2020-02-25,3호선,충무로,3,0,3
2412,2020-02-25,3호선,동대입구,6387,6701,13088
2413,2020-02-25,3호선,약수,11165,11067,22232
2414,2020-02-25,3호선,금호,6731,6333,13064
2415,2020-02-25,3호선,옥수,6986,7332,14318
2416,2020-02-25,3호선,압구정,26444,28590,55034
2417,2020-02-25,3호선,신사,25742,27746,53488
2418,2020-02-25,3호선,잠원,4477,4400,8877
2419,2020-02-25,3호선,고속터미널,26066,24938,51004
2420,2020-02-25,3호선,교대,11782,7988,19770
2421,2020-02-25,3호선,남부터미널,23655,24430,48085
2422,2020-02-25,3호선,양재,33464,36213,69677
2423,2020-02-25,3호선,매봉,10102,9755,19857
2424,2020-02-25,3호선,도곡,4118,4110,8228
2425,2020-02-25,3호선,대치,7947,7919,15866
2426,2020-02-25,3호선,학여울,1350,1313,2663
2427,2020-02-25,3호선,대청,7939,7292,15231
2428,2020-02-25,3호선,일원,7325,7338,14663
2429,2020-02-25,3호선,수서,11972,12069,24041
2430,2020-02-25,3호선,가락시장,7345,6953,14298
2431,2020-02-25,3호선,경찰병원,6516,6531,13047
2432,2020-02-25,3호선,오금,5471,4753,10224
2433,2020-02-25,3호선,원흥,7332,6896,14228
2434,2020-02-25,3호선,삼송,13957,13551,27508
2435,2020-02-25,3호선,원당,8754,8523,17277
2436,2020-02-25,3호선,화정,13287,13875,27162
2437,2020-02-25,3호선,대곡,1277,905,2182
2438,2020-02-25,3호선,백석,8024,8065,16089
2439,2020-02-25,3호선,마두,5557,5764,11321
2440,2020-02-25,3호선,정발산,5374,5499,10873
2441,2020-02-25,3호선,주엽,6348,6620,12968
2442,2020-02-25,3호선,대화,11174,8383,19557
2443,2020-02-26,3호선,지축,2322,2434,4756
2444,2020-02-26,3호선,구파발,16003,14420,30423
2445,2020-02-26,3호선,연신내,31973,30058,62031
2446,2020-02-26,3호선,불광,13319,14314,27633
2447,2020-02-26,3호선,녹번,11564,10437,22001
2448,2020-02-26,3호선,홍제,14333,13704,28037
2449,2020-02-26,3호선,무악재,3188,3233,6421
2450,2020-02-26,3호선,독립문,5447,5507,10954
2451,2020-02-26,3호선,경복궁,15977,15865,31842
2452,2020-02-26,3호선,안국,16644,16972,33616
2453,2020-02-26,3호선,종로3가,8660,9875,18535
2454,2020-02-26,3호선,을지로3가,9972,10237,20209
2455,2020-02-26,3호선,충무로,1,0,1
2456,2020-02-26,3호선,동대입구,6395,6841,13236
2457,2020-02-26,3호선,약수,11017,10904,21921
2458,2020-02-26,3호선,금호,6803,6369,13172
2459,2020-02-26,3호선,옥수,7158,7351,14509
2460,2020-02-26,3호선,압구정,25652,27677,53329
2461,2020-02-26,3호선,신사,25887,27657,53544
2462,2020-02-26,3호선,잠원,4413,4392,8805
2463,2020-02-26,3호선,고속터미널,25639,24616,50255
2464,2020-02-26,3호선,교대,11614,7917,19531
2465,2020-02-26,3호선,남부터미널,23194,23953,47147
2466,2020-02-26,3호선,양재,32483,35067,67550
2467,2020-02-26,3호선,매봉,10092,9558,19650
2468,2020-02-26,3호선,도곡,4013,4042,8055
2469,2020-02-26,3호선,대치,7663,7620,15283
2470,2020-02-26,3호선,학여울,1346,1361,2707
2471,2020-02-26,3호선,대청,7979,7395,15374
2472,2020-02-26,3호선,일원,6975,6987,13962
2473,2020-02-26,3호선,수서,11511,11739,23250
2474,2020-02-26,3호선,가락시장,7132,6971,14103
2475,2020-02-26,3호선,경찰병원,6218,6218,12436
2476,2020-02-26,3호선,오금,5280,4670,9950
2477,2020-02-26,3호선,원흥,7429,7031,14460
2478,2020-02-26,3호선,삼송,13887,13523,27410
2479,2020-02-26,3호선,원당,8955,8724,17679
2480,2020-02-26,3호선,화정,13274,13557,26831
2481,2020-02-26,3호선,대곡,1325,954,2279
2482,2020-02-26,3호선,백석,7891,7971,15862
2483,2020-02-26,3호선,마두,5552,5900,11452
2484,2020-02-26,3호선,정발산,5489,5451,10940
2485,2020-02-26,3호선,주엽,6484,6630,13114
2486,2020-02-26,3호선,대화,11085,8510,19595
2487,2020-02-27,3호선,지축,2276,2319,4595
2488,2020-02-27,3호선,구파발,15284,13657,28941
2489,2020-02-27,3호선,연신내,31199,29229,60428
2490,2020-02-27,3호선,불광,12960,13989,26949
2491,2020-02-27,3호선,녹번,11330,10147,21477
2492,2020-02-27,3호선,홍제,13858,13268,27126
2493,2020-02-27,3호선,무악재,3259,3232,6491
2494,2020-02-27,3호선,독립문,5148,5269,10417
2495,2020-02-27,3호선,경복궁,14800,14608,29408
2496,2020-02-27,3호선,안국,15850,16316,32166
2497,2020-02-27,3호선,종로3가,8400,9519,17919
2498,2020-02-27,3호선,을지로3가,9479,9993,19472
2499,2020-02-27,3호선,충무로,1,0,1
2500,2020-02-27,3호선,동대입구,6308,6716,13024
2501,2020-02-27,3호선,약수,10756,10481,21237
2502,2020-02-27,3호선,금호,6493,6038,12531
2503,2020-02-27,3호선,옥수,6948,7170,14118
2504,2020-02-27,3호선,압구정,24411,26272,50683
2505,2020-02-27,3호선,신사,24991,26909,51900
2506,2020-02-27,3호선,잠원,4272,4256,8528
2507,2020-02-27,3호선,고속터미널,24867,24334,49201
2508,2020-02-27,3호선,교대,12190,7980,20170
2509,2020-02-27,3호선,남부터미널,22375,23102,45477
2510,2020-02-27,3호선,양재,31633,34145,65778
2511,2020-02-27,3호선,매봉,9605,9199,18804
2512,2020-02-27,3호선,도곡,3897,3945,7842
2513,2020-02-27,3호선,대치,7353,7263,14616
2514,2020-02-27,3호선,학여울,1314,1320,2634
2515,2020-02-27,3호선,대청,7711,7190,14901
2516,2020-02-27,3호선,일원,6890,6707,13597
2517,2020-02-27,3호선,수서,11411,11548,22959
2518,2020-02-27,3호선,가락시장,6987,6976,13963
2519,2020-02-27,3호선,경찰병원,5983,5946,11929
2520,2020-02-27,3호선,오금,5121,4495,9616
2521,2020-02-27,3호선,원흥,7257,6977,14234
2522,2020-02-27,3호선,삼송,13563,13407,26970
2523,2020-02-27,3호선,원당,8803,8440,17243
2524,2020-02-27,3호선,화정,13173,13452,26625
2525,2020-02-27,3호선,대곡,1360,960,2320
2526,2020-02-27,3호선,백석,8017,8024,16041
2527,2020-02-27,3호선,마두,5427,5783,11210
2528,2020-02-27,3호선,정발산,5233,5307,10540
2529,2020-02-27,3호선,주엽,6327,6472,12799
2530,2020-02-27,3호선,대화,10667,8176,18843
2531,2020-02-28,3호선,지축,2182,2161,4343
2532,2020-02-28,3호선,구파발,13914,12234,26148
2533,2020-02-28,3호선,연신내,29822,28040,57862
2534,2020-02-28,3호선,불광,12250,13061,25311
2535,2020-02-28,3호선,녹번,10903,9626,20529
2536,2020-02-28,3호선,홍제,13546,12900,26446
2537,2020-02-28,3호선,무악재,2966,3013,5979
2538,2020-02-28,3호선,독립문,4828,5023,9851
2539,2020-02-28,3호선,경복궁,13572,13542,27114
2540,2020-02-28,3호선,안국,15256,15271,30527
2541,2020-02-28,3호선,종로3가,8400,9587,17987
2542,2020-02-28,3호선,을지로3가,9198,9454,18652
2543,2020-02-28,3호선,동대입구,6006,6305,12311
2544,2020-02-28,3호선,약수,10491,10310,20801
2545,2020-02-28,3호선,금호,6437,5941,12378
2546,2020-02-28,3호선,옥수,6630,6720,13350
2547,2020-02-28,3호선,압구정,23828,26050,49878
2548,2020-02-28,3호선,신사,24579,26671,51250
2549,2020-02-28,3호선,잠원,3956,3863,7819
2550,2020-02-28,3호선,고속터미널,23477,24773,48250
2551,2020-02-28,3호선,교대,10826,7362,18188
2552,2020-02-28,3호선,남부터미널,22742,23452,46194
2553,2020-02-28,3호선,양재,31366,32525,63891
2554,2020-02-28,3호선,매봉,9212,8945,18157
2555,2020-02-28,3호선,도곡,3873,3770,7643
2556,2020-02-28,3호선,대치,7243,7134,14377
2557,2020-02-28,3호선,학여울,1244,1243,2487
2558,2020-02-28,3호선,대청,7233,6654,13887
2559,2020-02-28,3호선,일원,6398,6311,12709
2560,2020-02-28,3호선,수서,11689,11695,23384
2561,2020-02-28,3호선,가락시장,6771,6707,13478
2562,2020-02-28,3호선,경찰병원,5840,5659,11499
2563,2020-02-28,3호선,오금,5025,4331,9356
2564,2020-02-28,3호선,원흥,6875,6304,13179
2565,2020-02-28,3호선,삼송,12841,12381,25222
2566,2020-02-28,3호선,원당,8257,7973,16230
2567,2020-02-28,3호선,화정,12135,12752,24887
2568,2020-02-28,3호선,대곡,1270,884,2154
2569,2020-02-28,3호선,백석,7516,7785,15301
2570,2020-02-28,3호선,마두,5244,5634,10878
2571,2020-02-28,3호선,정발산,4859,5187,10046
2572,2020-02-28,3호선,주엽,5867,5897,11764
2573,2020-02-28,3호선,대화,10150,8000,18150
2574,2020-02-29,3호선,지축,1098,1154,2252
2575,2020-02-29,3호선,구파발,7947,7552,15499
2576,2020-02-29,3호선,연신내,19279,18111,37390
2577,2020-02-29,3호선,불광,8166,9378,17544
2578,2020-02-29,3호선,녹번,5810,5060,10870
2579,2020-02-29,3호선,홍제,8381,7962,16343
2580,2020-02-29,3호선,무악재,1658,1628,3286
2581,2020-02-29,3호선,독립문,3259,3168,6427
2582,2020-02-29,3호선,경복궁,6120,6286,12406
2583,2020-02-29,3호선,안국,5647,6402,12049
2584,2020-02-29,3호선,종로3가,3196,4230,7426
2585,2020-02-29,3호선,을지로3가,2852,3002,5854
2586,2020-02-29,3호선,충무로,1,0,1
2587,2020-02-29,3호선,동대입구,3771,4155,7926
2588,2020-02-29,3호선,약수,6122,5782,11904
2589,2020-02-29,3호선,금호,3859,3619,7478
2590,2020-02-29,3호선,옥수,4015,4022,8037
2591,2020-02-29,3호선,압구정,14833,15677,30510
2592,2020-02-29,3호선,신사,14869,15891,30760
2593,2020-02-29,3호선,잠원,2158,2016,4174
2594,2020-02-29,3호선,고속터미널,19964,20287,40251
2595,2020-02-29,3호선,교대,3617,2370,5987
2596,2020-02-29,3호선,남부터미널,11114,11204,22318
2597,2020-02-29,3호선,양재,11517,12516,24033
2598,2020-02-29,3호선,매봉,3182,3018,6200
2599,2020-02-29,3호선,도곡,1811,1814,3625
2600,2020-02-29,3호선,대치,4046,3823,7869
2601,2020-02-29,3호선,학여울,589,567,1156
2602,2020-02-29,3호선,대청,3356,3075,6431
2603,2020-02-29,3호선,일원,2618,2490,5108
2604,2020-02-29,3호선,수서,5672,5828,11500
2605,2020-02-29,3호선,가락시장,3643,3330,6973
2606,2020-02-29,3호선,경찰병원,2419,2264,4683
2607,2020-02-29,3호선,오금,2256,2006,4262
2608,2020-02-29,3호선,원흥,3964,3839,7803
2609,2020-02-29,3호선,삼송,7650,7374,15024
2610,2020-02-29,3호선,원당,5109,4881,9990
2611,2020-02-29,3호선,화정,7655,7905,15560
2612,2020-02-29,3호선,대곡,711,565,1276
2613,2020-02-29,3호선,백석,4663,4730,9393
2614,2020-02-29,3호선,마두,2822,2839,5661
2615,2020-02-29,3호선,정발산,3414,3665,7079
2616,2020-02-29,3호선,주엽,3305,3313,6618
2617,2020-02-29,3호선,대화,5191,4558,9749
2618,2020-03-01,3호선,지축,737,666,1403
2619,2020-03-01,3호선,구파발,5803,5891,11694
2620,2020-03-01,3호선,연신내,12998,12125,25123
2621,2020-03-01,3호선,불광,5821,6725,12546
2622,2020-03-01,3호선,녹번,3547,3200,6747
2623,2020-03-01,3호선,홍제,5396,5053,10449
2624,2020-03-01,3호선,무악재,1014,1060,2074
2625,2020-03-01,3호선,독립문,2340,2372,4712
2626,2020-03-01,3호선,경복궁,4276,4402,8678
2627,2020-03-01,3호선,안국,3667,3953,7620
2628,2020-03-01,3호선,종로3가,1669,2097,3766
2629,2020-03-01,3호선,을지로3가,1206,1219,2425
2630,2020-03-01,3호선,동대입구,2782,3102,5884
2631,2020-03-01,3호선,약수,3870,3623,7493
2632,2020-03-01,3호선,금호,2418,2336,4754
2633,2020-03-01,3호선,옥수,2619,2777,5396
2634,2020-03-01,3호선,압구정,7036,7402,14438
2635,2020-03-01,3호선,신사,7621,7555,15176
2636,2020-03-01,3호선,잠원,1271,1258,2529
2637,2020-03-01,3호선,고속터미널,16392,16095,32487
2638,2020-03-01,3호선,교대,2079,1420,3499
2639,2020-03-01,3호선,남부터미널,7120,7615,14735
2640,2020-03-01,3호선,양재,6575,7783,14358
2641,2020-03-01,3호선,매봉,1896,1874,3770
2642,2020-03-01,3호선,도곡,941,1010,1951
2643,2020-03-01,3호선,대치,2146,2049,4195
2644,2020-03-01,3호선,학여울,395,401,796
2645,2020-03-01,3호선,대청,2063,1940,4003
2646,2020-03-01,3호선,일원,1580,1805,3385
2647,2020-03-01,3호선,수서,4231,4301,8532
2648,2020-03-01,3호선,가락시장,2058,2208,4266
2649,2020-03-01,3호선,경찰병원,1463,1451,2914
2650,2020-03-01,3호선,오금,1472,1378,2850
2651,2020-03-01,3호선,원흥,2584,2414,4998
2652,2020-03-01,3호선,삼송,5161,5066,10227
2653,2020-03-01,3호선,원당,3408,3343,6751
2654,2020-03-01,3호선,화정,5155,5235,10390
2655,2020-03-01,3호선,대곡,537,439,976
2656,2020-03-01,3호선,백석,3304,3253,6557
2657,2020-03-01,3호선,마두,1734,1745,3479
2658,2020-03-01,3호선,정발산,2429,2396,4825
2659,2020-03-01,3호선,주엽,2072,2050,4122
2660,2020-03-01,3호선,대화,3565,3228,6793
2661,2020-03-02,3호선,지축,2321,2363,4684
2662,2020-03-02,3호선,구파발,14582,13332,27914
2663,2020-03-02,3호선,연신내,30454,28816,59270
2664,2020-03-02,3호선,불광,12710,13472,26182
2665,2020-03-02,3호선,녹번,10812,9769,20581
2666,2020-03-02,3호선,홍제,13520,13017,26537
2667,2020-03-02,3호선,무악재,3090,3099,6189
2668,2020-03-02,3호선,독립문,5032,5194,10226
2669,2020-03-02,3호선,경복궁,13190,13076,26266
2670,2020-03-02,3호선,안국,14663,15164,29827
2671,2020-03-02,3호선,종로3가,8059,9120,17179
2672,2020-03-02,3호선,을지로3가,9013,9394,18407
2673,2020-03-02,3호선,충무로,1,0,1
2674,2020-03-02,3호선,동대입구,5665,6070,11735
2675,2020-03-02,3호선,약수,10433,10262,20695
2676,2020-03-02,3호선,금호,6320,5970,12290
2677,2020-03-02,3호선,옥수,6641,6998,13639
2678,2020-03-02,3호선,압구정,23499,25318,48817
2679,2020-03-02,3호선,신사,23498,25046,48544
2680,2020-03-02,3호선,잠원,4107,4016,8123
2681,2020-03-02,3호선,고속터미널,23169,21627,44796
2682,2020-03-02,3호선,교대,10680,7249,17929
2683,2020-03-02,3호선,남부터미널,21960,22510,44470
2684,2020-03-02,3호선,양재,30347,32813,63160
2685,2020-03-02,3호선,매봉,9532,9126,18658
2686,2020-03-02,3호선,도곡,3933,3938,7871
2687,2020-03-02,3호선,대치,7461,7254,14715
2688,2020-03-02,3호선,학여울,1260,1276,2536
2689,2020-03-02,3호선,대청,7573,6884,14457
2690,2020-03-02,3호선,일원,6695,6669,13364
2691,2020-03-02,3호선,수서,10868,11301,22169
2692,2020-03-02,3호선,가락시장,6946,6743,13689
2693,2020-03-02,3호선,경찰병원,5850,5928,11778
2694,2020-03-02,3호선,오금,5115,4430,9545
2695,2020-03-02,3호선,원흥,7042,6788,13830
2696,2020-03-02,3호선,삼송,13465,12982,26447
2697,2020-03-02,3호선,원당,8532,8140,16672
2698,2020-03-02,3호선,화정,12573,13005,25578
2699,2020-03-02,3호선,대곡,1338,926,2264
2700,2020-03-02,3호선,백석,7648,7727,15375
2701,2020-03-02,3호선,마두,5298,5482,10780
2702,2020-03-02,3호선,정발산,4940,5200,10140
2703,2020-03-02,3호선,주엽,6043,6201,12244
2704,2020-03-02,3호선,대화,10382,7907,18289
2705,2020-03-03,3호선,지축,2270,2389,4659
2706,2020-03-03,3호선,구파발,14664,13307,27971
2707,2020-03-03,3호선,연신내,30425,28634,59059
2708,2020-03-03,3호선,불광,12622,13456,26078
2709,2020-03-03,3호선,녹번,10914,9872,20786
2710,2020-03-03,3호선,홍제,13520,12827,26347
2711,2020-03-03,3호선,무악재,3023,3093,6116
2712,2020-03-03,3호선,독립문,5061,5180,10241
2713,2020-03-03,3호선,경복궁,13228,13055,26283
2714,2020-03-03,3호선,안국,14751,15194,29945
2715,2020-03-03,3호선,종로3가,8573,9756,18329
2716,2020-03-03,3호선,을지로3가,8996,9481,18477
2717,2020-03-03,3호선,동대입구,5678,6030,11708
2718,2020-03-03,3호선,약수,10461,10201,20662
2719,2020-03-03,3호선,금호,6245,5956,12201
2720,2020-03-03,3호선,옥수,6688,6944,13632
2721,2020-03-03,3호선,압구정,23718,25564,49282
2722,2020-03-03,3호선,신사,23814,25265,49079
2723,2020-03-03,3호선,잠원,4091,4058,8149
2724,2020-03-03,3호선,고속터미널,22000,21448,43448
2725,2020-03-03,3호선,교대,11085,7403,18488
2726,2020-03-03,3호선,남부터미널,21420,22143,43563
2727,2020-03-03,3호선,양재,30342,32737,63079
2728,2020-03-03,3호선,매봉,9451,9037,18488
2729,2020-03-03,3호선,도곡,3801,3869,7670
2730,2020-03-03,3호선,대치,7519,7414,14933
2731,2020-03-03,3호선,학여울,1216,1226,2442
2732,2020-03-03,3호선,대청,7414,6791,14205
2733,2020-03-03,3호선,일원,6784,6598,13382
2734,2020-03-03,3호선,수서,10721,10978,21699
2735,2020-03-03,3호선,가락시장,6967,6684,13651
2736,2020-03-03,3호선,경찰병원,6052,6059,12111
2737,2020-03-03,3호선,오금,5096,4518,9614
2738,2020-03-03,3호선,원흥,7094,6729,13823
2739,2020-03-03,3호선,삼송,13500,13057,26557
2740,2020-03-03,3호선,원당,8497,8164,16661
2741,2020-03-03,3호선,화정,12784,13091,25875
2742,2020-03-03,3호선,대곡,1321,970,2291
2743,2020-03-03,3호선,백석,7774,7758,15532
2744,2020-03-03,3호선,마두,5402,5688,11090
2745,2020-03-03,3호선,정발산,5096,5210,10306
2746,2020-03-03,3호선,주엽,5933,6101,12034
2747,2020-03-03,3호선,대화,10293,7968,18261
2748,2020-03-04,3호선,지축,2244,2350,4594
2749,2020-03-04,3호선,구파발,14539,13091,27630
2750,2020-03-04,3호선,연신내,30192,28564,58756
2751,2020-03-04,3호선,불광,12522,13370,25892
2752,2020-03-04,3호선,녹번,10791,9737,20528
2753,2020-03-04,3호선,홍제,13349,12891,26240
2754,2020-03-04,3호선,무악재,3023,3083,6106
2755,2020-03-04,3호선,독립문,4999,5162,10161
2756,2020-03-04,3호선,경복궁,13360,13326,26686
2757,2020-03-04,3호선,안국,14477,14869,29346
2758,2020-03-04,3호선,종로3가,8800,9801,18601
2759,2020-03-04,3호선,을지로3가,8961,9383,18344
2760,2020-03-04,3호선,동대입구,5739,5967,11706
2761,2020-03-04,3호선,약수,10147,9955,20102
2762,2020-03-04,3호선,금호,6310,5994,12304
2763,2020-03-04,3호선,옥수,6585,6848,13433
2764,2020-03-04,3호선,압구정,23397,25178,48575
2765,2020-03-04,3호선,신사,23715,25081,48796
2766,2020-03-04,3호선,잠원,4066,4022,8088
2767,2020-03-04,3호선,고속터미널,22235,21825,44060
2768,2020-03-04,3호선,교대,11122,7605,18727
2769,2020-03-04,3호선,남부터미널,21502,22237,43739
2770,2020-03-04,3호선,양재,30353,32737,63090
2771,2020-03-04,3호선,매봉,9368,9084,18452
2772,2020-03-04,3호선,도곡,3884,3896,7780
2773,2020-03-04,3호선,대치,7432,7292,14724
2774,2020-03-04,3호선,학여울,1229,1273,2502
2775,2020-03-04,3호선,대청,7565,6824,14389
2776,2020-03-04,3호선,일원,6669,6573,13242
2777,2020-03-04,3호선,수서,10709,10939,21648
2778,2020-03-04,3호선,가락시장,6918,6735,13653
2779,2020-03-04,3호선,경찰병원,5951,5964,11915
2780,2020-03-04,3호선,오금,5050,4474,9524
2781,2020-03-04,3호선,원흥,6999,6676,13675
2782,2020-03-04,3호선,삼송,13324,12938,26262
2783,2020-03-04,3호선,원당,8346,8059,16405
2784,2020-03-04,3호선,화정,12528,12987,25515
2785,2020-03-04,3호선,대곡,1263,909,2172
2786,2020-03-04,3호선,백석,7604,7800,15404
2787,2020-03-04,3호선,마두,5296,5577,10873
2788,2020-03-04,3호선,정발산,5218,5272,10490
2789,2020-03-04,3호선,주엽,5872,6047,11919
2790,2020-03-04,3호선,대화,10237,8036,18273
2791,2020-03-05,3호선,지축,2286,2327,4613
2792,2020-03-05,3호선,구파발,14669,13299,27968
2793,2020-03-05,3호선,연신내,30494,28833,59327
2794,2020-03-05,3호선,불광,12733,13521,26254
2795,2020-03-05,3호선,녹번,10879,9749,20628
2796,2020-03-05,3호선,홍제,13819,13198,27017
2797,2020-03-05,3호선,무악재,3053,3098,6151
2798,2020-03-05,3호선,독립문,5063,5211,10274
2799,2020-03-05,3호선,경복궁,13584,13404,26988
2800,2020-03-05,3호선,안국,13966,14597,28563
2801,2020-03-05,3호선,종로3가,8766,9959,18725
2802,2020-03-05,3호선,을지로3가,8996,9395,18391
2803,2020-03-05,3호선,충무로,1,0,1
2804,2020-03-05,3호선,동대입구,5599,6041,11640
2805,2020-03-05,3호선,약수,10413,10176,20589
2806,2020-03-05,3호선,금호,6244,5885,12129
2807,2020-03-05,3호선,옥수,6601,6913,13514
2808,2020-03-05,3호선,압구정,23495,25380,48875
2809,2020-03-05,3호선,신사,23878,25499,49377
2810,2020-03-05,3호선,잠원,4079,4037,8116
2811,2020-03-05,3호선,고속터미널,22946,22625,45571
2812,2020-03-05,3호선,교대,11720,7724,19444
2813,2020-03-05,3호선,남부터미널,21686,22152,43838
2814,2020-03-05,3호선,양재,30846,33203,64049
2815,2020-03-05,3호선,매봉,9306,8821,18127
2816,2020-03-05,3호선,도곡,3776,3826,7602
2817,2020-03-05,3호선,대치,7595,7358,14953
2818,2020-03-05,3호선,학여울,1251,1252,2503
2819,2020-03-05,3호선,대청,7476,6801,14277
2820,2020-03-05,3호선,일원,6720,6625,13345
2821,2020-03-05,3호선,수서,10903,11065,21968
2822,2020-03-05,3호선,가락시장,7065,6916,13981
2823,2020-03-05,3호선,경찰병원,5864,5973,11837
2824,2020-03-05,3호선,오금,4982,4341,9323
2825,2020-03-05,3호선,원흥,7128,6638,13766
2826,2020-03-05,3호선,삼송,13615,13109,26724
2827,2020-03-05,3호선,원당,8419,8151,16570
2828,2020-03-05,3호선,화정,12538,13094,25632
2829,2020-03-05,3호선,대곡,1300,903,2203
2830,2020-03-05,3호선,백석,7880,7919,15799
2831,2020-03-05,3호선,마두,5423,5654,11077
2832,2020-03-05,3호선,정발산,5145,5381,10526
2833,2020-03-05,3호선,주엽,6005,6115,12120
2834,2020-03-05,3호선,대화,10421,8059,18480
2835,2020-03-06,3호선,지축,2380,2453,4833
2836,2020-03-06,3호선,구파발,15165,13520,28685
2837,2020-03-06,3호선,연신내,31695,30129,61824
2838,2020-03-06,3호선,불광,12982,13868,26850
2839,2020-03-06,3호선,녹번,11093,9721,20814
2840,2020-03-06,3호선,홍제,14090,13280,27370
2841,2020-03-06,3호선,무악재,3032,3010,6042
2842,2020-03-06,3호선,독립문,5254,5420,10674
2843,2020-03-06,3호선,경복궁,14008,13826,27834
2844,2020-03-06,3호선,안국,14033,14668,28701
2845,2020-03-06,3호선,종로3가,8453,9927,18380
2846,2020-03-06,3호선,을지로3가,8877,9566,18443
2847,2020-03-06,3호선,충무로,1,0,1
2848,2020-03-06,3호선,동대입구,5752,6184,11936
2849,2020-03-06,3호선,약수,10849,10484,21333
2850,2020-03-06,3호선,금호,6615,6177,12792
2851,2020-03-06,3호선,옥수,7080,7051,14131
2852,2020-03-06,3호선,압구정,25225,27265,52490
2853,2020-03-06,3호선,신사,24983,27306,52289
2854,2020-03-06,3호선,잠원,4237,4072,8309
2855,2020-03-06,3호선,고속터미널,27124,28593,55717
2856,2020-03-06,3호선,교대,11475,7639,19114
2857,2020-03-06,3호선,남부터미널,23494,23931,47425
2858,2020-03-06,3호선,양재,32245,33658,65903
2859,2020-03-06,3호선,매봉,9504,9012,18516
2860,2020-03-06,3호선,도곡,4046,4016,8062
2861,2020-03-06,3호선,대치,7842,7662,15504
2862,2020-03-06,3호선,학여울,1323,1298,2621
2863,2020-03-06,3호선,대청,7599,6967,14566
2864,2020-03-06,3호선,일원,6792,6585,13377
2865,2020-03-06,3호선,수서,12136,12121,24257
2866,2020-03-06,3호선,가락시장,7241,7013,14254
2867,2020-03-06,3호선,경찰병원,5936,5948,11884
2868,2020-03-06,3호선,오금,5282,4558,9840
2869,2020-03-06,3호선,원흥,7227,6714,13941
2870,2020-03-06,3호선,삼송,13803,12994,26797
2871,2020-03-06,3호선,원당,8758,8420,17178
2872,2020-03-06,3호선,화정,13045,13744,26789
2873,2020-03-06,3호선,대곡,1355,947,2302
2874,2020-03-06,3호선,백석,8111,8190,16301
2875,2020-03-06,3호선,마두,5514,5875,11389
2876,2020-03-06,3호선,정발산,5464,6077,11541
2877,2020-03-06,3호선,주엽,6263,6331,12594
2878,2020-03-06,3호선,대화,10625,8320,18945
2879,2020-03-07,3호선,지축,1341,1373,2714
2880,2020-03-07,3호선,구파발,8952,8843,17795
2881,2020-03-07,3호선,연신내,21579,20100,41679
2882,2020-03-07,3호선,불광,8780,10187,18967
2883,2020-03-07,3호선,녹번,6224,5349,11573
2884,2020-03-07,3호선,홍제,8818,8284,17102
2885,2020-03-07,3호선,무악재,1665,1743,3408
2886,2020-03-07,3호선,독립문,3622,3722,7344
2887,2020-03-07,3호선,경복궁,6928,7040,13968
2888,2020-03-07,3호선,안국,5847,6984,12831
2889,2020-03-07,3호선,종로3가,3918,5153,9071
2890,2020-03-07,3호선,을지로3가,3006,3466,6472
2891,2020-03-07,3호선,동대입구,3627,4038,7665
2892,2020-03-07,3호선,약수,6326,5979,12305
2893,2020-03-07,3호선,금호,4107,3762,7869
2894,2020-03-07,3호선,옥수,4413,4356,8769
2895,2020-03-07,3호선,압구정,16006,17073,33079
2896,2020-03-07,3호선,신사,15986,16720,32706
2897,2020-03-07,3호선,잠원,2335,2231,4566
2898,2020-03-07,3호선,고속터미널,23070,23475,46545
2899,2020-03-07,3호선,교대,3952,2535,6487
2900,2020-03-07,3호선,남부터미널,11740,11974,23714
2901,2020-03-07,3호선,양재,12420,13155,25575
2902,2020-03-07,3호선,매봉,3468,3268,6736
2903,2020-03-07,3호선,도곡,2123,2072,4195
2904,2020-03-07,3호선,대치,4636,4344,8980
2905,2020-03-07,3호선,학여울,611,591,1202
2906,2020-03-07,3호선,대청,3757,3401,7158
2907,2020-03-07,3호선,일원,2651,2574,5225
2908,2020-03-07,3호선,수서,6354,6519,12873
2909,2020-03-07,3호선,가락시장,4029,3678,7707
2910,2020-03-07,3호선,경찰병원,2517,2377,4894
2911,2020-03-07,3호선,오금,2309,2112,4421
2912,2020-03-07,3호선,원흥,4276,3910,8186
2913,2020-03-07,3호선,삼송,8215,7786,16001
2914,2020-03-07,3호선,원당,5398,5014,10412
2915,2020-03-07,3호선,화정,8339,8683,17022
2916,2020-03-07,3호선,대곡,823,734,1557
2917,2020-03-07,3호선,백석,5186,5293,10479
2918,2020-03-07,3호선,마두,3131,3225,6356
2919,2020-03-07,3호선,정발산,3980,4471,8451
2920,2020-03-07,3호선,주엽,3669,3747,7416
2921,2020-03-07,3호선,대화,5659,4965,10624
2922,2020-03-08,3호선,지축,917,893,1810
2923,2020-03-08,3호선,구파발,6808,6941,13749
2924,2020-03-08,3호선,연신내,15155,14154,29309
2925,2020-03-08,3호선,불광,6474,7828,14302
2926,2020-03-08,3호선,녹번,3935,3492,7427
2927,2020-03-08,3호선,홍제,5967,5766,11733
2928,2020-03-08,3호선,무악재,1161,1246,2407
2929,2020-03-08,3호선,독립문,2475,2678,5153
2930,2020-03-08,3호선,경복궁,5196,5548,10744
2931,2020-03-08,3호선,안국,4475,5058,9533
2932,2020-03-08,3호선,종로3가,2305,2953,5258
2933,2020-03-08,3호선,을지로3가,1305,1403,2708
2934,2020-03-08,3호선,동대입구,2912,3407,6319
2935,2020-03-08,3호선,약수,4284,4121,8405
2936,2020-03-08,3호선,금호,2807,2629,5436
2937,2020-03-08,3호선,옥수,3172,3305,6477
2938,2020-03-08,3호선,압구정,8233,8641,16874
2939,2020-03-08,3호선,신사,8588,9001,17589
2940,2020-03-08,3호선,잠원,1557,1560,3117
2941,2020-03-08,3호선,고속터미널,20697,19736,40433
2942,2020-03-08,3호선,교대,2385,1522,3907
2943,2020-03-08,3호선,남부터미널,8265,8747,17012
2944,2020-03-08,3호선,양재,7279,8572,15851
2945,2020-03-08,3호선,매봉,2220,2181,4401
2946,2020-03-08,3호선,도곡,1116,1091,2207
2947,2020-03-08,3호선,대치,2832,2664,5496
2948,2020-03-08,3호선,학여울,432,435,867
2949,2020-03-08,3호선,대청,2491,2273,4764
2950,2020-03-08,3호선,일원,1778,1836,3614
2951,2020-03-08,3호선,수서,5003,5051,10054
2952,2020-03-08,3호선,가락시장,2194,2399,4593
2953,2020-03-08,3호선,경찰병원,1629,1681,3310
2954,2020-03-08,3호선,오금,1732,1581,3313
2955,2020-03-08,3호선,원흥,2926,2747,5673
2956,2020-03-08,3호선,삼송,5947,5695,11642
2957,2020-03-08,3호선,원당,3888,3678,7566
2958,2020-03-08,3호선,화정,5966,6168,12134
2959,2020-03-08,3호선,대곡,656,595,1251
2960,2020-03-08,3호선,백석,3822,3598,7420
2961,2020-03-08,3호선,마두,2017,1924,3941
2962,2020-03-08,3호선,정발산,3080,3193,6273
2963,2020-03-08,3호선,주엽,2490,2384,4874
2964,2020-03-08,3호선,대화,3969,3574,7543
2965,2020-03-09,3호선,지축,2525,2617,5142
2966,2020-03-09,3호선,구파발,15945,14562,30507
2967,2020-03-09,3호선,연신내,31872,30169,62041
2968,2020-03-09,3호선,불광,13250,14144,27394
2969,2020-03-09,3호선,녹번,11125,10080,21205
2970,2020-03-09,3호선,홍제,14365,13642,28007
2971,2020-03-09,3호선,무악재,3185,3202,6387
2972,2020-03-09,3호선,독립문,5377,5494,10871
2973,2020-03-09,3호선,경복궁,13770,13608,27378
2974,2020-03-09,3호선,안국,14178,14844,29022
2975,2020-03-09,3호선,종로3가,8945,10255,19200
2976,2020-03-09,3호선,을지로3가,9070,9659,18729
2977,2020-03-09,3호선,충무로,2,0,2
2978,2020-03-09,3호선,동대입구,5726,6216,11942
2979,2020-03-09,3호선,약수,10848,10598,21446
2980,2020-03-09,3호선,금호,6688,6295,12983
2981,2020-03-09,3호선,옥수,7170,7421,14591
2982,2020-03-09,3호선,압구정,24752,26649,51401
2983,2020-03-09,3호선,신사,24976,26561,51537
2984,2020-03-09,3호선,잠원,4479,4374,8853
2985,2020-03-09,3호선,고속터미널,26485,24789,51274
2986,2020-03-09,3호선,교대,11664,7838,19502
2987,2020-03-09,3호선,남부터미널,22558,23270,45828
2988,2020-03-09,3호선,양재,31429,34354,65783
2989,2020-03-09,3호선,매봉,9648,9292,18940
2990,2020-03-09,3호선,도곡,4123,4122,8245
2991,2020-03-09,3호선,대치,7553,7523,15076
2992,2020-03-09,3호선,학여울,1287,1291,2578
2993,2020-03-09,3호선,대청,7698,7190,14888
2994,2020-03-09,3호선,일원,7192,7059,14251
2995,2020-03-09,3호선,수서,11796,11948,23744
2996,2020-03-09,3호선,가락시장,7230,7129,14359
2997,2020-03-09,3호선,경찰병원,6294,6264,12558
2998,2020-03-09,3호선,오금,5363,4692,10055
2999,2020-03-09,3호선,원흥,7343,7012,14355
3000,2020-03-09,3호선,삼송,13829,13391,27220
3001,2020-03-09,3호선,원당,9098,8641,17739
3002,2020-03-09,3호선,화정,13534,13910,27444
3003,2020-03-09,3호선,대곡,1425,1007,2432
3004,2020-03-09,3호선,백석,8181,8245,16426
3005,2020-03-09,3호선,마두,5605,5883,11488
3006,2020-03-09,3호선,정발산,5419,5681,11100
3007,2020-03-09,3호선,주엽,6505,6666,13171
3008,2020-03-09,3호선,대화,10916,8403,19319
3009,2020-03-10,3호선,지축,2345,2405,4750
3010,2020-03-10,3호선,구파발,15272,13953,29225
3011,2020-03-10,3호선,연신내,29910,28509,58419
3012,2020-03-10,3호선,불광,12242,12984,25226
3013,2020-03-10,3호선,녹번,10858,9718,20576
3014,2020-03-10,3호선,홍제,13544,12928,26472
3015,2020-03-10,3호선,무악재,3074,3135,6209
3016,2020-03-10,3호선,독립문,4871,5024,9895
3017,2020-03-10,3호선,경복궁,13329,13244,26573
3018,2020-03-10,3호선,안국,14132,14402,28534
3019,2020-03-10,3호선,종로3가,8969,9918,18887
3020,2020-03-10,3호선,을지로3가,9157,9541,18698
3021,2020-03-10,3호선,충무로,2,0,2
3022,2020-03-10,3호선,동대입구,5717,6051,11768
3023,2020-03-10,3호선,약수,10404,10185,20589
3024,2020-03-10,3호선,금호,6407,6014,12421
3025,2020-03-10,3호선,옥수,6590,6829,13419
3026,2020-03-10,3호선,압구정,24147,26029,50176
3027,2020-03-10,3호선,신사,24748,26298,51046
3028,2020-03-10,3호선,잠원,4160,4123,8283
3029,2020-03-10,3호선,고속터미널,23095,22683,45778
3030,2020-03-10,3호선,교대,11242,7641,18883
3031,2020-03-10,3호선,남부터미널,22344,22866,45210
3032,2020-03-10,3호선,양재,31271,33626,64897
3033,2020-03-10,3호선,매봉,9580,9216,18796
3034,2020-03-10,3호선,도곡,3900,3857,7757
3035,2020-03-10,3호선,대치,7294,7247,14541
3036,2020-03-10,3호선,학여울,1179,1240,2419
3037,2020-03-10,3호선,대청,7409,6833,14242
3038,2020-03-10,3호선,일원,6851,6830,13681
3039,2020-03-10,3호선,수서,11149,11310,22459
3040,2020-03-10,3호선,가락시장,6954,6708,13662
3041,2020-03-10,3호선,경찰병원,6234,6340,12574
3042,2020-03-10,3호선,오금,5159,4388,9547
3043,2020-03-10,3호선,원흥,7002,6579,13581
3044,2020-03-10,3호선,삼송,13139,12677,25816
3045,2020-03-10,3호선,원당,8388,8142,16530
3046,2020-03-10,3호선,화정,12782,13245,26027
3047,2020-03-10,3호선,대곡,1256,951,2207
3048,2020-03-10,3호선,백석,7834,7961,15795
3049,2020-03-10,3호선,마두,5340,5632,10972
3050,2020-03-10,3호선,정발산,4972,5183,10155
3051,2020-03-10,3호선,주엽,6056,6275,12331
3052,2020-03-10,3호선,대화,10527,8016,18543
3053,2020-03-11,3호선,지축,2521,2580,5101
3054,2020-03-11,3호선,구파발,16077,14675,30752
3055,2020-03-11,3호선,연신내,31867,30030,61897
3056,2020-03-11,3호선,불광,13375,14233,27608
3057,2020-03-11,3호선,녹번,11200,9997,21197
3058,2020-03-11,3호선,홍제,14222,13606,27828
3059,2020-03-11,3호선,무악재,3155,3139,6294
3060,2020-03-11,3호선,독립문,5296,5509,10805
3061,2020-03-11,3호선,경복궁,13919,13887,27806
3062,2020-03-11,3호선,안국,14420,15295,29715
3063,2020-03-11,3호선,종로3가,8935,9985,18920
3064,2020-03-11,3호선,을지로3가,9063,9704,18767
3065,2020-03-11,3호선,동대입구,6032,6416,12448
3066,2020-03-11,3호선,약수,10724,10485,21209
3067,2020-03-11,3호선,금호,6559,6243,12802
3068,2020-03-11,3호선,옥수,7036,7145,14181
3069,2020-03-11,3호선,압구정,24700,26707,51407
3070,2020-03-11,3호선,신사,25801,27326,53127
3071,2020-03-11,3호선,잠원,4406,4279,8685
3072,2020-03-11,3호선,고속터미널,24888,23965,48853
3073,2020-03-11,3호선,교대,11702,7811,19513
3074,2020-03-11,3호선,남부터미널,22430,23210,45640
3075,2020-03-11,3호선,양재,31324,34049,65373
3076,2020-03-11,3호선,매봉,9608,9192,18800
3077,2020-03-11,3호선,도곡,3979,4038,8017
3078,2020-03-11,3호선,대치,7300,7194,14494
3079,2020-03-11,3호선,학여울,1293,1256,2549
3080,2020-03-11,3호선,대청,7480,6843,14323
3081,2020-03-11,3호선,일원,6852,6745,13597
3082,2020-03-11,3호선,수서,11380,11685,23065
3083,2020-03-11,3호선,가락시장,7373,7134,14507
3084,2020-03-11,3호선,경찰병원,6252,6334,12586
3085,2020-03-11,3호선,오금,5250,4453,9703
3086,2020-03-11,3호선,원흥,7324,7008,14332
3087,2020-03-11,3호선,삼송,13768,13196,26964
3088,2020-03-11,3호선,원당,8863,8434,17297
3089,2020-03-11,3호선,화정,13365,13743,27108
3090,2020-03-11,3호선,대곡,1395,1016,2411
3091,2020-03-11,3호선,백석,7905,7973,15878
3092,2020-03-11,3호선,마두,5776,5973,11749
3093,2020-03-11,3호선,정발산,5530,5919,11449
3094,2020-03-11,3호선,주엽,6473,6562,13035
3095,2020-03-11,3호선,대화,10606,8205,18811
3096,2020-03-12,3호선,지축,2427,2520,4947
3097,2020-03-12,3호선,구파발,15806,14246,30052
3098,2020-03-12,3호선,연신내,31182,29462,60644
3099,2020-03-12,3호선,불광,12971,13749,26720
3100,2020-03-12,3호선,녹번,10966,9750,20716
3101,2020-03-12,3호선,홍제,13595,12963,26558
3102,2020-03-12,3호선,무악재,3069,3101,6170
3103,2020-03-12,3호선,독립문,5222,5351,10573
3104,2020-03-12,3호선,경복궁,13784,13731,27515
3105,2020-03-12,3호선,안국,14169,14832,29001
3106,2020-03-12,3호선,종로3가,8727,10041,18768
3107,2020-03-12,3호선,을지로3가,8902,9338,18240
3108,2020-03-12,3호선,동대입구,5843,6289,12132
3109,2020-03-12,3호선,약수,10539,10176,20715
3110,2020-03-12,3호선,금호,6543,6196,12739
3111,2020-03-12,3호선,옥수,6894,7087,13981
3112,2020-03-12,3호선,압구정,24091,25946,50037
3113,2020-03-12,3호선,신사,25385,27183,52568
3114,2020-03-12,3호선,잠원,4171,4173,8344
3115,2020-03-12,3호선,고속터미널,25076,24314,49390
3116,2020-03-12,3호선,교대,11477,7785,19262
3117,2020-03-12,3호선,남부터미널,22105,22617,44722
3118,2020-03-12,3호선,양재,31204,33743,64947
3119,2020-03-12,3호선,매봉,9450,9057,18507
3120,2020-03-12,3호선,도곡,3886,3904,7790
3121,2020-03-12,3호선,대치,7240,7181,14421
3122,2020-03-12,3호선,학여울,1246,1239,2485
3123,2020-03-12,3호선,대청,7334,6678,14012
3124,2020-03-12,3호선,일원,6971,6921,13892
3125,2020-03-12,3호선,수서,11449,11670,23119
3126,2020-03-12,3호선,가락시장,7267,7018,14285
3127,2020-03-12,3호선,경찰병원,6145,6190,12335
3128,2020-03-12,3호선,오금,5191,4432,9623
3129,2020-03-12,3호선,원흥,7209,6821,14030
3130,2020-03-12,3호선,삼송,13797,13279,27076
3131,2020-03-12,3호선,원당,8733,8323,17056
3132,2020-03-12,3호선,화정,13166,13516,26682
3133,2020-03-12,3호선,대곡,1401,1003,2404
3134,2020-03-12,3호선,백석,7896,8021,15917
3135,2020-03-12,3호선,마두,5530,5710,11240
3136,2020-03-12,3호선,정발산,5538,5940,11478
3137,2020-03-12,3호선,주엽,6277,6392,12669
3138,2020-03-12,3호선,대화,10471,8125,18596
3139,2020-03-13,3호선,지축,2484,2477,4961
3140,2020-03-13,3호선,구파발,15817,14222,30039
3141,2020-03-13,3호선,연신내,32074,30489,62563
3142,2020-03-13,3호선,불광,13123,14013,27136
3143,2020-03-13,3호선,녹번,11100,9742,20842
3144,2020-03-13,3호선,홍제,14099,13269,27368
3145,2020-03-13,3호선,무악재,3124,3137,6261
3146,2020-03-13,3호선,독립문,5244,5327,10571
3147,2020-03-13,3호선,경복궁,13960,13824,27784
3148,2020-03-13,3호선,안국,14276,14783,29059
3149,2020-03-13,3호선,종로3가,8420,9813,18233
3150,2020-03-13,3호선,을지로3가,9007,9677,18684
3151,2020-03-13,3호선,충무로,1,0,1
3152,2020-03-13,3호선,동대입구,5961,6264,12225
3153,2020-03-13,3호선,약수,10905,10656,21561
3154,2020-03-13,3호선,금호,6700,6150,12850
3155,2020-03-13,3호선,옥수,7179,7297,14476
3156,2020-03-13,3호선,압구정,26044,28061,54105
3157,2020-03-13,3호선,신사,26561,28908,55469
3158,2020-03-13,3호선,잠원,4393,4232,8625
3159,2020-03-13,3호선,고속터미널,29475,30530,60005
3160,2020-03-13,3호선,교대,11582,7943,19525
3161,2020-03-13,3호선,남부터미널,23483,24019,47502
3162,2020-03-13,3호선,양재,32762,33944,66706
3163,2020-03-13,3호선,매봉,9443,9045,18488
3164,2020-03-13,3호선,도곡,4123,3999,8122
3165,2020-03-13,3호선,대치,7473,7330,14803
3166,2020-03-13,3호선,학여울,1272,1297,2569
3167,2020-03-13,3호선,대청,7451,6811,14262
3168,2020-03-13,3호선,일원,6912,6586,13498
3169,2020-03-13,3호선,수서,12658,12714,25372
3170,2020-03-13,3호선,가락시장,7372,7146,14518
3171,2020-03-13,3호선,경찰병원,6236,6273,12509
3172,2020-03-13,3호선,오금,5287,4523,9810
3173,2020-03-13,3호선,원흥,7454,6830,14284
3174,2020-03-13,3호선,삼송,13879,13255,27134
3175,2020-03-13,3호선,원당,8953,8349,17302
3176,2020-03-13,3호선,화정,13499,14173,27672
3177,2020-03-13,3호선,대곡,1360,975,2335
3178,2020-03-13,3호선,백석,8215,8355,16570
3179,2020-03-13,3호선,마두,5645,6035,11680
3180,2020-03-13,3호선,정발산,5697,6274,11971
3181,2020-03-13,3호선,주엽,6380,6519,12899
3182,2020-03-13,3호선,대화,10543,8279,18822
3183,2020-03-14,3호선,지축,1376,1428,2804
3184,2020-03-14,3호선,구파발,9686,9627,19313
3185,2020-03-14,3호선,연신내,22181,20619,42800
3186,2020-03-14,3호선,불광,9180,10524,19704
3187,2020-03-14,3호선,녹번,6410,5478,11888
3188,2020-03-14,3호선,홍제,9107,8459,17566
3189,2020-03-14,3호선,무악재,1789,1847,3636
3190,2020-03-14,3호선,독립문,3756,3870,7626
3191,2020-03-14,3호선,경복궁,7631,7882,15513
3192,2020-03-14,3호선,안국,6649,7804,14453
3193,2020-03-14,3호선,종로3가,4126,5375,9501
3194,2020-03-14,3호선,을지로3가,3161,3473,6634
3195,2020-03-14,3호선,동대입구,3717,4311,8028
3196,2020-03-14,3호선,약수,6483,6179,12662
3197,2020-03-14,3호선,금호,4283,3927,8210
3198,2020-03-14,3호선,옥수,4462,4434,8896
3199,2020-03-14,3호선,압구정,16736,17468,34204
3200,2020-03-14,3호선,신사,17373,18770,36143
3201,2020-03-14,3호선,잠원,2548,2433,4981
3202,2020-03-14,3호선,고속터미널,26297,26576,52873
3203,2020-03-14,3호선,교대,4063,2678,6741
3204,2020-03-14,3호선,남부터미널,12443,12399,24842
3205,2020-03-14,3호선,양재,12566,13625,26191
3206,2020-03-14,3호선,매봉,3584,3463,7047
3207,2020-03-14,3호선,도곡,2167,2077,4244
3208,2020-03-14,3호선,대치,4719,4421,9140
3209,2020-03-14,3호선,학여울,651,676,1327
3210,2020-03-14,3호선,대청,3874,3527,7401
3211,2020-03-14,3호선,일원,2791,2662,5453
3212,2020-03-14,3호선,수서,6777,6814,13591
3213,2020-03-14,3호선,가락시장,4137,3873,8010
3214,2020-03-14,3호선,경찰병원,2654,2499,5153
3215,2020-03-14,3호선,오금,2598,2265,4863
3216,2020-03-14,3호선,원흥,4599,4309,8908
3217,2020-03-14,3호선,삼송,8773,8289,17062
3218,2020-03-14,3호선,원당,5726,5487,11213
3219,2020-03-14,3호선,화정,8871,9055,17926
3220,2020-03-14,3호선,대곡,861,755,1616
3221,2020-03-14,3호선,백석,5422,5472,10894
3222,2020-03-14,3호선,마두,3264,3314,6578
3223,2020-03-14,3호선,정발산,4384,4769,9153
3224,2020-03-14,3호선,주엽,3974,4070,8044
3225,2020-03-14,3호선,대화,6055,5234,11289
3226,2020-03-15,3호선,지축,1017,954,1971
3227,2020-03-15,3호선,구파발,7022,7184,14206
3228,2020-03-15,3호선,연신내,14977,14149,29126
3229,2020-03-15,3호선,불광,6649,7830,14479
3230,2020-03-15,3호선,녹번,3900,3456,7356
3231,2020-03-15,3호선,홍제,5782,5482,11264
3232,2020-03-15,3호선,무악재,1150,1274,2424
3233,2020-03-15,3호선,독립문,2509,2680,5189
3234,2020-03-15,3호선,경복궁,5076,5222,10298
3235,2020-03-15,3호선,안국,4527,4937,9464
3236,2020-03-15,3호선,종로3가,2421,3218,5639
3237,2020-03-15,3호선,을지로3가,1280,1437,2717
3238,2020-03-15,3호선,동대입구,2984,3298,6282
3239,2020-03-15,3호선,약수,4202,3993,8195
3240,2020-03-15,3호선,금호,2747,2741,5488
3241,2020-03-15,3호선,옥수,2990,3248,6238
3242,2020-03-15,3호선,압구정,7847,8331,16178
3243,2020-03-15,3호선,신사,8456,8604,17060
3244,2020-03-15,3호선,잠원,1547,1527,3074
3245,2020-03-15,3호선,고속터미널,21618,20548,42166
3246,2020-03-15,3호선,교대,2390,1513,3903
3247,2020-03-15,3호선,남부터미널,8242,8558,16800
3248,2020-03-15,3호선,양재,7228,8573,15801
3249,2020-03-15,3호선,매봉,2121,2098,4219
3250,2020-03-15,3호선,도곡,1107,1202,2309
3251,2020-03-15,3호선,대치,2626,2479,5105
3252,2020-03-15,3호선,학여울,446,460,906
3253,2020-03-15,3호선,대청,2482,2392,4874
3254,2020-03-15,3호선,일원,1754,1898,3652
3255,2020-03-15,3호선,수서,5209,5479,10688
3256,2020-03-15,3호선,가락시장,2335,2502,4837
3257,2020-03-15,3호선,경찰병원,1702,1768,3470
3258,2020-03-15,3호선,오금,1704,1660,3364
3259,2020-03-15,3호선,원흥,2971,2817,5788
3260,2020-03-15,3호선,삼송,6190,5907,12097
3261,2020-03-15,3호선,원당,3904,3766,7670
3262,2020-03-15,3호선,화정,6138,6260,12398
3263,2020-03-15,3호선,대곡,633,528,1161
3264,2020-03-15,3호선,백석,3803,3722,7525
3265,2020-03-15,3호선,마두,2056,2003,4059
3266,2020-03-15,3호선,정발산,3039,3132,6171
3267,2020-03-15,3호선,주엽,2555,2470,5025
3268,2020-03-15,3호선,대화,4076,3720,7796
3269,2020-03-16,3호선,지축,2560,2644,5204
3270,2020-03-16,3호선,구파발,16023,14642,30665
3271,2020-03-16,3호선,연신내,31688,30062,61750
3272,2020-03-16,3호선,불광,13158,14123,27281
3273,2020-03-16,3호선,녹번,11121,9996,21117
3274,2020-03-16,3호선,홍제,14070,13686,27756
3275,2020-03-16,3호선,무악재,3154,3151,6305
3276,2020-03-16,3호선,독립문,5242,5330,10572
3277,2020-03-16,3호선,경복궁,13564,13332,26896
3278,2020-03-16,3호선,안국,14036,14645,28681
3279,2020-03-16,3호선,종로3가,8887,10019,18906
3280,2020-03-16,3호선,을지로3가,8989,9463,18452
3281,2020-03-16,3호선,충무로,1,0,1
3282,2020-03-16,3호선,동대입구,5851,6254,12105
3283,2020-03-16,3호선,약수,10547,10428,20975
3284,2020-03-16,3호선,금호,6561,6216,12777
3285,2020-03-16,3호선,옥수,6857,7242,14099
3286,2020-03-16,3호선,압구정,23054,24899,47953
3287,2020-03-16,3호선,신사,23802,25297,49099
3288,2020-03-16,3호선,잠원,4363,4257,8620
3289,2020-03-16,3호선,고속터미널,25428,23489,48917
3290,2020-03-16,3호선,교대,11760,7901,19661
3291,2020-03-16,3호선,남부터미널,22947,23328,46275
3292,2020-03-16,3호선,양재,31164,33862,65026
3293,2020-03-16,3호선,매봉,9524,9181,18705
3294,2020-03-16,3호선,도곡,4146,4087,8233
3295,2020-03-16,3호선,대치,7691,7556,15247
3296,2020-03-16,3호선,학여울,1317,1369,2686
3297,2020-03-16,3호선,대청,7485,6897,14382
3298,2020-03-16,3호선,일원,7030,7054,14084
3299,2020-03-16,3호선,수서,11839,12032,23871
3300,2020-03-16,3호선,가락시장,7097,6995,14092
3301,2020-03-16,3호선,경찰병원,6373,6454,12827
3302,2020-03-16,3호선,오금,5350,4684,10034
3303,2020-03-16,3호선,원흥,7328,7009,14337
3304,2020-03-16,3호선,삼송,14038,13525,27563
3305,2020-03-16,3호선,원당,8936,8542,17478
3306,2020-03-16,3호선,화정,13451,13729,27180
3307,2020-03-16,3호선,대곡,1393,1056,2449
3308,2020-03-16,3호선,백석,8141,8218,16359
3309,2020-03-16,3호선,마두,5791,5953,11744
3310,2020-03-16,3호선,정발산,5438,5668,11106
3311,2020-03-16,3호선,주엽,6509,6712,13221
3312,2020-03-16,3호선,대화,10761,8303,19064
3313,2020-03-17,3호선,주엽,6454,6693,13147
3314,2020-03-17,3호선,지축,2566,2563,5129
3315,2020-03-17,3호선,구파발,15932,14712,30644
3316,2020-03-17,3호선,연신내,31370,29481,60851
3317,2020-03-17,3호선,불광,12849,13932,26781
3318,2020-03-17,3호선,녹번,11158,10086,21244
3319,2020-03-17,3호선,홍제,13844,13292,27136
3320,2020-03-17,3호선,무악재,3145,3166,6311
3321,2020-03-17,3호선,독립문,5226,5260,10486
3322,2020-03-17,3호선,경복궁,13300,13179,26479
3323,2020-03-17,3호선,안국,14038,14553,28591
3324,2020-03-17,3호선,종로3가,8901,10024,18925
3325,2020-03-17,3호선,을지로3가,8961,9419,18380
3326,2020-03-17,3호선,충무로,1,0,1
3327,2020-03-17,3호선,동대입구,5873,6256,12129
3328,2020-03-17,3호선,약수,10400,10358,20758
3329,2020-03-17,3호선,금호,6573,6222,12795
3330,2020-03-17,3호선,옥수,6895,7206,14101
3331,2020-03-17,3호선,압구정,25001,26841,51842
3332,2020-03-17,3호선,신사,24253,25902,50155
3333,2020-03-17,3호선,잠원,4241,4096,8337
3334,2020-03-17,3호선,고속터미널,25114,24189,49303
3335,2020-03-17,3호선,교대,11741,7882,19623
3336,2020-03-17,3호선,남부터미널,22394,23047,45441
3337,2020-03-17,3호선,양재,31479,33873,65352
3338,2020-03-17,3호선,매봉,9501,9055,18556
3339,2020-03-17,3호선,도곡,3941,3986,7927
3340,2020-03-17,3호선,대치,7630,7491,15121
3341,2020-03-17,3호선,학여울,1292,1265,2557
3342,2020-03-17,3호선,대청,7515,6857,14372
3343,2020-03-17,3호선,일원,7010,6928,13938
3344,2020-03-17,3호선,수서,11653,11754,23407
3345,2020-03-17,3호선,가락시장,7162,6924,14086
3346,2020-03-17,3호선,경찰병원,6201,6288,12489
3347,2020-03-17,3호선,오금,5224,4496,9720
3348,2020-03-17,3호선,원흥,7452,7052,14504
3349,2020-03-17,3호선,삼송,13964,13396,27360
3350,2020-03-17,3호선,원당,8778,8468,17246
3351,2020-03-17,3호선,화정,13345,13898,27243
3352,2020-03-17,3호선,대곡,1443,1024,2467
3353,2020-03-17,3호선,백석,8139,8184,16323
3354,2020-03-17,3호선,마두,5587,5910,11497
3355,2020-03-17,3호선,정발산,5435,5679,11114
3356,2020-03-17,3호선,대화,10731,8312,19043
3357,2020-03-18,3호선,지축,2688,2698,5386
3358,2020-03-18,3호선,구파발,16509,15082,31591
3359,2020-03-18,3호선,연신내,32720,30862,63582
3360,2020-03-18,3호선,불광,13257,14545,27802
3361,2020-03-18,3호선,녹번,11462,10308,21770
3362,2020-03-18,3호선,홍제,14460,13714,28174
3363,2020-03-18,3호선,무악재,3294,3299,6593
3364,2020-03-18,3호선,독립문,5457,5543,11000
3365,2020-03-18,3호선,경복궁,14162,14203,28365
3366,2020-03-18,3호선,안국,14485,15250,29735
3367,2020-03-18,3호선,종로3가,9001,10308,19309
3368,2020-03-18,3호선,을지로3가,9109,9705,18814
3369,2020-03-18,3호선,동대입구,6148,6696,12844
3370,2020-03-18,3호선,약수,10786,10568,21354
3371,2020-03-18,3호선,금호,6842,6374,13216
3372,2020-03-18,3호선,옥수,7241,7502,14743
3373,2020-03-18,3호선,압구정,24932,26789,51721
3374,2020-03-18,3호선,신사,24471,26436,50907
3375,2020-03-18,3호선,잠원,4513,4375,8888
3376,2020-03-18,3호선,고속터미널,26556,25360,51916
3377,2020-03-18,3호선,교대,11864,8064,19928
3378,2020-03-18,3호선,남부터미널,22784,23404,46188
3379,2020-03-18,3호선,양재,31551,34234,65785
3380,2020-03-18,3호선,매봉,9683,9306,18989
3381,2020-03-18,3호선,도곡,4016,4073,8089
3382,2020-03-18,3호선,대치,7875,7643,15518
3383,2020-03-18,3호선,학여울,1387,1372,2759
3384,2020-03-18,3호선,대청,7726,7010,14736
3385,2020-03-18,3호선,일원,7308,7098,14406
3386,2020-03-18,3호선,수서,11693,11897,23590
3387,2020-03-18,3호선,가락시장,7335,7301,14636
3388,2020-03-18,3호선,경찰병원,6378,6342,12720
3389,2020-03-18,3호선,오금,5308,4704,10012
3390,2020-03-18,3호선,원흥,7663,7248,14911
3391,2020-03-18,3호선,삼송,14217,13672,27889
3392,2020-03-18,3호선,원당,9086,8664,17750
3393,2020-03-18,3호선,화정,13689,14225,27914
3394,2020-03-18,3호선,대곡,1487,1158,2645
3395,2020-03-18,3호선,백석,8204,8272,16476
3396,2020-03-18,3호선,마두,5721,6148,11869
3397,2020-03-18,3호선,정발산,5858,6039,11897
3398,2020-03-18,3호선,주엽,6702,6767,13469
3399,2020-03-18,3호선,대화,10942,8449,19391
3400,2020-03-19,3호선,지축,2497,2554,5051
3401,2020-03-19,3호선,구파발,15658,14272,29930
3402,2020-03-19,3호선,연신내,30461,28909,59370
3403,2020-03-19,3호선,불광,12586,13429,26015
3404,2020-03-19,3호선,녹번,10955,9742,20697
3405,2020-03-19,3호선,홍제,13624,12914,26538
3406,2020-03-19,3호선,무악재,3047,3055,6102
3407,2020-03-19,3호선,독립문,5008,5136,10144
3408,2020-03-19,3호선,경복궁,13101,12920,26021
3409,2020-03-19,3호선,안국,13668,14148,27816
3410,2020-03-19,3호선,종로3가,8888,9855,18743
3411,2020-03-19,3호선,을지로3가,8790,9355,18145
3412,2020-03-19,3호선,충무로,4,0,4
3413,2020-03-19,3호선,동대입구,5847,6182,12029
3414,2020-03-19,3호선,약수,10322,9991,20313
3415,2020-03-19,3호선,금호,6310,5965,12275
3416,2020-03-19,3호선,옥수,6762,7035,13797
3417,2020-03-19,3호선,압구정,23677,25479,49156
3418,2020-03-19,3호선,신사,23905,25456,49361
3419,2020-03-19,3호선,잠원,4209,4078,8287
3420,2020-03-19,3호선,고속터미널,24803,24393,49196
3421,2020-03-19,3호선,교대,11456,7750,19206
3422,2020-03-19,3호선,남부터미널,21761,22484,44245
3423,2020-03-19,3호선,양재,31333,33558,64891
3424,2020-03-19,3호선,매봉,9321,9033,18354
3425,2020-03-19,3호선,도곡,3890,3940,7830
3426,2020-03-19,3호선,대치,7543,7398,14941
3427,2020-03-19,3호선,학여울,1276,1240,2516
3428,2020-03-19,3호선,대청,7403,6801,14204
3429,2020-03-19,3호선,일원,6805,6735,13540
3430,2020-03-19,3호선,수서,11584,11734,23318
3431,2020-03-19,3호선,가락시장,6968,6807,13775
3432,2020-03-19,3호선,경찰병원,6051,6141,12192
3433,2020-03-19,3호선,오금,5113,4477,9590
3434,2020-03-19,3호선,원흥,7028,6607,13635
3435,2020-03-19,3호선,삼송,13409,12972,26381
3436,2020-03-19,3호선,원당,8462,8058,16520
3437,2020-03-19,3호선,화정,12730,13206,25936
3438,2020-03-19,3호선,대곡,1341,931,2272
3439,2020-03-19,3호선,백석,7759,7835,15594
3440,2020-03-19,3호선,마두,5390,5661,11051
3441,2020-03-19,3호선,정발산,5259,5369,10628
3442,2020-03-19,3호선,주엽,6180,6365,12545
3443,2020-03-19,3호선,대화,10225,7837,18062
3444,2020-03-20,3호선,지축,2670,2723,5393
3445,2020-03-20,3호선,구파발,16893,15315,32208
3446,2020-03-20,3호선,연신내,33912,32471,66383
3447,2020-03-20,3호선,불광,13789,14766,28555
3448,2020-03-20,3호선,녹번,11622,10042,21664
3449,2020-03-20,3호선,홍제,14777,13954,28731
3450,2020-03-20,3호선,무악재,3313,3239,6552
3451,2020-03-20,3호선,독립문,5645,5720,11365
3452,2020-03-20,3호선,경복궁,14404,14147,28551
3453,2020-03-20,3호선,안국,14377,15295,29672
3454,2020-03-20,3호선,종로3가,8561,10386,18947
3455,2020-03-20,3호선,을지로3가,9210,9872,19082
3456,2020-03-20,3호선,동대입구,6375,6809,13184
3457,2020-03-20,3호선,약수,11219,10855,22074
3458,2020-03-20,3호선,금호,7019,6574,13593
3459,2020-03-20,3호선,옥수,7563,7469,15032
3460,2020-03-20,3호선,압구정,26134,28313,54447
3461,2020-03-20,3호선,신사,26267,28812,55079
3462,2020-03-20,3호선,잠원,4600,4455,9055
3463,2020-03-20,3호선,고속터미널,31160,32782,63942
3464,2020-03-20,3호선,교대,12169,8156,20325
3465,2020-03-20,3호선,남부터미널,25768,26218,51986
3466,2020-03-20,3호선,양재,33467,34818,68285
3467,2020-03-20,3호선,매봉,9639,9237,18876
3468,2020-03-20,3호선,도곡,4092,4089,8181
3469,2020-03-20,3호선,대치,8190,8079,16269
3470,2020-03-20,3호선,학여울,1403,1353,2756
3471,2020-03-20,3호선,대청,7864,7008,14872
3472,2020-03-20,3호선,일원,7154,6816,13970
3473,2020-03-20,3호선,수서,13565,13597,27162
3474,2020-03-20,3호선,가락시장,7828,7601,15429
3475,2020-03-20,3호선,경찰병원,6344,6290,12634
3476,2020-03-20,3호선,오금,5497,4694,10191
3477,2020-03-20,3호선,원흥,7797,7252,15049
3478,2020-03-20,3호선,삼송,14806,13871,28677
3479,2020-03-20,3호선,원당,9360,8848,18208
3480,2020-03-20,3호선,화정,14146,14775,28921
3481,2020-03-20,3호선,대곡,1540,1103,2643
3482,2020-03-20,3호선,백석,8649,8809,17458
3483,2020-03-20,3호선,마두,5982,6334,12316
3484,2020-03-20,3호선,정발산,6157,6678,12835
3485,2020-03-20,3호선,주엽,6860,7081,13941
3486,2020-03-20,3호선,대화,10977,8760,19737
3487,2020-03-21,3호선,지축,1558,1528,3086
3488,2020-03-21,3호선,구파발,10297,10191,20488
3489,2020-03-21,3호선,연신내,23329,21831,45160
3490,2020-03-21,3호선,불광,9376,10831,20207
3491,2020-03-21,3호선,녹번,6657,5715,12372
3492,2020-03-21,3호선,홍제,9449,8950,18399
3493,2020-03-21,3호선,무악재,1960,1997,3957
3494,2020-03-21,3호선,독립문,3898,4218,8116
3495,2020-03-21,3호선,경복궁,8012,8333,16345
3496,2020-03-21,3호선,안국,6902,8091,14993
3497,2020-03-21,3호선,종로3가,4204,5944,10148
3498,2020-03-21,3호선,을지로3가,3182,3655,6837
3499,2020-03-21,3호선,동대입구,3906,4365,8271
3500,2020-03-21,3호선,약수,6704,6395,13099
3501,2020-03-21,3호선,금호,4252,4009,8261
3502,2020-03-21,3호선,옥수,4980,4992,9972
3503,2020-03-21,3호선,압구정,16767,17631,34398
3504,2020-03-21,3호선,신사,16278,17555,33833
3505,2020-03-21,3호선,잠원,2634,2527,5161
3506,2020-03-21,3호선,고속터미널,28747,28841,57588
3507,2020-03-21,3호선,교대,4344,2814,7158
3508,2020-03-21,3호선,남부터미널,13647,13852,27499
3509,2020-03-21,3호선,양재,12795,14042,26837
3510,2020-03-21,3호선,매봉,3688,3491,7179
3511,2020-03-21,3호선,도곡,2042,2049,4091
3512,2020-03-21,3호선,대치,5231,4756,9987
3513,2020-03-21,3호선,학여울,732,688,1420
3514,2020-03-21,3호선,대청,4025,3657,7682
3515,2020-03-21,3호선,일원,2803,2795,5598
3516,2020-03-21,3호선,수서,6971,7155,14126
3517,2020-03-21,3호선,가락시장,4310,3882,8192
3518,2020-03-21,3호선,경찰병원,2706,2561,5267
3519,2020-03-21,3호선,오금,2632,2382,5014
3520,2020-03-21,3호선,원흥,4830,4427,9257
3521,2020-03-21,3호선,삼송,9086,8628,17714
3522,2020-03-21,3호선,원당,6109,5791,11900
3523,2020-03-21,3호선,화정,9221,9653,18874
3524,2020-03-21,3호선,대곡,978,839,1817
3525,2020-03-21,3호선,백석,5564,5626,11190
3526,2020-03-21,3호선,마두,3528,3406,6934
3527,2020-03-21,3호선,정발산,4493,4978,9471
3528,2020-03-21,3호선,주엽,4163,4232,8395
3529,2020-03-21,3호선,대화,6156,5458,11614
3530,2020-03-22,3호선,지축,1110,1039,2149
3531,2020-03-22,3호선,구파발,7494,7577,15071
3532,2020-03-22,3호선,연신내,16186,15335,31521
3533,2020-03-22,3호선,불광,7162,8722,15884
3534,2020-03-22,3호선,녹번,4210,3788,7998
3535,2020-03-22,3호선,홍제,6187,5798,11985
3536,2020-03-22,3호선,무악재,1222,1273,2495
3537,2020-03-22,3호선,독립문,2790,3069,5859
3538,2020-03-22,3호선,경복궁,5809,6234,12043
3539,2020-03-22,3호선,안국,4783,5654,10437
3540,2020-03-22,3호선,종로3가,2282,3156,5438
3541,2020-03-22,3호선,을지로3가,1392,1483,2875
3542,2020-03-22,3호선,동대입구,3173,3874,7047
3543,2020-03-22,3호선,약수,4446,4226,8672
3544,2020-03-22,3호선,금호,2966,2760,5726
3545,2020-03-22,3호선,옥수,3413,3559,6972
3546,2020-03-22,3호선,압구정,7971,8500,16471
3547,2020-03-22,3호선,신사,9039,9215,18254
3548,2020-03-22,3호선,잠원,1795,1800,3595
3549,2020-03-22,3호선,고속터미널,24746,22861,47607
3550,2020-03-22,3호선,교대,2482,1675,4157
3551,2020-03-22,3호선,남부터미널,9952,10146,20098
3552,2020-03-22,3호선,양재,7689,9148,16837
3553,2020-03-22,3호선,매봉,2246,2320,4566
3554,2020-03-22,3호선,도곡,1082,1176,2258
3555,2020-03-22,3호선,대치,3095,2773,5868
3556,2020-03-22,3호선,학여울,449,498,947
3557,2020-03-22,3호선,대청,2635,2572,5207
3558,2020-03-22,3호선,일원,1960,2013,3973
3559,2020-03-22,3호선,수서,5678,5782,11460
3560,2020-03-22,3호선,가락시장,2380,2526,4906
3561,2020-03-22,3호선,경찰병원,1726,1758,3484
3562,2020-03-22,3호선,오금,1772,1706,3478
3563,2020-03-22,3호선,원흥,3117,3140,6257
3564,2020-03-22,3호선,삼송,6540,6426,12966
3565,2020-03-22,3호선,원당,4218,4038,8256
3566,2020-03-22,3호선,화정,6619,6817,13436
3567,2020-03-22,3호선,대곡,752,632,1384
3568,2020-03-22,3호선,백석,4089,3974,8063
3569,2020-03-22,3호선,마두,2260,2152,4412
3570,2020-03-22,3호선,정발산,3555,3519,7074
3571,2020-03-22,3호선,주엽,2728,2618,5346
3572,2020-03-22,3호선,대화,4340,3928,8268
3573,2020-03-23,3호선,지축,2626,2705,5331
3574,2020-03-23,3호선,구파발,16600,15230,31830
3575,2020-03-23,3호선,연신내,32318,30591,62909
3576,2020-03-23,3호선,불광,13411,14445,27856
3577,2020-03-23,3호선,녹번,11355,10127,21482
3578,2020-03-23,3호선,홍제,14296,13682,27978
3579,2020-03-23,3호선,무악재,3237,3247,6484
3580,2020-03-23,3호선,독립문,5468,5583,11051
3581,2020-03-23,3호선,경복궁,13623,13509,27132
3582,2020-03-23,3호선,안국,14779,15328,30107
3583,2020-03-23,3호선,종로3가,8907,10145,19052
3584,2020-03-23,3호선,을지로3가,9059,9506,18565
3585,2020-03-23,3호선,충무로,2,0,2
3586,2020-03-23,3호선,동대입구,5983,6423,12406
3587,2020-03-23,3호선,약수,10765,10494,21259
3588,2020-03-23,3호선,금호,6657,6311,12968
3589,2020-03-23,3호선,옥수,7028,7352,14380
3590,2020-03-23,3호선,압구정,25180,27165,52345
3591,2020-03-23,3호선,신사,24438,25820,50258
3592,2020-03-23,3호선,잠원,4443,4449,8892
3593,2020-03-23,3호선,고속터미널,27618,25642,53260
3594,2020-03-23,3호선,교대,12107,8276,20383
3595,2020-03-23,3호선,남부터미널,23432,24110,47542
3596,2020-03-23,3호선,양재,31689,34459,66148
3597,2020-03-23,3호선,매봉,9668,9131,18799
3598,2020-03-23,3호선,도곡,4037,4085,8122
3599,2020-03-23,3호선,대치,8106,7969,16075
3600,2020-03-23,3호선,학여울,1406,1407,2813
3601,2020-03-23,3호선,대청,7687,7111,14798
3602,2020-03-23,3호선,일원,7173,7171,14344
3603,2020-03-23,3호선,수서,12226,12486,24712
3604,2020-03-23,3호선,가락시장,7351,7345,14696
3605,2020-03-23,3호선,경찰병원,6472,6443,12915
3606,2020-03-23,3호선,오금,5444,4752,10196
3607,2020-03-23,3호선,원흥,7376,7062,14438
3608,2020-03-23,3호선,삼송,14149,13577,27726
3609,2020-03-23,3호선,원당,9267,8915,18182
3610,2020-03-23,3호선,화정,13692,14008,27700
3611,2020-03-23,3호선,대곡,1536,1110,2646
3612,2020-03-23,3호선,백석,8199,8265,16464
3613,2020-03-23,3호선,마두,5900,6169,12069
3614,2020-03-23,3호선,정발산,5730,5882,11612
3615,2020-03-23,3호선,주엽,6730,6963,13693
3616,2020-03-23,3호선,대화,11025,8390,19415
3617,2020-03-24,3호선,지축,2647,2693,5340
3618,2020-03-24,3호선,구파발,16769,15523,32292
3619,2020-03-24,3호선,연신내,32474,30602,63076
3620,2020-03-24,3호선,불광,13404,14397,27801
3621,2020-03-24,3호선,녹번,11376,10235,21611
3622,2020-03-24,3호선,홍제,14175,13547,27722
3623,2020-03-24,3호선,무악재,3198,3226,6424
3624,2020-03-24,3호선,독립문,5637,5832,11469
3625,2020-03-24,3호선,경복궁,13846,13707,27553
3626,2020-03-24,3호선,안국,15512,16067,31579
3627,2020-03-24,3호선,종로3가,8987,10238,19225
3628,2020-03-24,3호선,을지로3가,8997,9611,18608
3629,2020-03-24,3호선,동대입구,5998,6581,12579
3630,2020-03-24,3호선,약수,10809,10440,21249
3631,2020-03-24,3호선,금호,6746,6347,13093
3632,2020-03-24,3호선,옥수,7193,7453,14646
3633,2020-03-24,3호선,압구정,25333,27051,52384
3634,2020-03-24,3호선,신사,24639,25947,50586
3635,2020-03-24,3호선,잠원,4448,4464,8912
3636,2020-03-24,3호선,고속터미널,26348,25124,51472
3637,2020-03-24,3호선,교대,12439,8388,20827
3638,2020-03-24,3호선,남부터미널,23132,23842,46974
3639,2020-03-24,3호선,양재,32140,34524,66664
3640,2020-03-24,3호선,매봉,9661,9325,18986
3641,2020-03-24,3호선,도곡,4094,4028,8122
3642,2020-03-24,3호선,대치,7875,7831,15706
3643,2020-03-24,3호선,학여울,1368,1353,2721
3644,2020-03-24,3호선,대청,7647,7034,14681
3645,2020-03-24,3호선,일원,7285,7186,14471
3646,2020-03-24,3호선,수서,12033,12208,24241
3647,2020-03-24,3호선,가락시장,7431,7326,14757
3648,2020-03-24,3호선,경찰병원,6325,6355,12680
3649,2020-03-24,3호선,오금,5460,4694,10154
3650,2020-03-24,3호선,원흥,7508,7130,14638
3651,2020-03-24,3호선,삼송,14583,13995,28578
3652,2020-03-24,3호선,원당,9268,8926,18194
3653,2020-03-24,3호선,화정,14028,14418,28446
3654,2020-03-24,3호선,대곡,1468,1095,2563
3655,2020-03-24,3호선,백석,8336,8444,16780
3656,2020-03-24,3호선,마두,5884,6162,12046
3657,2020-03-24,3호선,정발산,5767,5922,11689
3658,2020-03-24,3호선,주엽,6652,6942,13594
3659,2020-03-24,3호선,대화,10933,8365,19298
3660,2020-03-25,3호선,지축,2741,2781,5522
3661,2020-03-25,3호선,구파발,16830,15536,32366
3662,2020-03-25,3호선,연신내,32970,31472,64442
3663,2020-03-25,3호선,불광,13867,14974,28841
3664,2020-03-25,3호선,녹번,11629,10456,22085
3665,2020-03-25,3호선,홍제,14549,13784,28333
3666,2020-03-25,3호선,무악재,3250,3274,6524
3667,2020-03-25,3호선,독립문,5577,5823,11400
3668,2020-03-25,3호선,경복궁,14407,14251,28658
3669,2020-03-25,3호선,안국,15061,15914,30975
3670,2020-03-25,3호선,종로3가,9035,10334,19369
3671,2020-03-25,3호선,을지로3가,9204,9812,19016
3672,2020-03-25,3호선,동대입구,6287,6738,13025
3673,2020-03-25,3호선,약수,10876,10577,21453
3674,2020-03-25,3호선,금호,6821,6533,13354
3675,2020-03-25,3호선,옥수,7275,7409,14684
3676,2020-03-25,3호선,압구정,24970,26926,51896
3677,2020-03-25,3호선,신사,24825,26442,51267
3678,2020-03-25,3호선,잠원,4557,4505,9062
3679,2020-03-25,3호선,고속터미널,27247,25889,53136
3680,2020-03-25,3호선,교대,12750,8428,21178
3681,2020-03-25,3호선,남부터미널,23139,23858,46997
3682,2020-03-25,3호선,양재,31874,34454,66328
3683,2020-03-25,3호선,매봉,9686,9240,18926
3684,2020-03-25,3호선,도곡,3900,4100,8000
3685,2020-03-25,3호선,대치,8067,7878,15945
3686,2020-03-25,3호선,학여울,1398,1370,2768
3687,2020-03-25,3호선,대청,7875,7089,14964
3688,2020-03-25,3호선,일원,7113,7129,14242
3689,2020-03-25,3호선,수서,12187,12372,24559
3690,2020-03-25,3호선,가락시장,7516,7238,14754
3691,2020-03-25,3호선,경찰병원,6360,6444,12804
3692,2020-03-25,3호선,오금,5420,4653,10073
3693,2020-03-25,3호선,원흥,7588,7221,14809
3694,2020-03-25,3호선,삼송,14577,13938,28515
3695,2020-03-25,3호선,원당,9372,8975,18347
3696,2020-03-25,3호선,화정,13995,14365,28360
3697,2020-03-25,3호선,대곡,1520,1186,2706
3698,2020-03-25,3호선,백석,8267,8283,16550
3699,2020-03-25,3호선,마두,6034,6312,12346
3700,2020-03-25,3호선,정발산,5853,6159,12012
3701,2020-03-25,3호선,주엽,6783,6931,13714
3702,2020-03-25,3호선,대화,10924,8580,19504
3703,2020-03-26,3호선,지축,2744,2716,5460
3704,2020-03-26,3호선,구파발,16545,15191,31736
3705,2020-03-26,3호선,연신내,31973,30199,62172
3706,2020-03-26,3호선,불광,13172,14211,27383
3707,2020-03-26,3호선,녹번,11415,10201,21616
3708,2020-03-26,3호선,홍제,14182,13611,27793
3709,2020-03-26,3호선,무악재,3216,3251,6467
3710,2020-03-26,3호선,독립문,5482,5715,11197
3711,2020-03-26,3호선,경복궁,13499,13519,27018
3712,2020-03-26,3호선,안국,14819,15354,30173
3713,2020-03-26,3호선,종로3가,8986,10204,19190
3714,2020-03-26,3호선,을지로3가,9009,9542,18551
3715,2020-03-26,3호선,동대입구,6038,6446,12484
3716,2020-03-26,3호선,약수,10689,10345,21034
3717,2020-03-26,3호선,금호,6644,6276,12920
3718,2020-03-26,3호선,옥수,7060,7348,14408
3719,2020-03-26,3호선,압구정,24409,26421,50830
3720,2020-03-26,3호선,신사,24126,25711,49837
3721,2020-03-26,3호선,잠원,4368,4295,8663
3722,2020-03-26,3호선,고속터미널,26722,26072,52794
3723,2020-03-26,3호선,교대,12199,8274,20473
3724,2020-03-26,3호선,남부터미널,22862,23725,46587
3725,2020-03-26,3호선,양재,31963,34343,66306
3726,2020-03-26,3호선,매봉,9524,9128,18652
3727,2020-03-26,3호선,도곡,3943,4049,7992
3728,2020-03-26,3호선,대치,7962,7817,15779
3729,2020-03-26,3호선,학여울,1334,1333,2667
3730,2020-03-26,3호선,대청,7652,7062,14714
3731,2020-03-26,3호선,일원,7168,7267,14435
3732,2020-03-26,3호선,수서,12088,12338,24426
3733,2020-03-26,3호선,가락시장,7455,7215,14670
3734,2020-03-26,3호선,경찰병원,6353,6341,12694
3735,2020-03-26,3호선,오금,5336,4660,9996
3736,2020-03-26,3호선,원흥,7458,6997,14455
3737,2020-03-26,3호선,삼송,14270,13625,27895
3738,2020-03-26,3호선,원당,9115,8750,17865
3739,2020-03-26,3호선,화정,13537,14006,27543
3740,2020-03-26,3호선,대곡,1450,1036,2486
3741,2020-03-26,3호선,백석,8224,8380,16604
3742,2020-03-26,3호선,마두,5725,5979,11704
3743,2020-03-26,3호선,정발산,5520,5699,11219
3744,2020-03-26,3호선,주엽,6565,6695,13260
3745,2020-03-26,3호선,대화,10801,8310,19111
3746,2020-03-27,3호선,지축,2720,2734,5454
3747,2020-03-27,3호선,구파발,16978,15288,32266
3748,2020-03-27,3호선,연신내,33284,31845,65129
3749,2020-03-27,3호선,불광,13761,14658,28419
3750,2020-03-27,3호선,녹번,11498,9940,21438
3751,2020-03-27,3호선,홍제,14723,13686,28409
3752,2020-03-27,3호선,무악재,3222,3202,6424
3753,2020-03-27,3호선,독립문,5532,5565,11097
3754,2020-03-27,3호선,경복궁,14138,13845,27983
3755,2020-03-27,3호선,안국,15052,15689,30741
3756,2020-03-27,3호선,종로3가,8805,10285,19090
3757,2020-03-27,3호선,을지로3가,9122,9858,18980
3758,2020-03-27,3호선,동대입구,6494,6915,13409
3759,2020-03-27,3호선,약수,11091,10941,22032
3760,2020-03-27,3호선,금호,6970,6367,13337
3761,2020-03-27,3호선,옥수,7501,7531,15032
3762,2020-03-27,3호선,압구정,26186,28537,54723
3763,2020-03-27,3호선,신사,26337,28725,55062
3764,2020-03-27,3호선,잠원,4670,4566,9236
3765,2020-03-27,3호선,고속터미널,31784,33525,65309
3766,2020-03-27,3호선,교대,12543,8335,20878
3767,2020-03-27,3호선,남부터미널,24902,25722,50624
3768,2020-03-27,3호선,양재,33670,34886,68556
3769,2020-03-27,3호선,매봉,9702,9315,19017
3770,2020-03-27,3호선,도곡,4154,4153,8307
3771,2020-03-27,3호선,대치,8432,8194,16626
3772,2020-03-27,3호선,학여울,1407,1401,2808
3773,2020-03-27,3호선,대청,7879,7190,15069
3774,2020-03-27,3호선,일원,7241,7118,14359
3775,2020-03-27,3호선,수서,13446,13708,27154
3776,2020-03-27,3호선,가락시장,7707,7491,15198
3777,2020-03-27,3호선,경찰병원,6378,6332,12710
3778,2020-03-27,3호선,오금,5412,4712,10124
3779,2020-03-27,3호선,원흥,7672,7042,14714
3780,2020-03-27,3호선,삼송,14616,13774,28390
3781,2020-03-27,3호선,원당,9495,8993,18488
3782,2020-03-27,3호선,화정,13995,14731,28726
3783,2020-03-27,3호선,대곡,1498,1132,2630
3784,2020-03-27,3호선,백석,8555,8694,17249
3785,2020-03-27,3호선,마두,6121,6385,12506
3786,2020-03-27,3호선,정발산,6089,6700,12789
3787,2020-03-27,3호선,주엽,6772,7062,13834
3788,2020-03-27,3호선,대화,10978,8599,19577
3789,2020-03-28,3호선,지축,1627,1609,3236
3790,2020-03-28,3호선,구파발,10650,10731,21381
3791,2020-03-28,3호선,연신내,24004,22469,46473
3792,2020-03-28,3호선,불광,10020,11355,21375
3793,2020-03-28,3호선,녹번,6792,5725,12517
3794,2020-03-28,3호선,홍제,9747,9166,18913
3795,2020-03-28,3호선,무악재,1888,2015,3903
3796,2020-03-28,3호선,독립문,4079,4481,8560
3797,2020-03-28,3호선,경복궁,8172,8719,16891
3798,2020-03-28,3호선,안국,6949,8150,15099
3799,2020-03-28,3호선,종로3가,3757,5228,8985
3800,2020-03-28,3호선,을지로3가,3312,3813,7125
3801,2020-03-28,3호선,동대입구,3746,4480,8226
3802,2020-03-28,3호선,약수,6935,6485,13420
3803,2020-03-28,3호선,금호,4448,4179,8627
3804,2020-03-28,3호선,옥수,5185,5108,10293
3805,2020-03-28,3호선,압구정,16926,17898,34824
3806,2020-03-28,3호선,신사,16743,17703,34446
3807,2020-03-28,3호선,잠원,2749,2673,5422
3808,2020-03-28,3호선,고속터미널,29535,27954,57489
3809,2020-03-28,3호선,교대,4494,2867,7361
3810,2020-03-28,3호선,남부터미널,13475,13558,27033
3811,2020-03-28,3호선,양재,12939,13728,26667
3812,2020-03-28,3호선,매봉,3907,3703,7610
3813,2020-03-28,3호선,도곡,2118,2133,4251
3814,2020-03-28,3호선,대치,5436,4818,10254
3815,2020-03-28,3호선,학여울,746,830,1576
3816,2020-03-28,3호선,대청,4031,3592,7623
3817,2020-03-28,3호선,일원,2749,2698,5447
3818,2020-03-28,3호선,수서,7247,7482,14729
3819,2020-03-28,3호선,가락시장,4382,3976,8358
3820,2020-03-28,3호선,경찰병원,2771,2657,5428
3821,2020-03-28,3호선,오금,2595,2356,4951
3822,2020-03-28,3호선,원흥,4825,4478,9303
3823,2020-03-28,3호선,삼송,9386,9000,18386
3824,2020-03-28,3호선,원당,6127,5915,12042
3825,2020-03-28,3호선,화정,9387,9804,19191
3826,2020-03-28,3호선,대곡,964,851,1815
3827,2020-03-28,3호선,백석,5739,5666,11405
3828,2020-03-28,3호선,마두,3573,3574,7147
3829,2020-03-28,3호선,정발산,4553,4941,9494
3830,2020-03-28,3호선,주엽,4257,4279,8536
3831,2020-03-28,3호선,대화,6404,5605,12009
3832,2020-03-29,3호선,지축,1229,1194,2423
3833,2020-03-29,3호선,구파발,8009,8178,16187
3834,2020-03-29,3호선,연신내,16882,15668,32550
3835,2020-03-29,3호선,불광,6950,8284,15234
3836,2020-03-29,3호선,녹번,4203,3776,7979
3837,2020-03-29,3호선,홍제,6464,6049,12513
3838,2020-03-29,3호선,무악재,1254,1408,2662
3839,2020-03-29,3호선,독립문,2789,3260,6049
3840,2020-03-29,3호선,경복궁,5784,6036,11820
3841,2020-03-29,3호선,안국,4880,5674,10554
3842,2020-03-29,3호선,종로3가,2315,3146,5461
3843,2020-03-29,3호선,을지로3가,1408,1628,3036
3844,2020-03-29,3호선,동대입구,3148,3843,6991
3845,2020-03-29,3호선,약수,4408,4320,8728
3846,2020-03-29,3호선,금호,3119,2982,6101
3847,2020-03-29,3호선,옥수,3603,3838,7441
3848,2020-03-29,3호선,압구정,8055,8531,16586
3849,2020-03-29,3호선,신사,8653,8790,17443
3850,2020-03-29,3호선,잠원,1836,1884,3720
3851,2020-03-29,3호선,고속터미널,25047,22912,47959
3852,2020-03-29,3호선,교대,2756,1808,4564
3853,2020-03-29,3호선,남부터미널,9783,9879,19662
3854,2020-03-29,3호선,양재,8061,9630,17691
3855,2020-03-29,3호선,매봉,2584,2531,5115
3856,2020-03-29,3호선,도곡,1189,1397,2586
3857,2020-03-29,3호선,대치,3262,2939,6201
3858,2020-03-29,3호선,학여울,503,505,1008
3859,2020-03-29,3호선,대청,2736,2600,5336
3860,2020-03-29,3호선,일원,1938,2083,4021
3861,2020-03-29,3호선,수서,5986,5981,11967
3862,2020-03-29,3호선,가락시장,2601,2688,5289
3863,2020-03-29,3호선,경찰병원,1772,1882,3654
3864,2020-03-29,3호선,오금,1852,1739,3591
3865,2020-03-29,3호선,원흥,3173,3076,6249
3866,2020-03-29,3호선,삼송,6643,6391,13034
3867,2020-03-29,3호선,원당,4409,4177,8586
3868,2020-03-29,3호선,화정,6624,6760,13384
3869,2020-03-29,3호선,대곡,758,629,1387
3870,2020-03-29,3호선,백석,3954,3875,7829
3871,2020-03-29,3호선,마두,2174,2146,4320
3872,2020-03-29,3호선,정발산,3555,3662,7217
3873,2020-03-29,3호선,주엽,2745,2683,5428
3874,2020-03-29,3호선,대화,4402,4018,8420
3875,2020-03-30,3호선,지축,2790,2797,5587
3876,2020-03-30,3호선,구파발,17196,15874,33070
3877,2020-03-30,3호선,연신내,32727,31206,63933
3878,2020-03-30,3호선,불광,13618,14727,28345
3879,2020-03-30,3호선,녹번,11467,10386,21853
3880,2020-03-30,3호선,홍제,14966,14473,29439
3881,2020-03-30,3호선,무악재,3215,3254,6469
3882,2020-03-30,3호선,독립문,5702,5876,11578
3883,2020-03-30,3호선,경복궁,13652,13723,27375
3884,2020-03-30,3호선,안국,15145,15501,30646
3885,2020-03-30,3호선,종로3가,8900,10266,19166
3886,2020-03-30,3호선,을지로3가,9194,9699,18893
3887,2020-03-30,3호선,동대입구,6160,6703,12863
3888,2020-03-30,3호선,약수,10801,10625,21426
3889,2020-03-30,3호선,금호,6720,6316,13036
3890,2020-03-30,3호선,옥수,7337,7570,14907
3891,2020-03-30,3호선,압구정,24970,26780,51750
3892,2020-03-30,3호선,신사,24201,25634,49835
3893,2020-03-30,3호선,잠원,4517,4459,8976
3894,2020-03-30,3호선,고속터미널,28107,26052,54159
3895,2020-03-30,3호선,교대,11973,8139,20112
3896,2020-03-30,3호선,남부터미널,23369,24069,47438
3897,2020-03-30,3호선,양재,31772,34574,66346
3898,2020-03-30,3호선,매봉,9872,9514,19386
3899,2020-03-30,3호선,도곡,4098,4118,8216
3900,2020-03-30,3호선,대치,8216,7993,16209
3901,2020-03-30,3호선,학여울,1416,1412,2828
3902,2020-03-30,3호선,대청,7624,7024,14648
3903,2020-03-30,3호선,일원,7136,7027,14163
3904,2020-03-30,3호선,수서,12435,12733,25168
3905,2020-03-30,3호선,가락시장,7328,7136,14464
3906,2020-03-30,3호선,경찰병원,6481,6507,12988
3907,2020-03-30,3호선,오금,5504,4774,10278
3908,2020-03-30,3호선,원흥,7680,7213,14893
3909,2020-03-30,3호선,삼송,14647,13998,28645
3910,2020-03-30,3호선,원당,9548,9155,18703
3911,2020-03-30,3호선,화정,14123,14535,28658
3912,2020-03-30,3호선,대곡,1508,1141,2649
3913,2020-03-30,3호선,백석,8438,8437,16875
3914,2020-03-30,3호선,마두,5968,6299,12267
3915,2020-03-30,3호선,정발산,5727,5914,11641
3916,2020-03-30,3호선,주엽,6975,6983,13958
3917,2020-03-30,3호선,대화,11219,8626,19845
3918,2020-03-31,3호선,지축,2781,2837,5618
3919,2020-03-31,3호선,구파발,17296,15727,33023
3920,2020-03-31,3호선,연신내,32923,31320,64243
3921,2020-03-31,3호선,불광,13674,14723,28397
3922,2020-03-31,3호선,녹번,11600,10368,21968
3923,2020-03-31,3호선,홍제,14912,14276,29188
3924,2020-03-31,3호선,무악재,3177,3170,6347
3925,2020-03-31,3호선,독립문,5909,6016,11925
3926,2020-03-31,3호선,경복궁,14088,14145,28233
3927,2020-03-31,3호선,안국,15263,16079,31342
3928,2020-03-31,3호선,종로3가,9009,10278,19287
3929,2020-03-31,3호선,을지로3가,9192,9817,19009
3930,2020-03-31,3호선,동대입구,6225,6773,12998
3931,2020-03-31,3호선,약수,10982,10774,21756
3932,2020-03-31,3호선,금호,6813,6417,13230
3933,2020-03-31,3호선,옥수,7373,7525,14898
3934,2020-03-31,3호선,압구정,25464,27339,52803
3935,2020-03-31,3호선,신사,24722,26271,50993
3936,2020-03-31,3호선,잠원,4468,4420,8888
3937,2020-03-31,3호선,고속터미널,27171,26078,53249
3938,2020-03-31,3호선,교대,12259,8206,20465
3939,2020-03-31,3호선,남부터미널,23085,23687,46772
3940,2020-03-31,3호선,양재,32345,34754,67099
3941,2020-03-31,3호선,매봉,9882,9583,19465
3942,2020-03-31,3호선,도곡,3968,4173,8141
3943,2020-03-31,3호선,대치,7989,7830,15819
3944,2020-03-31,3호선,학여울,1385,1371,2756
3945,2020-03-31,3호선,대청,7863,7063,14926
3946,2020-03-31,3호선,일원,7190,7222,14412
3947,2020-03-31,3호선,수서,12195,12331,24526
3948,2020-03-31,3호선,가락시장,7498,7387,14885
3949,2020-03-31,3호선,경찰병원,6416,6400,12816
3950,2020-03-31,3호선,오금,5438,4788,10226
3951,2020-03-31,3호선,원흥,7676,7262,14938
3952,2020-03-31,3호선,삼송,14751,14007,28758
3953,2020-03-31,3호선,원당,9456,8972,18428
3954,2020-03-31,3호선,화정,14285,14713,28998
3955,2020-03-31,3호선,대곡,1463,1125,2588
3956,2020-03-31,3호선,백석,8340,8464,16804
3957,2020-03-31,3호선,마두,6013,6345,12358
3958,2020-03-31,3호선,정발산,5888,6142,12030
3959,2020-03-31,3호선,주엽,6718,6826,13544
3960,2020-03-31,3호선,대화,11039,8590,19629
3961,2020-04-01,3호선,지축,2823,2762,5585
3962,2020-04-01,3호선,구파발,17084,15923,33007
3963,2020-04-01,3호선,연신내,33123,31183,64306
3964,2020-04-01,3호선,불광,13640,14717,28357
3965,2020-04-01,3호선,녹번,11631,10387,22018
3966,2020-04-01,3호선,홍제,15054,14368,29422
3967,2020-04-01,3호선,무악재,3267,3226,6493
3968,2020-04-01,3호선,독립문,5819,6163,11982
3969,2020-04-01,3호선,경복궁,14337,14292,28629
3970,2020-04-01,3호선,안국,15323,15897,31220
3971,2020-04-01,3호선,종로3가,9012,10328,19340
3972,2020-04-01,3호선,을지로3가,9215,9694,18909
3973,2020-04-01,3호선,충무로,1,0,1
3974,2020-04-01,3호선,동대입구,6203,6833,13036
3975,2020-04-01,3호선,약수,11087,10856,21943
3976,2020-04-01,3호선,금호,6774,6360,13134
3977,2020-04-01,3호선,옥수,7318,7509,14827
3978,2020-04-01,3호선,압구정,25103,27025,52128
3979,2020-04-01,3호선,신사,24391,25825,50216
3980,2020-04-01,3호선,잠원,4588,4492,9080
3981,2020-04-01,3호선,고속터미널,26876,25858,52734
3982,2020-04-01,3호선,교대,12349,8385,20734
3983,2020-04-01,3호선,남부터미널,23039,23771,46810
3984,2020-04-01,3호선,양재,32328,34986,67314
3985,2020-04-01,3호선,매봉,10094,9688,19782
3986,2020-04-01,3호선,도곡,4029,4322,8351
3987,2020-04-01,3호선,대치,8006,7842,15848
3988,2020-04-01,3호선,학여울,1387,1431,2818
3989,2020-04-01,3호선,대청,7720,7135,14855
3990,2020-04-01,3호선,일원,7386,7168,14554
3991,2020-04-01,3호선,수서,11943,12211,24154
3992,2020-04-01,3호선,가락시장,7506,7251,14757
3993,2020-04-01,3호선,경찰병원,6402,6429,12831
3994,2020-04-01,3호선,오금,5410,4719,10129
3995,2020-04-01,3호선,원흥,7759,7170,14929
3996,2020-04-01,3호선,지축,1,0,1
3997,2020-04-01,3호선,삼송,14650,14069,28719
3998,2020-04-01,3호선,원당,9473,9024,18497
3999,2020-04-01,3호선,화정,13941,14531,28472
4000,2020-04-01,3호선,대곡,1515,1164,2679
4001,2020-04-01,3호선,백석,8359,8374,16733
4002,2020-04-01,3호선,마두,6048,6306,12354
4003,2020-04-01,3호선,정발산,6063,6182,12245
4004,2020-04-01,3호선,주엽,6708,6808,13516
4005,2020-04-01,3호선,대화,10917,8492,19409
4006,2020-04-02,3호선,지축,2843,2814,5657
4007,2020-04-02,3호선,구파발,17351,16141,33492
4008,2020-04-02,3호선,연신내,33003,31088,64091
4009,2020-04-02,3호선,불광,13686,14647,28333
4010,2020-04-02,3호선,녹번,11689,10379,22068
4011,2020-04-02,3호선,홍제,14790,14169,28959
4012,2020-04-02,3호선,무악재,3339,3309,6648
4013,2020-04-02,3호선,독립문,5694,6058,11752
4014,2020-04-02,3호선,경복궁,14351,14457,28808
4015,2020-04-02,3호선,안국,15110,15758,30868
4016,2020-04-02,3호선,종로3가,8837,10209,19046
4017,2020-04-02,3호선,을지로3가,9098,9721,18819
4018,2020-04-02,3호선,충무로,2,0,2
4019,2020-04-02,3호선,동대입구,6218,6741,12959
4020,2020-04-02,3호선,약수,11068,10772,21840
4021,2020-04-02,3호선,금호,6891,6445,13336
4022,2020-04-02,3호선,옥수,7305,7549,14854
4023,2020-04-02,3호선,압구정,25107,26886,51993
4024,2020-04-02,3호선,신사,24714,26258,50972
4025,2020-04-02,3호선,잠원,4637,4547,9184
4026,2020-04-02,3호선,고속터미널,27359,26829,54188
4027,2020-04-02,3호선,교대,12306,8304,20610
4028,2020-04-02,3호선,남부터미널,22755,23485,46240
4029,2020-04-02,3호선,양재,32755,35202,67957
4030,2020-04-02,3호선,매봉,9895,9538,19433
4031,2020-04-02,3호선,도곡,3987,4229,8216
4032,2020-04-02,3호선,대치,8148,7939,16087
4033,2020-04-02,3호선,학여울,1430,1458,2888
4034,2020-04-02,3호선,대청,7661,6923,14584
4035,2020-04-02,3호선,일원,7374,7260,14634
4036,2020-04-02,3호선,수서,12267,12561,24828
4037,2020-04-02,3호선,가락시장,7514,7435,14949
4038,2020-04-02,3호선,경찰병원,6352,6378,12730
4039,2020-04-02,3호선,오금,5415,4725,10140
4040,2020-04-02,3호선,원흥,7723,7119,14842
4041,2020-04-02,3호선,삼송,14663,14104,28767
4042,2020-04-02,3호선,원당,9333,8910,18243
4043,2020-04-02,3호선,화정,14039,14462,28501
4044,2020-04-02,3호선,대곡,1545,1166,2711
4045,2020-04-02,3호선,백석,8350,8303,16653
4046,2020-04-02,3호선,마두,5862,6084,11946
4047,2020-04-02,3호선,정발산,5896,5979,11875
4048,2020-04-02,3호선,주엽,6740,6810,13550
4049,2020-04-02,3호선,대화,10922,8568,19490
4050,2020-04-03,3호선,지축,2926,2773,5699
4051,2020-04-03,3호선,구파발,17444,16019,33463
4052,2020-04-03,3호선,연신내,34222,32636,66858
4053,2020-04-03,3호선,불광,13876,14779,28655
4054,2020-04-03,3호선,녹번,11696,10249,21945
4055,2020-04-03,3호선,홍제,15332,14327,29659
4056,2020-04-03,3호선,무악재,3332,3251,6583
4057,2020-04-03,3호선,독립문,6052,6418,12470
4058,2020-04-03,3호선,경복궁,14804,14636,29440
4059,2020-04-03,3호선,안국,15576,16162,31738
4060,2020-04-03,3호선,종로3가,8545,10202,18747
4061,2020-04-03,3호선,을지로3가,9267,10025,19292
4062,2020-04-03,3호선,충무로,1,0,1
4063,2020-04-03,3호선,동대입구,6382,7002,13384
4064,2020-04-03,3호선,약수,11257,11140,22397
4065,2020-04-03,3호선,금호,7154,6506,13660
4066,2020-04-03,3호선,옥수,7730,7871,15601
4067,2020-04-03,3호선,압구정,26410,28583,54993
4068,2020-04-03,3호선,신사,26500,28887,55387
4069,2020-04-03,3호선,잠원,4817,4707,9524
4070,2020-04-03,3호선,고속터미널,33117,34869,67986
4071,2020-04-03,3호선,교대,12762,8605,21367
4072,2020-04-03,3호선,남부터미널,25284,25996,51280
4073,2020-04-03,3호선,양재,34413,35938,70351
4074,2020-04-03,3호선,매봉,10264,9785,20049
4075,2020-04-03,3호선,도곡,4196,4416,8612
4076,2020-04-03,3호선,대치,8336,8159,16495
4077,2020-04-03,3호선,학여울,1475,1507,2982
4078,2020-04-03,3호선,대청,7907,7145,15052
4079,2020-04-03,3호선,일원,7431,7314,14745
4080,2020-04-03,3호선,수서,13818,13909,27727
4081,2020-04-03,3호선,가락시장,7792,7710,15502
4082,2020-04-03,3호선,경찰병원,6500,6461,12961
4083,2020-04-03,3호선,오금,5574,4776,10350
4084,2020-04-03,3호선,화정,14638,15098,29736
4085,2020-04-03,3호선,원흥,7860,7229,15089
4086,2020-04-03,3호선,삼송,15349,14492,29841
4087,2020-04-03,3호선,원당,9780,9072,18852
4088,2020-04-03,3호선,대곡,1627,1268,2895
4089,2020-04-03,3호선,백석,8800,8903,17703
4090,2020-04-03,3호선,마두,6202,6514,12716
4091,2020-04-03,3호선,정발산,6324,6740,13064
4092,2020-04-03,3호선,주엽,7013,7385,14398
4093,2020-04-03,3호선,대화,10929,8855,19784
4094,2020-04-04,3호선,지축,1668,1654,3322
4095,2020-04-04,3호선,구파발,11035,11031,22066
4096,2020-04-04,3호선,연신내,24079,22595,46674
4097,2020-04-04,3호선,불광,9733,11076,20809
4098,2020-04-04,3호선,녹번,6754,5925,12679
4099,2020-04-04,3호선,홍제,9902,9363,19265
4100,2020-04-04,3호선,무악재,1959,2065,4024
4101,2020-04-04,3호선,독립문,4176,4580,8756
4102,2020-04-04,3호선,경복궁,8771,9150,17921
4103,2020-04-04,3호선,안국,7607,8742,16349
4104,2020-04-04,3호선,종로3가,3852,5427,9279
4105,2020-04-04,3호선,을지로3가,3262,3645,6907
4106,2020-04-04,3호선,동대입구,4312,5226,9538
4107,2020-04-04,3호선,약수,7029,6559,13588
4108,2020-04-04,3호선,금호,4621,4305,8926
4109,2020-04-04,3호선,옥수,5101,5155,10256
4110,2020-04-04,3호선,압구정,16760,17769,34529
4111,2020-04-04,3호선,신사,16543,17612,34155
4112,2020-04-04,3호선,잠원,2824,2759,5583
4113,2020-04-04,3호선,고속터미널,30623,30913,61536
4114,2020-04-04,3호선,교대,4365,2816,7181
4115,2020-04-04,3호선,남부터미널,13368,13647,27015
4116,2020-04-04,3호선,양재,12866,13880,26746
4117,2020-04-04,3호선,매봉,3849,3596,7445
4118,2020-04-04,3호선,도곡,2029,1964,3993
4119,2020-04-04,3호선,대치,5508,5129,10637
4120,2020-04-04,3호선,학여울,756,747,1503
4121,2020-04-04,3호선,대청,4267,3912,8179
4122,2020-04-04,3호선,일원,2885,2916,5801
4123,2020-04-04,3호선,수서,7676,7763,15439
4124,2020-04-04,3호선,가락시장,4340,4152,8492
4125,2020-04-04,3호선,경찰병원,2771,2660,5431
4126,2020-04-04,3호선,오금,2638,2420,5058
4127,2020-04-04,3호선,원흥,4916,4522,9438
4128,2020-04-04,3호선,삼송,9500,9056,18556
4129,2020-04-04,3호선,원당,6242,5951,12193
4130,2020-04-04,3호선,화정,9462,9884,19346
4131,2020-04-04,3호선,대곡,944,828,1772
4132,2020-04-04,3호선,백석,5754,5807,11561
4133,2020-04-04,3호선,마두,3567,3614,7181
4134,2020-04-04,3호선,정발산,4954,5438,10392
4135,2020-04-04,3호선,주엽,4289,4345,8634
4136,2020-04-04,3호선,대화,6490,5743,12233
4137,2020-04-05,3호선,지축,1165,1117,2282
4138,2020-04-05,3호선,구파발,8184,8454,16638
4139,2020-04-05,3호선,연신내,17067,15773,32840
4140,2020-04-05,3호선,불광,7005,8662,15667
4141,2020-04-05,3호선,녹번,4435,4043,8478
4142,2020-04-05,3호선,홍제,6527,6335,12862
4143,2020-04-05,3호선,무악재,1310,1349,2659
4144,2020-04-05,3호선,독립문,2921,3369,6290
4145,2020-04-05,3호선,경복궁,5959,6425,12384
4146,2020-04-05,3호선,안국,5095,5722,10817
4147,2020-04-05,3호선,종로3가,2315,2996,5311
4148,2020-04-05,3호선,을지로3가,1428,1526,2954
4149,2020-04-05,3호선,동대입구,3368,4232,7600
4150,2020-04-05,3호선,약수,4527,4396,8923
4151,2020-04-05,3호선,금호,3011,2938,5949
4152,2020-04-05,3호선,옥수,3387,3647,7034
4153,2020-04-05,3호선,압구정,8084,8360,16444
4154,2020-04-05,3호선,신사,8723,8694,17417
4155,2020-04-05,3호선,잠원,1733,1805,3538
4156,2020-04-05,3호선,고속터미널,25173,23223,48396
4157,2020-04-05,3호선,교대,2617,1731,4348
4158,2020-04-05,3호선,남부터미널,9585,9861,19446
4159,2020-04-05,3호선,양재,7920,9264,17184
4160,2020-04-05,3호선,매봉,2265,2299,4564
4161,2020-04-05,3호선,도곡,1138,1324,2462
4162,2020-04-05,3호선,대치,3394,3048,6442
4163,2020-04-05,3호선,학여울,491,487,978
4164,2020-04-05,3호선,대청,2811,2689,5500
4165,2020-04-05,3호선,일원,1859,2042,3901
4166,2020-04-05,3호선,수서,6154,5974,12128
4167,2020-04-05,3호선,가락시장,2533,2861,5394
4168,2020-04-05,3호선,경찰병원,1877,1879,3756
4169,2020-04-05,3호선,오금,1923,1816,3739
4170,2020-04-05,3호선,원흥,3347,3132,6479
4171,2020-04-05,3호선,삼송,6857,6618,13475
4172,2020-04-05,3호선,원당,4442,4139,8581
4173,2020-04-05,3호선,화정,6703,6960,13663
4174,2020-04-05,3호선,대곡,744,611,1355
4175,2020-04-05,3호선,백석,4037,3941,7978
4176,2020-04-05,3호선,마두,2323,2263,4586
4177,2020-04-05,3호선,정발산,3694,3753,7447
4178,2020-04-05,3호선,주엽,2843,2732,5575
4179,2020-04-05,3호선,대화,4511,3969,8480
4180,2020-04-06,3호선,지축,2942,2931,5873
4181,2020-04-06,3호선,구파발,18085,16682,34767
4182,2020-04-06,3호선,연신내,33779,31916,65695
4183,2020-04-06,3호선,불광,14080,15237,29317
4184,2020-04-06,3호선,녹번,11815,10577,22392
4185,2020-04-06,3호선,홍제,15295,14687,29982
4186,2020-04-06,3호선,무악재,3382,3400,6782
4187,2020-04-06,3호선,독립문,5960,6247,12207
4188,2020-04-06,3호선,경복궁,14625,14277,28902
4189,2020-04-06,3호선,안국,15681,16144,31825
4190,2020-04-06,3호선,종로3가,8920,10256,19176
4191,2020-04-06,3호선,을지로3가,9576,10066,19642
4192,2020-04-06,3호선,동대입구,6245,6754,12999
4193,2020-04-06,3호선,약수,11073,11109,22182
4194,2020-04-06,3호선,금호,6991,6683,13674
4195,2020-04-06,3호선,옥수,7400,7810,15210
4196,2020-04-06,3호선,압구정,26367,28305,54672
4197,2020-04-06,3호선,신사,24890,26412,51302
4198,2020-04-06,3호선,잠원,4681,4583,9264
4199,2020-04-06,3호선,고속터미널,28849,26740,55589
4200,2020-04-06,3호선,교대,12252,8395,20647
4201,2020-04-06,3호선,남부터미널,24028,24712,48740
4202,2020-04-06,3호선,양재,33416,36196,69612
4203,2020-04-06,3호선,매봉,9961,9579,19540
4204,2020-04-06,3호선,도곡,4352,4442,8794
4205,2020-04-06,3호선,대치,8484,8229,16713
4206,2020-04-06,3호선,학여울,1436,1415,2851
4207,2020-04-06,3호선,대청,8161,7527,15688
4208,2020-04-06,3호선,일원,7664,7625,15289
4209,2020-04-06,3호선,수서,12943,13160,26103
4210,2020-04-06,3호선,가락시장,7674,7362,15036
4211,2020-04-06,3호선,경찰병원,6789,6750,13539
4212,2020-04-06,3호선,오금,5548,4936,10484
4213,2020-04-06,3호선,원흥,7798,7254,15052
4214,2020-04-06,3호선,삼송,14861,14559,29420
4215,2020-04-06,3호선,원당,9692,9123,18815
4216,2020-04-06,3호선,화정,14416,14969,29385
4217,2020-04-06,3호선,대곡,1623,1196,2819
4218,2020-04-06,3호선,백석,8455,8463,16918
4219,2020-04-06,3호선,마두,6217,6493,12710
4220,2020-04-06,3호선,정발산,5937,6123,12060
4221,2020-04-06,3호선,주엽,7226,7304,14530
4222,2020-04-06,3호선,대화,11400,8743,20143
4223,2020-04-07,3호선,지축,2999,2941,5940
4224,2020-04-07,3호선,구파발,18049,16766,34815
4225,2020-04-07,3호선,연신내,33655,32087,65742
4226,2020-04-07,3호선,불광,14040,15176,29216
4227,2020-04-07,3호선,녹번,12013,10765,22778
4228,2020-04-07,3호선,홍제,15323,14455,29778
4229,2020-04-07,3호선,무악재,3434,3371,6805
4230,2020-04-07,3호선,독립문,5989,6184,12173
4231,2020-04-07,3호선,경복궁,14790,14654,29444
4232,2020-04-07,3호선,안국,15612,16267,31879
4233,2020-04-07,3호선,종로3가,9109,10389,19498
4234,2020-04-07,3호선,을지로3가,9406,10134,19540
4235,2020-04-07,3호선,충무로,2,0,2
4236,2020-04-07,3호선,동대입구,6423,6937,13360
4237,2020-04-07,3호선,약수,11173,11066,22239
4238,2020-04-07,3호선,금호,7125,6665,13790
4239,2020-04-07,3호선,옥수,7684,7889,15573
4240,2020-04-07,3호선,압구정,26776,28776,55552
4241,2020-04-07,3호선,신사,25551,27183,52734
4242,2020-04-07,3호선,잠원,4810,4629,9439
4243,2020-04-07,3호선,고속터미널,27507,26527,54034
4244,2020-04-07,3호선,교대,12459,8575,21034
4245,2020-04-07,3호선,남부터미널,23746,24166,47912
4246,2020-04-07,3호선,양재,33998,36679,70677
4247,2020-04-07,3호선,매봉,9961,9648,19609
4248,2020-04-07,3호선,도곡,4200,4287,8487
4249,2020-04-07,3호선,대치,8377,8123,16500
4250,2020-04-07,3호선,학여울,1436,1463,2899
4251,2020-04-07,3호선,대청,8280,7563,15843
4252,2020-04-07,3호선,일원,7814,7885,15699
4253,2020-04-07,3호선,수서,12912,12980,25892
4254,2020-04-07,3호선,가락시장,7853,7566,15419
4255,2020-04-07,3호선,경찰병원,6746,6630,13376
4256,2020-04-07,3호선,오금,5644,5010,10654
4257,2020-04-07,3호선,원흥,7840,7307,15147
4258,2020-04-07,3호선,삼송,15003,14487,29490
4259,2020-04-07,3호선,원당,9594,9120,18714
4260,2020-04-07,3호선,화정,14430,14959,29389
4261,2020-04-07,3호선,대곡,1571,1225,2796
4262,2020-04-07,3호선,백석,8384,8411,16795
4263,2020-04-07,3호선,마두,6028,6280,12308
4264,2020-04-07,3호선,정발산,6043,6165,12208
4265,2020-04-07,3호선,주엽,6989,7074,14063
4266,2020-04-07,3호선,대화,11352,8815,20167
4267,2020-04-08,3호선,지축,2984,2934,5918
4268,2020-04-08,3호선,구파발,18039,16883,34922
4269,2020-04-08,3호선,연신내,33881,32113,65994
4270,2020-04-08,3호선,불광,13916,14993,28909
4271,2020-04-08,3호선,녹번,12042,10855,22897
4272,2020-04-08,3호선,홍제,15375,14557,29932
4273,2020-04-08,3호선,무악재,3383,3383,6766
4274,2020-04-08,3호선,독립문,5942,6331,12273
4275,2020-04-08,3호선,경복궁,15373,15058,30431
4276,2020-04-08,3호선,안국,15615,16478,32093
4277,2020-04-08,3호선,종로3가,9182,10460,19642
4278,2020-04-08,3호선,을지로3가,9615,10078,19693
4279,2020-04-08,3호선,동대입구,6394,6948,13342
4280,2020-04-08,3호선,약수,11196,11081,22277
4281,2020-04-08,3호선,금호,7192,6737,13929
4282,2020-04-08,3호선,옥수,7701,7904,15605
4283,2020-04-08,3호선,압구정,26242,28384,54626
4284,2020-04-08,3호선,신사,25759,27309,53068
4285,2020-04-08,3호선,잠원,4850,4760,9610
4286,2020-04-08,3호선,고속터미널,28127,26934,55061
4287,2020-04-08,3호선,교대,12802,8594,21396
4288,2020-04-08,3호선,남부터미널,23736,24529,48265
4289,2020-04-08,3호선,양재,33984,36425,70409
4290,2020-04-08,3호선,매봉,10002,9590,19592
4291,2020-04-08,3호선,도곡,4217,4375,8592
4292,2020-04-08,3호선,대치,8391,8180,16571
4293,2020-04-08,3호선,학여울,1434,1475,2909
4294,2020-04-08,3호선,대청,8308,7629,15937
4295,2020-04-08,3호선,일원,7822,7685,15507
4296,2020-04-08,3호선,수서,13045,13105,26150
4297,2020-04-08,3호선,가락시장,7757,7632,15389
4298,2020-04-08,3호선,경찰병원,6620,6612,13232
4299,2020-04-08,3호선,오금,5706,4990,10696
4300,2020-04-08,3호선,원흥,7834,7350,15184
4301,2020-04-08,3호선,삼송,15298,14404,29702
4302,2020-04-08,3호선,원당,9568,9233,18801
4303,2020-04-08,3호선,화정,14690,14942,29632
4304,2020-04-08,3호선,대곡,1563,1177,2740
4305,2020-04-08,3호선,백석,8315,8257,16572
4306,2020-04-08,3호선,마두,6068,6368,12436
4307,2020-04-08,3호선,정발산,6223,6513,12736
4308,2020-04-08,3호선,주엽,7106,7342,14448
4309,2020-04-08,3호선,대화,11246,8750,19996
4310,2020-04-09,3호선,지축,2990,2919,5909
4311,2020-04-09,3호선,구파발,18061,16783,34844
4312,2020-04-09,3호선,연신내,33652,31678,65330
4313,2020-04-09,3호선,불광,14029,15094,29123
4314,2020-04-09,3호선,녹번,11944,10674,22618
4315,2020-04-09,3호선,홍제,15391,14580,29971
4316,2020-04-09,3호선,무악재,3429,3355,6784
4317,2020-04-09,3호선,독립문,5967,6391,12358
4318,2020-04-09,3호선,경복궁,15163,14896,30059
4319,2020-04-09,3호선,안국,15712,16309,32021
4320,2020-04-09,3호선,종로3가,8944,10361,19305
4321,2020-04-09,3호선,을지로3가,9502,10149,19651
4322,2020-04-09,3호선,충무로,1,0,1
4323,2020-04-09,3호선,동대입구,6374,7057,13431
4324,2020-04-09,3호선,약수,11206,11198,22404
4325,2020-04-09,3호선,금호,7109,6623,13732
4326,2020-04-09,3호선,옥수,7687,7815,15502
4327,2020-04-09,3호선,압구정,25956,28027,53983
4328,2020-04-09,3호선,신사,25620,27313,52933
4329,2020-04-09,3호선,잠원,4749,4630,9379
4330,2020-04-09,3호선,고속터미널,27765,27477,55242
4331,2020-04-09,3호선,교대,12784,8653,21437
4332,2020-04-09,3호선,남부터미널,24014,24471,48485
4333,2020-04-09,3호선,양재,33737,36665,70402
4334,2020-04-09,3호선,매봉,9963,9543,19506
4335,2020-04-09,3호선,도곡,4204,4272,8476
4336,2020-04-09,3호선,대치,8451,8269,16720
4337,2020-04-09,3호선,학여울,1437,1420,2857
4338,2020-04-09,3호선,대청,8128,7386,15514
4339,2020-04-09,3호선,일원,7833,7560,15393
4340,2020-04-09,3호선,수서,12866,13104,25970
4341,2020-04-09,3호선,가락시장,7829,7635,15464
4342,2020-04-09,3호선,경찰병원,6639,6636,13275
4343,2020-04-09,3호선,오금,5588,4974,10562
4344,2020-04-09,3호선,화정,14267,14735,29002
4345,2020-04-09,3호선,원흥,7842,7294,15136
4346,2020-04-09,3호선,삼송,15165,14516,29681
4347,2020-04-09,3호선,원당,9592,9039,18631
4348,2020-04-09,3호선,대곡,1499,1188,2687
4349,2020-04-09,3호선,백석,8656,8561,17217
4350,2020-04-09,3호선,마두,6113,6386,12499
4351,2020-04-09,3호선,정발산,6121,6318,12439
4352,2020-04-09,3호선,주엽,6935,7051,13986
4353,2020-04-09,3호선,대화,11213,8819,20032
4354,2020-04-10,3호선,지축,3098,2934,6032
4355,2020-04-10,3호선,구파발,18440,17054,35494
4356,2020-04-10,3호선,연신내,34708,33187,67895
4357,2020-04-10,3호선,불광,14571,15338,29909
4358,2020-04-10,3호선,녹번,12324,10742,23066
4359,2020-04-10,3호선,홍제,15849,14773,30622
4360,2020-04-10,3호선,무악재,3475,3426,6901
4361,2020-04-10,3호선,독립문,6193,6311,12504
4362,2020-04-10,3호선,경복궁,15581,15371,30952
4363,2020-04-10,3호선,안국,15962,16516,32478
4364,2020-04-10,3호선,종로3가,8611,10380,18991
4365,2020-04-10,3호선,을지로3가,9720,10514,20234
4366,2020-04-10,3호선,충무로,1,0,1
4367,2020-04-10,3호선,동대입구,6439,6999,13438
4368,2020-04-10,3호선,약수,11703,11549,23252
4369,2020-04-10,3호선,금호,7266,6665,13931
4370,2020-04-10,3호선,옥수,8191,8230,16421
4371,2020-04-10,3호선,압구정,28371,30871,59242
4372,2020-04-10,3호선,신사,27391,30006,57397
4373,2020-04-10,3호선,잠원,4977,4788,9765
4374,2020-04-10,3호선,고속터미널,33381,35917,69298
4375,2020-04-10,3호선,교대,13102,8733,21835
4376,2020-04-10,3호선,남부터미널,26790,27412,54202
4377,2020-04-10,3호선,양재,35165,36653,71818
4378,2020-04-10,3호선,매봉,10163,9737,19900
4379,2020-04-10,3호선,도곡,4427,4433,8860
4380,2020-04-10,3호선,대치,8720,8546,17266
4381,2020-04-10,3호선,학여울,1538,1495,3033
4382,2020-04-10,3호선,대청,8273,7497,15770
4383,2020-04-10,3호선,일원,7972,7573,15545
4384,2020-04-10,3호선,수서,14528,14795,29323
4385,2020-04-10,3호선,가락시장,8201,7925,16126
4386,2020-04-10,3호선,경찰병원,6745,6637,13382
4387,2020-04-10,3호선,오금,5766,5027,10793
4388,2020-04-10,3호선,원흥,7903,7326,15229
4389,2020-04-10,3호선,삼송,15566,14631,30197
4390,2020-04-10,3호선,원당,10073,9375,19448
4391,2020-04-10,3호선,화정,14794,15462,30256
4392,2020-04-10,3호선,대곡,1576,1257,2833
4393,2020-04-10,3호선,백석,8978,9107,18085
4394,2020-04-10,3호선,마두,6469,6806,13275
4395,2020-04-10,3호선,정발산,6371,6944,13315
4396,2020-04-10,3호선,주엽,7417,7564,14981
4397,2020-04-10,3호선,대화,11610,9102,20712
4398,2020-04-11,3호선,지축,1781,1794,3575
4399,2020-04-11,3호선,구파발,11986,11716,23702
4400,2020-04-11,3호선,연신내,24988,23490,48478
4401,2020-04-11,3호선,불광,9979,11865,21844
4402,2020-04-11,3호선,녹번,7228,6241,13469
4403,2020-04-11,3호선,홍제,10231,9691,19922
4404,2020-04-11,3호선,무악재,2126,2072,4198
4405,2020-04-11,3호선,독립문,4597,5028,9625
4406,2020-04-11,3호선,경복궁,9166,9605,18771
4407,2020-04-11,3호선,안국,7613,9057,16670
4408,2020-04-11,3호선,종로3가,4016,5549,9565
4409,2020-04-11,3호선,을지로3가,3392,3795,7187
4410,2020-04-11,3호선,동대입구,4378,5309,9687
4411,2020-04-11,3호선,약수,7400,6865,14265
4412,2020-04-11,3호선,금호,4679,4381,9060
4413,2020-04-11,3호선,옥수,5417,5324,10741
4414,2020-04-11,3호선,압구정,17814,18802,36616
4415,2020-04-11,3호선,신사,17690,18830,36520
4416,2020-04-11,3호선,잠원,2980,2849,5829
4417,2020-04-11,3호선,고속터미널,31676,32299,63975
4418,2020-04-11,3호선,교대,4813,3085,7898
4419,2020-04-11,3호선,남부터미널,14396,14495,28891
4420,2020-04-11,3호선,양재,14033,14974,29007
4421,2020-04-11,3호선,매봉,4033,3771,7804
4422,2020-04-11,3호선,도곡,2259,2196,4455
4423,2020-04-11,3호선,대치,6248,5712,11960
4424,2020-04-11,3호선,학여울,808,802,1610
4425,2020-04-11,3호선,대청,4386,3995,8381
4426,2020-04-11,3호선,일원,3063,3041,6104
4427,2020-04-11,3호선,수서,8032,8083,16115
4428,2020-04-11,3호선,가락시장,4768,4481,9249
4429,2020-04-11,3호선,경찰병원,3009,2835,5844
4430,2020-04-11,3호선,오금,2838,2517,5355
4431,2020-04-11,3호선,원흥,5013,4679,9692
4432,2020-04-11,3호선,삼송,10168,9704,19872
4433,2020-04-11,3호선,원당,6763,6313,13076
4434,2020-04-11,3호선,화정,10269,10717,20986
4435,2020-04-11,3호선,대곡,1086,880,1966
4436,2020-04-11,3호선,백석,6137,6097,12234
4437,2020-04-11,3호선,마두,3705,3847,7552
4438,2020-04-11,3호선,정발산,5088,5642,10730
4439,2020-04-11,3호선,주엽,4720,4733,9453
4440,2020-04-11,3호선,대화,6726,5897,12623
4441,2020-04-12,3호선,지축,1175,1172,2347
4442,2020-04-12,3호선,구파발,8207,8424,16631
4443,2020-04-12,3호선,연신내,17393,16063,33456
4444,2020-04-12,3호선,불광,7394,9172,16566
4445,2020-04-12,3호선,녹번,4502,4039,8541
4446,2020-04-12,3호선,홍제,6845,6616,13461
4447,2020-04-12,3호선,무악재,1350,1508,2858
4448,2020-04-12,3호선,독립문,3295,3513,6808
4449,2020-04-12,3호선,경복궁,6374,6502,12876
4450,2020-04-12,3호선,안국,5109,5732,10841
4451,2020-04-12,3호선,종로3가,2353,3139,5492
4452,2020-04-12,3호선,을지로3가,1716,1832,3548
4453,2020-04-12,3호선,충무로,1,0,1
4454,2020-04-12,3호선,동대입구,3301,3957,7258
4455,2020-04-12,3호선,약수,4764,4539,9303
4456,2020-04-12,3호선,금호,3311,3155,6466
4457,2020-04-12,3호선,옥수,3609,3862,7471
4458,2020-04-12,3호선,압구정,8619,9275,17894
4459,2020-04-12,3호선,신사,9104,9183,18287
4460,2020-04-12,3호선,잠원,1727,1738,3465
4461,2020-04-12,3호선,고속터미널,26196,24399,50595
4462,2020-04-12,3호선,교대,2724,1834,4558
4463,2020-04-12,3호선,남부터미널,10439,10816,21255
4464,2020-04-12,3호선,양재,8306,9691,17997
4465,2020-04-12,3호선,매봉,2529,2482,5011
4466,2020-04-12,3호선,도곡,1177,1254,2431
4467,2020-04-12,3호선,대치,3994,3474,7468
4468,2020-04-12,3호선,학여울,503,517,1020
4469,2020-04-12,3호선,대청,2847,2760,5607
4470,2020-04-12,3호선,일원,1961,2161,4122
4471,2020-04-12,3호선,수서,6499,6302,12801
4472,2020-04-12,3호선,가락시장,2519,2798,5317
4473,2020-04-12,3호선,경찰병원,1901,1985,3886
4474,2020-04-12,3호선,오금,1979,1897,3876
4475,2020-04-12,3호선,원흥,3228,3190,6418
4476,2020-04-12,3호선,삼송,6942,6835,13777
4477,2020-04-12,3호선,원당,4593,4371,8964
4478,2020-04-12,3호선,화정,6917,7209,14126
4479,2020-04-12,3호선,대곡,802,664,1466
4480,2020-04-12,3호선,백석,4387,4241,8628
4481,2020-04-12,3호선,마두,2489,2376,4865
4482,2020-04-12,3호선,정발산,3734,3805,7539
4483,2020-04-12,3호선,주엽,3024,2984,6008
4484,2020-04-12,3호선,대화,4678,4201,8879
4485,2020-04-13,3호선,지축,2973,2953,5926
4486,2020-04-13,3호선,구파발,18186,17051,35237
4487,2020-04-13,3호선,연신내,33951,32093,66044
4488,2020-04-13,3호선,불광,14342,15501,29843
4489,2020-04-13,3호선,녹번,12261,10982,23243
4490,2020-04-13,3호선,홍제,15648,14916,30564
4491,2020-04-13,3호선,무악재,3421,3493,6914
4492,2020-04-13,3호선,독립문,6086,6271,12357
4493,2020-04-13,3호선,경복궁,15123,15076,30199
4494,2020-04-13,3호선,안국,15741,16282,32023
4495,2020-04-13,3호선,종로3가,9070,10459,19529
4496,2020-04-13,3호선,을지로3가,9569,10162,19731
4497,2020-04-13,3호선,동대입구,6128,6677,12805
4498,2020-04-13,3호선,약수,11339,11047,22386
4499,2020-04-13,3호선,금호,7200,6766,13966
4500,2020-04-13,3호선,옥수,7745,8041,15786
4501,2020-04-13,3호선,압구정,26936,28961,55897
4502,2020-04-13,3호선,신사,25521,27240,52761
4503,2020-04-13,3호선,잠원,4909,4734,9643
4504,2020-04-13,3호선,고속터미널,29678,27800,57478
4505,2020-04-13,3호선,교대,12516,8581,21097
4506,2020-04-13,3호선,남부터미널,24815,25449,50264
4507,2020-04-13,3호선,양재,33191,36383,69574
4508,2020-04-13,3호선,매봉,10004,9626,19630
4509,2020-04-13,3호선,도곡,4334,4462,8796
4510,2020-04-13,3호선,대치,8645,8422,17067
4511,2020-04-13,3호선,학여울,1464,1505,2969
4512,2020-04-13,3호선,대청,8156,7424,15580
4513,2020-04-13,3호선,일원,8316,8218,16534
4514,2020-04-13,3호선,수서,13451,13602,27053
4515,2020-04-13,3호선,가락시장,7837,7699,15536
4516,2020-04-13,3호선,경찰병원,6896,6949,13845
4517,2020-04-13,3호선,오금,5810,5002,10812
4518,2020-04-13,3호선,원흥,7818,7437,15255
4519,2020-04-13,3호선,삼송,15449,14642,30091
4520,2020-04-13,3호선,원당,9874,9302,19176
4521,2020-04-13,3호선,화정,14716,15242,29958
4522,2020-04-13,3호선,대곡,1593,1200,2793
4523,2020-04-13,3호선,백석,8799,8719,17518
4524,2020-04-13,3호선,마두,6322,6529,12851
4525,2020-04-13,3호선,정발산,6040,6110,12150
4526,2020-04-13,3호선,주엽,7355,7529,14884
4527,2020-04-13,3호선,대화,11671,8950,20621
4528,2020-04-14,3호선,지축,3044,2902,5946
4529,2020-04-14,3호선,구파발,18820,17236,36056
4530,2020-04-14,3호선,연신내,35369,33453,68822
4531,2020-04-14,3호선,불광,14979,15864,30843
4532,2020-04-14,3호선,녹번,12502,10963,23465
4533,2020-04-14,3호선,홍제,15987,14761,30748
4534,2020-04-14,3호선,무악재,3500,3425,6925
4535,2020-04-14,3호선,독립문,6323,6641,12964
4536,2020-04-14,3호선,경복궁,15886,15714,31600
4537,2020-04-14,3호선,안국,16108,17246,33354
4538,2020-04-14,3호선,종로3가,9375,10151,19526
4539,2020-04-14,3호선,을지로3가,9877,10504,20381
4540,2020-04-14,3호선,동대입구,6399,6773,13172
4541,2020-04-14,3호선,약수,11692,11638,23330
4542,2020-04-14,3호선,금호,7481,6874,14355
4543,2020-04-14,3호선,옥수,8159,8147,16306
4544,2020-04-14,3호선,압구정,27963,30416,58379
4545,2020-04-14,3호선,신사,27121,29664,56785
4546,2020-04-14,3호선,잠원,5077,4828,9905
4547,2020-04-14,3호선,고속터미널,31301,31311,62612
4548,2020-04-14,3호선,교대,13185,8975,22160
4549,2020-04-14,3호선,남부터미널,25540,26084,51624
4550,2020-04-14,3호선,양재,34678,37911,72589
4551,2020-04-14,3호선,매봉,10433,10069,20502
4552,2020-04-14,3호선,도곡,4498,4627,9125
4553,2020-04-14,3호선,대치,8772,8489,17261
4554,2020-04-14,3호선,학여울,1495,1525,3020
4555,2020-04-14,3호선,대청,8415,7607,16022
4556,2020-04-14,3호선,일원,8125,7944,16069
4557,2020-04-14,3호선,수서,14018,13904,27922
4558,2020-04-14,3호선,가락시장,8323,8126,16449
4559,2020-04-14,3호선,경찰병원,7023,7031,14054
4560,2020-04-14,3호선,오금,5779,5097,10876
4561,2020-04-14,3호선,원흥,8219,7535,15754
4562,2020-04-14,3호선,삼송,15914,14921,30835
4563,2020-04-14,3호선,원당,10110,9434,19544
4564,2020-04-14,3호선,화정,15103,15554,30657
4565,2020-04-14,3호선,대곡,1659,1278,2937
4566,2020-04-14,3호선,백석,9101,9089,18190
4567,2020-04-14,3호선,마두,6528,6644,13172
4568,2020-04-14,3호선,정발산,6269,6721,12990
4569,2020-04-14,3호선,주엽,7419,7461,14880
4570,2020-04-14,3호선,대화,11764,9278,21042
4571,2020-04-15,3호선,지축,1684,1568,3252
4572,2020-04-15,3호선,구파발,10180,10145,20325
4573,2020-04-15,3호선,연신내,22285,20653,42938
4574,2020-04-15,3호선,불광,8592,10173,18765
4575,2020-04-15,3호선,녹번,6451,5613,12064
4576,2020-04-15,3호선,홍제,9093,8784,17877
4577,2020-04-15,3호선,무악재,1831,1994,3825
4578,2020-04-15,3호선,독립문,3856,4093,7949
4579,2020-04-15,3호선,경복궁,7854,8636,16490
4580,2020-04-15,3호선,안국,6590,7931,14521
4581,2020-04-15,3호선,종로3가,4903,6364,11267
4582,2020-04-15,3호선,을지로3가,3046,3359,6405
4583,2020-04-15,3호선,동대입구,3703,4254,7957
4584,2020-04-15,3호선,약수,6540,6209,12749
4585,2020-04-15,3호선,금호,4318,3957,8275
4586,2020-04-15,3호선,옥수,5010,5017,10027
4587,2020-04-15,3호선,압구정,13670,14531,28201
4588,2020-04-15,3호선,신사,13339,14035,27374
4589,2020-04-15,3호선,잠원,2634,2534,5168
4590,2020-04-15,3호선,고속터미널,25804,24473,50277
4591,2020-04-15,3호선,교대,3885,2404,6289
4592,2020-04-15,3호선,남부터미널,11120,11455,22575
4593,2020-04-15,3호선,양재,11021,12325,23346
4594,2020-04-15,3호선,매봉,3625,3398,7023
4595,2020-04-15,3호선,도곡,1873,1903,3776
4596,2020-04-15,3호선,대치,4936,4600,9536
4597,2020-04-15,3호선,학여울,781,874,1655
4598,2020-04-15,3호선,대청,3943,3603,7546
4599,2020-04-15,3호선,일원,2637,2693,5330
4600,2020-04-15,3호선,수서,6641,6790,13431
4601,2020-04-15,3호선,가락시장,4073,3960,8033
4602,2020-04-15,3호선,경찰병원,2548,2721,5269
4603,2020-04-15,3호선,오금,2404,2268,4672
4604,2020-04-15,3호선,원흥,4573,4367,8940
4605,2020-04-15,3호선,지축,1,0,1
4606,2020-04-15,3호선,삼송,9176,8974,18150
4607,2020-04-15,3호선,원당,5884,5612,11496
4608,2020-04-15,3호선,화정,8915,9286,18201
4609,2020-04-15,3호선,대곡,974,850,1824
4610,2020-04-15,3호선,백석,5284,5183,10467
4611,2020-04-15,3호선,마두,3237,3216,6453
4612,2020-04-15,3호선,정발산,4435,4622,9057
4613,2020-04-15,3호선,주엽,3938,3965,7903
4614,2020-04-15,3호선,대화,5823,5029,10852
4615,2020-04-16,3호선,지축,2968,2977,5945
4616,2020-04-16,3호선,구파발,18303,17107,35410
4617,2020-04-16,3호선,연신내,34734,32618,67352
4618,2020-04-16,3호선,불광,14644,15710,30354
4619,2020-04-16,3호선,녹번,12255,10832,23087
4620,2020-04-16,3호선,홍제,15854,14902,30756
4621,2020-04-16,3호선,무악재,3467,3500,6967
4622,2020-04-16,3호선,독립문,6158,6459,12617
4623,2020-04-16,3호선,경복궁,15712,15521,31233
4624,2020-04-16,3호선,안국,16308,17096,33404
4625,2020-04-16,3호선,종로3가,9384,10933,20317
4626,2020-04-16,3호선,을지로3가,9487,10212,19699
4627,2020-04-16,3호선,충무로,1,0,1
4628,2020-04-16,3호선,동대입구,6338,6914,13252
4629,2020-04-16,3호선,약수,11511,11238,22749
4630,2020-04-16,3호선,금호,7309,6847,14156
4631,2020-04-16,3호선,옥수,8030,8254,16284
4632,2020-04-16,3호선,압구정,26800,29143,55943
4633,2020-04-16,3호선,신사,26372,28315,54687
4634,2020-04-16,3호선,잠원,4861,4782,9643
4635,2020-04-16,3호선,고속터미널,30195,28881,59076
4636,2020-04-16,3호선,교대,13042,8803,21845
4637,2020-04-16,3호선,남부터미널,25347,25792,51139
4638,2020-04-16,3호선,양재,33886,36700,70586
4639,2020-04-16,3호선,매봉,10170,9832,20002
4640,2020-04-16,3호선,도곡,4430,4567,8997
4641,2020-04-16,3호선,대치,8670,8508,17178
4642,2020-04-16,3호선,학여울,1700,1517,3217
4643,2020-04-16,3호선,대청,8202,7460,15662
4644,2020-04-16,3호선,일원,8155,8044,16199
4645,2020-04-16,3호선,수서,13488,13674,27162
4646,2020-04-16,3호선,가락시장,8053,7911,15964
4647,2020-04-16,3호선,경찰병원,6958,6938,13896
4648,2020-04-16,3호선,오금,5663,5018,10681
4649,2020-04-16,3호선,원흥,8116,7625,15741
4650,2020-04-16,3호선,삼송,15716,15019,30735
4651,2020-04-16,3호선,원당,10003,9458,19461
4652,2020-04-16,3호선,화정,14840,15251,30091
4653,2020-04-16,3호선,대곡,1597,1226,2823
4654,2020-04-16,3호선,백석,8908,8886,17794
4655,2020-04-16,3호선,마두,6467,6675,13142
4656,2020-04-16,3호선,정발산,6352,6478,12830
4657,2020-04-16,3호선,주엽,7318,7391,14709
4658,2020-04-16,3호선,대화,11592,9027,20619
4659,2020-04-17,3호선,지축,2908,2756,5664
4660,2020-04-17,3호선,구파발,18064,16433,34497
4661,2020-04-17,3호선,연신내,33796,32234,66030
4662,2020-04-17,3호선,불광,13918,14838,28756
4663,2020-04-17,3호선,녹번,12145,10532,22677
4664,2020-04-17,3호선,홍제,15402,14423,29825
4665,2020-04-17,3호선,무악재,3341,3239,6580
4666,2020-04-17,3호선,독립문,5677,5941,11618
4667,2020-04-17,3호선,경복궁,15138,15051,30189
4668,2020-04-17,3호선,안국,15660,16324,31984
4669,2020-04-17,3호선,종로3가,8709,10402,19111
4670,2020-04-17,3호선,을지로3가,9619,10478,20097
4671,2020-04-17,3호선,충무로,1,0,1
4672,2020-04-17,3호선,동대입구,6111,6437,12548
4673,2020-04-17,3호선,약수,11507,11243,22750
4674,2020-04-17,3호선,금호,7214,6532,13746
4675,2020-04-17,3호선,옥수,7936,8055,15991
4676,2020-04-17,3호선,압구정,27546,30035,57581
4677,2020-04-17,3호선,신사,26519,29139,55658
4678,2020-04-17,3호선,잠원,4992,4812,9804
4679,2020-04-17,3호선,고속터미널,34187,36347,70534
4680,2020-04-17,3호선,교대,12786,8683,21469
4681,2020-04-17,3호선,남부터미널,26641,26988,53629
4682,2020-04-17,3호선,양재,35593,37069,72662
4683,2020-04-17,3호선,매봉,10075,9632,19707
4684,2020-04-17,3호선,도곡,4481,4506,8987
4685,2020-04-17,3호선,대치,9085,8798,17883
4686,2020-04-17,3호선,학여울,1490,1462,2952
4687,2020-04-17,3호선,대청,8442,7498,15940
4688,2020-04-17,3호선,일원,8073,7850,15923
4689,2020-04-17,3호선,수서,14677,14657,29334
4690,2020-04-17,3호선,가락시장,8184,7896,16080
4691,2020-04-17,3호선,경찰병원,6900,6910,13810
4692,2020-04-17,3호선,오금,5700,4968,10668
4693,2020-04-17,3호선,원흥,7638,6992,14630
4694,2020-04-17,3호선,삼송,15045,14102,29147
4695,2020-04-17,3호선,원당,9514,8871,18385
4696,2020-04-17,3호선,화정,14219,14884,29103
4697,2020-04-17,3호선,대곡,1455,1127,2582
4698,2020-04-17,3호선,백석,8480,8564,17044
4699,2020-04-17,3호선,마두,6117,6433,12550
4700,2020-04-17,3호선,정발산,5846,6319,12165
4701,2020-04-17,3호선,주엽,7042,7172,14214
4702,2020-04-17,3호선,대화,11402,8697,20099
4703,2020-04-18,3호선,지축,1995,1889,3884
4704,2020-04-18,3호선,구파발,12933,13223,26156
4705,2020-04-18,3호선,연신내,26992,25193,52185
4706,2020-04-18,3호선,불광,11169,12957,24126
4707,2020-04-18,3호선,녹번,7877,6759,14636
4708,2020-04-18,3호선,홍제,11110,10381,21491
4709,2020-04-18,3호선,무악재,2196,2225,4421
4710,2020-04-18,3호선,독립문,4814,5145,9959
4711,2020-04-18,3호선,경복궁,10467,11240,21707
4712,2020-04-18,3호선,안국,8514,10277,18791
4713,2020-04-18,3호선,종로3가,4410,6291,10701
4714,2020-04-18,3호선,을지로3가,3763,4435,8198
4715,2020-04-18,3호선,동대입구,4608,5540,10148
4716,2020-04-18,3호선,약수,7702,7275,14977
4717,2020-04-18,3호선,금호,5094,4640,9734
4718,2020-04-18,3호선,옥수,6040,6008,12048
4719,2020-04-18,3호선,압구정,19068,19945,39013
4720,2020-04-18,3호선,신사,19594,21098,40692
4721,2020-04-18,3호선,잠원,3257,3085,6342
4722,2020-04-18,3호선,고속터미널,36187,36178,72365
4723,2020-04-18,3호선,교대,5035,3153,8188
4724,2020-04-18,3호선,남부터미널,15904,16165,32069
4725,2020-04-18,3호선,양재,15016,16154,31170
4726,2020-04-18,3호선,매봉,4405,4113,8518
4727,2020-04-18,3호선,도곡,2404,2381,4785
4728,2020-04-18,3호선,대치,6997,6355,13352
4729,2020-04-18,3호선,학여울,863,859,1722
4730,2020-04-18,3호선,대청,4689,4343,9032
4731,2020-04-18,3호선,일원,3547,3406,6953
4732,2020-04-18,3호선,수서,8907,8946,17853
4733,2020-04-18,3호선,가락시장,5217,4908,10125
4734,2020-04-18,3호선,경찰병원,3190,3030,6220
4735,2020-04-18,3호선,오금,2986,2776,5762
4736,2020-04-18,3호선,원흥,5559,5143,10702
4737,2020-04-18,3호선,삼송,10764,10243,21007
4738,2020-04-18,3호선,원당,7051,6651,13702
4739,2020-04-18,3호선,화정,10837,11272,22109
4740,2020-04-18,3호선,대곡,1123,978,2101
4741,2020-04-18,3호선,백석,6371,6538,12909
4742,2020-04-18,3호선,마두,3953,4019,7972
4743,2020-04-18,3호선,정발산,5561,5526,11087
4744,2020-04-18,3호선,주엽,5163,5228,10391
4745,2020-04-18,3호선,대화,7224,6192,13416
4746,2020-04-19,3호선,지축,1289,1176,2465
4747,2020-04-19,3호선,구파발,8607,8785,17392
4748,2020-04-19,3호선,연신내,17510,16306,33816
4749,2020-04-19,3호선,불광,7448,8762,16210
4750,2020-04-19,3호선,녹번,4910,4513,9423
4751,2020-04-19,3호선,홍제,6693,6572,13265
4752,2020-04-19,3호선,무악재,1355,1560,2915
4753,2020-04-19,3호선,독립문,3048,3258,6306
4754,2020-04-19,3호선,경복궁,6206,6422,12628
4755,2020-04-19,3호선,안국,5200,5499,10699
4756,2020-04-19,3호선,종로3가,2586,3130,5716
4757,2020-04-19,3호선,을지로3가,1681,1774,3455
4758,2020-04-19,3호선,동대입구,3183,3524,6707
4759,2020-04-19,3호선,약수,4640,4553,9193
4760,2020-04-19,3호선,금호,3180,3146,6326
4761,2020-04-19,3호선,옥수,3496,3816,7312
4762,2020-04-19,3호선,압구정,8485,9057,17542
4763,2020-04-19,3호선,신사,8989,9437,18426
4764,2020-04-19,3호선,잠원,1908,1900,3808
4765,2020-04-19,3호선,고속터미널,28269,26288,54557
4766,2020-04-19,3호선,교대,2858,1894,4752
4767,2020-04-19,3호선,남부터미널,10207,10651,20858
4768,2020-04-19,3호선,양재,8893,10472,19365
4769,2020-04-19,3호선,매봉,2646,2669,5315
4770,2020-04-19,3호선,도곡,1256,1327,2583
4771,2020-04-19,3호선,대치,4247,3794,8041
4772,2020-04-19,3호선,학여울,521,555,1076
4773,2020-04-19,3호선,대청,2929,2750,5679
4774,2020-04-19,3호선,일원,2154,2290,4444
4775,2020-04-19,3호선,수서,6797,6863,13660
4776,2020-04-19,3호선,가락시장,2825,3077,5902
4777,2020-04-19,3호선,경찰병원,2067,2199,4266
4778,2020-04-19,3호선,오금,2008,1912,3920
4779,2020-04-19,3호선,원흥,3345,3179,6524
4780,2020-04-19,3호선,삼송,7013,6740,13753
4781,2020-04-19,3호선,원당,4585,4428,9013
4782,2020-04-19,3호선,화정,6912,7175,14087
4783,2020-04-19,3호선,대곡,741,609,1350
4784,2020-04-19,3호선,백석,4316,4218,8534
4785,2020-04-19,3호선,마두,2469,2419,4888
4786,2020-04-19,3호선,정발산,3525,2889,6414
4787,2020-04-19,3호선,주엽,3125,3016,6141
4788,2020-04-19,3호선,대화,4700,4324,9024
4789,2020-04-20,3호선,지축,3045,2961,6006
4790,2020-04-20,3호선,구파발,18714,17329,36043
4791,2020-04-20,3호선,연신내,34700,32878,67578
4792,2020-04-20,3호선,불광,14837,15925,30762
4793,2020-04-20,3호선,녹번,12541,11340,23881
4794,2020-04-20,3호선,홍제,15828,15137,30965
4795,2020-04-20,3호선,무악재,3507,3490,6997
4796,2020-04-20,3호선,독립문,5941,6279,12220
4797,2020-04-20,3호선,경복궁,15075,14951,30026
4798,2020-04-20,3호선,안국,16388,16728,33116
4799,2020-04-20,3호선,종로3가,9339,10601,19940
4800,2020-04-20,3호선,을지로3가,9970,10373,20343
4801,2020-04-20,3호선,충무로,1,0,1
4802,2020-04-20,3호선,동대입구,6175,6528,12703
4803,2020-04-20,3호선,약수,11658,11482,23140
4804,2020-04-20,3호선,금호,7226,6773,13999
4805,2020-04-20,3호선,옥수,7900,8225,16125
4806,2020-04-20,3호선,압구정,26796,28897,55693
4807,2020-04-20,3호선,신사,26150,27883,54033
4808,2020-04-20,3호선,잠원,5112,5014,10126
4809,2020-04-20,3호선,고속터미널,30671,28461,59132
4810,2020-04-20,3호선,교대,12878,8919,21797
4811,2020-04-20,3호선,남부터미널,25825,26431,52256
4812,2020-04-20,3호선,양재,34901,37857,72758
4813,2020-04-20,3호선,매봉,10489,10113,20602
4814,2020-04-20,3호선,도곡,4544,4595,9139
4815,2020-04-20,3호선,대치,8910,8698,17608
4816,2020-04-20,3호선,학여울,1519,1601,3120
4817,2020-04-20,3호선,대청,8558,7826,16384
4818,2020-04-20,3호선,일원,8352,8241,16593
4819,2020-04-20,3호선,수서,14109,14260,28369
4820,2020-04-20,3호선,가락시장,8165,7973,16138
4821,2020-04-20,3호선,경찰병원,7168,7271,14439
4822,2020-04-20,3호선,오금,5851,5180,11031
4823,2020-04-20,3호선,원흥,7963,7499,15462
4824,2020-04-20,3호선,삼송,15543,14946,30489
4825,2020-04-20,3호선,원당,9922,9518,19440
4826,2020-04-20,3호선,화정,14732,15350,30082
4827,2020-04-20,3호선,대곡,1622,1212,2834
4828,2020-04-20,3호선,백석,8960,8904,17864
4829,2020-04-20,3호선,마두,6486,6692,13178
4830,2020-04-20,3호선,정발산,5875,4949,10824
4831,2020-04-20,3호선,주엽,7551,7655,15206
4832,2020-04-20,3호선,대화,11833,9085,20918
4833,2020-04-21,3호선,지축,3076,3036,6112
4834,2020-04-21,3호선,구파발,19208,17969,37177
4835,2020-04-21,3호선,연신내,35573,33870,69443
4836,2020-04-21,3호선,불광,15239,16179,31418
4837,2020-04-21,3호선,녹번,12752,11542,24294
4838,2020-04-21,3호선,홍제,16201,15476,31677
4839,2020-04-21,3호선,무악재,3618,3634,7252
4840,2020-04-21,3호선,독립문,6309,6527,12836
4841,2020-04-21,3호선,경복궁,15929,15685,31614
4842,2020-04-21,3호선,안국,17135,17497,34632
4843,2020-04-21,3호선,종로3가,9857,11112,20969
4844,2020-04-21,3호선,을지로3가,10041,10573,20614
4845,2020-04-21,3호선,충무로,1,0,1
4846,2020-04-21,3호선,동대입구,6327,6801,13128
4847,2020-04-21,3호선,약수,11978,11760,23738
4848,2020-04-21,3호선,금호,7429,7007,14436
4849,2020-04-21,3호선,옥수,8115,8371,16486
4850,2020-04-21,3호선,압구정,27543,29622,57165
4851,2020-04-21,3호선,신사,27575,29221,56796
4852,2020-04-21,3호선,잠원,5255,5154,10409
4853,2020-04-21,3호선,고속터미널,31214,29801,61015
4854,2020-04-21,3호선,교대,13319,8894,22213
4855,2020-04-21,3호선,남부터미널,26073,26640,52713
4856,2020-04-21,3호선,양재,35877,38528,74405
4857,2020-04-21,3호선,매봉,10735,10325,21060
4858,2020-04-21,3호선,도곡,4640,4682,9322
4859,2020-04-21,3호선,대치,9083,9054,18137
4860,2020-04-21,3호선,학여울,1539,1588,3127
4861,2020-04-21,3호선,대청,8656,7989,16645
4862,2020-04-21,3호선,일원,8422,8270,16692
4863,2020-04-21,3호선,수서,14090,14206,28296
4864,2020-04-21,3호선,가락시장,8395,8089,16484
4865,2020-04-21,3호선,경찰병원,7158,7094,14252
4866,2020-04-21,3호선,오금,5852,5236,11088
4867,2020-04-21,3호선,원흥,8259,7802,16061
4868,2020-04-21,3호선,지축,1,0,1
4869,2020-04-21,3호선,삼송,15965,15408,31373
4870,2020-04-21,3호선,원당,10134,9587,19721
4871,2020-04-21,3호선,화정,15208,15661,30869
4872,2020-04-21,3호선,대곡,1603,1235,2838
4873,2020-04-21,3호선,백석,9105,9171,18276
4874,2020-04-21,3호선,마두,6631,6874,13505
4875,2020-04-21,3호선,정발산,6179,6235,12414
4876,2020-04-21,3호선,주엽,7546,7753,15299
4877,2020-04-21,3호선,대화,11920,9398,21318
4878,2020-04-22,3호선,지축,2967,2891,5858
4879,2020-04-22,3호선,구파발,18776,17529,36305
4880,2020-04-22,3호선,연신내,35018,33114,68132
4881,2020-04-22,3호선,불광,15158,16381,31539
4882,2020-04-22,3호선,녹번,12409,11067,23476
4883,2020-04-22,3호선,홍제,16011,15203,31214
4884,2020-04-22,3호선,무악재,3467,3491,6958
4885,2020-04-22,3호선,독립문,6178,6452,12630
4886,2020-04-22,3호선,경복궁,16105,15705,31810
4887,2020-04-22,3호선,안국,16819,17226,34045
4888,2020-04-22,3호선,종로3가,9522,11000,20522
4889,2020-04-22,3호선,을지로3가,10089,10785,20874
4890,2020-04-22,3호선,동대입구,6141,6679,12820
4891,2020-04-22,3호선,약수,11606,11509,23115
4892,2020-04-22,3호선,금호,7408,6983,14391
4893,2020-04-22,3호선,옥수,8125,8325,16450
4894,2020-04-22,3호선,압구정,27003,29195,56198
4895,2020-04-22,3호선,신사,27213,28726,55939
4896,2020-04-22,3호선,잠원,5190,5190,10380
4897,2020-04-22,3호선,고속터미널,31581,30396,61977
4898,2020-04-22,3호선,교대,13405,9044,22449
4899,2020-04-22,3호선,남부터미널,26723,27408,54131
4900,2020-04-22,3호선,양재,35834,38571,74405
4901,2020-04-22,3호선,매봉,10682,10283,20965
4902,2020-04-22,3호선,도곡,4544,4581,9125
4903,2020-04-22,3호선,대치,8938,8853,17791
4904,2020-04-22,3호선,학여울,1497,1529,3026
4905,2020-04-22,3호선,대청,8528,7757,16285
4906,2020-04-22,3호선,일원,8301,8211,16512
4907,2020-04-22,3호선,수서,14041,13960,28001
4908,2020-04-22,3호선,가락시장,8291,8149,16440
4909,2020-04-22,3호선,경찰병원,7181,7234,14415
4910,2020-04-22,3호선,오금,5816,5218,11034
4911,2020-04-22,3호선,원흥,8132,7656,15788
4912,2020-04-22,3호선,삼송,15767,15105,30872
4913,2020-04-22,3호선,원당,10076,9666,19742
4914,2020-04-22,3호선,화정,14936,15318,30254
4915,2020-04-22,3호선,대곡,1604,1191,2795
4916,2020-04-22,3호선,백석,8789,8847,17636
4917,2020-04-22,3호선,마두,6548,6830,13378
4918,2020-04-22,3호선,정발산,6191,6320,12511
4919,2020-04-22,3호선,주엽,7298,7528,14826
4920,2020-04-22,3호선,대화,11554,8974,20528
4921,2020-04-23,3호선,지축,3037,2948,5985
4922,2020-04-23,3호선,구파발,19503,18265,37768
4923,2020-04-23,3호선,연신내,36191,34117,70308
4924,2020-04-23,3호선,불광,15683,16706,32389
4925,2020-04-23,3호선,녹번,12524,11157,23681
4926,2020-04-23,3호선,홍제,16385,15543,31928
4927,2020-04-23,3호선,무악재,3616,3640,7256
4928,2020-04-23,3호선,독립문,6422,6680,13102
4929,2020-04-23,3호선,경복궁,16378,16263,32641
4930,2020-04-23,3호선,안국,17190,18077,35267
4931,2020-04-23,3호선,종로3가,9792,11257,21049
4932,2020-04-23,3호선,을지로3가,10372,10927,21299
4933,2020-04-23,3호선,동대입구,6295,6977,13272
4934,2020-04-23,3호선,약수,12079,11704,23783
4935,2020-04-23,3호선,금호,7526,7076,14602
4936,2020-04-23,3호선,옥수,8441,8521,16962
4937,2020-04-23,3호선,압구정,27224,29632,56856
4938,2020-04-23,3호선,신사,27687,29369,57056
4939,2020-04-23,3호선,잠원,5186,5078,10264
4940,2020-04-23,3호선,고속터미널,32060,31297,63357
4941,2020-04-23,3호선,교대,13699,9253,22952
4942,2020-04-23,3호선,남부터미널,26447,26940,53387
4943,2020-04-23,3호선,양재,36135,39213,75348
4944,2020-04-23,3호선,매봉,10833,10409,21242
4945,2020-04-23,3호선,도곡,4616,4679,9295
4946,2020-04-23,3호선,대치,9108,9015,18123
4947,2020-04-23,3호선,학여울,1523,1534,3057
4948,2020-04-23,3호선,대청,8682,7905,16587
4949,2020-04-23,3호선,일원,8552,8382,16934
4950,2020-04-23,3호선,수서,14687,14661,29348
4951,2020-04-23,3호선,가락시장,8506,8478,16984
4952,2020-04-23,3호선,경찰병원,7081,6941,14022
4953,2020-04-23,3호선,오금,6006,5278,11284
4954,2020-04-23,3호선,원흥,8406,7758,16164
4955,2020-04-23,3호선,삼송,16261,15659,31920
4956,2020-04-23,3호선,원당,10239,9820,20059
4957,2020-04-23,3호선,화정,15251,15674,30925
4958,2020-04-23,3호선,대곡,1707,1243,2950
4959,2020-04-23,3호선,백석,9320,9329,18649
4960,2020-04-23,3호선,마두,6568,6874,13442
4961,2020-04-23,3호선,정발산,6270,6398,12668
4962,2020-04-23,3호선,주엽,7692,7754,15446
4963,2020-04-23,3호선,대화,11863,9318,21181
4964,2020-04-24,3호선,지축,3201,3050,6251
4965,2020-04-24,3호선,구파발,19861,18121,37982
4966,2020-04-24,3호선,연신내,37489,35537,73026
4967,2020-04-24,3호선,불광,15953,17074,33027
4968,2020-04-24,3호선,녹번,12953,11129,24082
4969,2020-04-24,3호선,홍제,17068,15666,32734
4970,2020-04-24,3호선,무악재,3648,3598,7246
4971,2020-04-24,3호선,독립문,6788,7048,13836
4972,2020-04-24,3호선,경복궁,17294,16974,34268
4973,2020-04-24,3호선,안국,17655,18524,36179
4974,2020-04-24,3호선,종로3가,9301,11366,20667
4975,2020-04-24,3호선,을지로3가,10383,11397,21780
4976,2020-04-24,3호선,충무로,1,0,1
4977,2020-04-24,3호선,동대입구,6700,7188,13888
4978,2020-04-24,3호선,약수,12332,12080,24412
4979,2020-04-24,3호선,금호,7942,7210,15152
4980,2020-04-24,3호선,옥수,8682,8713,17395
4981,2020-04-24,3호선,압구정,29800,32588,62388
4982,2020-04-24,3호선,신사,30091,33360,63451
4983,2020-04-24,3호선,잠원,5519,5342,10861
4984,2020-04-24,3호선,고속터미널,38569,40703,79272
4985,2020-04-24,3호선,교대,14197,9543,23740
4986,2020-04-24,3호선,남부터미널,29221,29517,58738
4987,2020-04-24,3호선,양재,38648,40371,79019
4988,2020-04-24,3호선,매봉,11028,10623,21651
4989,2020-04-24,3호선,도곡,5018,5080,10098
4990,2020-04-24,3호선,대치,9675,9608,19283
4991,2020-04-24,3호선,학여울,1579,1681,3260
4992,2020-04-24,3호선,대청,9284,8339,17623
4993,2020-04-24,3호선,일원,8831,8464,17295
4994,2020-04-24,3호선,수서,16317,16024,32341
4995,2020-04-24,3호선,가락시장,9048,8945,17993
4996,2020-04-24,3호선,경찰병원,7434,7263,14697
4997,2020-04-24,3호선,오금,6132,5361,11493
4998,2020-04-24,3호선,원흥,8578,7676,16254
4999,2020-04-24,3호선,지축,1,0,1
5000,2020-04-24,3호선,삼송,16705,15749,32454
5001,2020-04-24,3호선,원당,10487,9804,20291
5002,2020-04-24,3호선,화정,15861,16486,32347
5003,2020-04-24,3호선,대곡,1759,1370,3129
5004,2020-04-24,3호선,백석,9633,9862,19495
5005,2020-04-24,3호선,마두,6930,7194,14124
5006,2020-04-24,3호선,정발산,6537,7238,13775
5007,2020-04-24,3호선,주엽,7955,8043,15998
5008,2020-04-24,3호선,대화,12327,9416,21743
5009,2020-04-25,3호선,지축,2101,2046,4147
5010,2020-04-25,3호선,구파발,13320,13311,26631
5011,2020-04-25,3호선,연신내,28178,26517,54695
5012,2020-04-25,3호선,불광,11501,13276,24777
5013,2020-04-25,3호선,녹번,7908,6480,14388
5014,2020-04-25,3호선,홍제,11685,10680,22365
5015,2020-04-25,3호선,무악재,2355,2351,4706
5016,2020-04-25,3호선,독립문,4902,5270,10172
5017,2020-04-25,3호선,경복궁,11097,12244,23341
5018,2020-04-25,3호선,안국,9564,11520,21084
5019,2020-04-25,3호선,종로3가,4688,6875,11563
5020,2020-04-25,3호선,을지로3가,3970,4673,8643
5021,2020-04-25,3호선,동대입구,4696,5593,10289
5022,2020-04-25,3호선,약수,7917,7540,15457
5023,2020-04-25,3호선,금호,5354,4918,10272
5024,2020-04-25,3호선,옥수,6300,6240,12540
5025,2020-04-25,3호선,압구정,19919,21207,41126
5026,2020-04-25,3호선,신사,21417,22742,44159
5027,2020-04-25,3호선,잠원,3540,3328,6868
5028,2020-04-25,3호선,고속터미널,39321,39355,78676
5029,2020-04-25,3호선,교대,5528,3530,9058
5030,2020-04-25,3호선,남부터미널,17496,17705,35201
5031,2020-04-25,3호선,양재,17319,18511,35830
5032,2020-04-25,3호선,매봉,4406,4275,8681
5033,2020-04-25,3호선,도곡,2690,2634,5324
5034,2020-04-25,3호선,대치,7152,6519,13671
5035,2020-04-25,3호선,학여울,924,937,1861
5036,2020-04-25,3호선,대청,4920,4434,9354
5037,2020-04-25,3호선,일원,3807,3708,7515
5038,2020-04-25,3호선,수서,9763,9917,19680
5039,2020-04-25,3호선,가락시장,5582,5296,10878
5040,2020-04-25,3호선,경찰병원,3425,3329,6754
5041,2020-04-25,3호선,오금,3199,2926,6125
5042,2020-04-25,3호선,원흥,5563,5133,10696
5043,2020-04-25,3호선,삼송,11621,10999,22620
5044,2020-04-25,3호선,원당,7502,7019,14521
5045,2020-04-25,3호선,화정,11408,11762,23170
5046,2020-04-25,3호선,대곡,1070,967,2037
5047,2020-04-25,3호선,백석,6792,6842,13634
5048,2020-04-25,3호선,마두,4203,4320,8523
5049,2020-04-25,3호선,정발산,5423,5817,11240
5050,2020-04-25,3호선,주엽,5176,5203,10379
5051,2020-04-25,3호선,대화,7632,6458,14090
5052,2020-04-26,3호선,지축,1422,1371,2793
5053,2020-04-26,3호선,구파발,10117,10183,20300
5054,2020-04-26,3호선,연신내,20085,18709,38794
5055,2020-04-26,3호선,불광,8823,10644,19467
5056,2020-04-26,3호선,녹번,5067,4672,9739
5057,2020-04-26,3호선,홍제,7856,7676,15532
5058,2020-04-26,3호선,무악재,1572,1684,3256
5059,2020-04-26,3호선,독립문,3621,4190,7811
5060,2020-04-26,3호선,경복궁,8194,8792,16986
5061,2020-04-26,3호선,안국,6714,7657,14371
5062,2020-04-26,3호선,종로3가,2927,4071,6998
5063,2020-04-26,3호선,을지로3가,2177,2317,4494
5064,2020-04-26,3호선,충무로,1,0,1
5065,2020-04-26,3호선,동대입구,3778,4597,8375
5066,2020-04-26,3호선,약수,5343,5190,10533
5067,2020-04-26,3호선,금호,3746,3562,7308
5068,2020-04-26,3호선,옥수,4373,4668,9041
5069,2020-04-26,3호선,압구정,9969,10431,20400
5070,2020-04-26,3호선,신사,11520,11430,22950
5071,2020-04-26,3호선,잠원,2425,2404,4829
5072,2020-04-26,3호선,고속터미널,31898,30292,62190
5073,2020-04-26,3호선,교대,3260,2044,5304
5074,2020-04-26,3호선,남부터미널,11758,12366,24124
5075,2020-04-26,3호선,양재,10416,12012,22428
5076,2020-04-26,3호선,매봉,2995,2916,5911
5077,2020-04-26,3호선,도곡,1367,1453,2820
5078,2020-04-26,3호선,대치,4672,4167,8839
5079,2020-04-26,3호선,학여울,562,558,1120
5080,2020-04-26,3호선,대청,3249,3118,6367
5081,2020-04-26,3호선,일원,2468,2528,4996
5082,2020-04-26,3호선,수서,7724,7760,15484
5083,2020-04-26,3호선,가락시장,3302,3422,6724
5084,2020-04-26,3호선,경찰병원,2237,2272,4509
5085,2020-04-26,3호선,오금,2296,2201,4497
5086,2020-04-26,3호선,원흥,3945,3792,7737
5087,2020-04-26,3호선,삼송,8485,8315,16800
5088,2020-04-26,3호선,원당,5526,5265,10791
5089,2020-04-26,3호선,화정,8145,8534,16679
5090,2020-04-26,3호선,대곡,938,792,1730
5091,2020-04-26,3호선,백석,5053,5040,10093
5092,2020-04-26,3호선,마두,2819,2798,5617
5093,2020-04-26,3호선,정발산,4482,4547,9029
5094,2020-04-26,3호선,주엽,3606,3536,7142
5095,2020-04-26,3호선,대화,5456,4928,10384
5096,2020-04-27,3호선,지축,3199,3165,6364
5097,2020-04-27,3호선,구파발,20019,18416,38435
5098,2020-04-27,3호선,연신내,36444,34616,71060
5099,2020-04-27,3호선,불광,15605,16751,32356
5100,2020-04-27,3호선,녹번,12882,11498,24380
5101,2020-04-27,3호선,홍제,17068,16016,33084
5102,2020-04-27,3호선,무악재,3672,3747,7419
5103,2020-04-27,3호선,독립문,6643,6796,13439
5104,2020-04-27,3호선,경복궁,16030,16147,32177
5105,2020-04-27,3호선,안국,17341,18101,35442
5106,2020-04-27,3호선,종로3가,9768,11293,21061
5107,2020-04-27,3호선,을지로3가,10223,10810,21033
5108,2020-04-27,3호선,동대입구,6405,6867,13272
5109,2020-04-27,3호선,약수,12328,12023,24351
5110,2020-04-27,3호선,금호,7886,7300,15186
5111,2020-04-27,3호선,옥수,8393,8804,17197
5112,2020-04-27,3호선,압구정,28290,30567,58857
5113,2020-04-27,3호선,신사,27991,29801,57792
5114,2020-04-27,3호선,잠원,5478,5311,10789
5115,2020-04-27,3호선,고속터미널,34336,32434,66770
5116,2020-04-27,3호선,교대,13577,9140,22717
5117,2020-04-27,3호선,남부터미널,26903,27854,54757
5118,2020-04-27,3호선,양재,36382,39511,75893
5119,2020-04-27,3호선,매봉,11012,10479,21491
5120,2020-04-27,3호선,도곡,4874,5005,9879
5121,2020-04-27,3호선,대치,9585,9404,18989
5122,2020-04-27,3호선,학여울,1572,1608,3180
5123,2020-04-27,3호선,대청,8911,8189,17100
5124,2020-04-27,3호선,일원,8866,8767,17633
5125,2020-04-27,3호선,수서,14865,15101,29966
5126,2020-04-27,3호선,가락시장,8662,8508,17170
5127,2020-04-27,3호선,경찰병원,7305,7391,14696
5128,2020-04-27,3호선,오금,6167,5405,11572
5129,2020-04-27,3호선,원흥,8479,7910,16389
5130,2020-04-27,3호선,삼송,16495,15884,32379
5131,2020-04-27,3호선,원당,10616,10120,20736
5132,2020-04-27,3호선,화정,15663,16097,31760
5133,2020-04-27,3호선,대곡,1733,1326,3059
5134,2020-04-27,3호선,백석,9453,9439,18892
5135,2020-04-27,3호선,마두,6957,7207,14164
5136,2020-04-27,3호선,정발산,6381,6530,12911
5137,2020-04-27,3호선,주엽,8093,8140,16233
5138,2020-04-27,3호선,대화,12408,9464,21872
5139,2020-04-28,3호선,지축,3205,3167,6372
5140,2020-04-28,3호선,구파발,19945,18505,38450
5141,2020-04-28,3호선,연신내,37285,35060,72345
5142,2020-04-28,3호선,불광,15951,16991,32942
5143,2020-04-28,3호선,녹번,13071,11681,24752
5144,2020-04-28,3호선,홍제,17179,16015,33194
5145,2020-04-28,3호선,무악재,3698,3758,7456
5146,2020-04-28,3호선,독립문,6763,7070,13833
5147,2020-04-28,3호선,경복궁,16939,16799,33738
5148,2020-04-28,3호선,안국,17711,18802,36513
5149,2020-04-28,3호선,종로3가,10063,11719,21782
5150,2020-04-28,3호선,을지로3가,10617,11122,21739
5151,2020-04-28,3호선,충무로,1,0,1
5152,2020-04-28,3호선,동대입구,6488,7131,13619
5153,2020-04-28,3호선,약수,12516,12178,24694
5154,2020-04-28,3호선,금호,7836,7321,15157
5155,2020-04-28,3호선,옥수,8772,8909,17681
5156,2020-04-28,3호선,압구정,29196,31875,61071
5157,2020-04-28,3호선,신사,29572,31350,60922
5158,2020-04-28,3호선,잠원,5624,5381,11005
5159,2020-04-28,3호선,고속터미널,34707,34227,68934
5160,2020-04-28,3호선,교대,14275,9529,23804
5161,2020-04-28,3호선,남부터미널,27314,28157,55471
5162,2020-04-28,3호선,양재,37343,40639,77982
5163,2020-04-28,3호선,매봉,11189,10922,22111
5164,2020-04-28,3호선,도곡,5034,5163,10197
5165,2020-04-28,3호선,대치,9667,9440,19107
5166,2020-04-28,3호선,학여울,1591,1633,3224
5167,2020-04-28,3호선,대청,9023,8267,17290
5168,2020-04-28,3호선,일원,9189,8976,18165
5169,2020-04-28,3호선,수서,15162,15335,30497
5170,2020-04-28,3호선,가락시장,8859,8706,17565
5171,2020-04-28,3호선,경찰병원,7468,7490,14958
5172,2020-04-28,3호선,오금,6246,5498,11744
5173,2020-04-28,3호선,원흥,8688,8024,16712
5174,2020-04-28,3호선,삼송,16741,16092,32833
5175,2020-04-28,3호선,원당,10833,10264,21097
5176,2020-04-28,3호선,화정,16016,16605,32621
5177,2020-04-28,3호선,대곡,1792,1362,3154
5178,2020-04-28,3호선,백석,9763,9781,19544
5179,2020-04-28,3호선,마두,7156,7330,14486
5180,2020-04-28,3호선,정발산,6699,6812,13511
5181,2020-04-28,3호선,주엽,8041,8108,16149
5182,2020-04-28,3호선,대화,12558,9793,22351
5183,2020-04-29,3호선,지축,3270,3080,6350
5184,2020-04-29,3호선,구파발,20447,18670,39117
5185,2020-04-29,3호선,연신내,38352,36209,74561
5186,2020-04-29,3호선,불광,16328,17307,33635
5187,2020-04-29,3호선,녹번,13714,11627,25341
5188,2020-04-29,3호선,홍제,17665,16459,34124
5189,2020-04-29,3호선,무악재,3835,3837,7672
5190,2020-04-29,3호선,독립문,6912,7128,14040
5191,2020-04-29,3호선,경복궁,17863,18021,35884
5192,2020-04-29,3호선,안국,18356,19357,37713
5193,2020-04-29,3호선,종로3가,10366,12752,23118
5194,2020-04-29,3호선,을지로3가,10828,11785,22613
5195,2020-04-29,3호선,동대입구,6859,7363,14222
5196,2020-04-29,3호선,약수,12916,12554,25470
5197,2020-04-29,3호선,금호,8326,7520,15846
5198,2020-04-29,3호선,옥수,9158,9202,18360
5199,2020-04-29,3호선,압구정,30282,33232,63514
5200,2020-04-29,3호선,신사,30330,33610,63940
5201,2020-04-29,3호선,잠원,5772,5482,11254
5202,2020-04-29,3호선,고속터미널,39340,47621,86961
5203,2020-04-29,3호선,교대,14681,9720,24401
5204,2020-04-29,3호선,남부터미널,29544,31736,61280
5205,2020-04-29,3호선,양재,39432,41206,80638
5206,2020-04-29,3호선,매봉,11529,10967,22496
5207,2020-04-29,3호선,도곡,5160,5266,10426
5208,2020-04-29,3호선,대치,9948,9513,19461
5209,2020-04-29,3호선,학여울,1670,1621,3291
5210,2020-04-29,3호선,대청,9354,8363,17717
5211,2020-04-29,3호선,일원,9173,8856,18029
5212,2020-04-29,3호선,수서,16511,17411,33922
5213,2020-04-29,3호선,가락시장,9335,9074,18409
5214,2020-04-29,3호선,경찰병원,7628,7539,15167
5215,2020-04-29,3호선,오금,6435,5493,11928
5216,2020-04-29,3호선,원흥,8864,8122,16986
5217,2020-04-29,3호선,삼송,17288,16190,33478
5218,2020-04-29,3호선,원당,11051,10250,21301
5219,2020-04-29,3호선,화정,16675,16990,33665
5220,2020-04-29,3호선,대곡,1768,1340,3108
5221,2020-04-29,3호선,백석,9964,10030,19994
5222,2020-04-29,3호선,마두,7542,7812,15354
5223,2020-04-29,3호선,정발산,7060,7653,14713
5224,2020-04-29,3호선,주엽,8127,8108,16235
5225,2020-04-29,3호선,대화,12845,9943,22788
5226,2020-04-30,3호선,지축,1891,1763,3654
5227,2020-04-30,3호선,구파발,13022,12836,25858
5228,2020-04-30,3호선,연신내,25693,23439,49132
5229,2020-04-30,3호선,불광,10435,11676,22111
5230,2020-04-30,3호선,녹번,7105,5879,12984
5231,2020-04-30,3호선,홍제,10529,9569,20098
5232,2020-04-30,3호선,무악재,2233,2294,4527
5233,2020-04-30,3호선,독립문,4588,5267,9855
5234,2020-04-30,3호선,경복궁,10896,11960,22856
5235,2020-04-30,3호선,안국,11059,13908,24967
5236,2020-04-30,3호선,종로3가,3994,6189,10183
5237,2020-04-30,3호선,을지로3가,3560,3947,7507
5238,2020-04-30,3호선,동대입구,4687,5728,10415
5239,2020-04-30,3호선,약수,7208,6626,13834
5240,2020-04-30,3호선,금호,4876,4316,9192
5241,2020-04-30,3호선,옥수,5881,5711,11592
5242,2020-04-30,3호선,압구정,13749,15016,28765
5243,2020-04-30,3호선,신사,15204,16421,31625
5244,2020-04-30,3호선,잠원,3007,2824,5831
5245,2020-04-30,3호선,고속터미널,36539,43899,80438
5246,2020-04-30,3호선,교대,4158,2651,6809
5247,2020-04-30,3호선,남부터미널,14745,16925,31670
5248,2020-04-30,3호선,양재,12963,13830,26793
5249,2020-04-30,3호선,매봉,3906,3705,7611
5250,2020-04-30,3호선,도곡,2021,2034,4055
5251,2020-04-30,3호선,대치,5646,5174,10820
5252,2020-04-30,3호선,학여울,735,729,1464
5253,2020-04-30,3호선,대청,4315,3763,8078
5254,2020-04-30,3호선,일원,3306,3264,6570
5255,2020-04-30,3호선,수서,8409,10212,18621
5256,2020-04-30,3호선,가락시장,4776,4534,9310
5257,2020-04-30,3호선,경찰병원,2872,2750,5622
5258,2020-04-30,3호선,오금,2744,2453,5197
5259,2020-04-30,3호선,원흥,5207,4826,10033
5260,2020-04-30,3호선,삼송,10849,10200,21049
5261,2020-04-30,3호선,원당,7050,6740,13790
5262,2020-04-30,3호선,화정,10413,10567,20980
5263,2020-04-30,3호선,대곡,1139,972,2111
5264,2020-04-30,3호선,백석,6132,6080,12212
5265,2020-04-30,3호선,마두,3909,3921,7830
5266,2020-04-30,3호선,정발산,5468,5723,11191
5267,2020-04-30,3호선,주엽,4812,4838,9650
5268,2020-04-30,3호선,대화,6989,6001,12990
5269,2020-05-01,3호선,대화,7824,6713,14537
5270,2020-05-01,3호선,주엽,5647,5615,11262
5271,2020-05-01,3호선,정발산,5673,6092,11765
5272,2020-05-01,3호선,마두,4718,4896,9614
5273,2020-05-01,3호선,백석,6670,6583,13253
5274,2020-05-01,3호선,대곡,1089,946,2035
5275,2020-05-01,3호선,화정,11848,12371,24219
5276,2020-05-01,3호선,원당,7752,7310,15062
5277,2020-05-01,3호선,삼송,11479,10791,22270
5278,2020-05-01,3호선,원흥,5718,5243,10961
5279,2020-05-01,3호선,오금,3277,2938,6215
5280,2020-05-01,3호선,경찰병원,3775,3721,7496
5281,2020-05-01,3호선,가락시장,5581,5322,10903
5282,2020-05-01,3호선,수서,9796,10667,20463
5283,2020-05-01,3호선,일원,3726,3668,7394
5284,2020-05-01,3호선,대청,5092,4551,9643
5285,2020-05-01,3호선,학여울,947,974,1921
5286,2020-05-01,3호선,대치,6920,6557,13477
5287,2020-05-01,3호선,도곡,2721,2759,5480
5288,2020-05-01,3호선,매봉,4598,4337,8935
5289,2020-05-01,3호선,양재,15487,16888,32375
5290,2020-05-01,3호선,남부터미널,16588,17528,34116
5291,2020-05-01,3호선,교대,6848,4279,11127
5292,2020-05-01,3호선,고속터미널,39568,42273,81841
5293,2020-05-01,3호선,잠원,3699,3514,7213
5294,2020-05-01,3호선,신사,18429,20751,39180
5295,2020-05-01,3호선,압구정,19403,20814,40217
5296,2020-05-01,3호선,옥수,6140,5994,12134
5297,2020-05-01,3호선,금호,5371,4830,10201
5298,2020-05-01,3호선,약수,8367,7799,16166
5299,2020-05-01,3호선,동대입구,4452,5156,9608
5300,2020-05-01,3호선,충무로,1,0,1
5301,2020-05-01,3호선,을지로3가,4706,5219,9925
5302,2020-05-01,3호선,종로3가,4651,6749,11400
5303,2020-05-01,3호선,안국,10737,12482,23219
5304,2020-05-01,3호선,경복궁,12432,13290,25722
5305,2020-05-01,3호선,독립문,4736,5120,9856
5306,2020-05-01,3호선,무악재,2328,2437,4765
5307,2020-05-01,3호선,홍제,12035,11110,23145
5308,2020-05-01,3호선,녹번,7855,6775,14630
5309,2020-05-01,3호선,불광,11133,12567,23700
5310,2020-05-01,3호선,연신내,27469,25282,52751
5311,2020-05-01,3호선,구파발,13058,12596,25654
5312,2020-05-01,3호선,지축,2104,1931,4035
5313,2020-05-02,3호선,지축,1839,1778,3617
5314,2020-05-02,3호선,구파발,12082,12253,24335
5315,2020-05-02,3호선,연신내,25380,24355,49735
5316,2020-05-02,3호선,불광,10645,12173,22818
5317,2020-05-02,3호선,녹번,7185,6128,13313
5318,2020-05-02,3호선,홍제,10965,9938,20903
5319,2020-05-02,3호선,무악재,2210,2290,4500
5320,2020-05-02,3호선,독립문,4677,5054,9731
5321,2020-05-02,3호선,경복궁,10516,11376,21892
5322,2020-05-02,3호선,안국,9587,11497,21084
5323,2020-05-02,3호선,종로3가,4420,6780,11200
5324,2020-05-02,3호선,을지로3가,3698,4351,8049
5325,2020-05-02,3호선,동대입구,4476,5395,9871
5326,2020-05-02,3호선,약수,7445,7062,14507
5327,2020-05-02,3호선,금호,4984,4499,9483
5328,2020-05-02,3호선,옥수,5992,6026,12018
5329,2020-05-02,3호선,압구정,19008,19737,38745
5330,2020-05-02,3호선,신사,18847,20293,39140
5331,2020-05-02,3호선,잠원,3372,3295,6667
5332,2020-05-02,3호선,고속터미널,41635,41852,83487
5333,2020-05-02,3호선,교대,4855,3119,7974
5334,2020-05-02,3호선,남부터미널,16664,16810,33474
5335,2020-05-02,3호선,양재,14758,16195,30953
5336,2020-05-02,3호선,매봉,4093,3992,8085
5337,2020-05-02,3호선,도곡,2495,2470,4965
5338,2020-05-02,3호선,대치,7223,6553,13776
5339,2020-05-02,3호선,학여울,908,886,1794
5340,2020-05-02,3호선,대청,4618,4211,8829
5341,2020-05-02,3호선,일원,3302,3204,6506
5342,2020-05-02,3호선,수서,10294,10052,20346
5343,2020-05-02,3호선,가락시장,5229,5005,10234
5344,2020-05-02,3호선,경찰병원,3179,3078,6257
5345,2020-05-02,3호선,오금,3058,2820,5878
5346,2020-05-02,3호선,원흥,5198,4901,10099
5347,2020-05-02,3호선,삼송,10655,10219,20874
5348,2020-05-02,3호선,원당,7025,6626,13651
5349,2020-05-02,3호선,화정,10866,11284,22150
5350,2020-05-02,3호선,대곡,1069,884,1953
5351,2020-05-02,3호선,대화,7148,6202,13350
5352,2020-05-02,3호선,주엽,5071,5024,10095
5353,2020-05-02,3호선,정발산,5388,5921,11309
5354,2020-05-02,3호선,마두,4155,4151,8306
5355,2020-05-02,3호선,백석,6314,6418,12732
5356,2020-05-03,3호선,대화,5461,5010,10471
5357,2020-05-03,3호선,주엽,3765,3723,7488
5358,2020-05-03,3호선,정발산,4558,4698,9256
5359,2020-05-03,3호선,마두,2977,2981,5958
5360,2020-05-03,3호선,백석,4906,4861,9767
5361,2020-05-03,3호선,대곡,928,816,1744
5362,2020-05-03,3호선,화정,8350,8646,16996
5363,2020-05-03,3호선,원당,5562,5223,10785
5364,2020-05-03,3호선,삼송,8718,8445,17163
5365,2020-05-03,3호선,원흥,4010,3907,7917
5366,2020-05-03,3호선,오금,2373,2495,4868
5367,2020-05-03,3호선,경찰병원,2235,2405,4640
5368,2020-05-03,3호선,가락시장,3416,3684,7100
5369,2020-05-03,3호선,수서,9086,7850,16936
5370,2020-05-03,3호선,일원,2433,2657,5090
5371,2020-05-03,3호선,대청,3352,3205,6557
5372,2020-05-03,3호선,학여울,585,611,1196
5373,2020-05-03,3호선,대치,4740,4153,8893
5374,2020-05-03,3호선,도곡,1473,1619,3092
5375,2020-05-03,3호선,매봉,3088,3069,6157
5376,2020-05-03,3호선,양재,10035,11771,21806
5377,2020-05-03,3호선,남부터미널,13198,12017,25215
5378,2020-05-03,3호선,교대,3243,2028,5271
5379,2020-05-03,3호선,고속터미널,38270,32761,71031
5380,2020-05-03,3호선,잠원,2371,2347,4718
5381,2020-05-03,3호선,신사,11059,11442,22501
5382,2020-05-03,3호선,압구정,10294,10832,21126
5383,2020-05-03,3호선,옥수,4457,4566,9023
5384,2020-05-03,3호선,금호,3768,3575,7343
5385,2020-05-03,3호선,약수,5553,5428,10981
5386,2020-05-03,3호선,동대입구,3694,4233,7927
5387,2020-05-03,3호선,충무로,1,0,1
5388,2020-05-03,3호선,을지로3가,2262,2363,4625
5389,2020-05-03,3호선,종로3가,3058,4324,7382
5390,2020-05-03,3호선,안국,7065,8491,15556
5391,2020-05-03,3호선,경복궁,7427,8153,15580
5392,2020-05-03,3호선,독립문,3574,3877,7451
5393,2020-05-03,3호선,무악재,1561,1713,3274
5394,2020-05-03,3호선,홍제,7858,7521,15379
5395,2020-05-03,3호선,녹번,5148,4772,9920
5396,2020-05-03,3호선,불광,8421,9889,18310
5397,2020-05-03,3호선,연신내,19812,18932,38744
5398,2020-05-03,3호선,구파발,9531,9909,19440
5399,2020-05-03,3호선,지축,1440,1448,2888
5400,2020-05-04,3호선,대곡,1566,1182,2748
5401,2020-05-04,3호선,화정,15328,15629,30957
5402,2020-05-04,3호선,원당,9982,9318,19300
5403,2020-05-04,3호선,삼송,15193,14559,29752
5404,2020-05-04,3호선,원흥,7818,7120,14938
5405,2020-05-04,3호선,대화,11290,9102,20392
5406,2020-05-04,3호선,주엽,7593,7614,15207
5407,2020-05-04,3호선,정발산,6857,7171,14028
5408,2020-05-04,3호선,오금,4911,4323,9234
5409,2020-05-04,3호선,경찰병원,6102,6032,12134
5410,2020-05-04,3호선,가락시장,7504,7212,14716
5411,2020-05-04,3호선,수서,13281,12440,25721
5412,2020-05-04,3호선,일원,7921,7679,15600
5413,2020-05-04,3호선,대청,7833,7042,14875
5414,2020-05-04,3호선,학여울,1295,1297,2592
5415,2020-05-04,3호선,대치,8916,8572,17488
5416,2020-05-04,3호선,도곡,4204,4122,8326
5417,2020-05-04,3호선,매봉,8770,8334,17104
5418,2020-05-04,3호선,양재,27302,29977,57279
5419,2020-05-04,3호선,남부터미널,23346,22980,46326
5420,2020-05-04,3호선,교대,10886,7086,17972
5421,2020-05-04,3호선,고속터미널,40935,38221,79156
5422,2020-05-04,3호선,잠원,5025,4794,9819
5423,2020-05-04,3호선,신사,24587,27013,51600
5424,2020-05-04,3호선,압구정,25201,27224,52425
5425,2020-05-04,3호선,옥수,7862,8127,15989
5426,2020-05-04,3호선,금호,7067,6563,13630
5427,2020-05-04,3호선,약수,11102,10847,21949
5428,2020-05-04,3호선,동대입구,5399,5918,11317
5429,2020-05-04,3호선,충무로,1,0,1
5430,2020-05-04,3호선,을지로3가,8523,9606,18129
5431,2020-05-04,3호선,종로3가,8733,11066,19799
5432,2020-05-04,3호선,안국,12221,13742,25963
5433,2020-05-04,3호선,경복궁,14639,15110,29749
5434,2020-05-04,3호선,독립문,6371,6494,12865
5435,2020-05-04,3호선,무악재,3218,3234,6452
5436,2020-05-04,3호선,홍제,15823,14663,30486
5437,2020-05-04,3호선,녹번,11468,9979,21447
5438,2020-05-04,3호선,불광,14583,15773,30356
5439,2020-05-04,3호선,연신내,34643,32993,67636
5440,2020-05-04,3호선,구파발,17958,16902,34860
5441,2020-05-04,3호선,지축,2824,2684,5508
5442,2020-05-04,3호선,마두,6754,6891,13645
5443,2020-05-04,3호선,백석,9168,9128,18296
5444,2020-05-05,3호선,지축,1719,1661,3380
5445,2020-05-05,3호선,구파발,10902,11004,21906
5446,2020-05-05,3호선,연신내,22152,21395,43547
5447,2020-05-05,3호선,불광,9169,10732,19901
5448,2020-05-05,3호선,녹번,6061,5472,11533
5449,2020-05-05,3호선,홍제,9023,8711,17734
5450,2020-05-05,3호선,무악재,1854,1938,3792
5451,2020-05-05,3호선,독립문,4048,4226,8274
5452,2020-05-05,3호선,경복궁,8189,8830,17019
5453,2020-05-05,3호선,안국,8190,9911,18101
5454,2020-05-05,3호선,종로3가,3478,5130,8608
5455,2020-05-05,3호선,을지로3가,3038,3152,6190
5456,2020-05-05,3호선,동대입구,4166,4919,9085
5457,2020-05-05,3호선,약수,6252,6014,12266
5458,2020-05-05,3호선,금호,4242,3976,8218
5459,2020-05-05,3호선,옥수,4874,4949,9823
5460,2020-05-05,3호선,압구정,11589,12473,24062
5461,2020-05-05,3호선,신사,12472,12911,25383
5462,2020-05-05,3호선,잠원,2606,2516,5122
5463,2020-05-05,3호선,고속터미널,36367,32329,68696
5464,2020-05-05,3호선,교대,3765,2477,6242
5465,2020-05-05,3호선,남부터미널,13169,13175,26344
5466,2020-05-05,3호선,양재,10561,12030,22591
5467,2020-05-05,3호선,매봉,3708,3617,7325
5468,2020-05-05,3호선,도곡,1833,1800,3633
5469,2020-05-05,3호선,대치,4840,4607,9447
5470,2020-05-05,3호선,학여울,590,688,1278
5471,2020-05-05,3호선,대청,3908,3675,7583
5472,2020-05-05,3호선,일원,2837,3022,5859
5473,2020-05-05,3호선,수서,8711,7792,16503
5474,2020-05-05,3호선,가락시장,4208,4163,8371
5475,2020-05-05,3호선,경찰병원,2605,2557,5162
5476,2020-05-05,3호선,오금,2351,2227,4578
5477,2020-05-05,3호선,대화,6187,5396,11583
5478,2020-05-05,3호선,주엽,4378,4299,8677
5479,2020-05-05,3호선,정발산,4993,5191,10184
5480,2020-05-05,3호선,마두,3399,3473,6872
5481,2020-05-05,3호선,백석,5430,5453,10883
5482,2020-05-05,3호선,대곡,994,843,1837
5483,2020-05-05,3호선,화정,9181,9539,18720
5484,2020-05-05,3호선,원당,6425,6037,12462
5485,2020-05-05,3호선,삼송,9991,9570,19561
5486,2020-05-05,3호선,원흥,4676,4421,9097
5487,2020-05-06,3호선,삼송,17386,16755,34141
5488,2020-05-06,3호선,원당,11255,10580,21835
5489,2020-05-06,3호선,화정,16982,17345,34327
5490,2020-05-06,3호선,대곡,1763,1365,3128
5491,2020-05-06,3호선,백석,10068,9908,19976
5492,2020-05-06,3호선,마두,7618,7815,15433
5493,2020-05-06,3호선,정발산,7166,7502,14668
5494,2020-05-06,3호선,주엽,8727,8827,17554
5495,2020-05-06,3호선,대화,13181,10264,23445
5496,2020-05-06,3호선,오금,6368,5717,12085
5497,2020-05-06,3호선,경찰병원,7732,7772,15504
5498,2020-05-06,3호선,가락시장,8827,8707,17534
5499,2020-05-06,3호선,수서,15645,15506,31151
5500,2020-05-06,3호선,일원,9128,9079,18207
5501,2020-05-06,3호선,대청,9362,8595,17957
5502,2020-05-06,3호선,학여울,1667,1699,3366
5503,2020-05-06,3호선,대치,10226,10026,20252
5504,2020-05-06,3호선,도곡,5071,5222,10293
5505,2020-05-06,3호선,매봉,11476,11033,22509
5506,2020-05-06,3호선,양재,37821,41341,79162
5507,2020-05-06,3호선,남부터미널,28778,29303,58081
5508,2020-05-06,3호선,교대,14202,9539,23741
5509,2020-05-06,3호선,고속터미널,38442,36540,74982
5510,2020-05-06,3호선,잠원,5863,5619,11482
5511,2020-05-06,3호선,신사,29941,32063,62004
5512,2020-05-06,3호선,압구정,30730,33207,63937
5513,2020-05-06,3호선,옥수,9080,9361,18441
5514,2020-05-06,3호선,금호,8209,7704,15913
5515,2020-05-06,3호선,약수,12554,12551,25105
5516,2020-05-06,3호선,동대입구,6644,7095,13739
5517,2020-05-06,3호선,을지로3가,10785,11644,22429
5518,2020-05-06,3호선,종로3가,10154,12178,22332
5519,2020-05-06,3호선,안국,18881,19592,38473
5520,2020-05-06,3호선,경복궁,18019,17776,35795
5521,2020-05-06,3호선,독립문,7090,7443,14533
5522,2020-05-06,3호선,무악재,3781,3869,7650
5523,2020-05-06,3호선,홍제,17891,16740,34631
5524,2020-05-06,3호선,녹번,13718,12082,25800
5525,2020-05-06,3호선,불광,16744,18005,34749
5526,2020-05-06,3호선,연신내,38144,35847,73991
5527,2020-05-06,3호선,구파발,20508,19276,39784
5528,2020-05-06,3호선,지축,3357,3309,6666
5529,2020-05-06,3호선,원흥,8984,8357,17341
5530,2020-05-07,3호선,지축,3372,3249,6621
5531,2020-05-07,3호선,구파발,21096,19585,40681
5532,2020-05-07,3호선,연신내,38592,36746,75338
5533,2020-05-07,3호선,불광,16371,17912,34283
5534,2020-05-07,3호선,녹번,13520,12053,25573
5535,2020-05-07,3호선,홍제,17808,16835,34643
5536,2020-05-07,3호선,무악재,3896,3872,7768
5537,2020-05-07,3호선,독립문,7186,7571,14757
5538,2020-05-07,3호선,경복궁,18115,18138,36253
5539,2020-05-07,3호선,안국,18811,19851,38662
5540,2020-05-07,3호선,종로3가,10167,12023,22190
5541,2020-05-07,3호선,을지로3가,10995,11638,22633
5542,2020-05-07,3호선,충무로,1,0,1
5543,2020-05-07,3호선,동대입구,6736,7219,13955
5544,2020-05-07,3호선,약수,12940,12678,25618
5545,2020-05-07,3호선,금호,8378,7710,16088
5546,2020-05-07,3호선,옥수,9199,9399,18598
5547,2020-05-07,3호선,압구정,30725,33117,63842
5548,2020-05-07,3호선,신사,30319,32458,62777
5549,2020-05-07,3호선,잠원,5875,5526,11401
5550,2020-05-07,3호선,고속터미널,39778,39966,79744
5551,2020-05-07,3호선,교대,14951,9843,24794
5552,2020-05-07,3호선,남부터미널,28777,29825,58602
5553,2020-05-07,3호선,양재,39002,42519,81521
5554,2020-05-07,3호선,매봉,11759,11293,23052
5555,2020-05-07,3호선,도곡,5303,5250,10553
5556,2020-05-07,3호선,대치,10531,10361,20892
5557,2020-05-07,3호선,학여울,1731,1723,3454
5558,2020-05-07,3호선,대청,9472,8751,18223
5559,2020-05-07,3호선,일원,9747,9571,19318
5560,2020-05-07,3호선,수서,16351,16509,32860
5561,2020-05-07,3호선,가락시장,9168,8960,18128
5562,2020-05-07,3호선,경찰병원,7551,7565,15116
5563,2020-05-07,3호선,오금,6367,5572,11939
5564,2020-05-07,3호선,원흥,9226,8606,17832
5565,2020-05-07,3호선,삼송,17727,16902,34629
5566,2020-05-07,3호선,원당,11382,10869,22251
5567,2020-05-07,3호선,화정,17249,17586,34835
5568,2020-05-07,3호선,대곡,1825,1367,3192
5569,2020-05-07,3호선,백석,10217,10096,20313
5570,2020-05-07,3호선,마두,7567,7825,15392
5571,2020-05-07,3호선,정발산,7395,7484,14879
5572,2020-05-07,3호선,주엽,8751,8771,17522
5573,2020-05-07,3호선,대화,13410,10335,23745
5574,2020-05-08,3호선,지축,3398,3310,6708
5575,2020-05-08,3호선,구파발,21448,19803,41251
5576,2020-05-08,3호선,연신내,39302,37556,76858
5577,2020-05-08,3호선,불광,16718,18152,34870
5578,2020-05-08,3호선,녹번,13867,12492,26359
5579,2020-05-08,3호선,홍제,17995,17641,35636
5580,2020-05-08,3호선,무악재,3934,4133,8067
5581,2020-05-08,3호선,독립문,7205,7388,14593
5582,2020-05-08,3호선,경복궁,18886,18230,37116
5583,2020-05-08,3호선,안국,19599,19686,39285
5584,2020-05-08,3호선,종로3가,9809,11629,21438
5585,2020-05-08,3호선,을지로3가,11457,11486,22943
5586,2020-05-08,3호선,충무로,2,0,2
5587,2020-05-08,3호선,동대입구,6841,6947,13788
5588,2020-05-08,3호선,약수,13382,13288,26670
5589,2020-05-08,3호선,금호,8618,8152,16770
5590,2020-05-08,3호선,옥수,9554,10077,19631
5591,2020-05-08,3호선,압구정,32739,35075,67814
5592,2020-05-08,3호선,신사,32039,33604,65643
5593,2020-05-08,3호선,잠원,6165,5997,12162
5594,2020-05-08,3호선,고속터미널,45570,51509,97079
5595,2020-05-08,3호선,교대,15206,9769,24975
5596,2020-05-08,3호선,남부터미널,32401,33494,65895
5597,2020-05-08,3호선,양재,42389,42992,85381
5598,2020-05-08,3호선,매봉,12076,11651,23727
5599,2020-05-08,3호선,대치,11002,10893,21895
5600,2020-05-08,3호선,학여울,1823,1840,3663
5601,2020-05-08,3호선,대청,9824,9048,18872
5602,2020-05-08,3호선,일원,9729,9504,19233
5603,2020-05-08,3호선,수서,17813,18369,36182
5604,2020-05-08,3호선,가락시장,9578,9447,19025
5605,2020-05-08,3호선,경찰병원,7997,7983,15980
5606,2020-05-08,3호선,오금,6464,5793,12257
5607,2020-05-08,3호선,원흥,9084,8455,17539
5608,2020-05-08,3호선,삼송,18090,17523,35613
5609,2020-05-08,3호선,원당,11519,11110,22629
5610,2020-05-08,3호선,화정,17085,17982,35067
5611,2020-05-08,3호선,대곡,1887,1435,3322
5612,2020-05-08,3호선,백석,10362,10797,21159
5613,2020-05-08,3호선,마두,7682,8221,15903
5614,2020-05-08,3호선,정발산,7309,7894,15203
5615,2020-05-08,3호선,주엽,8685,9228,17913
5616,2020-05-08,3호선,대화,14405,11945,26350
5617,2020-05-08,3호선,도곡,5490,5592,11082
5618,2020-05-09,3호선,대치,7717,6811,14528
5619,2020-05-09,3호선,학여울,922,938,1860
5620,2020-05-09,3호선,대청,4821,4376,9197
5621,2020-05-09,3호선,일원,3760,3751,7511
5622,2020-05-09,3호선,수서,10757,10762,21519
5623,2020-05-09,3호선,가락시장,5251,4925,10176
5624,2020-05-09,3호선,경찰병원,3511,3387,6898
5625,2020-05-09,3호선,오금,3439,3225,6664
5626,2020-05-09,3호선,원흥,5253,4985,10238
5627,2020-05-09,3호선,삼송,10835,10191,21026
5628,2020-05-09,3호선,원당,6803,6476,13279
5629,2020-05-09,3호선,화정,10646,10110,20756
5630,2020-05-09,3호선,대곡,969,786,1755
5631,2020-05-09,3호선,백석,6557,6523,13080
5632,2020-05-09,3호선,마두,4130,4185,8315
5633,2020-05-09,3호선,정발산,4868,5504,10372
5634,2020-05-09,3호선,주엽,5114,4973,10087
5635,2020-05-09,3호선,대화,8429,7400,15829
5636,2020-05-09,3호선,지축,1767,1721,3488
5637,2020-05-09,3호선,구파발,11728,11252,22980
5638,2020-05-09,3호선,연신내,25099,24381,49480
5639,2020-05-09,3호선,불광,10190,11069,21259
5640,2020-05-09,3호선,녹번,7620,6474,14094
5641,2020-05-09,3호선,홍제,10528,9946,20474
5642,2020-05-09,3호선,무악재,2225,2203,4428
5643,2020-05-09,3호선,독립문,4179,4029,8208
5644,2020-05-09,3호선,경복궁,9011,9015,18026
5645,2020-05-09,3호선,안국,8438,9781,18219
5646,2020-05-09,3호선,종로3가,4429,6091,10520
5647,2020-05-09,3호선,을지로3가,3783,4374,8157
5648,2020-05-09,3호선,동대입구,4583,4968,9551
5649,2020-05-09,3호선,약수,7583,7149,14732
5650,2020-05-09,3호선,금호,5306,4663,9969
5651,2020-05-09,3호선,옥수,5526,5510,11036
5652,2020-05-09,3호선,압구정,20527,21448,41975
5653,2020-05-09,3호선,신사,20418,21723,42141
5654,2020-05-09,3호선,잠원,3302,3116,6418
5655,2020-05-09,3호선,고속터미널,42915,43287,86202
5656,2020-05-09,3호선,교대,6179,3761,9940
5657,2020-05-09,3호선,남부터미널,18547,18789,37336
5658,2020-05-09,3호선,양재,17810,19133,36943
5659,2020-05-09,3호선,매봉,4753,4506,9259
5660,2020-05-09,3호선,도곡,3056,2952,6008
5661,2020-05-10,3호선,지축,1483,1480,2963
5662,2020-05-10,3호선,구파발,10267,10558,20825
5663,2020-05-10,3호선,연신내,20843,19891,40734
5664,2020-05-10,3호선,불광,9073,10988,20061
5665,2020-05-10,3호선,녹번,5674,5111,10785
5666,2020-05-10,3호선,홍제,8732,8155,16887
5667,2020-05-10,3호선,무악재,1735,1797,3532
5668,2020-05-10,3호선,독립문,3807,4364,8171
5669,2020-05-10,3호선,경복궁,8180,8501,16681
5670,2020-05-10,3호선,안국,7688,8731,16419
5671,2020-05-10,3호선,종로3가,2884,3955,6839
5672,2020-05-10,3호선,을지로3가,2386,2536,4922
5673,2020-05-10,3호선,동대입구,3468,4080,7548
5674,2020-05-10,3호선,약수,5946,5707,11653
5675,2020-05-10,3호선,금호,3936,3770,7706
5676,2020-05-10,3호선,옥수,4542,4816,9358
5677,2020-05-10,3호선,압구정,11125,11576,22701
5678,2020-05-10,3호선,신사,11980,12393,24373
5679,2020-05-10,3호선,잠원,2404,2512,4916
5680,2020-05-10,3호선,고속터미널,37797,34252,72049
5681,2020-05-10,3호선,교대,4007,2449,6456
5682,2020-05-10,3호선,남부터미널,14361,14326,28687
5683,2020-05-10,3호선,양재,12298,14319,26617
5684,2020-05-10,3호선,매봉,3262,3263,6525
5685,2020-05-10,3호선,도곡,1663,1735,3398
5686,2020-05-10,3호선,대치,5155,4442,9597
5687,2020-05-10,3호선,학여울,646,652,1298
5688,2020-05-10,3호선,대청,3458,3309,6767
5689,2020-05-10,3호선,일원,2756,2864,5620
5690,2020-05-10,3호선,수서,9327,8386,17713
5691,2020-05-10,3호선,가락시장,3437,3639,7076
5692,2020-05-10,3호선,경찰병원,2447,2565,5012
5693,2020-05-10,3호선,오금,2423,2343,4766
5694,2020-05-10,3호선,원흥,4252,4153,8405
5695,2020-05-10,3호선,삼송,9129,8687,17816
5696,2020-05-10,3호선,원당,6066,5737,11803
5697,2020-05-10,3호선,화정,8910,8341,17251
5698,2020-05-10,3호선,대곡,969,783,1752
5699,2020-05-10,3호선,백석,5294,5219,10513
5700,2020-05-10,3호선,마두,3036,3065,6101
5701,2020-05-10,3호선,정발산,4919,4890,9809
5702,2020-05-10,3호선,주엽,3944,3933,7877
5703,2020-05-10,3호선,대화,7190,6566,13756
5704,2020-05-11,3호선,가락시장,8994,8568,17562
5705,2020-05-11,3호선,경찰병원,7626,7678,15304
5706,2020-05-11,3호선,오금,6223,5517,11740
5707,2020-05-11,3호선,대화,14200,11297,25497
5708,2020-05-11,3호선,정발산,6814,7332,14146
5709,2020-05-11,3호선,마두,7596,7892,15488
5710,2020-05-11,3호선,백석,10097,10011,20108
5711,2020-05-11,3호선,대곡,1977,1429,3406
5712,2020-05-11,3호선,화정,16764,17196,33960
5713,2020-05-11,3호선,원당,11262,10700,21962
5714,2020-05-11,3호선,삼송,17367,16794,34161
5715,2020-05-11,3호선,원흥,8946,8486,17432
5716,2020-05-11,3호선,주엽,8798,8812,17610
5717,2020-05-11,3호선,지축,3380,3224,6604
5718,2020-05-11,3호선,구파발,19996,18558,38554
5719,2020-05-11,3호선,연신내,37687,35745,73432
5720,2020-05-11,3호선,불광,16301,17427,33728
5721,2020-05-11,3호선,녹번,13585,12245,25830
5722,2020-05-11,3호선,홍제,17485,16746,34231
5723,2020-05-11,3호선,무악재,3735,3887,7622
5724,2020-05-11,3호선,독립문,6795,7011,13806
5725,2020-05-11,3호선,경복궁,16870,16892,33762
5726,2020-05-11,3호선,안국,18283,18933,37216
5727,2020-05-11,3호선,종로3가,9740,11400,21140
5728,2020-05-11,3호선,을지로3가,10828,11171,21999
5729,2020-05-11,3호선,충무로,2,0,2
5730,2020-05-11,3호선,동대입구,7178,7717,14895
5731,2020-05-11,3호선,약수,12620,12563,25183
5732,2020-05-11,3호선,금호,8027,7577,15604
5733,2020-05-11,3호선,옥수,8748,9125,17873
5734,2020-05-11,3호선,압구정,29539,31867,61406
5735,2020-05-11,3호선,신사,28682,30578,59260
5736,2020-05-11,3호선,잠원,5887,5790,11677
5737,2020-05-11,3호선,고속터미널,36677,34405,71082
5738,2020-05-11,3호선,교대,14320,9506,23826
5739,2020-05-11,3호선,남부터미널,28387,29446,57833
5740,2020-05-11,3호선,양재,37964,41597,79561
5741,2020-05-11,3호선,매봉,11203,10739,21942
5742,2020-05-11,3호선,도곡,5209,5312,10521
5743,2020-05-11,3호선,대치,10256,10077,20333
5744,2020-05-11,3호선,학여울,1652,1678,3330
5745,2020-05-11,3호선,대청,9295,8610,17905
5746,2020-05-11,3호선,일원,9370,9280,18650
5747,2020-05-11,3호선,수서,16069,16119,32188
5748,2020-05-12,3호선,지축,3290,3215,6505
5749,2020-05-12,3호선,구파발,20588,19182,39770
5750,2020-05-12,3호선,연신내,37555,35453,73008
5751,2020-05-12,3호선,불광,15982,17466,33448
5752,2020-05-12,3호선,녹번,13469,12134,25603
5753,2020-05-12,3호선,홍제,17092,16130,33222
5754,2020-05-12,3호선,무악재,3732,3840,7572
5755,2020-05-12,3호선,독립문,6751,7061,13812
5756,2020-05-12,3호선,경복궁,17392,17263,34655
5757,2020-05-12,3호선,안국,18634,19183,37817
5758,2020-05-12,3호선,종로3가,9923,11436,21359
5759,2020-05-12,3호선,을지로3가,10554,11192,21746
5760,2020-05-12,3호선,충무로,1,0,1
5761,2020-05-12,3호선,동대입구,7084,7443,14527
5762,2020-05-12,3호선,약수,12411,12345,24756
5763,2020-05-12,3호선,금호,8168,7605,15773
5764,2020-05-12,3호선,옥수,9015,9213,18228
5765,2020-05-12,3호선,압구정,29855,32147,62002
5766,2020-05-12,3호선,신사,28638,30272,58910
5767,2020-05-12,3호선,잠원,5767,5579,11346
5768,2020-05-12,3호선,고속터미널,35050,33825,68875
5769,2020-05-12,3호선,교대,14438,9499,23937
5770,2020-05-12,3호선,남부터미널,28359,29205,57564
5771,2020-05-12,3호선,양재,38545,41873,80418
5772,2020-05-12,3호선,매봉,11329,10893,22222
5773,2020-05-12,3호선,도곡,5190,5200,10390
5774,2020-05-12,3호선,대치,10027,9943,19970
5775,2020-05-12,3호선,학여울,1777,1771,3548
5776,2020-05-12,3호선,대청,9271,8529,17800
5777,2020-05-12,3호선,일원,9379,9132,18511
5778,2020-05-12,3호선,수서,15667,15675,31342
5779,2020-05-12,3호선,가락시장,8957,8812,17769
5780,2020-05-12,3호선,경찰병원,7590,7571,15161
5781,2020-05-12,3호선,오금,6159,5586,11745
5782,2020-05-12,3호선,원흥,8822,8313,17135
5783,2020-05-12,3호선,삼송,17187,16505,33692
5784,2020-05-12,3호선,원당,10947,10407,21354
5785,2020-05-12,3호선,화정,16697,17104,33801
5786,2020-05-12,3호선,대곡,1912,1433,3345
5787,2020-05-12,3호선,백석,9898,9774,19672
5788,2020-05-12,3호선,마두,7246,7593,14839
5789,2020-05-12,3호선,정발산,6771,7062,13833
5790,2020-05-12,3호선,주엽,8364,8562,16926
5791,2020-05-12,3호선,대화,13206,10174,23380
5792,2020-05-13,3호선,원흥,9026,8523,17549
5793,2020-05-13,3호선,삼송,17292,16702,33994
5794,2020-05-13,3호선,원당,11099,10567,21666
5795,2020-05-13,3호선,화정,16764,17226,33990
5796,2020-05-13,3호선,대곡,1893,1420,3313
5797,2020-05-13,3호선,백석,9860,9909,19769
5798,2020-05-13,3호선,마두,7419,7718,15137
5799,2020-05-13,3호선,정발산,7300,7635,14935
5800,2020-05-13,3호선,주엽,8515,8774,17289
5801,2020-05-13,3호선,대화,12973,10074,23047
5802,2020-05-13,3호선,지축,3402,3291,6693
5803,2020-05-13,3호선,구파발,20688,19492,40180
5804,2020-05-13,3호선,연신내,37690,35985,73675
5805,2020-05-13,3호선,불광,16317,17543,33860
5806,2020-05-13,3호선,녹번,13729,12281,26010
5807,2020-05-13,3호선,홍제,17327,16550,33877
5808,2020-05-13,3호선,무악재,3817,3811,7628
5809,2020-05-13,3호선,독립문,7205,7516,14721
5810,2020-05-13,3호선,경복궁,18228,18103,36331
5811,2020-05-13,3호선,안국,18810,19706,38516
5812,2020-05-13,3호선,종로3가,10044,11570,21614
5813,2020-05-13,3호선,을지로3가,10648,11289,21937
5814,2020-05-13,3호선,충무로,1,0,1
5815,2020-05-13,3호선,동대입구,6970,7567,14537
5816,2020-05-13,3호선,약수,12606,12501,25107
5817,2020-05-13,3호선,금호,7995,7553,15548
5818,2020-05-13,3호선,옥수,9135,9185,18320
5819,2020-05-13,3호선,압구정,29379,31683,61062
5820,2020-05-13,3호선,신사,28410,30422,58832
5821,2020-05-13,3호선,잠원,5849,5682,11531
5822,2020-05-13,3호선,고속터미널,35585,34216,69801
5823,2020-05-13,3호선,교대,14762,9660,24422
5824,2020-05-13,3호선,남부터미널,28331,28902,57233
5825,2020-05-13,3호선,양재,38607,41558,80165
5826,2020-05-13,3호선,매봉,11477,10936,22413
5827,2020-05-13,3호선,도곡,5127,5162,10289
5828,2020-05-13,3호선,대치,10050,9910,19960
5829,2020-05-13,3호선,학여울,1609,1645,3254
5830,2020-05-13,3호선,대청,9135,8426,17561
5831,2020-05-13,3호선,일원,9200,9058,18258
5832,2020-05-13,3호선,수서,15710,15946,31656
5833,2020-05-13,3호선,가락시장,8998,8900,17898
5834,2020-05-13,3호선,경찰병원,7545,7577,15122
5835,2020-05-13,3호선,오금,6371,5642,12013
5836,2020-05-14,3호선,오금,6322,5655,11977
5837,2020-05-14,3호선,경찰병원,7538,7542,15080
5838,2020-05-14,3호선,가락시장,8724,8634,17358
5839,2020-05-14,3호선,수서,15977,15933,31910
5840,2020-05-14,3호선,일원,9438,9232,18670
5841,2020-05-14,3호선,대청,9180,8444,17624
5842,2020-05-14,3호선,학여울,1789,1780,3569
5843,2020-05-14,3호선,대치,10186,9958,20144
5844,2020-05-14,3호선,도곡,5154,5199,10353
5845,2020-05-14,3호선,매봉,11434,10946,22380
5846,2020-05-14,3호선,양재,38604,41922,80526
5847,2020-05-14,3호선,남부터미널,27870,28318,56188
5848,2020-05-14,3호선,교대,14601,9680,24281
5849,2020-05-14,3호선,고속터미널,35649,34500,70149
5850,2020-05-14,3호선,잠원,5710,5494,11204
5851,2020-05-14,3호선,신사,28353,30575,58928
5852,2020-05-14,3호선,압구정,28963,31459,60422
5853,2020-05-14,3호선,옥수,9011,9133,18144
5854,2020-05-14,3호선,약수,12504,12233,24737
5855,2020-05-14,3호선,동대입구,6882,7439,14321
5856,2020-05-14,3호선,충무로,1,0,1
5857,2020-05-14,3호선,을지로3가,10501,11209,21710
5858,2020-05-14,3호선,종로3가,9476,11051,20527
5859,2020-05-14,3호선,안국,18208,19253,37461
5860,2020-05-14,3호선,경복궁,17961,17807,35768
5861,2020-05-14,3호선,독립문,7007,7487,14494
5862,2020-05-14,3호선,금호,7925,7367,15292
5863,2020-05-14,3호선,대화,12925,10018,22943
5864,2020-05-14,3호선,주엽,8491,8592,17083
5865,2020-05-14,3호선,정발산,7038,7353,14391
5866,2020-05-14,3호선,마두,7259,7517,14776
5867,2020-05-14,3호선,백석,10031,10044,20075
5868,2020-05-14,3호선,대곡,1891,1457,3348
5869,2020-05-14,3호선,화정,16639,16992,33631
5870,2020-05-14,3호선,원당,11004,10435,21439
5871,2020-05-14,3호선,삼송,17317,16555,33872
5872,2020-05-14,3호선,원흥,9053,8487,17540
5873,2020-05-14,3호선,불광,16200,17273,33473
5874,2020-05-14,3호선,연신내,37413,35577,72990
5875,2020-05-14,3호선,구파발,20589,19196,39785
5876,2020-05-14,3호선,지축,3440,3266,6706
5877,2020-05-14,3호선,무악재,3787,3795,7582
5878,2020-05-14,3호선,홍제,17259,16172,33431
5879,2020-05-14,3호선,녹번,13413,11941,25354
5880,2020-05-15,3호선,원흥,8551,7842,16393
5881,2020-05-15,3호선,삼송,16707,15915,32622
5882,2020-05-15,3호선,원당,10510,9884,20394
5883,2020-05-15,3호선,화정,15821,16561,32382
5884,2020-05-15,3호선,대곡,1646,1281,2927
5885,2020-05-15,3호선,백석,9666,9741,19407
5886,2020-05-15,3호선,마두,7153,7361,14514
5887,2020-05-15,3호선,정발산,6595,7375,13970
5888,2020-05-15,3호선,주엽,8022,8325,16347
5889,2020-05-15,3호선,대화,12732,10005,22737
5890,2020-05-15,3호선,오금,6157,5512,11669
5891,2020-05-15,3호선,경찰병원,7408,7393,14801
5892,2020-05-15,3호선,가락시장,8856,8646,17502
5893,2020-05-15,3호선,수서,17301,17179,34480
5894,2020-05-15,3호선,일원,8922,8679,17601
5895,2020-05-15,3호선,대청,9295,8433,17728
5896,2020-05-15,3호선,학여울,1712,1700,3412
5897,2020-05-15,3호선,대치,10327,10256,20583
5898,2020-05-15,3호선,도곡,5232,5177,10409
5899,2020-05-15,3호선,매봉,11402,10907,22309
5900,2020-05-15,3호선,지축,3116,2974,6090
5901,2020-05-15,3호선,구파발,19821,18043,37864
5902,2020-05-15,3호선,연신내,36167,35014,71181
5903,2020-05-15,3호선,불광,15460,16428,31888
5904,2020-05-15,3호선,녹번,13267,11703,24970
5905,2020-05-15,3호선,홍제,16664,15841,32505
5906,2020-05-15,3호선,무악재,3686,3655,7341
5907,2020-05-15,3호선,독립문,6364,6537,12901
5908,2020-05-15,3호선,경복궁,17653,17194,34847
5909,2020-05-15,3호선,안국,18491,18617,37108
5910,2020-05-15,3호선,종로3가,8980,10482,19462
5911,2020-05-15,3호선,을지로3가,10781,11315,22096
5912,2020-05-15,3호선,충무로,1,0,1
5913,2020-05-15,3호선,동대입구,6588,6847,13435
5914,2020-05-15,3호선,약수,12350,12224,24574
5915,2020-05-15,3호선,금호,7965,7394,15359
5916,2020-05-15,3호선,옥수,8674,8915,17589
5917,2020-05-15,3호선,압구정,30273,32746,63019
5918,2020-05-15,3호선,신사,29262,32227,61489
5919,2020-05-15,3호선,잠원,5754,5629,11383
5920,2020-05-15,3호선,고속터미널,39895,42659,82554
5921,2020-05-15,3호선,교대,14428,9619,24047
5922,2020-05-15,3호선,남부터미널,29887,30208,60095
5923,2020-05-15,3호선,양재,40336,41914,82250
5924,2020-05-16,3호선,대화,7915,6818,14733
5925,2020-05-16,3호선,주엽,5663,5657,11320
5926,2020-05-16,3호선,정발산,5583,6103,11686
5927,2020-05-16,3호선,마두,4548,4600,9148
5928,2020-05-16,3호선,백석,6956,7003,13959
5929,2020-05-16,3호선,대곡,1129,919,2048
5930,2020-05-16,3호선,화정,11605,12018,23623
5931,2020-05-16,3호선,원당,7558,7149,14707
5932,2020-05-16,3호선,삼송,11546,11072,22618
5933,2020-05-16,3호선,원흥,5606,5399,11005
5934,2020-05-16,3호선,지축,2049,1896,3945
5935,2020-05-16,3호선,구파발,13252,13128,26380
5936,2020-05-16,3호선,연신내,27808,26481,54289
5937,2020-05-16,3호선,불광,11363,12635,23998
5938,2020-05-16,3호선,녹번,8291,7167,15458
5939,2020-05-16,3호선,홍제,12191,11346,23537
5940,2020-05-16,3호선,무악재,2396,2483,4879
5941,2020-05-16,3호선,독립문,5152,5565,10717
5942,2020-05-16,3호선,경복궁,10544,10851,21395
5943,2020-05-16,3호선,안국,9681,11598,21279
5944,2020-05-16,3호선,종로3가,4804,6439,11243
5945,2020-05-16,3호선,을지로3가,4093,4781,8874
5946,2020-05-16,3호선,충무로,1,0,1
5947,2020-05-16,3호선,동대입구,5126,5794,10920
5948,2020-05-16,3호선,약수,8275,7934,16209
5949,2020-05-16,3호선,금호,5378,4909,10287
5950,2020-05-16,3호선,옥수,6598,6430,13028
5951,2020-05-16,3호선,압구정,21105,22020,43125
5952,2020-05-16,3호선,신사,20931,22799,43730
5953,2020-05-16,3호선,잠원,3845,3591,7436
5954,2020-05-16,3호선,고속터미널,39789,40889,80678
5955,2020-05-16,3호선,교대,6216,3917,10133
5956,2020-05-16,3호선,남부터미널,18087,18733,36820
5957,2020-05-16,3호선,양재,19255,20869,40124
5958,2020-05-16,3호선,매봉,4959,4699,9658
5959,2020-05-16,3호선,도곡,2995,3029,6024
5960,2020-05-16,3호선,대치,7834,7056,14890
5961,2020-05-16,3호선,학여울,1030,993,2023
5962,2020-05-16,3호선,대청,5085,4669,9754
5963,2020-05-16,3호선,일원,3950,3812,7762
5964,2020-05-16,3호선,수서,10862,11233,22095
5965,2020-05-16,3호선,가락시장,5872,5589,11461
5966,2020-05-16,3호선,경찰병원,3670,3428,7098
5967,2020-05-16,3호선,오금,3689,3528,7217
5968,2020-05-17,3호선,대화,5761,5031,10792
5969,2020-05-17,3호선,주엽,3892,3833,7725
5970,2020-05-17,3호선,정발산,4808,4981,9789
5971,2020-05-17,3호선,마두,3013,3044,6057
5972,2020-05-17,3호선,백석,5107,5111,10218
5973,2020-05-17,3호선,대곡,952,862,1814
5974,2020-05-17,3호선,화정,8564,8806,17370
5975,2020-05-17,3호선,원당,5976,5720,11696
5976,2020-05-17,3호선,삼송,8810,8411,17221
5977,2020-05-17,3호선,원흥,4194,4038,8232
5978,2020-05-17,3호선,오금,2738,2672,5410
5979,2020-05-17,3호선,경찰병원,2407,2537,4944
5980,2020-05-17,3호선,가락시장,3630,3800,7430
5981,2020-05-17,3호선,수서,8840,8480,17320
5982,2020-05-17,3호선,일원,2778,2935,5713
5983,2020-05-17,3호선,대청,3574,3359,6933
5984,2020-05-17,3호선,학여울,701,696,1397
5985,2020-05-17,3호선,대치,4992,4356,9348
5986,2020-05-17,3호선,도곡,1565,1587,3152
5987,2020-05-17,3호선,매봉,3351,3336,6687
5988,2020-05-17,3호선,양재,12051,13894,25945
5989,2020-05-17,3호선,남부터미널,12053,12660,24713
5990,2020-05-17,3호선,교대,3797,2358,6155
5991,2020-05-17,3호선,고속터미널,33315,31334,64649
5992,2020-05-17,3호선,잠원,2672,2685,5357
5993,2020-05-17,3호선,신사,11678,12108,23786
5994,2020-05-17,3호선,압구정,11015,11679,22694
5995,2020-05-17,3호선,옥수,4698,4994,9692
5996,2020-05-17,3호선,금호,4014,3804,7818
5997,2020-05-17,3호선,약수,5944,5686,11630
5998,2020-05-17,3호선,동대입구,3997,4523,8520
5999,2020-05-17,3호선,을지로3가,2227,2337,4564
6000,2020-05-17,3호선,종로3가,2857,3896,6753
6001,2020-05-17,3호선,안국,6866,8108,14974
6002,2020-05-17,3호선,경복궁,8062,8394,16456
6003,2020-05-17,3호선,독립문,4041,4517,8558
6004,2020-05-17,3호선,무악재,1680,1812,3492
6005,2020-05-17,3호선,홍제,8543,8149,16692
6006,2020-05-17,3호선,녹번,5608,5126,10734
6007,2020-05-17,3호선,불광,8879,10687,19566
6008,2020-05-17,3호선,연신내,20809,19291,40100
6009,2020-05-17,3호선,구파발,10428,10683,21111
6010,2020-05-17,3호선,지축,1528,1537,3065
6011,2020-05-18,3호선,오금,6108,5429,11537
6012,2020-05-18,3호선,경찰병원,7711,7877,15588
6013,2020-05-18,3호선,가락시장,8630,8378,17008
6014,2020-05-18,3호선,수서,15077,15480,30557
6015,2020-05-18,3호선,일원,9064,8978,18042
6016,2020-05-18,3호선,대청,9124,8459,17583
6017,2020-05-18,3호선,학여울,1579,1674,3253
6018,2020-05-18,3호선,대치,9887,9820,19707
6019,2020-05-18,3호선,도곡,5055,5121,10176
6020,2020-05-18,3호선,매봉,11431,11021,22452
6021,2020-05-18,3호선,양재,37113,40308,77421
6022,2020-05-18,3호선,남부터미널,26989,27721,54710
6023,2020-05-18,3호선,교대,13538,8923,22461
6024,2020-05-18,3호선,고속터미널,34099,32244,66343
6025,2020-05-18,3호선,잠원,5561,5546,11107
6026,2020-05-18,3호선,신사,27207,28743,55950
6027,2020-05-18,3호선,압구정,28497,30503,59000
6028,2020-05-18,3호선,옥수,8301,8642,16943
6029,2020-05-18,3호선,금호,7670,7290,14960
6030,2020-05-18,3호선,약수,12153,11990,24143
6031,2020-05-18,3호선,동대입구,6696,6996,13692
6032,2020-05-18,3호선,을지로3가,10765,10680,21445
6033,2020-05-18,3호선,종로3가,10083,11125,21208
6034,2020-05-18,3호선,안국,18272,18106,36378
6035,2020-05-18,3호선,경복궁,16284,16132,32416
6036,2020-05-18,3호선,독립문,6489,6881,13370
6037,2020-05-18,3호선,무악재,3601,3743,7344
6038,2020-05-18,3호선,홍제,16501,16139,32640
6039,2020-05-18,3호선,녹번,12944,11846,24790
6040,2020-05-18,3호선,불광,15453,16289,31742
6041,2020-05-18,3호선,연신내,35864,33730,69594
6042,2020-05-18,3호선,구파발,19289,17973,37262
6043,2020-05-18,3호선,지축,3214,3143,6357
6044,2020-05-18,3호선,원흥,8414,7943,16357
6045,2020-05-18,3호선,삼송,16225,15937,32162
6046,2020-05-18,3호선,원당,10431,9848,20279
6047,2020-05-18,3호선,화정,15496,16081,31577
6048,2020-05-18,3호선,대곡,1717,1223,2940
6049,2020-05-18,3호선,백석,9243,9473,18716
6050,2020-05-18,3호선,마두,6951,7346,14297
6051,2020-05-18,3호선,정발산,6396,6439,12835
6052,2020-05-18,3호선,주엽,8050,8145,16195
6053,2020-05-18,3호선,대화,12585,9820,22405
6054,2020-05-19,3호선,원흥,8389,7931,16320
6055,2020-05-19,3호선,삼송,16499,15900,32399
6056,2020-05-19,3호선,원당,10502,9952,20454
6057,2020-05-19,3호선,화정,15914,16535,32449
6058,2020-05-19,3호선,대곡,1618,1209,2827
6059,2020-05-19,3호선,백석,9632,9538,19170
6060,2020-05-19,3호선,마두,6908,7250,14158
6061,2020-05-19,3호선,정발산,6605,6890,13495
6062,2020-05-19,3호선,주엽,8112,8310,16422
6063,2020-05-19,3호선,대화,12694,9618,22312
6064,2020-05-19,3호선,오금,6152,5445,11597
6065,2020-05-19,3호선,경찰병원,7513,7428,14941
6066,2020-05-19,3호선,가락시장,8679,8486,17165
6067,2020-05-19,3호선,수서,14882,15122,30004
6068,2020-05-19,3호선,일원,8822,8632,17454
6069,2020-05-19,3호선,대청,8993,8264,17257
6070,2020-05-19,3호선,학여울,1605,1644,3249
6071,2020-05-19,3호선,대치,9910,9799,19709
6072,2020-05-19,3호선,도곡,5070,5079,10149
6073,2020-05-19,3호선,매봉,11391,10927,22318
6074,2020-05-19,3호선,양재,37510,40476,77986
6075,2020-05-19,3호선,남부터미널,26924,27779,54703
6076,2020-05-19,3호선,교대,13898,9316,23214
6077,2020-05-19,3호선,고속터미널,33480,32565,66045
6078,2020-05-19,3호선,잠원,5742,5500,11242
6079,2020-05-19,3호선,신사,28309,30177,58486
6080,2020-05-19,3호선,압구정,29022,31277,60299
6081,2020-05-19,3호선,옥수,8726,8978,17704
6082,2020-05-19,3호선,금호,7858,7213,15071
6083,2020-05-19,3호선,약수,12024,12005,24029
6084,2020-05-19,3호선,동대입구,6774,7057,13831
6085,2020-05-19,3호선,충무로,1,0,1
6086,2020-05-19,3호선,을지로3가,10449,11018,21467
6087,2020-05-19,3호선,종로3가,9906,11304,21210
6088,2020-05-19,3호선,안국,17959,18596,36555
6089,2020-05-19,3호선,경복궁,16985,16665,33650
6090,2020-05-19,3호선,독립문,6484,6644,13128
6091,2020-05-19,3호선,무악재,3772,3798,7570
6092,2020-05-19,3호선,홍제,16723,15836,32559
6093,2020-05-19,3호선,녹번,13024,11813,24837
6094,2020-05-19,3호선,불광,15407,16304,31711
6095,2020-05-19,3호선,연신내,36257,34277,70534
6096,2020-05-19,3호선,구파발,19920,18365,38285
6097,2020-05-19,3호선,지축,3198,3146,6344
6098,2020-05-20,3호선,대화,13343,10412,23755
6099,2020-05-20,3호선,주엽,8861,8915,17776
6100,2020-05-20,3호선,정발산,7479,7729,15208
6101,2020-05-20,3호선,마두,7597,7866,15463
6102,2020-05-20,3호선,백석,10183,10240,20423
6103,2020-05-20,3호선,대곡,1925,1419,3344
6104,2020-05-20,3호선,화정,17361,17899,35260
6105,2020-05-20,3호선,원당,11473,10938,22411
6106,2020-05-20,3호선,삼송,17577,17105,34682
6107,2020-05-20,3호선,원흥,9301,8654,17955
6108,2020-05-20,3호선,오금,6437,5653,12090
6109,2020-05-20,3호선,경찰병원,7731,7547,15278
6110,2020-05-20,3호선,가락시장,9416,9092,18508
6111,2020-05-20,3호선,수서,16263,16409,32672
6112,2020-05-20,3호선,일원,8458,8000,16458
6113,2020-05-20,3호선,대청,9459,8845,18304
6114,2020-05-20,3호선,학여울,1746,1717,3463
6115,2020-05-20,3호선,대치,10067,10068,20135
6116,2020-05-20,3호선,도곡,5219,5333,10552
6117,2020-05-20,3호선,매봉,11737,11248,22985
6118,2020-05-20,3호선,양재,39129,42627,81756
6119,2020-05-20,3호선,남부터미널,28136,28926,57062
6120,2020-05-20,3호선,교대,14972,9782,24754
6121,2020-05-20,3호선,고속터미널,35779,34530,70309
6122,2020-05-20,3호선,잠원,5948,5815,11763
6123,2020-05-20,3호선,신사,29392,31582,60974
6124,2020-05-20,3호선,압구정,30050,32241,62291
6125,2020-05-20,3호선,옥수,9361,9480,18841
6126,2020-05-20,3호선,금호,8235,7745,15980
6127,2020-05-20,3호선,약수,12944,12753,25697
6128,2020-05-20,3호선,동대입구,7197,7841,15038
6129,2020-05-20,3호선,을지로3가,10850,11488,22338
6130,2020-05-20,3호선,종로3가,10085,11720,21805
6131,2020-05-20,3호선,안국,19928,20499,40427
6132,2020-05-20,3호선,경복궁,18778,18566,37344
6133,2020-05-20,3호선,독립문,7323,7786,15109
6134,2020-05-20,3호선,무악재,3918,3853,7771
6135,2020-05-20,3호선,홍제,17943,17013,34956
6136,2020-05-20,3호선,녹번,13879,12374,26253
6137,2020-05-20,3호선,불광,16663,17934,34597
6138,2020-05-20,3호선,연신내,38829,36813,75642
6139,2020-05-20,3호선,구파발,21108,19754,40862
6140,2020-05-20,3호선,지축,3509,3442,6951
6141,2020-05-21,3호선,오금,6408,5705,12113
6142,2020-05-21,3호선,경찰병원,7689,7763,15452
6143,2020-05-21,3호선,가락시장,9392,9245,18637
6144,2020-05-21,3호선,수서,16295,16203,32498
6145,2020-05-21,3호선,일원,8707,8306,17013
6146,2020-05-21,3호선,대청,9416,8766,18182
6147,2020-05-21,3호선,학여울,1703,1762,3465
6148,2020-05-21,3호선,대치,10141,9950,20091
6149,2020-05-21,3호선,도곡,5359,5377,10736
6150,2020-05-21,3호선,매봉,11867,11209,23076
6151,2020-05-21,3호선,양재,39220,42867,82087
6152,2020-05-21,3호선,남부터미널,28392,28902,57294
6153,2020-05-21,3호선,교대,15005,9790,24795
6154,2020-05-21,3호선,고속터미널,36812,35438,72250
6155,2020-05-21,3호선,잠원,6016,5710,11726
6156,2020-05-21,3호선,신사,29691,31928,61619
6157,2020-05-21,3호선,압구정,29608,32018,61626
6158,2020-05-21,3호선,옥수,9375,9580,18955
6159,2020-05-21,3호선,금호,8155,7579,15734
6160,2020-05-21,3호선,약수,13054,12812,25866
6161,2020-05-21,3호선,동대입구,7152,7887,15039
6162,2020-05-21,3호선,을지로3가,10688,11420,22108
6163,2020-05-21,3호선,종로3가,9909,11691,21600
6164,2020-05-21,3호선,안국,19396,20556,39952
6165,2020-05-21,3호선,경복궁,18680,18685,37365
6166,2020-05-21,3호선,독립문,7481,7865,15346
6167,2020-05-21,3호선,무악재,3943,3910,7853
6168,2020-05-21,3호선,홍제,17761,16669,34430
6169,2020-05-21,3호선,녹번,13829,12310,26139
6170,2020-05-21,3호선,불광,16608,17845,34453
6171,2020-05-21,3호선,연신내,38616,36496,75112
6172,2020-05-21,3호선,구파발,21352,19924,41276
6173,2020-05-21,3호선,지축,3455,3343,6798
6174,2020-05-21,3호선,대화,13526,10397,23923
6175,2020-05-21,3호선,주엽,8658,8808,17466
6176,2020-05-21,3호선,정발산,7369,7532,14901
6177,2020-05-21,3호선,마두,7420,7762,15182
6178,2020-05-21,3호선,백석,10215,10068,20283
6179,2020-05-21,3호선,대곡,1896,1423,3319
6180,2020-05-21,3호선,화정,17222,17833,35055
6181,2020-05-21,3호선,원당,11365,10790,22155
6182,2020-05-21,3호선,삼송,17724,17048,34772
6183,2020-05-21,3호선,원흥,9225,8595,17820
6184,2020-05-22,3호선,원흥,9243,8316,17559
6185,2020-05-22,3호선,삼송,17673,16883,34556
6186,2020-05-22,3호선,원당,11517,10774,22291
6187,2020-05-22,3호선,화정,17013,17987,35000
6188,2020-05-22,3호선,대곡,1881,1448,3329
6189,2020-05-22,3호선,백석,10298,10456,20754
6190,2020-05-22,3호선,마두,7623,7918,15541
6191,2020-05-22,3호선,정발산,7306,8103,15409
6192,2020-05-22,3호선,주엽,8886,8902,17788
6193,2020-05-22,3호선,대화,13528,10719,24247
6194,2020-05-22,3호선,가락시장,9748,9542,19290
6195,2020-05-22,3호선,지축,3542,3290,6832
6196,2020-05-22,3호선,구파발,21403,19652,41055
6197,2020-05-22,3호선,연신내,39398,37391,76789
6198,2020-05-22,3호선,불광,16902,17746,34648
6199,2020-05-22,3호선,녹번,13988,12161,26149
6200,2020-05-22,3호선,홍제,18161,16732,34893
6201,2020-05-22,3호선,무악재,3850,3824,7674
6202,2020-05-22,3호선,독립문,7454,7733,15187
6203,2020-05-22,3호선,경복궁,19246,19194,38440
6204,2020-05-22,3호선,안국,19806,20776,40582
6205,2020-05-22,3호선,종로3가,9850,11861,21711
6206,2020-05-22,3호선,을지로3가,10860,11817,22677
6207,2020-05-22,3호선,충무로,1,0,1
6208,2020-05-22,3호선,동대입구,7302,7714,15016
6209,2020-05-22,3호선,약수,13378,12954,26332
6210,2020-05-22,3호선,금호,8622,7841,16463
6211,2020-05-22,3호선,옥수,9721,9806,19527
6212,2020-05-22,3호선,압구정,31502,34695,66197
6213,2020-05-22,3호선,신사,31595,35257,66852
6214,2020-05-22,3호선,잠원,6113,5839,11952
6215,2020-05-22,3호선,고속터미널,42725,45173,87898
6216,2020-05-22,3호선,교대,15220,10068,25288
6217,2020-05-22,3호선,남부터미널,30890,31641,62531
6218,2020-05-22,3호선,양재,41411,43361,84772
6219,2020-05-22,3호선,매봉,11861,11383,23244
6220,2020-05-22,3호선,도곡,5532,5559,11091
6221,2020-05-22,3호선,대치,10826,10768,21594
6222,2020-05-22,3호선,학여울,1825,1790,3615
6223,2020-05-22,3호선,대청,9581,8679,18260
6224,2020-05-22,3호선,일원,8643,8215,16858
6225,2020-05-22,3호선,수서,17870,18202,36072
6226,2020-05-22,3호선,경찰병원,7685,7680,15365
6227,2020-05-22,3호선,오금,6352,5844,12196
6228,2020-05-23,3호선,연신내,30626,28928,59554
6229,2020-05-23,3호선,지축,2306,2220,4526
6230,2020-05-23,3호선,구파발,15066,15146,30212
6231,2020-05-23,3호선,불광,12844,14791,27635
6232,2020-05-23,3호선,녹번,9077,7603,16680
6233,2020-05-23,3호선,홍제,13517,12410,25927
6234,2020-05-23,3호선,무악재,2686,2680,5366
6235,2020-05-23,3호선,독립문,5854,6416,12270
6236,2020-05-23,3호선,경복궁,12939,13790,26729
6237,2020-05-23,3호선,안국,11797,14434,26231
6238,2020-05-23,3호선,종로3가,4951,7139,12090
6239,2020-05-23,3호선,을지로3가,4422,5297,9719
6240,2020-05-23,3호선,충무로,1,0,1
6241,2020-05-23,3호선,동대입구,5445,6224,11669
6242,2020-05-23,3호선,약수,9018,8281,17299
6243,2020-05-23,3호선,금호,6032,5317,11349
6244,2020-05-23,3호선,옥수,7180,7160,14340
6245,2020-05-23,3호선,압구정,22115,23417,45532
6246,2020-05-23,3호선,신사,23749,25879,49628
6247,2020-05-23,3호선,잠원,4204,3977,8181
6248,2020-05-23,3호선,고속터미널,45315,45888,91203
6249,2020-05-23,3호선,교대,6876,4217,11093
6250,2020-05-23,3호선,남부터미널,19285,19186,38471
6251,2020-05-23,3호선,양재,20549,22012,42561
6252,2020-05-23,3호선,매봉,5268,5023,10291
6253,2020-05-23,3호선,도곡,3151,3059,6210
6254,2020-05-23,3호선,대치,8040,7282,15322
6255,2020-05-23,3호선,학여울,1070,1093,2163
6256,2020-05-23,3호선,대청,5460,5010,10470
6257,2020-05-23,3호선,일원,4398,4188,8586
6258,2020-05-23,3호선,수서,11652,11943,23595
6259,2020-05-23,3호선,가락시장,6313,6061,12374
6260,2020-05-23,3호선,경찰병원,3979,3862,7841
6261,2020-05-23,3호선,오금,3837,3664,7501
6262,2020-05-23,3호선,원흥,6116,5800,11916
6263,2020-05-23,3호선,삼송,12534,11981,24515
6264,2020-05-23,3호선,원당,8308,7865,16173
6265,2020-05-23,3호선,화정,12696,13170,25866
6266,2020-05-23,3호선,대곡,1352,1124,2476
6267,2020-05-23,3호선,백석,7481,7550,15031
6268,2020-05-23,3호선,마두,4901,5041,9942
6269,2020-05-23,3호선,정발산,6542,6999,13541
6270,2020-05-23,3호선,주엽,5972,5956,11928
6271,2020-05-23,3호선,대화,8734,7534,16268
6272,2020-05-24,3호선,화정,8408,7835,16243
6273,2020-05-24,3호선,원당,5497,5238,10735
6274,2020-05-24,3호선,삼송,8577,8379,16956
6275,2020-05-24,3호선,원흥,4016,3903,7919
6276,2020-05-24,3호선,오금,2750,2762,5512
6277,2020-05-24,3호선,경찰병원,2506,2674,5180
6278,2020-05-24,3호선,가락시장,3157,3436,6593
6279,2020-05-24,3호선,수서,8728,8284,17012
6280,2020-05-24,3호선,일원,2555,2661,5216
6281,2020-05-24,3호선,대청,3459,3257,6716
6282,2020-05-24,3호선,학여울,639,699,1338
6283,2020-05-24,3호선,대치,4722,4148,8870
6284,2020-05-24,3호선,도곡,1675,1764,3439
6285,2020-05-24,3호선,매봉,3271,3216,6487
6286,2020-05-24,3호선,양재,11478,13424,24902
6287,2020-05-24,3호선,남부터미널,12626,13182,25808
6288,2020-05-24,3호선,교대,3871,2401,6272
6289,2020-05-24,3호선,고속터미널,34019,32146,66165
6290,2020-05-24,3호선,잠원,2320,2326,4646
6291,2020-05-24,3호선,신사,12082,12470,24552
6292,2020-05-24,3호선,압구정,11146,11605,22751
6293,2020-05-24,3호선,옥수,4379,4685,9064
6294,2020-05-24,3호선,금호,4003,3798,7801
6295,2020-05-24,3호선,약수,5856,5617,11473
6296,2020-05-24,3호선,동대입구,3971,4308,8279
6297,2020-05-24,3호선,을지로3가,2384,2484,4868
6298,2020-05-24,3호선,종로3가,2861,4002,6863
6299,2020-05-24,3호선,안국,7060,8069,15129
6300,2020-05-24,3호선,경복궁,7732,8123,15855
6301,2020-05-24,3호선,독립문,3606,3825,7431
6302,2020-05-24,3호선,무악재,1597,1720,3317
6303,2020-05-24,3호선,홍제,8297,7820,16117
6304,2020-05-24,3호선,녹번,5374,4941,10315
6305,2020-05-24,3호선,불광,8215,9454,17669
6306,2020-05-24,3호선,연신내,19917,18784,38701
6307,2020-05-24,3호선,구파발,9597,9862,19459
6308,2020-05-24,3호선,지축,1472,1332,2804
6309,2020-05-24,3호선,대화,5477,4965,10442
6310,2020-05-24,3호선,주엽,3675,3625,7300
6311,2020-05-24,3호선,정발산,4533,4476,9009
6312,2020-05-24,3호선,마두,2908,2875,5783
6313,2020-05-24,3호선,백석,5071,4958,10029
6314,2020-05-24,3호선,대곡,893,752,1645
6315,2020-05-25,3호선,대화,13626,10431,24057
6316,2020-05-25,3호선,주엽,8920,8923,17843
6317,2020-05-25,3호선,정발산,7091,7260,14351
6318,2020-05-25,3호선,마두,7669,7940,15609
6319,2020-05-25,3호선,백석,10040,10035,20075
6320,2020-05-25,3호선,대곡,1938,1436,3374
6321,2020-05-25,3호선,화정,17175,17697,34872
6322,2020-05-25,3호선,원당,11328,10821,22149
6323,2020-05-25,3호선,삼송,17487,16939,34426
6324,2020-05-25,3호선,원흥,9107,8472,17579
6325,2020-05-25,3호선,오금,6430,5678,12108
6326,2020-05-25,3호선,경찰병원,7569,7635,15204
6327,2020-05-25,3호선,가락시장,9351,9111,18462
6328,2020-05-25,3호선,수서,16014,16287,32301
6329,2020-05-25,3호선,일원,9015,8735,17750
6330,2020-05-25,3호선,대청,9590,8801,18391
6331,2020-05-25,3호선,학여울,1780,1824,3604
6332,2020-05-25,3호선,대치,10303,10344,20647
6333,2020-05-25,3호선,도곡,5313,5400,10713
6334,2020-05-25,3호선,매봉,11661,11244,22905
6335,2020-05-25,3호선,양재,38067,41766,79833
6336,2020-05-25,3호선,남부터미널,28297,29251,57548
6337,2020-05-25,3호선,교대,14360,9529,23889
6338,2020-05-25,3호선,고속터미널,37042,34927,71969
6339,2020-05-25,3호선,잠원,5918,5737,11655
6340,2020-05-25,3호선,신사,28710,30786,59496
6341,2020-05-25,3호선,압구정,29808,32420,62228
6342,2020-05-25,3호선,옥수,8923,9232,18155
6343,2020-05-25,3호선,금호,8291,7785,16076
6344,2020-05-25,3호선,약수,12973,12862,25835
6345,2020-05-25,3호선,동대입구,7001,7420,14421
6346,2020-05-25,3호선,충무로,1,0,1
6347,2020-05-25,3호선,을지로3가,10714,11097,21811
6348,2020-05-25,3호선,종로3가,10016,11714,21730
6349,2020-05-25,3호선,안국,18910,19614,38524
6350,2020-05-25,3호선,경복궁,17303,17261,34564
6351,2020-05-25,3호선,독립문,7180,7338,14518
6352,2020-05-25,3호선,무악재,3855,3924,7779
6353,2020-05-25,3호선,홍제,17697,16902,34599
6354,2020-05-25,3호선,녹번,13795,12424,26219
6355,2020-05-25,3호선,불광,16317,17741,34058
6356,2020-05-25,3호선,연신내,38468,36339,74807
6357,2020-05-25,3호선,구파발,20873,19369,40242
6358,2020-05-25,3호선,지축,3499,3393,6892
6359,2020-05-26,3호선,매봉,11950,11509,23459
6360,2020-05-26,3호선,양재,39088,42291,81379
6361,2020-05-26,3호선,남부터미널,28202,29131,57333
6362,2020-05-26,3호선,교대,14629,9509,24138
6363,2020-05-26,3호선,고속터미널,35228,34272,69500
6364,2020-05-26,3호선,잠원,5871,5649,11520
6365,2020-05-26,3호선,신사,29254,31280,60534
6366,2020-05-26,3호선,압구정,30322,32955,63277
6367,2020-05-26,3호선,옥수,9156,9468,18624
6368,2020-05-26,3호선,금호,8048,7414,15462
6369,2020-05-26,3호선,약수,13013,12802,25815
6370,2020-05-26,3호선,동대입구,7244,7643,14887
6371,2020-05-26,3호선,충무로,2,0,2
6372,2020-05-26,3호선,을지로3가,11165,11373,22538
6373,2020-05-26,3호선,종로3가,10260,11692,21952
6374,2020-05-26,3호선,안국,19344,19931,39275
6375,2020-05-26,3호선,경복궁,18107,17906,36013
6376,2020-05-26,3호선,독립문,7161,7576,14737
6377,2020-05-26,3호선,무악재,3848,3981,7829
6378,2020-05-26,3호선,홍제,17481,16498,33979
6379,2020-05-26,3호선,녹번,13828,12567,26395
6380,2020-05-26,3호선,불광,16463,17465,33928
6381,2020-05-26,3호선,연신내,38116,35948,74064
6382,2020-05-26,3호선,구파발,20889,19364,40253
6383,2020-05-26,3호선,지축,3401,3331,6732
6384,2020-05-26,3호선,대치,10300,10182,20482
6385,2020-05-26,3호선,도곡,5425,5438,10863
6386,2020-05-26,3호선,학여울,1728,1768,3496
6387,2020-05-26,3호선,대화,13202,10186,23388
6388,2020-05-26,3호선,주엽,8551,8768,17319
6389,2020-05-26,3호선,정발산,6906,7082,13988
6390,2020-05-26,3호선,마두,7453,7685,15138
6391,2020-05-26,3호선,백석,10012,10065,20077
6392,2020-05-26,3호선,대곡,1906,1439,3345
6393,2020-05-26,3호선,화정,16815,17390,34205
6394,2020-05-26,3호선,원당,11258,10596,21854
6395,2020-05-26,3호선,삼송,17281,16923,34204
6396,2020-05-26,3호선,원흥,8885,8391,17276
6397,2020-05-26,3호선,오금,6505,5734,12239
6398,2020-05-26,3호선,경찰병원,7820,7800,15620
6399,2020-05-26,3호선,가락시장,9345,9217,18562
6400,2020-05-26,3호선,수서,16030,16140,32170
6401,2020-05-26,3호선,일원,9057,8956,18013
6402,2020-05-26,3호선,대청,9686,8906,18592
6403,2020-05-27,3호선,오금,6445,5793,12238
6404,2020-05-27,3호선,경찰병원,7663,7803,15466
6405,2020-05-27,3호선,가락시장,9540,9181,18721
6406,2020-05-27,3호선,수서,16399,16419,32818
6407,2020-05-27,3호선,일원,9163,8922,18085
6408,2020-05-27,3호선,대청,9925,8974,18899
6409,2020-05-27,3호선,학여울,1780,1743,3523
6410,2020-05-27,3호선,대치,10354,10483,20837
6411,2020-05-27,3호선,도곡,5291,5418,10709
6412,2020-05-27,3호선,매봉,11987,11479,23466
6413,2020-05-27,3호선,양재,39443,42871,82314
6414,2020-05-27,3호선,남부터미널,28519,29458,57977
6415,2020-05-27,3호선,교대,14972,9764,24736
6416,2020-05-27,3호선,고속터미널,36878,35361,72239
6417,2020-05-27,3호선,잠원,6059,5906,11965
6418,2020-05-27,3호선,신사,29694,31525,61219
6419,2020-05-27,3호선,압구정,29985,32193,62178
6420,2020-05-27,3호선,옥수,9220,9514,18734
6421,2020-05-27,3호선,금호,8197,7506,15703
6422,2020-05-27,3호선,약수,13259,13129,26388
6423,2020-05-27,3호선,동대입구,7456,8037,15493
6424,2020-05-27,3호선,충무로,3,0,3
6425,2020-05-27,3호선,을지로3가,10967,11648,22615
6426,2020-05-27,3호선,종로3가,10381,11876,22257
6427,2020-05-27,3호선,안국,20517,21555,42072
6428,2020-05-27,3호선,경복궁,19397,19406,38803
6429,2020-05-27,3호선,독립문,7373,7787,15160
6430,2020-05-27,3호선,무악재,3909,3915,7824
6431,2020-05-27,3호선,홍제,17921,16890,34811
6432,2020-05-27,3호선,녹번,14276,12611,26887
6433,2020-05-27,3호선,불광,16882,18305,35187
6434,2020-05-27,3호선,연신내,39198,37000,76198
6435,2020-05-27,3호선,구파발,21202,19914,41116
6436,2020-05-27,3호선,지축,3571,3482,7053
6437,2020-05-27,3호선,마두,7704,8096,15800
6438,2020-05-27,3호선,정발산,7715,7942,15657
6439,2020-05-27,3호선,주엽,8906,8890,17796
6440,2020-05-27,3호선,대화,13565,10576,24141
6441,2020-05-27,3호선,백석,10130,9934,20064
6442,2020-05-27,3호선,대곡,1895,1422,3317
6443,2020-05-27,3호선,화정,17755,18082,35837
6444,2020-05-27,3호선,원당,11432,10887,22319
6445,2020-05-27,3호선,삼송,17873,17094,34967
6446,2020-05-27,3호선,원흥,9194,8620,17814
6447,2020-05-28,3호선,대화,13331,10323,23654
6448,2020-05-28,3호선,주엽,8716,8850,17566
6449,2020-05-28,3호선,정발산,7048,7333,14381
6450,2020-05-28,3호선,마두,7405,7753,15158
6451,2020-05-28,3호선,백석,9960,9952,19912
6452,2020-05-28,3호선,대곡,1831,1436,3267
6453,2020-05-28,3호선,화정,17143,17609,34752
6454,2020-05-28,3호선,원당,11202,10623,21825
6455,2020-05-28,3호선,삼송,17474,17083,34557
6456,2020-05-28,3호선,원흥,9101,8407,17508
6457,2020-05-28,3호선,오금,6431,5731,12162
6458,2020-05-28,3호선,경찰병원,7627,7684,15311
6459,2020-05-28,3호선,가락시장,9268,9137,18405
6460,2020-05-28,3호선,수서,16577,16627,33204
6461,2020-05-28,3호선,일원,9113,8866,17979
6462,2020-05-28,3호선,대청,9828,9024,18852
6463,2020-05-28,3호선,학여울,1782,1844,3626
6464,2020-05-28,3호선,대치,10288,10301,20589
6465,2020-05-28,3호선,도곡,5300,5469,10769
6466,2020-05-28,3호선,매봉,11646,11165,22811
6467,2020-05-28,3호선,양재,39308,43044,82352
6468,2020-05-28,3호선,남부터미널,28076,29139,57215
6469,2020-05-28,3호선,교대,14701,9767,24468
6470,2020-05-28,3호선,고속터미널,36591,35460,72051
6471,2020-05-28,3호선,잠원,6006,5747,11753
6472,2020-05-28,3호선,신사,29114,31416,60530
6473,2020-05-28,3호선,압구정,29654,32329,61983
6474,2020-05-28,3호선,옥수,9090,9226,18316
6475,2020-05-28,3호선,금호,8193,7417,15610
6476,2020-05-28,3호선,약수,13194,12899,26093
6477,2020-05-28,3호선,동대입구,6963,7512,14475
6478,2020-05-28,3호선,충무로,1,0,1
6479,2020-05-28,3호선,을지로3가,10745,11534,22279
6480,2020-05-28,3호선,종로3가,9966,11730,21696
6481,2020-05-28,3호선,안국,19893,20928,40821
6482,2020-05-28,3호선,경복궁,19000,18912,37912
6483,2020-05-28,3호선,독립문,7240,7735,14975
6484,2020-05-28,3호선,무악재,3975,4013,7988
6485,2020-05-28,3호선,홍제,17881,16634,34515
6486,2020-05-28,3호선,녹번,13967,12318,26285
6487,2020-05-28,3호선,불광,16739,17972,34711
6488,2020-05-28,3호선,연신내,38212,36028,74240
6489,2020-05-28,3호선,구파발,21064,19794,40858
6490,2020-05-28,3호선,지축,3463,3332,6795
6491,2020-05-29,3호선,지축,3533,3393,6926
6492,2020-05-29,3호선,구파발,21227,19558,40785
6493,2020-05-29,3호선,연신내,39323,37122,76445
6494,2020-05-29,3호선,불광,16933,17920,34853
6495,2020-05-29,3호선,녹번,14137,12227,26364
6496,2020-05-29,3호선,홍제,17937,16702,34639
6497,2020-05-29,3호선,무악재,3984,3859,7843
6498,2020-05-29,3호선,독립문,7473,7600,15073
6499,2020-05-29,3호선,경복궁,19496,19196,38692
6500,2020-05-29,3호선,안국,20066,20801,40867
6501,2020-05-29,3호선,종로3가,9662,11787,21449
6502,2020-05-29,3호선,을지로3가,10977,11970,22947
6503,2020-05-29,3호선,충무로,4,0,4
6504,2020-05-29,3호선,동대입구,7027,7385,14412
6505,2020-05-29,3호선,약수,13222,12988,26210
6506,2020-05-29,3호선,금호,8287,7428,15715
6507,2020-05-29,3호선,옥수,9478,9678,19156
6508,2020-05-29,3호선,압구정,31609,34650,66259
6509,2020-05-29,3호선,신사,30730,34732,65462
6510,2020-05-29,3호선,잠원,6204,5937,12141
6511,2020-05-29,3호선,고속터미널,42526,45925,88451
6512,2020-05-29,3호선,교대,15001,10018,25019
6513,2020-05-29,3호선,남부터미널,30953,31648,62601
6514,2020-05-29,3호선,양재,41404,43490,84894
6515,2020-05-29,3호선,매봉,11724,11246,22970
6516,2020-05-29,3호선,도곡,5624,5502,11126
6517,2020-05-29,3호선,대치,10701,10714,21415
6518,2020-05-29,3호선,학여울,1825,1779,3604
6519,2020-05-29,3호선,대청,10345,9438,19783
6520,2020-05-29,3호선,일원,9297,8812,18109
6521,2020-05-29,3호선,수서,18126,18560,36686
6522,2020-05-29,3호선,가락시장,9555,9531,19086
6523,2020-05-29,3호선,경찰병원,7649,7483,15132
6524,2020-05-29,3호선,오금,6551,5747,12298
6525,2020-05-29,3호선,원흥,9102,8321,17423
6526,2020-05-29,3호선,삼송,17677,16767,34444
6527,2020-05-29,3호선,원당,11366,10791,22157
6528,2020-05-29,3호선,화정,17411,18061,35472
6529,2020-05-29,3호선,대곡,1862,1435,3297
6530,2020-05-29,3호선,백석,10121,10203,20324
6531,2020-05-29,3호선,마두,7624,7786,15410
6532,2020-05-29,3호선,정발산,7422,8055,15477
6533,2020-05-29,3호선,주엽,8710,8860,17570
6534,2020-05-29,3호선,대화,13514,10538,24052
6535,2020-05-30,3호선,지축,2153,2030,4183
6536,2020-05-30,3호선,구파발,15173,15278,30451
6537,2020-05-30,3호선,연신내,29465,27612,57077
6538,2020-05-30,3호선,불광,12367,13884,26251
6539,2020-05-30,3호선,녹번,8798,7482,16280
6540,2020-05-30,3호선,홍제,12726,11591,24317
6541,2020-05-30,3호선,무악재,2496,2701,5197
6542,2020-05-30,3호선,독립문,5314,5703,11017
6543,2020-05-30,3호선,경복궁,11820,12415,24235
6544,2020-05-30,3호선,안국,10884,12862,23746
6545,2020-05-30,3호선,종로3가,4698,6647,11345
6546,2020-05-30,3호선,을지로3가,4301,5233,9534
6547,2020-05-30,3호선,동대입구,5231,5722,10953
6548,2020-05-30,3호선,약수,8503,7947,16450
6549,2020-05-30,3호선,금호,5553,4944,10497
6550,2020-05-30,3호선,옥수,6866,6792,13658
6551,2020-05-30,3호선,압구정,21865,23435,45300
6552,2020-05-30,3호선,신사,22595,24456,47051
6553,2020-05-30,3호선,잠원,4092,3896,7988
6554,2020-05-30,3호선,고속터미널,42506,43237,85743
6555,2020-05-30,3호선,교대,6617,4031,10648
6556,2020-05-30,3호선,남부터미널,18401,18590,36991
6557,2020-05-30,3호선,양재,20169,21928,42097
6558,2020-05-30,3호선,매봉,5095,4768,9863
6559,2020-05-30,3호선,도곡,3034,3053,6087
6560,2020-05-30,3호선,대치,7620,6915,14535
6561,2020-05-30,3호선,학여울,1356,1370,2726
6562,2020-05-30,3호선,대청,5426,4907,10333
6563,2020-05-30,3호선,일원,4358,4193,8551
6564,2020-05-30,3호선,수서,11276,11368,22644
6565,2020-05-30,3호선,가락시장,5892,5718,11610
6566,2020-05-30,3호선,경찰병원,3569,3395,6964
6567,2020-05-30,3호선,오금,3594,3380,6974
6568,2020-05-30,3호선,원흥,5850,5498,11348
6569,2020-05-30,3호선,삼송,11860,11361,23221
6570,2020-05-30,3호선,원당,7965,7566,15531
6571,2020-05-30,3호선,화정,12216,12693,24909
6572,2020-05-30,3호선,대곡,1230,1106,2336
6573,2020-05-30,3호선,백석,7212,7184,14396
6574,2020-05-30,3호선,마두,4615,4558,9173
6575,2020-05-30,3호선,정발산,6042,6652,12694
6576,2020-05-30,3호선,주엽,5916,5962,11878
6577,2020-05-30,3호선,대화,8305,7184,15489
6578,2020-05-31,3호선,대화,5651,5135,10786
6579,2020-05-31,3호선,주엽,3838,3765,7603
6580,2020-05-31,3호선,정발산,4742,4716,9458
6581,2020-05-31,3호선,마두,3022,3001,6023
6582,2020-05-31,3호선,백석,5017,4957,9974
6583,2020-05-31,3호선,대곡,936,810,1746
6584,2020-05-31,3호선,화정,8659,8817,17476
6585,2020-05-31,3호선,원당,5742,5507,11249
6586,2020-05-31,3호선,삼송,8597,8166,16763
6587,2020-05-31,3호선,원흥,4064,3941,8005
6588,2020-05-31,3호선,오금,2488,2442,4930
6589,2020-05-31,3호선,경찰병원,2407,2557,4964
6590,2020-05-31,3호선,가락시장,3403,3587,6990
6591,2020-05-31,3호선,수서,8940,8463,17403
6592,2020-05-31,3호선,일원,2610,2727,5337
6593,2020-05-31,3호선,대청,3451,3310,6761
6594,2020-05-31,3호선,학여울,866,1012,1878
6595,2020-05-31,3호선,대치,4633,4091,8724
6596,2020-05-31,3호선,도곡,1699,1748,3447
6597,2020-05-31,3호선,매봉,3297,3199,6496
6598,2020-05-31,3호선,양재,11733,13743,25476
6599,2020-05-31,3호선,남부터미널,12463,12928,25391
6600,2020-05-31,3호선,교대,3811,2496,6307
6601,2020-05-31,3호선,고속터미널,34080,31763,65843
6602,2020-05-31,3호선,잠원,2486,2584,5070
6603,2020-05-31,3호선,신사,12386,12705,25091
6604,2020-05-31,3호선,압구정,11586,12314,23900
6605,2020-05-31,3호선,옥수,4489,4671,9160
6606,2020-05-31,3호선,금호,3743,3694,7437
6607,2020-05-31,3호선,약수,5844,5778,11622
6608,2020-05-31,3호선,동대입구,3858,4202,8060
6609,2020-05-31,3호선,충무로,1,0,1
6610,2020-05-31,3호선,을지로3가,2268,2403,4671
6611,2020-05-31,3호선,종로3가,2772,3893,6665
6612,2020-05-31,3호선,안국,6481,7552,14033
6613,2020-05-31,3호선,경복궁,8096,8448,16544
6614,2020-05-31,3호선,독립문,3904,4052,7956
6615,2020-05-31,3호선,무악재,1632,1738,3370
6616,2020-05-31,3호선,홍제,8455,8001,16456
6617,2020-05-31,3호선,녹번,5641,5130,10771
6618,2020-05-31,3호선,불광,8738,10289,19027
6619,2020-05-31,3호선,연신내,20448,19182,39630
6620,2020-05-31,3호선,구파발,10421,10875,21296
6621,2020-05-31,3호선,지축,1476,1375,2851
6622,2020-06-01,3호선,불광,15920,17131,33051
6623,2020-06-01,3호선,연신내,37604,35416,73020
6624,2020-06-01,3호선,구파발,20615,19107,39722
6625,2020-06-01,3호선,지축,3385,3350,6735
6626,2020-06-01,3호선,오금,6320,5624,11944
6627,2020-06-01,3호선,경찰병원,7578,7639,15217
6628,2020-06-01,3호선,가락시장,8974,8735,17709
6629,2020-06-01,3호선,수서,15743,15966,31709
6630,2020-06-01,3호선,일원,9238,8956,18194
6631,2020-06-01,3호선,대청,9742,8896,18638
6632,2020-06-01,3호선,학여울,1722,1754,3476
6633,2020-06-01,3호선,대치,10204,10284,20488
6634,2020-06-01,3호선,도곡,5326,5297,10623
6635,2020-06-01,3호선,매봉,11608,11142,22750
6636,2020-06-01,3호선,양재,37084,40557,77641
6637,2020-06-01,3호선,남부터미널,27549,28524,56073
6638,2020-06-01,3호선,교대,13806,9403,23209
6639,2020-06-01,3호선,고속터미널,35929,33536,69465
6640,2020-06-01,3호선,잠원,5770,5607,11377
6641,2020-06-01,3호선,신사,28027,30205,58232
6642,2020-06-01,3호선,압구정,29323,31659,60982
6643,2020-06-01,3호선,옥수,8825,9197,18022
6644,2020-06-01,3호선,금호,8050,7498,15548
6645,2020-06-01,3호선,약수,12727,12642,25369
6646,2020-06-01,3호선,동대입구,7010,7537,14547
6647,2020-06-01,3호선,을지로3가,10516,11055,21571
6648,2020-06-01,3호선,종로3가,9599,11010,20609
6649,2020-06-01,3호선,안국,18534,19011,37545
6650,2020-06-01,3호선,경복궁,17059,16784,33843
6651,2020-06-01,3호선,독립문,6985,7183,14168
6652,2020-06-01,3호선,무악재,3839,3925,7764
6653,2020-06-01,3호선,홍제,17493,16640,34133
6654,2020-06-01,3호선,녹번,13782,12420,26202
6655,2020-06-01,3호선,대화,13325,10199,23524
6656,2020-06-01,3호선,주엽,8561,8587,17148
6657,2020-06-01,3호선,정발산,6879,7060,13939
6658,2020-06-01,3호선,마두,7356,7618,14974
6659,2020-06-01,3호선,백석,9690,9663,19353
6660,2020-06-01,3호선,대곡,1826,1351,3177
6661,2020-06-01,3호선,화정,16952,17267,34219
6662,2020-06-01,3호선,원당,11194,10668,21862
6663,2020-06-01,3호선,삼송,17426,16915,34341
6664,2020-06-01,3호선,원흥,8843,8318,17161
6665,2020-06-02,3호선,불광,15601,16565,32166
6666,2020-06-02,3호선,연신내,36803,34857,71660
6667,2020-06-02,3호선,구파발,20160,18851,39011
6668,2020-06-02,3호선,지축,3364,3251,6615
6669,2020-06-02,3호선,대화,12783,9781,22564
6670,2020-06-02,3호선,주엽,7945,8106,16051
6671,2020-06-02,3호선,정발산,6344,6465,12809
6672,2020-06-02,3호선,마두,6863,7126,13989
6673,2020-06-02,3호선,백석,9190,9262,18452
6674,2020-06-02,3호선,대곡,1817,1369,3186
6675,2020-06-02,3호선,화정,15871,16599,32470
6676,2020-06-02,3호선,원당,10619,10209,20828
6677,2020-06-02,3호선,삼송,16589,16084,32673
6678,2020-06-02,3호선,원흥,8573,8041,16614
6679,2020-06-02,3호선,녹번,13489,12258,25747
6680,2020-06-02,3호선,오금,6284,5561,11845
6681,2020-06-02,3호선,경찰병원,7512,7374,14886
6682,2020-06-02,3호선,가락시장,8795,8702,17497
6683,2020-06-02,3호선,수서,15361,15630,30991
6684,2020-06-02,3호선,일원,9001,8929,17930
6685,2020-06-02,3호선,대청,9511,8657,18168
6686,2020-06-02,3호선,학여울,1714,1772,3486
6687,2020-06-02,3호선,대치,9938,9926,19864
6688,2020-06-02,3호선,도곡,5255,5262,10517
6689,2020-06-02,3호선,매봉,11511,11031,22542
6690,2020-06-02,3호선,양재,38011,41077,79088
6691,2020-06-02,3호선,남부터미널,26706,27585,54291
6692,2020-06-02,3호선,교대,13824,9355,23179
6693,2020-06-02,3호선,고속터미널,32905,31869,64774
6694,2020-06-02,3호선,잠원,5635,5504,11139
6695,2020-06-02,3호선,신사,27968,29946,57914
6696,2020-06-02,3호선,압구정,29622,31723,61345
6697,2020-06-02,3호선,옥수,8535,8955,17490
6698,2020-06-02,3호선,금호,7888,7400,15288
6699,2020-06-02,3호선,약수,12364,12294,24658
6700,2020-06-02,3호선,동대입구,6948,7241,14189
6701,2020-06-02,3호선,충무로,1,0,1
6702,2020-06-02,3호선,을지로3가,10273,10815,21088
6703,2020-06-02,3호선,종로3가,9627,11106,20733
6704,2020-06-02,3호선,안국,18290,18800,37090
6705,2020-06-02,3호선,경복궁,17095,16704,33799
6706,2020-06-02,3호선,독립문,6762,7047,13809
6707,2020-06-02,3호선,무악재,3738,3808,7546
6708,2020-06-02,3호선,홍제,16872,16031,32903
6709,2020-06-03,3호선,구파발,21011,19504,40515
6710,2020-06-03,3호선,연신내,38101,35903,74004
6711,2020-06-03,3호선,불광,16472,17800,34272
6712,2020-06-03,3호선,녹번,14069,12656,26725
6713,2020-06-03,3호선,홍제,17473,16487,33960
6714,2020-06-03,3호선,무악재,3812,3920,7732
6715,2020-06-03,3호선,독립문,7129,7527,14656
6716,2020-06-03,3호선,경복궁,18347,18117,36464
6717,2020-06-03,3호선,안국,19387,19873,39260
6718,2020-06-03,3호선,종로3가,9818,11820,21638
6719,2020-06-03,3호선,지축,3528,3390,6918
6720,2020-06-03,3호선,대화,13253,10303,23556
6721,2020-06-03,3호선,주엽,8605,8735,17340
6722,2020-06-03,3호선,정발산,7058,7411,14469
6723,2020-06-03,3호선,마두,7606,7906,15512
6724,2020-06-03,3호선,백석,9940,9851,19791
6725,2020-06-03,3호선,대곡,1960,1441,3401
6726,2020-06-03,3호선,화정,17283,17779,35062
6727,2020-06-03,3호선,원당,11247,10551,21798
6728,2020-06-03,3호선,삼송,17472,17067,34539
6729,2020-06-03,3호선,원흥,9106,8438,17544
6730,2020-06-03,3호선,을지로3가,10667,11348,22015
6731,2020-06-03,3호선,충무로,1,0,1
6732,2020-06-03,3호선,동대입구,7052,7474,14526
6733,2020-06-03,3호선,약수,12796,12650,25446
6734,2020-06-03,3호선,금호,8163,7531,15694
6735,2020-06-03,3호선,옥수,9256,9463,18719
6736,2020-06-03,3호선,압구정,29947,32248,62195
6737,2020-06-03,3호선,신사,29318,31479,60797
6738,2020-06-03,3호선,잠원,5938,5594,11532
6739,2020-06-03,3호선,고속터미널,35381,34229,69610
6740,2020-06-03,3호선,교대,14339,9553,23892
6741,2020-06-03,3호선,남부터미널,27950,28725,56675
6742,2020-06-03,3호선,양재,38181,41647,79828
6743,2020-06-03,3호선,매봉,11747,11221,22968
6744,2020-06-03,3호선,도곡,5376,5436,10812
6745,2020-06-03,3호선,대치,10104,10179,20283
6746,2020-06-03,3호선,학여울,1698,1718,3416
6747,2020-06-03,3호선,대청,9875,8996,18871
6748,2020-06-03,3호선,일원,9123,8944,18067
6749,2020-06-03,3호선,수서,15801,15829,31630
6750,2020-06-03,3호선,가락시장,9215,9080,18295
6751,2020-06-03,3호선,경찰병원,7678,7614,15292
6752,2020-06-03,3호선,오금,6306,5717,12023
6753,2020-06-04,3호선,원당,11225,10604,21829
6754,2020-06-04,3호선,지축,3420,3262,6682
6755,2020-06-04,3호선,구파발,20851,19638,40489
6756,2020-06-04,3호선,연신내,38288,35811,74099
6757,2020-06-04,3호선,불광,16108,17137,33245
6758,2020-06-04,3호선,녹번,13850,12316,26166
6759,2020-06-04,3호선,홍제,17302,16406,33708
6760,2020-06-04,3호선,무악재,3818,3809,7627
6761,2020-06-04,3호선,독립문,7127,7419,14546
6762,2020-06-04,3호선,경복궁,18171,18093,36264
6763,2020-06-04,3호선,안국,19012,19593,38605
6764,2020-06-04,3호선,종로3가,9852,11536,21388
6765,2020-06-04,3호선,을지로3가,10480,11245,21725
6766,2020-06-04,3호선,동대입구,7394,7833,15227
6767,2020-06-04,3호선,약수,12856,12698,25554
6768,2020-06-04,3호선,금호,8253,7598,15851
6769,2020-06-04,3호선,옥수,9168,9262,18430
6770,2020-06-04,3호선,압구정,30089,32602,62691
6771,2020-06-04,3호선,신사,29457,31980,61437
6772,2020-06-04,3호선,잠원,5714,5549,11263
6773,2020-06-04,3호선,고속터미널,36147,35581,71728
6774,2020-06-04,3호선,교대,14643,9884,24527
6775,2020-06-04,3호선,남부터미널,27892,28646,56538
6776,2020-06-04,3호선,양재,38721,42074,80795
6777,2020-06-04,3호선,매봉,11671,11278,22949
6778,2020-06-04,3호선,도곡,5330,5293,10623
6779,2020-06-04,3호선,대치,10395,10204,20599
6780,2020-06-04,3호선,학여울,3526,3637,7163
6781,2020-06-04,3호선,대청,9791,8762,18553
6782,2020-06-04,3호선,일원,9423,9229,18652
6783,2020-06-04,3호선,수서,16059,16408,32467
6784,2020-06-04,3호선,가락시장,9189,9091,18280
6785,2020-06-04,3호선,경찰병원,7660,7608,15268
6786,2020-06-04,3호선,오금,6336,5679,12015
6787,2020-06-04,3호선,원흥,8857,8230,17087
6788,2020-06-04,3호선,삼송,17590,16868,34458
6789,2020-06-04,3호선,화정,16561,17247,33808
6790,2020-06-04,3호선,대곡,1844,1435,3279
6791,2020-06-04,3호선,백석,9777,9741,19518
6792,2020-06-04,3호선,마두,7354,7665,15019
6793,2020-06-04,3호선,정발산,6903,7313,14216
6794,2020-06-04,3호선,주엽,8388,8555,16943
6795,2020-06-04,3호선,대화,13189,10147,23336
6796,2020-06-05,3호선,오금,6489,5757,12246
6797,2020-06-05,3호선,경찰병원,7696,7682,15378
6798,2020-06-05,3호선,가락시장,9681,9479,19160
6799,2020-06-05,3호선,수서,18034,18327,36361
6800,2020-06-05,3호선,일원,9528,9094,18622
6801,2020-06-05,3호선,대청,10103,9181,19284
6802,2020-06-05,3호선,학여울,3533,3628,7161
6803,2020-06-05,3호선,대치,10656,10519,21175
6804,2020-06-05,3호선,도곡,5574,5576,11150
6805,2020-06-05,3호선,매봉,11970,11435,23405
6806,2020-06-05,3호선,양재,40790,42750,83540
6807,2020-06-05,3호선,남부터미널,30622,31770,62392
6808,2020-06-05,3호선,교대,15061,9950,25011
6809,2020-06-05,3호선,고속터미널,43746,48402,92148
6810,2020-06-05,3호선,잠원,6190,5783,11973
6811,2020-06-05,3호선,신사,31437,35656,67093
6812,2020-06-05,3호선,압구정,31870,34861,66731
6813,2020-06-05,3호선,옥수,9484,9578,19062
6814,2020-06-05,3호선,금호,8566,7536,16102
6815,2020-06-05,3호선,약수,13276,12872,26148
6816,2020-06-05,3호선,동대입구,7115,7388,14503
6817,2020-06-05,3호선,을지로3가,10318,11566,21884
6818,2020-06-05,3호선,종로3가,9727,11958,21685
6819,2020-06-05,3호선,안국,19236,19857,39093
6820,2020-06-05,3호선,경복궁,18960,18922,37882
6821,2020-06-05,3호선,독립문,7276,7464,14740
6822,2020-06-05,3호선,무악재,3858,3849,7707
6823,2020-06-05,3호선,홍제,17945,16537,34482
6824,2020-06-05,3호선,녹번,14214,12293,26507
6825,2020-06-05,3호선,불광,16543,17565,34108
6826,2020-06-05,3호선,연신내,39348,37246,76594
6827,2020-06-05,3호선,구파발,21350,19521,40871
6828,2020-06-05,3호선,지축,3539,3279,6818
6829,2020-06-05,3호선,대화,14286,11310,25596
6830,2020-06-05,3호선,주엽,8941,9118,18059
6831,2020-06-05,3호선,정발산,7452,8191,15643
6832,2020-06-05,3호선,마두,7643,7806,15449
6833,2020-06-05,3호선,백석,10481,10574,21055
6834,2020-06-05,3호선,대곡,1930,1502,3432
6835,2020-06-05,3호선,화정,17392,18127,35519
6836,2020-06-05,3호선,원당,11429,10637,22066
6837,2020-06-05,3호선,삼송,17818,17100,34918
6838,2020-06-05,3호선,원흥,8979,8191,17170
6839,2020-06-06,3호선,대화,8071,7136,15207
6840,2020-06-06,3호선,주엽,5184,5133,10317
6841,2020-06-06,3호선,정발산,5500,6079,11579
6842,2020-06-06,3호선,마두,4163,4160,8323
6843,2020-06-06,3호선,백석,6458,6610,13068
6844,2020-06-06,3호선,대곡,1075,945,2020
6845,2020-06-06,3호선,화정,11106,11400,22506
6846,2020-06-06,3호선,원당,7252,6869,14121
6847,2020-06-06,3호선,삼송,11700,10998,22698
6848,2020-06-06,3호선,원흥,5336,4991,10327
6849,2020-06-06,3호선,오금,3285,2870,6155
6850,2020-06-06,3호선,경찰병원,3208,3072,6280
6851,2020-06-06,3호선,가락시장,5547,5229,10776
6852,2020-06-06,3호선,수서,10430,10968,21398
6853,2020-06-06,3호선,일원,3564,3500,7064
6854,2020-06-06,3호선,대청,4995,4574,9569
6855,2020-06-06,3호선,학여울,2697,2821,5518
6856,2020-06-06,3호선,대치,6488,5702,12190
6857,2020-06-06,3호선,도곡,2703,2596,5299
6858,2020-06-06,3호선,매봉,4555,4383,8938
6859,2020-06-06,3호선,양재,17351,18466,35817
6860,2020-06-06,3호선,남부터미널,16664,16605,33269
6861,2020-06-06,3호선,교대,5741,3553,9294
6862,2020-06-06,3호선,고속터미널,41002,42035,83037
6863,2020-06-06,3호선,잠원,3463,3364,6827
6864,2020-06-06,3호선,신사,17539,19672,37211
6865,2020-06-06,3호선,압구정,15701,16557,32258
6866,2020-06-06,3호선,옥수,6058,6088,12146
6867,2020-06-06,3호선,금호,5073,4496,9569
6868,2020-06-06,3호선,약수,7525,6984,14509
6869,2020-06-06,3호선,동대입구,4999,5808,10807
6870,2020-06-06,3호선,충무로,1,0,1
6871,2020-06-06,3호선,을지로3가,3868,4639,8507
6872,2020-06-06,3호선,종로3가,3898,6189,10087
6873,2020-06-06,3호선,안국,9434,11267,20701
6874,2020-06-06,3호선,경복궁,11076,12297,23373
6875,2020-06-06,3호선,독립문,4999,5331,10330
6876,2020-06-06,3호선,무악재,2249,2263,4512
6877,2020-06-06,3호선,홍제,11377,10540,21917
6878,2020-06-06,3호선,녹번,7898,6750,14648
6879,2020-06-06,3호선,불광,11081,12883,23964
6880,2020-06-06,3호선,연신내,26536,24525,51061
6881,2020-06-06,3호선,구파발,13356,13536,26892
6882,2020-06-06,3호선,지축,2084,1908,3992
6883,2020-06-07,3호선,지축,1568,1469,3037
6884,2020-06-07,3호선,구파발,10702,10978,21680
6885,2020-06-07,3호선,연신내,20384,19134,39518
6886,2020-06-07,3호선,불광,8732,10526,19258
6887,2020-06-07,3호선,녹번,5662,5023,10685
6888,2020-06-07,3호선,홍제,8460,7893,16353
6889,2020-06-07,3호선,무악재,1555,1736,3291
6890,2020-06-07,3호선,독립문,3761,4225,7986
6891,2020-06-07,3호선,경복궁,7868,8434,16302
6892,2020-06-07,3호선,안국,6529,7474,14003
6893,2020-06-07,3호선,종로3가,2554,3636,6190
6894,2020-06-07,3호선,을지로3가,2274,2434,4708
6895,2020-06-07,3호선,동대입구,3991,4419,8410
6896,2020-06-07,3호선,약수,5835,5625,11460
6897,2020-06-07,3호선,금호,3813,3733,7546
6898,2020-06-07,3호선,오금,2700,2666,5366
6899,2020-06-07,3호선,경찰병원,2366,2536,4902
6900,2020-06-07,3호선,옥수,4489,4774,9263
6901,2020-06-07,3호선,압구정,11395,12072,23467
6902,2020-06-07,3호선,신사,11967,12785,24752
6903,2020-06-07,3호선,잠원,2632,2797,5429
6904,2020-06-07,3호선,고속터미널,36379,33139,69518
6905,2020-06-07,3호선,교대,3704,2274,5978
6906,2020-06-07,3호선,남부터미널,12566,12757,25323
6907,2020-06-07,3호선,양재,12197,14433,26630
6908,2020-06-07,3호선,매봉,3400,3411,6811
6909,2020-06-07,3호선,도곡,1714,1795,3509
6910,2020-06-07,3호선,대치,4380,3961,8341
6911,2020-06-07,3호선,학여울,1971,2063,4034
6912,2020-06-07,3호선,대청,3405,3307,6712
6913,2020-06-07,3호선,일원,2735,2798,5533
6914,2020-06-07,3호선,수서,9290,8663,17953
6915,2020-06-07,3호선,가락시장,3563,3684,7247
6916,2020-06-07,3호선,대화,6033,5516,11549
6917,2020-06-07,3호선,주엽,3913,4014,7927
6918,2020-06-07,3호선,정발산,4850,4852,9702
6919,2020-06-07,3호선,마두,3097,3046,6143
6920,2020-06-07,3호선,백석,5281,5109,10390
6921,2020-06-07,3호선,대곡,941,789,1730
6922,2020-06-07,3호선,화정,8661,8097,16758
6923,2020-06-07,3호선,원당,5559,5295,10854
6924,2020-06-07,3호선,삼송,8719,8483,17202
6925,2020-06-07,3호선,원흥,4083,3902,7985
6926,2020-06-08,3호선,지축,3423,3336,6759
6927,2020-06-08,3호선,구파발,20627,19296,39923
6928,2020-06-08,3호선,연신내,37621,35438,73059
6929,2020-06-08,3호선,불광,16254,17035,33289
6930,2020-06-08,3호선,녹번,13830,12461,26291
6931,2020-06-08,3호선,홍제,17305,16556,33861
6932,2020-06-08,3호선,무악재,3743,3853,7596
6933,2020-06-08,3호선,독립문,6863,7089,13952
6934,2020-06-08,3호선,경복궁,17031,16940,33971
6935,2020-06-08,3호선,안국,18802,19304,38106
6936,2020-06-08,3호선,종로3가,9610,11296,20906
6937,2020-06-08,3호선,을지로3가,10324,10980,21304
6938,2020-06-08,3호선,충무로,2,0,2
6939,2020-06-08,3호선,동대입구,7032,7358,14390
6940,2020-06-08,3호선,약수,12729,12606,25335
6941,2020-06-08,3호선,금호,7933,7337,15270
6942,2020-06-08,3호선,옥수,8776,8978,17754
6943,2020-06-08,3호선,압구정,30119,32398,62517
6944,2020-06-08,3호선,신사,28292,30162,58454
6945,2020-06-08,3호선,잠원,5779,5678,11457
6946,2020-06-08,3호선,고속터미널,36292,34399,70691
6947,2020-06-08,3호선,교대,14133,9416,23549
6948,2020-06-08,3호선,남부터미널,28013,28738,56751
6949,2020-06-08,3호선,양재,37270,40770,78040
6950,2020-06-08,3호선,매봉,11717,11172,22889
6951,2020-06-08,3호선,도곡,5406,5459,10865
6952,2020-06-08,3호선,대치,10099,10027,20126
6953,2020-06-08,3호선,학여울,1675,1799,3474
6954,2020-06-08,3호선,대청,9923,9138,19061
6955,2020-06-08,3호선,일원,9320,9183,18503
6956,2020-06-08,3호선,수서,15737,15941,31678
6957,2020-06-08,3호선,가락시장,9007,8842,17849
6958,2020-06-08,3호선,경찰병원,7811,7759,15570
6959,2020-06-08,3호선,오금,6382,5529,11911
6960,2020-06-08,3호선,대화,13361,10106,23467
6961,2020-06-08,3호선,주엽,8494,8688,17182
6962,2020-06-08,3호선,정발산,6671,6917,13588
6963,2020-06-08,3호선,마두,7310,7602,14912
6964,2020-06-08,3호선,백석,9741,9713,19454
6965,2020-06-08,3호선,대곡,1864,1434,3298
6966,2020-06-08,3호선,화정,16625,15750,32375
6967,2020-06-08,3호선,원당,11022,10445,21467
6968,2020-06-08,3호선,삼송,17245,16730,33975
6969,2020-06-08,3호선,원흥,8779,8273,17052
6970,2020-06-09,3호선,오금,6408,5610,12018
6971,2020-06-09,3호선,경찰병원,7711,7745,15456
6972,2020-06-09,3호선,가락시장,9127,8878,18005
6973,2020-06-09,3호선,수서,15902,15872,31774
6974,2020-06-09,3호선,일원,9353,9109,18462
6975,2020-06-09,3호선,대청,10025,9105,19130
6976,2020-06-09,3호선,학여울,1747,1800,3547
6977,2020-06-09,3호선,대치,10105,10114,20219
6978,2020-06-09,3호선,도곡,5356,5469,10825
6979,2020-06-09,3호선,매봉,11917,11362,23279
6980,2020-06-09,3호선,양재,38598,41637,80235
6981,2020-06-09,3호선,남부터미널,27814,28522,56336
6982,2020-06-09,3호선,교대,14455,9696,24151
6983,2020-06-09,3호선,고속터미널,35807,34552,70359
6984,2020-06-09,3호선,잠원,5843,5571,11414
6985,2020-06-09,3호선,신사,29073,31375,60448
6986,2020-06-09,3호선,압구정,30690,33066,63756
6987,2020-06-09,3호선,옥수,9024,9255,18279
6988,2020-06-09,3호선,금호,8038,7382,15420
6989,2020-06-09,3호선,약수,12962,12636,25598
6990,2020-06-09,3호선,동대입구,7091,7402,14493
6991,2020-06-09,3호선,충무로,1,0,1
6992,2020-06-09,3호선,을지로3가,10686,11209,21895
6993,2020-06-09,3호선,종로3가,9938,11465,21403
6994,2020-06-09,3호선,안국,19141,19796,38937
6995,2020-06-09,3호선,경복궁,17948,17683,35631
6996,2020-06-09,3호선,독립문,7038,7245,14283
6997,2020-06-09,3호선,무악재,3831,3898,7729
6998,2020-06-09,3호선,홍제,17524,16512,34036
6999,2020-06-09,3호선,녹번,13992,12558,26550
7000,2020-06-09,3호선,불광,15894,17246,33140
7001,2020-06-09,3호선,연신내,37705,35346,73051
7002,2020-06-09,3호선,구파발,21040,19483,40523
7003,2020-06-09,3호선,지축,3337,3218,6555
7004,2020-06-09,3호선,대화,13131,10066,23197
7005,2020-06-09,3호선,주엽,8603,8846,17449
7006,2020-06-09,3호선,정발산,6796,6875,13671
7007,2020-06-09,3호선,마두,7370,7634,15004
7008,2020-06-09,3호선,백석,9868,9807,19675
7009,2020-06-09,3호선,대곡,1828,1362,3190
7010,2020-06-09,3호선,화정,16593,15714,32307
7011,2020-06-09,3호선,원당,10946,10469,21415
7012,2020-06-09,3호선,삼송,17228,16845,34073
7013,2020-06-09,3호선,원흥,8762,8291,17053
7014,2020-06-10,3호선,오금,6496,5691,12187
7015,2020-06-10,3호선,경찰병원,7865,7831,15696
7016,2020-06-10,3호선,가락시장,9264,9079,18343
7017,2020-06-10,3호선,수서,16116,16156,32272
7018,2020-06-10,3호선,일원,9339,9206,18545
7019,2020-06-10,3호선,대청,10074,9157,19231
7020,2020-06-10,3호선,학여울,1717,1747,3464
7021,2020-06-10,3호선,대치,10193,10335,20528
7022,2020-06-10,3호선,도곡,5338,5444,10782
7023,2020-06-10,3호선,매봉,11935,11382,23317
7024,2020-06-10,3호선,양재,39179,42001,81180
7025,2020-06-10,3호선,남부터미널,28197,28962,57159
7026,2020-06-10,3호선,교대,14610,9556,24166
7027,2020-06-10,3호선,고속터미널,36188,34629,70817
7028,2020-06-10,3호선,잠원,5717,5775,11492
7029,2020-06-10,3호선,신사,29140,30998,60138
7030,2020-06-10,3호선,압구정,30097,32332,62429
7031,2020-06-10,3호선,옥수,8905,9323,18228
7032,2020-06-10,3호선,금호,8050,7537,15587
7033,2020-06-10,3호선,약수,12831,12950,25781
7034,2020-06-10,3호선,동대입구,7288,7529,14817
7035,2020-06-10,3호선,충무로,1,0,1
7036,2020-06-10,3호선,을지로3가,11041,11173,22214
7037,2020-06-10,3호선,종로3가,10221,11483,21704
7038,2020-06-10,3호선,안국,19455,19593,39048
7039,2020-06-10,3호선,경복궁,18426,17959,36385
7040,2020-06-10,3호선,독립문,6834,7291,14125
7041,2020-06-10,3호선,무악재,3778,3937,7715
7042,2020-06-10,3호선,홍제,17377,16687,34064
7043,2020-06-10,3호선,녹번,14121,12698,26819
7044,2020-06-10,3호선,불광,16085,17245,33330
7045,2020-06-10,3호선,연신내,38085,35835,73920
7046,2020-06-10,3호선,구파발,20980,19791,40771
7047,2020-06-10,3호선,지축,3407,3389,6796
7048,2020-06-10,3호선,원흥,8873,8343,17216
7049,2020-06-10,3호선,삼송,16959,16536,33495
7050,2020-06-10,3호선,원당,10799,10384,21183
7051,2020-06-10,3호선,화정,16713,17482,34195
7052,2020-06-10,3호선,대곡,1870,1414,3284
7053,2020-06-10,3호선,백석,9493,9579,19072
7054,2020-06-10,3호선,마두,7566,7807,15373
7055,2020-06-10,3호선,정발산,6904,6900,13804
7056,2020-06-10,3호선,주엽,8761,8969,17730
7057,2020-06-10,3호선,대화,13092,10246,23338
7058,2020-06-11,3호선,대화,13005,10012,23017
7059,2020-06-11,3호선,주엽,8606,8700,17306
7060,2020-06-11,3호선,정발산,6761,7112,13873
7061,2020-06-11,3호선,마두,7531,7808,15339
7062,2020-06-11,3호선,백석,10017,10092,20109
7063,2020-06-11,3호선,대곡,1895,1453,3348
7064,2020-06-11,3호선,화정,16752,17374,34126
7065,2020-06-11,3호선,원당,10919,10381,21300
7066,2020-06-11,3호선,삼송,17317,16725,34042
7067,2020-06-11,3호선,원흥,9012,8444,17456
7068,2020-06-11,3호선,오금,6387,5642,12029
7069,2020-06-11,3호선,경찰병원,7728,7725,15453
7070,2020-06-11,3호선,가락시장,9379,9073,18452
7071,2020-06-11,3호선,수서,16298,16526,32824
7072,2020-06-11,3호선,일원,9588,9356,18944
7073,2020-06-11,3호선,대청,9981,9011,18992
7074,2020-06-11,3호선,학여울,2502,2670,5172
7075,2020-06-11,3호선,대치,10356,10230,20586
7076,2020-06-11,3호선,도곡,5398,5494,10892
7077,2020-06-11,3호선,매봉,11822,11363,23185
7078,2020-06-11,3호선,양재,38564,42196,80760
7079,2020-06-11,3호선,남부터미널,27996,28478,56474
7080,2020-06-11,3호선,교대,14684,9860,24544
7081,2020-06-11,3호선,고속터미널,36946,35753,72699
7082,2020-06-11,3호선,잠원,5796,5621,11417
7083,2020-06-11,3호선,신사,28999,31534,60533
7084,2020-06-11,3호선,압구정,29802,32373,62175
7085,2020-06-11,3호선,옥수,9097,9430,18527
7086,2020-06-11,3호선,금호,8068,7386,15454
7087,2020-06-11,3호선,약수,12984,12708,25692
7088,2020-06-11,3호선,동대입구,7302,7670,14972
7089,2020-06-11,3호선,을지로3가,10592,11292,21884
7090,2020-06-11,3호선,종로3가,9805,11558,21363
7091,2020-06-11,3호선,안국,18988,19761,38749
7092,2020-06-11,3호선,경복궁,18279,17987,36266
7093,2020-06-11,3호선,독립문,6946,7284,14230
7094,2020-06-11,3호선,무악재,3858,3884,7742
7095,2020-06-11,3호선,홍제,17184,16157,33341
7096,2020-06-11,3호선,녹번,13948,12391,26339
7097,2020-06-11,3호선,불광,16144,17064,33208
7098,2020-06-11,3호선,연신내,37817,35612,73429
7099,2020-06-11,3호선,구파발,20939,19681,40620
7100,2020-06-11,3호선,지축,3381,3182,6563
7101,2020-06-12,3호선,대화,13398,10575,23973
7102,2020-06-12,3호선,주엽,8835,8877,17712
7103,2020-06-12,3호선,정발산,7204,7962,15166
7104,2020-06-12,3호선,마두,7650,7921,15571
7105,2020-06-12,3호선,백석,10159,10380,20539
7106,2020-06-12,3호선,대곡,1842,1395,3237
7107,2020-06-12,3호선,화정,17378,17967,35345
7108,2020-06-12,3호선,원당,11360,10670,22030
7109,2020-06-12,3호선,삼송,17734,16781,34515
7110,2020-06-12,3호선,원흥,9135,8273,17408
7111,2020-06-12,3호선,오금,6453,5565,12018
7112,2020-06-12,3호선,경찰병원,7739,7477,15216
7113,2020-06-12,3호선,가락시장,9550,9273,18823
7114,2020-06-12,3호선,수서,17939,18251,36190
7115,2020-06-12,3호선,일원,9593,9022,18615
7116,2020-06-12,3호선,대청,10209,9160,19369
7117,2020-06-12,3호선,학여울,2442,2536,4978
7118,2020-06-12,3호선,대치,10577,10437,21014
7119,2020-06-12,3호선,도곡,5575,5575,11150
7120,2020-06-12,3호선,매봉,11837,11410,23247
7121,2020-06-12,3호선,양재,40689,42693,83382
7122,2020-06-12,3호선,남부터미널,30647,31250,61897
7123,2020-06-12,3호선,교대,14896,9762,24658
7124,2020-06-12,3호선,고속터미널,43756,46833,90589
7125,2020-06-12,3호선,잠원,6029,5723,11752
7126,2020-06-12,3호선,신사,30885,34860,65745
7127,2020-06-12,3호선,압구정,31907,34302,66209
7128,2020-06-12,3호선,옥수,9363,9507,18870
7129,2020-06-12,3호선,금호,8568,7696,16264
7130,2020-06-12,3호선,약수,13332,13132,26464
7131,2020-06-12,3호선,동대입구,7051,7572,14623
7132,2020-06-12,3호선,을지로3가,10679,11638,22317
7133,2020-06-12,3호선,종로3가,9565,11696,21261
7134,2020-06-12,3호선,안국,19231,19753,38984
7135,2020-06-12,3호선,경복궁,18786,18611,37397
7136,2020-06-12,3호선,독립문,7272,7463,14735
7137,2020-06-12,3호선,무악재,3867,3761,7628
7138,2020-06-12,3호선,홍제,17781,16492,34273
7139,2020-06-12,3호선,녹번,14266,12374,26640
7140,2020-06-12,3호선,불광,16541,17304,33845
7141,2020-06-12,3호선,연신내,39403,37087,76490
7142,2020-06-12,3호선,구파발,21096,19450,40546
7143,2020-06-12,3호선,지축,3542,3336,6878
7144,2020-06-13,3호선,원당,7684,7246,14930
7145,2020-06-13,3호선,화정,12094,12000,24094
7146,2020-06-13,3호선,대곡,1264,1101,2365
7147,2020-06-13,3호선,백석,7134,7323,14457
7148,2020-06-13,3호선,마두,4838,4749,9587
7149,2020-06-13,3호선,정발산,5647,6224,11871
7150,2020-06-13,3호선,주엽,6041,5929,11970
7151,2020-06-13,3호선,대화,8383,7241,15624
7152,2020-06-13,3호선,지축,2075,1958,4033
7153,2020-06-13,3호선,구파발,14538,14427,28965
7154,2020-06-13,3호선,연신내,28551,26826,55377
7155,2020-06-13,3호선,불광,11798,13327,25125
7156,2020-06-13,3호선,녹번,8821,7428,16249
7157,2020-06-13,3호선,홍제,12387,11298,23685
7158,2020-06-13,3호선,무악재,2475,2610,5085
7159,2020-06-13,3호선,독립문,5354,5449,10803
7160,2020-06-13,3호선,경복궁,10824,11235,22059
7161,2020-06-13,3호선,안국,10108,11784,21892
7162,2020-06-13,3호선,종로3가,4459,6839,11298
7163,2020-06-13,3호선,을지로3가,4389,5114,9503
7164,2020-06-13,3호선,충무로,1,0,1
7165,2020-06-13,3호선,동대입구,5577,5970,11547
7166,2020-06-13,3호선,약수,8725,8162,16887
7167,2020-06-13,3호선,금호,5617,5007,10624
7168,2020-06-13,3호선,옥수,6465,6576,13041
7169,2020-06-13,3호선,압구정,22547,23691,46238
7170,2020-06-13,3호선,신사,22277,24148,46425
7171,2020-06-13,3호선,잠원,3722,3557,7279
7172,2020-06-13,3호선,고속터미널,43888,44652,88540
7173,2020-06-13,3호선,교대,6779,4102,10881
7174,2020-06-13,3호선,남부터미널,18793,18812,37605
7175,2020-06-13,3호선,양재,19641,21235,40876
7176,2020-06-13,3호선,매봉,5241,5060,10301
7177,2020-06-13,3호선,도곡,3376,3481,6857
7178,2020-06-13,3호선,대치,7335,6619,13954
7179,2020-06-13,3호선,학여울,1562,1680,3242
7180,2020-06-13,3호선,대청,6319,5886,12205
7181,2020-06-13,3호선,일원,4709,4388,9097
7182,2020-06-13,3호선,수서,11166,11576,22742
7183,2020-06-13,3호선,가락시장,6041,5781,11822
7184,2020-06-13,3호선,경찰병원,3860,3763,7623
7185,2020-06-13,3호선,오금,3614,3351,6965
7186,2020-06-13,3호선,원흥,5793,5528,11321
7187,2020-06-13,3호선,삼송,11897,11376,23273
7188,2020-06-14,3호선,대화,5946,5338,11284
7189,2020-06-14,3호선,주엽,3886,3757,7643
7190,2020-06-14,3호선,정발산,4559,4643,9202
7191,2020-06-14,3호선,마두,3051,3070,6121
7192,2020-06-14,3호선,백석,5181,4970,10151
7193,2020-06-14,3호선,대곡,955,791,1746
7194,2020-06-14,3호선,화정,8415,8673,17088
7195,2020-06-14,3호선,원당,5509,5322,10831
7196,2020-06-14,3호선,삼송,8811,8434,17245
7197,2020-06-14,3호선,원흥,4096,3957,8053
7198,2020-06-14,3호선,오금,2698,2655,5353
7199,2020-06-14,3호선,경찰병원,2429,2528,4957
7200,2020-06-14,3호선,가락시장,3274,3543,6817
7201,2020-06-14,3호선,수서,8648,8398,17046
7202,2020-06-14,3호선,일원,2692,2953,5645
7203,2020-06-14,3호선,대청,4305,4175,8480
7204,2020-06-14,3호선,학여울,676,654,1330
7205,2020-06-14,3호선,대치,4396,3952,8348
7206,2020-06-14,3호선,도곡,1694,1727,3421
7207,2020-06-14,3호선,매봉,3360,3400,6760
7208,2020-06-14,3호선,양재,11750,13602,25352
7209,2020-06-14,3호선,남부터미널,12457,13111,25568
7210,2020-06-14,3호선,교대,3665,2386,6051
7211,2020-06-14,3호선,고속터미널,35638,33217,68855
7212,2020-06-14,3호선,잠원,2424,2433,4857
7213,2020-06-14,3호선,신사,11960,12555,24515
7214,2020-06-14,3호선,압구정,11670,12229,23899
7215,2020-06-14,3호선,옥수,4530,4832,9362
7216,2020-06-14,3호선,금호,3899,3660,7559
7217,2020-06-14,3호선,약수,5953,5765,11718
7218,2020-06-14,3호선,동대입구,4057,4498,8555
7219,2020-06-14,3호선,충무로,2,0,2
7220,2020-06-14,3호선,을지로3가,2265,2469,4734
7221,2020-06-14,3호선,종로3가,2970,4195,7165
7222,2020-06-14,3호선,안국,6417,7022,13439
7223,2020-06-14,3호선,경복궁,7792,8248,16040
7224,2020-06-14,3호선,독립문,3733,3981,7714
7225,2020-06-14,3호선,무악재,1664,1814,3478
7226,2020-06-14,3호선,홍제,8496,8050,16546
7227,2020-06-14,3호선,녹번,5831,5186,11017
7228,2020-06-14,3호선,불광,8700,10402,19102
7229,2020-06-14,3호선,연신내,20467,19076,39543
7230,2020-06-14,3호선,구파발,10072,10394,20466
7231,2020-06-14,3호선,지축,1543,1481,3024
7232,2020-06-15,3호선,대화,13559,10382,23941
7233,2020-06-15,3호선,주엽,8771,8849,17620
7234,2020-06-15,3호선,정발산,6914,7203,14117
7235,2020-06-15,3호선,마두,7529,7747,15276
7236,2020-06-15,3호선,백석,9893,10031,19924
7237,2020-06-15,3호선,대곡,1867,1405,3272
7238,2020-06-15,3호선,화정,16897,17176,34073
7239,2020-06-15,3호선,원당,11206,10636,21842
7240,2020-06-15,3호선,삼송,17660,17178,34838
7241,2020-06-15,3호선,원흥,9039,8485,17524
7242,2020-06-15,3호선,오금,6268,5525,11793
7243,2020-06-15,3호선,경찰병원,7746,7792,15538
7244,2020-06-15,3호선,가락시장,8896,8897,17793
7245,2020-06-15,3호선,수서,16066,16410,32476
7246,2020-06-15,3호선,일원,9533,9194,18727
7247,2020-06-15,3호선,대청,9828,9069,18897
7248,2020-06-15,3호선,학여울,1734,1789,3523
7249,2020-06-15,3호선,대치,10337,10228,20565
7250,2020-06-15,3호선,도곡,5514,5471,10985
7251,2020-06-15,3호선,매봉,11735,11297,23032
7252,2020-06-15,3호선,양재,37823,41392,79215
7253,2020-06-15,3호선,남부터미널,27753,28960,56713
7254,2020-06-15,3호선,교대,14125,9495,23620
7255,2020-06-15,3호선,고속터미널,36430,34549,70979
7256,2020-06-15,3호선,잠원,5874,5703,11577
7257,2020-06-15,3호선,신사,28233,30325,58558
7258,2020-06-15,3호선,압구정,30313,32572,62885
7259,2020-06-15,3호선,옥수,8963,9298,18261
7260,2020-06-15,3호선,금호,8031,7475,15506
7261,2020-06-15,3호선,약수,12985,12743,25728
7262,2020-06-15,3호선,동대입구,7067,7408,14475
7263,2020-06-15,3호선,충무로,2,0,2
7264,2020-06-15,3호선,을지로3가,10594,10995,21589
7265,2020-06-15,3호선,종로3가,9851,11600,21451
7266,2020-06-15,3호선,안국,18940,19422,38362
7267,2020-06-15,3호선,경복궁,17362,17309,34671
7268,2020-06-15,3호선,독립문,6971,7173,14144
7269,2020-06-15,3호선,무악재,3782,3846,7628
7270,2020-06-15,3호선,홍제,17504,16604,34108
7271,2020-06-15,3호선,녹번,14150,12603,26753
7272,2020-06-15,3호선,불광,16190,17254,33444
7273,2020-06-15,3호선,연신내,38047,35867,73914
7274,2020-06-15,3호선,구파발,20777,19308,40085
7275,2020-06-15,3호선,지축,3403,3331,6734
7276,2020-06-16,3호선,대화,13305,10263,23568
7277,2020-06-16,3호선,주엽,8631,8739,17370
7278,2020-06-16,3호선,정발산,6832,7144,13976
7279,2020-06-16,3호선,마두,7447,7710,15157
7280,2020-06-16,3호선,백석,9828,9921,19749
7281,2020-06-16,3호선,대곡,1877,1426,3303
7282,2020-06-16,3호선,화정,16929,17560,34489
7283,2020-06-16,3호선,원당,11223,10652,21875
7284,2020-06-16,3호선,삼송,17921,17283,35204
7285,2020-06-16,3호선,원흥,8975,8429,17404
7286,2020-06-16,3호선,지축,3440,3343,6783
7287,2020-06-16,3호선,구파발,21145,19720,40865
7288,2020-06-16,3호선,연신내,38429,35908,74337
7289,2020-06-16,3호선,불광,16342,17341,33683
7290,2020-06-16,3호선,녹번,14188,12752,26940
7291,2020-06-16,3호선,홍제,17567,16607,34174
7292,2020-06-16,3호선,무악재,3827,3911,7738
7293,2020-06-16,3호선,독립문,7173,7316,14489
7294,2020-06-16,3호선,경복궁,18118,17899,36017
7295,2020-06-16,3호선,안국,19170,19966,39136
7296,2020-06-16,3호선,종로3가,10115,11661,21776
7297,2020-06-16,3호선,을지로3가,10611,11190,21801
7298,2020-06-16,3호선,동대입구,7177,7538,14715
7299,2020-06-16,3호선,약수,13224,12799,26023
7300,2020-06-16,3호선,금호,8162,7544,15706
7301,2020-06-16,3호선,옥수,9213,9350,18563
7302,2020-06-16,3호선,압구정,30883,33186,64069
7303,2020-06-16,3호선,신사,29186,31553,60739
7304,2020-06-16,3호선,잠원,5829,5688,11517
7305,2020-06-16,3호선,고속터미널,36780,35458,72238
7306,2020-06-16,3호선,교대,14803,9812,24615
7307,2020-06-16,3호선,남부터미널,27671,28677,56348
7308,2020-06-16,3호선,양재,38719,42321,81040
7309,2020-06-16,3호선,매봉,11954,11606,23560
7310,2020-06-16,3호선,도곡,5422,5438,10860
7311,2020-06-16,3호선,대치,10086,10148,20234
7312,2020-06-16,3호선,학여울,1759,1810,3569
7313,2020-06-16,3호선,대청,9941,9022,18963
7314,2020-06-16,3호선,일원,9557,9210,18767
7315,2020-06-16,3호선,수서,16050,16197,32247
7316,2020-06-16,3호선,가락시장,9154,9035,18189
7317,2020-06-16,3호선,경찰병원,7744,7631,15375
7318,2020-06-16,3호선,오금,6423,5757,12180
7319,2020-06-17,3호선,교대,15017,9861,24878
7320,2020-06-17,3호선,남부터미널,28305,28994,57299
7321,2020-06-17,3호선,양재,39096,42416,81512
7322,2020-06-17,3호선,매봉,12173,11558,23731
7323,2020-06-17,3호선,도곡,5505,5565,11070
7324,2020-06-17,3호선,대치,10066,9998,20064
7325,2020-06-17,3호선,학여울,1764,1786,3550
7326,2020-06-17,3호선,대청,10089,9284,19373
7327,2020-06-17,3호선,일원,9512,9200,18712
7328,2020-06-17,3호선,수서,16395,16319,32714
7329,2020-06-17,3호선,가락시장,9158,9120,18278
7330,2020-06-17,3호선,경찰병원,7883,7797,15680
7331,2020-06-17,3호선,오금,6341,5626,11967
7332,2020-06-17,3호선,지축,3472,3349,6821
7333,2020-06-17,3호선,구파발,21191,19982,41173
7334,2020-06-17,3호선,연신내,38712,35907,74619
7335,2020-06-17,3호선,불광,16502,17785,34287
7336,2020-06-17,3호선,녹번,14237,12742,26979
7337,2020-06-17,3호선,홍제,17507,16507,34014
7338,2020-06-17,3호선,무악재,3883,4035,7918
7339,2020-06-17,3호선,독립문,7098,7501,14599
7340,2020-06-17,3호선,경복궁,18402,18143,36545
7341,2020-06-17,3호선,안국,19330,19862,39192
7342,2020-06-17,3호선,종로3가,10076,11867,21943
7343,2020-06-17,3호선,을지로3가,10783,11330,22113
7344,2020-06-17,3호선,동대입구,7189,7694,14883
7345,2020-06-17,3호선,약수,13119,12986,26105
7346,2020-06-17,3호선,금호,8237,7577,15814
7347,2020-06-17,3호선,옥수,9209,9541,18750
7348,2020-06-17,3호선,압구정,30391,32756,63147
7349,2020-06-17,3호선,신사,29144,31234,60378
7350,2020-06-17,3호선,잠원,5961,5763,11724
7351,2020-06-17,3호선,고속터미널,36855,35852,72707
7352,2020-06-17,3호선,대화,13708,10810,24518
7353,2020-06-17,3호선,주엽,9016,8998,18014
7354,2020-06-17,3호선,정발산,7160,7281,14441
7355,2020-06-17,3호선,마두,7568,7936,15504
7356,2020-06-17,3호선,백석,9947,9843,19790
7357,2020-06-17,3호선,대곡,1917,1462,3379
7358,2020-06-17,3호선,화정,17340,17901,35241
7359,2020-06-17,3호선,원당,11181,10632,21813
7360,2020-06-17,3호선,삼송,17832,17316,35148
7361,2020-06-17,3호선,원흥,9157,8737,17894
7362,2020-06-18,3호선,대청,9781,8807,18588
7363,2020-06-18,3호선,학여울,1833,1855,3688
7364,2020-06-18,3호선,대치,10084,9900,19984
7365,2020-06-18,3호선,도곡,5381,5443,10824
7366,2020-06-18,3호선,매봉,11865,11421,23286
7367,2020-06-18,3호선,양재,39132,42730,81862
7368,2020-06-18,3호선,남부터미널,28456,29377,57833
7369,2020-06-18,3호선,교대,15091,9998,25089
7370,2020-06-18,3호선,고속터미널,36456,35900,72356
7371,2020-06-18,3호선,잠원,5897,5636,11533
7372,2020-06-18,3호선,신사,29278,31591,60869
7373,2020-06-18,3호선,압구정,30258,32704,62962
7374,2020-06-18,3호선,옥수,9386,9708,19094
7375,2020-06-18,3호선,금호,8226,7578,15804
7376,2020-06-18,3호선,종로3가,9991,11885,21876
7377,2020-06-18,3호선,안국,19336,20017,39353
7378,2020-06-18,3호선,경복궁,18292,18165,36457
7379,2020-06-18,3호선,독립문,7074,7349,14423
7380,2020-06-18,3호선,무악재,3884,3947,7831
7381,2020-06-18,3호선,홍제,17513,16511,34024
7382,2020-06-18,3호선,녹번,14409,12660,27069
7383,2020-06-18,3호선,불광,16412,17461,33873
7384,2020-06-18,3호선,연신내,38398,36043,74441
7385,2020-06-18,3호선,구파발,20965,19673,40638
7386,2020-06-18,3호선,지축,3470,3321,6791
7387,2020-06-18,3호선,약수,13339,13052,26391
7388,2020-06-18,3호선,동대입구,7244,7655,14899
7389,2020-06-18,3호선,충무로,3,0,3
7390,2020-06-18,3호선,을지로3가,10719,11322,22041
7391,2020-06-18,3호선,오금,6467,5675,12142
7392,2020-06-18,3호선,경찰병원,7810,7799,15609
7393,2020-06-18,3호선,가락시장,9373,9140,18513
7394,2020-06-18,3호선,수서,16398,16758,33156
7395,2020-06-18,3호선,일원,9633,9483,19116
7396,2020-06-18,3호선,원흥,9191,8509,17700
7397,2020-06-18,3호선,삼송,18058,17346,35404
7398,2020-06-18,3호선,원당,11161,10713,21874
7399,2020-06-18,3호선,화정,17164,16942,34106
7400,2020-06-18,3호선,대곡,1855,1428,3283
7401,2020-06-18,3호선,백석,9788,9840,19628
7402,2020-06-18,3호선,마두,7406,7621,15027
7403,2020-06-18,3호선,정발산,6840,7197,14037
7404,2020-06-18,3호선,주엽,8681,8693,17374
7405,2020-06-18,3호선,대화,13916,10968,24884
7406,2020-06-19,3호선,지축,3517,3295,6812
7407,2020-06-19,3호선,구파발,21095,19430,40525
7408,2020-06-19,3호선,연신내,39365,36800,76165
7409,2020-06-19,3호선,불광,16652,17536,34188
7410,2020-06-19,3호선,녹번,14456,12467,26923
7411,2020-06-19,3호선,홍제,17953,16570,34523
7412,2020-06-19,3호선,무악재,4000,3935,7935
7413,2020-06-19,3호선,독립문,7263,7365,14628
7414,2020-06-19,3호선,경복궁,19027,18582,37609
7415,2020-06-19,3호선,안국,19247,20300,39547
7416,2020-06-19,3호선,종로3가,9986,12417,22403
7417,2020-06-19,3호선,을지로3가,10772,11881,22653
7418,2020-06-19,3호선,동대입구,7226,7594,14820
7419,2020-06-19,3호선,약수,13577,13275,26852
7420,2020-06-19,3호선,금호,8489,7722,16211
7421,2020-06-19,3호선,옥수,9591,9741,19332
7422,2020-06-19,3호선,압구정,32463,35519,67982
7423,2020-06-19,3호선,신사,31147,34979,66126
7424,2020-06-19,3호선,잠원,6245,5905,12150
7425,2020-06-19,3호선,고속터미널,43816,47562,91378
7426,2020-06-19,3호선,교대,15206,10018,25224
7427,2020-06-19,3호선,남부터미널,31883,33128,65011
7428,2020-06-19,3호선,양재,40954,43121,84075
7429,2020-06-19,3호선,매봉,12256,11625,23881
7430,2020-06-19,3호선,도곡,5826,5789,11615
7431,2020-06-19,3호선,대치,10954,10862,21816
7432,2020-06-19,3호선,학여울,2313,2336,4649
7433,2020-06-19,3호선,대청,10138,9099,19237
7434,2020-06-19,3호선,일원,9841,9114,18955
7435,2020-06-19,3호선,수서,18040,18220,36260
7436,2020-06-19,3호선,가락시장,9687,9524,19211
7437,2020-06-19,3호선,경찰병원,7751,7692,15443
7438,2020-06-19,3호선,오금,6693,5792,12485
7439,2020-06-19,3호선,원흥,9184,8483,17667
7440,2020-06-19,3호선,삼송,18272,17176,35448
7441,2020-06-19,3호선,원당,11382,10570,21952
7442,2020-06-19,3호선,화정,17773,17647,35420
7443,2020-06-19,3호선,대곡,1955,1508,3463
7444,2020-06-19,3호선,백석,10189,10403,20592
7445,2020-06-19,3호선,마두,8037,8185,16222
7446,2020-06-19,3호선,정발산,7411,7923,15334
7447,2020-06-19,3호선,주엽,8969,9079,18048
7448,2020-06-19,3호선,대화,13946,11019,24965
7449,2020-06-20,3호선,원흥,5997,5624,11621
7450,2020-06-20,3호선,삼송,12457,11704,24161
7451,2020-06-20,3호선,원당,7952,7542,15494
7452,2020-06-20,3호선,화정,12342,12259,24601
7453,2020-06-20,3호선,대곡,1243,1095,2338
7454,2020-06-20,3호선,백석,7426,7497,14923
7455,2020-06-20,3호선,마두,4804,4901,9705
7456,2020-06-20,3호선,정발산,5936,6500,12436
7457,2020-06-20,3호선,주엽,6089,5967,12056
7458,2020-06-20,3호선,대화,9107,7995,17102
7459,2020-06-20,3호선,오금,3536,3265,6801
7460,2020-06-20,3호선,경찰병원,3837,3650,7487
7461,2020-06-20,3호선,가락시장,6076,5699,11775
7462,2020-06-20,3호선,수서,11954,12137,24091
7463,2020-06-20,3호선,일원,4045,4009,8054
7464,2020-06-20,3호선,대청,5371,4922,10293
7465,2020-06-20,3호선,학여울,1526,1609,3135
7466,2020-06-20,3호선,대치,8283,7337,15620
7467,2020-06-20,3호선,도곡,3216,3206,6422
7468,2020-06-20,3호선,매봉,5423,5003,10426
7469,2020-06-20,3호선,양재,20046,21479,41525
7470,2020-06-20,3호선,남부터미널,19760,19887,39647
7471,2020-06-20,3호선,교대,6672,4074,10746
7472,2020-06-20,3호선,고속터미널,45117,46550,91667
7473,2020-06-20,3호선,잠원,3905,3667,7572
7474,2020-06-20,3호선,신사,22993,25341,48334
7475,2020-06-20,3호선,압구정,22313,23745,46058
7476,2020-06-20,3호선,옥수,7023,7203,14226
7477,2020-06-20,3호선,금호,5678,5017,10695
7478,2020-06-20,3호선,약수,8766,8308,17074
7479,2020-06-20,3호선,동대입구,5398,5968,11366
7480,2020-06-20,3호선,을지로3가,4373,5245,9618
7481,2020-06-20,3호선,종로3가,4673,7096,11769
7482,2020-06-20,3호선,안국,10547,12462,23009
7483,2020-06-20,3호선,경복궁,11365,11950,23315
7484,2020-06-20,3호선,독립문,5282,5437,10719
7485,2020-06-20,3호선,무악재,2540,2534,5074
7486,2020-06-20,3호선,홍제,12271,11378,23649
7487,2020-06-20,3호선,녹번,9062,7722,16784
7488,2020-06-20,3호선,불광,11949,13805,25754
7489,2020-06-20,3호선,연신내,29204,26875,56079
7490,2020-06-20,3호선,구파발,14355,14218,28573
7491,2020-06-20,3호선,지축,2148,2128,4276
7492,2020-06-21,3호선,오금,2684,2751,5435
7493,2020-06-21,3호선,경찰병원,2517,2634,5151
7494,2020-06-21,3호선,가락시장,3538,3847,7385
7495,2020-06-21,3호선,수서,9168,8728,17896
7496,2020-06-21,3호선,일원,2699,2980,5679
7497,2020-06-21,3호선,대청,3572,3330,6902
7498,2020-06-21,3호선,학여울,661,744,1405
7499,2020-06-21,3호선,대치,5110,4632,9742
7500,2020-06-21,3호선,도곡,1661,1699,3360
7501,2020-06-21,3호선,매봉,3528,3379,6907
7502,2020-06-21,3호선,양재,12378,14249,26627
7503,2020-06-21,3호선,남부터미널,12550,13128,25678
7504,2020-06-21,3호선,교대,3771,2306,6077
7505,2020-06-21,3호선,고속터미널,36527,33574,70101
7506,2020-06-21,3호선,잠원,2599,2622,5221
7507,2020-06-21,3호선,신사,12181,12728,24909
7508,2020-06-21,3호선,압구정,11521,12035,23556
7509,2020-06-21,3호선,옥수,4665,5008,9673
7510,2020-06-21,3호선,금호,3861,3743,7604
7511,2020-06-21,3호선,약수,6077,5957,12034
7512,2020-06-21,3호선,동대입구,3944,4334,8278
7513,2020-06-21,3호선,충무로,1,0,1
7514,2020-06-21,3호선,을지로3가,2437,2547,4984
7515,2020-06-21,3호선,종로3가,3035,4239,7274
7516,2020-06-21,3호선,안국,7016,8049,15065
7517,2020-06-21,3호선,경복궁,8043,8281,16324
7518,2020-06-21,3호선,독립문,3827,4063,7890
7519,2020-06-21,3호선,무악재,1648,1788,3436
7520,2020-06-21,3호선,홍제,8444,7976,16420
7521,2020-06-21,3호선,녹번,5995,5351,11346
7522,2020-06-21,3호선,불광,8981,10577,19558
7523,2020-06-21,3호선,연신내,20869,19477,40346
7524,2020-06-21,3호선,구파발,10575,10975,21550
7525,2020-06-21,3호선,지축,1467,1440,2907
7526,2020-06-21,3호선,원흥,4241,4057,8298
7527,2020-06-21,3호선,삼송,8976,8745,17721
7528,2020-06-21,3호선,원당,5730,5461,11191
7529,2020-06-21,3호선,화정,8769,8905,17674
7530,2020-06-21,3호선,대곡,960,820,1780
7531,2020-06-21,3호선,백석,5324,5171,10495
7532,2020-06-21,3호선,마두,3126,3065,6191
7533,2020-06-21,3호선,정발산,4851,4871,9722
7534,2020-06-21,3호선,주엽,4092,4043,8135
7535,2020-06-21,3호선,대화,6386,5815,12201
7536,2020-06-22,3호선,대화,13470,10325,23795
7537,2020-06-22,3호선,주엽,8635,8812,17447
7538,2020-06-22,3호선,정발산,6734,6838,13572
7539,2020-06-22,3호선,마두,7341,7672,15013
7540,2020-06-22,3호선,백석,9628,9844,19472
7541,2020-06-22,3호선,대곡,1799,1294,3093
7542,2020-06-22,3호선,화정,16497,17096,33593
7543,2020-06-22,3호선,원당,10878,10237,21115
7544,2020-06-22,3호선,삼송,17072,16464,33536
7545,2020-06-22,3호선,원흥,8854,8384,17238
7546,2020-06-22,3호선,오금,6440,5624,12064
7547,2020-06-22,3호선,경찰병원,7775,7817,15592
7548,2020-06-22,3호선,가락시장,9048,8936,17984
7549,2020-06-22,3호선,수서,16212,16455,32667
7550,2020-06-22,3호선,일원,9596,9387,18983
7551,2020-06-22,3호선,대청,9735,8811,18546
7552,2020-06-22,3호선,학여울,1719,1825,3544
7553,2020-06-22,3호선,대치,10367,10379,20746
7554,2020-06-22,3호선,도곡,5340,5373,10713
7555,2020-06-22,3호선,매봉,11822,11331,23153
7556,2020-06-22,3호선,양재,37442,41005,78447
7557,2020-06-22,3호선,남부터미널,28146,29094,57240
7558,2020-06-22,3호선,교대,14089,9621,23710
7559,2020-06-22,3호선,고속터미널,37584,35088,72672
7560,2020-06-22,3호선,잠원,5765,5623,11388
7561,2020-06-22,3호선,신사,27792,29751,57543
7562,2020-06-22,3호선,압구정,30082,31999,62081
7563,2020-06-22,3호선,옥수,8807,9185,17992
7564,2020-06-22,3호선,금호,7971,7408,15379
7565,2020-06-22,3호선,약수,12577,12453,25030
7566,2020-06-22,3호선,동대입구,7341,7631,14972
7567,2020-06-22,3호선,을지로3가,10627,11058,21685
7568,2020-06-22,3호선,종로3가,10020,11750,21770
7569,2020-06-22,3호선,안국,18896,19309,38205
7570,2020-06-22,3호선,경복궁,17157,16932,34089
7571,2020-06-22,3호선,독립문,6762,6911,13673
7572,2020-06-22,3호선,무악재,3765,3921,7686
7573,2020-06-22,3호선,홍제,17059,16376,33435
7574,2020-06-22,3호선,녹번,14098,12577,26675
7575,2020-06-22,3호선,불광,15904,16877,32781
7576,2020-06-22,3호선,연신내,37091,34870,71961
7577,2020-06-22,3호선,구파발,20502,19134,39636
7578,2020-06-22,3호선,지축,3406,3320,6726
7579,2020-06-23,3호선,대화,13529,10492,24021
7580,2020-06-23,3호선,주엽,8626,8986,17612
7581,2020-06-23,3호선,정발산,6855,7002,13857
7582,2020-06-23,3호선,마두,7520,7799,15319
7583,2020-06-23,3호선,백석,10062,9988,20050
7584,2020-06-23,3호선,대곡,1958,1454,3412
7585,2020-06-23,3호선,화정,16967,17569,34536
7586,2020-06-23,3호선,원당,11311,10736,22047
7587,2020-06-23,3호선,삼송,17594,17039,34633
7588,2020-06-23,3호선,원흥,9142,8518,17660
7589,2020-06-23,3호선,오금,6386,5644,12030
7590,2020-06-23,3호선,경찰병원,7711,7774,15485
7591,2020-06-23,3호선,가락시장,9347,9252,18599
7592,2020-06-23,3호선,수서,16503,16557,33060
7593,2020-06-23,3호선,일원,9544,9354,18898
7594,2020-06-23,3호선,대청,9828,9041,18869
7595,2020-06-23,3호선,학여울,1716,1747,3463
7596,2020-06-23,3호선,대치,10630,10528,21158
7597,2020-06-23,3호선,도곡,5467,5480,10947
7598,2020-06-23,3호선,매봉,12167,11649,23816
7599,2020-06-23,3호선,양재,38832,42285,81117
7600,2020-06-23,3호선,남부터미널,28805,29533,58338
7601,2020-06-23,3호선,교대,14543,9806,24349
7602,2020-06-23,3호선,고속터미널,36883,35554,72437
7603,2020-06-23,3호선,잠원,5862,5609,11471
7604,2020-06-23,3호선,신사,28823,31182,60005
7605,2020-06-23,3호선,압구정,31055,33495,64550
7606,2020-06-23,3호선,옥수,9176,9493,18669
7607,2020-06-23,3호선,금호,8219,7634,15853
7608,2020-06-23,3호선,약수,13167,12754,25921
7609,2020-06-23,3호선,동대입구,7434,7946,15380
7610,2020-06-23,3호선,충무로,2,0,2
7611,2020-06-23,3호선,을지로3가,10696,11168,21864
7612,2020-06-23,3호선,종로3가,9978,11848,21826
7613,2020-06-23,3호선,안국,19598,19992,39590
7614,2020-06-23,3호선,경복궁,18093,17922,36015
7615,2020-06-23,3호선,독립문,7043,7320,14363
7616,2020-06-23,3호선,무악재,3855,3950,7805
7617,2020-06-23,3호선,홍제,17424,16471,33895
7618,2020-06-23,3호선,녹번,14503,12982,27485
7619,2020-06-23,3호선,불광,16253,17360,33613
7620,2020-06-23,3호선,연신내,38039,35730,73769
7621,2020-06-23,3호선,구파발,21237,19740,40977
7622,2020-06-23,3호선,지축,3417,3329,6746
7623,2020-06-24,3호선,원흥,8653,8159,16812
7624,2020-06-24,3호선,삼송,16620,16003,32623
7625,2020-06-24,3호선,원당,10384,9922,20306
7626,2020-06-24,3호선,오금,6389,5661,12050
7627,2020-06-24,3호선,경찰병원,7798,7851,15649
7628,2020-06-24,3호선,가락시장,8849,8620,17469
7629,2020-06-24,3호선,수서,16090,16140,32230
7630,2020-06-24,3호선,일원,9196,9086,18282
7631,2020-06-24,3호선,대청,9675,8867,18542
7632,2020-06-24,3호선,학여울,1703,1812,3515
7633,2020-06-24,3호선,대치,10313,10369,20682
7634,2020-06-24,3호선,도곡,5435,5387,10822
7635,2020-06-24,3호선,매봉,11884,11377,23261
7636,2020-06-24,3호선,양재,38891,41748,80639
7637,2020-06-24,3호선,남부터미널,28104,28718,56822
7638,2020-06-24,3호선,교대,14829,9772,24601
7639,2020-06-24,3호선,고속터미널,35267,33977,69244
7640,2020-06-24,3호선,잠원,5699,5654,11353
7641,2020-06-24,3호선,신사,27732,29744,57476
7642,2020-06-24,3호선,압구정,29658,31948,61606
7643,2020-06-24,3호선,옥수,8487,9081,17568
7644,2020-06-24,3호선,금호,7890,7359,15249
7645,2020-06-24,3호선,약수,12519,12490,25009
7646,2020-06-24,3호선,동대입구,7003,7231,14234
7647,2020-06-24,3호선,충무로,2,0,2
7648,2020-06-24,3호선,을지로3가,10904,11141,22045
7649,2020-06-24,3호선,종로3가,10048,11454,21502
7650,2020-06-24,3호선,안국,19627,19566,39193
7651,2020-06-24,3호선,경복궁,17510,17282,34792
7652,2020-06-24,3호선,독립문,6456,6698,13154
7653,2020-06-24,3호선,무악재,3796,3847,7643
7654,2020-06-24,3호선,홍제,16592,15847,32439
7655,2020-06-24,3호선,녹번,13935,12574,26509
7656,2020-06-24,3호선,불광,15492,16347,31839
7657,2020-06-24,3호선,연신내,35647,34044,69691
7658,2020-06-24,3호선,구파발,20000,18658,38658
7659,2020-06-24,3호선,지축,3244,3203,6447
7660,2020-06-24,3호선,화정,15713,16381,32094
7661,2020-06-24,3호선,대곡,1666,1237,2903
7662,2020-06-24,3호선,백석,9147,9164,18311
7663,2020-06-24,3호선,마두,7051,7375,14426
7664,2020-06-24,3호선,정발산,6414,6369,12783
7665,2020-06-24,3호선,주엽,8077,8244,16321
7666,2020-06-24,3호선,대화,12697,10013,22710
7667,2020-06-25,3호선,매봉,11997,11545,23542
7668,2020-06-25,3호선,오금,6349,5670,12019
7669,2020-06-25,3호선,경찰병원,7704,7670,15374
7670,2020-06-25,3호선,가락시장,9206,8944,18150
7671,2020-06-25,3호선,수서,16464,16628,33092
7672,2020-06-25,3호선,일원,9697,9461,19158
7673,2020-06-25,3호선,대청,9870,8994,18864
7674,2020-06-25,3호선,학여울,2001,2060,4061
7675,2020-06-25,3호선,대치,10596,10532,21128
7676,2020-06-25,3호선,도곡,5319,5440,10759
7677,2020-06-25,3호선,양재,38796,42614,81410
7678,2020-06-25,3호선,남부터미널,28250,29291,57541
7679,2020-06-25,3호선,교대,15215,10044,25259
7680,2020-06-25,3호선,고속터미널,36739,36027,72766
7681,2020-06-25,3호선,잠원,5874,5749,11623
7682,2020-06-25,3호선,신사,28559,31099,59658
7683,2020-06-25,3호선,압구정,30060,32563,62623
7684,2020-06-25,3호선,옥수,9042,9373,18415
7685,2020-06-25,3호선,금호,8129,7562,15691
7686,2020-06-25,3호선,약수,13049,12690,25739
7687,2020-06-25,3호선,동대입구,7282,7542,14824
7688,2020-06-25,3호선,충무로,1,0,1
7689,2020-06-25,3호선,을지로3가,11044,11607,22651
7690,2020-06-25,3호선,종로3가,10177,11781,21958
7691,2020-06-25,3호선,안국,19396,20102,39498
7692,2020-06-25,3호선,경복궁,18252,17963,36215
7693,2020-06-25,3호선,독립문,6665,7156,13821
7694,2020-06-25,3호선,무악재,3914,3949,7863
7695,2020-06-25,3호선,홍제,17234,16350,33584
7696,2020-06-25,3호선,녹번,14435,12725,27160
7697,2020-06-25,3호선,불광,16150,17113,33263
7698,2020-06-25,3호선,연신내,38075,35443,73518
7699,2020-06-25,3호선,구파발,20853,19444,40297
7700,2020-06-25,3호선,지축,3381,3276,6657
7701,2020-06-25,3호선,대화,13276,10254,23530
7702,2020-06-25,3호선,주엽,8369,8545,16914
7703,2020-06-25,3호선,정발산,6544,6802,13346
7704,2020-06-25,3호선,마두,7301,7441,14742
7705,2020-06-25,3호선,백석,9935,9927,19862
7706,2020-06-25,3호선,대곡,1723,1288,3011
7707,2020-06-25,3호선,화정,16669,17250,33919
7708,2020-06-25,3호선,원당,10932,10327,21259
7709,2020-06-25,3호선,삼송,17496,16773,34269
7710,2020-06-25,3호선,원흥,9001,8460,17461
7711,2020-06-26,3호선,오금,6730,5854,12584
7712,2020-06-26,3호선,경찰병원,7872,7797,15669
7713,2020-06-26,3호선,가락시장,9836,9466,19302
7714,2020-06-26,3호선,수서,18292,18700,36992
7715,2020-06-26,3호선,일원,9814,9338,19152
7716,2020-06-26,3호선,대청,10669,9578,20247
7717,2020-06-26,3호선,학여울,3365,3422,6787
7718,2020-06-26,3호선,대치,11460,11356,22816
7719,2020-06-26,3호선,도곡,5615,5451,11066
7720,2020-06-26,3호선,매봉,12262,11626,23888
7721,2020-06-26,3호선,양재,41548,44166,85714
7722,2020-06-26,3호선,남부터미널,31725,32647,64372
7723,2020-06-26,3호선,교대,15213,10258,25471
7724,2020-06-26,3호선,고속터미널,45519,48604,94123
7725,2020-06-26,3호선,잠원,6228,5918,12146
7726,2020-06-26,3호선,신사,31885,36020,67905
7727,2020-06-26,3호선,압구정,33455,36404,69859
7728,2020-06-26,3호선,옥수,9807,9895,19702
7729,2020-06-26,3호선,금호,8729,7854,16583
7730,2020-06-26,3호선,약수,13585,13437,27022
7731,2020-06-26,3호선,동대입구,7331,7930,15261
7732,2020-06-26,3호선,을지로3가,11181,12243,23424
7733,2020-06-26,3호선,종로3가,9919,12444,22363
7734,2020-06-26,3호선,안국,19881,20661,40542
7735,2020-06-26,3호선,경복궁,18952,18781,37733
7736,2020-06-26,3호선,독립문,7258,7356,14614
7737,2020-06-26,3호선,무악재,3897,3860,7757
7738,2020-06-26,3호선,홍제,18116,16682,34798
7739,2020-06-26,3호선,녹번,14769,12667,27436
7740,2020-06-26,3호선,불광,16919,17863,34782
7741,2020-06-26,3호선,연신내,39832,37379,77211
7742,2020-06-26,3호선,구파발,21943,20303,42246
7743,2020-06-26,3호선,지축,3530,3197,6727
7744,2020-06-26,3호선,대화,14125,10764,24889
7745,2020-06-26,3호선,주엽,8925,9097,18022
7746,2020-06-26,3호선,정발산,7371,8148,15519
7747,2020-06-26,3호선,마두,7879,8161,16040
7748,2020-06-26,3호선,백석,10425,10472,20897
7749,2020-06-26,3호선,대곡,1876,1450,3326
7750,2020-06-26,3호선,화정,17379,17970,35349
7751,2020-06-26,3호선,원당,11619,10825,22444
7752,2020-06-26,3호선,삼송,18296,17238,35534
7753,2020-06-26,3호선,원흥,9454,8752,18206
7754,2020-06-27,3호선,지축,2189,2133,4322
7755,2020-06-27,3호선,구파발,15279,15517,30796
7756,2020-06-27,3호선,연신내,30245,28132,58377
7757,2020-06-27,3호선,불광,12325,14106,26431
7758,2020-06-27,3호선,녹번,9445,7810,17255
7759,2020-06-27,3호선,홍제,12885,11907,24792
7760,2020-06-27,3호선,무악재,2544,2649,5193
7761,2020-06-27,3호선,독립문,5293,5603,10896
7762,2020-06-27,3호선,경복궁,11948,12322,24270
7763,2020-06-27,3호선,안국,10680,12780,23460
7764,2020-06-27,3호선,종로3가,4929,7591,12520
7765,2020-06-27,3호선,을지로3가,4934,5690,10624
7766,2020-06-27,3호선,동대입구,5655,6193,11848
7767,2020-06-27,3호선,약수,9210,8567,17777
7768,2020-06-27,3호선,금호,5812,5185,10997
7769,2020-06-27,3호선,옥수,6895,6782,13677
7770,2020-06-27,3호선,압구정,23485,24944,48429
7771,2020-06-27,3호선,신사,23853,26175,50028
7772,2020-06-27,3호선,잠원,4246,3929,8175
7773,2020-06-27,3호선,고속터미널,47354,48498,95852
7774,2020-06-27,3호선,교대,6939,4207,11146
7775,2020-06-27,3호선,남부터미널,20935,21285,42220
7776,2020-06-27,3호선,양재,21241,22921,44162
7777,2020-06-27,3호선,매봉,5511,5301,10812
7778,2020-06-27,3호선,도곡,3370,3163,6533
7779,2020-06-27,3호선,대치,8845,7825,16670
7780,2020-06-27,3호선,학여울,2822,2923,5745
7781,2020-06-27,3호선,대청,5575,5003,10578
7782,2020-06-27,3호선,일원,4649,4488,9137
7783,2020-06-27,3호선,수서,12151,12508,24659
7784,2020-06-27,3호선,가락시장,6288,5879,12167
7785,2020-06-27,3호선,경찰병원,3962,3727,7689
7786,2020-06-27,3호선,오금,3941,3771,7712
7787,2020-06-27,3호선,원흥,6394,5867,12261
7788,2020-06-27,3호선,삼송,13075,12532,25607
7789,2020-06-27,3호선,원당,8309,7775,16084
7790,2020-06-27,3호선,화정,12874,13257,26131
7791,2020-06-27,3호선,대곡,1305,1184,2489
7792,2020-06-27,3호선,백석,7794,7836,15630
7793,2020-06-27,3호선,마두,5092,5210,10302
7794,2020-06-27,3호선,정발산,6128,6688,12816
7795,2020-06-27,3호선,주엽,6354,6277,12631
7796,2020-06-27,3호선,대화,8893,7772,16665
7797,2020-06-28,3호선,대화,6448,5779,12227
7798,2020-06-28,3호선,주엽,4176,4064,8240
7799,2020-06-28,3호선,정발산,4979,5104,10083
7800,2020-06-28,3호선,마두,3111,3038,6149
7801,2020-06-28,3호선,백석,5538,5303,10841
7802,2020-06-28,3호선,대곡,1002,843,1845
7803,2020-06-28,3호선,화정,9420,9623,19043
7804,2020-06-28,3호선,원당,5961,5704,11665
7805,2020-06-28,3호선,삼송,9353,9095,18448
7806,2020-06-28,3호선,원흥,4424,4258,8682
7807,2020-06-28,3호선,오금,2841,2699,5540
7808,2020-06-28,3호선,경찰병원,2595,2709,5304
7809,2020-06-28,3호선,가락시장,3499,3829,7328
7810,2020-06-28,3호선,수서,9573,9140,18713
7811,2020-06-28,3호선,일원,2737,2879,5616
7812,2020-06-28,3호선,대청,3602,3529,7131
7813,2020-06-28,3호선,학여울,2038,2243,4281
7814,2020-06-28,3호선,대치,5436,4825,10261
7815,2020-06-28,3호선,도곡,1844,1867,3711
7816,2020-06-28,3호선,매봉,3681,3605,7286
7817,2020-06-28,3호선,양재,12991,14941,27932
7818,2020-06-28,3호선,남부터미널,14402,14945,29347
7819,2020-06-28,3호선,교대,3955,2435,6390
7820,2020-06-28,3호선,고속터미널,39020,36116,75136
7821,2020-06-28,3호선,잠원,2556,2575,5131
7822,2020-06-28,3호선,신사,13277,13816,27093
7823,2020-06-28,3호선,압구정,12426,13023,25449
7824,2020-06-28,3호선,옥수,4774,5235,10009
7825,2020-06-28,3호선,금호,4097,3866,7963
7826,2020-06-28,3호선,약수,6263,6044,12307
7827,2020-06-28,3호선,동대입구,4053,4498,8551
7828,2020-06-28,3호선,을지로3가,2591,2672,5263
7829,2020-06-28,3호선,종로3가,3122,4631,7753
7830,2020-06-28,3호선,안국,7269,8484,15753
7831,2020-06-28,3호선,경복궁,7973,8504,16477
7832,2020-06-28,3호선,독립문,3862,4149,8011
7833,2020-06-28,3호선,무악재,1685,1851,3536
7834,2020-06-28,3호선,홍제,8547,8183,16730
7835,2020-06-28,3호선,녹번,6281,5605,11886
7836,2020-06-28,3호선,불광,9065,10982,20047
7837,2020-06-28,3호선,연신내,21605,20323,41928
7838,2020-06-28,3호선,구파발,11333,11670,23003
7839,2020-06-28,3호선,지축,1587,1497,3084
7840,2020-06-29,3호선,지축,3414,3338,6752
7841,2020-06-29,3호선,구파발,21215,19792,41007
7842,2020-06-29,3호선,연신내,37987,35492,73479
7843,2020-06-29,3호선,불광,15987,16978,32965
7844,2020-06-29,3호선,녹번,14298,13002,27300
7845,2020-06-29,3호선,홍제,17458,16733,34191
7846,2020-06-29,3호선,무악재,3910,3970,7880
7847,2020-06-29,3호선,독립문,6894,7251,14145
7848,2020-06-29,3호선,경복궁,17626,17261,34887
7849,2020-06-29,3호선,안국,18987,19304,38291
7850,2020-06-29,3호선,종로3가,10197,11662,21859
7851,2020-06-29,3호선,을지로3가,10897,11138,22035
7852,2020-06-29,3호선,충무로,1,0,1
7853,2020-06-29,3호선,동대입구,6791,7044,13835
7854,2020-06-29,3호선,약수,12999,12942,25941
7855,2020-06-29,3호선,금호,7971,7488,15459
7856,2020-06-29,3호선,옥수,8928,9396,18324
7857,2020-06-29,3호선,압구정,31038,33319,64357
7858,2020-06-29,3호선,신사,28878,30729,59607
7859,2020-06-29,3호선,잠원,5893,5800,11693
7860,2020-06-29,3호선,고속터미널,37774,35696,73470
7861,2020-06-29,3호선,교대,14241,9727,23968
7862,2020-06-29,3호선,남부터미널,28694,29458,58152
7863,2020-06-29,3호선,양재,38063,41778,79841
7864,2020-06-29,3호선,매봉,12001,11391,23392
7865,2020-06-29,3호선,도곡,5586,5654,11240
7866,2020-06-29,3호선,대치,10748,10813,21561
7867,2020-06-29,3호선,학여울,1713,1750,3463
7868,2020-06-29,3호선,대청,10155,9462,19617
7869,2020-06-29,3호선,일원,9763,9701,19464
7870,2020-06-29,3호선,수서,16382,16673,33055
7871,2020-06-29,3호선,가락시장,9226,9160,18386
7872,2020-06-29,3호선,경찰병원,7848,7839,15687
7873,2020-06-29,3호선,오금,6466,5719,12185
7874,2020-06-29,3호선,원흥,8985,8475,17460
7875,2020-06-29,3호선,삼송,17512,16993,34505
7876,2020-06-29,3호선,원당,11042,10414,21456
7877,2020-06-29,3호선,화정,16762,17085,33847
7878,2020-06-29,3호선,대곡,1781,1368,3149
7879,2020-06-29,3호선,백석,9720,9932,19652
7880,2020-06-29,3호선,마두,7283,7760,15043
7881,2020-06-29,3호선,정발산,6819,6957,13776
7882,2020-06-29,3호선,주엽,8579,8767,17346
7883,2020-06-29,3호선,대화,13573,10443,24016
7884,2020-06-30,3호선,지축,3318,3203,6521
7885,2020-06-30,3호선,구파발,20639,19218,39857
7886,2020-06-30,3호선,연신내,37068,34803,71871
7887,2020-06-30,3호선,불광,15902,16855,32757
7888,2020-06-30,3호선,녹번,14354,12784,27138
7889,2020-06-30,3호선,홍제,17178,16198,33376
7890,2020-06-30,3호선,무악재,3862,3853,7715
7891,2020-06-30,3호선,독립문,6765,6972,13737
7892,2020-06-30,3호선,경복궁,17628,17459,35087
7893,2020-06-30,3호선,안국,18965,19644,38609
7894,2020-06-30,3호선,종로3가,10191,11817,22008
7895,2020-06-30,3호선,을지로3가,10739,11297,22036
7896,2020-06-30,3호선,충무로,1,0,1
7897,2020-06-30,3호선,동대입구,6967,7295,14262
7898,2020-06-30,3호선,약수,12824,12557,25381
7899,2020-06-30,3호선,금호,8122,7512,15634
7900,2020-06-30,3호선,옥수,8903,9227,18130
7901,2020-06-30,3호선,압구정,30841,33248,64089
7902,2020-06-30,3호선,신사,29118,31476,60594
7903,2020-06-30,3호선,잠원,5768,5519,11287
7904,2020-06-30,3호선,고속터미널,35333,34499,69832
7905,2020-06-30,3호선,교대,14300,9788,24088
7906,2020-06-30,3호선,남부터미널,28036,29019,57055
7907,2020-06-30,3호선,양재,37791,41553,79344
7908,2020-06-30,3호선,매봉,11871,11324,23195
7909,2020-06-30,3호선,도곡,5485,5527,11012
7910,2020-06-30,3호선,대치,10617,10664,21281
7911,2020-06-30,3호선,학여울,1762,1808,3570
7912,2020-06-30,3호선,대청,9956,9079,19035
7913,2020-06-30,3호선,일원,9595,9401,18996
7914,2020-06-30,3호선,수서,15843,16071,31914
7915,2020-06-30,3호선,가락시장,8963,8683,17646
7916,2020-06-30,3호선,경찰병원,7752,7774,15526
7917,2020-06-30,3호선,오금,6323,5688,12011
7918,2020-06-30,3호선,원흥,8868,8384,17252
7919,2020-06-30,3호선,삼송,16983,16456,33439
7920,2020-06-30,3호선,원당,10593,10317,20910
7921,2020-06-30,3호선,화정,16250,16631,32881
7922,2020-06-30,3호선,대곡,1753,1255,3008
7923,2020-06-30,3호선,백석,9521,9611,19132
7924,2020-06-30,3호선,마두,7150,7328,14478
7925,2020-06-30,3호선,대화,13097,9865,22962
7926,2020-06-30,3호선,주엽,8370,8470,16840
7927,2020-06-30,3호선,정발산,6466,6530,12996
7928,2020-07-01,3호선,남부터미널,28865,29827,58692
7929,2020-07-01,3호선,대화,14094,10924,25018
7930,2020-07-01,3호선,주엽,8798,8955,17753
7931,2020-07-01,3호선,정발산,7100,7481,14581
7932,2020-07-01,3호선,마두,7543,7771,15314
7933,2020-07-01,3호선,백석,10045,10001,20046
7934,2020-07-01,3호선,대곡,1906,1508,3414
7935,2020-07-01,3호선,화정,17456,17781,35237
7936,2020-07-01,3호선,원당,11363,10737,22100
7937,2020-07-01,3호선,삼송,17987,17254,35241
7938,2020-07-01,3호선,원흥,9627,8889,18516
7939,2020-07-01,3호선,양재,38843,42562,81405
7940,2020-07-01,3호선,매봉,11999,11590,23589
7941,2020-07-01,3호선,도곡,5509,5575,11084
7942,2020-07-01,3호선,대치,10857,10737,21594
7943,2020-07-01,3호선,학여울,1831,1880,3711
7944,2020-07-01,3호선,대청,10137,9085,19222
7945,2020-07-01,3호선,일원,9822,9666,19488
7946,2020-07-01,3호선,수서,16167,16267,32434
7947,2020-07-01,3호선,가락시장,9211,9105,18316
7948,2020-07-01,3호선,경찰병원,7852,7779,15631
7949,2020-07-01,3호선,오금,6518,5681,12199
7950,2020-07-01,3호선,지축,3485,3413,6898
7951,2020-07-01,3호선,구파발,21561,20246,41807
7952,2020-07-01,3호선,연신내,38747,36348,75095
7953,2020-07-01,3호선,불광,16546,17802,34348
7954,2020-07-01,3호선,녹번,14846,13245,28091
7955,2020-07-01,3호선,홍제,17925,16679,34604
7956,2020-07-01,3호선,무악재,4004,3980,7984
7957,2020-07-01,3호선,독립문,7052,7432,14484
7958,2020-07-01,3호선,경복궁,18970,18860,37830
7959,2020-07-01,3호선,안국,20139,20986,41125
7960,2020-07-01,3호선,종로3가,10126,12098,22224
7961,2020-07-01,3호선,을지로3가,10875,11604,22479
7962,2020-07-01,3호선,충무로,1,0,1
7963,2020-07-01,3호선,동대입구,7130,7696,14826
7964,2020-07-01,3호선,약수,13343,13101,26444
7965,2020-07-01,3호선,금호,8504,7874,16378
7966,2020-07-01,3호선,옥수,9403,9741,19144
7967,2020-07-01,3호선,압구정,31626,34188,65814
7968,2020-07-01,3호선,신사,30148,32633,62781
7969,2020-07-01,3호선,잠원,6087,5822,11909
7970,2020-07-01,3호선,고속터미널,38501,37038,75539
7971,2020-07-01,3호선,교대,14929,9984,24913
7972,2020-07-02,3호선,오금,6479,5791,12270
7973,2020-07-02,3호선,경찰병원,7892,7949,15841
7974,2020-07-02,3호선,가락시장,9542,9471,19013
7975,2020-07-02,3호선,수서,16646,16979,33625
7976,2020-07-02,3호선,일원,9917,9694,19611
7977,2020-07-02,3호선,대청,10147,9116,19263
7978,2020-07-02,3호선,학여울,2026,2098,4124
7979,2020-07-02,3호선,대치,11025,10975,22000
7980,2020-07-02,3호선,도곡,5535,5567,11102
7981,2020-07-02,3호선,매봉,12169,11678,23847
7982,2020-07-02,3호선,양재,39124,42948,82072
7983,2020-07-02,3호선,남부터미널,29010,29878,58888
7984,2020-07-02,3호선,교대,15121,10026,25147
7985,2020-07-02,3호선,고속터미널,39201,38251,77452
7986,2020-07-02,3호선,잠원,5963,5738,11701
7987,2020-07-02,3호선,신사,30164,32621,62785
7988,2020-07-02,3호선,압구정,31317,33647,64964
7989,2020-07-02,3호선,옥수,9478,9642,19120
7990,2020-07-02,3호선,금호,8377,7696,16073
7991,2020-07-02,3호선,약수,13402,13083,26485
7992,2020-07-02,3호선,동대입구,7248,7682,14930
7993,2020-07-02,3호선,을지로3가,10959,11718,22677
7994,2020-07-02,3호선,종로3가,10224,12173,22397
7995,2020-07-02,3호선,안국,20011,21021,41032
7996,2020-07-02,3호선,경복궁,19045,18865,37910
7997,2020-07-02,3호선,독립문,7120,7511,14631
7998,2020-07-02,3호선,무악재,4035,4034,8069
7999,2020-07-02,3호선,홍제,17832,16767,34599
8000,2020-07-02,3호선,녹번,14768,13229,27997
8001,2020-07-02,3호선,불광,16486,17585,34071
8002,2020-07-02,3호선,연신내,38759,36296,75055
8003,2020-07-02,3호선,구파발,21759,20463,42222
8004,2020-07-02,3호선,지축,3533,3443,6976
8005,2020-07-02,3호선,원흥,9355,8712,18067
8006,2020-07-02,3호선,삼송,17976,17222,35198
8007,2020-07-02,3호선,원당,11326,10743,22069
8008,2020-07-02,3호선,화정,17475,17939,35414
8009,2020-07-02,3호선,대곡,1892,1442,3334
8010,2020-07-02,3호선,백석,10028,10137,20165
8011,2020-07-02,3호선,마두,7466,7828,15294
8012,2020-07-02,3호선,정발산,7082,7404,14486
8013,2020-07-02,3호선,주엽,8874,8972,17846
8014,2020-07-02,3호선,대화,14191,11010,25201
8015,2020-07-03,3호선,대화,14405,11293,25698
8016,2020-07-03,3호선,주엽,9064,9295,18359
8017,2020-07-03,3호선,정발산,7458,8075,15533
8018,2020-07-03,3호선,마두,7805,8035,15840
8019,2020-07-03,3호선,백석,10344,10566,20910
8020,2020-07-03,3호선,대곡,1962,1513,3475
8021,2020-07-03,3호선,화정,17893,18610,36503
8022,2020-07-03,3호선,원당,11592,10728,22320
8023,2020-07-03,3호선,삼송,18262,17369,35631
8024,2020-07-03,3호선,원흥,9734,8841,18575
8025,2020-07-03,3호선,오금,6670,5891,12561
8026,2020-07-03,3호선,경찰병원,8227,8015,16242
8027,2020-07-03,3호선,가락시장,10009,9749,19758
8028,2020-07-03,3호선,수서,18385,18673,37058
8029,2020-07-03,3호선,일원,10056,9544,19600
8030,2020-07-03,3호선,대청,10502,9336,19838
8031,2020-07-03,3호선,학여울,3135,3326,6461
8032,2020-07-03,3호선,대치,11506,11425,22931
8033,2020-07-03,3호선,도곡,5561,5588,11149
8034,2020-07-03,3호선,매봉,12243,11745,23988
8035,2020-07-03,3호선,양재,41836,43962,85798
8036,2020-07-03,3호선,남부터미널,31612,32530,64142
8037,2020-07-03,3호선,교대,15058,10212,25270
8038,2020-07-03,3호선,고속터미널,46042,49080,95122
8039,2020-07-03,3호선,잠원,6248,5938,12186
8040,2020-07-03,3호선,신사,32499,36479,68978
8041,2020-07-03,3호선,압구정,33597,36608,70205
8042,2020-07-03,3호선,옥수,9832,9985,19817
8043,2020-07-03,3호선,금호,8620,7816,16436
8044,2020-07-03,3호선,약수,13635,13376,27011
8045,2020-07-03,3호선,동대입구,7279,7710,14989
8046,2020-07-03,3호선,충무로,1,0,1
8047,2020-07-03,3호선,을지로3가,11333,12451,23784
8048,2020-07-03,3호선,종로3가,10111,12557,22668
8049,2020-07-03,3호선,안국,20037,20869,40906
8050,2020-07-03,3호선,경복궁,19580,19288,38868
8051,2020-07-03,3호선,독립문,7321,7455,14776
8052,2020-07-03,3호선,무악재,4000,3888,7888
8053,2020-07-03,3호선,홍제,18083,16923,35006
8054,2020-07-03,3호선,녹번,14941,12821,27762
8055,2020-07-03,3호선,불광,16554,17402,33956
8056,2020-07-03,3호선,연신내,39856,37284,77140
8057,2020-07-03,3호선,구파발,21895,20242,42137
8058,2020-07-03,3호선,지축,3595,3391,6986
8059,2020-07-04,3호선,도곡,3558,3411,6969
8060,2020-07-04,3호선,오금,3911,3642,7553
8061,2020-07-04,3호선,경찰병원,4061,3815,7876
8062,2020-07-04,3호선,가락시장,6123,5694,11817
8063,2020-07-04,3호선,수서,12013,12361,24374
8064,2020-07-04,3호선,일원,4385,4315,8700
8065,2020-07-04,3호선,대청,5549,5075,10624
8066,2020-07-04,3호선,학여울,2212,2298,4510
8067,2020-07-04,3호선,대치,8916,7926,16842
8068,2020-07-04,3호선,대화,9843,8752,18595
8069,2020-07-04,3호선,주엽,6284,6210,12494
8070,2020-07-04,3호선,정발산,6035,6587,12622
8071,2020-07-04,3호선,마두,4973,4911,9884
8072,2020-07-04,3호선,백석,7508,7576,15084
8073,2020-07-04,3호선,대곡,1190,1040,2230
8074,2020-07-04,3호선,화정,12500,13024,25524
8075,2020-07-04,3호선,원당,8003,7607,15610
8076,2020-07-04,3호선,삼송,12572,11837,24409
8077,2020-07-04,3호선,원흥,6235,6010,12245
8078,2020-07-04,3호선,매봉,5557,5293,10850
8079,2020-07-04,3호선,양재,20082,21902,41984
8080,2020-07-04,3호선,남부터미널,21068,21634,42702
8081,2020-07-04,3호선,교대,6968,4343,11311
8082,2020-07-04,3호선,고속터미널,46732,47623,94355
8083,2020-07-04,3호선,잠원,4030,3766,7796
8084,2020-07-04,3호선,신사,24545,27120,51665
8085,2020-07-04,3호선,압구정,23284,24809,48093
8086,2020-07-04,3호선,옥수,7244,7233,14477
8087,2020-07-04,3호선,금호,5824,5277,11101
8088,2020-07-04,3호선,약수,8985,8315,17300
8089,2020-07-04,3호선,동대입구,5099,5779,10878
8090,2020-07-04,3호선,충무로,1,0,1
8091,2020-07-04,3호선,을지로3가,4558,5658,10216
8092,2020-07-04,3호선,종로3가,5006,8062,13068
8093,2020-07-04,3호선,안국,11266,13541,24807
8094,2020-07-04,3호선,경복궁,12297,12991,25288
8095,2020-07-04,3호선,독립문,5429,5511,10940
8096,2020-07-04,3호선,무악재,2612,2587,5199
8097,2020-07-04,3호선,홍제,12590,11661,24251
8098,2020-07-04,3호선,녹번,9312,7978,17290
8099,2020-07-04,3호선,불광,12305,13767,26072
8100,2020-07-04,3호선,연신내,29853,27810,57663
8101,2020-07-04,3호선,구파발,15399,15566,30965
8102,2020-07-04,3호선,지축,2226,2153,4379
8103,2020-07-05,3호선,대화,6310,5651,11961
8104,2020-07-05,3호선,지축,1501,1485,2986
8105,2020-07-05,3호선,구파발,11182,11464,22646
8106,2020-07-05,3호선,연신내,21237,19843,41080
8107,2020-07-05,3호선,불광,8546,10413,18959
8108,2020-07-05,3호선,녹번,6057,5443,11500
8109,2020-07-05,3호선,홍제,8711,8129,16840
8110,2020-07-05,3호선,무악재,1707,1846,3553
8111,2020-07-05,3호선,독립문,3831,4152,7983
8112,2020-07-05,3호선,경복궁,7985,8562,16547
8113,2020-07-05,3호선,안국,7572,8808,16380
8114,2020-07-05,3호선,종로3가,3209,4451,7660
8115,2020-07-05,3호선,을지로3가,2622,2678,5300
8116,2020-07-05,3호선,동대입구,3930,4430,8360
8117,2020-07-05,3호선,약수,6209,6008,12217
8118,2020-07-05,3호선,금호,4162,3916,8078
8119,2020-07-05,3호선,옥수,4774,5098,9872
8120,2020-07-05,3호선,압구정,12234,12788,25022
8121,2020-07-05,3호선,신사,13252,13850,27102
8122,2020-07-05,3호선,잠원,2565,2535,5100
8123,2020-07-05,3호선,고속터미널,38185,34868,73053
8124,2020-07-05,3호선,교대,4003,2431,6434
8125,2020-07-05,3호선,남부터미널,14132,14340,28472
8126,2020-07-05,3호선,양재,12050,14249,26299
8127,2020-07-05,3호선,매봉,3511,3572,7083
8128,2020-07-05,3호선,도곡,1763,1816,3579
8129,2020-07-05,3호선,대치,5669,4910,10579
8130,2020-07-05,3호선,학여울,1688,1845,3533
8131,2020-07-05,3호선,대청,3587,3574,7161
8132,2020-07-05,3호선,일원,2946,3135,6081
8133,2020-07-05,3호선,수서,9397,8911,18308
8134,2020-07-05,3호선,가락시장,3568,3951,7519
8135,2020-07-05,3호선,경찰병원,2547,2684,5231
8136,2020-07-05,3호선,오금,2808,2738,5546
8137,2020-07-05,3호선,주엽,4052,3998,8050
8138,2020-07-05,3호선,정발산,4741,4989,9730
8139,2020-07-05,3호선,마두,3300,3204,6504
8140,2020-07-05,3호선,백석,5301,5141,10442
8141,2020-07-05,3호선,대곡,956,828,1784
8142,2020-07-05,3호선,화정,8862,8985,17847
8143,2020-07-05,3호선,원당,5825,5528,11353
8144,2020-07-05,3호선,삼송,9140,8799,17939
8145,2020-07-05,3호선,원흥,4309,4290,8599
8146,2020-07-06,3호선,지축,1,0,1
8147,2020-07-06,3호선,오금,6525,5707,12232
8148,2020-07-06,3호선,경찰병원,8055,8100,16155
8149,2020-07-06,3호선,가락시장,9468,9134,18602
8150,2020-07-06,3호선,수서,16222,16650,32872
8151,2020-07-06,3호선,일원,9970,9796,19766
8152,2020-07-06,3호선,대청,10386,9541,19927
8153,2020-07-06,3호선,학여울,1803,1874,3677
8154,2020-07-06,3호선,대치,10808,10875,21683
8155,2020-07-06,3호선,도곡,5576,5635,11211
8156,2020-07-06,3호선,매봉,12205,11752,23957
8157,2020-07-06,3호선,양재,38316,42278,80594
8158,2020-07-06,3호선,남부터미널,29130,29903,59033
8159,2020-07-06,3호선,교대,14790,9876,24666
8160,2020-07-06,3호선,고속터미널,38993,36234,75227
8161,2020-07-06,3호선,잠원,5890,5738,11628
8162,2020-07-06,3호선,신사,29537,31936,61473
8163,2020-07-06,3호선,압구정,31725,33870,65595
8164,2020-07-06,3호선,옥수,9251,9643,18894
8165,2020-07-06,3호선,금호,8316,7760,16076
8166,2020-07-06,3호선,약수,13246,12997,26243
8167,2020-07-06,3호선,동대입구,6896,7178,14074
8168,2020-07-06,3호선,충무로,1,0,1
8169,2020-07-06,3호선,을지로3가,10732,11467,22199
8170,2020-07-06,3호선,종로3가,10239,11995,22234
8171,2020-07-06,3호선,안국,19516,20230,39746
8172,2020-07-06,3호선,경복궁,17694,17507,35201
8173,2020-07-06,3호선,독립문,6983,7273,14256
8174,2020-07-06,3호선,무악재,3981,3953,7934
8175,2020-07-06,3호선,홍제,17503,16628,34131
8176,2020-07-06,3호선,녹번,14609,13150,27759
8177,2020-07-06,3호선,불광,16066,17307,33373
8178,2020-07-06,3호선,연신내,38046,35712,73758
8179,2020-07-06,3호선,구파발,21492,20124,41616
8180,2020-07-06,3호선,지축,3476,3357,6833
8181,2020-07-06,3호선,원흥,9186,8722,17908
8182,2020-07-06,3호선,삼송,17820,17342,35162
8183,2020-07-06,3호선,원당,11347,10807,22154
8184,2020-07-06,3호선,화정,17218,17700,34918
8185,2020-07-06,3호선,대곡,1845,1401,3246
8186,2020-07-06,3호선,백석,9993,10057,20050
8187,2020-07-06,3호선,마두,7836,7948,15784
8188,2020-07-06,3호선,정발산,7145,7252,14397
8189,2020-07-06,3호선,주엽,9058,9243,18301
8190,2020-07-06,3호선,대화,13884,10760,24644
8191,2020-07-07,3호선,매봉,12286,11707,23993
8192,2020-07-07,3호선,도곡,5492,5623,11115
8193,2020-07-07,3호선,대치,11056,10830,21886
8194,2020-07-07,3호선,학여울,1739,1788,3527
8195,2020-07-07,3호선,대청,10264,9438,19702
8196,2020-07-07,3호선,일원,10071,9888,19959
8197,2020-07-07,3호선,수서,16425,16587,33012
8198,2020-07-07,3호선,가락시장,9517,9140,18657
8199,2020-07-07,3호선,경찰병원,8005,7920,15925
8200,2020-07-07,3호선,오금,6482,5883,12365
8201,2020-07-07,3호선,금호,8378,7647,16025
8202,2020-07-07,3호선,신사,30127,32555,62682
8203,2020-07-07,3호선,잠원,5913,5772,11685
8204,2020-07-07,3호선,고속터미널,37834,36199,74033
8205,2020-07-07,3호선,교대,15227,10091,25318
8206,2020-07-07,3호선,남부터미널,29167,29993,59160
8207,2020-07-07,3호선,양재,39353,43294,82647
8208,2020-07-07,3호선,압구정,31913,34414,66327
8209,2020-07-07,3호선,옥수,9447,9703,19150
8210,2020-07-07,3호선,약수,13317,13091,26408
8211,2020-07-07,3호선,동대입구,7053,7341,14394
8212,2020-07-07,3호선,을지로3가,10967,11682,22649
8213,2020-07-07,3호선,종로3가,10167,12002,22169
8214,2020-07-07,3호선,안국,19932,20875,40807
8215,2020-07-07,3호선,경복궁,18774,18752,37526
8216,2020-07-07,3호선,독립문,7149,7425,14574
8217,2020-07-07,3호선,무악재,4007,4052,8059
8218,2020-07-07,3호선,홍제,17731,16478,34209
8219,2020-07-07,3호선,녹번,14704,13196,27900
8220,2020-07-07,3호선,불광,16487,17502,33989
8221,2020-07-07,3호선,연신내,38600,36104,74704
8222,2020-07-07,3호선,구파발,21475,20337,41812
8223,2020-07-07,3호선,지축,3492,3377,6869
8224,2020-07-07,3호선,대화,13477,10375,23852
8225,2020-07-07,3호선,주엽,8926,9152,18078
8226,2020-07-07,3호선,정발산,7098,7276,14374
8227,2020-07-07,3호선,마두,7536,7772,15308
8228,2020-07-07,3호선,백석,10150,10096,20246
8229,2020-07-07,3호선,대곡,1892,1484,3376
8230,2020-07-07,3호선,화정,17151,17888,35039
8231,2020-07-07,3호선,원당,11320,10684,22004
8232,2020-07-07,3호선,삼송,17802,17295,35097
8233,2020-07-07,3호선,원흥,9439,8843,18282
8234,2020-07-08,3호선,신사,30219,32811,63030
8235,2020-07-08,3호선,압구정,31989,34437,66426
8236,2020-07-08,3호선,옥수,9543,9837,19380
8237,2020-07-08,3호선,금호,8357,7683,16040
8238,2020-07-08,3호선,약수,13576,13311,26887
8239,2020-07-08,3호선,동대입구,7171,7574,14745
8240,2020-07-08,3호선,충무로,2,0,2
8241,2020-07-08,3호선,을지로3가,11164,11942,23106
8242,2020-07-08,3호선,종로3가,10536,12452,22988
8243,2020-07-08,3호선,안국,20437,21331,41768
8244,2020-07-08,3호선,경복궁,18927,18888,37815
8245,2020-07-08,3호선,독립문,7159,7455,14614
8246,2020-07-08,3호선,무악재,4036,3978,8014
8247,2020-07-08,3호선,홍제,17589,16651,34240
8248,2020-07-08,3호선,녹번,14862,13279,28141
8249,2020-07-08,3호선,불광,16446,17506,33952
8250,2020-07-08,3호선,연신내,38729,36474,75203
8251,2020-07-08,3호선,구파발,21855,20359,42214
8252,2020-07-08,3호선,지축,3541,3375,6916
8253,2020-07-08,3호선,경찰병원,7953,7939,15892
8254,2020-07-08,3호선,오금,6558,5895,12453
8255,2020-07-08,3호선,가락시장,9451,9234,18685
8256,2020-07-08,3호선,수서,16633,16866,33499
8257,2020-07-08,3호선,일원,10100,9741,19841
8258,2020-07-08,3호선,대청,10277,9472,19749
8259,2020-07-08,3호선,학여울,1746,1839,3585
8260,2020-07-08,3호선,대치,10880,10931,21811
8261,2020-07-08,3호선,도곡,5580,5496,11076
8262,2020-07-08,3호선,매봉,12270,11720,23990
8263,2020-07-08,3호선,양재,40160,43567,83727
8264,2020-07-08,3호선,남부터미널,29442,30078,59520
8265,2020-07-08,3호선,교대,15566,10280,25846
8266,2020-07-08,3호선,고속터미널,38666,37090,75756
8267,2020-07-08,3호선,잠원,6043,5860,11903
8268,2020-07-08,3호선,원흥,9426,8894,18320
8269,2020-07-08,3호선,삼송,17693,17059,34752
8270,2020-07-08,3호선,원당,10981,10340,21321
8271,2020-07-08,3호선,화정,17302,17725,35027
8272,2020-07-08,3호선,대곡,1862,1407,3269
8273,2020-07-08,3호선,백석,9830,9697,19527
8274,2020-07-08,3호선,마두,7764,8053,15817
8275,2020-07-08,3호선,정발산,7368,7632,15000
8276,2020-07-08,3호선,주엽,8919,9141,18060
8277,2020-07-08,3호선,대화,13506,10379,23885
8278,2020-07-09,3호선,원흥,9412,8811,18223
8279,2020-07-09,3호선,삼송,17621,17109,34730
8280,2020-07-09,3호선,원당,11010,10345,21355
8281,2020-07-09,3호선,화정,17455,17787,35242
8282,2020-07-09,3호선,대곡,1903,1467,3370
8283,2020-07-09,3호선,백석,10079,10075,20154
8284,2020-07-09,3호선,마두,7600,7769,15369
8285,2020-07-09,3호선,정발산,7088,7445,14533
8286,2020-07-09,3호선,주엽,8838,9034,17872
8287,2020-07-09,3호선,대화,13575,10515,24090
8288,2020-07-09,3호선,오금,6420,5661,12081
8289,2020-07-09,3호선,경찰병원,7956,7937,15893
8290,2020-07-09,3호선,가락시장,9415,9128,18543
8291,2020-07-09,3호선,수서,16879,16892,33771
8292,2020-07-09,3호선,일원,10152,9805,19957
8293,2020-07-09,3호선,대청,10139,9272,19411
8294,2020-07-09,3호선,학여울,1853,1906,3759
8295,2020-07-09,3호선,대치,11167,11076,22243
8296,2020-07-09,3호선,도곡,5565,5734,11299
8297,2020-07-09,3호선,매봉,12395,11727,24122
8298,2020-07-09,3호선,양재,40290,44263,84553
8299,2020-07-09,3호선,남부터미널,29331,30082,59413
8300,2020-07-09,3호선,교대,15671,10351,26022
8301,2020-07-09,3호선,고속터미널,39219,38432,77651
8302,2020-07-09,3호선,잠원,5910,5784,11694
8303,2020-07-09,3호선,신사,30921,33355,64276
8304,2020-07-09,3호선,압구정,31368,34059,65427
8305,2020-07-09,3호선,옥수,9539,9884,19423
8306,2020-07-09,3호선,금호,8379,7795,16174
8307,2020-07-09,3호선,약수,13289,13142,26431
8308,2020-07-09,3호선,동대입구,7176,7547,14723
8309,2020-07-09,3호선,충무로,1,0,1
8310,2020-07-09,3호선,을지로3가,11183,11996,23179
8311,2020-07-09,3호선,종로3가,10216,12111,22327
8312,2020-07-09,3호선,안국,20203,21142,41345
8313,2020-07-09,3호선,경복궁,18988,18931,37919
8314,2020-07-09,3호선,독립문,7095,7437,14532
8315,2020-07-09,3호선,무악재,3998,3975,7973
8316,2020-07-09,3호선,홍제,17631,16527,34158
8317,2020-07-09,3호선,녹번,14889,13234,28123
8318,2020-07-09,3호선,불광,16336,17304,33640
8319,2020-07-09,3호선,연신내,38740,36222,74962
8320,2020-07-09,3호선,구파발,21508,20241,41749
8321,2020-07-09,3호선,지축,3427,3325,6752
8322,2020-07-10,3호선,대화,13448,10408,23856
8323,2020-07-10,3호선,주엽,8772,8802,17574
8324,2020-07-10,3호선,정발산,7162,7752,14914
8325,2020-07-10,3호선,마두,7333,7815,15148
8326,2020-07-10,3호선,백석,10025,10139,20164
8327,2020-07-10,3호선,대곡,1890,1434,3324
8328,2020-07-10,3호선,화정,17081,17773,34854
8329,2020-07-10,3호선,원당,10953,10120,21073
8330,2020-07-10,3호선,삼송,17691,16761,34452
8331,2020-07-10,3호선,원흥,9327,8536,17863
8332,2020-07-10,3호선,오금,6545,5673,12218
8333,2020-07-10,3호선,경찰병원,7961,8029,15990
8334,2020-07-10,3호선,가락시장,9862,9499,19361
8335,2020-07-10,3호선,수서,18118,18509,36627
8336,2020-07-10,3호선,일원,10002,9469,19471
8337,2020-07-10,3호선,대청,10220,9146,19366
8338,2020-07-10,3호선,학여울,1924,1919,3843
8339,2020-07-10,3호선,대치,11444,11476,22920
8340,2020-07-10,3호선,도곡,5511,5460,10971
8341,2020-07-10,3호선,매봉,12359,11766,24125
8342,2020-07-10,3호선,양재,41421,43613,85034
8343,2020-07-10,3호선,남부터미널,31919,32495,64414
8344,2020-07-10,3호선,교대,16343,10551,26894
8345,2020-07-10,3호선,고속터미널,44816,47822,92638
8346,2020-07-10,3호선,잠원,6130,5850,11980
8347,2020-07-10,3호선,신사,31950,35992,67942
8348,2020-07-10,3호선,압구정,33075,36176,69251
8349,2020-07-10,3호선,옥수,9723,9889,19612
8350,2020-07-10,3호선,금호,8637,7832,16469
8351,2020-07-10,3호선,약수,13394,13202,26596
8352,2020-07-10,3호선,동대입구,7037,7402,14439
8353,2020-07-10,3호선,을지로3가,11013,12144,23157
8354,2020-07-10,3호선,종로3가,10079,12633,22712
8355,2020-07-10,3호선,안국,20036,20802,40838
8356,2020-07-10,3호선,경복궁,18687,18616,37303
8357,2020-07-10,3호선,독립문,7156,7089,14245
8358,2020-07-10,3호선,무악재,3913,3840,7753
8359,2020-07-10,3호선,홍제,17767,16543,34310
8360,2020-07-10,3호선,녹번,14861,12770,27631
8361,2020-07-10,3호선,불광,16282,17158,33440
8362,2020-07-10,3호선,연신내,38869,36492,75361
8363,2020-07-10,3호선,구파발,21028,19570,40598
8364,2020-07-10,3호선,지축,3530,3243,6773
8365,2020-07-11,3호선,원흥,6319,5828,12147
8366,2020-07-11,3호선,삼송,12784,12120,24904
8367,2020-07-11,3호선,원당,7915,7186,15101
8368,2020-07-11,3호선,화정,12316,12827,25143
8369,2020-07-11,3호선,대곡,1297,1105,2402
8370,2020-07-11,3호선,백석,7427,7525,14952
8371,2020-07-11,3호선,마두,4885,4901,9786
8372,2020-07-11,3호선,정발산,6059,6729,12788
8373,2020-07-11,3호선,주엽,6194,6335,12529
8374,2020-07-11,3호선,대화,8828,7446,16274
8375,2020-07-11,3호선,지축,2258,2127,4385
8376,2020-07-11,3호선,구파발,15326,15139,30465
8377,2020-07-11,3호선,연신내,30348,28160,58508
8378,2020-07-11,3호선,불광,12415,13792,26207
8379,2020-07-11,3호선,녹번,9583,8021,17604
8380,2020-07-11,3호선,홍제,12809,11745,24554
8381,2020-07-11,3호선,무악재,2526,2504,5030
8382,2020-07-11,3호선,독립문,5407,5448,10855
8383,2020-07-11,3호선,경복궁,12195,13131,25326
8384,2020-07-11,3호선,안국,11229,12862,24091
8385,2020-07-11,3호선,종로3가,5013,7859,12872
8386,2020-07-11,3호선,을지로3가,4516,5559,10075
8387,2020-07-11,3호선,동대입구,5639,6139,11778
8388,2020-07-11,3호선,약수,9051,8290,17341
8389,2020-07-11,3호선,금호,6069,5157,11226
8390,2020-07-11,3호선,옥수,7277,7121,14398
8391,2020-07-11,3호선,압구정,23723,24797,48520
8392,2020-07-11,3호선,신사,24260,26242,50502
8393,2020-07-11,3호선,잠원,4114,3832,7946
8394,2020-07-11,3호선,고속터미널,46984,47188,94172
8395,2020-07-11,3호선,교대,7270,4324,11594
8396,2020-07-11,3호선,남부터미널,21825,22182,44007
8397,2020-07-11,3호선,양재,20057,21501,41558
8398,2020-07-11,3호선,매봉,6000,5619,11619
8399,2020-07-11,3호선,도곡,3503,3527,7030
8400,2020-07-11,3호선,대치,8760,7620,16380
8401,2020-07-11,3호선,학여울,1336,1274,2610
8402,2020-07-11,3호선,대청,6287,5633,11920
8403,2020-07-11,3호선,일원,4945,4598,9543
8404,2020-07-11,3호선,수서,12252,12342,24594
8405,2020-07-11,3호선,가락시장,6568,6088,12656
8406,2020-07-11,3호선,경찰병원,4089,3859,7948
8407,2020-07-11,3호선,오금,4061,3769,7830
8408,2020-07-12,3호선,오금,2613,2607,5220
8409,2020-07-12,3호선,경찰병원,2501,2633,5134
8410,2020-07-12,3호선,가락시장,3457,3697,7154
8411,2020-07-12,3호선,수서,9179,9094,18273
8412,2020-07-12,3호선,일원,2865,3014,5879
8413,2020-07-12,3호선,대청,3823,3774,7597
8414,2020-07-12,3호선,학여울,805,880,1685
8415,2020-07-12,3호선,대치,5487,4846,10333
8416,2020-07-12,3호선,도곡,1552,1606,3158
8417,2020-07-12,3호선,매봉,3465,3522,6987
8418,2020-07-12,3호선,양재,12140,13944,26084
8419,2020-07-12,3호선,남부터미널,14637,14905,29542
8420,2020-07-12,3호선,교대,4327,2664,6991
8421,2020-07-12,3호선,고속터미널,38188,35311,73499
8422,2020-07-12,3호선,잠원,2402,2466,4868
8423,2020-07-12,3호선,신사,13160,13445,26605
8424,2020-07-12,3호선,압구정,11996,12571,24567
8425,2020-07-12,3호선,옥수,4686,4969,9655
8426,2020-07-12,3호선,금호,4072,3897,7969
8427,2020-07-12,3호선,약수,6184,6036,12220
8428,2020-07-12,3호선,동대입구,3960,4230,8190
8429,2020-07-12,3호선,을지로3가,2539,2689,5228
8430,2020-07-12,3호선,종로3가,3328,4768,8096
8431,2020-07-12,3호선,안국,7742,8406,16148
8432,2020-07-12,3호선,경복궁,8693,9013,17706
8433,2020-07-12,3호선,독립문,3821,4065,7886
8434,2020-07-12,3호선,무악재,1745,1929,3674
8435,2020-07-12,3호선,홍제,8540,8292,16832
8436,2020-07-12,3호선,녹번,6232,5734,11966
8437,2020-07-12,3호선,불광,8854,10749,19603
8438,2020-07-12,3호선,연신내,21114,19766,40880
8439,2020-07-12,3호선,구파발,11309,11216,22525
8440,2020-07-12,3호선,지축,1570,1590,3160
8441,2020-07-12,3호선,대화,6025,5523,11548
8442,2020-07-12,3호선,주엽,4129,4047,8176
8443,2020-07-12,3호선,정발산,4643,4645,9288
8444,2020-07-12,3호선,마두,3096,3181,6277
8445,2020-07-12,3호선,백석,5284,5291,10575
8446,2020-07-12,3호선,대곡,965,851,1816
8447,2020-07-12,3호선,화정,8633,8958,17591
8448,2020-07-12,3호선,원당,5598,5334,10932
8449,2020-07-12,3호선,삼송,8917,8774,17691
8450,2020-07-12,3호선,원흥,4396,4197,8593
8451,2020-07-13,3호선,대화,12912,9907,22819
8452,2020-07-13,3호선,주엽,8305,8428,16733
8453,2020-07-13,3호선,정발산,6084,6208,12292
8454,2020-07-13,3호선,마두,7294,7633,14927
8455,2020-07-13,3호선,백석,9587,9454,19041
8456,2020-07-13,3호선,대곡,1727,1248,2975
8457,2020-07-13,3호선,화정,15797,16378,32175
8458,2020-07-13,3호선,원당,10423,9818,20241
8459,2020-07-13,3호선,삼송,16791,16462,33253
8460,2020-07-13,3호선,원흥,8612,8101,16713
8461,2020-07-13,3호선,오금,6229,5510,11739
8462,2020-07-13,3호선,경찰병원,8154,8281,16435
8463,2020-07-13,3호선,가락시장,8889,8730,17619
8464,2020-07-13,3호선,수서,16277,16284,32561
8465,2020-07-13,3호선,일원,9556,9457,19013
8466,2020-07-13,3호선,대청,9728,9020,18748
8467,2020-07-13,3호선,학여울,1751,1796,3547
8468,2020-07-13,3호선,대치,10870,10839,21709
8469,2020-07-13,3호선,도곡,5529,5663,11192
8470,2020-07-13,3호선,매봉,11802,11307,23109
8471,2020-07-13,3호선,양재,37607,41255,78862
8472,2020-07-13,3호선,남부터미널,28334,28849,57183
8473,2020-07-13,3호선,교대,14393,9740,24133
8474,2020-07-13,3호선,고속터미널,37518,35036,72554
8475,2020-07-13,3호선,잠원,5705,5693,11398
8476,2020-07-13,3호선,신사,28384,30163,58547
8477,2020-07-13,3호선,압구정,30582,32836,63418
8478,2020-07-13,3호선,옥수,8598,9128,17726
8479,2020-07-13,3호선,금호,7855,7298,15153
8480,2020-07-13,3호선,약수,12543,12548,25091
8481,2020-07-13,3호선,동대입구,6416,6693,13109
8482,2020-07-13,3호선,충무로,1,0,1
8483,2020-07-13,3호선,을지로3가,10904,11201,22105
8484,2020-07-13,3호선,종로3가,10109,11658,21767
8485,2020-07-13,3호선,안국,18890,19027,37917
8486,2020-07-13,3호선,경복궁,17396,17177,34573
8487,2020-07-13,3호선,독립문,6503,6861,13364
8488,2020-07-13,3호선,무악재,3715,3771,7486
8489,2020-07-13,3호선,홍제,16227,15555,31782
8490,2020-07-13,3호선,녹번,14201,12736,26937
8491,2020-07-13,3호선,불광,15383,16157,31540
8492,2020-07-13,3호선,연신내,35958,34028,69986
8493,2020-07-13,3호선,구파발,20089,18739,38828
8494,2020-07-13,3호선,지축,3194,3069,6263
8495,2020-07-14,3호선,지축,3464,3312,6776
8496,2020-07-14,3호선,구파발,21365,19892,41257
8497,2020-07-14,3호선,연신내,38145,35819,73964
8498,2020-07-14,3호선,불광,16153,17299,33452
8499,2020-07-14,3호선,녹번,14844,13422,28266
8500,2020-07-14,3호선,홍제,17544,16437,33981
8501,2020-07-14,3호선,무악재,3948,3942,7890
8502,2020-07-14,3호선,독립문,7203,7333,14536
8503,2020-07-14,3호선,경복궁,19191,19266,38457
8504,2020-07-14,3호선,안국,19780,20710,40490
8505,2020-07-14,3호선,종로3가,10448,12419,22867
8506,2020-07-14,3호선,을지로3가,11005,11787,22792
8507,2020-07-14,3호선,충무로,3,0,3
8508,2020-07-14,3호선,동대입구,7215,7525,14740
8509,2020-07-14,3호선,약수,13235,13059,26294
8510,2020-07-14,3호선,금호,8389,7687,16076
8511,2020-07-14,3호선,옥수,9501,9788,19289
8512,2020-07-14,3호선,압구정,32149,34543,66692
8513,2020-07-14,3호선,신사,29911,32766,62677
8514,2020-07-14,3호선,잠원,6056,5735,11791
8515,2020-07-14,3호선,고속터미널,37520,36311,73831
8516,2020-07-14,3호선,교대,15323,10293,25616
8517,2020-07-14,3호선,남부터미널,29421,30229,59650
8518,2020-07-14,3호선,양재,39560,43307,82867
8519,2020-07-14,3호선,매봉,12260,11693,23953
8520,2020-07-14,3호선,도곡,5552,5725,11277
8521,2020-07-14,3호선,대치,10928,10922,21850
8522,2020-07-14,3호선,학여울,1866,1904,3770
8523,2020-07-14,3호선,대청,10181,9336,19517
8524,2020-07-14,3호선,일원,10039,9675,19714
8525,2020-07-14,3호선,수서,16325,16544,32869
8526,2020-07-14,3호선,가락시장,9711,9354,19065
8527,2020-07-14,3호선,경찰병원,8040,8029,16069
8528,2020-07-14,3호선,오금,6550,5902,12452
8529,2020-07-14,3호선,원흥,9328,8745,18073
8530,2020-07-14,3호선,삼송,17675,17137,34812
8531,2020-07-14,3호선,원당,11044,10534,21578
8532,2020-07-14,3호선,화정,17231,17761,34992
8533,2020-07-14,3호선,대곡,1825,1452,3277
8534,2020-07-14,3호선,백석,10129,10121,20250
8535,2020-07-14,3호선,마두,7688,7872,15560
8536,2020-07-14,3호선,정발산,7078,7269,14347
8537,2020-07-14,3호선,주엽,8863,8949,17812
8538,2020-07-14,3호선,대화,13592,10598,24190
8539,2020-07-15,3호선,지축,3536,3353,6889
8540,2020-07-15,3호선,구파발,22088,21106,43194
8541,2020-07-15,3호선,연신내,39537,36883,76420
8542,2020-07-15,3호선,불광,16858,18069,34927
8543,2020-07-15,3호선,녹번,15239,13416,28655
8544,2020-07-15,3호선,홍제,18149,16765,34914
8545,2020-07-15,3호선,무악재,4065,4008,8073
8546,2020-07-15,3호선,독립문,7377,7752,15129
8547,2020-07-15,3호선,경복궁,19807,19933,39740
8548,2020-07-15,3호선,안국,20610,21470,42080
8549,2020-07-15,3호선,종로3가,10773,12983,23756
8550,2020-07-15,3호선,을지로3가,11216,12056,23272
8551,2020-07-15,3호선,동대입구,7546,7943,15489
8552,2020-07-15,3호선,약수,13736,13590,27326
8553,2020-07-15,3호선,금호,8632,7851,16483
8554,2020-07-15,3호선,옥수,9721,10005,19726
8555,2020-07-15,3호선,압구정,32528,35183,67711
8556,2020-07-15,3호선,신사,30859,33116,63975
8557,2020-07-15,3호선,잠원,6157,5925,12082
8558,2020-07-15,3호선,고속터미널,40176,38857,79033
8559,2020-07-15,3호선,교대,15662,10361,26023
8560,2020-07-15,3호선,남부터미널,30413,31408,61821
8561,2020-07-15,3호선,양재,40085,43707,83792
8562,2020-07-15,3호선,매봉,12563,11933,24496
8563,2020-07-15,3호선,도곡,5710,5785,11495
8564,2020-07-15,3호선,대치,11124,11075,22199
8565,2020-07-15,3호선,학여울,2863,2862,5725
8566,2020-07-15,3호선,대청,10363,9394,19757
8567,2020-07-15,3호선,일원,10121,9938,20059
8568,2020-07-15,3호선,수서,17027,17374,34401
8569,2020-07-15,3호선,가락시장,9649,9522,19171
8570,2020-07-15,3호선,경찰병원,8299,8246,16545
8571,2020-07-15,3호선,오금,6597,5830,12427
8572,2020-07-15,3호선,원흥,9525,9004,18529
8573,2020-07-15,3호선,삼송,18275,17753,36028
8574,2020-07-15,3호선,원당,11661,10827,22488
8575,2020-07-15,3호선,화정,17973,18445,36418
8576,2020-07-15,3호선,대곡,1994,1572,3566
8577,2020-07-15,3호선,백석,10310,10438,20748
8578,2020-07-15,3호선,마두,7950,8200,16150
8579,2020-07-15,3호선,정발산,7667,7951,15618
8580,2020-07-15,3호선,주엽,9039,9164,18203
8581,2020-07-15,3호선,대화,13920,10809,24729
8582,2020-07-16,3호선,정발산,7238,7563,14801
8583,2020-07-16,3호선,지축,3536,3367,6903
8584,2020-07-16,3호선,구파발,21908,20707,42615
8585,2020-07-16,3호선,연신내,39074,36715,75789
8586,2020-07-16,3호선,불광,16701,17871,34572
8587,2020-07-16,3호선,녹번,15181,13487,28668
8588,2020-07-16,3호선,홍제,17760,16582,34342
8589,2020-07-16,3호선,무악재,4011,4157,8168
8590,2020-07-16,3호선,독립문,7374,7618,14992
8591,2020-07-16,3호선,경복궁,19927,20103,40030
8592,2020-07-16,3호선,안국,20821,21528,42349
8593,2020-07-16,3호선,종로3가,10573,12792,23365
8594,2020-07-16,3호선,을지로3가,10939,11945,22884
8595,2020-07-16,3호선,충무로,1,0,1
8596,2020-07-16,3호선,동대입구,7599,7894,15493
8597,2020-07-16,3호선,약수,13484,13324,26808
8598,2020-07-16,3호선,금호,8537,7719,16256
8599,2020-07-16,3호선,옥수,9717,9845,19562
8600,2020-07-16,3호선,압구정,31997,34447,66444
8601,2020-07-16,3호선,신사,30955,33625,64580
8602,2020-07-16,3호선,잠원,6080,5773,11853
8603,2020-07-16,3호선,고속터미널,40124,38966,79090
8604,2020-07-16,3호선,교대,15916,10537,26453
8605,2020-07-16,3호선,남부터미널,29882,30842,60724
8606,2020-07-16,3호선,양재,40555,44453,85008
8607,2020-07-16,3호선,매봉,12416,11778,24194
8608,2020-07-16,3호선,도곡,5572,5715,11287
8609,2020-07-16,3호선,대치,11129,11199,22328
8610,2020-07-16,3호선,학여울,2776,2930,5706
8611,2020-07-16,3호선,대청,10339,9246,19585
8612,2020-07-16,3호선,일원,10256,10076,20332
8613,2020-07-16,3호선,수서,17282,17514,34796
8614,2020-07-16,3호선,가락시장,9752,9483,19235
8615,2020-07-16,3호선,경찰병원,8218,8118,16336
8616,2020-07-16,3호선,오금,6648,5827,12475
8617,2020-07-16,3호선,대화,13997,11021,25018
8618,2020-07-16,3호선,주엽,9019,9017,18036
8619,2020-07-16,3호선,마두,7683,7928,15611
8620,2020-07-16,3호선,백석,10080,10150,20230
8621,2020-07-16,3호선,대곡,1995,1477,3472
8622,2020-07-16,3호선,화정,17457,17865,35322
8623,2020-07-16,3호선,원당,11292,10717,22009
8624,2020-07-16,3호선,삼송,18073,17389,35462
8625,2020-07-16,3호선,원흥,9453,8818,18271
8626,2020-07-17,3호선,오금,6725,5925,12650
8627,2020-07-17,3호선,경찰병원,8360,8078,16438
8628,2020-07-17,3호선,가락시장,9866,9725,19591
8629,2020-07-17,3호선,수서,18668,18943,37611
8630,2020-07-17,3호선,일원,9990,9510,19500
8631,2020-07-17,3호선,대청,10414,9397,19811
8632,2020-07-17,3호선,학여울,3062,3106,6168
8633,2020-07-17,3호선,대치,11469,11322,22791
8634,2020-07-17,3호선,도곡,5635,5606,11241
8635,2020-07-17,3호선,매봉,12432,11659,24091
8636,2020-07-17,3호선,양재,41974,44097,86071
8637,2020-07-17,3호선,남부터미널,32931,33832,66763
8638,2020-07-17,3호선,교대,16562,10549,27111
8639,2020-07-17,3호선,고속터미널,46988,50234,97222
8640,2020-07-17,3호선,잠원,6212,5986,12198
8641,2020-07-17,3호선,신사,32353,36298,68651
8642,2020-07-17,3호선,압구정,33692,37024,70716
8643,2020-07-17,3호선,옥수,9847,10169,20016
8644,2020-07-17,3호선,금호,8726,7770,16496
8645,2020-07-17,3호선,약수,13720,13439,27159
8646,2020-07-17,3호선,동대입구,7510,7822,15332
8647,2020-07-17,3호선,충무로,1,0,1
8648,2020-07-17,3호선,을지로3가,11146,12291,23437
8649,2020-07-17,3호선,종로3가,10401,13052,23453
8650,2020-07-17,3호선,안국,20464,21311,41775
8651,2020-07-17,3호선,경복궁,19752,19595,39347
8652,2020-07-17,3호선,독립문,7417,7499,14916
8653,2020-07-17,3호선,무악재,3979,3876,7855
8654,2020-07-17,3호선,홍제,18057,16752,34809
8655,2020-07-17,3호선,녹번,15315,13018,28333
8656,2020-07-17,3호선,불광,16888,17873,34761
8657,2020-07-17,3호선,연신내,39617,37264,76881
8658,2020-07-17,3호선,구파발,21757,20023,41780
8659,2020-07-17,3호선,지축,3517,3314,6831
8660,2020-07-17,3호선,원흥,9509,8762,18271
8661,2020-07-17,3호선,삼송,18312,17333,35645
8662,2020-07-17,3호선,원당,11651,10658,22309
8663,2020-07-17,3호선,화정,17800,18279,36079
8664,2020-07-17,3호선,대곡,1967,1464,3431
8665,2020-07-17,3호선,백석,10560,10672,21232
8666,2020-07-17,3호선,마두,8051,8243,16294
8667,2020-07-17,3호선,정발산,7513,8263,15776
8668,2020-07-17,3호선,주엽,9210,9509,18719
8669,2020-07-17,3호선,대화,14577,11495,26072
8670,2020-07-18,3호선,대화,9432,8352,17784
8671,2020-07-18,3호선,지축,2298,2246,4544
8672,2020-07-18,3호선,구파발,15853,15974,31827
8673,2020-07-18,3호선,연신내,30315,27804,58119
8674,2020-07-18,3호선,불광,12061,13987,26048
8675,2020-07-18,3호선,녹번,9510,8095,17605
8676,2020-07-18,3호선,홍제,12829,11865,24694
8677,2020-07-18,3호선,무악재,2591,2542,5133
8678,2020-07-18,3호선,독립문,5540,5781,11321
8679,2020-07-18,3호선,경복궁,12515,13238,25753
8680,2020-07-18,3호선,안국,11294,13132,24426
8681,2020-07-18,3호선,종로3가,5461,8690,14151
8682,2020-07-18,3호선,을지로3가,4705,5804,10509
8683,2020-07-18,3호선,충무로,3,0,3
8684,2020-07-18,3호선,동대입구,6075,6528,12603
8685,2020-07-18,3호선,약수,8921,8369,17290
8686,2020-07-18,3호선,금호,5708,5235,10943
8687,2020-07-18,3호선,옥수,7034,7036,14070
8688,2020-07-18,3호선,압구정,23769,25226,48995
8689,2020-07-18,3호선,신사,23956,26150,50106
8690,2020-07-18,3호선,잠원,4100,3853,7953
8691,2020-07-18,3호선,고속터미널,48083,48852,96935
8692,2020-07-18,3호선,교대,6867,4363,11230
8693,2020-07-18,3호선,남부터미널,22224,22534,44758
8694,2020-07-18,3호선,양재,19732,21434,41166
8695,2020-07-18,3호선,매봉,5478,5259,10737
8696,2020-07-18,3호선,도곡,3264,3316,6580
8697,2020-07-18,3호선,대치,8302,7363,15665
8698,2020-07-18,3호선,학여울,1108,1124,2232
8699,2020-07-18,3호선,대청,6554,6025,12579
8700,2020-07-18,3호선,일원,4262,4173,8435
8701,2020-07-18,3호선,수서,12335,12402,24737
8702,2020-07-18,3호선,가락시장,6263,5925,12188
8703,2020-07-18,3호선,경찰병원,4050,3896,7946
8704,2020-07-18,3호선,오금,3818,3584,7402
8705,2020-07-18,3호선,원흥,6377,5875,12252
8706,2020-07-18,3호선,삼송,12588,11925,24513
8707,2020-07-18,3호선,원당,8032,7510,15542
8708,2020-07-18,3호선,화정,12681,13047,25728
8709,2020-07-18,3호선,대곡,1293,1135,2428
8710,2020-07-18,3호선,백석,7381,7527,14908
8711,2020-07-18,3호선,마두,4967,5086,10053
8712,2020-07-18,3호선,정발산,5946,6461,12407
8713,2020-07-18,3호선,주엽,6374,6235,12609
8714,2020-07-19,3호선,오금,2564,2496,5060
8715,2020-07-19,3호선,경찰병원,2368,2461,4829
8716,2020-07-19,3호선,가락시장,3176,3476,6652
8717,2020-07-19,3호선,수서,8700,8410,17110
8718,2020-07-19,3호선,일원,2575,2845,5420
8719,2020-07-19,3호선,대청,3751,3710,7461
8720,2020-07-19,3호선,학여울,601,614,1215
8721,2020-07-19,3호선,대치,4577,4111,8688
8722,2020-07-19,3호선,도곡,1610,1657,3267
8723,2020-07-19,3호선,매봉,3188,3224,6412
8724,2020-07-19,3호선,양재,10515,12475,22990
8725,2020-07-19,3호선,남부터미널,13406,13470,26876
8726,2020-07-19,3호선,교대,3604,2368,5972
8727,2020-07-19,3호선,고속터미널,35451,32483,67934
8728,2020-07-19,3호선,잠원,2198,2217,4415
8729,2020-07-19,3호선,신사,11143,11766,22909
8730,2020-07-19,3호선,압구정,11365,11987,23352
8731,2020-07-19,3호선,옥수,3947,4322,8269
8732,2020-07-19,3호선,금호,3534,3404,6938
8733,2020-07-19,3호선,약수,5373,5255,10628
8734,2020-07-19,3호선,동대입구,4028,4228,8256
8735,2020-07-19,3호선,을지로3가,2173,2393,4566
8736,2020-07-19,3호선,종로3가,3224,4320,7544
8737,2020-07-19,3호선,안국,5952,6423,12375
8738,2020-07-19,3호선,경복궁,6582,6742,13324
8739,2020-07-19,3호선,독립문,3030,3163,6193
8740,2020-07-19,3호선,무악재,1507,1575,3082
8741,2020-07-19,3호선,홍제,7421,7163,14584
8742,2020-07-19,3호선,녹번,5536,4839,10375
8743,2020-07-19,3호선,불광,7049,8108,15157
8744,2020-07-19,3호선,연신내,17742,17164,34906
8745,2020-07-19,3호선,구파발,8959,9111,18070
8746,2020-07-19,3호선,지축,1276,1298,2574
8747,2020-07-19,3호선,원흥,3734,3681,7415
8748,2020-07-19,3호선,삼송,7959,7327,15286
8749,2020-07-19,3호선,원당,4890,4660,9550
8750,2020-07-19,3호선,화정,7785,8010,15795
8751,2020-07-19,3호선,대곡,798,704,1502
8752,2020-07-19,3호선,백석,4829,4552,9381
8753,2020-07-19,3호선,마두,2771,2875,5646
8754,2020-07-19,3호선,정발산,3932,3817,7749
8755,2020-07-19,3호선,주엽,3685,3512,7197
8756,2020-07-19,3호선,대화,5828,5300,11128
8757,2020-07-20,3호선,지축,3311,3183,6494
8758,2020-07-20,3호선,구파발,20471,19295,39766
8759,2020-07-20,3호선,연신내,37213,34758,71971
8760,2020-07-20,3호선,불광,15641,16528,32169
8761,2020-07-20,3호선,녹번,14519,13079,27598
8762,2020-07-20,3호선,홍제,17007,16091,33098
8763,2020-07-20,3호선,무악재,3751,3831,7582
8764,2020-07-20,3호선,독립문,6693,6843,13536
8765,2020-07-20,3호선,경복궁,17101,16953,34054
8766,2020-07-20,3호선,안국,18933,19651,38584
8767,2020-07-20,3호선,종로3가,10215,11989,22204
8768,2020-07-20,3호선,을지로3가,10686,11369,22055
8769,2020-07-20,3호선,충무로,1,0,1
8770,2020-07-20,3호선,동대입구,6698,7024,13722
8771,2020-07-20,3호선,약수,12897,12622,25519
8772,2020-07-20,3호선,금호,8221,7624,15845
8773,2020-07-20,3호선,옥수,9112,9368,18480
8774,2020-07-20,3호선,압구정,31402,33981,65383
8775,2020-07-20,3호선,신사,28999,31519,60518
8776,2020-07-20,3호선,잠원,5769,5557,11326
8777,2020-07-20,3호선,고속터미널,33543,31175,64718
8778,2020-07-20,3호선,교대,14604,9907,24511
8779,2020-07-20,3호선,남부터미널,28244,28961,57205
8780,2020-07-20,3호선,양재,37591,41476,79067
8781,2020-07-20,3호선,매봉,11860,11296,23156
8782,2020-07-20,3호선,도곡,5500,5573,11073
8783,2020-07-20,3호선,대치,10776,10710,21486
8784,2020-07-20,3호선,학여울,1726,1799,3525
8785,2020-07-20,3호선,대청,9817,8944,18761
8786,2020-07-20,3호선,일원,9841,9685,19526
8787,2020-07-20,3호선,수서,16320,16469,32789
8788,2020-07-20,3호선,가락시장,9033,8710,17743
8789,2020-07-20,3호선,경찰병원,7891,8073,15964
8790,2020-07-20,3호선,오금,6438,5733,12171
8791,2020-07-20,3호선,원흥,8860,8352,17212
8792,2020-07-20,3호선,지축,1,0,1
8793,2020-07-20,3호선,삼송,17505,16801,34306
8794,2020-07-20,3호선,원당,10751,10245,20996
8795,2020-07-20,3호선,화정,16828,17140,33968
8796,2020-07-20,3호선,대곡,1731,1260,2991
8797,2020-07-20,3호선,백석,9681,9520,19201
8798,2020-07-20,3호선,마두,7273,7570,14843
8799,2020-07-20,3호선,정발산,6641,6830,13471
8800,2020-07-20,3호선,주엽,8661,8793,17454
8801,2020-07-20,3호선,대화,13292,10025,23317
8802,2020-07-21,3호선,금호,8543,7966,16509
8803,2020-07-21,3호선,옥수,9593,10000,19593
8804,2020-07-21,3호선,압구정,32953,35477,68430
8805,2020-07-21,3호선,신사,31277,33676,64953
8806,2020-07-21,3호선,잠원,6075,5762,11837
8807,2020-07-21,3호선,고속터미널,40427,38986,79413
8808,2020-07-21,3호선,교대,15536,10320,25856
8809,2020-07-21,3호선,남부터미널,29556,30573,60129
8810,2020-07-21,3호선,양재,40370,44132,84502
8811,2020-07-21,3호선,매봉,12499,11972,24471
8812,2020-07-21,3호선,도곡,5618,5749,11367
8813,2020-07-21,3호선,대치,10887,10717,21604
8814,2020-07-21,3호선,학여울,1973,2030,4003
8815,2020-07-21,3호선,대청,10207,9336,19543
8816,2020-07-21,3호선,일원,10195,9906,20101
8817,2020-07-21,3호선,수서,16848,16887,33735
8818,2020-07-21,3호선,가락시장,9657,9460,19117
8819,2020-07-21,3호선,경찰병원,8081,8139,16220
8820,2020-07-21,3호선,오금,6659,5985,12644
8821,2020-07-21,3호선,원흥,9371,8889,18260
8822,2020-07-21,3호선,삼송,18267,17526,35793
8823,2020-07-21,3호선,원당,11549,10795,22344
8824,2020-07-21,3호선,화정,17465,18055,35520
8825,2020-07-21,3호선,대곡,1984,1483,3467
8826,2020-07-21,3호선,백석,10390,10311,20701
8827,2020-07-21,3호선,마두,7820,8195,16015
8828,2020-07-21,3호선,정발산,7191,7487,14678
8829,2020-07-21,3호선,주엽,9111,9199,18310
8830,2020-07-21,3호선,대화,13769,10610,24379
8831,2020-07-21,3호선,지축,3521,3424,6945
8832,2020-07-21,3호선,구파발,22081,20923,43004
8833,2020-07-21,3호선,연신내,39370,36589,75959
8834,2020-07-21,3호선,불광,16737,17766,34503
8835,2020-07-21,3호선,녹번,15010,13563,28573
8836,2020-07-21,3호선,홍제,17593,16662,34255
8837,2020-07-21,3호선,무악재,4090,4036,8126
8838,2020-07-21,3호선,독립문,7244,7512,14756
8839,2020-07-21,3호선,경복궁,19188,18986,38174
8840,2020-07-21,3호선,안국,20656,21560,42216
8841,2020-07-21,3호선,종로3가,10717,12703,23420
8842,2020-07-21,3호선,을지로3가,11069,11787,22856
8843,2020-07-21,3호선,충무로,2,0,2
8844,2020-07-21,3호선,동대입구,7614,8079,15693
8845,2020-07-21,3호선,약수,13671,13382,27053
8846,2020-07-22,3호선,지축,3490,3347,6837
8847,2020-07-22,3호선,구파발,21241,19981,41222
8848,2020-07-22,3호선,연신내,37968,35673,73641
8849,2020-07-22,3호선,불광,16291,17221,33512
8850,2020-07-22,3호선,녹번,14857,13290,28147
8851,2020-07-22,3호선,홍제,17561,16523,34084
8852,2020-07-22,3호선,무악재,3992,4021,8013
8853,2020-07-22,3호선,독립문,6962,7240,14202
8854,2020-07-22,3호선,경복궁,18928,18823,37751
8855,2020-07-22,3호선,안국,20547,21311,41858
8856,2020-07-22,3호선,종로3가,10572,12678,23250
8857,2020-07-22,3호선,을지로3가,11040,11921,22961
8858,2020-07-22,3호선,충무로,1,0,1
8859,2020-07-22,3호선,동대입구,7367,7685,15052
8860,2020-07-22,3호선,약수,13472,13097,26569
8861,2020-07-22,3호선,금호,8410,7668,16078
8862,2020-07-22,3호선,옥수,9317,9615,18932
8863,2020-07-22,3호선,압구정,31808,34372,66180
8864,2020-07-22,3호선,신사,29823,32234,62057
8865,2020-07-22,3호선,잠원,5824,5631,11455
8866,2020-07-22,3호선,고속터미널,38555,37330,75885
8867,2020-07-22,3호선,교대,15172,10137,25309
8868,2020-07-22,3호선,남부터미널,29529,30367,59896
8869,2020-07-22,3호선,양재,39184,43023,82207
8870,2020-07-22,3호선,매봉,12357,11834,24191
8871,2020-07-22,3호선,도곡,5425,5510,10935
8872,2020-07-22,3호선,대치,10584,10479,21063
8873,2020-07-22,3호선,학여울,1864,1868,3732
8874,2020-07-22,3호선,대청,10075,9116,19191
8875,2020-07-22,3호선,일원,9686,9506,19192
8876,2020-07-22,3호선,수서,16736,16853,33589
8877,2020-07-22,3호선,가락시장,9240,8908,18148
8878,2020-07-22,3호선,경찰병원,7889,7888,15777
8879,2020-07-22,3호선,오금,6538,5798,12336
8880,2020-07-22,3호선,대화,13611,10472,24083
8881,2020-07-22,3호선,주엽,8885,8963,17848
8882,2020-07-22,3호선,정발산,6912,7162,14074
8883,2020-07-22,3호선,마두,7533,7875,15408
8884,2020-07-22,3호선,백석,9724,9706,19430
8885,2020-07-22,3호선,대곡,1793,1399,3192
8886,2020-07-22,3호선,화정,17025,17388,34413
8887,2020-07-22,3호선,원당,10951,10468,21419
8888,2020-07-22,3호선,삼송,17624,16938,34562
8889,2020-07-22,3호선,원흥,9074,8463,17537
8890,2020-07-23,3호선,지축,3267,3196,6463
8891,2020-07-23,3호선,구파발,20588,19599,40187
8892,2020-07-23,3호선,연신내,36808,34349,71157
8893,2020-07-23,3호선,불광,15621,16166,31787
8894,2020-07-23,3호선,녹번,14465,13118,27583
8895,2020-07-23,3호선,홍제,16821,16418,33239
8896,2020-07-23,3호선,무악재,3837,4089,7926
8897,2020-07-23,3호선,독립문,6473,6957,13430
8898,2020-07-23,3호선,경복궁,19091,18556,37647
8899,2020-07-23,3호선,안국,21160,20698,41858
8900,2020-07-23,3호선,종로3가,11013,12300,23313
8901,2020-07-23,3호선,을지로3가,12076,11706,23782
8902,2020-07-23,3호선,충무로,1,0,1
8903,2020-07-23,3호선,동대입구,6998,7165,14163
8904,2020-07-23,3호선,약수,13037,13055,26092
8905,2020-07-23,3호선,금호,8099,7546,15645
8906,2020-07-23,3호선,옥수,9033,9683,18716
8907,2020-07-23,3호선,압구정,31171,33785,64956
8908,2020-07-23,3호선,신사,30223,31807,62030
8909,2020-07-23,3호선,잠원,5773,5722,11495
8910,2020-07-23,3호선,고속터미널,40376,38710,79086
8911,2020-07-23,3호선,교대,15399,10335,25734
8912,2020-07-23,3호선,남부터미널,29823,30420,60243
8913,2020-07-23,3호선,양재,40574,43167,83741
8914,2020-07-23,3호선,매봉,12362,11852,24214
8915,2020-07-23,3호선,도곡,5434,5646,11080
8916,2020-07-23,3호선,대치,10706,10884,21590
8917,2020-07-23,3호선,학여울,2000,2103,4103
8918,2020-07-23,3호선,대청,10299,9235,19534
8919,2020-07-23,3호선,일원,9922,9814,19736
8920,2020-07-23,3호선,수서,16950,17189,34139
8921,2020-07-23,3호선,가락시장,8998,8981,17979
8922,2020-07-23,3호선,경찰병원,7857,7919,15776
8923,2020-07-23,3호선,오금,6457,5814,12271
8924,2020-07-23,3호선,원흥,8800,8265,17065
8925,2020-07-23,3호선,삼송,16800,16555,33355
8926,2020-07-23,3호선,원당,10339,9801,20140
8927,2020-07-23,3호선,화정,16045,16723,32768
8928,2020-07-23,3호선,대곡,1732,1267,2999
8929,2020-07-23,3호선,백석,9565,9786,19351
8930,2020-07-23,3호선,마두,7290,7595,14885
8931,2020-07-23,3호선,정발산,6484,6611,13095
8932,2020-07-23,3호선,주엽,8417,8684,17101
8933,2020-07-23,3호선,대화,13145,10272,23417
8934,2020-07-24,3호선,원흥,9355,8596,17951
8935,2020-07-24,3호선,삼송,18163,17311,35474
8936,2020-07-24,3호선,원당,11124,10333,21457
8937,2020-07-24,3호선,화정,17509,18039,35548
8938,2020-07-24,3호선,대곡,1845,1414,3259
8939,2020-07-24,3호선,백석,10344,10331,20675
8940,2020-07-24,3호선,마두,7713,7947,15660
8941,2020-07-24,3호선,정발산,7087,7770,14857
8942,2020-07-24,3호선,주엽,8975,9159,18134
8943,2020-07-24,3호선,대화,13629,10471,24100
8944,2020-07-24,3호선,지축,3521,3188,6709
8945,2020-07-24,3호선,구파발,21454,19676,41130
8946,2020-07-24,3호선,연신내,39274,36741,76015
8947,2020-07-24,3호선,불광,16495,17271,33766
8948,2020-07-24,3호선,녹번,15120,13001,28121
8949,2020-07-24,3호선,홍제,17656,16358,34014
8950,2020-07-24,3호선,무악재,3987,3839,7826
8951,2020-07-24,3호선,독립문,7086,7128,14214
8952,2020-07-24,3호선,경복궁,19120,18903,38023
8953,2020-07-24,3호선,안국,19980,20694,40674
8954,2020-07-24,3호선,종로3가,10274,12909,23183
8955,2020-07-24,3호선,을지로3가,11232,12369,23601
8956,2020-07-24,3호선,동대입구,7052,7231,14283
8957,2020-07-24,3호선,약수,13520,13319,26839
8958,2020-07-24,3호선,금호,8672,7793,16465
8959,2020-07-24,3호선,옥수,9667,9769,19436
8960,2020-07-24,3호선,압구정,33188,36476,69664
8961,2020-07-24,3호선,신사,30982,35407,66389
8962,2020-07-24,3호선,잠원,6049,5714,11763
8963,2020-07-24,3호선,고속터미널,45197,48774,93971
8964,2020-07-24,3호선,교대,15478,10407,25885
8965,2020-07-24,3호선,남부터미널,32004,33415,65419
8966,2020-07-24,3호선,양재,41767,43956,85723
8967,2020-07-24,3호선,매봉,12349,11808,24157
8968,2020-07-24,3호선,도곡,5397,5352,10749
8969,2020-07-24,3호선,대치,11092,10709,21801
8970,2020-07-24,3호선,학여울,2139,2185,4324
8971,2020-07-24,3호선,대청,10247,9216,19463
8972,2020-07-24,3호선,일원,9854,9532,19386
8973,2020-07-24,3호선,수서,18255,18695,36950
8974,2020-07-24,3호선,가락시장,9919,9717,19636
8975,2020-07-24,3호선,경찰병원,7805,7661,15466
8976,2020-07-24,3호선,오금,6676,5811,12487
8977,2020-07-25,3호선,오금,3673,3398,7071
8978,2020-07-25,3호선,경찰병원,3957,3672,7629
8979,2020-07-25,3호선,가락시장,6422,5885,12307
8980,2020-07-25,3호선,수서,12240,12403,24643
8981,2020-07-25,3호선,일원,4705,4583,9288
8982,2020-07-25,3호선,대청,5653,5115,10768
8983,2020-07-25,3호선,학여울,1540,1512,3052
8984,2020-07-25,3호선,대치,7990,7188,15178
8985,2020-07-25,3호선,도곡,2928,2824,5752
8986,2020-07-25,3호선,매봉,5573,5420,10993
8987,2020-07-25,3호선,양재,18697,20325,39022
8988,2020-07-25,3호선,남부터미널,21446,22076,43522
8989,2020-07-25,3호선,교대,6921,4518,11439
8990,2020-07-25,3호선,고속터미널,45737,47425,93162
8991,2020-07-25,3호선,잠원,4039,3906,7945
8992,2020-07-25,3호선,대화,8541,7448,15989
8993,2020-07-25,3호선,주엽,6461,6354,12815
8994,2020-07-25,3호선,정발산,5853,6301,12154
8995,2020-07-25,3호선,마두,4987,5030,10017
8996,2020-07-25,3호선,백석,7505,7461,14966
8997,2020-07-25,3호선,대곡,1361,1151,2512
8998,2020-07-25,3호선,화정,12554,12884,25438
8999,2020-07-25,3호선,원당,7927,7548,15475
9000,2020-07-25,3호선,삼송,12939,12449,25388
9001,2020-07-25,3호선,원흥,6328,5737,12065
9002,2020-07-25,3호선,신사,22457,25045,47502
9003,2020-07-25,3호선,압구정,23746,25389,49135
9004,2020-07-25,3호선,옥수,7139,7057,14196
9005,2020-07-25,3호선,금호,5968,5322,11290
9006,2020-07-25,3호선,약수,8853,8141,16994
9007,2020-07-25,3호선,동대입구,5587,6163,11750
9008,2020-07-25,3호선,충무로,2,0,2
9009,2020-07-25,3호선,을지로3가,4893,5963,10856
9010,2020-07-25,3호선,종로3가,5515,8761,14276
9011,2020-07-25,3호선,안국,12189,14315,26504
9012,2020-07-25,3호선,경복궁,13076,13849,26925
9013,2020-07-25,3호선,독립문,5480,5498,10978
9014,2020-07-25,3호선,무악재,2563,2601,5164
9015,2020-07-25,3호선,홍제,12688,11775,24463
9016,2020-07-25,3호선,녹번,9430,8033,17463
9017,2020-07-25,3호선,불광,12221,14010,26231
9018,2020-07-25,3호선,연신내,30307,28017,58324
9019,2020-07-25,3호선,구파발,15322,15394,30716
9020,2020-07-25,3호선,지축,2184,2126,4310
9021,2020-07-26,3호선,원흥,4513,4355,8868
9022,2020-07-26,3호선,삼송,9386,9073,18459
9023,2020-07-26,3호선,원당,5914,5777,11691
9024,2020-07-26,3호선,화정,9007,9194,18201
9025,2020-07-26,3호선,대곡,1101,933,2034
9026,2020-07-26,3호선,백석,5468,5407,10875
9027,2020-07-26,3호선,마두,3281,3286,6567
9028,2020-07-26,3호선,정발산,4799,4937,9736
9029,2020-07-26,3호선,주엽,4219,4262,8481
9030,2020-07-26,3호선,대화,6292,5527,11819
9031,2020-07-26,3호선,오금,2658,2647,5305
9032,2020-07-26,3호선,경찰병원,2486,2660,5146
9033,2020-07-26,3호선,가락시장,3258,3608,6866
9034,2020-07-26,3호선,수서,9310,9141,18451
9035,2020-07-26,3호선,일원,2908,3032,5940
9036,2020-07-26,3호선,대청,3755,3587,7342
9037,2020-07-26,3호선,학여울,1156,1233,2389
9038,2020-07-26,3호선,대치,4752,4393,9145
9039,2020-07-26,3호선,도곡,1701,1702,3403
9040,2020-07-26,3호선,매봉,3608,3530,7138
9041,2020-07-26,3호선,양재,11458,13127,24585
9042,2020-07-26,3호선,남부터미널,15021,15291,30312
9043,2020-07-26,3호선,교대,4047,2496,6543
9044,2020-07-26,3호선,고속터미널,38043,35874,73917
9045,2020-07-26,3호선,잠원,2561,2507,5068
9046,2020-07-26,3호선,신사,12450,12800,25250
9047,2020-07-26,3호선,압구정,12736,13538,26274
9048,2020-07-26,3호선,옥수,4874,5118,9992
9049,2020-07-26,3호선,금호,4223,3986,8209
9050,2020-07-26,3호선,약수,6315,6320,12635
9051,2020-07-26,3호선,동대입구,4653,5014,9667
9052,2020-07-26,3호선,을지로3가,2737,2958,5695
9053,2020-07-26,3호선,종로3가,3516,4970,8486
9054,2020-07-26,3호선,안국,8096,9285,17381
9055,2020-07-26,3호선,경복궁,9369,9942,19311
9056,2020-07-26,3호선,독립문,4032,4354,8386
9057,2020-07-26,3호선,무악재,1672,1771,3443
9058,2020-07-26,3호선,홍제,8799,8356,17155
9059,2020-07-26,3호선,녹번,6359,5659,12018
9060,2020-07-26,3호선,불광,9079,10916,19995
9061,2020-07-26,3호선,연신내,21845,20371,42216
9062,2020-07-26,3호선,구파발,11488,11676,23164
9063,2020-07-26,3호선,지축,1572,1529,3101
9064,2020-07-27,3호선,지축,3327,3238,6565
9065,2020-07-27,3호선,구파발,20711,19314,40025
9066,2020-07-27,3호선,연신내,37702,35350,73052
9067,2020-07-27,3호선,불광,15981,16840,32821
9068,2020-07-27,3호선,녹번,14453,13030,27483
9069,2020-07-27,3호선,홍제,17073,16235,33308
9070,2020-07-27,3호선,무악재,3829,3883,7712
9071,2020-07-27,3호선,독립문,6812,7068,13880
9072,2020-07-27,3호선,경복궁,17404,16976,34380
9073,2020-07-27,3호선,안국,19466,20003,39469
9074,2020-07-27,3호선,종로3가,10446,12261,22707
9075,2020-07-27,3호선,을지로3가,10858,11349,22207
9076,2020-07-27,3호선,충무로,2,0,2
9077,2020-07-27,3호선,동대입구,6610,6838,13448
9078,2020-07-27,3호선,약수,12956,12737,25693
9079,2020-07-27,3호선,금호,8105,7513,15618
9080,2020-07-27,3호선,옥수,8886,9295,18181
9081,2020-07-27,3호선,압구정,29386,31923,61309
9082,2020-07-27,3호선,신사,28887,31188,60075
9083,2020-07-27,3호선,잠원,5651,5576,11227
9084,2020-07-27,3호선,고속터미널,39403,36858,76261
9085,2020-07-27,3호선,교대,13973,9552,23525
9086,2020-07-27,3호선,남부터미널,28699,29608,58307
9087,2020-07-27,3호선,양재,37697,41381,79078
9088,2020-07-27,3호선,매봉,11905,11289,23194
9089,2020-07-27,3호선,도곡,5460,5559,11019
9090,2020-07-27,3호선,대치,10684,10620,21304
9091,2020-07-27,3호선,학여울,1714,1734,3448
9092,2020-07-27,3호선,대청,10103,9145,19248
9093,2020-07-27,3호선,일원,9798,9758,19556
9094,2020-07-27,3호선,수서,16457,16509,32966
9095,2020-07-27,3호선,가락시장,9101,8917,18018
9096,2020-07-27,3호선,경찰병원,7715,7793,15508
9097,2020-07-27,3호선,오금,6353,5680,12033
9098,2020-07-27,3호선,대화,13967,9800,23767
9099,2020-07-27,3호선,주엽,8804,8944,17748
9100,2020-07-27,3호선,정발산,6912,6958,13870
9101,2020-07-27,3호선,마두,7461,7709,15170
9102,2020-07-27,3호선,백석,9589,9669,19258
9103,2020-07-27,3호선,대곡,1817,1367,3184
9104,2020-07-27,3호선,화정,16774,17295,34069
9105,2020-07-27,3호선,원당,10966,10305,21271
9106,2020-07-27,3호선,삼송,17512,16894,34406
9107,2020-07-27,3호선,원흥,9058,8455,17513
9108,2020-07-28,3호선,오금,6541,5799,12340
9109,2020-07-28,3호선,경찰병원,7648,7565,15213
9110,2020-07-28,3호선,가락시장,9368,9135,18503
9111,2020-07-28,3호선,수서,16607,16990,33597
9112,2020-07-28,3호선,일원,9679,9393,19072
9113,2020-07-28,3호선,대청,10213,9279,19492
9114,2020-07-28,3호선,학여울,1732,1809,3541
9115,2020-07-28,3호선,대치,10937,10757,21694
9116,2020-07-28,3호선,도곡,5528,5648,11176
9117,2020-07-28,3호선,매봉,12346,11722,24068
9118,2020-07-28,3호선,양재,39151,42412,81563
9119,2020-07-28,3호선,남부터미널,29910,30722,60632
9120,2020-07-28,3호선,교대,14412,9712,24124
9121,2020-07-28,3호선,고속터미널,39174,37785,76959
9122,2020-07-28,3호선,잠원,5823,5616,11439
9123,2020-07-28,3호선,신사,30111,32749,62860
9124,2020-07-28,3호선,압구정,32409,34839,67248
9125,2020-07-28,3호선,옥수,9309,9545,18854
9126,2020-07-28,3호선,금호,8371,7715,16086
9127,2020-07-28,3호선,약수,13356,13080,26436
9128,2020-07-28,3호선,동대입구,7090,7187,14277
9129,2020-07-28,3호선,을지로3가,10967,11643,22610
9130,2020-07-28,3호선,종로3가,10117,12060,22177
9131,2020-07-28,3호선,안국,20265,21013,41278
9132,2020-07-28,3호선,경복궁,18675,18785,37460
9133,2020-07-28,3호선,독립문,7210,7503,14713
9134,2020-07-28,3호선,무악재,3916,3899,7815
9135,2020-07-28,3호선,홍제,17596,16449,34045
9136,2020-07-28,3호선,녹번,14907,13269,28176
9137,2020-07-28,3호선,불광,16501,17524,34025
9138,2020-07-28,3호선,연신내,38399,36011,74410
9139,2020-07-28,3호선,구파발,21472,20177,41649
9140,2020-07-28,3호선,지축,3476,3346,6822
9141,2020-07-28,3호선,대화,14066,9800,23866
9142,2020-07-28,3호선,주엽,8979,9154,18133
9143,2020-07-28,3호선,정발산,7013,7253,14266
9144,2020-07-28,3호선,마두,7680,7851,15531
9145,2020-07-28,3호선,백석,9945,10061,20006
9146,2020-07-28,3호선,대곡,1857,1405,3262
9147,2020-07-28,3호선,화정,17225,17737,34962
9148,2020-07-28,3호선,원당,11135,10645,21780
9149,2020-07-28,3호선,삼송,17896,17187,35083
9150,2020-07-28,3호선,원흥,9146,8619,17765
9151,2020-07-29,3호선,마두,7134,7446,14580
9152,2020-07-29,3호선,정발산,6764,6850,13614
9153,2020-07-29,3호선,주엽,8524,8536,17060
9154,2020-07-29,3호선,대화,13508,9292,22800
9155,2020-07-29,3호선,지축,3251,3120,6371
9156,2020-07-29,3호선,구파발,20822,19779,40601
9157,2020-07-29,3호선,연신내,37080,34652,71732
9158,2020-07-29,3호선,불광,15756,16618,32374
9159,2020-07-29,3호선,녹번,14574,12836,27410
9160,2020-07-29,3호선,홍제,16832,15948,32780
9161,2020-07-29,3호선,무악재,3850,3881,7731
9162,2020-07-29,3호선,독립문,6852,7141,13993
9163,2020-07-29,3호선,경복궁,18539,17981,36520
9164,2020-07-29,3호선,안국,20483,21199,41682
9165,2020-07-29,3호선,종로3가,10533,12384,22917
9166,2020-07-29,3호선,을지로3가,10944,11715,22659
9167,2020-07-29,3호선,충무로,2,0,2
9168,2020-07-29,3호선,동대입구,6834,7129,13963
9169,2020-07-29,3호선,약수,12944,12701,25645
9170,2020-07-29,3호선,금호,8071,7475,15546
9171,2020-07-29,3호선,옥수,8990,9354,18344
9172,2020-07-29,3호선,압구정,30942,33751,64693
9173,2020-07-29,3호선,신사,29130,31528,60658
9174,2020-07-29,3호선,잠원,5560,5431,10991
9175,2020-07-29,3호선,고속터미널,39057,38332,77389
9176,2020-07-29,3호선,교대,13823,9492,23315
9177,2020-07-29,3호선,남부터미널,29341,30492,59833
9178,2020-07-29,3호선,양재,38259,41546,79805
9179,2020-07-29,3호선,매봉,11969,11514,23483
9180,2020-07-29,3호선,도곡,5460,5550,11010
9181,2020-07-29,3호선,대치,10692,10382,21074
9182,2020-07-29,3호선,학여울,1734,1809,3543
9183,2020-07-29,3호선,대청,10106,9083,19189
9184,2020-07-29,3호선,일원,9820,9620,19440
9185,2020-07-29,3호선,수서,16504,16652,33156
9186,2020-07-29,3호선,가락시장,8874,8857,17731
9187,2020-07-29,3호선,경찰병원,7670,7634,15304
9188,2020-07-29,3호선,오금,6279,5588,11867
9189,2020-07-29,3호선,백석,9365,9328,18693
9190,2020-07-29,3호선,대곡,1728,1309,3037
9191,2020-07-29,3호선,화정,16657,16860,33517
9192,2020-07-29,3호선,원당,10690,9997,20687
9193,2020-07-29,3호선,삼송,17156,16618,33774
9194,2020-07-29,3호선,원흥,8988,8361,17349
9195,2020-07-30,3호선,주엽,8776,8786,17562
9196,2020-07-30,3호선,정발산,7211,7597,14808
9197,2020-07-30,3호선,마두,7470,7651,15121
9198,2020-07-30,3호선,백석,9968,10045,20013
9199,2020-07-30,3호선,대곡,1879,1424,3303
9200,2020-07-30,3호선,화정,17170,17456,34626
9201,2020-07-30,3호선,원당,10830,10203,21033
9202,2020-07-30,3호선,삼송,17955,17270,35225
9203,2020-07-30,3호선,원흥,9258,8615,17873
9204,2020-07-30,3호선,오금,6282,5606,11888
9205,2020-07-30,3호선,경찰병원,7551,7540,15091
9206,2020-07-30,3호선,가락시장,9326,9063,18389
9207,2020-07-30,3호선,수서,16599,16993,33592
9208,2020-07-30,3호선,일원,9760,9400,19160
9209,2020-07-30,3호선,대청,10204,9033,19237
9210,2020-07-30,3호선,학여울,1995,2041,4036
9211,2020-07-30,3호선,대치,10397,10153,20550
9212,2020-07-30,3호선,도곡,5312,5570,10882
9213,2020-07-30,3호선,매봉,11881,11336,23217
9214,2020-07-30,3호선,양재,38499,42162,80661
9215,2020-07-30,3호선,남부터미널,28926,29967,58893
9216,2020-07-30,3호선,교대,14119,9600,23719
9217,2020-07-30,3호선,고속터미널,40541,40044,80585
9218,2020-07-30,3호선,잠원,5675,5467,11142
9219,2020-07-30,3호선,신사,30062,32894,62956
9220,2020-07-30,3호선,압구정,31182,34067,65249
9221,2020-07-30,3호선,옥수,9348,9662,19010
9222,2020-07-30,3호선,금호,8334,7695,16029
9223,2020-07-30,3호선,약수,13197,12940,26137
9224,2020-07-30,3호선,동대입구,7237,7671,14908
9225,2020-07-30,3호선,을지로3가,11005,11788,22793
9226,2020-07-30,3호선,종로3가,10491,12941,23432
9227,2020-07-30,3호선,안국,20398,21591,41989
9228,2020-07-30,3호선,경복궁,19081,18858,37939
9229,2020-07-30,3호선,독립문,7189,7416,14605
9230,2020-07-30,3호선,무악재,3873,3935,7808
9231,2020-07-30,3호선,홍제,17414,16220,33634
9232,2020-07-30,3호선,녹번,14939,13083,28022
9233,2020-07-30,3호선,불광,16272,17226,33498
9234,2020-07-30,3호선,연신내,38956,36182,75138
9235,2020-07-30,3호선,구파발,21267,19949,41216
9236,2020-07-30,3호선,지축,3402,3192,6594
9237,2020-07-30,3호선,대화,13837,9517,23354
9238,2020-07-31,3호선,지축,3425,3185,6610
9239,2020-07-31,3호선,구파발,22018,20408,42426
9240,2020-07-31,3호선,연신내,39856,36840,76696
9241,2020-07-31,3호선,불광,16897,17686,34583
9242,2020-07-31,3호선,녹번,15218,12839,28057
9243,2020-07-31,3호선,홍제,17825,16488,34313
9244,2020-07-31,3호선,무악재,3928,3892,7820
9245,2020-07-31,3호선,독립문,7360,7507,14867
9246,2020-07-31,3호선,경복궁,19704,19556,39260
9247,2020-07-31,3호선,안국,20972,22053,43025
9248,2020-07-31,3호선,종로3가,10426,13179,23605
9249,2020-07-31,3호선,을지로3가,11263,12530,23793
9250,2020-07-31,3호선,충무로,2,0,2
9251,2020-07-31,3호선,동대입구,7478,7868,15346
9252,2020-07-31,3호선,약수,13863,13365,27228
9253,2020-07-31,3호선,금호,8644,7823,16467
9254,2020-07-31,3호선,옥수,9570,9573,19143
9255,2020-07-31,3호선,압구정,33125,36412,69537
9256,2020-07-31,3호선,신사,31612,35674,67286
9257,2020-07-31,3호선,잠원,5834,5650,11484
9258,2020-07-31,3호선,고속터미널,48143,53140,101283
9259,2020-07-31,3호선,교대,13903,9449,23352
9260,2020-07-31,3호선,남부터미널,31916,34022,65938
9261,2020-07-31,3호선,양재,40359,42288,82647
9262,2020-07-31,3호선,매봉,12146,11370,23516
9263,2020-07-31,3호선,도곡,5436,5512,10948
9264,2020-07-31,3호선,대치,10671,10364,21035
9265,2020-07-31,3호선,학여울,1957,2120,4077
9266,2020-07-31,3호선,대청,10409,9292,19701
9267,2020-07-31,3호선,일원,9560,9047,18607
9268,2020-07-31,3호선,수서,18197,18553,36750
9269,2020-07-31,3호선,가락시장,9770,9142,18912
9270,2020-07-31,3호선,경찰병원,7835,7668,15503
9271,2020-07-31,3호선,오금,6546,5618,12164
9272,2020-07-31,3호선,대화,13863,9414,23277
9273,2020-07-31,3호선,주엽,9282,9315,18597
9274,2020-07-31,3호선,정발산,7569,8080,15649
9275,2020-07-31,3호선,마두,7902,8016,15918
9276,2020-07-31,3호선,백석,10299,10456,20755
9277,2020-07-31,3호선,대곡,1912,1534,3446
9278,2020-07-31,3호선,화정,17634,18045,35679
9279,2020-07-31,3호선,원당,11267,10453,21720
9280,2020-07-31,3호선,삼송,18376,17536,35912
9281,2020-07-31,3호선,원흥,9294,8363,17657
9282,2020-08-01,3호선,오금,3505,3190,6695
9283,2020-08-01,3호선,경찰병원,3518,3358,6876
9284,2020-08-01,3호선,가락시장,4911,4669,9580
9285,2020-08-01,3호선,수서,10130,10621,20751
9286,2020-08-01,3호선,일원,3890,3831,7721
9287,2020-08-01,3호선,대청,4983,4508,9491
9288,2020-08-01,3호선,학여울,1050,1077,2127
9289,2020-08-01,3호선,대치,6839,6317,13156
9290,2020-08-01,3호선,도곡,2565,2455,5020
9291,2020-08-01,3호선,매봉,4836,4737,9573
9292,2020-08-01,3호선,양재,15733,17090,32823
9293,2020-08-01,3호선,남부터미널,18762,19593,38355
9294,2020-08-01,3호선,교대,5803,3745,9548
9295,2020-08-01,3호선,고속터미널,44294,47872,92166
9296,2020-08-01,3호선,잠원,3367,3136,6503
9297,2020-08-01,3호선,신사,18771,20689,39460
9298,2020-08-01,3호선,압구정,19944,21286,41230
9299,2020-08-01,3호선,옥수,5784,5776,11560
9300,2020-08-01,3호선,금호,5031,4404,9435
9301,2020-08-01,3호선,약수,7586,7145,14731
9302,2020-08-01,3호선,동대입구,4364,4700,9064
9303,2020-08-01,3호선,을지로3가,3903,4660,8563
9304,2020-08-01,3호선,종로3가,4678,7015,11693
9305,2020-08-01,3호선,안국,9348,10834,20182
9306,2020-08-01,3호선,경복궁,9745,10185,19930
9307,2020-08-01,3호선,독립문,4513,4361,8874
9308,2020-08-01,3호선,무악재,2226,2155,4381
9309,2020-08-01,3호선,홍제,10736,9858,20594
9310,2020-08-01,3호선,녹번,8112,6837,14949
9311,2020-08-01,3호선,불광,9931,11076,21007
9312,2020-08-01,3호선,연신내,24566,23215,47781
9313,2020-08-01,3호선,구파발,12270,12314,24584
9314,2020-08-01,3호선,지축,1752,1616,3368
9315,2020-08-01,3호선,원흥,5087,4797,9884
9316,2020-08-01,3호선,삼송,11037,10531,21568
9317,2020-08-01,3호선,원당,6300,5976,12276
9318,2020-08-01,3호선,화정,10155,10539,20694
9319,2020-08-01,3호선,대곡,975,815,1790
9320,2020-08-01,3호선,백석,6133,6250,12383
9321,2020-08-01,3호선,마두,4161,4098,8259
9322,2020-08-01,3호선,정발산,4958,5387,10345
9323,2020-08-01,3호선,주엽,5040,4937,9977
9324,2020-08-01,3호선,대화,7254,5509,12763
9325,2020-08-02,3호선,지축,1143,1092,2235
9326,2020-08-02,3호선,구파발,8681,8807,17488
9327,2020-08-02,3호선,연신내,16711,16216,32927
9328,2020-08-02,3호선,불광,6691,7717,14408
9329,2020-08-02,3호선,녹번,5091,4627,9718
9330,2020-08-02,3호선,홍제,6685,6634,13319
9331,2020-08-02,3호선,무악재,1396,1502,2898
9332,2020-08-02,3호선,독립문,2832,2950,5782
9333,2020-08-02,3호선,경복궁,6862,7037,13899
9334,2020-08-02,3호선,안국,5996,6385,12381
9335,2020-08-02,3호선,종로3가,3045,3957,7002
9336,2020-08-02,3호선,을지로3가,2302,2450,4752
9337,2020-08-02,3호선,동대입구,3356,3514,6870
9338,2020-08-02,3호선,약수,5158,5149,10307
9339,2020-08-02,3호선,금호,3401,3348,6749
9340,2020-08-02,3호선,옥수,3799,4143,7942
9341,2020-08-02,3호선,압구정,10751,11364,22115
9342,2020-08-02,3호선,신사,9972,10354,20326
9343,2020-08-02,3호선,잠원,2066,2045,4111
9344,2020-08-02,3호선,고속터미널,37058,33155,70213
9345,2020-08-02,3호선,교대,3465,2265,5730
9346,2020-08-02,3호선,남부터미널,13212,12817,26029
9347,2020-08-02,3호선,양재,9846,11543,21389
9348,2020-08-02,3호선,매봉,3023,2981,6004
9349,2020-08-02,3호선,도곡,1395,1580,2975
9350,2020-08-02,3호선,대치,4130,3837,7967
9351,2020-08-02,3호선,학여울,721,737,1458
9352,2020-08-02,3호선,대청,3226,3209,6435
9353,2020-08-02,3호선,일원,2431,2721,5152
9354,2020-08-02,3호선,수서,8602,7882,16484
9355,2020-08-02,3호선,가락시장,2745,3135,5880
9356,2020-08-02,3호선,경찰병원,2163,2235,4398
9357,2020-08-02,3호선,오금,2259,2184,4443
9358,2020-08-02,3호선,백석,4457,4333,8790
9359,2020-08-02,3호선,대곡,735,643,1378
9360,2020-08-02,3호선,화정,7221,7308,14529
9361,2020-08-02,3호선,원당,4577,4492,9069
9362,2020-08-02,3호선,삼송,7771,7590,15361
9363,2020-08-02,3호선,원흥,3553,3389,6942
9364,2020-08-02,3호선,마두,2806,2835,5641
9365,2020-08-02,3호선,정발산,3824,3899,7723
9366,2020-08-02,3호선,주엽,3409,3434,6843
9367,2020-08-02,3호선,대화,5195,4773,9968
9368,2020-08-03,3호선,오금,5829,5143,10972
9369,2020-08-03,3호선,경찰병원,7287,7388,14675
9370,2020-08-03,3호선,가락시장,8411,8110,16521
9371,2020-08-03,3호선,수서,15638,15653,31291
9372,2020-08-03,3호선,일원,9164,9042,18206
9373,2020-08-03,3호선,대청,9227,8550,17777
9374,2020-08-03,3호선,학여울,1548,1599,3147
9375,2020-08-03,3호선,대치,10150,10110,20260
9376,2020-08-03,3호선,도곡,5003,5045,10048
9377,2020-08-03,3호선,매봉,11035,10610,21645
9378,2020-08-03,3호선,양재,34576,37693,72269
9379,2020-08-03,3호선,남부터미널,27586,28058,55644
9380,2020-08-03,3호선,교대,12572,8510,21082
9381,2020-08-03,3호선,고속터미널,38423,36053,74476
9382,2020-08-03,3호선,잠원,5373,5258,10631
9383,2020-08-03,3호선,신사,26983,28983,55966
9384,2020-08-03,3호선,압구정,29140,31141,60281
9385,2020-08-03,3호선,옥수,8234,8648,16882
9386,2020-08-03,3호선,금호,7323,6788,14111
9387,2020-08-03,3호선,약수,11751,11552,23303
9388,2020-08-03,3호선,동대입구,6061,6361,12422
9389,2020-08-03,3호선,충무로,1,0,1
9390,2020-08-03,3호선,을지로3가,8989,9356,18345
9391,2020-08-03,3호선,종로3가,5278,6564,11842
9392,2020-08-03,3호선,안국,17647,17625,35272
9393,2020-08-03,3호선,경복궁,15554,15332,30886
9394,2020-08-03,3호선,독립문,5945,6084,12029
9395,2020-08-03,3호선,무악재,3289,3278,6567
9396,2020-08-03,3호선,홍제,14745,14098,28843
9397,2020-08-03,3호선,녹번,12516,11316,23832
9398,2020-08-03,3호선,불광,13645,14769,28414
9399,2020-08-03,3호선,연신내,32025,30221,62246
9400,2020-08-03,3호선,구파발,18097,17053,35150
9401,2020-08-03,3호선,지축,2754,2715,5469
9402,2020-08-03,3호선,대화,11831,8968,20799
9403,2020-08-03,3호선,주엽,7466,7611,15077
9404,2020-08-03,3호선,정발산,5814,5918,11732
9405,2020-08-03,3호선,마두,6527,6665,13192
9406,2020-08-03,3호선,백석,8552,8586,17138
9407,2020-08-03,3호선,대곡,1455,1124,2579
9408,2020-08-03,3호선,화정,14034,14488,28522
9409,2020-08-03,3호선,원당,9065,8619,17684
9410,2020-08-03,3호선,삼송,14946,14492,29438
9411,2020-08-03,3호선,원흥,7543,7202,14745
9412,2020-08-04,3호선,대화,12383,9607,21990
9413,2020-08-04,3호선,주엽,8290,8335,16625
9414,2020-08-04,3호선,정발산,6455,6650,13105
9415,2020-08-04,3호선,마두,6997,7245,14242
9416,2020-08-04,3호선,백석,9169,9273,18442
9417,2020-08-04,3호선,대곡,1629,1251,2880
9418,2020-08-04,3호선,화정,15414,15803,31217
9419,2020-08-04,3호선,원당,9913,9374,19287
9420,2020-08-04,3호선,삼송,16040,15561,31601
9421,2020-08-04,3호선,원흥,8132,7708,15840
9422,2020-08-04,3호선,오금,6123,5416,11539
9423,2020-08-04,3호선,경찰병원,7443,7425,14868
9424,2020-08-04,3호선,가락시장,8772,8583,17355
9425,2020-08-04,3호선,수서,15880,16045,31925
9426,2020-08-04,3호선,일원,9273,9123,18396
9427,2020-08-04,3호선,대청,9667,8882,18549
9428,2020-08-04,3호선,학여울,1736,1788,3524
9429,2020-08-04,3호선,대치,10371,10263,20634
9430,2020-08-04,3호선,도곡,5124,5245,10369
9431,2020-08-04,3호선,매봉,11515,11107,22622
9432,2020-08-04,3호선,양재,35999,39112,75111
9433,2020-08-04,3호선,남부터미널,28103,28635,56738
9434,2020-08-04,3호선,교대,13108,8812,21920
9435,2020-08-04,3호선,고속터미널,38956,36647,75603
9436,2020-08-04,3호선,잠원,5636,5506,11142
9437,2020-08-04,3호선,신사,28378,30729,59107
9438,2020-08-04,3호선,압구정,30391,32472,62863
9439,2020-08-04,3호선,옥수,8556,9041,17597
9440,2020-08-04,3호선,금호,7880,7284,15164
9441,2020-08-04,3호선,약수,12468,12250,24718
9442,2020-08-04,3호선,동대입구,6532,6751,13283
9443,2020-08-04,3호선,충무로,1,0,1
9444,2020-08-04,3호선,을지로3가,9288,9889,19177
9445,2020-08-04,3호선,종로3가,5862,7098,12960
9446,2020-08-04,3호선,안국,19184,19624,38808
9447,2020-08-04,3호선,경복궁,17492,17398,34890
9448,2020-08-04,3호선,독립문,6529,6690,13219
9449,2020-08-04,3호선,무악재,3631,3566,7197
9450,2020-08-04,3호선,홍제,15837,14988,30825
9451,2020-08-04,3호선,녹번,13331,12068,25399
9452,2020-08-04,3호선,불광,14770,15683,30453
9453,2020-08-04,3호선,연신내,34656,32577,67233
9454,2020-08-04,3호선,구파발,19405,18312,37717
9455,2020-08-04,3호선,지축,2951,2885,5836
9456,2020-08-05,3호선,원흥,8294,7883,16177
9457,2020-08-05,3호선,삼송,16297,15751,32048
9458,2020-08-05,3호선,원당,9881,9352,19233
9459,2020-08-05,3호선,화정,15932,16207,32139
9460,2020-08-05,3호선,대곡,1595,1295,2890
9461,2020-08-05,3호선,백석,9162,9131,18293
9462,2020-08-05,3호선,마두,7103,7221,14324
9463,2020-08-05,3호선,정발산,6728,6867,13595
9464,2020-08-05,3호선,주엽,8023,8186,16209
9465,2020-08-05,3호선,대화,12615,9783,22398
9466,2020-08-05,3호선,지축,2929,2894,5823
9467,2020-08-05,3호선,구파발,19452,18307,37759
9468,2020-08-05,3호선,연신내,35202,32884,68086
9469,2020-08-05,3호선,불광,15003,16009,31012
9470,2020-08-05,3호선,녹번,13790,12163,25953
9471,2020-08-05,3호선,홍제,16031,14968,30999
9472,2020-08-05,3호선,무악재,3600,3649,7249
9473,2020-08-05,3호선,독립문,6423,6612,13035
9474,2020-08-05,3호선,경복궁,17480,17480,34960
9475,2020-08-05,3호선,안국,19151,19948,39099
9476,2020-08-05,3호선,종로3가,5987,7090,13077
9477,2020-08-05,3호선,을지로3가,10088,10602,20690
9478,2020-08-05,3호선,충무로,1,0,1
9479,2020-08-05,3호선,동대입구,6518,6833,13351
9480,2020-08-05,3호선,약수,12403,12181,24584
9481,2020-08-05,3호선,금호,7751,7175,14926
9482,2020-08-05,3호선,옥수,8505,8846,17351
9483,2020-08-05,3호선,압구정,30028,32149,62177
9484,2020-08-05,3호선,신사,28085,29994,58079
9485,2020-08-05,3호선,잠원,5609,5436,11045
9486,2020-08-05,3호선,고속터미널,39356,37981,77337
9487,2020-08-05,3호선,교대,13385,8802,22187
9488,2020-08-05,3호선,남부터미널,28887,29480,58367
9489,2020-08-05,3호선,양재,36594,39601,76195
9490,2020-08-05,3호선,매봉,11370,10872,22242
9491,2020-08-05,3호선,도곡,5247,5270,10517
9492,2020-08-05,3호선,대치,10346,10234,20580
9493,2020-08-05,3호선,학여울,1660,1685,3345
9494,2020-08-05,3호선,대청,9742,8709,18451
9495,2020-08-05,3호선,일원,9382,9289,18671
9496,2020-08-05,3호선,수서,15949,16127,32076
9497,2020-08-05,3호선,가락시장,8874,8599,17473
9498,2020-08-05,3호선,경찰병원,7428,7440,14868
9499,2020-08-05,3호선,오금,6031,5340,11371
9500,2020-08-06,3호선,원흥,8756,8175,16931
9501,2020-08-06,3호선,삼송,17007,16444,33451
9502,2020-08-06,3호선,원당,10429,9866,20295
9503,2020-08-06,3호선,화정,16412,16837,33249
9504,2020-08-06,3호선,대곡,1762,1365,3127
9505,2020-08-06,3호선,백석,9570,9566,19136
9506,2020-08-06,3호선,마두,7237,7530,14767
9507,2020-08-06,3호선,정발산,7008,6938,13946
9508,2020-08-06,3호선,주엽,8615,8650,17265
9509,2020-08-06,3호선,대화,13196,10242,23438
9510,2020-08-06,3호선,지축,3105,3018,6123
9511,2020-08-06,3호선,구파발,20307,18991,39298
9512,2020-08-06,3호선,연신내,36644,34589,71233
9513,2020-08-06,3호선,불광,16078,16886,32964
9514,2020-08-06,3호선,녹번,15526,13054,28580
9515,2020-08-06,3호선,홍제,17162,15895,33057
9516,2020-08-06,3호선,무악재,3776,3768,7544
9517,2020-08-06,3호선,독립문,6802,7044,13846
9518,2020-08-06,3호선,경복궁,18771,18857,37628
9519,2020-08-06,3호선,안국,19344,20595,39939
9520,2020-08-06,3호선,종로3가,10353,12583,22936
9521,2020-08-06,3호선,을지로3가,10661,11764,22425
9522,2020-08-06,3호선,충무로,1,0,1
9523,2020-08-06,3호선,동대입구,6853,7316,14169
9524,2020-08-06,3호선,약수,13008,12701,25709
9525,2020-08-06,3호선,금호,8499,7687,16186
9526,2020-08-06,3호선,옥수,9204,9359,18563
9527,2020-08-06,3호선,압구정,32400,35122,67522
9528,2020-08-06,3호선,신사,30252,33654,63906
9529,2020-08-06,3호선,잠원,6350,5914,12264
9530,2020-08-06,3호선,고속터미널,40285,39528,79813
9531,2020-08-06,3호선,교대,14319,9548,23867
9532,2020-08-06,3호선,남부터미널,29734,30765,60499
9533,2020-08-06,3호선,양재,38129,41915,80044
9534,2020-08-06,3호선,매봉,11977,11533,23510
9535,2020-08-06,3호선,도곡,5296,5457,10753
9536,2020-08-06,3호선,대치,11206,11171,22377
9537,2020-08-06,3호선,학여울,1731,1721,3452
9538,2020-08-06,3호선,대청,9882,9004,18886
9539,2020-08-06,3호선,일원,9709,9649,19358
9540,2020-08-06,3호선,수서,16238,16286,32524
9541,2020-08-06,3호선,가락시장,9037,8761,17798
9542,2020-08-06,3호선,경찰병원,7548,7681,15229
9543,2020-08-06,3호선,오금,6148,5385,11533
9544,2020-08-07,3호선,오금,6392,5635,12027
9545,2020-08-07,3호선,경찰병원,7736,7680,15416
9546,2020-08-07,3호선,가락시장,9723,9491,19214
9547,2020-08-07,3호선,수서,18467,18448,36915
9548,2020-08-07,3호선,일원,9917,9450,19367
9549,2020-08-07,3호선,대청,10501,9274,19775
9550,2020-08-07,3호선,학여울,2459,2603,5062
9551,2020-08-07,3호선,대치,11898,11695,23593
9552,2020-08-07,3호선,도곡,5588,5607,11195
9553,2020-08-07,3호선,매봉,12343,11632,23975
9554,2020-08-07,3호선,양재,40408,42860,83268
9555,2020-08-07,3호선,남부터미널,32344,34074,66418
9556,2020-08-07,3호선,교대,14687,9692,24379
9557,2020-08-07,3호선,고속터미널,48088,51047,99135
9558,2020-08-07,3호선,잠원,6387,5787,12174
9559,2020-08-07,3호선,신사,32343,36670,69013
9560,2020-08-07,3호선,압구정,34448,37941,72389
9561,2020-08-07,3호선,옥수,9852,9751,19603
9562,2020-08-07,3호선,금호,8766,7885,16651
9563,2020-08-07,3호선,약수,13685,13366,27051
9564,2020-08-07,3호선,동대입구,7156,7503,14659
9565,2020-08-07,3호선,을지로3가,11211,12363,23574
9566,2020-08-07,3호선,종로3가,10437,13441,23878
9567,2020-08-07,3호선,안국,20504,21651,42155
9568,2020-08-07,3호선,경복궁,19602,19822,39424
9569,2020-08-07,3호선,독립문,7315,7609,14924
9570,2020-08-07,3호선,무악재,4060,3781,7841
9571,2020-08-07,3호선,홍제,18419,16763,35182
9572,2020-08-07,3호선,녹번,15306,12893,28199
9573,2020-08-07,3호선,불광,17098,18083,35181
9574,2020-08-07,3호선,연신내,39161,36838,75999
9575,2020-08-07,3호선,구파발,21486,19967,41453
9576,2020-08-07,3호선,지축,3472,3291,6763
9577,2020-08-07,3호선,정발산,7607,8310,15917
9578,2020-08-07,3호선,주엽,9279,9343,18622
9579,2020-08-07,3호선,대화,14188,10595,24783
9580,2020-08-07,3호선,원흥,9308,8529,17837
9581,2020-08-07,3호선,삼송,17921,17105,35026
9582,2020-08-07,3호선,원당,11341,10461,21802
9583,2020-08-07,3호선,화정,17591,17916,35507
9584,2020-08-07,3호선,대곡,1949,1553,3502
9585,2020-08-07,3호선,백석,10306,10500,20806
9586,2020-08-07,3호선,마두,7847,8019,15866
9587,2020-08-08,3호선,지축,2019,2006,4025
9588,2020-08-08,3호선,구파발,14612,14675,29287
9589,2020-08-08,3호선,연신내,28804,26884,55688
9590,2020-08-08,3호선,불광,11836,13035,24871
9591,2020-08-08,3호선,녹번,9125,7956,17081
9592,2020-08-08,3호선,홍제,12344,11562,23906
9593,2020-08-08,3호선,무악재,2438,2518,4956
9594,2020-08-08,3호선,독립문,5406,5419,10825
9595,2020-08-08,3호선,경복궁,14321,14417,28738
9596,2020-08-08,3호선,안국,10891,12570,23461
9597,2020-08-08,3호선,종로3가,5591,8035,13626
9598,2020-08-08,3호선,을지로3가,4800,5279,10079
9599,2020-08-08,3호선,충무로,1,0,1
9600,2020-08-08,3호선,동대입구,5358,5836,11194
9601,2020-08-08,3호선,약수,8514,8116,16630
9602,2020-08-08,3호선,금호,5695,5042,10737
9603,2020-08-08,3호선,옥수,6412,6546,12958
9604,2020-08-08,3호선,압구정,23419,24686,48105
9605,2020-08-08,3호선,신사,22367,24142,46509
9606,2020-08-08,3호선,잠원,3595,3375,6970
9607,2020-08-08,3호선,고속터미널,47541,48488,96029
9608,2020-08-08,3호선,교대,6542,4201,10743
9609,2020-08-08,3호선,남부터미널,20922,21545,42467
9610,2020-08-08,3호선,양재,18100,19722,37822
9611,2020-08-08,3호선,매봉,5361,5099,10460
9612,2020-08-08,3호선,도곡,2970,3028,5998
9613,2020-08-08,3호선,대치,9431,8275,17706
9614,2020-08-08,3호선,학여울,1770,1954,3724
9615,2020-08-08,3호선,대청,5268,4890,10158
9616,2020-08-08,3호선,일원,4610,4519,9129
9617,2020-08-08,3호선,수서,12203,12081,24284
9618,2020-08-08,3호선,가락시장,5831,5482,11313
9619,2020-08-08,3호선,경찰병원,3749,3627,7376
9620,2020-08-08,3호선,오금,3429,3133,6562
9621,2020-08-08,3호선,원흥,6142,5648,11790
9622,2020-08-08,3호선,삼송,12673,12041,24714
9623,2020-08-08,3호선,원당,7682,7088,14770
9624,2020-08-08,3호선,화정,12096,12474,24570
9625,2020-08-08,3호선,대곡,1154,997,2151
9626,2020-08-08,3호선,백석,7159,7203,14362
9627,2020-08-08,3호선,마두,4848,4987,9835
9628,2020-08-08,3호선,정발산,5756,6213,11969
9629,2020-08-08,3호선,주엽,6189,5985,12174
9630,2020-08-08,3호선,대화,8410,7439,15849
9631,2020-08-09,3호선,지축,1047,1071,2118
9632,2020-08-09,3호선,구파발,8315,8395,16710
9633,2020-08-09,3호선,연신내,15974,15710,31684
9634,2020-08-09,3호선,불광,6496,7488,13984
9635,2020-08-09,3호선,녹번,5368,4765,10133
9636,2020-08-09,3호선,홍제,6817,6549,13366
9637,2020-08-09,3호선,무악재,1372,1482,2854
9638,2020-08-09,3호선,독립문,2875,2827,5702
9639,2020-08-09,3호선,경복궁,6485,6477,12962
9640,2020-08-09,3호선,안국,5662,6136,11798
9641,2020-08-09,3호선,종로3가,3120,4040,7160
9642,2020-08-09,3호선,을지로3가,2293,2404,4697
9643,2020-08-09,3호선,동대입구,3306,3522,6828
9644,2020-08-09,3호선,약수,5376,5196,10572
9645,2020-08-09,3호선,금호,3420,3267,6687
9646,2020-08-09,3호선,옥수,3693,4048,7741
9647,2020-08-09,3호선,압구정,11028,11487,22515
9648,2020-08-09,3호선,신사,9972,10310,20282
9649,2020-08-09,3호선,잠원,1984,2014,3998
9650,2020-08-09,3호선,고속터미널,35675,33696,69371
9651,2020-08-09,3호선,교대,3721,2279,6000
9652,2020-08-09,3호선,남부터미널,13341,13489,26830
9653,2020-08-09,3호선,양재,9723,11694,21417
9654,2020-08-09,3호선,매봉,3126,3219,6345
9655,2020-08-09,3호선,도곡,1460,1421,2881
9656,2020-08-09,3호선,대치,5604,4813,10417
9657,2020-08-09,3호선,학여울,1161,1269,2430
9658,2020-08-09,3호선,대청,3098,3004,6102
9659,2020-08-09,3호선,일원,2409,2756,5165
9660,2020-08-09,3호선,수서,8446,7980,16426
9661,2020-08-09,3호선,가락시장,2716,2979,5695
9662,2020-08-09,3호선,경찰병원,2248,2386,4634
9663,2020-08-09,3호선,오금,2347,2285,4632
9664,2020-08-09,3호선,원흥,3294,3193,6487
9665,2020-08-09,3호선,삼송,7319,7223,14542
9666,2020-08-09,3호선,원당,4233,4009,8242
9667,2020-08-09,3호선,화정,6804,7075,13879
9668,2020-08-09,3호선,대곡,712,597,1309
9669,2020-08-09,3호선,백석,4304,4144,8448
9670,2020-08-09,3호선,마두,2573,2545,5118
9671,2020-08-09,3호선,정발산,3412,3554,6966
9672,2020-08-09,3호선,주엽,3315,3220,6535
9673,2020-08-09,3호선,대화,5034,4390,9424
9674,2020-08-10,3호선,대화,13594,10185,23779
9675,2020-08-10,3호선,주엽,8693,8806,17499
9676,2020-08-10,3호선,정발산,6735,6641,13376
9677,2020-08-10,3호선,마두,7386,7655,15041
9678,2020-08-10,3호선,백석,9682,9760,19442
9679,2020-08-10,3호선,대곡,1713,1331,3044
9680,2020-08-10,3호선,화정,16220,16601,32821
9681,2020-08-10,3호선,원당,10433,9802,20235
9682,2020-08-10,3호선,삼송,16976,16573,33549
9683,2020-08-10,3호선,원흥,8720,8253,16973
9684,2020-08-10,3호선,오금,6276,5411,11687
9685,2020-08-10,3호선,경찰병원,7808,7980,15788
9686,2020-08-10,3호선,가락시장,9165,8924,18089
9687,2020-08-10,3호선,수서,16515,16839,33354
9688,2020-08-10,3호선,일원,9591,9671,19262
9689,2020-08-10,3호선,대청,9491,8758,18249
9690,2020-08-10,3호선,학여울,1738,1836,3574
9691,2020-08-10,3호선,대치,11440,11324,22764
9692,2020-08-10,3호선,도곡,5322,5322,10644
9693,2020-08-10,3호선,매봉,12003,11335,23338
9694,2020-08-10,3호선,양재,37916,41427,79343
9695,2020-08-10,3호선,남부터미널,29243,30085,59328
9696,2020-08-10,3호선,교대,14573,9754,24327
9697,2020-08-10,3호선,고속터미널,41737,39829,81566
9698,2020-08-10,3호선,잠원,5872,5579,11451
9699,2020-08-10,3호선,신사,29613,31473,61086
9700,2020-08-10,3호선,압구정,31531,34024,65555
9701,2020-08-10,3호선,옥수,8773,9174,17947
9702,2020-08-10,3호선,금호,8060,7481,15541
9703,2020-08-10,3호선,약수,12461,12262,24723
9704,2020-08-10,3호선,동대입구,6398,6659,13057
9705,2020-08-10,3호선,충무로,1,0,1
9706,2020-08-10,3호선,을지로3가,10989,11456,22445
9707,2020-08-10,3호선,종로3가,10481,12024,22505
9708,2020-08-10,3호선,안국,19300,19459,38759
9709,2020-08-10,3호선,경복궁,17326,17225,34551
9710,2020-08-10,3호선,독립문,6645,6930,13575
9711,2020-08-10,3호선,무악재,3796,3847,7643
9712,2020-08-10,3호선,홍제,16958,16123,33081
9713,2020-08-10,3호선,녹번,14160,12965,27125
9714,2020-08-10,3호선,불광,15669,16708,32377
9715,2020-08-10,3호선,연신내,36459,34273,70732
9716,2020-08-10,3호선,구파발,20165,19002,39167
9717,2020-08-10,3호선,지축,3183,3075,6258
9718,2020-08-11,3호선,대화,13368,9928,23296
9719,2020-08-11,3호선,주엽,8687,8724,17411
9720,2020-08-11,3호선,정발산,6661,6777,13438
9721,2020-08-11,3호선,마두,7320,7654,14974
9722,2020-08-11,3호선,백석,9752,9685,19437
9723,2020-08-11,3호선,대곡,1735,1324,3059
9724,2020-08-11,3호선,화정,16414,16728,33142
9725,2020-08-11,3호선,원당,10477,9836,20313
9726,2020-08-11,3호선,삼송,17130,16387,33517
9727,2020-08-11,3호선,원흥,8859,8382,17241
9728,2020-08-11,3호선,오금,6249,5469,11718
9729,2020-08-11,3호선,경찰병원,7762,7819,15581
9730,2020-08-11,3호선,가락시장,9105,8620,17725
9731,2020-08-11,3호선,수서,16502,16729,33231
9732,2020-08-11,3호선,일원,9647,9629,19276
9733,2020-08-11,3호선,대청,9511,8757,18268
9734,2020-08-11,3호선,학여울,1899,1876,3775
9735,2020-08-11,3호선,대치,11405,11065,22470
9736,2020-08-11,3호선,도곡,5252,5323,10575
9737,2020-08-11,3호선,매봉,12014,11402,23416
9738,2020-08-11,3호선,양재,38400,42054,80454
9739,2020-08-11,3호선,남부터미널,29828,30670,60498
9740,2020-08-11,3호선,교대,14902,9867,24769
9741,2020-08-11,3호선,고속터미널,40248,39321,79569
9742,2020-08-11,3호선,잠원,5848,5462,11310
9743,2020-08-11,3호선,신사,29779,32671,62450
9744,2020-08-11,3호선,압구정,32016,34415,66431
9745,2020-08-11,3호선,옥수,8976,9172,18148
9746,2020-08-11,3호선,금호,8287,7531,15818
9747,2020-08-11,3호선,약수,12732,12499,25231
9748,2020-08-11,3호선,동대입구,6839,7072,13911
9749,2020-08-11,3호선,을지로3가,10615,11601,22216
9750,2020-08-11,3호선,종로3가,10555,12391,22946
9751,2020-08-11,3호선,안국,19506,20514,40020
9752,2020-08-11,3호선,경복궁,18064,17916,35980
9753,2020-08-11,3호선,독립문,6796,6957,13753
9754,2020-08-11,3호선,무악재,3831,3811,7642
9755,2020-08-11,3호선,홍제,16915,15835,32750
9756,2020-08-11,3호선,녹번,14503,12991,27494
9757,2020-08-11,3호선,불광,16118,16955,33073
9758,2020-08-11,3호선,연신내,36661,34782,71443
9759,2020-08-11,3호선,구파발,20661,19195,39856
9760,2020-08-11,3호선,지축,3165,3085,6250
9761,2020-08-12,3호선,오금,6402,5802,12204
9762,2020-08-12,3호선,경찰병원,7971,7887,15858
9763,2020-08-12,3호선,가락시장,9355,9032,18387
9764,2020-08-12,3호선,수서,16981,17196,34177
9765,2020-08-12,3호선,일원,9783,9659,19442
9766,2020-08-12,3호선,대청,9749,8917,18666
9767,2020-08-12,3호선,학여울,1865,1867,3732
9768,2020-08-12,3호선,대치,11351,11159,22510
9769,2020-08-12,3호선,도곡,5335,5491,10826
9770,2020-08-12,3호선,매봉,12357,11614,23971
9771,2020-08-12,3호선,양재,39316,42915,82231
9772,2020-08-12,3호선,남부터미널,30696,31808,62504
9773,2020-08-12,3호선,교대,15279,9993,25272
9774,2020-08-12,3호선,고속터미널,42812,42211,85023
9775,2020-08-12,3호선,잠원,5993,5768,11761
9776,2020-08-12,3호선,신사,31063,33758,64821
9777,2020-08-12,3호선,압구정,32804,35497,68301
9778,2020-08-12,3호선,옥수,9241,9656,18897
9779,2020-08-12,3호선,금호,8711,7843,16554
9780,2020-08-12,3호선,약수,13057,12798,25855
9781,2020-08-12,3호선,동대입구,7024,7475,14499
9782,2020-08-12,3호선,을지로3가,11121,11803,22924
9783,2020-08-12,3호선,종로3가,10775,13198,23973
9784,2020-08-12,3호선,안국,21076,22055,43131
9785,2020-08-12,3호선,경복궁,19321,19331,38652
9786,2020-08-12,3호선,독립문,7362,7617,14979
9787,2020-08-12,3호선,무악재,4028,4009,8037
9788,2020-08-12,3호선,녹번,15204,13474,28678
9789,2020-08-12,3호선,불광,17004,18106,35110
9790,2020-08-12,3호선,연신내,38486,36286,74772
9791,2020-08-12,3호선,구파발,21389,20020,41409
9792,2020-08-12,3호선,지축,3365,3327,6692
9793,2020-08-12,3호선,홍제,17481,16270,33751
9794,2020-08-12,3호선,대화,13770,10777,24547
9795,2020-08-12,3호선,주엽,9153,9239,18392
9796,2020-08-12,3호선,정발산,7563,7851,15414
9797,2020-08-12,3호선,마두,7940,8143,16083
9798,2020-08-12,3호선,백석,9867,9816,19683
9799,2020-08-12,3호선,대곡,1829,1541,3370
9800,2020-08-12,3호선,화정,17463,17842,35305
9801,2020-08-12,3호선,원당,11227,10450,21677
9802,2020-08-12,3호선,삼송,17874,16997,34871
9803,2020-08-12,3호선,원흥,9261,8819,18080
9804,2020-08-13,3호선,지축,3219,3116,6335
9805,2020-08-13,3호선,구파발,21135,19573,40708
9806,2020-08-13,3호선,연신내,37967,35569,73536
9807,2020-08-13,3호선,불광,16260,17435,33695
9808,2020-08-13,3호선,녹번,14809,13026,27835
9809,2020-08-13,3호선,홍제,17385,16014,33399
9810,2020-08-13,3호선,무악재,3886,3902,7788
9811,2020-08-13,3호선,독립문,7076,7340,14416
9812,2020-08-13,3호선,경복궁,18987,19000,37987
9813,2020-08-13,3호선,안국,20208,21382,41590
9814,2020-08-13,3호선,종로3가,10535,12914,23449
9815,2020-08-13,3호선,을지로3가,10675,11537,22212
9816,2020-08-13,3호선,동대입구,7238,7591,14829
9817,2020-08-13,3호선,약수,13081,12835,25916
9818,2020-08-13,3호선,금호,8531,7803,16334
9819,2020-08-13,3호선,옥수,9268,9418,18686
9820,2020-08-13,3호선,압구정,32278,34723,67001
9821,2020-08-13,3호선,신사,31293,34001,65294
9822,2020-08-13,3호선,잠원,5809,5404,11213
9823,2020-08-13,3호선,고속터미널,43483,43612,87095
9824,2020-08-13,3호선,교대,15090,9856,24946
9825,2020-08-13,3호선,남부터미널,31013,32012,63025
9826,2020-08-13,3호선,양재,38873,42399,81272
9827,2020-08-13,3호선,매봉,12191,11733,23924
9828,2020-08-13,3호선,도곡,5209,5307,10516
9829,2020-08-13,3호선,대치,11425,11197,22622
9830,2020-08-13,3호선,학여울,1762,1860,3622
9831,2020-08-13,3호선,대청,9738,8806,18544
9832,2020-08-13,3호선,일원,9755,9719,19474
9833,2020-08-13,3호선,수서,17103,17566,34669
9834,2020-08-13,3호선,가락시장,9473,9183,18656
9835,2020-08-13,3호선,경찰병원,7895,7882,15777
9836,2020-08-13,3호선,오금,6425,5735,12160
9837,2020-08-13,3호선,원흥,9038,8492,17530
9838,2020-08-13,3호선,삼송,17698,16893,34591
9839,2020-08-13,3호선,원당,10846,10160,21006
9840,2020-08-13,3호선,화정,16819,17100,33919
9841,2020-08-13,3호선,대곡,1859,1481,3340
9842,2020-08-13,3호선,백석,10049,9930,19979
9843,2020-08-13,3호선,마두,7528,7776,15304
9844,2020-08-13,3호선,정발산,6966,7246,14212
9845,2020-08-13,3호선,주엽,8771,8823,17594
9846,2020-08-13,3호선,대화,13774,10667,24441
9847,2020-08-14,3호선,지축,3120,2979,6099
9848,2020-08-14,3호선,구파발,20106,18381,38487
9849,2020-08-14,3호선,연신내,37722,35251,72973
9850,2020-08-14,3호선,불광,15951,16839,32790
9851,2020-08-14,3호선,녹번,14613,12423,27036
9852,2020-08-14,3호선,홍제,17021,15663,32684
9853,2020-08-14,3호선,무악재,3823,3674,7497
9854,2020-08-14,3호선,독립문,6961,7141,14102
9855,2020-08-14,3호선,경복궁,18459,18295,36754
9856,2020-08-14,3호선,안국,19304,20302,39606
9857,2020-08-14,3호선,종로3가,9624,12077,21701
9858,2020-08-14,3호선,을지로3가,10318,11416,21734
9859,2020-08-14,3호선,동대입구,7026,7264,14290
9860,2020-08-14,3호선,약수,12939,12604,25543
9861,2020-08-14,3호선,금호,8528,7574,16102
9862,2020-08-14,3호선,옥수,9331,9436,18767
9863,2020-08-14,3호선,압구정,32903,35980,68883
9864,2020-08-14,3호선,신사,31975,35821,67796
9865,2020-08-14,3호선,잠원,5778,5484,11262
9866,2020-08-14,3호선,고속터미널,49312,57842,107154
9867,2020-08-14,3호선,교대,15057,9670,24727
9868,2020-08-14,3호선,남부터미널,32639,34976,67615
9869,2020-08-14,3호선,양재,39264,41303,80567
9870,2020-08-14,3호선,매봉,11981,11317,23298
9871,2020-08-14,3호선,도곡,5110,5187,10297
9872,2020-08-14,3호선,대치,11677,11049,22726
9873,2020-08-14,3호선,학여울,1807,1831,3638
9874,2020-08-14,3호선,대청,9522,8601,18123
9875,2020-08-14,3호선,일원,9454,8962,18416
9876,2020-08-14,3호선,수서,17723,18271,35994
9877,2020-08-14,3호선,가락시장,9453,9059,18512
9878,2020-08-14,3호선,경찰병원,7694,7551,15245
9879,2020-08-14,3호선,오금,6347,5513,11860
9880,2020-08-14,3호선,원흥,8921,8223,17144
9881,2020-08-14,3호선,삼송,17467,16360,33827
9882,2020-08-14,3호선,원당,10633,9744,20377
9883,2020-08-14,3호선,화정,16527,16932,33459
9884,2020-08-14,3호선,대곡,1822,1386,3208
9885,2020-08-14,3호선,백석,9734,9837,19571
9886,2020-08-14,3호선,마두,7400,7631,15031
9887,2020-08-14,3호선,정발산,7138,7761,14899
9888,2020-08-14,3호선,주엽,8656,8759,17415
9889,2020-08-14,3호선,대화,13270,10308,23578
9890,2020-08-15,3호선,대화,7039,6361,13400
9891,2020-08-15,3호선,주엽,4770,4748,9518
9892,2020-08-15,3호선,정발산,4485,4831,9316
9893,2020-08-15,3호선,마두,3686,3729,7415
9894,2020-08-15,3호선,백석,5914,6014,11928
9895,2020-08-15,3호선,대곡,919,736,1655
9896,2020-08-15,3호선,화정,9268,9640,18908
9897,2020-08-15,3호선,원당,6072,5791,11863
9898,2020-08-15,3호선,삼송,10481,9974,20455
9899,2020-08-15,3호선,원흥,4719,4346,9065
9900,2020-08-15,3호선,오금,2804,2549,5353
9901,2020-08-15,3호선,경찰병원,3108,2976,6084
9902,2020-08-15,3호선,가락시장,4848,4424,9272
9903,2020-08-15,3호선,수서,10220,10673,20893
9904,2020-08-15,3호선,일원,3375,3218,6593
9905,2020-08-15,3호선,대청,4403,3901,8304
9906,2020-08-15,3호선,학여울,839,771,1610
9907,2020-08-15,3호선,대치,7715,6760,14475
9908,2020-08-15,3호선,도곡,2372,2281,4653
9909,2020-08-15,3호선,매봉,4459,4138,8597
9910,2020-08-15,3호선,양재,15307,16311,31618
9911,2020-08-15,3호선,남부터미널,17956,19219,37175
9912,2020-08-15,3호선,교대,5221,3270,8491
9913,2020-08-15,3호선,고속터미널,41986,48150,90136
9914,2020-08-15,3호선,잠원,3099,2910,6009
9915,2020-08-15,3호선,신사,15675,17584,33259
9916,2020-08-15,3호선,압구정,16064,17304,33368
9917,2020-08-15,3호선,옥수,5158,5229,10387
9918,2020-08-15,3호선,금호,4610,4004,8614
9919,2020-08-15,3호선,약수,6849,6330,13179
9920,2020-08-15,3호선,동대입구,4734,4897,9631
9921,2020-08-15,3호선,을지로3가,4077,4884,8961
9922,2020-08-15,3호선,종로3가,4279,7531,11810
9923,2020-08-15,3호선,안국,12761,13057,25818
9924,2020-08-15,3호선,경복궁,24779,22548,47327
9925,2020-08-15,3호선,독립문,5840,4986,10826
9926,2020-08-15,3호선,무악재,2240,2216,4456
9927,2020-08-15,3호선,홍제,10167,9732,19899
9928,2020-08-15,3호선,녹번,7664,6492,14156
9929,2020-08-15,3호선,불광,9454,10593,20047
9930,2020-08-15,3호선,연신내,23004,21686,44690
9931,2020-08-15,3호선,구파발,11260,11128,22388
9932,2020-08-15,3호선,지축,1547,1556,3103
9933,2020-08-16,3호선,대화,5860,5113,10973
9934,2020-08-16,3호선,주엽,3709,3744,7453
9935,2020-08-16,3호선,정발산,4164,4300,8464
9936,2020-08-16,3호선,마두,2916,2941,5857
9937,2020-08-16,3호선,백석,4788,4748,9536
9938,2020-08-16,3호선,대곡,907,770,1677
9939,2020-08-16,3호선,화정,7814,8186,16000
9940,2020-08-16,3호선,원당,5193,4959,10152
9941,2020-08-16,3호선,삼송,8653,8439,17092
9942,2020-08-16,3호선,원흥,4052,3704,7756
9943,2020-08-16,3호선,오금,2803,2620,5423
9944,2020-08-16,3호선,경찰병원,2452,2407,4859
9945,2020-08-16,3호선,가락시장,3474,3647,7121
9946,2020-08-16,3호선,수서,9028,8230,17258
9947,2020-08-16,3호선,일원,2698,2963,5661
9948,2020-08-16,3호선,대청,3510,3483,6993
9949,2020-08-16,3호선,학여울,596,607,1203
9950,2020-08-16,3호선,대치,5859,5191,11050
9951,2020-08-16,3호선,도곡,1588,1670,3258
9952,2020-08-16,3호선,매봉,3296,3268,6564
9953,2020-08-16,3호선,양재,10674,11775,22449
9954,2020-08-16,3호선,남부터미널,12915,12970,25885
9955,2020-08-16,3호선,교대,3857,2327,6184
9956,2020-08-16,3호선,고속터미널,35855,33796,69651
9957,2020-08-16,3호선,잠원,2244,2150,4394
9958,2020-08-16,3호선,신사,12321,13072,25393
9959,2020-08-16,3호선,압구정,11906,12742,24648
9960,2020-08-16,3호선,옥수,4311,4484,8795
9961,2020-08-16,3호선,금호,3853,3558,7411
9962,2020-08-16,3호선,약수,5753,5497,11250
9963,2020-08-16,3호선,동대입구,4043,4471,8514
9964,2020-08-16,3호선,충무로,1,0,1
9965,2020-08-16,3호선,을지로3가,2370,2700,5070
9966,2020-08-16,3호선,종로3가,2912,4383,7295
9967,2020-08-16,3호선,안국,7317,8722,16039
9968,2020-08-16,3호선,경복궁,8044,8186,16230
9969,2020-08-16,3호선,독립문,3727,3902,7629
9970,2020-08-16,3호선,무악재,1653,1676,3329
9971,2020-08-16,3호선,홍제,7893,7490,15383
9972,2020-08-16,3호선,녹번,5933,5270,11203
9973,2020-08-16,3호선,불광,8376,9764,18140
9974,2020-08-16,3호선,연신내,20384,19077,39461
9975,2020-08-16,3호선,구파발,10693,10779,21472
9976,2020-08-16,3호선,지축,1306,1340,2646
9977,2020-08-17,3호선,지축,1755,1692,3447
9978,2020-08-17,3호선,구파발,12383,12434,24817
9979,2020-08-17,3호선,연신내,25001,23507,48508
9980,2020-08-17,3호선,불광,9863,11469,21332
9981,2020-08-17,3호선,녹번,7949,7198,15147
9982,2020-08-17,3호선,홍제,10615,10290,20905
9983,2020-08-17,3호선,무악재,2028,2084,4112
9984,2020-08-17,3호선,독립문,4208,4452,8660
9985,2020-08-17,3호선,경복궁,8248,8219,16467
9986,2020-08-17,3호선,안국,7929,8851,16780
9987,2020-08-17,3호선,종로3가,6604,8282,14886
9988,2020-08-17,3호선,을지로3가,4198,4542,8740
9989,2020-08-17,3호선,동대입구,4157,4419,8576
9990,2020-08-17,3호선,약수,7542,7567,15109
9991,2020-08-17,3호선,금호,4811,4596,9407
9992,2020-08-17,3호선,옥수,5345,5642,10987
9993,2020-08-17,3호선,압구정,18439,19511,37950
9994,2020-08-17,3호선,신사,17439,18595,36034
9995,2020-08-17,3호선,잠원,2897,2953,5850
9996,2020-08-17,3호선,고속터미널,41422,35069,76491
9997,2020-08-17,3호선,교대,5434,3731,9165
9998,2020-08-17,3호선,남부터미널,17538,16642,34180
9999,2020-08-17,3호선,양재,13786,16441,30227
10000,2020-08-17,3호선,매봉,5002,4825,9827
10001,2020-08-17,3호선,도곡,2491,2565,5056
10002,2020-08-17,3호선,대치,7236,6787,14023
10003,2020-08-17,3호선,학여울,818,826,1644
10004,2020-08-17,3호선,대청,4664,4311,8975
10005,2020-08-17,3호선,일원,5865,5980,11845
10006,2020-08-17,3호선,수서,10288,9728,20016
10007,2020-08-17,3호선,가락시장,4901,4796,9697
10008,2020-08-17,3호선,경찰병원,3267,3460,6727
10009,2020-08-17,3호선,오금,2989,2853,5842
10010,2020-08-17,3호선,원흥,4914,4797,9711
10011,2020-08-17,3호선,삼송,10601,10280,20881
10012,2020-08-17,3호선,원당,6930,6327,13257
10013,2020-08-17,3호선,화정,9946,10184,20130
10014,2020-08-17,3호선,대곡,1014,805,1819
10015,2020-08-17,3호선,백석,6257,6266,12523
10016,2020-08-17,3호선,마두,4109,4237,8346
10017,2020-08-17,3호선,정발산,4532,4659,9191
10018,2020-08-17,3호선,주엽,5044,5071,10115
10019,2020-08-17,3호선,대화,7452,6221,13673
10020,2020-08-18,3호선,대화,12350,9527,21877
10021,2020-08-18,3호선,주엽,8086,8262,16348
10022,2020-08-18,3호선,정발산,6332,6479,12811
10023,2020-08-18,3호선,마두,6942,7205,14147
10024,2020-08-18,3호선,백석,9224,9193,18417
10025,2020-08-18,3호선,대곡,1710,1311,3021
10026,2020-08-18,3호선,화정,15400,15874,31274
10027,2020-08-18,3호선,원당,10152,9613,19765
10028,2020-08-18,3호선,삼송,16082,15739,31821
10029,2020-08-18,3호선,원흥,8228,7845,16073
10030,2020-08-18,3호선,오금,5974,5463,11437
10031,2020-08-18,3호선,경찰병원,7471,7515,14986
10032,2020-08-18,3호선,가락시장,8452,8254,16706
10033,2020-08-18,3호선,수서,15582,15591,31173
10034,2020-08-18,3호선,일원,8879,8659,17538
10035,2020-08-18,3호선,대청,8832,8219,17051
10036,2020-08-18,3호선,학여울,1652,1693,3345
10037,2020-08-18,3호선,대치,10365,10337,20702
10038,2020-08-18,3호선,도곡,4846,4930,9776
10039,2020-08-18,3호선,매봉,11377,10841,22218
10040,2020-08-18,3호선,양재,35640,38899,74539
10041,2020-08-18,3호선,남부터미널,27711,28126,55837
10042,2020-08-18,3호선,교대,13716,9234,22950
10043,2020-08-18,3호선,고속터미널,36271,34331,70602
10044,2020-08-18,3호선,잠원,5054,4904,9958
10045,2020-08-18,3호선,신사,27699,29915,57614
10046,2020-08-18,3호선,압구정,29586,31490,61076
10047,2020-08-18,3호선,옥수,8331,8668,16999
10048,2020-08-18,3호선,금호,7548,7142,14690
10049,2020-08-18,3호선,약수,12083,11867,23950
10050,2020-08-18,3호선,동대입구,6616,6984,13600
10051,2020-08-18,3호선,충무로,1,0,1
10052,2020-08-18,3호선,을지로3가,9713,10114,19827
10053,2020-08-18,3호선,종로3가,9868,11306,21174
10054,2020-08-18,3호선,안국,17654,17855,35509
10055,2020-08-18,3호선,경복궁,15893,15737,31630
10056,2020-08-18,3호선,독립문,6486,6632,13118
10057,2020-08-18,3호선,무악재,3642,3681,7323
10058,2020-08-18,3호선,홍제,16049,15115,31164
10059,2020-08-18,3호선,녹번,13869,12607,26476
10060,2020-08-18,3호선,불광,15217,16295,31512
10061,2020-08-18,3호선,연신내,35203,33184,68387
10062,2020-08-18,3호선,구파발,19529,18353,37882
10063,2020-08-18,3호선,지축,3002,2985,5987
10064,2020-08-19,3호선,원흥,7886,7611,15497
10065,2020-08-19,3호선,삼송,15436,14963,30399
10066,2020-08-19,3호선,원당,9603,9174,18777
10067,2020-08-19,3호선,화정,14483,14967,29450
10068,2020-08-19,3호선,대곡,1612,1214,2826
10069,2020-08-19,3호선,백석,8642,8658,17300
10070,2020-08-19,3호선,마두,6601,6858,13459
10071,2020-08-19,3호선,정발산,6023,6058,12081
10072,2020-08-19,3호선,주엽,7481,7568,15049
10073,2020-08-19,3호선,대화,11734,9138,20872
10074,2020-08-19,3호선,오금,5784,5123,10907
10075,2020-08-19,3호선,경찰병원,7077,7147,14224
10076,2020-08-19,3호선,가락시장,8141,7866,16007
10077,2020-08-19,3호선,수서,14544,14751,29295
10078,2020-08-19,3호선,일원,8487,8393,16880
10079,2020-08-19,3호선,대청,8390,7786,16176
10080,2020-08-19,3호선,학여울,1556,1613,3169
10081,2020-08-19,3호선,대치,9346,9289,18635
10082,2020-08-19,3호선,도곡,4796,4806,9602
10083,2020-08-19,3호선,매봉,10981,10410,21391
10084,2020-08-19,3호선,양재,34374,37186,71560
10085,2020-08-19,3호선,남부터미널,25720,26313,52033
10086,2020-08-19,3호선,교대,13475,8635,22110
10087,2020-08-19,3호선,고속터미널,32752,32234,64986
10088,2020-08-19,3호선,잠원,4925,4797,9722
10089,2020-08-19,3호선,신사,26522,28497,55019
10090,2020-08-19,3호선,압구정,27899,29892,57791
10091,2020-08-19,3호선,옥수,8040,8300,16340
10092,2020-08-19,3호선,금호,7276,6795,14071
10093,2020-08-19,3호선,약수,11556,11437,22993
10094,2020-08-19,3호선,동대입구,6469,6698,13167
10095,2020-08-19,3호선,충무로,1,0,1
10096,2020-08-19,3호선,을지로3가,9379,9756,19135
10097,2020-08-19,3호선,종로3가,8875,10278,19153
10098,2020-08-19,3호선,안국,16214,16471,32685
10099,2020-08-19,3호선,경복궁,15350,15058,30408
10100,2020-08-19,3호선,독립문,6054,6226,12280
10101,2020-08-19,3호선,무악재,3465,3466,6931
10102,2020-08-19,3호선,홍제,15460,14672,30132
10103,2020-08-19,3호선,녹번,13343,12009,25352
10104,2020-08-19,3호선,불광,14582,15865,30447
10105,2020-08-19,3호선,연신내,34336,32238,66574
10106,2020-08-19,3호선,구파발,18487,17410,35897
10107,2020-08-19,3호선,지축,2818,2899,5717
10108,2020-08-20,3호선,대화,11866,9456,21322
10109,2020-08-20,3호선,주엽,7334,7441,14775
10110,2020-08-20,3호선,정발산,5814,5858,11672
10111,2020-08-20,3호선,마두,6347,6671,13018
10112,2020-08-20,3호선,백석,8635,8638,17273
10113,2020-08-20,3호선,대곡,1656,1264,2920
10114,2020-08-20,3호선,화정,14232,14592,28824
10115,2020-08-20,3호선,원당,9472,8996,18468
10116,2020-08-20,3호선,삼송,15142,14826,29968
10117,2020-08-20,3호선,원흥,7769,7459,15228
10118,2020-08-20,3호선,지축,2878,2804,5682
10119,2020-08-20,3호선,구파발,17992,17026,35018
10120,2020-08-20,3호선,연신내,33138,31336,64474
10121,2020-08-20,3호선,불광,14420,15255,29675
10122,2020-08-20,3호선,녹번,12868,11500,24368
10123,2020-08-20,3호선,홍제,14818,14021,28839
10124,2020-08-20,3호선,무악재,3457,3437,6894
10125,2020-08-20,3호선,독립문,5890,6067,11957
10126,2020-08-20,3호선,경복궁,14502,14353,28855
10127,2020-08-20,3호선,안국,15141,15316,30457
10128,2020-08-20,3호선,종로3가,8562,9896,18458
10129,2020-08-20,3호선,을지로3가,8966,9324,18290
10130,2020-08-20,3호선,동대입구,6371,6582,12953
10131,2020-08-20,3호선,약수,11423,11210,22633
10132,2020-08-20,3호선,금호,7163,6678,13841
10133,2020-08-20,3호선,옥수,7928,8142,16070
10134,2020-08-20,3호선,압구정,27047,29205,56252
10135,2020-08-20,3호선,신사,25698,27608,53306
10136,2020-08-20,3호선,잠원,4705,4582,9287
10137,2020-08-20,3호선,고속터미널,30790,31014,61804
10138,2020-08-20,3호선,교대,13133,8550,21683
10139,2020-08-20,3호선,남부터미널,24577,25433,50010
10140,2020-08-20,3호선,양재,34011,36802,70813
10141,2020-08-20,3호선,매봉,10724,10291,21015
10142,2020-08-20,3호선,도곡,4545,4625,9170
10143,2020-08-20,3호선,대치,9065,8968,18033
10144,2020-08-20,3호선,학여울,1517,1516,3033
10145,2020-08-20,3호선,대청,8201,7624,15825
10146,2020-08-20,3호선,일원,8337,8254,16591
10147,2020-08-20,3호선,수서,13901,14207,28108
10148,2020-08-20,3호선,가락시장,8100,7871,15971
10149,2020-08-20,3호선,경찰병원,6889,6870,13759
10150,2020-08-20,3호선,오금,5661,5041,10702
10151,2020-08-21,3호선,마두,6371,6588,12959
10152,2020-08-21,3호선,정발산,5546,5859,11405
10153,2020-08-21,3호선,주엽,7125,7272,14397
10154,2020-08-21,3호선,대화,11174,8908,20082
10155,2020-08-21,3호선,원흥,7630,7239,14869
10156,2020-08-21,3호선,삼송,14746,14158,28904
10157,2020-08-21,3호선,원당,9288,8851,18139
10158,2020-08-21,3호선,화정,14157,14633,28790
10159,2020-08-21,3호선,대곡,1533,1220,2753
10160,2020-08-21,3호선,백석,8410,8627,17037
10161,2020-08-21,3호선,오금,5633,5015,10648
10162,2020-08-21,3호선,경찰병원,6772,6596,13368
10163,2020-08-21,3호선,가락시장,7960,7752,15712
10164,2020-08-21,3호선,수서,14643,15259,29902
10165,2020-08-21,3호선,일원,8110,7888,15998
10166,2020-08-21,3호선,대청,8288,7495,15783
10167,2020-08-21,3호선,학여울,1540,1572,3112
10168,2020-08-21,3호선,대치,9211,9185,18396
10169,2020-08-21,3호선,도곡,4518,4433,8951
10170,2020-08-21,3호선,매봉,10694,10160,20854
10171,2020-08-21,3호선,양재,34613,36234,70847
10172,2020-08-21,3호선,남부터미널,24513,25449,49962
10173,2020-08-21,3호선,교대,12730,8526,21256
10174,2020-08-21,3호선,고속터미널,33019,35961,68980
10175,2020-08-21,3호선,잠원,4768,4642,9410
10176,2020-08-21,3호선,신사,25540,28255,53795
10177,2020-08-21,3호선,압구정,28032,30072,58104
10178,2020-08-21,3호선,옥수,7994,8254,16248
10179,2020-08-21,3호선,금호,7185,6605,13790
10180,2020-08-21,3호선,약수,11501,11015,22516
10181,2020-08-21,3호선,동대입구,6212,6417,12629
10182,2020-08-21,3호선,충무로,2,0,2
10183,2020-08-21,3호선,을지로3가,8673,9184,17857
10184,2020-08-21,3호선,종로3가,8289,9609,17898
10185,2020-08-21,3호선,안국,14556,14677,29233
10186,2020-08-21,3호선,경복궁,14350,13941,28291
10187,2020-08-21,3호선,독립문,5881,5882,11763
10188,2020-08-21,3호선,무악재,3344,3264,6608
10189,2020-08-21,3호선,홍제,14904,14131,29035
10190,2020-08-21,3호선,녹번,12785,11387,24172
10191,2020-08-21,3호선,불광,14046,14790,28836
10192,2020-08-21,3호선,연신내,33219,31074,64293
10193,2020-08-21,3호선,구파발,17291,16234,33525
10194,2020-08-21,3호선,지축,2745,2727,5472
10195,2020-08-22,3호선,원흥,4149,4010,8159
10196,2020-08-22,3호선,삼송,8396,8174,16570
10197,2020-08-22,3호선,원당,5311,5055,10366
10198,2020-08-22,3호선,화정,8048,8441,16489
10199,2020-08-22,3호선,대곡,847,687,1534
10200,2020-08-22,3호선,백석,4796,5099,9895
10201,2020-08-22,3호선,마두,3246,3303,6549
10202,2020-08-22,3호선,정발산,3576,3789,7365
10203,2020-08-22,3호선,주엽,4028,4140,8168
10204,2020-08-22,3호선,대화,5765,5093,10858
10205,2020-08-22,3호선,오금,2397,2275,4672
10206,2020-08-22,3호선,경찰병원,2809,2694,5503
10207,2020-08-22,3호선,가락시장,4182,3795,7977
10208,2020-08-22,3호선,수서,7495,7715,15210
10209,2020-08-22,3호선,일원,3063,3130,6193
10210,2020-08-22,3호선,대청,3843,3554,7397
10211,2020-08-22,3호선,학여울,795,812,1607
10212,2020-08-22,3호선,대치,5853,5406,11259
10213,2020-08-22,3호선,도곡,2254,2266,4520
10214,2020-08-22,3호선,매봉,3798,3733,7531
10215,2020-08-22,3호선,양재,12833,13681,26514
10216,2020-08-22,3호선,남부터미널,11659,12212,23871
10217,2020-08-22,3호선,교대,4124,2709,6833
10218,2020-08-22,3호선,고속터미널,26010,27326,53336
10219,2020-08-22,3호선,잠원,2957,2828,5785
10220,2020-08-22,3호선,신사,14310,15426,29736
10221,2020-08-22,3호선,압구정,16613,17422,34035
10222,2020-08-22,3호선,옥수,4574,4519,9093
10223,2020-08-22,3호선,금호,4095,3741,7836
10224,2020-08-22,3호선,약수,6220,5809,12029
10225,2020-08-22,3호선,동대입구,3585,3772,7357
10226,2020-08-22,3호선,을지로3가,2898,3275,6173
10227,2020-08-22,3호선,종로3가,3226,4066,7292
10228,2020-08-22,3호선,안국,5543,6272,11815
10229,2020-08-22,3호선,경복궁,6161,5868,12029
10230,2020-08-22,3호선,독립문,3657,3535,7192
10231,2020-08-22,3호선,무악재,1796,1837,3633
10232,2020-08-22,3호선,홍제,8911,8311,17222
10233,2020-08-22,3호선,녹번,6675,5915,12590
10234,2020-08-22,3호선,불광,8592,9730,18322
10235,2020-08-22,3호선,연신내,21113,19645,40758
10236,2020-08-22,3호선,구파발,9920,10175,20095
10237,2020-08-22,3호선,지축,1417,1449,2866
10238,2020-08-23,3호선,원흥,2941,2814,5755
10239,2020-08-23,3호선,삼송,6147,6057,12204
10240,2020-08-23,3호선,원당,3942,3800,7742
10241,2020-08-23,3호선,화정,5932,6107,12039
10242,2020-08-23,3호선,대곡,662,634,1296
10243,2020-08-23,3호선,백석,3690,3623,7313
10244,2020-08-23,3호선,마두,2139,2118,4257
10245,2020-08-23,3호선,정발산,2850,2956,5806
10246,2020-08-23,3호선,주엽,2707,2632,5339
10247,2020-08-23,3호선,대화,4019,3572,7591
10248,2020-08-23,3호선,지축,1021,981,2002
10249,2020-08-23,3호선,구파발,7221,7658,14879
10250,2020-08-23,3호선,연신내,15269,14130,29399
10251,2020-08-23,3호선,불광,6356,7619,13975
10252,2020-08-23,3호선,녹번,4325,3914,8239
10253,2020-08-23,3호선,홍제,5764,5503,11267
10254,2020-08-23,3호선,무악재,1122,1190,2312
10255,2020-08-23,3호선,독립문,2389,2522,4911
10256,2020-08-23,3호선,경복궁,4445,4568,9013
10257,2020-08-23,3호선,안국,4127,4526,8653
10258,2020-08-23,3호선,종로3가,1816,2356,4172
10259,2020-08-23,3호선,을지로3가,1274,1343,2617
10260,2020-08-23,3호선,동대입구,3048,3325,6373
10261,2020-08-23,3호선,약수,4105,4089,8194
10262,2020-08-23,3호선,금호,2885,2690,5575
10263,2020-08-23,3호선,옥수,3394,3589,6983
10264,2020-08-23,3호선,압구정,8458,8899,17357
10265,2020-08-23,3호선,신사,7842,8348,16190
10266,2020-08-23,3호선,잠원,1548,1562,3110
10267,2020-08-23,3호선,고속터미널,22675,20481,43156
10268,2020-08-23,3호선,교대,2428,1563,3991
10269,2020-08-23,3호선,남부터미널,8488,8494,16982
10270,2020-08-23,3호선,양재,7613,9127,16740
10271,2020-08-23,3호선,매봉,2570,2544,5114
10272,2020-08-23,3호선,도곡,1111,1148,2259
10273,2020-08-23,3호선,대치,3547,3147,6694
10274,2020-08-23,3호선,학여울,446,490,936
10275,2020-08-23,3호선,대청,2587,2447,5034
10276,2020-08-23,3호선,일원,1888,2051,3939
10277,2020-08-23,3호선,수서,6221,5586,11807
10278,2020-08-23,3호선,가락시장,2317,2536,4853
10279,2020-08-23,3호선,경찰병원,1747,1785,3532
10280,2020-08-23,3호선,오금,1681,1638,3319
10281,2020-08-24,3호선,지축,2739,2789,5528
10282,2020-08-24,3호선,구파발,17417,16437,33854
10283,2020-08-24,3호선,연신내,32465,30232,62697
10284,2020-08-24,3호선,불광,13836,14491,28327
10285,2020-08-24,3호선,녹번,12469,11510,23979
10286,2020-08-24,3호선,홍제,14225,13547,27772
10287,2020-08-24,3호선,무악재,3278,3326,6604
10288,2020-08-24,3호선,독립문,5761,5836,11597
10289,2020-08-24,3호선,경복궁,13289,13030,26319
10290,2020-08-24,3호선,안국,13948,14126,28074
10291,2020-08-24,3호선,종로3가,8494,9605,18099
10292,2020-08-24,3호선,을지로3가,8759,9046,17805
10293,2020-08-24,3호선,충무로,1,0,1
10294,2020-08-24,3호선,동대입구,5928,6292,12220
10295,2020-08-24,3호선,약수,10961,10844,21805
10296,2020-08-24,3호선,금호,6764,6481,13245
10297,2020-08-24,3호선,옥수,7450,7816,15266
10298,2020-08-24,3호선,압구정,24102,26020,50122
10299,2020-08-24,3호선,신사,23326,25035,48361
10300,2020-08-24,3호선,잠원,4474,4443,8917
10301,2020-08-24,3호선,고속터미널,25876,23521,49397
10302,2020-08-24,3호선,교대,11644,7856,19500
10303,2020-08-24,3호선,남부터미널,23415,24101,47516
10304,2020-08-24,3호선,양재,32203,35104,67307
10305,2020-08-24,3호선,매봉,10197,9775,19972
10306,2020-08-24,3호선,도곡,4435,4674,9109
10307,2020-08-24,3호선,대치,8411,8362,16773
10308,2020-08-24,3호선,학여울,1372,1460,2832
10309,2020-08-24,3호선,대청,8064,7554,15618
10310,2020-08-24,3호선,일원,7874,7774,15648
10311,2020-08-24,3호선,수서,13009,13138,26147
10312,2020-08-24,3호선,가락시장,7603,7451,15054
10313,2020-08-24,3호선,경찰병원,6682,6708,13390
10314,2020-08-24,3호선,오금,5320,4800,10120
10315,2020-08-24,3호선,원흥,7746,7507,15253
10316,2020-08-24,3호선,삼송,14554,14269,28823
10317,2020-08-24,3호선,원당,9314,8833,18147
10318,2020-08-24,3호선,화정,13839,14228,28067
10319,2020-08-24,3호선,대곡,1486,1217,2703
10320,2020-08-24,3호선,백석,8253,8253,16506
10321,2020-08-24,3호선,마두,6243,6472,12715
10322,2020-08-24,3호선,정발산,5365,5393,10758
10323,2020-08-24,3호선,주엽,7129,7355,14484
10324,2020-08-24,3호선,대화,11154,8713,19867
10325,2020-08-25,3호선,화정,13994,14481,28475
10326,2020-08-25,3호선,대곡,1591,1183,2774
10327,2020-08-25,3호선,백석,8257,8411,16668
10328,2020-08-25,3호선,마두,6238,6415,12653
10329,2020-08-25,3호선,정발산,5629,5748,11377
10330,2020-08-25,3호선,주엽,7114,7250,14364
10331,2020-08-25,3호선,대화,11178,8778,19956
10332,2020-08-25,3호선,오금,5337,4795,10132
10333,2020-08-25,3호선,경찰병원,6655,6607,13262
10334,2020-08-25,3호선,가락시장,7723,7431,15154
10335,2020-08-25,3호선,수서,12923,13143,26066
10336,2020-08-25,3호선,일원,7847,7795,15642
10337,2020-08-25,3호선,대청,8353,7560,15913
10338,2020-08-25,3호선,학여울,1446,1470,2916
10339,2020-08-25,3호선,대치,8535,8568,17103
10340,2020-08-25,3호선,도곡,4504,4477,8981
10341,2020-08-25,3호선,매봉,10402,9856,20258
10342,2020-08-25,3호선,양재,32743,35208,67951
10343,2020-08-25,3호선,남부터미널,22993,23542,46535
10344,2020-08-25,3호선,교대,11662,7824,19486
10345,2020-08-25,3호선,고속터미널,28374,27101,55475
10346,2020-08-25,3호선,잠원,4513,4397,8910
10347,2020-08-25,3호선,신사,24173,25918,50091
10348,2020-08-25,3호선,압구정,26480,28504,54984
10349,2020-08-25,3호선,옥수,7615,7998,15613
10350,2020-08-25,3호선,금호,6841,6486,13327
10351,2020-08-25,3호선,약수,11091,11021,22112
10352,2020-08-25,3호선,동대입구,6008,6278,12286
10353,2020-08-25,3호선,을지로3가,8856,9115,17971
10354,2020-08-25,3호선,종로3가,8691,9691,18382
10355,2020-08-25,3호선,안국,14228,14664,28892
10356,2020-08-25,3호선,경복궁,13782,13362,27144
10357,2020-08-25,3호선,독립문,5915,5948,11863
10358,2020-08-25,3호선,무악재,3250,3354,6604
10359,2020-08-25,3호선,홍제,14528,13858,28386
10360,2020-08-25,3호선,녹번,12451,11387,23838
10361,2020-08-25,3호선,불광,13924,14883,28807
10362,2020-08-25,3호선,연신내,32497,30407,62904
10363,2020-08-25,3호선,구파발,17565,16623,34188
10364,2020-08-25,3호선,지축,2680,2774,5454
10365,2020-08-25,3호선,원흥,7742,7495,15237
10366,2020-08-25,3호선,삼송,14576,14423,28999
10367,2020-08-25,3호선,원당,9335,8963,18298
10368,2020-08-26,3호선,지축,2591,2635,5226
10369,2020-08-26,3호선,구파발,16613,15640,32253
10370,2020-08-26,3호선,연신내,31364,29195,60559
10371,2020-08-26,3호선,불광,13406,14188,27594
10372,2020-08-26,3호선,녹번,12341,11292,23633
10373,2020-08-26,3호선,홍제,14094,13604,27698
10374,2020-08-26,3호선,무악재,3151,3237,6388
10375,2020-08-26,3호선,독립문,5595,5716,11311
10376,2020-08-26,3호선,경복궁,13660,13134,26794
10377,2020-08-26,3호선,안국,14233,14195,28428
10378,2020-08-26,3호선,종로3가,8678,9642,18320
10379,2020-08-26,3호선,을지로3가,8740,8936,17676
10380,2020-08-26,3호선,동대입구,6109,6273,12382
10381,2020-08-26,3호선,약수,10613,10582,21195
10382,2020-08-26,3호선,금호,6634,6202,12836
10383,2020-08-26,3호선,옥수,7226,7677,14903
10384,2020-08-26,3호선,압구정,25458,27195,52653
10385,2020-08-26,3호선,신사,22723,24026,46749
10386,2020-08-26,3호선,잠원,4407,4344,8751
10387,2020-08-26,3호선,고속터미널,27246,25741,52987
10388,2020-08-26,3호선,교대,11417,7636,19053
10389,2020-08-26,3호선,남부터미널,22671,23301,45972
10390,2020-08-26,3호선,양재,32317,34279,66596
10391,2020-08-26,3호선,매봉,10025,9641,19666
10392,2020-08-26,3호선,도곡,4322,4279,8601
10393,2020-08-26,3호선,대치,8256,8393,16649
10394,2020-08-26,3호선,학여울,1417,1464,2881
10395,2020-08-26,3호선,대청,8195,7538,15733
10396,2020-08-26,3호선,일원,7840,7843,15683
10397,2020-08-26,3호선,수서,12502,12711,25213
10398,2020-08-26,3호선,가락시장,7586,7372,14958
10399,2020-08-26,3호선,경찰병원,6497,6492,12989
10400,2020-08-26,3호선,오금,5220,4798,10018
10401,2020-08-26,3호선,원흥,7460,7245,14705
10402,2020-08-26,3호선,삼송,14173,14110,28283
10403,2020-08-26,3호선,원당,9041,8666,17707
10404,2020-08-26,3호선,화정,13535,14047,27582
10405,2020-08-26,3호선,대곡,1429,1132,2561
10406,2020-08-26,3호선,백석,7879,7974,15853
10407,2020-08-26,3호선,마두,6005,6343,12348
10408,2020-08-26,3호선,정발산,5552,5490,11042
10409,2020-08-26,3호선,주엽,6890,7102,13992
10410,2020-08-26,3호선,대화,10791,8587,19378
10411,2020-08-27,3호선,약수,9920,9783,19703
10412,2020-08-27,3호선,동대입구,5442,5568,11010
10413,2020-08-27,3호선,을지로3가,8258,8751,17009
10414,2020-08-27,3호선,종로3가,7960,9058,17018
10415,2020-08-27,3호선,안국,13118,13321,26439
10416,2020-08-27,3호선,경복궁,12361,12005,24366
10417,2020-08-27,3호선,독립문,5278,5360,10638
10418,2020-08-27,3호선,무악재,2992,2928,5920
10419,2020-08-27,3호선,홍제,13020,12368,25388
10420,2020-08-27,3호선,녹번,11478,10427,21905
10421,2020-08-27,3호선,불광,12221,13127,25348
10422,2020-08-27,3호선,연신내,28642,26755,55397
10423,2020-08-27,3호선,구파발,15440,14248,29688
10424,2020-08-27,3호선,지축,2380,2393,4773
10425,2020-08-27,3호선,대화,9909,7541,17450
10426,2020-08-27,3호선,주엽,6052,6198,12250
10427,2020-08-27,3호선,정발산,4715,4731,9446
10428,2020-08-27,3호선,마두,5364,5642,11006
10429,2020-08-27,3호선,백석,7154,7193,14347
10430,2020-08-27,3호선,대곡,1326,1013,2339
10431,2020-08-27,3호선,화정,12075,12491,24566
10432,2020-08-27,3호선,원당,8036,7798,15834
10433,2020-08-27,3호선,삼송,12986,12680,25666
10434,2020-08-27,3호선,원흥,6747,6491,13238
10435,2020-08-27,3호선,오금,4946,4386,9332
10436,2020-08-27,3호선,경찰병원,6191,6245,12436
10437,2020-08-27,3호선,가락시장,7184,6879,14063
10438,2020-08-27,3호선,수서,11741,12020,23761
10439,2020-08-27,3호선,일원,7369,7347,14716
10440,2020-08-27,3호선,대청,7675,7035,14710
10441,2020-08-27,3호선,학여울,1271,1279,2550
10442,2020-08-27,3호선,대치,7966,7990,15956
10443,2020-08-27,3호선,도곡,3920,4013,7933
10444,2020-08-27,3호선,매봉,9506,8961,18467
10445,2020-08-27,3호선,양재,29980,32177,62157
10446,2020-08-27,3호선,남부터미널,21033,21792,42825
10447,2020-08-27,3호선,교대,10763,7263,18026
10448,2020-08-27,3호선,고속터미널,24382,23868,48250
10449,2020-08-27,3호선,잠원,4195,4039,8234
10450,2020-08-27,3호선,신사,21214,22965,44179
10451,2020-08-27,3호선,압구정,23612,24877,48489
10452,2020-08-27,3호선,옥수,6817,7128,13945
10453,2020-08-27,3호선,금호,6252,5883,12135
10454,2020-08-28,3호선,대화,10743,8505,19248
10455,2020-08-28,3호선,주엽,6764,6819,13583
10456,2020-08-28,3호선,정발산,5327,5536,10863
10457,2020-08-28,3호선,마두,5807,6184,11991
10458,2020-08-28,3호선,백석,7839,8099,15938
10459,2020-08-28,3호선,대곡,1491,1191,2682
10460,2020-08-28,3호선,화정,13390,13883,27273
10461,2020-08-28,3호선,원당,8960,8550,17510
10462,2020-08-28,3호선,삼송,13993,13899,27892
10463,2020-08-28,3호선,원흥,7441,7011,14452
10464,2020-08-28,3호선,오금,5248,4697,9945
10465,2020-08-28,3호선,경찰병원,6354,6302,12656
10466,2020-08-28,3호선,가락시장,7589,7409,14998
10467,2020-08-28,3호선,수서,13371,13985,27356
10468,2020-08-28,3호선,일원,7350,7115,14465
10469,2020-08-28,3호선,대청,7902,7224,15126
10470,2020-08-28,3호선,학여울,1434,1454,2888
10471,2020-08-28,3호선,대치,8445,8521,16966
10472,2020-08-28,3호선,도곡,3972,4023,7995
10473,2020-08-28,3호선,매봉,9976,9476,19452
10474,2020-08-28,3호선,양재,32459,33805,66264
10475,2020-08-28,3호선,남부터미널,23628,24575,48203
10476,2020-08-28,3호선,교대,11346,7602,18948
10477,2020-08-28,3호선,고속터미널,30198,32126,62324
10478,2020-08-28,3호선,잠원,4442,4300,8742
10479,2020-08-28,3호선,신사,23902,25881,49783
10480,2020-08-28,3호선,압구정,26238,28260,54498
10481,2020-08-28,3호선,옥수,7355,7639,14994
10482,2020-08-28,3호선,금호,6779,6310,13089
10483,2020-08-28,3호선,약수,10714,10558,21272
10484,2020-08-28,3호선,동대입구,5937,6121,12058
10485,2020-08-28,3호선,충무로,3,0,3
10486,2020-08-28,3호선,을지로3가,8494,9031,17525
10487,2020-08-28,3호선,종로3가,8020,9278,17298
10488,2020-08-28,3호선,안국,13844,14179,28023
10489,2020-08-28,3호선,경복궁,13051,12582,25633
10490,2020-08-28,3호선,독립문,5680,5642,11322
10491,2020-08-28,3호선,무악재,3202,3143,6345
10492,2020-08-28,3호선,홍제,14200,13555,27755
10493,2020-08-28,3호선,녹번,12188,10852,23040
10494,2020-08-28,3호선,불광,13366,14095,27461
10495,2020-08-28,3호선,연신내,31354,29144,60498
10496,2020-08-28,3호선,구파발,16217,15045,31262
10497,2020-08-28,3호선,지축,2627,2601,5228
10498,2020-08-29,3호선,대화,5292,4769,10061
10499,2020-08-29,3호선,주엽,3767,3751,7518
10500,2020-08-29,3호선,오금,2254,2093,4347
10501,2020-08-29,3호선,경찰병원,2514,2446,4960
10502,2020-08-29,3호선,가락시장,3858,3551,7409
10503,2020-08-29,3호선,수서,6580,6828,13408
10504,2020-08-29,3호선,일원,2753,2838,5591
10505,2020-08-29,3호선,대청,3615,3222,6837
10506,2020-08-29,3호선,학여울,660,627,1287
10507,2020-08-29,3호선,대치,5421,4996,10417
10508,2020-08-29,3호선,도곡,1970,1868,3838
10509,2020-08-29,3호선,매봉,3539,3388,6927
10510,2020-08-29,3호선,양재,11127,12143,23270
10511,2020-08-29,3호선,남부터미널,10722,11258,21980
10512,2020-08-29,3호선,교대,3700,2418,6118
10513,2020-08-29,3호선,고속터미널,22986,23740,46726
10514,2020-08-29,3호선,잠원,2834,2660,5494
10515,2020-08-29,3호선,신사,12726,13652,26378
10516,2020-08-29,3호선,압구정,15295,16088,31383
10517,2020-08-29,3호선,옥수,4185,4275,8460
10518,2020-08-29,3호선,금호,3835,3538,7373
10519,2020-08-29,3호선,약수,5985,5599,11584
10520,2020-08-29,3호선,동대입구,3498,3696,7194
10521,2020-08-29,3호선,을지로3가,2667,2847,5514
10522,2020-08-29,3호선,종로3가,2782,3485,6267
10523,2020-08-29,3호선,안국,4975,5431,10406
10524,2020-08-29,3호선,경복궁,5466,5269,10735
10525,2020-08-29,3호선,독립문,3136,3159,6295
10526,2020-08-29,3호선,무악재,1685,1670,3355
10527,2020-08-29,3호선,홍제,8282,7871,16153
10528,2020-08-29,3호선,녹번,6150,5461,11611
10529,2020-08-29,3호선,불광,8155,9147,17302
10530,2020-08-29,3호선,연신내,19754,18373,38127
10531,2020-08-29,3호선,구파발,8968,8890,17858
10532,2020-08-29,3호선,지축,1339,1323,2662
10533,2020-08-29,3호선,정발산,3310,3546,6856
10534,2020-08-29,3호선,원흥,4054,3925,7979
10535,2020-08-29,3호선,삼송,7777,7665,15442
10536,2020-08-29,3호선,원당,5098,4871,9969
10537,2020-08-29,3호선,화정,7457,7842,15299
10538,2020-08-29,3호선,대곡,801,704,1505
10539,2020-08-29,3호선,백석,4742,4817,9559
10540,2020-08-29,3호선,마두,3076,3096,6172
10541,2020-08-30,3호선,지축,916,846,1762
10542,2020-08-30,3호선,구파발,6301,6440,12741
10543,2020-08-30,3호선,연신내,13005,12077,25082
10544,2020-08-30,3호선,불광,5413,6300,11713
10545,2020-08-30,3호선,녹번,3803,3458,7261
10546,2020-08-30,3호선,홍제,5077,4970,10047
10547,2020-08-30,3호선,무악재,1021,1095,2116
10548,2020-08-30,3호선,독립문,2240,2241,4481
10549,2020-08-30,3호선,경복궁,3481,3541,7022
10550,2020-08-30,3호선,안국,3580,3841,7421
10551,2020-08-30,3호선,종로3가,1658,2009,3667
10552,2020-08-30,3호선,을지로3가,1136,1187,2323
10553,2020-08-30,3호선,충무로,1,0,1
10554,2020-08-30,3호선,동대입구,2865,2988,5853
10555,2020-08-30,3호선,약수,3640,3556,7196
10556,2020-08-30,3호선,금호,2459,2380,4839
10557,2020-08-30,3호선,옥수,2881,3087,5968
10558,2020-08-30,3호선,압구정,7372,7736,15108
10559,2020-08-30,3호선,신사,6398,6579,12977
10560,2020-08-30,3호선,잠원,1562,1496,3058
10561,2020-08-30,3호선,고속터미널,18774,17248,36022
10562,2020-08-30,3호선,교대,2008,1312,3320
10563,2020-08-30,3호선,남부터미널,7547,7677,15224
10564,2020-08-30,3호선,양재,6327,7799,14126
10565,2020-08-30,3호선,매봉,2136,2106,4242
10566,2020-08-30,3호선,도곡,988,1029,2017
10567,2020-08-30,3호선,대치,3043,2711,5754
10568,2020-08-30,3호선,학여울,421,448,869
10569,2020-08-30,3호선,대청,2205,2130,4335
10570,2020-08-30,3호선,일원,1620,1741,3361
10571,2020-08-30,3호선,수서,5348,4937,10285
10572,2020-08-30,3호선,가락시장,2162,2377,4539
10573,2020-08-30,3호선,경찰병원,1587,1615,3202
10574,2020-08-30,3호선,오금,1496,1416,2912
10575,2020-08-30,3호선,원흥,2641,2556,5197
10576,2020-08-30,3호선,삼송,5385,5359,10744
10577,2020-08-30,3호선,원당,3514,3430,6944
10578,2020-08-30,3호선,화정,5041,5128,10169
10579,2020-08-30,3호선,대곡,575,485,1060
10580,2020-08-30,3호선,백석,3286,3223,6509
10581,2020-08-30,3호선,마두,1795,1811,3606
10582,2020-08-30,3호선,정발산,2560,2528,5088
10583,2020-08-30,3호선,주엽,2358,2338,4696
10584,2020-08-30,3호선,대화,3597,3275,6872
10585,2020-08-31,3호선,대화,10364,7902,18266
10586,2020-08-31,3호선,주엽,6462,6542,13004
10587,2020-08-31,3호선,정발산,5044,4864,9908
10588,2020-08-31,3호선,마두,5452,5692,11144
10589,2020-08-31,3호선,백석,7515,7559,15074
10590,2020-08-31,3호선,대곡,1428,1053,2481
10591,2020-08-31,3호선,화정,12653,12967,25620
10592,2020-08-31,3호선,원당,8840,8495,17335
10593,2020-08-31,3호선,삼송,13556,13426,26982
10594,2020-08-31,3호선,원흥,7073,6824,13897
10595,2020-08-31,3호선,지축,2554,2585,5139
10596,2020-08-31,3호선,구파발,16198,15273,31471
10597,2020-08-31,3호선,연신내,30194,28122,58316
10598,2020-08-31,3호선,불광,12984,13857,26841
10599,2020-08-31,3호선,녹번,11883,10991,22874
10600,2020-08-31,3호선,홍제,13514,13080,26594
10601,2020-08-31,3호선,무악재,3033,3079,6112
10602,2020-08-31,3호선,독립문,5427,5581,11008
10603,2020-08-31,3호선,경복궁,12319,11968,24287
10604,2020-08-31,3호선,안국,13462,13529,26991
10605,2020-08-31,3호선,종로3가,7640,8646,16286
10606,2020-08-31,3호선,을지로3가,8180,8520,16700
10607,2020-08-31,3호선,충무로,1,0,1
10608,2020-08-31,3호선,동대입구,5470,5617,11087
10609,2020-08-31,3호선,약수,9887,9763,19650
10610,2020-08-31,3호선,금호,6380,5998,12378
10611,2020-08-31,3호선,옥수,6881,7219,14100
10612,2020-08-31,3호선,압구정,23737,25275,49012
10613,2020-08-31,3호선,신사,21200,22359,43559
10614,2020-08-31,3호선,잠원,4116,4048,8164
10615,2020-08-31,3호선,고속터미널,25004,23815,48819
10616,2020-08-31,3호선,교대,10594,7103,17697
10617,2020-08-31,3호선,남부터미널,22056,22842,44898
10618,2020-08-31,3호선,양재,30018,32728,62746
10619,2020-08-31,3호선,매봉,9456,8964,18420
10620,2020-08-31,3호선,도곡,4183,4184,8367
10621,2020-08-31,3호선,대치,7048,7033,14081
10622,2020-08-31,3호선,학여울,1336,1365,2701
10623,2020-08-31,3호선,대청,7399,6792,14191
10624,2020-08-31,3호선,일원,7236,7163,14399
10625,2020-08-31,3호선,수서,12248,12611,24859
10626,2020-08-31,3호선,가락시장,7090,6918,14008
10627,2020-08-31,3호선,경찰병원,6072,6183,12255
10628,2020-08-31,3호선,오금,5000,4515,9515
10629,2020-09-01,3호선,주엽,6123,6290,12413
10630,2020-09-01,3호선,대화,10034,7923,17957
10631,2020-09-01,3호선,지축,2413,2512,4925
10632,2020-09-01,3호선,구파발,15799,14922,30721
10633,2020-09-01,3호선,연신내,29662,27762,57424
10634,2020-09-01,3호선,불광,12831,13640,26471
10635,2020-09-01,3호선,녹번,11617,10708,22325
10636,2020-09-01,3호선,홍제,13334,12820,26154
10637,2020-09-01,3호선,무악재,2967,3082,6049
10638,2020-09-01,3호선,독립문,5421,5584,11005
10639,2020-09-01,3호선,경복궁,12442,12063,24505
10640,2020-09-01,3호선,안국,13270,13524,26794
10641,2020-09-01,3호선,종로3가,7658,8667,16325
10642,2020-09-01,3호선,을지로3가,8193,8479,16672
10643,2020-09-01,3호선,동대입구,5506,5660,11166
10644,2020-09-01,3호선,약수,9813,9777,19590
10645,2020-09-01,3호선,금호,6353,6001,12354
10646,2020-09-01,3호선,옥수,6739,7014,13753
10647,2020-09-01,3호선,압구정,23814,25196,49010
10648,2020-09-01,3호선,신사,21284,22089,43373
10649,2020-09-01,3호선,잠원,3977,3973,7950
10650,2020-09-01,3호선,고속터미널,23686,23246,46932
10651,2020-09-01,3호선,교대,10392,6968,17360
10652,2020-09-01,3호선,남부터미널,21242,21888,43130
10653,2020-09-01,3호선,양재,29730,31964,61694
10654,2020-09-01,3호선,매봉,9449,8872,18321
10655,2020-09-01,3호선,도곡,4117,4077,8194
10656,2020-09-01,3호선,대치,6944,6876,13820
10657,2020-09-01,3호선,학여울,1258,1315,2573
10658,2020-09-01,3호선,대청,7120,6601,13721
10659,2020-09-01,3호선,일원,7192,7162,14354
10660,2020-09-01,3호선,수서,11504,11626,23130
10661,2020-09-01,3호선,가락시장,6862,6744,13606
10662,2020-09-01,3호선,경찰병원,6034,6068,12102
10663,2020-09-01,3호선,오금,4963,4479,9442
10664,2020-09-01,3호선,원흥,6923,6681,13604
10665,2020-09-01,3호선,삼송,13114,13038,26152
10666,2020-09-01,3호선,원당,8567,8209,16776
10667,2020-09-01,3호선,화정,12198,12536,24734
10668,2020-09-01,3호선,대곡,1344,1063,2407
10669,2020-09-01,3호선,백석,7501,7648,15149
10670,2020-09-01,3호선,마두,5298,5642,10940
10671,2020-09-01,3호선,정발산,4775,4783,9558
10672,2020-09-02,3호선,원흥,6467,6195,12662
10673,2020-09-02,3호선,지축,1,0,1
10674,2020-09-02,3호선,삼송,12544,12677,25221
10675,2020-09-02,3호선,원당,8052,7846,15898
10676,2020-09-02,3호선,화정,11519,12127,23646
10677,2020-09-02,3호선,대곡,1278,1003,2281
10678,2020-09-02,3호선,백석,7001,7147,14148
10679,2020-09-02,3호선,마두,4936,5339,10275
10680,2020-09-02,3호선,정발산,4440,4308,8748
10681,2020-09-02,3호선,주엽,5960,6046,12006
10682,2020-09-02,3호선,대화,9605,7645,17250
10683,2020-09-02,3호선,지축,2341,2323,4664
10684,2020-09-02,3호선,구파발,15434,14492,29926
10685,2020-09-02,3호선,연신내,28193,26723,54916
10686,2020-09-02,3호선,불광,12276,13046,25322
10687,2020-09-02,3호선,녹번,11456,10657,22113
10688,2020-09-02,3호선,홍제,12860,12673,25533
10689,2020-09-02,3호선,무악재,2966,3065,6031
10690,2020-09-02,3호선,독립문,5057,5278,10335
10691,2020-09-02,3호선,경복궁,12299,11719,24018
10692,2020-09-02,3호선,안국,13494,13137,26631
10693,2020-09-02,3호선,종로3가,7894,8525,16419
10694,2020-09-02,3호선,을지로3가,8501,8197,16698
10695,2020-09-02,3호선,충무로,2,0,2
10696,2020-09-02,3호선,동대입구,5136,5256,10392
10697,2020-09-02,3호선,약수,9476,9361,18837
10698,2020-09-02,3호선,금호,5946,5690,11636
10699,2020-09-02,3호선,옥수,6320,6795,13115
10700,2020-09-02,3호선,압구정,22765,23903,46668
10701,2020-09-02,3호선,신사,20403,21130,41533
10702,2020-09-02,3호선,잠원,3857,3781,7638
10703,2020-09-02,3호선,고속터미널,22620,21617,44237
10704,2020-09-02,3호선,교대,9992,6748,16740
10705,2020-09-02,3호선,남부터미널,20774,21276,42050
10706,2020-09-02,3호선,양재,29013,31083,60096
10707,2020-09-02,3호선,매봉,9224,8717,17941
10708,2020-09-02,3호선,도곡,3917,3802,7719
10709,2020-09-02,3호선,대치,6717,6621,13338
10710,2020-09-02,3호선,학여울,1180,1268,2448
10711,2020-09-02,3호선,대청,6937,6377,13314
10712,2020-09-02,3호선,일원,6978,6967,13945
10713,2020-09-02,3호선,수서,11013,11426,22439
10714,2020-09-02,3호선,가락시장,6436,6326,12762
10715,2020-09-02,3호선,경찰병원,5915,5924,11839
10716,2020-09-02,3호선,오금,4838,4382,9220
10717,2020-09-03,3호선,주엽,5538,5692,11230
10718,2020-09-03,3호선,정발산,4429,4475,8904
10719,2020-09-03,3호선,마두,4936,5178,10114
10720,2020-09-03,3호선,백석,7028,7109,14137
10721,2020-09-03,3호선,대곡,1288,992,2280
10722,2020-09-03,3호선,화정,11625,11927,23552
10723,2020-09-03,3호선,원당,8127,7891,16018
10724,2020-09-03,3호선,삼송,12558,12424,24982
10725,2020-09-03,3호선,원흥,6602,6261,12863
10726,2020-09-03,3호선,오금,4700,4265,8965
10727,2020-09-03,3호선,경찰병원,5790,5677,11467
10728,2020-09-03,3호선,가락시장,6695,6470,13165
10729,2020-09-03,3호선,수서,11114,11363,22477
10730,2020-09-03,3호선,일원,6918,6827,13745
10731,2020-09-03,3호선,대청,6902,6357,13259
10732,2020-09-03,3호선,학여울,1260,1295,2555
10733,2020-09-03,3호선,대치,6664,6517,13181
10734,2020-09-03,3호선,도곡,3918,3896,7814
10735,2020-09-03,3호선,매봉,8923,8417,17340
10736,2020-09-03,3호선,양재,28434,30718,59152
10737,2020-09-03,3호선,남부터미널,20282,21090,41372
10738,2020-09-03,3호선,교대,10081,6762,16843
10739,2020-09-03,3호선,고속터미널,22837,22516,45353
10740,2020-09-03,3호선,잠원,3879,3928,7807
10741,2020-09-03,3호선,신사,20263,21285,41548
10742,2020-09-03,3호선,압구정,22481,23729,46210
10743,2020-09-03,3호선,옥수,6556,6882,13438
10744,2020-09-03,3호선,금호,6013,5583,11596
10745,2020-09-03,3호선,약수,9517,9273,18790
10746,2020-09-03,3호선,동대입구,5222,5398,10620
10747,2020-09-03,3호선,충무로,1,0,1
10748,2020-09-03,3호선,을지로3가,7966,8400,16366
10749,2020-09-03,3호선,종로3가,7507,8504,16011
10750,2020-09-03,3호선,안국,12639,12785,25424
10751,2020-09-03,3호선,경복궁,12247,11643,23890
10752,2020-09-03,3호선,독립문,5010,5111,10121
10753,2020-09-03,3호선,무악재,2803,2845,5648
10754,2020-09-03,3호선,홍제,12729,12242,24971
10755,2020-09-03,3호선,녹번,11188,10189,21377
10756,2020-09-03,3호선,불광,12009,12808,24817
10757,2020-09-03,3호선,연신내,28214,26539,54753
10758,2020-09-03,3호선,구파발,15010,14147,29157
10759,2020-09-03,3호선,지축,2328,2300,4628
10760,2020-09-03,3호선,대화,9334,7262,16596
10761,2020-09-04,3호선,지축,2629,2607,5236
10762,2020-09-04,3호선,구파발,16468,15578,32046
10763,2020-09-04,3호선,연신내,31206,29279,60485
10764,2020-09-04,3호선,불광,13433,14490,27923
10765,2020-09-04,3호선,녹번,12252,11004,23256
10766,2020-09-04,3호선,홍제,14213,13584,27797
10767,2020-09-04,3호선,무악재,3176,3176,6352
10768,2020-09-04,3호선,독립문,5772,5938,11710
10769,2020-09-04,3호선,경복궁,13373,12918,26291
10770,2020-09-04,3호선,안국,13789,14055,27844
10771,2020-09-04,3호선,종로3가,7589,8792,16381
10772,2020-09-04,3호선,을지로3가,8277,8545,16822
10773,2020-09-04,3호선,동대입구,5783,6078,11861
10774,2020-09-04,3호선,약수,10552,10396,20948
10775,2020-09-04,3호선,금호,6732,6316,13048
10776,2020-09-04,3호선,옥수,7413,7553,14966
10777,2020-09-04,3호선,압구정,25701,27221,52922
10778,2020-09-04,3호선,신사,23330,24383,47713
10779,2020-09-04,3호선,잠원,4463,4397,8860
10780,2020-09-04,3호선,고속터미널,29832,32054,61886
10781,2020-09-04,3호선,교대,10716,7121,17837
10782,2020-09-04,3호선,남부터미널,23418,24289,47707
10783,2020-09-04,3호선,양재,31174,32147,63321
10784,2020-09-04,3호선,매봉,9507,9068,18575
10785,2020-09-04,3호선,도곡,4142,4015,8157
10786,2020-09-04,3호선,대치,7436,7265,14701
10787,2020-09-04,3호선,학여울,1368,1408,2776
10788,2020-09-04,3호선,대청,7409,6754,14163
10789,2020-09-04,3호선,일원,7181,7005,14186
10790,2020-09-04,3호선,수서,12979,13903,26882
10791,2020-09-04,3호선,가락시장,7446,7330,14776
10792,2020-09-04,3호선,경찰병원,6113,6030,12143
10793,2020-09-04,3호선,오금,5224,4601,9825
10794,2020-09-04,3호선,원흥,7260,6947,14207
10795,2020-09-04,3호선,삼송,13990,13890,27880
10796,2020-09-04,3호선,원당,9037,8585,17622
10797,2020-09-04,3호선,화정,13059,13592,26651
10798,2020-09-04,3호선,대곡,1494,1221,2715
10799,2020-09-04,3호선,백석,7948,8114,16062
10800,2020-09-04,3호선,마두,5523,5776,11299
10801,2020-09-04,3호선,정발산,5411,5550,10961
10802,2020-09-04,3호선,주엽,6431,6714,13145
10803,2020-09-04,3호선,대화,10260,8168,18428
10804,2020-09-05,3호선,지축,1486,1445,2931
10805,2020-09-05,3호선,구파발,10194,10448,20642
10806,2020-09-05,3호선,연신내,21364,19632,40996
10807,2020-09-05,3호선,불광,9091,10530,19621
10808,2020-09-05,3호선,녹번,6542,5851,12393
10809,2020-09-05,3호선,홍제,8970,8487,17457
10810,2020-09-05,3호선,무악재,1744,1773,3517
10811,2020-09-05,3호선,독립문,3753,3750,7503
10812,2020-09-05,3호선,경복궁,6525,6639,13164
10813,2020-09-05,3호선,안국,5548,6330,11878
10814,2020-09-05,3호선,종로3가,2659,3595,6254
10815,2020-09-05,3호선,을지로3가,2696,2965,5661
10816,2020-09-05,3호선,충무로,1,0,1
10817,2020-09-05,3호선,동대입구,3934,4345,8279
10818,2020-09-05,3호선,약수,6217,5758,11975
10819,2020-09-05,3호선,금호,4084,3696,7780
10820,2020-09-05,3호선,옥수,4836,4810,9646
10821,2020-09-05,3호선,압구정,15998,16626,32624
10822,2020-09-05,3호선,신사,13371,14130,27501
10823,2020-09-05,3호선,잠원,2565,2488,5053
10824,2020-09-05,3호선,고속터미널,25111,25469,50580
10825,2020-09-05,3호선,교대,3525,2227,5752
10826,2020-09-05,3호선,남부터미널,11356,11768,23124
10827,2020-09-05,3호선,양재,11748,12707,24455
10828,2020-09-05,3호선,매봉,3657,3417,7074
10829,2020-09-05,3호선,도곡,1973,1915,3888
10830,2020-09-05,3호선,대치,4434,4131,8565
10831,2020-09-05,3호선,학여울,659,662,1321
10832,2020-09-05,3호선,대청,3614,3298,6912
10833,2020-09-05,3호선,일원,3002,2932,5934
10834,2020-09-05,3호선,수서,7022,7271,14293
10835,2020-09-05,3호선,가락시장,4174,3958,8132
10836,2020-09-05,3호선,경찰병원,2636,2565,5201
10837,2020-09-05,3호선,오금,2446,2244,4690
10838,2020-09-05,3호선,원흥,4284,4165,8449
10839,2020-09-05,3호선,삼송,8429,8444,16873
10840,2020-09-05,3호선,원당,5574,5288,10862
10841,2020-09-05,3호선,화정,8058,8538,16596
10842,2020-09-05,3호선,대곡,885,767,1652
10843,2020-09-05,3호선,백석,5019,5138,10157
10844,2020-09-05,3호선,마두,3157,3274,6431
10845,2020-09-05,3호선,정발산,3911,4075,7986
10846,2020-09-05,3호선,주엽,3858,3987,7845
10847,2020-09-05,3호선,대화,5730,4952,10682
10848,2020-09-06,3호선,원흥,2800,2676,5476
10849,2020-09-06,3호선,삼송,5814,5824,11638
10850,2020-09-06,3호선,원당,3788,3617,7405
10851,2020-09-06,3호선,화정,5313,5522,10835
10852,2020-09-06,3호선,대곡,651,585,1236
10853,2020-09-06,3호선,백석,3453,3292,6745
10854,2020-09-06,3호선,마두,1856,1895,3751
10855,2020-09-06,3호선,정발산,2685,2660,5345
10856,2020-09-06,3호선,주엽,2456,2431,4887
10857,2020-09-06,3호선,대화,3915,3468,7383
10858,2020-09-06,3호선,대치,2371,2204,4575
10859,2020-09-06,3호선,도곡,1073,1093,2166
10860,2020-09-06,3호선,매봉,2242,2236,4478
10861,2020-09-06,3호선,양재,6942,8193,15135
10862,2020-09-06,3호선,남부터미널,7800,7843,15643
10863,2020-09-06,3호선,교대,1889,1260,3149
10864,2020-09-06,3호선,고속터미널,21003,18524,39527
10865,2020-09-06,3호선,잠원,1414,1435,2849
10866,2020-09-06,3호선,신사,6625,6875,13500
10867,2020-09-06,3호선,압구정,7492,7882,15374
10868,2020-09-06,3호선,옥수,3154,3314,6468
10869,2020-09-06,3호선,금호,2607,2572,5179
10870,2020-09-06,3호선,약수,3819,3723,7542
10871,2020-09-06,3호선,동대입구,2778,3120,5898
10872,2020-09-06,3호선,충무로,1,0,1
10873,2020-09-06,3호선,을지로3가,1199,1254,2453
10874,2020-09-06,3호선,종로3가,1524,2072,3596
10875,2020-09-06,3호선,안국,3848,4070,7918
10876,2020-09-06,3호선,경복궁,4116,4275,8391
10877,2020-09-06,3호선,독립문,2267,2347,4614
10878,2020-09-06,3호선,무악재,1043,1181,2224
10879,2020-09-06,3호선,홍제,5573,5341,10914
10880,2020-09-06,3호선,녹번,4007,3737,7744
10881,2020-09-06,3호선,불광,5900,7028,12928
10882,2020-09-06,3호선,연신내,14095,13082,27177
10883,2020-09-06,3호선,구파발,6707,7130,13837
10884,2020-09-06,3호선,지축,994,904,1898
10885,2020-09-06,3호선,오금,1597,1592,3189
10886,2020-09-06,3호선,경찰병원,1520,1585,3105
10887,2020-09-06,3호선,가락시장,2286,2505,4791
10888,2020-09-06,3호선,수서,5781,5356,11137
10889,2020-09-06,3호선,일원,1775,1973,3748
10890,2020-09-06,3호선,대청,2410,2269,4679
10891,2020-09-06,3호선,학여울,413,431,844
10892,2020-09-07,3호선,오금,4734,4322,9056
10893,2020-09-07,3호선,경찰병원,6237,6271,12508
10894,2020-09-07,3호선,가락시장,6613,6470,13083
10895,2020-09-07,3호선,수서,11620,11816,23436
10896,2020-09-07,3호선,일원,7116,7168,14284
10897,2020-09-07,3호선,대청,7283,6675,13958
10898,2020-09-07,3호선,학여울,1237,1287,2524
10899,2020-09-07,3호선,대치,6989,6855,13844
10900,2020-09-07,3호선,도곡,4065,4059,8124
10901,2020-09-07,3호선,매봉,9241,8746,17987
10902,2020-09-07,3호선,양재,29248,31322,60570
10903,2020-09-07,3호선,남부터미널,21574,21953,43527
10904,2020-09-07,3호선,교대,10266,6927,17193
10905,2020-09-07,3호선,고속터미널,24280,22593,46873
10906,2020-09-07,3호선,잠원,3888,3905,7793
10907,2020-09-07,3호선,신사,20933,21730,42663
10908,2020-09-07,3호선,압구정,22813,24037,46850
10909,2020-09-07,3호선,옥수,6248,6787,13035
10910,2020-09-07,3호선,금호,6062,5749,11811
10911,2020-09-07,3호선,약수,9562,9529,19091
10912,2020-09-07,3호선,동대입구,5247,5258,10505
10913,2020-09-07,3호선,충무로,1,0,1
10914,2020-09-07,3호선,을지로3가,8541,8673,17214
10915,2020-09-07,3호선,종로3가,7694,8440,16134
10916,2020-09-07,3호선,안국,12741,12554,25295
10917,2020-09-07,3호선,경복궁,11757,11357,23114
10918,2020-09-07,3호선,독립문,4790,5047,9837
10919,2020-09-07,3호선,무악재,2915,3033,5948
10920,2020-09-07,3호선,홍제,12604,12317,24921
10921,2020-09-07,3호선,녹번,11337,10456,21793
10922,2020-09-07,3호선,불광,11699,12422,24121
10923,2020-09-07,3호선,연신내,27318,25799,53117
10924,2020-09-07,3호선,구파발,14945,13949,28894
10925,2020-09-07,3호선,지축,2269,2331,4600
10926,2020-09-07,3호선,대화,9606,7415,17021
10927,2020-09-07,3호선,주엽,5729,5953,11682
10928,2020-09-07,3호선,정발산,4186,4071,8257
10929,2020-09-07,3호선,마두,4886,5140,10026
10930,2020-09-07,3호선,백석,6994,7135,14129
10931,2020-09-07,3호선,대곡,1193,869,2062
10932,2020-09-07,3호선,화정,11318,11675,22993
10933,2020-09-07,3호선,원당,7823,7687,15510
10934,2020-09-07,3호선,삼송,12475,12227,24702
10935,2020-09-07,3호선,원흥,6345,6133,12478
10936,2020-09-08,3호선,경복궁,13700,13281,26981
10937,2020-09-08,3호선,독립문,5841,5941,11782
10938,2020-09-08,3호선,무악재,3177,3212,6389
10939,2020-09-08,3호선,홍제,14367,13922,28289
10940,2020-09-08,3호선,녹번,12505,11361,23866
10941,2020-09-08,3호선,불광,13541,14512,28053
10942,2020-09-08,3호선,연신내,31649,29761,61410
10943,2020-09-08,3호선,구파발,16922,15979,32901
10944,2020-09-08,3호선,지축,2616,2660,5276
10945,2020-09-08,3호선,오금,5231,4721,9952
10946,2020-09-08,3호선,경찰병원,6327,6378,12705
10947,2020-09-08,3호선,가락시장,7665,7539,15204
10948,2020-09-08,3호선,수서,12438,12615,25053
10949,2020-09-08,3호선,일원,7584,7573,15157
10950,2020-09-08,3호선,대청,7757,7173,14930
10951,2020-09-08,3호선,학여울,1390,1416,2806
10952,2020-09-08,3호선,대치,7356,7393,14749
10953,2020-09-08,3호선,도곡,4227,4229,8456
10954,2020-09-08,3호선,매봉,9917,9482,19399
10955,2020-09-08,3호선,양재,31501,34077,65578
10956,2020-09-08,3호선,남부터미널,22657,23128,45785
10957,2020-09-08,3호선,교대,11502,7572,19074
10958,2020-09-08,3호선,고속터미널,26749,25641,52390
10959,2020-09-08,3호선,잠원,4272,4331,8603
10960,2020-09-08,3호선,신사,23313,24237,47550
10961,2020-09-08,3호선,압구정,25322,26713,52035
10962,2020-09-08,3호선,옥수,7488,7678,15166
10963,2020-09-08,3호선,금호,6653,6271,12924
10964,2020-09-08,3호선,약수,10448,10398,20846
10965,2020-09-08,3호선,동대입구,5985,6321,12306
10966,2020-09-08,3호선,을지로3가,8678,8948,17626
10967,2020-09-08,3호선,종로3가,8098,9193,17291
10968,2020-09-08,3호선,안국,14219,14662,28881
10969,2020-09-08,3호선,원흥,7296,7040,14336
10970,2020-09-08,3호선,삼송,14192,14023,28215
10971,2020-09-08,3호선,원당,9100,8785,17885
10972,2020-09-08,3호선,화정,13267,13741,27008
10973,2020-09-08,3호선,대곡,1511,1200,2711
10974,2020-09-08,3호선,백석,8036,8104,16140
10975,2020-09-08,3호선,마두,5835,6106,11941
10976,2020-09-08,3호선,정발산,5394,5443,10837
10977,2020-09-08,3호선,주엽,6845,6949,13794
10978,2020-09-08,3호선,대화,10510,8229,18739
10979,2020-09-09,3호선,대화,10350,8119,18469
10980,2020-09-09,3호선,주엽,6483,6506,12989
10981,2020-09-09,3호선,정발산,5080,5077,10157
10982,2020-09-09,3호선,마두,5612,5934,11546
10983,2020-09-09,3호선,백석,7628,7703,15331
10984,2020-09-09,3호선,대곡,1413,1050,2463
10985,2020-09-09,3호선,화정,12751,13141,25892
10986,2020-09-09,3호선,원당,8817,8484,17301
10987,2020-09-09,3호선,삼송,13675,13587,27262
10988,2020-09-09,3호선,원흥,7207,6982,14189
10989,2020-09-09,3호선,오금,5123,4518,9641
10990,2020-09-09,3호선,경찰병원,6441,6451,12892
10991,2020-09-09,3호선,가락시장,7384,7252,14636
10992,2020-09-09,3호선,수서,12356,12611,24967
10993,2020-09-09,3호선,일원,7728,7650,15378
10994,2020-09-09,3호선,대청,7658,6989,14647
10995,2020-09-09,3호선,학여울,1376,1402,2778
10996,2020-09-09,3호선,대치,7403,7305,14708
10997,2020-09-09,3호선,도곡,4269,4339,8608
10998,2020-09-09,3호선,매봉,9925,9366,19291
10999,2020-09-09,3호선,양재,31082,33506,64588
11000,2020-09-09,3호선,남부터미널,22220,23130,45350
11001,2020-09-09,3호선,교대,11459,7505,18964
11002,2020-09-09,3호선,고속터미널,26098,25596,51694
11003,2020-09-09,3호선,잠원,4306,4248,8554
11004,2020-09-09,3호선,신사,22490,23517,46007
11005,2020-09-09,3호선,압구정,24541,25900,50441
11006,2020-09-09,3호선,옥수,7140,7452,14592
11007,2020-09-09,3호선,금호,6523,6199,12722
11008,2020-09-09,3호선,약수,10270,10004,20274
11009,2020-09-09,3호선,동대입구,5701,5996,11697
11010,2020-09-09,3호선,충무로,1,0,1
11011,2020-09-09,3호선,을지로3가,8693,8899,17592
11012,2020-09-09,3호선,종로3가,8197,9073,17270
11013,2020-09-09,3호선,안국,13728,14209,27937
11014,2020-09-09,3호선,경복궁,13484,12944,26428
11015,2020-09-09,3호선,독립문,5585,5728,11313
11016,2020-09-09,3호선,무악재,3183,3275,6458
11017,2020-09-09,3호선,홍제,13974,13434,27408
11018,2020-09-09,3호선,녹번,12165,11354,23519
11019,2020-09-09,3호선,불광,13125,13924,27049
11020,2020-09-09,3호선,연신내,30566,28741,59307
11021,2020-09-09,3호선,구파발,16404,15450,31854
11022,2020-09-09,3호선,지축,2587,2625,5212
11023,2020-09-10,3호선,지축,2676,2691,5367
11024,2020-09-10,3호선,구파발,17311,16347,33658
11025,2020-09-10,3호선,연신내,31702,29777,61479
11026,2020-09-10,3호선,불광,13900,14762,28662
11027,2020-09-10,3호선,녹번,12254,11312,23566
11028,2020-09-10,3호선,홍제,14292,13704,27996
11029,2020-09-10,3호선,무악재,3189,3291,6480
11030,2020-09-10,3호선,독립문,5889,6001,11890
11031,2020-09-10,3호선,경복궁,13842,13691,27533
11032,2020-09-10,3호선,안국,14281,14584,28865
11033,2020-09-10,3호선,종로3가,8125,9435,17560
11034,2020-09-10,3호선,을지로3가,8489,8871,17360
11035,2020-09-10,3호선,동대입구,5937,6266,12203
11036,2020-09-10,3호선,약수,10600,10431,21031
11037,2020-09-10,3호선,금호,6725,6403,13128
11038,2020-09-10,3호선,옥수,7456,7777,15233
11039,2020-09-10,3호선,압구정,24936,26460,51396
11040,2020-09-10,3호선,신사,23209,24341,47550
11041,2020-09-10,3호선,잠원,4389,4301,8690
11042,2020-09-10,3호선,고속터미널,27456,26651,54107
11043,2020-09-10,3호선,교대,11900,7726,19626
11044,2020-09-10,3호선,남부터미널,22818,23418,46236
11045,2020-09-10,3호선,양재,31753,34387,66140
11046,2020-09-10,3호선,매봉,9984,9441,19425
11047,2020-09-10,3호선,도곡,4303,4351,8654
11048,2020-09-10,3호선,대치,7475,7405,14880
11049,2020-09-10,3호선,학여울,1392,1429,2821
11050,2020-09-10,3호선,대청,7758,7066,14824
11051,2020-09-10,3호선,일원,7724,7660,15384
11052,2020-09-10,3호선,수서,12926,13252,26178
11053,2020-09-10,3호선,가락시장,7703,7446,15149
11054,2020-09-10,3호선,경찰병원,6271,6336,12607
11055,2020-09-10,3호선,오금,5167,4679,9846
11056,2020-09-10,3호선,원흥,7453,7186,14639
11057,2020-09-10,3호선,삼송,14297,14175,28472
11058,2020-09-10,3호선,원당,9318,8904,18222
11059,2020-09-10,3호선,화정,13374,13847,27221
11060,2020-09-10,3호선,대곡,1486,1141,2627
11061,2020-09-10,3호선,백석,8005,8241,16246
11062,2020-09-10,3호선,마두,5711,6008,11719
11063,2020-09-10,3호선,정발산,5540,5464,11004
11064,2020-09-10,3호선,주엽,6694,6756,13450
11065,2020-09-10,3호선,대화,10715,8473,19188
11066,2020-09-11,3호선,대화,10791,8731,19522
11067,2020-09-11,3호선,주엽,6902,7131,14033
11068,2020-09-11,3호선,정발산,5679,5670,11349
11069,2020-09-11,3호선,마두,5783,6248,12031
11070,2020-09-11,3호선,백석,8196,8383,16579
11071,2020-09-11,3호선,대곡,1577,1153,2730
11072,2020-09-11,3호선,화정,13447,14093,27540
11073,2020-09-11,3호선,원당,9297,8955,18252
11074,2020-09-11,3호선,삼송,14383,14142,28525
11075,2020-09-11,3호선,원흥,7444,7176,14620
11076,2020-09-11,3호선,오금,5284,4785,10069
11077,2020-09-11,3호선,경찰병원,6470,6415,12885
11078,2020-09-11,3호선,가락시장,7779,7745,15524
11079,2020-09-11,3호선,수서,14135,14815,28950
11080,2020-09-11,3호선,일원,7807,7636,15443
11081,2020-09-11,3호선,대청,7886,7285,15171
11082,2020-09-11,3호선,학여울,1486,1515,3001
11083,2020-09-11,3호선,대치,8009,7823,15832
11084,2020-09-11,3호선,도곡,4333,4345,8678
11085,2020-09-11,3호선,매봉,10185,9612,19797
11086,2020-09-11,3호선,양재,33461,34740,68201
11087,2020-09-11,3호선,남부터미널,24714,25582,50296
11088,2020-09-11,3호선,교대,11990,7610,19600
11089,2020-09-11,3호선,고속터미널,31900,34786,66686
11090,2020-09-11,3호선,잠원,4515,4448,8963
11091,2020-09-11,3호선,신사,25443,25977,51420
11092,2020-09-11,3호선,압구정,27141,28573,55714
11093,2020-09-11,3호선,옥수,7640,7976,15616
11094,2020-09-11,3호선,금호,6987,6579,13566
11095,2020-09-11,3호선,약수,10831,10541,21372
11096,2020-09-11,3호선,동대입구,5950,6092,12042
11097,2020-09-11,3호선,충무로,1,0,1
11098,2020-09-11,3호선,을지로3가,8716,8894,17610
11099,2020-09-11,3호선,종로3가,7977,9303,17280
11100,2020-09-11,3호선,안국,14632,14766,29398
11101,2020-09-11,3호선,경복궁,14227,13515,27742
11102,2020-09-11,3호선,독립문,5873,6082,11955
11103,2020-09-11,3호선,무악재,3320,3291,6611
11104,2020-09-11,3호선,홍제,14452,14080,28532
11105,2020-09-11,3호선,녹번,12488,11304,23792
11106,2020-09-11,3호선,불광,13920,14808,28728
11107,2020-09-11,3호선,연신내,32213,30439,62652
11108,2020-09-11,3호선,구파발,17160,16160,33320
11109,2020-09-11,3호선,지축,2709,2677,5386
11110,2020-09-12,3호선,대화,5873,5332,11205
11111,2020-09-12,3호선,주엽,4132,4235,8367
11112,2020-09-12,3호선,정발산,4068,4163,8231
11113,2020-09-12,3호선,마두,3297,3459,6756
11114,2020-09-12,3호선,백석,5313,5490,10803
11115,2020-09-12,3호선,대곡,911,732,1643
11116,2020-09-12,3호선,화정,8594,9076,17670
11117,2020-09-12,3호선,원당,5886,5694,11580
11118,2020-09-12,3호선,삼송,9393,9198,18591
11119,2020-09-12,3호선,원흥,4571,4413,8984
11120,2020-09-12,3호선,오금,2506,2321,4827
11121,2020-09-12,3호선,경찰병원,2881,2728,5609
11122,2020-09-12,3호선,가락시장,4581,4203,8784
11123,2020-09-12,3호선,수서,7606,7971,15577
11124,2020-09-12,3호선,일원,3070,3139,6209
11125,2020-09-12,3호선,대청,3949,3496,7445
11126,2020-09-12,3호선,학여울,766,734,1500
11127,2020-09-12,3호선,대치,4733,4495,9228
11128,2020-09-12,3호선,도곡,2284,2276,4560
11129,2020-09-12,3호선,매봉,3810,3608,7418
11130,2020-09-12,3호선,양재,12832,13734,26566
11131,2020-09-12,3호선,남부터미널,12704,13229,25933
11132,2020-09-12,3호선,교대,3734,2446,6180
11133,2020-09-12,3호선,고속터미널,28088,29174,57262
11134,2020-09-12,3호선,잠원,2811,2672,5483
11135,2020-09-12,3호선,신사,14879,15732,30611
11136,2020-09-12,3호선,압구정,17229,17902,35131
11137,2020-09-12,3호선,옥수,4932,4978,9910
11138,2020-09-12,3호선,금호,4398,4037,8435
11139,2020-09-12,3호선,약수,6546,6079,12625
11140,2020-09-12,3호선,동대입구,3783,4109,7892
11141,2020-09-12,3호선,을지로3가,3035,3327,6362
11142,2020-09-12,3호선,종로3가,3011,4074,7085
11143,2020-09-12,3호선,안국,6463,7532,13995
11144,2020-09-12,3호선,경복궁,7054,7083,14137
11145,2020-09-12,3호선,독립문,3774,3717,7491
11146,2020-09-12,3호선,무악재,1866,1909,3775
11147,2020-09-12,3호선,홍제,9234,8788,18022
11148,2020-09-12,3호선,녹번,6769,5994,12763
11149,2020-09-12,3호선,불광,9062,10296,19358
11150,2020-09-12,3호선,연신내,21451,20243,41694
11151,2020-09-12,3호선,구파발,10053,10262,20315
11152,2020-09-12,3호선,지축,1513,1485,2998
11153,2020-09-13,3호선,가락시장,2492,2838,5330
11154,2020-09-13,3호선,경복궁,5797,6299,12096
11155,2020-09-13,3호선,경찰병원,1786,1771,3557
11156,2020-09-13,3호선,고속터미널,24765,21930,46695
11157,2020-09-13,3호선,교대,2166,1486,3652
11158,2020-09-13,3호선,구파발,8101,8386,16487
11159,2020-09-13,3호선,금호,3115,2982,6097
11160,2020-09-13,3호선,남부터미널,9418,9335,18753
11161,2020-09-13,3호선,녹번,4560,4075,8635
11162,2020-09-13,3호선,대곡,800,668,1468
11163,2020-09-13,3호선,대청,2622,2531,5153
11164,2020-09-13,3호선,대치,2680,2608,5288
11165,2020-09-13,3호선,대화,4406,3951,8357
11166,2020-09-13,3호선,도곡,1246,1343,2589
11167,2020-09-13,3호선,독립문,2960,3178,6138
11168,2020-09-13,3호선,동대입구,3289,3754,7043
11169,2020-09-13,3호선,마두,2192,2127,4319
11170,2020-09-13,3호선,매봉,2580,2593,5173
11171,2020-09-13,3호선,무악재,1250,1351,2601
11172,2020-09-13,3호선,백석,4068,4026,8094
11173,2020-09-13,3호선,불광,6987,8301,15288
11174,2020-09-13,3호선,삼송,7027,6900,13927
11175,2020-09-13,3호선,수서,6766,5958,12724
11176,2020-09-13,3호선,신사,8578,8883,17461
11177,2020-09-13,3호선,안국,5480,6432,11912
11178,2020-09-13,3호선,압구정,8690,9100,17790
11179,2020-09-13,3호선,약수,4479,4323,8802
11180,2020-09-13,3호선,양재,7837,9334,17171
11181,2020-09-13,3호선,연신내,15980,14710,30690
11182,2020-09-13,3호선,오금,1800,1686,3486
11183,2020-09-13,3호선,옥수,3752,3999,7751
11184,2020-09-13,3호선,원당,4479,4242,8721
11185,2020-09-13,3호선,원흥,3260,3164,6424
11186,2020-09-13,3호선,을지로3가,1434,1516,2950
11187,2020-09-13,3호선,일원,2038,2179,4217
11188,2020-09-13,3호선,잠원,1732,1709,3441
11189,2020-09-13,3호선,정발산,3521,3502,7023
11190,2020-09-13,3호선,종로3가,1887,2614,4501
11191,2020-09-13,3호선,주엽,2936,2872,5808
11192,2020-09-13,3호선,지축,1085,1107,2192
11193,2020-09-13,3호선,학여울,519,563,1082
11194,2020-09-13,3호선,홍제,6376,6111,12487
11195,2020-09-13,3호선,화정,6421,6576,12997
11196,2020-09-14,3호선,대화,11701,9043,20744
11197,2020-09-14,3호선,주엽,7376,7502,14878
11198,2020-09-14,3호선,정발산,5967,5988,11955
11199,2020-09-14,3호선,마두,6474,6737,13211
11200,2020-09-14,3호선,백석,8614,8756,17370
11201,2020-09-14,3호선,대곡,1615,1253,2868
11202,2020-09-14,3호선,화정,14505,15001,29506
11203,2020-09-14,3호선,원당,9914,9443,19357
11204,2020-09-14,3호선,삼송,15565,14988,30553
11205,2020-09-14,3호선,원흥,8283,7901,16184
11206,2020-09-14,3호선,오금,5496,4886,10382
11207,2020-09-14,3호선,경찰병원,6946,7050,13996
11208,2020-09-14,3호선,가락시장,8145,8012,16157
11209,2020-09-14,3호선,수서,13639,13750,27389
11210,2020-09-14,3호선,일원,8362,8396,16758
11211,2020-09-14,3호선,대청,8426,7756,16182
11212,2020-09-14,3호선,학여울,1493,1487,2980
11213,2020-09-14,3호선,대치,8629,8520,17149
11214,2020-09-14,3호선,도곡,4652,4804,9456
11215,2020-09-14,3호선,매봉,10442,9984,20426
11216,2020-09-14,3호선,양재,33082,36144,69226
11217,2020-09-14,3호선,남부터미널,25022,25507,50529
11218,2020-09-14,3호선,교대,11937,8071,20008
11219,2020-09-14,3호선,고속터미널,29796,27650,57446
11220,2020-09-14,3호선,잠원,4684,4658,9342
11221,2020-09-14,3호선,신사,24848,26642,51490
11222,2020-09-14,3호선,압구정,26784,28649,55433
11223,2020-09-14,3호선,옥수,7732,8117,15849
11224,2020-09-14,3호선,금호,7235,6794,14029
11225,2020-09-14,3호선,약수,11116,10958,22074
11226,2020-09-14,3호선,동대입구,6071,6442,12513
11227,2020-09-14,3호선,충무로,1,0,1
11228,2020-09-14,3호선,을지로3가,9057,9403,18460
11229,2020-09-14,3호선,종로3가,8629,9979,18608
11230,2020-09-14,3호선,안국,14846,15298,30144
11231,2020-09-14,3호선,경복궁,14395,14117,28512
11232,2020-09-14,3호선,독립문,6098,6290,12388
11233,2020-09-14,3호선,무악재,3428,3418,6846
11234,2020-09-14,3호선,홍제,15368,14709,30077
11235,2020-09-14,3호선,녹번,13094,12033,25127
11236,2020-09-14,3호선,불광,14417,15398,29815
11237,2020-09-14,3호선,연신내,33463,31468,64931
11238,2020-09-14,3호선,구파발,17914,16894,34808
11239,2020-09-14,3호선,지축,2907,2834,5741
11240,2020-09-15,3호선,지축,3003,2943,5946
11241,2020-09-15,3호선,구파발,18406,17361,35767
11242,2020-09-15,3호선,연신내,34346,32181,66527
11243,2020-09-15,3호선,불광,14891,15960,30851
11244,2020-09-15,3호선,녹번,13509,12079,25588
11245,2020-09-15,3호선,홍제,15705,14875,30580
11246,2020-09-15,3호선,무악재,3473,3434,6907
11247,2020-09-15,3호선,독립문,6365,6544,12909
11248,2020-09-15,3호선,경복궁,15027,14621,29648
11249,2020-09-15,3호선,안국,15708,16395,32103
11250,2020-09-15,3호선,종로3가,8644,10019,18663
11251,2020-09-15,3호선,을지로3가,9082,9633,18715
11252,2020-09-15,3호선,충무로,1,0,1
11253,2020-09-15,3호선,동대입구,6494,6946,13440
11254,2020-09-15,3호선,약수,11536,11283,22819
11255,2020-09-15,3호선,금호,7375,6797,14172
11256,2020-09-15,3호선,옥수,8128,8399,16527
11257,2020-09-15,3호선,압구정,27425,29264,56689
11258,2020-09-15,3호선,신사,25717,27454,53171
11259,2020-09-15,3호선,잠원,4805,4682,9487
11260,2020-09-15,3호선,고속터미널,29746,28518,58264
11261,2020-09-15,3호선,교대,12609,8365,20974
11262,2020-09-15,3호선,남부터미널,24951,25699,50650
11263,2020-09-15,3호선,양재,34363,37391,71754
11264,2020-09-15,3호선,매봉,10817,10249,21066
11265,2020-09-15,3호선,도곡,4651,4787,9438
11266,2020-09-15,3호선,대치,8812,8766,17578
11267,2020-09-15,3호선,학여울,1546,1535,3081
11268,2020-09-15,3호선,대청,8581,7830,16411
11269,2020-09-15,3호선,일원,8624,8528,17152
11270,2020-09-15,3호선,수서,13860,13963,27823
11271,2020-09-15,3호선,가락시장,8305,8195,16500
11272,2020-09-15,3호선,경찰병원,6950,6977,13927
11273,2020-09-15,3호선,오금,5655,5171,10826
11274,2020-09-15,3호선,원흥,8501,8144,16645
11275,2020-09-15,3호선,삼송,15739,15369,31108
11276,2020-09-15,3호선,원당,9974,9514,19488
11277,2020-09-15,3호선,화정,15050,15348,30398
11278,2020-09-15,3호선,대곡,1673,1260,2933
11279,2020-09-15,3호선,백석,8754,8929,17683
11280,2020-09-15,3호선,마두,6534,6929,13463
11281,2020-09-15,3호선,정발산,6022,6166,12188
11282,2020-09-15,3호선,주엽,7679,7801,15480
11283,2020-09-15,3호선,대화,11813,9206,21019
11284,2020-09-16,3호선,지축,2897,2904,5801
11285,2020-09-16,3호선,구파발,18284,16967,35251
11286,2020-09-16,3호선,연신내,33523,31363,64886
11287,2020-09-16,3호선,불광,14490,15333,29823
11288,2020-09-16,3호선,녹번,13242,12071,25313
11289,2020-09-16,3호선,홍제,15351,14594,29945
11290,2020-09-16,3호선,무악재,3402,3404,6806
11291,2020-09-16,3호선,독립문,6030,6112,12142
11292,2020-09-16,3호선,경복궁,15075,14778,29853
11293,2020-09-16,3호선,안국,15404,15949,31353
11294,2020-09-16,3호선,종로3가,8629,9944,18573
11295,2020-09-16,3호선,을지로3가,9048,9554,18602
11296,2020-09-16,3호선,충무로,1,0,1
11297,2020-09-16,3호선,동대입구,6693,6958,13651
11298,2020-09-16,3호선,약수,11430,11328,22758
11299,2020-09-16,3호선,금호,7120,6574,13694
11300,2020-09-16,3호선,옥수,7971,8271,16242
11301,2020-09-16,3호선,압구정,26969,28896,55865
11302,2020-09-16,3호선,신사,25121,26726,51847
11303,2020-09-16,3호선,잠원,4774,4722,9496
11304,2020-09-16,3호선,고속터미널,29615,28614,58229
11305,2020-09-16,3호선,교대,13493,8726,22219
11306,2020-09-16,3호선,남부터미널,24472,25191,49663
11307,2020-09-16,3호선,양재,33420,36581,70001
11308,2020-09-16,3호선,매봉,10660,10105,20765
11309,2020-09-16,3호선,도곡,4680,4789,9469
11310,2020-09-16,3호선,대치,9292,8997,18289
11311,2020-09-16,3호선,학여울,1537,1599,3136
11312,2020-09-16,3호선,대청,8650,7956,16606
11313,2020-09-16,3호선,일원,8430,8278,16708
11314,2020-09-16,3호선,수서,13852,14006,27858
11315,2020-09-16,3호선,가락시장,8247,8108,16355
11316,2020-09-16,3호선,경찰병원,6869,6870,13739
11317,2020-09-16,3호선,오금,5581,5010,10591
11318,2020-09-16,3호선,원흥,8128,7858,15986
11319,2020-09-16,3호선,삼송,15520,14947,30467
11320,2020-09-16,3호선,원당,9741,9221,18962
11321,2020-09-16,3호선,화정,14741,15214,29955
11322,2020-09-16,3호선,대곡,1649,1258,2907
11323,2020-09-16,3호선,백석,8535,8583,17118
11324,2020-09-16,3호선,마두,6650,6906,13556
11325,2020-09-16,3호선,정발산,5855,5994,11849
11326,2020-09-16,3호선,주엽,7416,7493,14909
11327,2020-09-16,3호선,대화,11476,9090,20566
11328,2020-09-17,3호선,약수,11786,11565,23351
11329,2020-09-17,3호선,대화,11699,9223,20922
11330,2020-09-17,3호선,주엽,7807,7880,15687
11331,2020-09-17,3호선,정발산,6065,6253,12318
11332,2020-09-17,3호선,마두,6564,6971,13535
11333,2020-09-17,3호선,백석,8939,9052,17991
11334,2020-09-17,3호선,대곡,1675,1280,2955
11335,2020-09-17,3호선,화정,14942,15287,30229
11336,2020-09-17,3호선,원당,10118,9524,19642
11337,2020-09-17,3호선,삼송,15976,15382,31358
11338,2020-09-17,3호선,원흥,8279,7934,16213
11339,2020-09-17,3호선,오금,5630,5079,10709
11340,2020-09-17,3호선,경찰병원,6893,6982,13875
11341,2020-09-17,3호선,가락시장,8399,8246,16645
11342,2020-09-17,3호선,수서,14232,14078,28310
11343,2020-09-17,3호선,일원,8660,8445,17105
11344,2020-09-17,3호선,대청,8624,7943,16567
11345,2020-09-17,3호선,학여울,1549,1632,3181
11346,2020-09-17,3호선,대치,9049,8940,17989
11347,2020-09-17,3호선,도곡,4661,4840,9501
11348,2020-09-17,3호선,매봉,10698,10186,20884
11349,2020-09-17,3호선,양재,34663,37717,72380
11350,2020-09-17,3호선,남부터미널,25104,25544,50648
11351,2020-09-17,3호선,교대,13136,8511,21647
11352,2020-09-17,3호선,고속터미널,30758,29860,60618
11353,2020-09-17,3호선,잠원,4859,4719,9578
11354,2020-09-17,3호선,신사,25772,27705,53477
11355,2020-09-17,3호선,압구정,27517,29752,57269
11356,2020-09-17,3호선,옥수,8290,8448,16738
11357,2020-09-17,3호선,금호,7360,6767,14127
11358,2020-09-17,3호선,동대입구,6876,7132,14008
11359,2020-09-17,3호선,을지로3가,9255,9657,18912
11360,2020-09-17,3호선,종로3가,8710,10259,18969
11361,2020-09-17,3호선,안국,16243,16933,33176
11362,2020-09-17,3호선,경복궁,15675,15345,31020
11363,2020-09-17,3호선,독립문,6253,6504,12757
11364,2020-09-17,3호선,무악재,3533,3505,7038
11365,2020-09-17,3호선,홍제,15814,14909,30723
11366,2020-09-17,3호선,녹번,13563,12185,25748
11367,2020-09-17,3호선,불광,14962,15955,30917
11368,2020-09-17,3호선,연신내,34429,32037,66466
11369,2020-09-17,3호선,구파발,18699,17593,36292
11370,2020-09-17,3호선,지축,3060,2991,6051
11371,2020-09-18,3호선,대화,12315,9601,21916
11372,2020-09-18,3호선,주엽,7875,8124,15999
11373,2020-09-18,3호선,정발산,6547,7027,13574
11374,2020-09-18,3호선,마두,7224,7401,14625
11375,2020-09-18,3호선,백석,9340,9693,19033
11376,2020-09-18,3호선,대곡,1712,1333,3045
11377,2020-09-18,3호선,화정,15771,16380,32151
11378,2020-09-18,3호선,원당,10431,9781,20212
11379,2020-09-18,3호선,삼송,16848,16074,32922
11380,2020-09-18,3호선,원흥,8846,8208,17054
11381,2020-09-18,3호선,오금,5908,5259,11167
11382,2020-09-18,3호선,경찰병원,6982,6923,13905
11383,2020-09-18,3호선,가락시장,8871,8798,17669
11384,2020-09-18,3호선,수서,15983,16392,32375
11385,2020-09-18,3호선,일원,8723,8424,17147
11386,2020-09-18,3호선,대청,8886,7977,16863
11387,2020-09-18,3호선,학여울,1645,1666,3311
11388,2020-09-18,3호선,대치,9717,9569,19286
11389,2020-09-18,3호선,도곡,4771,4786,9557
11390,2020-09-18,3호선,매봉,10965,10440,21405
11391,2020-09-18,3호선,양재,37251,38918,76169
11392,2020-09-18,3호선,남부터미널,27252,27940,55192
11393,2020-09-18,3호선,교대,13244,8735,21979
11394,2020-09-18,3호선,고속터미널,37154,39291,76445
11395,2020-09-18,3호선,잠원,5056,4952,10008
11396,2020-09-18,3호선,신사,28105,31315,59420
11397,2020-09-18,3호선,압구정,29990,32408,62398
11398,2020-09-18,3호선,옥수,8844,8946,17790
11399,2020-09-18,3호선,금호,7856,7041,14897
11400,2020-09-18,3호선,약수,12389,12011,24400
11401,2020-09-18,3호선,동대입구,7077,7426,14503
11402,2020-09-18,3호선,을지로3가,9396,10219,19615
11403,2020-09-18,3호선,종로3가,8631,10601,19232
11404,2020-09-18,3호선,안국,16560,17245,33805
11405,2020-09-18,3호선,경복궁,16431,16184,32615
11406,2020-09-18,3호선,독립문,6639,6758,13397
11407,2020-09-18,3호선,무악재,3680,3569,7249
11408,2020-09-18,3호선,홍제,16399,15285,31684
11409,2020-09-18,3호선,녹번,13817,12173,25990
11410,2020-09-18,3호선,불광,15545,16521,32066
11411,2020-09-18,3호선,연신내,36044,33905,69949
11412,2020-09-18,3호선,구파발,19261,17967,37228
11413,2020-09-18,3호선,지축,3082,2958,6040
11414,2020-09-19,3호선,원흥,5485,5158,10643
11415,2020-09-19,3호선,삼송,11398,10910,22308
11416,2020-09-19,3호선,원당,6983,6531,13514
11417,2020-09-19,3호선,화정,10742,11072,21814
11418,2020-09-19,3호선,대곡,1198,1004,2202
11419,2020-09-19,3호선,백석,6475,6584,13059
11420,2020-09-19,3호선,마두,4328,4349,8677
11421,2020-09-19,3호선,정발산,5212,5657,10869
11422,2020-09-19,3호선,주엽,5330,5248,10578
11423,2020-09-19,3호선,대화,7280,6342,13622
11424,2020-09-19,3호선,지축,1895,1748,3643
11425,2020-09-19,3호선,구파발,13038,13153,26191
11426,2020-09-19,3호선,연신내,26593,24821,51414
11427,2020-09-19,3호선,불광,10966,12639,23605
11428,2020-09-19,3호선,녹번,8234,7072,15306
11429,2020-09-19,3호선,홍제,11474,10619,22093
11430,2020-09-19,3호선,무악재,2259,2337,4596
11431,2020-09-19,3호선,독립문,4885,5044,9929
11432,2020-09-19,3호선,경복궁,10432,11110,21542
11433,2020-09-19,3호선,안국,9144,11010,20154
11434,2020-09-19,3호선,종로3가,3980,6009,9989
11435,2020-09-19,3호선,을지로3가,3590,4272,7862
11436,2020-09-19,3호선,충무로,1,0,1
11437,2020-09-19,3호선,동대입구,4472,5175,9647
11438,2020-09-19,3호선,약수,7794,7372,15166
11439,2020-09-19,3호선,금호,5215,4751,9966
11440,2020-09-19,3호선,옥수,6244,6189,12433
11441,2020-09-19,3호선,압구정,20907,22222,43129
11442,2020-09-19,3호선,신사,19682,21235,40917
11443,2020-09-19,3호선,잠원,3340,3251,6591
11444,2020-09-19,3호선,고속터미널,35004,36066,71070
11445,2020-09-19,3호선,교대,5253,3177,8430
11446,2020-09-19,3호선,남부터미널,15897,16400,32297
11447,2020-09-19,3호선,양재,16709,18007,34716
11448,2020-09-19,3호선,매봉,4783,4524,9307
11449,2020-09-19,3호선,도곡,2605,2538,5143
11450,2020-09-19,3호선,대치,7485,6658,14143
11451,2020-09-19,3호선,학여울,1019,949,1968
11452,2020-09-19,3호선,대청,4927,4397,9324
11453,2020-09-19,3호선,일원,4184,4039,8223
11454,2020-09-19,3호선,수서,9625,9970,19595
11455,2020-09-19,3호선,가락시장,5555,5362,10917
11456,2020-09-19,3호선,경찰병원,3482,3255,6737
11457,2020-09-19,3호선,오금,3344,3147,6491
11458,2020-09-20,3호선,원흥,3850,3652,7502
11459,2020-09-20,3호선,삼송,7980,7766,15746
11460,2020-09-20,3호선,원당,5029,4878,9907
11461,2020-09-20,3호선,화정,7248,7487,14735
11462,2020-09-20,3호선,대곡,873,764,1637
11463,2020-09-20,3호선,백석,4484,4471,8955
11464,2020-09-20,3호선,마두,2581,2598,5179
11465,2020-09-20,3호선,정발산,3917,3937,7854
11466,2020-09-20,3호선,주엽,3378,3273,6651
11467,2020-09-20,3호선,대화,5003,4435,9438
11468,2020-09-20,3호선,지축,1362,1277,2639
11469,2020-09-20,3호선,구파발,9349,9754,19103
11470,2020-09-20,3호선,연신내,18233,16825,35058
11471,2020-09-20,3호선,불광,8057,9598,17655
11472,2020-09-20,3호선,녹번,5274,4725,9999
11473,2020-09-20,3호선,홍제,7253,6892,14145
11474,2020-09-20,3호선,무악재,1425,1539,2964
11475,2020-09-20,3호선,독립문,3258,3564,6822
11476,2020-09-20,3호선,경복궁,7262,7765,15027
11477,2020-09-20,3호선,안국,6476,7505,13981
11478,2020-09-20,3호선,종로3가,2471,3556,6027
11479,2020-09-20,3호선,을지로3가,1782,1905,3687
11480,2020-09-20,3호선,동대입구,3471,3994,7465
11481,2020-09-20,3호선,약수,5081,4978,10059
11482,2020-09-20,3호선,금호,3621,3260,6881
11483,2020-09-20,3호선,옥수,4265,4488,8753
11484,2020-09-20,3호선,압구정,10330,10974,21304
11485,2020-09-20,3호선,신사,10665,11186,21851
11486,2020-09-20,3호선,잠원,2119,2244,4363
11487,2020-09-20,3호선,고속터미널,29133,26961,56094
11488,2020-09-20,3호선,교대,2972,1872,4844
11489,2020-09-20,3호선,남부터미널,10218,10770,20988
11490,2020-09-20,3호선,양재,9874,11542,21416
11491,2020-09-20,3호선,매봉,3122,3045,6167
11492,2020-09-20,3호선,도곡,1543,1687,3230
11493,2020-09-20,3호선,대치,4319,3825,8144
11494,2020-09-20,3호선,학여울,565,589,1154
11495,2020-09-20,3호선,대청,3109,3013,6122
11496,2020-09-20,3호선,일원,2504,2544,5048
11497,2020-09-20,3호선,수서,7681,7428,15109
11498,2020-09-20,3호선,가락시장,3379,3627,7006
11499,2020-09-20,3호선,경찰병원,2140,2220,4360
11500,2020-09-20,3호선,오금,2212,2149,4361
11501,2020-09-21,3호선,주엽,8172,8289,16461
11502,2020-09-21,3호선,지축,3150,3130,6280
11503,2020-09-21,3호선,구파발,19544,18305,37849
11504,2020-09-21,3호선,연신내,35592,33269,68861
11505,2020-09-21,3호선,불광,15480,16638,32118
11506,2020-09-21,3호선,녹번,13947,12660,26607
11507,2020-09-21,3호선,홍제,16680,15914,32594
11508,2020-09-21,3호선,무악재,3649,3597,7246
11509,2020-09-21,3호선,독립문,6681,6955,13636
11510,2020-09-21,3호선,경복궁,15996,15679,31675
11511,2020-09-21,3호선,안국,16578,17269,33847
11512,2020-09-21,3호선,종로3가,8865,10411,19276
11513,2020-09-21,3호선,을지로3가,9543,10037,19580
11514,2020-09-21,3호선,충무로,2,0,2
11515,2020-09-21,3호선,동대입구,6961,7127,14088
11516,2020-09-21,3호선,약수,12100,12133,24233
11517,2020-09-21,3호선,금호,7555,7005,14560
11518,2020-09-21,3호선,옥수,8493,8998,17491
11519,2020-09-21,3호선,압구정,28397,30541,58938
11520,2020-09-21,3호선,신사,26602,28186,54788
11521,2020-09-21,3호선,잠원,5092,5005,10097
11522,2020-09-21,3호선,고속터미널,32444,30664,63108
11523,2020-09-21,3호선,교대,12890,8557,21447
11524,2020-09-21,3호선,남부터미널,26171,27042,53213
11525,2020-09-21,3호선,양재,35319,39055,74374
11526,2020-09-21,3호선,매봉,11144,10725,21869
11527,2020-09-21,3호선,도곡,5162,5230,10392
11528,2020-09-21,3호선,대치,9402,9357,18759
11529,2020-09-21,3호선,학여울,1635,1620,3255
11530,2020-09-21,3호선,대청,9191,8302,17493
11531,2020-09-21,3호선,일원,9025,8921,17946
11532,2020-09-21,3호선,수서,14890,15067,29957
11533,2020-09-21,3호선,가락시장,8632,8483,17115
11534,2020-09-21,3호선,경찰병원,7254,7298,14552
11535,2020-09-21,3호선,오금,5851,5251,11102
11536,2020-09-21,3호선,원흥,8712,8331,17043
11537,2020-09-21,3호선,삼송,16786,16093,32879
11538,2020-09-21,3호선,원당,10682,10143,20825
11539,2020-09-21,3호선,화정,15613,15991,31604
11540,2020-09-21,3호선,대곡,1748,1354,3102
11541,2020-09-21,3호선,백석,9203,9343,18546
11542,2020-09-21,3호선,마두,6833,7134,13967
11543,2020-09-21,3호선,정발산,6222,6394,12616
11544,2020-09-21,3호선,대화,12537,9638,22175
11545,2020-09-22,3호선,오금,6070,5412,11482
11546,2020-09-22,3호선,경찰병원,7265,7336,14601
11547,2020-09-22,3호선,가락시장,8825,8780,17605
11548,2020-09-22,3호선,수서,14932,15109,30041
11549,2020-09-22,3호선,일원,9191,9052,18243
11550,2020-09-22,3호선,대청,9375,8485,17860
11551,2020-09-22,3호선,학여울,1649,1708,3357
11552,2020-09-22,3호선,대치,9429,9498,18927
11553,2020-09-22,3호선,도곡,5169,5139,10308
11554,2020-09-22,3호선,매봉,11446,10850,22296
11555,2020-09-22,3호선,양재,36345,39760,76105
11556,2020-09-22,3호선,남부터미널,26292,27188,53480
11557,2020-09-22,3호선,교대,13581,8936,22517
11558,2020-09-22,3호선,고속터미널,32509,31192,63701
11559,2020-09-22,3호선,잠원,5065,5039,10104
11560,2020-09-22,3호선,신사,27230,29177,56407
11561,2020-09-22,3호선,압구정,29578,31776,61354
11562,2020-09-22,3호선,옥수,8651,8845,17496
11563,2020-09-22,3호선,금호,7750,7192,14942
11564,2020-09-22,3호선,약수,12311,12138,24449
11565,2020-09-22,3호선,동대입구,6924,7262,14186
11566,2020-09-22,3호선,을지로3가,9512,10124,19636
11567,2020-09-22,3호선,종로3가,9029,10639,19668
11568,2020-09-22,3호선,안국,17349,18142,35491
11569,2020-09-22,3호선,경복궁,16524,16314,32838
11570,2020-09-22,3호선,독립문,6867,7055,13922
11571,2020-09-22,3호선,무악재,3643,3690,7333
11572,2020-09-22,3호선,홍제,16734,15858,32592
11573,2020-09-22,3호선,녹번,14200,12866,27066
11574,2020-09-22,3호선,불광,15834,17046,32880
11575,2020-09-22,3호선,연신내,36203,33855,70058
11576,2020-09-22,3호선,구파발,19720,18626,38346
11577,2020-09-22,3호선,지축,3275,3096,6371
11578,2020-09-22,3호선,대화,12397,9617,22014
11579,2020-09-22,3호선,주엽,8173,8221,16394
11580,2020-09-22,3호선,정발산,6411,6601,13012
11581,2020-09-22,3호선,마두,7041,7372,14413
11582,2020-09-22,3호선,백석,9415,9534,18949
11583,2020-09-22,3호선,대곡,1768,1368,3136
11584,2020-09-22,3호선,화정,15598,16128,31726
11585,2020-09-22,3호선,원당,10553,10046,20599
11586,2020-09-22,3호선,삼송,16911,16398,33309
11587,2020-09-22,3호선,원흥,8735,8389,17124
11588,2020-09-23,3호선,대화,12490,9611,22101
11589,2020-09-23,3호선,지축,3199,3151,6350
11590,2020-09-23,3호선,구파발,19944,18731,38675
11591,2020-09-23,3호선,연신내,36090,33888,69978
11592,2020-09-23,3호선,불광,15907,17061,32968
11593,2020-09-23,3호선,녹번,14450,12848,27298
11594,2020-09-23,3호선,홍제,16752,16019,32771
11595,2020-09-23,3호선,무악재,3789,3769,7558
11596,2020-09-23,3호선,독립문,6805,7045,13850
11597,2020-09-23,3호선,경복궁,17183,16747,33930
11598,2020-09-23,3호선,안국,17561,18344,35905
11599,2020-09-23,3호선,종로3가,9200,10776,19976
11600,2020-09-23,3호선,을지로3가,9757,10317,20074
11601,2020-09-23,3호선,충무로,2,0,2
11602,2020-09-23,3호선,동대입구,6890,7361,14251
11603,2020-09-23,3호선,약수,12732,12526,25258
11604,2020-09-23,3호선,금호,7716,7223,14939
11605,2020-09-23,3호선,옥수,8683,9031,17714
11606,2020-09-23,3호선,압구정,29712,31968,61680
11607,2020-09-23,3호선,신사,27002,29275,56277
11608,2020-09-23,3호선,잠원,5116,5042,10158
11609,2020-09-23,3호선,고속터미널,33092,32242,65334
11610,2020-09-23,3호선,교대,13826,9112,22938
11611,2020-09-23,3호선,남부터미널,26227,27109,53336
11612,2020-09-23,3호선,양재,36804,39887,76691
11613,2020-09-23,3호선,매봉,11452,10939,22391
11614,2020-09-23,3호선,도곡,5126,5191,10317
11615,2020-09-23,3호선,대치,9797,9769,19566
11616,2020-09-23,3호선,학여울,1651,1666,3317
11617,2020-09-23,3호선,대청,9454,8659,18113
11618,2020-09-23,3호선,일원,9242,9126,18368
11619,2020-09-23,3호선,수서,15136,15250,30386
11620,2020-09-23,3호선,가락시장,9064,8829,17893
11621,2020-09-23,3호선,경찰병원,7320,7226,14546
11622,2020-09-23,3호선,오금,6123,5361,11484
11623,2020-09-23,3호선,원흥,8862,8474,17336
11624,2020-09-23,3호선,삼송,16983,16452,33435
11625,2020-09-23,3호선,원당,10671,10204,20875
11626,2020-09-23,3호선,화정,15902,16286,32188
11627,2020-09-23,3호선,대곡,1857,1476,3333
11628,2020-09-23,3호선,백석,9384,9262,18646
11629,2020-09-23,3호선,마두,6920,7185,14105
11630,2020-09-23,3호선,정발산,6594,6681,13275
11631,2020-09-23,3호선,주엽,8073,8248,16321
11632,2020-09-24,3호선,원흥,8971,8363,17334
11633,2020-09-24,3호선,삼송,17079,16496,33575
11634,2020-09-24,3호선,원당,10719,10017,20736
11635,2020-09-24,3호선,화정,15663,16220,31883
11636,2020-09-24,3호선,대곡,1740,1323,3063
11637,2020-09-24,3호선,백석,9471,9471,18942
11638,2020-09-24,3호선,마두,6789,7100,13889
11639,2020-09-24,3호선,정발산,6495,6750,13245
11640,2020-09-24,3호선,주엽,8104,8047,16151
11641,2020-09-24,3호선,대화,12713,9805,22518
11642,2020-09-24,3호선,오금,5953,5368,11321
11643,2020-09-24,3호선,경찰병원,7208,7209,14417
11644,2020-09-24,3호선,가락시장,9036,8850,17886
11645,2020-09-24,3호선,수서,15411,15577,30988
11646,2020-09-24,3호선,일원,9360,9168,18528
11647,2020-09-24,3호선,대청,9416,8442,17858
11648,2020-09-24,3호선,학여울,1637,1671,3308
11649,2020-09-24,3호선,대치,9769,9753,19522
11650,2020-09-24,3호선,도곡,5192,5272,10464
11651,2020-09-24,3호선,매봉,11500,10918,22418
11652,2020-09-24,3호선,양재,37124,40697,77821
11653,2020-09-24,3호선,남부터미널,26366,27205,53571
11654,2020-09-24,3호선,교대,14009,9187,23196
11655,2020-09-24,3호선,고속터미널,33597,33008,66605
11656,2020-09-24,3호선,잠원,5118,4974,10092
11657,2020-09-24,3호선,신사,27465,29800,57265
11658,2020-09-24,3호선,압구정,29718,32189,61907
11659,2020-09-24,3호선,옥수,8746,8977,17723
11660,2020-09-24,3호선,금호,7784,7158,14942
11661,2020-09-24,3호선,약수,12696,12461,25157
11662,2020-09-24,3호선,동대입구,6758,7214,13972
11663,2020-09-24,3호선,충무로,1,0,1
11664,2020-09-24,3호선,을지로3가,9692,10297,19989
11665,2020-09-24,3호선,종로3가,9105,10891,19996
11666,2020-09-24,3호선,안국,17849,18582,36431
11667,2020-09-24,3호선,경복궁,17268,17022,34290
11668,2020-09-24,3호선,독립문,6935,7142,14077
11669,2020-09-24,3호선,무악재,3732,3762,7494
11670,2020-09-24,3호선,홍제,16810,15787,32597
11671,2020-09-24,3호선,녹번,14343,12854,27197
11672,2020-09-24,3호선,불광,15856,16979,32835
11673,2020-09-24,3호선,연신내,36385,33785,70170
11674,2020-09-24,3호선,구파발,19978,18772,38750
11675,2020-09-24,3호선,지축,3230,3135,6365
11676,2020-09-25,3호선,옥수,9205,9505,18710
11677,2020-09-25,3호선,대화,12831,10113,22944
11678,2020-09-25,3호선,주엽,8494,8658,17152
11679,2020-09-25,3호선,정발산,6885,7264,14149
11680,2020-09-25,3호선,마두,7308,7627,14935
11681,2020-09-25,3호선,백석,9888,9916,19804
11682,2020-09-25,3호선,대곡,1867,1407,3274
11683,2020-09-25,3호선,화정,16402,16937,33339
11684,2020-09-25,3호선,원당,11078,10312,21390
11685,2020-09-25,3호선,삼송,17826,17109,34935
11686,2020-09-25,3호선,원흥,9253,8475,17728
11687,2020-09-25,3호선,오금,6126,5454,11580
11688,2020-09-25,3호선,경찰병원,7357,7321,14678
11689,2020-09-25,3호선,가락시장,9713,9810,19523
11690,2020-09-25,3호선,수서,17043,17210,34253
11691,2020-09-25,3호선,일원,9341,8939,18280
11692,2020-09-25,3호선,대청,9654,8603,18257
11693,2020-09-25,3호선,학여울,1713,1730,3443
11694,2020-09-25,3호선,대치,10523,10459,20982
11695,2020-09-25,3호선,도곡,5202,5227,10429
11696,2020-09-25,3호선,매봉,11778,11189,22967
11697,2020-09-25,3호선,양재,39188,41396,80584
11698,2020-09-25,3호선,남부터미널,28822,29329,58151
11699,2020-09-25,3호선,교대,14371,9269,23640
11700,2020-09-25,3호선,고속터미널,39502,40954,80456
11701,2020-09-25,3호선,잠원,5455,5314,10769
11702,2020-09-25,3호선,신사,29433,33138,62571
11703,2020-09-25,3호선,압구정,32258,35453,67711
11704,2020-09-25,3호선,금호,8238,7553,15791
11705,2020-09-25,3호선,약수,13238,13000,26238
11706,2020-09-25,3호선,동대입구,7056,7347,14403
11707,2020-09-25,3호선,을지로3가,10100,10964,21064
11708,2020-09-25,3호선,종로3가,9072,11437,20509
11709,2020-09-25,3호선,안국,18190,19063,37253
11710,2020-09-25,3호선,경복궁,17994,17717,35711
11711,2020-09-25,3호선,독립문,7192,7345,14537
11712,2020-09-25,3호선,무악재,3864,3888,7752
11713,2020-09-25,3호선,홍제,17504,16395,33899
11714,2020-09-25,3호선,녹번,14633,12899,27532
11715,2020-09-25,3호선,불광,16467,17364,33831
11716,2020-09-25,3호선,연신내,37677,35228,72905
11717,2020-09-25,3호선,구파발,20528,19107,39635
11718,2020-09-25,3호선,지축,3377,3200,6577
11719,2020-09-26,3호선,지축,2024,1895,3919
11720,2020-09-26,3호선,구파발,13867,13598,27465
11721,2020-09-26,3호선,연신내,27824,25669,53493
11722,2020-09-26,3호선,불광,11686,13266,24952
11723,2020-09-26,3호선,녹번,8708,7374,16082
11724,2020-09-26,3호선,홍제,12056,11177,23233
11725,2020-09-26,3호선,무악재,2351,2463,4814
11726,2020-09-26,3호선,독립문,5188,5518,10706
11727,2020-09-26,3호선,경복궁,11683,12497,24180
11728,2020-09-26,3호선,안국,10075,12306,22381
11729,2020-09-26,3호선,종로3가,4307,6568,10875
11730,2020-09-26,3호선,을지로3가,3950,4669,8619
11731,2020-09-26,3호선,충무로,1,0,1
11732,2020-09-26,3호선,동대입구,4914,5519,10433
11733,2020-09-26,3호선,약수,8351,7767,16118
11734,2020-09-26,3호선,금호,5506,4923,10429
11735,2020-09-26,3호선,옥수,6413,6383,12796
11736,2020-09-26,3호선,압구정,22762,24253,47015
11737,2020-09-26,3호선,신사,21192,22951,44143
11738,2020-09-26,3호선,잠원,3848,3663,7511
11739,2020-09-26,3호선,고속터미널,38494,39684,78178
11740,2020-09-26,3호선,교대,5469,3405,8874
11741,2020-09-26,3호선,남부터미널,16232,16728,32960
11742,2020-09-26,3호선,양재,17174,18650,35824
11743,2020-09-26,3호선,매봉,5113,4904,10017
11744,2020-09-26,3호선,도곡,3153,3110,6263
11745,2020-09-26,3호선,대치,7907,7188,15095
11746,2020-09-26,3호선,학여울,968,937,1905
11747,2020-09-26,3호선,대청,5209,4724,9933
11748,2020-09-26,3호선,일원,4124,4018,8142
11749,2020-09-26,3호선,수서,10153,10670,20823
11750,2020-09-26,3호선,가락시장,6080,5970,12050
11751,2020-09-26,3호선,경찰병원,3508,3378,6886
11752,2020-09-26,3호선,오금,3366,3097,6463
11753,2020-09-26,3호선,원흥,5803,5457,11260
11754,2020-09-26,3호선,삼송,12018,11527,23545
11755,2020-09-26,3호선,원당,7409,6906,14315
11756,2020-09-26,3호선,화정,10949,11369,22318
11757,2020-09-26,3호선,대곡,1198,1026,2224
11758,2020-09-26,3호선,백석,6761,6849,13610
11759,2020-09-26,3호선,마두,4411,4510,8921
11760,2020-09-26,3호선,정발산,5548,5958,11506
11761,2020-09-26,3호선,주엽,5568,5589,11157
11762,2020-09-26,3호선,대화,7601,6773,14374
11763,2020-09-27,3호선,대화,5420,4741,10161
11764,2020-09-27,3호선,주엽,3618,3537,7155
11765,2020-09-27,3호선,정발산,4130,4139,8269
11766,2020-09-27,3호선,마두,2783,2811,5594
11767,2020-09-27,3호선,백석,4678,4726,9404
11768,2020-09-27,3호선,대곡,890,707,1597
11769,2020-09-27,3호선,화정,7786,8186,15972
11770,2020-09-27,3호선,원당,5311,5036,10347
11771,2020-09-27,3호선,삼송,8807,8543,17350
11772,2020-09-27,3호선,원흥,4077,3840,7917
11773,2020-09-27,3호선,오금,2447,2344,4791
11774,2020-09-27,3호선,경찰병원,2247,2243,4490
11775,2020-09-27,3호선,가락시장,3428,3657,7085
11776,2020-09-27,3호선,수서,7355,7665,15020
11777,2020-09-27,3호선,일원,2483,2648,5131
11778,2020-09-27,3호선,대청,3270,3099,6369
11779,2020-09-27,3호선,학여울,644,646,1290
11780,2020-09-27,3호선,대치,4736,4152,8888
11781,2020-09-27,3호선,도곡,1615,1689,3304
11782,2020-09-27,3호선,매봉,3313,3190,6503
11783,2020-09-27,3호선,양재,10106,11734,21840
11784,2020-09-27,3호선,남부터미널,10202,11199,21401
11785,2020-09-27,3호선,교대,3120,2021,5141
11786,2020-09-27,3호선,고속터미널,29763,30038,59801
11787,2020-09-27,3호선,잠원,2089,2138,4227
11788,2020-09-27,3호선,신사,11541,12054,23595
11789,2020-09-27,3호선,압구정,11613,12156,23769
11790,2020-09-27,3호선,옥수,4465,4606,9071
11791,2020-09-27,3호선,금호,3717,3473,7190
11792,2020-09-27,3호선,약수,5384,5123,10507
11793,2020-09-27,3호선,동대입구,3666,4094,7760
11794,2020-09-27,3호선,충무로,1,0,1
11795,2020-09-27,3호선,을지로3가,2015,2115,4130
11796,2020-09-27,3호선,종로3가,2668,3776,6444
11797,2020-09-27,3호선,안국,7103,8698,15801
11798,2020-09-27,3호선,경복궁,8341,8735,17076
11799,2020-09-27,3호선,독립문,3626,4011,7637
11800,2020-09-27,3호선,무악재,1494,1716,3210
11801,2020-09-27,3호선,홍제,7988,7542,15530
11802,2020-09-27,3호선,녹번,5709,4994,10703
11803,2020-09-27,3호선,불광,8680,10225,18905
11804,2020-09-27,3호선,연신내,19341,17823,37164
11805,2020-09-27,3호선,구파발,9664,9950,19614
11806,2020-09-27,3호선,지축,1480,1462,2942
11807,2020-09-28,3호선,지축,3203,3122,6325
11808,2020-09-28,3호선,구파발,19915,18668,38583
11809,2020-09-28,3호선,연신내,37177,34696,71873
11810,2020-09-28,3호선,불광,16011,17179,33190
11811,2020-09-28,3호선,녹번,14224,12746,26970
11812,2020-09-28,3호선,홍제,17217,16254,33471
11813,2020-09-28,3호선,무악재,3759,3768,7527
11814,2020-09-28,3호선,독립문,6992,7169,14161
11815,2020-09-28,3호선,경복궁,16761,16711,33472
11816,2020-09-28,3호선,안국,14550,15428,29978
11817,2020-09-28,3호선,종로3가,9067,10879,19946
11818,2020-09-28,3호선,을지로3가,9899,10363,20262
11819,2020-09-28,3호선,동대입구,6808,7033,13841
11820,2020-09-28,3호선,약수,12867,12804,25671
11821,2020-09-28,3호선,금호,7955,7360,15315
11822,2020-09-28,3호선,옥수,8848,9021,17869
11823,2020-09-28,3호선,압구정,30674,32965,63639
11824,2020-09-28,3호선,신사,28120,30362,58482
11825,2020-09-28,3호선,잠원,5169,5087,10256
11826,2020-09-28,3호선,고속터미널,36273,39872,76145
11827,2020-09-28,3호선,교대,13370,9062,22432
11828,2020-09-28,3호선,남부터미널,26770,28822,55592
11829,2020-09-28,3호선,양재,36111,39895,76006
11830,2020-09-28,3호선,매봉,11435,10953,22388
11831,2020-09-28,3호선,도곡,5111,5194,10305
11832,2020-09-28,3호선,대치,10029,9941,19970
11833,2020-09-28,3호선,학여울,1622,1674,3296
11834,2020-09-28,3호선,대청,9420,8492,17912
11835,2020-09-28,3호선,일원,9113,8845,17958
11836,2020-09-28,3호선,수서,15255,16699,31954
11837,2020-09-28,3호선,가락시장,9419,9309,18728
11838,2020-09-28,3호선,경찰병원,7161,7176,14337
11839,2020-09-28,3호선,오금,5947,5257,11204
11840,2020-09-28,3호선,원흥,8940,8256,17196
11841,2020-09-28,3호선,삼송,17347,16562,33909
11842,2020-09-28,3호선,원당,10727,10145,20872
11843,2020-09-28,3호선,화정,16181,16557,32738
11844,2020-09-28,3호선,대곡,1674,1288,2962
11845,2020-09-28,3호선,백석,9654,9667,19321
11846,2020-09-28,3호선,마두,7130,7282,14412
11847,2020-09-28,3호선,정발산,6557,6579,13136
11848,2020-09-28,3호선,주엽,8425,8420,16845
11849,2020-09-28,3호선,대화,12889,9909,22798
11850,2020-09-29,3호선,경찰병원,6820,6616,13436
11851,2020-09-29,3호선,대화,12045,9597,21642
11852,2020-09-29,3호선,주엽,8031,8239,16270
11853,2020-09-29,3호선,정발산,6421,6808,13229
11854,2020-09-29,3호선,마두,6863,7074,13937
11855,2020-09-29,3호선,백석,9488,9738,19226
11856,2020-09-29,3호선,대곡,1625,1230,2855
11857,2020-09-29,3호선,화정,15578,16291,31869
11858,2020-09-29,3호선,원당,10433,9872,20305
11859,2020-09-29,3호선,삼송,16713,16221,32934
11860,2020-09-29,3호선,원흥,8494,7647,16141
11861,2020-09-29,3호선,지축,3166,2984,6150
11862,2020-09-29,3호선,구파발,19246,17751,36997
11863,2020-09-29,3호선,연신내,36697,34140,70837
11864,2020-09-29,3호선,불광,15606,16671,32277
11865,2020-09-29,3호선,녹번,13891,11905,25796
11866,2020-09-29,3호선,홍제,17003,15875,32878
11867,2020-09-29,3호선,무악재,3580,3506,7086
11868,2020-09-29,3호선,독립문,7090,7004,14094
11869,2020-09-29,3호선,경복궁,16639,15770,32409
11870,2020-09-29,3호선,안국,13966,15041,29007
11871,2020-09-29,3호선,종로3가,8644,10630,19274
11872,2020-09-29,3호선,을지로3가,9267,9902,19169
11873,2020-09-29,3호선,충무로,1,0,1
11874,2020-09-29,3호선,동대입구,6593,6691,13284
11875,2020-09-29,3호선,약수,12484,11837,24321
11876,2020-09-29,3호선,금호,7960,7228,15188
11877,2020-09-29,3호선,옥수,8857,8898,17755
11878,2020-09-29,3호선,압구정,30603,32839,63442
11879,2020-09-29,3호선,신사,28297,30958,59255
11880,2020-09-29,3호선,잠원,5121,5034,10155
11881,2020-09-29,3호선,고속터미널,40012,62114,102126
11882,2020-09-29,3호선,교대,12259,8109,20368
11883,2020-09-29,3호선,남부터미널,26726,31036,57762
11884,2020-09-29,3호선,양재,35722,36817,72539
11885,2020-09-29,3호선,매봉,10669,10070,20739
11886,2020-09-29,3호선,도곡,4996,4934,9930
11887,2020-09-29,3호선,대치,10170,10177,20347
11888,2020-09-29,3호선,학여울,1557,1581,3138
11889,2020-09-29,3호선,대청,9042,8090,17132
11890,2020-09-29,3호선,일원,8784,8368,17152
11891,2020-09-29,3호선,수서,13902,14641,28543
11892,2020-09-29,3호선,가락시장,9144,9196,18340
11893,2020-09-29,3호선,오금,5818,5116,10934
11894,2020-09-30,3호선,대화,4705,4280,8985
11895,2020-09-30,3호선,주엽,3211,3268,6479
11896,2020-09-30,3호선,정발산,3089,3250,6339
11897,2020-09-30,3호선,마두,2542,2629,5171
11898,2020-09-30,3호선,백석,4349,4544,8893
11899,2020-09-30,3호선,대곡,719,635,1354
11900,2020-09-30,3호선,화정,6868,7340,14208
11901,2020-09-30,3호선,원당,4673,4705,9378
11902,2020-09-30,3호선,삼송,7597,7572,15169
11903,2020-09-30,3호선,원흥,3598,3222,6820
11904,2020-09-30,3호선,오금,2017,1696,3713
11905,2020-09-30,3호선,경찰병원,2107,1846,3953
11906,2020-09-30,3호선,가락시장,3810,3532,7342
11907,2020-09-30,3호선,수서,5608,7132,12740
11908,2020-09-30,3호선,일원,2253,2285,4538
11909,2020-09-30,3호선,대청,3110,2726,5836
11910,2020-09-30,3호선,학여울,508,459,967
11911,2020-09-30,3호선,대치,5363,4729,10092
11912,2020-09-30,3호선,도곡,1554,1488,3042
11913,2020-09-30,3호선,매봉,2803,2430,5233
11914,2020-09-30,3호선,양재,7831,8146,15977
11915,2020-09-30,3호선,남부터미널,9163,12849,22012
11916,2020-09-30,3호선,교대,2632,1414,4046
11917,2020-09-30,3호선,고속터미널,19051,36431,55482
11918,2020-09-30,3호선,잠원,2006,1792,3798
11919,2020-09-30,3호선,신사,10743,11332,22075
11920,2020-09-30,3호선,압구정,12045,12370,24415
11921,2020-09-30,3호선,옥수,3914,3809,7723
11922,2020-09-30,3호선,금호,3369,2985,6354
11923,2020-09-30,3호선,약수,4898,4342,9240
11924,2020-09-30,3호선,동대입구,3049,3222,6271
11925,2020-09-30,3호선,을지로3가,1617,1791,3408
11926,2020-09-30,3호선,종로3가,2135,3116,5251
11927,2020-09-30,3호선,안국,5658,5979,11637
11928,2020-09-30,3호선,경복궁,6979,6955,13934
11929,2020-09-30,3호선,독립문,3055,3091,6146
11930,2020-09-30,3호선,무악재,1458,1530,2988
11931,2020-09-30,3호선,홍제,7224,6699,13923
11932,2020-09-30,3호선,녹번,5284,4535,9819
11933,2020-09-30,3호선,불광,7136,7808,14944
11934,2020-09-30,3호선,연신내,17327,15933,33260
11935,2020-09-30,3호선,구파발,8253,8337,16590
11936,2020-09-30,3호선,지축,1162,1171,2333
11937,2020-10-01,3호선,지축,917,915,1832
11938,2020-10-01,3호선,구파발,6130,6215,12345
11939,2020-10-01,3호선,연신내,12634,11966,24600
11940,2020-10-01,3호선,불광,4688,5237,9925
11941,2020-10-01,3호선,녹번,3685,3358,7043
11942,2020-10-01,3호선,홍제,5246,4857,10103
11943,2020-10-01,3호선,무악재,1100,1142,2242
11944,2020-10-01,3호선,독립문,2362,2420,4782
11945,2020-10-01,3호선,경복궁,5440,6358,11798
11946,2020-10-01,3호선,안국,4036,4638,8674
11947,2020-10-01,3호선,종로3가,1396,2282,3678
11948,2020-10-01,3호선,을지로3가,881,979,1860
11949,2020-10-01,3호선,동대입구,2150,2593,4743
11950,2020-10-01,3호선,약수,3521,3322,6843
11951,2020-10-01,3호선,금호,2459,2229,4688
11952,2020-10-01,3호선,옥수,2677,2602,5279
11953,2020-10-01,3호선,압구정,3936,4080,8016
11954,2020-10-01,3호선,신사,4228,4923,9151
11955,2020-10-01,3호선,잠원,1192,1147,2339
11956,2020-10-01,3호선,고속터미널,13060,13451,26511
11957,2020-10-01,3호선,교대,1234,813,2047
11958,2020-10-01,3호선,남부터미널,6259,6259,12518
11959,2020-10-01,3호선,양재,4618,5308,9926
11960,2020-10-01,3호선,매봉,1620,1579,3199
11961,2020-10-01,3호선,도곡,888,846,1734
11962,2020-10-01,3호선,대치,2686,2488,5174
11963,2020-10-01,3호선,학여울,374,311,685
11964,2020-10-01,3호선,대청,2055,1950,4005
11965,2020-10-01,3호선,일원,1582,1641,3223
11966,2020-10-01,3호선,수서,4701,4626,9327
11967,2020-10-01,3호선,가락시장,1738,1711,3449
11968,2020-10-01,3호선,경찰병원,1413,1352,2765
11969,2020-10-01,3호선,오금,1283,1215,2498
11970,2020-10-01,3호선,원흥,2410,2312,4722
11971,2020-10-01,3호선,삼송,6002,5477,11479
11972,2020-10-01,3호선,원당,3477,3417,6894
11973,2020-10-01,3호선,화정,4911,5176,10087
11974,2020-10-01,3호선,대곡,601,443,1044
11975,2020-10-01,3호선,백석,2889,2908,5797
11976,2020-10-01,3호선,마두,1747,1688,3435
11977,2020-10-01,3호선,정발산,2240,2480,4720
11978,2020-10-01,3호선,주엽,2283,2201,4484
11979,2020-10-01,3호선,대화,3429,3353,6782
11980,2020-10-02,3호선,대청,2762,2533,5295
11981,2020-10-02,3호선,대화,4925,4125,9050
11982,2020-10-02,3호선,주엽,3221,3026,6247
11983,2020-10-02,3호선,정발산,3648,4222,7870
11984,2020-10-02,3호선,마두,2540,2361,4901
11985,2020-10-02,3호선,백석,4352,4413,8765
11986,2020-10-02,3호선,대곡,741,612,1353
11987,2020-10-02,3호선,화정,7149,7349,14498
11988,2020-10-02,3호선,원당,4678,4262,8940
11989,2020-10-02,3호선,삼송,7752,7350,15102
11990,2020-10-02,3호선,원흥,3444,3182,6626
11991,2020-10-02,3호선,오금,1738,1666,3404
11992,2020-10-02,3호선,경찰병원,1882,1864,3746
11993,2020-10-02,3호선,가락시장,2741,2802,5543
11994,2020-10-02,3호선,수서,6329,5518,11847
11995,2020-10-02,3호선,일원,2197,2258,4455
11996,2020-10-02,3호선,학여울,517,470,987
11997,2020-10-02,3호선,대치,3926,3416,7342
11998,2020-10-02,3호선,도곡,1410,1344,2754
11999,2020-10-02,3호선,매봉,2606,2545,5151
12000,2020-10-02,3호선,양재,7032,8201,15233
12001,2020-10-02,3호선,남부터미널,9721,8266,17987
12002,2020-10-02,3호선,교대,2287,1508,3795
12003,2020-10-02,3호선,고속터미널,30064,23309,53373
12004,2020-10-02,3호선,잠원,1681,1682,3363
12005,2020-10-02,3호선,신사,8570,10424,18994
12006,2020-10-02,3호선,압구정,6852,7632,14484
12007,2020-10-02,3호선,옥수,3665,3724,7389
12008,2020-10-02,3호선,금호,3115,2758,5873
12009,2020-10-02,3호선,약수,4270,4301,8571
12010,2020-10-02,3호선,동대입구,2913,3768,6681
12011,2020-10-02,3호선,을지로3가,1562,1956,3518
12012,2020-10-02,3호선,종로3가,2177,4036,6213
12013,2020-10-02,3호선,안국,5738,7103,12841
12014,2020-10-02,3호선,경복궁,7479,8739,16218
12015,2020-10-02,3호선,독립문,3174,3561,6735
12016,2020-10-02,3호선,무악재,1406,1456,2862
12017,2020-10-02,3호선,홍제,6651,6149,12800
12018,2020-10-02,3호선,녹번,4772,4116,8888
12019,2020-10-02,3호선,불광,6817,8232,15049
12020,2020-10-02,3호선,연신내,16474,15569,32043
12021,2020-10-02,3호선,구파발,8364,8545,16909
12022,2020-10-02,3호선,지축,1197,1042,2239
12023,2020-10-03,3호선,대화,5747,4917,10664
12024,2020-10-03,3호선,주엽,3968,3804,7772
12025,2020-10-03,3호선,정발산,4669,5176,9845
12026,2020-10-03,3호선,마두,3298,3260,6558
12027,2020-10-03,3호선,백석,5061,5032,10093
12028,2020-10-03,3호선,대곡,970,845,1815
12029,2020-10-03,3호선,화정,8625,9118,17743
12030,2020-10-03,3호선,원당,5530,5173,10703
12031,2020-10-03,3호선,삼송,9312,8849,18161
12032,2020-10-03,3호선,원흥,4309,4115,8424
12033,2020-10-03,3호선,오금,2195,2171,4366
12034,2020-10-03,3호선,경찰병원,2284,2365,4649
12035,2020-10-03,3호선,가락시장,3306,3312,6618
12036,2020-10-03,3호선,수서,7464,6266,13730
12037,2020-10-03,3호선,일원,2680,2617,5297
12038,2020-10-03,3호선,대청,3405,3253,6658
12039,2020-10-03,3호선,학여울,605,575,1180
12040,2020-10-03,3호선,대치,5074,4430,9504
12041,2020-10-03,3호선,도곡,1634,1630,3264
12042,2020-10-03,3호선,매봉,3353,3245,6598
12043,2020-10-03,3호선,양재,9644,11142,20786
12044,2020-10-03,3호선,남부터미널,13426,10946,24372
12045,2020-10-03,3호선,교대,3000,1959,4959
12046,2020-10-03,3호선,고속터미널,38444,26583,65027
12047,2020-10-03,3호선,잠원,2260,2277,4537
12048,2020-10-03,3호선,신사,11185,13102,24287
12049,2020-10-03,3호선,압구정,11379,12177,23556
12050,2020-10-03,3호선,옥수,4681,4655,9336
12051,2020-10-03,3호선,금호,3883,3561,7444
12052,2020-10-03,3호선,약수,5370,5275,10645
12053,2020-10-03,3호선,동대입구,3860,4529,8389
12054,2020-10-03,3호선,충무로,1,0,1
12055,2020-10-03,3호선,을지로3가,2486,2831,5317
12056,2020-10-03,3호선,종로3가,2800,5153,7953
12057,2020-10-03,3호선,안국,8164,11563,19727
12058,2020-10-03,3호선,경복궁,3155,2709,5864
12059,2020-10-03,3호선,독립문,5650,6741,12391
12060,2020-10-03,3호선,무악재,1820,1937,3757
12061,2020-10-03,3호선,홍제,8544,8068,16612
12062,2020-10-03,3호선,녹번,6003,5523,11526
12063,2020-10-03,3호선,불광,9131,11143,20274
12064,2020-10-03,3호선,연신내,20313,19560,39873
12065,2020-10-03,3호선,구파발,10539,11285,21824
12066,2020-10-03,3호선,지축,1620,1544,3164
12067,2020-10-04,3호선,지축,1319,1310,2629
12068,2020-10-04,3호선,구파발,8888,9322,18210
12069,2020-10-04,3호선,연신내,17800,16575,34375
12070,2020-10-04,3호선,불광,7843,9590,17433
12071,2020-10-04,3호선,녹번,5165,4813,9978
12072,2020-10-04,3호선,홍제,6927,6884,13811
12073,2020-10-04,3호선,무악재,1490,1605,3095
12074,2020-10-04,3호선,독립문,3299,3776,7075
12075,2020-10-04,3호선,경복궁,7528,8150,15678
12076,2020-10-04,3호선,안국,6058,6878,12936
12077,2020-10-04,3호선,종로3가,2417,3578,5995
12078,2020-10-04,3호선,을지로3가,1705,1844,3549
12079,2020-10-04,3호선,동대입구,3290,3918,7208
12080,2020-10-04,3호선,약수,4837,4799,9636
12081,2020-10-04,3호선,금호,3452,3357,6809
12082,2020-10-04,3호선,옥수,4037,4307,8344
12083,2020-10-04,3호선,압구정,9897,10705,20602
12084,2020-10-04,3호선,신사,9619,10241,19860
12085,2020-10-04,3호선,잠원,1957,1992,3949
12086,2020-10-04,3호선,고속터미널,39931,27496,67427
12087,2020-10-04,3호선,교대,2572,1728,4300
12088,2020-10-04,3호선,남부터미널,12740,11057,23797
12089,2020-10-04,3호선,양재,8650,10598,19248
12090,2020-10-04,3호선,매봉,2977,3014,5991
12091,2020-10-04,3호선,도곡,1419,1437,2856
12092,2020-10-04,3호선,대치,4205,3715,7920
12093,2020-10-04,3호선,학여울,590,624,1214
12094,2020-10-04,3호선,대청,3168,3136,6304
12095,2020-10-04,3호선,일원,2426,2604,5030
12096,2020-10-04,3호선,수서,7110,6562,13672
12097,2020-10-04,3호선,가락시장,2906,3051,5957
12098,2020-10-04,3호선,경찰병원,2050,2184,4234
12099,2020-10-04,3호선,오금,2112,2091,4203
12100,2020-10-04,3호선,대화,5044,4605,9649
12101,2020-10-04,3호선,주엽,3364,3254,6618
12102,2020-10-04,3호선,정발산,3904,3893,7797
12103,2020-10-04,3호선,마두,2655,2652,5307
12104,2020-10-04,3호선,백석,4539,4380,8919
12105,2020-10-04,3호선,대곡,829,687,1516
12106,2020-10-04,3호선,화정,7459,7703,15162
12107,2020-10-04,3호선,원당,5005,4801,9806
12108,2020-10-04,3호선,삼송,8067,7890,15957
12109,2020-10-04,3호선,지축,1,0,1
12110,2020-10-04,3호선,원흥,3753,3613,7366
12111,2020-10-05,3호선,신사,27429,29453,56882
12112,2020-10-05,3호선,압구정,29516,31409,60925
12113,2020-10-05,3호선,옥수,8468,9064,17532
12114,2020-10-05,3호선,금호,7721,7318,15039
12115,2020-10-05,3호선,약수,12302,12349,24651
12116,2020-10-05,3호선,동대입구,6744,7111,13855
12117,2020-10-05,3호선,충무로,2,0,2
12118,2020-10-05,3호선,을지로3가,9608,10111,19719
12119,2020-10-05,3호선,종로3가,8981,10542,19523
12120,2020-10-05,3호선,안국,16283,16942,33225
12121,2020-10-05,3호선,경복궁,16170,15935,32105
12122,2020-10-05,3호선,독립문,6865,7132,13997
12123,2020-10-05,3호선,무악재,3649,3770,7419
12124,2020-10-05,3호선,홍제,16762,16256,33018
12125,2020-10-05,3호선,녹번,14027,12858,26885
12126,2020-10-05,3호선,불광,15681,16701,32382
12127,2020-10-05,3호선,연신내,36122,33827,69949
12128,2020-10-05,3호선,구파발,19702,18508,38210
12129,2020-10-05,3호선,지축,3156,3152,6308
12130,2020-10-05,3호선,양재,36013,39684,75697
12131,2020-10-05,3호선,매봉,11407,10927,22334
12132,2020-10-05,3호선,도곡,5098,5189,10287
12133,2020-10-05,3호선,대치,9364,9495,18859
12134,2020-10-05,3호선,학여울,1660,1641,3301
12135,2020-10-05,3호선,대청,9249,8492,17741
12136,2020-10-05,3호선,일원,9236,9241,18477
12137,2020-10-05,3호선,수서,15564,14617,30181
12138,2020-10-05,3호선,가락시장,8471,8332,16803
12139,2020-10-05,3호선,경찰병원,7264,7401,14665
12140,2020-10-05,3호선,오금,6014,5363,11377
12141,2020-10-05,3호선,대화,12846,9766,22612
12142,2020-10-05,3호선,주엽,8308,8445,16753
12143,2020-10-05,3호선,정발산,6463,6455,12918
12144,2020-10-05,3호선,마두,7104,7443,14547
12145,2020-10-05,3호선,백석,9480,9513,18993
12146,2020-10-05,3호선,대곡,1767,1387,3154
12147,2020-10-05,3호선,화정,15999,16432,32431
12148,2020-10-05,3호선,원당,10779,10196,20975
12149,2020-10-05,3호선,삼송,17253,16655,33908
12150,2020-10-05,3호선,원흥,8963,8570,17533
12151,2020-10-05,3호선,남부터미널,27629,27716,55345
12152,2020-10-05,3호선,교대,12765,8717,21482
12153,2020-10-05,3호선,고속터미널,35997,31587,67584
12154,2020-10-05,3호선,잠원,4971,4890,9861
12155,2020-10-06,3호선,주엽,8312,8545,16857
12156,2020-10-06,3호선,대화,12799,9774,22573
12157,2020-10-06,3호선,마두,7250,7492,14742
12158,2020-10-06,3호선,정발산,6676,6721,13397
12159,2020-10-06,3호선,지축,3256,3194,6450
12160,2020-10-06,3호선,구파발,20297,19021,39318
12161,2020-10-06,3호선,연신내,36799,34580,71379
12162,2020-10-06,3호선,불광,16251,17189,33440
12163,2020-10-06,3호선,녹번,14404,13176,27580
12164,2020-10-06,3호선,홍제,17100,16266,33366
12165,2020-10-06,3호선,무악재,3793,3881,7674
12166,2020-10-06,3호선,독립문,6953,7352,14305
12167,2020-10-06,3호선,경복궁,17092,16873,33965
12168,2020-10-06,3호선,안국,17805,18474,36279
12169,2020-10-06,3호선,종로3가,9283,10791,20074
12170,2020-10-06,3호선,을지로3가,9945,10366,20311
12171,2020-10-06,3호선,동대입구,6997,7348,14345
12172,2020-10-06,3호선,약수,12612,12393,25005
12173,2020-10-06,3호선,금호,8015,7409,15424
12174,2020-10-06,3호선,옥수,8875,9156,18031
12175,2020-10-06,3호선,압구정,31005,33126,64131
12176,2020-10-06,3호선,신사,28912,30841,59753
12177,2020-10-06,3호선,잠원,5119,5037,10156
12178,2020-10-06,3호선,고속터미널,34572,32520,67092
12179,2020-10-06,3호선,교대,13525,9066,22591
12180,2020-10-06,3호선,남부터미널,27432,28055,55487
12181,2020-10-06,3호선,양재,37428,40853,78281
12182,2020-10-06,3호선,매봉,11790,11208,22998
12183,2020-10-06,3호선,도곡,5197,5203,10400
12184,2020-10-06,3호선,대치,9808,9930,19738
12185,2020-10-06,3호선,학여울,1637,1666,3303
12186,2020-10-06,3호선,대청,9586,8841,18427
12187,2020-10-06,3호선,일원,9776,9595,19371
12188,2020-10-06,3호선,수서,15306,15106,30412
12189,2020-10-06,3호선,가락시장,8699,8663,17362
12190,2020-10-06,3호선,경찰병원,7278,7369,14647
12191,2020-10-06,3호선,오금,6123,5544,11667
12192,2020-10-06,3호선,원흥,8948,8623,17571
12193,2020-10-06,3호선,삼송,17355,16770,34125
12194,2020-10-06,3호선,원당,10751,10222,20973
12195,2020-10-06,3호선,화정,16144,16625,32769
12196,2020-10-06,3호선,대곡,1769,1371,3140
12197,2020-10-06,3호선,백석,9477,9596,19073
12198,2020-10-07,3호선,백석,9465,9423,18888
12199,2020-10-07,3호선,지축,3318,3229,6547
12200,2020-10-07,3호선,구파발,20220,19240,39460
12201,2020-10-07,3호선,연신내,37121,34519,71640
12202,2020-10-07,3호선,불광,16361,17397,33758
12203,2020-10-07,3호선,녹번,14827,13186,28013
12204,2020-10-07,3호선,홍제,17136,16147,33283
12205,2020-10-07,3호선,무악재,3861,3862,7723
12206,2020-10-07,3호선,독립문,7103,7401,14504
12207,2020-10-07,3호선,경복궁,18066,17843,35909
12208,2020-10-07,3호선,안국,18512,19356,37868
12209,2020-10-07,3호선,종로3가,9235,11064,20299
12210,2020-10-07,3호선,을지로3가,9999,10648,20647
12211,2020-10-07,3호선,충무로,2,0,2
12212,2020-10-07,3호선,동대입구,6870,7346,14216
12213,2020-10-07,3호선,약수,12770,12581,25351
12214,2020-10-07,3호선,금호,8012,7409,15421
12215,2020-10-07,3호선,옥수,8953,9272,18225
12216,2020-10-07,3호선,압구정,30586,32949,63535
12217,2020-10-07,3호선,신사,28728,31089,59817
12218,2020-10-07,3호선,잠원,5216,5086,10302
12219,2020-10-07,3호선,고속터미널,34686,33181,67867
12220,2020-10-07,3호선,교대,14419,9639,24058
12221,2020-10-07,3호선,남부터미널,27543,28351,55894
12222,2020-10-07,3호선,양재,37755,41220,78975
12223,2020-10-07,3호선,매봉,11737,11196,22933
12224,2020-10-07,3호선,도곡,5137,5152,10289
12225,2020-10-07,3호선,대치,9826,9951,19777
12226,2020-10-07,3호선,학여울,1709,1711,3420
12227,2020-10-07,3호선,대청,9716,8905,18621
12228,2020-10-07,3호선,일원,9984,9831,19815
12229,2020-10-07,3호선,수서,15667,15407,31074
12230,2020-10-07,3호선,가락시장,8881,8784,17665
12231,2020-10-07,3호선,경찰병원,7595,7673,15268
12232,2020-10-07,3호선,오금,6175,5542,11717
12233,2020-10-07,3호선,대화,12944,10151,23095
12234,2020-10-07,3호선,주엽,8372,8413,16785
12235,2020-10-07,3호선,정발산,6779,6981,13760
12236,2020-10-07,3호선,마두,7196,7504,14700
12237,2020-10-07,3호선,원흥,9110,8840,17950
12238,2020-10-07,3호선,삼송,17586,16966,34552
12239,2020-10-07,3호선,원당,10958,10336,21294
12240,2020-10-07,3호선,화정,16319,16744,33063
12241,2020-10-07,3호선,대곡,1882,1473,3355
12242,2020-10-08,3호선,대화,13237,10261,23498
12243,2020-10-08,3호선,주엽,8746,8695,17441
12244,2020-10-08,3호선,정발산,7098,7545,14643
12245,2020-10-08,3호선,마두,7545,7676,15221
12246,2020-10-08,3호선,백석,9954,10177,20131
12247,2020-10-08,3호선,대곡,1923,1442,3365
12248,2020-10-08,3호선,화정,16786,17255,34041
12249,2020-10-08,3호선,원당,11057,10247,21304
12250,2020-10-08,3호선,삼송,17952,17070,35022
12251,2020-10-08,3호선,원흥,9451,8668,18119
12252,2020-10-08,3호선,오금,6504,5737,12241
12253,2020-10-08,3호선,경찰병원,7827,7793,15620
12254,2020-10-08,3호선,가락시장,9360,9253,18613
12255,2020-10-08,3호선,수서,17243,17256,34499
12256,2020-10-08,3호선,일원,10246,9713,19959
12257,2020-10-08,3호선,대청,9806,8853,18659
12258,2020-10-08,3호선,학여울,1834,1825,3659
12259,2020-10-08,3호선,대치,10439,10385,20824
12260,2020-10-08,3호선,도곡,5212,5282,10494
12261,2020-10-08,3호선,매봉,12042,11455,23497
12262,2020-10-08,3호선,양재,40287,42752,83039
12263,2020-10-08,3호선,남부터미널,29534,30632,60166
12264,2020-10-08,3호선,교대,14604,9604,24208
12265,2020-10-08,3호선,고속터미널,40114,42470,82584
12266,2020-10-08,3호선,잠원,5474,5236,10710
12267,2020-10-08,3호선,신사,30548,33916,64464
12268,2020-10-08,3호선,압구정,31786,35092,66878
12269,2020-10-08,3호선,옥수,9468,9633,19101
12270,2020-10-08,3호선,금호,8343,7583,15926
12271,2020-10-08,3호선,약수,13498,13334,26832
12272,2020-10-08,3호선,동대입구,7211,7545,14756
12273,2020-10-08,3호선,을지로3가,10437,11300,21737
12274,2020-10-08,3호선,종로3가,9587,11886,21473
12275,2020-10-08,3호선,안국,18912,19594,38506
12276,2020-10-08,3호선,경복궁,18674,18873,37547
12277,2020-10-08,3호선,독립문,7528,7612,15140
12278,2020-10-08,3호선,무악재,3931,3863,7794
12279,2020-10-08,3호선,홍제,17770,16613,34383
12280,2020-10-08,3호선,녹번,14917,13069,27986
12281,2020-10-08,3호선,불광,16707,17675,34382
12282,2020-10-08,3호선,연신내,38414,35673,74087
12283,2020-10-08,3호선,구파발,21200,19748,40948
12284,2020-10-08,3호선,지축,3365,3160,6525
12285,2020-10-09,3호선,지축,1887,1738,3625
12286,2020-10-09,3호선,구파발,12741,12738,25479
12287,2020-10-09,3호선,연신내,25935,23834,49769
12288,2020-10-09,3호선,불광,11233,12665,23898
12289,2020-10-09,3호선,녹번,8123,6833,14956
12290,2020-10-09,3호선,홍제,11556,10636,22192
12291,2020-10-09,3호선,무악재,2330,2387,4717
12292,2020-10-09,3호선,독립문,5254,5709,10963
12293,2020-10-09,3호선,경복궁,10594,10831,21425
12294,2020-10-09,3호선,안국,10523,12728,23251
12295,2020-10-09,3호선,종로3가,4033,6738,10771
12296,2020-10-09,3호선,을지로3가,3852,4634,8486
12297,2020-10-09,3호선,동대입구,5041,5800,10841
12298,2020-10-09,3호선,약수,7562,7072,14634
12299,2020-10-09,3호선,금호,5209,4539,9748
12300,2020-10-09,3호선,옥수,6106,6038,12144
12301,2020-10-09,3호선,압구정,16451,17886,34337
12302,2020-10-09,3호선,신사,16879,18829,35708
12303,2020-10-09,3호선,잠원,3136,3088,6224
12304,2020-10-09,3호선,고속터미널,38321,40060,78381
12305,2020-10-09,3호선,교대,4654,3008,7662
12306,2020-10-09,3호선,남부터미널,15452,16200,31652
12307,2020-10-09,3호선,양재,15160,16633,31793
12308,2020-10-09,3호선,매봉,4658,4395,9053
12309,2020-10-09,3호선,도곡,2758,2970,5728
12310,2020-10-09,3호선,대치,6443,6064,12507
12311,2020-10-09,3호선,학여울,900,862,1762
12312,2020-10-09,3호선,대청,4858,4244,9102
12313,2020-10-09,3호선,일원,3532,3494,7026
12314,2020-10-09,3호선,수서,9303,10254,19557
12315,2020-10-09,3호선,가락시장,5584,5454,11038
12316,2020-10-09,3호선,경찰병원,3308,3182,6490
12317,2020-10-09,3호선,오금,3169,2909,6078
12318,2020-10-09,3호선,원흥,5585,5269,10854
12319,2020-10-09,3호선,삼송,11764,11101,22865
12320,2020-10-09,3호선,원당,7087,6631,13718
12321,2020-10-09,3호선,화정,10592,10936,21528
12322,2020-10-09,3호선,대곡,1150,1031,2181
12323,2020-10-09,3호선,백석,6351,6152,12503
12324,2020-10-09,3호선,마두,4061,3994,8055
12325,2020-10-09,3호선,정발산,5356,5806,11162
12326,2020-10-09,3호선,주엽,5184,5058,10242
12327,2020-10-09,3호선,대화,7130,6200,13330
12328,2020-10-10,3호선,지축,2135,2066,4201
12329,2020-10-10,3호선,구파발,13723,13806,27529
12330,2020-10-10,3호선,연신내,27418,25949,53367
12331,2020-10-10,3호선,불광,11630,13268,24898
12332,2020-10-10,3호선,녹번,8540,7497,16037
12333,2020-10-10,3호선,홍제,11797,10906,22703
12334,2020-10-10,3호선,무악재,2389,2449,4838
12335,2020-10-10,3호선,독립문,5420,5929,11349
12336,2020-10-10,3호선,경복궁,11769,13031,24800
12337,2020-10-10,3호선,안국,10546,12691,23237
12338,2020-10-10,3호선,종로3가,4303,6673,10976
12339,2020-10-10,3호선,을지로3가,3957,4639,8596
12340,2020-10-10,3호선,동대입구,5124,6108,11232
12341,2020-10-10,3호선,약수,7926,7645,15571
12342,2020-10-10,3호선,금호,5355,4822,10177
12343,2020-10-10,3호선,옥수,6317,6303,12620
12344,2020-10-10,3호선,압구정,21761,22989,44750
12345,2020-10-10,3호선,신사,20771,22563,43334
12346,2020-10-10,3호선,잠원,3582,3482,7064
12347,2020-10-10,3호선,고속터미널,40011,38602,78613
12348,2020-10-10,3호선,교대,5447,3409,8856
12349,2020-10-10,3호선,남부터미널,16951,16759,33710
12350,2020-10-10,3호선,양재,16136,17962,34098
12351,2020-10-10,3호선,매봉,4946,4868,9814
12352,2020-10-10,3호선,도곡,2730,2689,5419
12353,2020-10-10,3호선,대치,7578,6857,14435
12354,2020-10-10,3호선,학여울,1002,929,1931
12355,2020-10-10,3호선,대청,5049,4754,9803
12356,2020-10-10,3호선,일원,4091,4055,8146
12357,2020-10-10,3호선,수서,10604,10067,20671
12358,2020-10-10,3호선,가락시장,5563,5349,10912
12359,2020-10-10,3호선,경찰병원,3408,3393,6801
12360,2020-10-10,3호선,오금,3695,3475,7170
12361,2020-10-10,3호선,원흥,5722,5454,11176
12362,2020-10-10,3호선,삼송,11748,11206,22954
12363,2020-10-10,3호선,원당,7630,7161,14791
12364,2020-10-10,3호선,화정,11278,11636,22914
12365,2020-10-10,3호선,대곡,1251,998,2249
12366,2020-10-10,3호선,백석,6563,6655,13218
12367,2020-10-10,3호선,마두,4490,4459,8949
12368,2020-10-10,3호선,정발산,5652,5959,11611
12369,2020-10-10,3호선,주엽,5528,5437,10965
12370,2020-10-10,3호선,대화,7516,6584,14100
12371,2020-10-11,3호선,오금,2598,2630,5228
12372,2020-10-11,3호선,원흥,4152,4080,8232
12373,2020-10-11,3호선,삼송,8635,8229,16864
12374,2020-10-11,3호선,원당,5471,5176,10647
12375,2020-10-11,3호선,화정,7985,8273,16258
12376,2020-10-11,3호선,대곡,926,761,1687
12377,2020-10-11,3호선,백석,4861,4794,9655
12378,2020-10-11,3호선,마두,2888,2828,5716
12379,2020-10-11,3호선,정발산,4261,4214,8475
12380,2020-10-11,3호선,주엽,3700,3700,7400
12381,2020-10-11,3호선,대화,5439,4873,10312
12382,2020-10-11,3호선,지축,1439,1440,2879
12383,2020-10-11,3호선,구파발,9853,10262,20115
12384,2020-10-11,3호선,연신내,20014,18660,38674
12385,2020-10-11,3호선,불광,8684,10379,19063
12386,2020-10-11,3호선,녹번,5755,5235,10990
12387,2020-10-11,3호선,홍제,7888,7555,15443
12388,2020-10-11,3호선,무악재,1601,1756,3357
12389,2020-10-11,3호선,독립문,3755,4258,8013
12390,2020-10-11,3호선,경복궁,8891,9452,18343
12391,2020-10-11,3호선,안국,7333,8378,15711
12392,2020-10-11,3호선,종로3가,2666,3842,6508
12393,2020-10-11,3호선,을지로3가,2000,2175,4175
12394,2020-10-11,3호선,동대입구,4055,4713,8768
12395,2020-10-11,3호선,약수,5546,5284,10830
12396,2020-10-11,3호선,금호,3750,3649,7399
12397,2020-10-11,3호선,옥수,4227,4603,8830
12398,2020-10-11,3호선,압구정,11215,11669,22884
12399,2020-10-11,3호선,신사,11403,12163,23566
12400,2020-10-11,3호선,잠원,2495,2574,5069
12401,2020-10-11,3호선,고속터미널,33974,31997,65971
12402,2020-10-11,3호선,교대,3301,2061,5362
12403,2020-10-11,3호선,남부터미널,12496,12862,25358
12404,2020-10-11,3호선,양재,10806,12536,23342
12405,2020-10-11,3호선,매봉,3321,3192,6513
12406,2020-10-11,3호선,도곡,1619,1674,3293
12407,2020-10-11,3호선,대치,4852,4256,9108
12408,2020-10-11,3호선,학여울,727,751,1478
12409,2020-10-11,3호선,대청,3401,3295,6696
12410,2020-10-11,3호선,일원,2670,2721,5391
12411,2020-10-11,3호선,수서,8887,8366,17253
12412,2020-10-11,3호선,가락시장,3198,3530,6728
12413,2020-10-11,3호선,경찰병원,2481,2590,5071
12414,2020-10-12,3호선,지축,3246,3207,6453
12415,2020-10-12,3호선,구파발,20986,19740,40726
12416,2020-10-12,3호선,연신내,37613,35086,72699
12417,2020-10-12,3호선,불광,16579,17627,34206
12418,2020-10-12,3호선,녹번,14868,13336,28204
12419,2020-10-12,3호선,홍제,17611,16758,34369
12420,2020-10-12,3호선,무악재,3876,3927,7803
12421,2020-10-12,3호선,독립문,7194,7513,14707
12422,2020-10-12,3호선,경복궁,17598,17594,35192
12423,2020-10-12,3호선,안국,18268,18892,37160
12424,2020-10-12,3호선,종로3가,9455,11083,20538
12425,2020-10-12,3호선,을지로3가,10083,10653,20736
12426,2020-10-12,3호선,충무로,1,0,1
12427,2020-10-12,3호선,동대입구,7115,7604,14719
12428,2020-10-12,3호선,약수,12867,12745,25612
12429,2020-10-12,3호선,금호,8156,7533,15689
12430,2020-10-12,3호선,옥수,8888,9227,18115
12431,2020-10-12,3호선,압구정,29996,32432,62428
12432,2020-10-12,3호선,신사,28300,30296,58596
12433,2020-10-12,3호선,잠원,5272,5215,10487
12434,2020-10-12,3호선,고속터미널,35003,32929,67932
12435,2020-10-12,3호선,교대,14361,9558,23919
12436,2020-10-12,3호선,남부터미널,27770,28894,56664
12437,2020-10-12,3호선,양재,37898,41523,79421
12438,2020-10-12,3호선,매봉,11997,11427,23424
12439,2020-10-12,3호선,도곡,5258,5341,10599
12440,2020-10-12,3호선,대치,10376,10422,20798
12441,2020-10-12,3호선,학여울,1813,1849,3662
12442,2020-10-12,3호선,대청,9853,9061,18914
12443,2020-10-12,3호선,일원,9747,9619,19366
12444,2020-10-12,3호선,수서,16147,16215,32362
12445,2020-10-12,3호선,가락시장,9085,8858,17943
12446,2020-10-12,3호선,경찰병원,7833,7888,15721
12447,2020-10-12,3호선,오금,6268,5598,11866
12448,2020-10-12,3호선,원흥,9272,8808,18080
12449,2020-10-12,3호선,삼송,17679,17032,34711
12450,2020-10-12,3호선,원당,11163,10525,21688
12451,2020-10-12,3호선,화정,16932,17258,34190
12452,2020-10-12,3호선,대곡,1951,1452,3403
12453,2020-10-12,3호선,백석,9821,9864,19685
12454,2020-10-12,3호선,마두,7551,7721,15272
12455,2020-10-12,3호선,정발산,6649,6691,13340
12456,2020-10-12,3호선,주엽,8754,8824,17578
12457,2020-10-12,3호선,대화,13653,10728,24381
12458,2020-10-13,3호선,오금,6301,5773,12074
12459,2020-10-13,3호선,경찰병원,7758,7797,15555
12460,2020-10-13,3호선,가락시장,9347,9207,18554
12461,2020-10-13,3호선,수서,16120,16324,32444
12462,2020-10-13,3호선,일원,10138,9885,20023
12463,2020-10-13,3호선,대청,9904,9078,18982
12464,2020-10-13,3호선,학여울,1928,1950,3878
12465,2020-10-13,3호선,대치,10497,10597,21094
12466,2020-10-13,3호선,도곡,5440,5547,10987
12467,2020-10-13,3호선,매봉,12308,11873,24181
12468,2020-10-13,3호선,양재,39374,42772,82146
12469,2020-10-13,3호선,남부터미널,28397,29413,57810
12470,2020-10-13,3호선,교대,14734,9843,24577
12471,2020-10-13,3호선,고속터미널,35421,34192,69613
12472,2020-10-13,3호선,잠원,5357,5351,10708
12473,2020-10-13,3호선,신사,29459,31649,61108
12474,2020-10-13,3호선,압구정,31656,34022,65678
12475,2020-10-13,3호선,옥수,9227,9430,18657
12476,2020-10-13,3호선,금호,8259,7625,15884
12477,2020-10-13,3호선,약수,13193,12943,26136
12478,2020-10-13,3호선,동대입구,7308,7778,15086
12479,2020-10-13,3호선,충무로,2,0,2
12480,2020-10-13,3호선,을지로3가,10497,10968,21465
12481,2020-10-13,3호선,종로3가,9949,11595,21544
12482,2020-10-13,3호선,안국,19645,20492,40137
12483,2020-10-13,3호선,경복궁,18694,18430,37124
12484,2020-10-13,3호선,독립문,7518,7852,15370
12485,2020-10-13,3호선,무악재,3902,3958,7860
12486,2020-10-13,3호선,홍제,17983,16906,34889
12487,2020-10-13,3호선,녹번,15149,13555,28704
12488,2020-10-13,3호선,불광,16571,17812,34383
12489,2020-10-13,3호선,연신내,38154,35621,73775
12490,2020-10-13,3호선,구파발,21329,20007,41336
12491,2020-10-13,3호선,지축,3363,3308,6671
12492,2020-10-13,3호선,대화,13309,10288,23597
12493,2020-10-13,3호선,주엽,8752,8946,17698
12494,2020-10-13,3호선,정발산,6864,6776,13640
12495,2020-10-13,3호선,마두,7497,7816,15313
12496,2020-10-13,3호선,백석,10022,9973,19995
12497,2020-10-13,3호선,대곡,1939,1504,3443
12498,2020-10-13,3호선,화정,16864,17288,34152
12499,2020-10-13,3호선,원당,11441,10789,22230
12500,2020-10-13,3호선,삼송,18102,17385,35487
12501,2020-10-13,3호선,원흥,9345,8963,18308
12502,2020-10-14,3호선,원흥,9374,8899,18273
12503,2020-10-14,3호선,삼송,17934,17337,35271
12504,2020-10-14,3호선,원당,11259,10705,21964
12505,2020-10-14,3호선,화정,16970,17426,34396
12506,2020-10-14,3호선,대곡,1944,1522,3466
12507,2020-10-14,3호선,백석,9956,9716,19672
12508,2020-10-14,3호선,마두,7671,8023,15694
12509,2020-10-14,3호선,정발산,6911,6966,13877
12510,2020-10-14,3호선,주엽,8889,9017,17906
12511,2020-10-14,3호선,대화,13353,10456,23809
12512,2020-10-14,3호선,오금,6417,5727,12144
12513,2020-10-14,3호선,경찰병원,7715,7753,15468
12514,2020-10-14,3호선,가락시장,9305,9155,18460
12515,2020-10-14,3호선,수서,16776,16639,33415
12516,2020-10-14,3호선,일원,10065,9860,19925
12517,2020-10-14,3호선,대청,10067,9140,19207
12518,2020-10-14,3호선,학여울,2057,2138,4195
12519,2020-10-14,3호선,대치,10321,10434,20755
12520,2020-10-14,3호선,도곡,5405,5458,10863
12521,2020-10-14,3호선,매봉,12270,11944,24214
12522,2020-10-14,3호선,양재,39568,43103,82671
12523,2020-10-14,3호선,남부터미널,28390,29142,57532
12524,2020-10-14,3호선,교대,15280,9970,25250
12525,2020-10-14,3호선,고속터미널,35804,35012,70816
12526,2020-10-14,3호선,잠원,5355,5385,10740
12527,2020-10-14,3호선,신사,29052,31075,60127
12528,2020-10-14,3호선,압구정,31002,33540,64542
12529,2020-10-14,3호선,옥수,9218,9543,18761
12530,2020-10-14,3호선,금호,8242,7625,15867
12531,2020-10-14,3호선,약수,13272,12989,26261
12532,2020-10-14,3호선,동대입구,7328,7937,15265
12533,2020-10-14,3호선,을지로3가,10429,11058,21487
12534,2020-10-14,3호선,종로3가,9889,11621,21510
12535,2020-10-14,3호선,안국,20271,20949,41220
12536,2020-10-14,3호선,경복궁,19246,18886,38132
12537,2020-10-14,3호선,독립문,7377,7763,15140
12538,2020-10-14,3호선,무악재,4017,4034,8051
12539,2020-10-14,3호선,홍제,17884,16926,34810
12540,2020-10-14,3호선,녹번,15137,13719,28856
12541,2020-10-14,3호선,불광,16701,17870,34571
12542,2020-10-14,3호선,연신내,38156,35792,73948
12543,2020-10-14,3호선,구파발,21231,19829,41060
12544,2020-10-14,3호선,지축,3410,3307,6717
12545,2020-10-15,3호선,원흥,9278,8872,18150
12546,2020-10-15,3호선,삼송,18224,17436,35660
12547,2020-10-15,3호선,원당,11367,10598,21965
12548,2020-10-15,3호선,화정,16797,17308,34105
12549,2020-10-15,3호선,대곡,1961,1494,3455
12550,2020-10-15,3호선,백석,9926,9994,19920
12551,2020-10-15,3호선,마두,7618,7851,15469
12552,2020-10-15,3호선,정발산,6828,6902,13730
12553,2020-10-15,3호선,주엽,8703,8879,17582
12554,2020-10-15,3호선,대화,13235,10372,23607
12555,2020-10-15,3호선,충무로,4,0,4
12556,2020-10-15,3호선,지축,3419,3271,6690
12557,2020-10-15,3호선,구파발,21376,20099,41475
12558,2020-10-15,3호선,연신내,38309,35545,73854
12559,2020-10-15,3호선,불광,16792,17973,34765
12560,2020-10-15,3호선,녹번,15026,13470,28496
12561,2020-10-15,3호선,홍제,17859,16793,34652
12562,2020-10-15,3호선,무악재,3920,4000,7920
12563,2020-10-15,3호선,독립문,7420,7656,15076
12564,2020-10-15,3호선,경복궁,19149,18998,38147
12565,2020-10-15,3호선,안국,20119,20782,40901
12566,2020-10-15,3호선,종로3가,9527,11284,20811
12567,2020-10-15,3호선,을지로3가,10244,10854,21098
12568,2020-10-15,3호선,동대입구,7335,7913,15248
12569,2020-10-15,3호선,약수,13086,12732,25818
12570,2020-10-15,3호선,금호,8244,7557,15801
12571,2020-10-15,3호선,옥수,9267,9326,18593
12572,2020-10-15,3호선,압구정,30233,33057,63290
12573,2020-10-15,3호선,신사,28972,31836,60808
12574,2020-10-15,3호선,잠원,5349,5184,10533
12575,2020-10-15,3호선,고속터미널,36847,35650,72497
12576,2020-10-15,3호선,교대,15289,10108,25397
12577,2020-10-15,3호선,남부터미널,28503,29087,57590
12578,2020-10-15,3호선,양재,39680,43385,83065
12579,2020-10-15,3호선,매봉,12091,11755,23846
12580,2020-10-15,3호선,도곡,5289,5489,10778
12581,2020-10-15,3호선,대치,10683,10767,21450
12582,2020-10-15,3호선,학여울,2139,2159,4298
12583,2020-10-15,3호선,대청,10284,9281,19565
12584,2020-10-15,3호선,일원,10076,9936,20012
12585,2020-10-15,3호선,수서,16824,16682,33506
12586,2020-10-15,3호선,가락시장,9367,9412,18779
12587,2020-10-15,3호선,경찰병원,7731,7791,15522
12588,2020-10-15,3호선,오금,6271,5646,11917
12589,2020-10-16,3호선,지축,3457,3253,6710
12590,2020-10-16,3호선,구파발,21577,20257,41834
12591,2020-10-16,3호선,연신내,38858,36540,75398
12592,2020-10-16,3호선,불광,16930,17953,34883
12593,2020-10-16,3호선,녹번,15200,13459,28659
12594,2020-10-16,3호선,홍제,18325,16922,35247
12595,2020-10-16,3호선,무악재,4138,4032,8170
12596,2020-10-16,3호선,독립문,7563,7778,15341
12597,2020-10-16,3호선,경복궁,20070,19791,39861
12598,2020-10-16,3호선,안국,20910,21727,42637
12599,2020-10-16,3호선,종로3가,9899,12494,22393
12600,2020-10-16,3호선,을지로3가,10578,11629,22207
12601,2020-10-16,3호선,동대입구,7413,7780,15193
12602,2020-10-16,3호선,약수,13470,13179,26649
12603,2020-10-16,3호선,금호,8462,7669,16131
12604,2020-10-16,3호선,옥수,9600,9778,19378
12605,2020-10-16,3호선,압구정,32307,35809,68116
12606,2020-10-16,3호선,신사,31219,35163,66382
12607,2020-10-16,3호선,잠원,5514,5376,10890
12608,2020-10-16,3호선,고속터미널,43262,45271,88533
12609,2020-10-16,3호선,교대,15521,10279,25800
12610,2020-10-16,3호선,남부터미널,31496,31788,63284
12611,2020-10-16,3호선,양재,41934,44242,86176
12612,2020-10-16,3호선,매봉,12388,11891,24279
12613,2020-10-16,3호선,도곡,5435,5505,10940
12614,2020-10-16,3호선,대치,11209,11143,22352
12615,2020-10-16,3호선,학여울,2007,2128,4135
12616,2020-10-16,3호선,대청,10501,9411,19912
12617,2020-10-16,3호선,일원,10015,9643,19658
12618,2020-10-16,3호선,수서,18317,18450,36767
12619,2020-10-16,3호선,가락시장,9794,9664,19458
12620,2020-10-16,3호선,경찰병원,7716,7572,15288
12621,2020-10-16,3호선,오금,6520,5755,12275
12622,2020-10-16,3호선,충무로,2,0,2
12623,2020-10-16,3호선,대화,13627,10677,24304
12624,2020-10-16,3호선,주엽,8938,8904,17842
12625,2020-10-16,3호선,정발산,7132,7419,14551
12626,2020-10-16,3호선,마두,7809,8009,15818
12627,2020-10-16,3호선,백석,10144,10265,20409
12628,2020-10-16,3호선,대곡,1912,1506,3418
12629,2020-10-16,3호선,화정,17168,17735,34903
12630,2020-10-16,3호선,원당,11458,10717,22175
12631,2020-10-16,3호선,삼송,18227,17330,35557
12632,2020-10-16,3호선,원흥,9510,8705,18215
12633,2020-10-17,3호선,원흥,6359,6068,12427
12634,2020-10-17,3호선,삼송,13298,12505,25803
12635,2020-10-17,3호선,원당,8305,7699,16004
12636,2020-10-17,3호선,화정,12376,12887,25263
12637,2020-10-17,3호선,대곡,1346,1148,2494
12638,2020-10-17,3호선,백석,7414,7464,14878
12639,2020-10-17,3호선,마두,4980,5040,10020
12640,2020-10-17,3호선,정발산,6010,6338,12348
12641,2020-10-17,3호선,주엽,6150,6085,12235
12642,2020-10-17,3호선,대화,8941,7907,16848
12643,2020-10-17,3호선,오금,3850,3700,7550
12644,2020-10-17,3호선,경찰병원,4224,4122,8346
12645,2020-10-17,3호선,가락시장,6428,6157,12585
12646,2020-10-17,3호선,수서,12337,12651,24988
12647,2020-10-17,3호선,일원,4984,4832,9816
12648,2020-10-17,3호선,대청,5669,5207,10876
12649,2020-10-17,3호선,학여울,1223,1162,2385
12650,2020-10-17,3호선,대치,9059,8069,17128
12651,2020-10-17,3호선,도곡,3514,3546,7060
12652,2020-10-17,3호선,매봉,5966,5608,11574
12653,2020-10-17,3호선,양재,21250,22624,43874
12654,2020-10-17,3호선,남부터미널,20462,20446,40908
12655,2020-10-17,3호선,교대,6830,4266,11096
12656,2020-10-17,3호선,고속터미널,45284,46081,91365
12657,2020-10-17,3호선,잠원,3803,3732,7535
12658,2020-10-17,3호선,신사,24243,25988,50231
12659,2020-10-17,3호선,압구정,23996,25750,49746
12660,2020-10-17,3호선,옥수,7220,7176,14396
12661,2020-10-17,3호선,금호,5977,5412,11389
12662,2020-10-17,3호선,약수,8941,8393,17334
12663,2020-10-17,3호선,동대입구,6162,7226,13388
12664,2020-10-17,3호선,을지로3가,4567,5418,9985
12665,2020-10-17,3호선,종로3가,5151,8380,13531
12666,2020-10-17,3호선,안국,12956,15366,28322
12667,2020-10-17,3호선,경복궁,14747,15268,30015
12668,2020-10-17,3호선,독립문,6357,6881,13238
12669,2020-10-17,3호선,무악재,2699,2908,5607
12670,2020-10-17,3호선,홍제,13381,12426,25807
12671,2020-10-17,3호선,녹번,9969,8336,18305
12672,2020-10-17,3호선,불광,12665,14895,27560
12673,2020-10-17,3호선,연신내,30609,28261,58870
12674,2020-10-17,3호선,구파발,15770,15616,31386
12675,2020-10-17,3호선,지축,2407,2311,4718
12676,2020-10-18,3호선,오금,2750,2697,5447
12677,2020-10-18,3호선,경찰병원,2679,2709,5388
12678,2020-10-18,3호선,가락시장,3888,4170,8058
12679,2020-10-18,3호선,수서,9208,9118,18326
12680,2020-10-18,3호선,일원,2926,3022,5948
12681,2020-10-18,3호선,대청,3801,3595,7396
12682,2020-10-18,3호선,학여울,728,729,1457
12683,2020-10-18,3호선,대치,5671,4926,10597
12684,2020-10-18,3호선,도곡,1799,1874,3673
12685,2020-10-18,3호선,매봉,3648,3599,7247
12686,2020-10-18,3호선,양재,12989,14997,27986
12687,2020-10-18,3호선,남부터미널,13100,13810,26910
12688,2020-10-18,3호선,교대,4043,2453,6496
12689,2020-10-18,3호선,고속터미널,35505,34553,70058
12690,2020-10-18,3호선,잠원,2327,2474,4801
12691,2020-10-18,3호선,신사,13015,13094,26109
12692,2020-10-18,3호선,압구정,12362,13030,25392
12693,2020-10-18,3호선,옥수,4973,5102,10075
12694,2020-10-18,3호선,금호,4109,3852,7961
12695,2020-10-18,3호선,약수,6255,5952,12207
12696,2020-10-18,3호선,동대입구,4824,5604,10428
12697,2020-10-18,3호선,충무로,1,0,1
12698,2020-10-18,3호선,을지로3가,2450,2584,5034
12699,2020-10-18,3호선,종로3가,3154,4330,7484
12700,2020-10-18,3호선,안국,8555,10003,18558
12701,2020-10-18,3호선,경복궁,10085,10415,20500
12702,2020-10-18,3호선,독립문,4248,4886,9134
12703,2020-10-18,3호선,무악재,1731,1994,3725
12704,2020-10-18,3호선,홍제,8921,8354,17275
12705,2020-10-18,3호선,녹번,6355,5644,11999
12706,2020-10-18,3호선,불광,9388,11160,20548
12707,2020-10-18,3호선,연신내,21308,19765,41073
12708,2020-10-18,3호선,구파발,11319,11545,22864
12709,2020-10-18,3호선,지축,1681,1716,3397
12710,2020-10-18,3호선,대화,5934,5377,11311
12711,2020-10-18,3호선,주엽,4096,4086,8182
12712,2020-10-18,3호선,정발산,4553,4533,9086
12713,2020-10-18,3호선,마두,3279,3262,6541
12714,2020-10-18,3호선,백석,5312,5124,10436
12715,2020-10-18,3호선,대곡,1023,907,1930
12716,2020-10-18,3호선,화정,8819,9024,17843
12717,2020-10-18,3호선,원당,5950,5797,11747
12718,2020-10-18,3호선,삼송,9332,9223,18555
12719,2020-10-18,3호선,원흥,4519,4374,8893
12720,2020-10-19,3호선,마두,7696,7862,15558
12721,2020-10-19,3호선,오금,6419,5611,12030
12722,2020-10-19,3호선,경찰병원,8187,8279,16466
12723,2020-10-19,3호선,가락시장,8986,8874,17860
12724,2020-10-19,3호선,수서,16357,16717,33074
12725,2020-10-19,3호선,일원,10084,9975,20059
12726,2020-10-19,3호선,대청,10190,9267,19457
12727,2020-10-19,3호선,학여울,1840,1837,3677
12728,2020-10-19,3호선,대화,13659,10453,24112
12729,2020-10-19,3호선,주엽,9172,9112,18284
12730,2020-10-19,3호선,정발산,6732,6798,13530
12731,2020-10-19,3호선,백석,9833,9905,19738
12732,2020-10-19,3호선,대곡,2020,1571,3591
12733,2020-10-19,3호선,화정,16762,17332,34094
12734,2020-10-19,3호선,원당,11409,10790,22199
12735,2020-10-19,3호선,삼송,18205,17626,35831
12736,2020-10-19,3호선,원흥,9463,9102,18565
12737,2020-10-19,3호선,대치,10740,10806,21546
12738,2020-10-19,3호선,도곡,5588,5670,11258
12739,2020-10-19,3호선,매봉,12226,11671,23897
12740,2020-10-19,3호선,양재,38662,42697,81359
12741,2020-10-19,3호선,남부터미널,28676,29699,58375
12742,2020-10-19,3호선,교대,14598,9845,24443
12743,2020-10-19,3호선,고속터미널,35493,34040,69533
12744,2020-10-19,3호선,잠원,5380,5325,10705
12745,2020-10-19,3호선,신사,28174,30184,58358
12746,2020-10-19,3호선,압구정,30013,32481,62494
12747,2020-10-19,3호선,옥수,8987,9322,18309
12748,2020-10-19,3호선,금호,8125,7572,15697
12749,2020-10-19,3호선,약수,13002,12748,25750
12750,2020-10-19,3호선,동대입구,7407,7863,15270
12751,2020-10-19,3호선,충무로,2,0,2
12752,2020-10-19,3호선,을지로3가,10322,10886,21208
12753,2020-10-19,3호선,종로3가,9669,11495,21164
12754,2020-10-19,3호선,안국,20017,20649,40666
12755,2020-10-19,3호선,경복궁,18146,18115,36261
12756,2020-10-19,3호선,독립문,7317,7677,14994
12757,2020-10-19,3호선,무악재,3915,3911,7826
12758,2020-10-19,3호선,홍제,17722,16853,34575
12759,2020-10-19,3호선,녹번,15100,13640,28740
12760,2020-10-19,3호선,불광,16776,17715,34491
12761,2020-10-19,3호선,연신내,37688,35198,72886
12762,2020-10-19,3호선,구파발,21575,20126,41701
12763,2020-10-19,3호선,지축,3411,3362,6773
12764,2020-10-20,3호선,대화,13743,10714,24457
12765,2020-10-20,3호선,주엽,8920,8902,17822
12766,2020-10-20,3호선,정발산,6890,7041,13931
12767,2020-10-20,3호선,마두,7796,7942,15738
12768,2020-10-20,3호선,백석,10242,10266,20508
12769,2020-10-20,3호선,대곡,1996,1554,3550
12770,2020-10-20,3호선,화정,17266,17895,35161
12771,2020-10-20,3호선,원당,11623,11015,22638
12772,2020-10-20,3호선,삼송,18392,17897,36289
12773,2020-10-20,3호선,원흥,9701,9273,18974
12774,2020-10-20,3호선,지축,3418,3314,6732
12775,2020-10-20,3호선,구파발,22016,20447,42463
12776,2020-10-20,3호선,연신내,38966,36361,75327
12777,2020-10-20,3호선,불광,16845,18054,34899
12778,2020-10-20,3호선,녹번,15437,13942,29379
12779,2020-10-20,3호선,홍제,18360,17387,35747
12780,2020-10-20,3호선,무악재,4064,4136,8200
12781,2020-10-20,3호선,독립문,7478,8002,15480
12782,2020-10-20,3호선,경복궁,18787,18617,37404
12783,2020-10-20,3호선,안국,20731,21916,42647
12784,2020-10-20,3호선,종로3가,9941,11893,21834
12785,2020-10-20,3호선,을지로3가,10435,11208,21643
12786,2020-10-20,3호선,충무로,3,0,3
12787,2020-10-20,3호선,동대입구,7477,7850,15327
12788,2020-10-20,3호선,약수,13268,13106,26374
12789,2020-10-20,3호선,금호,8559,7927,16486
12790,2020-10-20,3호선,옥수,9442,9719,19161
12791,2020-10-20,3호선,압구정,31446,33886,65332
12792,2020-10-20,3호선,신사,29477,31505,60982
12793,2020-10-20,3호선,잠원,5338,5293,10631
12794,2020-10-20,3호선,고속터미널,36226,35291,71517
12795,2020-10-20,3호선,교대,15156,10025,25181
12796,2020-10-20,3호선,남부터미널,29042,30060,59102
12797,2020-10-20,3호선,양재,40383,44007,84390
12798,2020-10-20,3호선,매봉,12638,12278,24916
12799,2020-10-20,3호선,도곡,5500,5409,10909
12800,2020-10-20,3호선,대치,10899,10966,21865
12801,2020-10-20,3호선,학여울,1893,1882,3775
12802,2020-10-20,3호선,대청,10453,9538,19991
12803,2020-10-20,3호선,일원,10335,10064,20399
12804,2020-10-20,3호선,수서,16869,17015,33884
12805,2020-10-20,3호선,가락시장,9366,9229,18595
12806,2020-10-20,3호선,경찰병원,8194,8202,16396
12807,2020-10-20,3호선,오금,6524,5847,12371
12808,2020-10-21,3호선,지축,3358,3230,6588
12809,2020-10-21,3호선,구파발,21544,20183,41727
12810,2020-10-21,3호선,연신내,38416,36145,74561
12811,2020-10-21,3호선,불광,16791,17943,34734
12812,2020-10-21,3호선,녹번,15393,14017,29410
12813,2020-10-21,3호선,홍제,17821,16974,34795
12814,2020-10-21,3호선,무악재,4115,4044,8159
12815,2020-10-21,3호선,독립문,7519,7914,15433
12816,2020-10-21,3호선,경복궁,19581,19428,39009
12817,2020-10-21,3호선,종로3가,9918,11874,21792
12818,2020-10-21,3호선,을지로3가,10380,11077,21457
12819,2020-10-21,3호선,충무로,1,0,1
12820,2020-10-21,3호선,동대입구,7589,7927,15516
12821,2020-10-21,3호선,약수,13326,13255,26581
12822,2020-10-21,3호선,금호,8358,7768,16126
12823,2020-10-21,3호선,옥수,9386,9736,19122
12824,2020-10-21,3호선,압구정,30750,33406,64156
12825,2020-10-21,3호선,신사,28764,31345,60109
12826,2020-10-21,3호선,잠원,5293,5279,10572
12827,2020-10-21,3호선,고속터미널,36714,35690,72404
12828,2020-10-21,3호선,교대,15373,10183,25556
12829,2020-10-21,3호선,남부터미널,29490,30382,59872
12830,2020-10-21,3호선,양재,39677,43406,83083
12831,2020-10-21,3호선,매봉,12588,12082,24670
12832,2020-10-21,3호선,도곡,5681,5593,11274
12833,2020-10-21,3호선,대치,10558,10714,21272
12834,2020-10-21,3호선,학여울,1963,1980,3943
12835,2020-10-21,3호선,대청,10074,9173,19247
12836,2020-10-21,3호선,일원,10109,10064,20173
12837,2020-10-21,3호선,수서,16814,16831,33645
12838,2020-10-21,3호선,가락시장,9419,9316,18735
12839,2020-10-21,3호선,경찰병원,8099,8176,16275
12840,2020-10-21,3호선,오금,6550,5959,12509
12841,2020-10-21,3호선,안국,20875,21666,42541
12842,2020-10-21,3호선,대화,13648,10471,24119
12843,2020-10-21,3호선,주엽,8783,8833,17616
12844,2020-10-21,3호선,정발산,6947,7040,13987
12845,2020-10-21,3호선,마두,7641,7993,15634
12846,2020-10-21,3호선,백석,9928,9889,19817
12847,2020-10-21,3호선,대곡,2046,1538,3584
12848,2020-10-21,3호선,화정,17059,17828,34887
12849,2020-10-21,3호선,원당,11360,10631,21991
12850,2020-10-21,3호선,삼송,18299,17526,35825
12851,2020-10-21,3호선,원흥,9624,9096,18720
12852,2020-10-22,3호선,대화,13888,11008,24896
12853,2020-10-22,3호선,주엽,8909,8782,17691
12854,2020-10-22,3호선,정발산,6837,7113,13950
12855,2020-10-22,3호선,마두,7604,7844,15448
12856,2020-10-22,3호선,백석,9978,10041,20019
12857,2020-10-22,3호선,대곡,1966,1556,3522
12858,2020-10-22,3호선,화정,16882,17419,34301
12859,2020-10-22,3호선,원당,11282,10667,21949
12860,2020-10-22,3호선,삼송,18360,17776,36136
12861,2020-10-22,3호선,원흥,9618,8940,18558
12862,2020-10-22,3호선,지축,3410,3346,6756
12863,2020-10-22,3호선,구파발,21750,20287,42037
12864,2020-10-22,3호선,연신내,38491,36066,74557
12865,2020-10-22,3호선,불광,16715,17875,34590
12866,2020-10-22,3호선,녹번,15344,13779,29123
12867,2020-10-22,3호선,홍제,17977,16844,34821
12868,2020-10-22,3호선,무악재,4009,4110,8119
12869,2020-10-22,3호선,독립문,7317,7650,14967
12870,2020-10-22,3호선,경복궁,19455,19413,38868
12871,2020-10-22,3호선,안국,20677,21785,42462
12872,2020-10-22,3호선,종로3가,9988,11904,21892
12873,2020-10-22,3호선,을지로3가,10489,11311,21800
12874,2020-10-22,3호선,충무로,1,0,1
12875,2020-10-22,3호선,동대입구,7524,7984,15508
12876,2020-10-22,3호선,약수,13255,12982,26237
12877,2020-10-22,3호선,금호,8333,7715,16048
12878,2020-10-22,3호선,옥수,9454,9698,19152
12879,2020-10-22,3호선,압구정,30407,33189,63596
12880,2020-10-22,3호선,신사,29273,31810,61083
12881,2020-10-22,3호선,잠원,5375,5317,10692
12882,2020-10-22,3호선,고속터미널,37828,36761,74589
12883,2020-10-22,3호선,교대,15194,10064,25258
12884,2020-10-22,3호선,남부터미널,29264,30089,59353
12885,2020-10-22,3호선,양재,40238,44051,84289
12886,2020-10-22,3호선,매봉,12498,12090,24588
12887,2020-10-22,3호선,도곡,5534,5653,11187
12888,2020-10-22,3호선,대치,11052,11015,22067
12889,2020-10-22,3호선,학여울,3180,3292,6472
12890,2020-10-22,3호선,대청,10197,9348,19545
12891,2020-10-22,3호선,일원,10211,10074,20285
12892,2020-10-22,3호선,수서,17084,17137,34221
12893,2020-10-22,3호선,가락시장,9446,9302,18748
12894,2020-10-22,3호선,경찰병원,7800,7775,15575
12895,2020-10-22,3호선,오금,6537,5929,12466
12896,2020-10-23,3호선,정발산,7442,8069,15511
12897,2020-10-23,3호선,마두,8107,8119,16226
12898,2020-10-23,3호선,백석,10581,10648,21229
12899,2020-10-23,3호선,대곡,1976,1493,3469
12900,2020-10-23,3호선,화정,17654,18238,35892
12901,2020-10-23,3호선,원당,11812,10947,22759
12902,2020-10-23,3호선,삼송,19258,18362,37620
12903,2020-10-23,3호선,지축,1,0,1
12904,2020-10-23,3호선,원흥,9848,9063,18911
12905,2020-10-23,3호선,주엽,9157,9240,18397
12906,2020-10-23,3호선,지축,3506,3261,6767
12907,2020-10-23,3호선,구파발,22259,20767,43026
12908,2020-10-23,3호선,연신내,39857,37331,77188
12909,2020-10-23,3호선,불광,17520,18339,35859
12910,2020-10-23,3호선,녹번,15688,13770,29458
12911,2020-10-23,3호선,홍제,18323,17296,35619
12912,2020-10-23,3호선,무악재,4053,4027,8080
12913,2020-10-23,3호선,독립문,7797,8164,15961
12914,2020-10-23,3호선,경복궁,21237,20946,42183
12915,2020-10-23,3호선,안국,21593,22741,44334
12916,2020-10-23,3호선,종로3가,10177,12571,22748
12917,2020-10-23,3호선,을지로3가,11099,12097,23196
12918,2020-10-23,3호선,충무로,1,0,1
12919,2020-10-23,3호선,동대입구,7543,8101,15644
12920,2020-10-23,3호선,약수,13901,13497,27398
12921,2020-10-23,3호선,금호,8816,7892,16708
12922,2020-10-23,3호선,옥수,9770,10120,19890
12923,2020-10-23,3호선,압구정,33381,36783,70164
12924,2020-10-23,3호선,신사,32405,36188,68593
12925,2020-10-23,3호선,잠원,5513,5513,11026
12926,2020-10-23,3호선,고속터미널,46257,49049,95306
12927,2020-10-23,3호선,교대,15767,10234,26001
12928,2020-10-23,3호선,남부터미널,32392,32736,65128
12929,2020-10-23,3호선,양재,42378,44536,86914
12930,2020-10-23,3호선,매봉,12831,12193,25024
12931,2020-10-23,3호선,도곡,5355,5535,10890
12932,2020-10-23,3호선,대치,11580,11705,23285
12933,2020-10-23,3호선,학여울,3006,3067,6073
12934,2020-10-23,3호선,대청,10343,9192,19535
12935,2020-10-23,3호선,일원,10393,9931,20324
12936,2020-10-23,3호선,수서,18688,18706,37394
12937,2020-10-23,3호선,가락시장,9913,9796,19709
12938,2020-10-23,3호선,경찰병원,8043,7940,15983
12939,2020-10-23,3호선,오금,6686,5812,12498
12940,2020-10-23,3호선,대화,14261,11247,25508
12941,2020-10-24,3호선,잠원,3794,3827,7621
12942,2020-10-24,3호선,신사,25382,27521,52903
12943,2020-10-24,3호선,압구정,24656,26501,51157
12944,2020-10-24,3호선,옥수,7023,7204,14227
12945,2020-10-24,3호선,금호,6095,5382,11477
12946,2020-10-24,3호선,대화,9268,7993,17261
12947,2020-10-24,3호선,주엽,6249,6275,12524
12948,2020-10-24,3호선,정발산,6169,6611,12780
12949,2020-10-24,3호선,마두,5346,5328,10674
12950,2020-10-24,3호선,백석,8022,7890,15912
12951,2020-10-24,3호선,대곡,1405,1190,2595
12952,2020-10-24,3호선,교대,6996,4244,11240
12953,2020-10-24,3호선,남부터미널,20666,21306,41972
12954,2020-10-24,3호선,양재,21714,23453,45167
12955,2020-10-24,3호선,매봉,6187,5884,12071
12956,2020-10-24,3호선,도곡,3621,3557,7178
12957,2020-10-24,3호선,대치,9263,8158,17421
12958,2020-10-24,3호선,학여울,2653,2980,5633
12959,2020-10-24,3호선,대청,5767,5276,11043
12960,2020-10-24,3호선,일원,5123,4862,9985
12961,2020-10-24,3호선,수서,12863,12899,25762
12962,2020-10-24,3호선,가락시장,6538,6339,12877
12963,2020-10-24,3호선,경찰병원,4028,3825,7853
12964,2020-10-24,3호선,오금,3739,3530,7269
12965,2020-10-24,3호선,화정,12646,13199,25845
12966,2020-10-24,3호선,원당,8272,7757,16029
12967,2020-10-24,3호선,삼송,13621,12902,26523
12968,2020-10-24,3호선,원흥,6617,6086,12703
12969,2020-10-24,3호선,고속터미널,48286,49495,97781
12970,2020-10-24,3호선,약수,9355,8682,18037
12971,2020-10-24,3호선,동대입구,6093,7330,13423
12972,2020-10-24,3호선,충무로,2,0,2
12973,2020-10-24,3호선,을지로3가,4743,5708,10451
12974,2020-10-24,3호선,종로3가,5389,8737,14126
12975,2020-10-24,3호선,안국,13894,16380,30274
12976,2020-10-24,3호선,경복궁,16823,17983,34806
12977,2020-10-24,3호선,독립문,6327,6830,13157
12978,2020-10-24,3호선,무악재,2701,2753,5454
12979,2020-10-24,3호선,홍제,12837,12225,25062
12980,2020-10-24,3호선,녹번,10094,8456,18550
12981,2020-10-24,3호선,불광,13250,15380,28630
12982,2020-10-24,3호선,연신내,30897,28926,59823
12983,2020-10-24,3호선,구파발,16368,16228,32596
12984,2020-10-24,3호선,지축,2416,2296,4712
12985,2020-10-25,3호선,화정,9287,9522,18809
12986,2020-10-25,3호선,원당,6179,5809,11988
12987,2020-10-25,3호선,삼송,9985,9734,19719
12988,2020-10-25,3호선,원흥,4575,4455,9030
12989,2020-10-25,3호선,대화,6591,5849,12440
12990,2020-10-25,3호선,주엽,4355,4316,8671
12991,2020-10-25,3호선,정발산,5002,4869,9871
12992,2020-10-25,3호선,마두,3389,3411,6800
12993,2020-10-25,3호선,백석,5587,5517,11104
12994,2020-10-25,3호선,대곡,1059,911,1970
12995,2020-10-25,3호선,지축,1607,1628,3235
12996,2020-10-25,3호선,구파발,12673,12986,25659
12997,2020-10-25,3호선,연신내,22477,20664,43141
12998,2020-10-25,3호선,불광,9730,11989,21719
12999,2020-10-25,3호선,녹번,6599,5953,12552
13000,2020-10-25,3호선,홍제,9322,8856,18178
13001,2020-10-25,3호선,무악재,1879,2073,3952
13002,2020-10-25,3호선,독립문,4294,5052,9346
13003,2020-10-25,3호선,경복궁,11691,12404,24095
13004,2020-10-25,3호선,안국,9450,10803,20253
13005,2020-10-25,3호선,종로3가,3412,4882,8294
13006,2020-10-25,3호선,을지로3가,2923,2750,5673
13007,2020-10-25,3호선,충무로,1,0,1
13008,2020-10-25,3호선,동대입구,4756,5596,10352
13009,2020-10-25,3호선,약수,6454,6192,12646
13010,2020-10-25,3호선,금호,4155,3970,8125
13011,2020-10-25,3호선,옥수,5079,5348,10427
13012,2020-10-25,3호선,압구정,13531,14129,27660
13013,2020-10-25,3호선,신사,14330,14714,29044
13014,2020-10-25,3호선,잠원,2345,2488,4833
13015,2020-10-25,3호선,고속터미널,37909,37283,75192
13016,2020-10-25,3호선,교대,4179,2532,6711
13017,2020-10-25,3호선,남부터미널,14046,14976,29022
13018,2020-10-25,3호선,양재,13682,15734,29416
13019,2020-10-25,3호선,매봉,4000,3918,7918
13020,2020-10-25,3호선,도곡,2008,2151,4159
13021,2020-10-25,3호선,대치,5730,5101,10831
13022,2020-10-25,3호선,학여울,1794,2054,3848
13023,2020-10-25,3호선,대청,3867,3770,7637
13024,2020-10-25,3호선,일원,3173,3286,6459
13025,2020-10-25,3호선,수서,9571,9613,19184
13026,2020-10-25,3호선,가락시장,3701,3967,7668
13027,2020-10-25,3호선,경찰병원,2626,2688,5314
13028,2020-10-25,3호선,오금,2762,2703,5465
13029,2020-10-26,3호선,대화,13984,10801,24785
13030,2020-10-26,3호선,주엽,8810,8837,17647
13031,2020-10-26,3호선,정발산,6835,6896,13731
13032,2020-10-26,3호선,마두,7554,7932,15486
13033,2020-10-26,3호선,백석,10017,10091,20108
13034,2020-10-26,3호선,대곡,1999,1528,3527
13035,2020-10-26,3호선,화정,16861,17410,34271
13036,2020-10-26,3호선,원당,11559,10916,22475
13037,2020-10-26,3호선,삼송,18198,17528,35726
13038,2020-10-26,3호선,원흥,9460,9076,18536
13039,2020-10-26,3호선,지축,3446,3264,6710
13040,2020-10-26,3호선,구파발,21290,20041,41331
13041,2020-10-26,3호선,연신내,38129,35785,73914
13042,2020-10-26,3호선,불광,16836,17981,34817
13043,2020-10-26,3호선,녹번,15019,13735,28754
13044,2020-10-26,3호선,홍제,17833,16860,34693
13045,2020-10-26,3호선,무악재,3886,4054,7940
13046,2020-10-26,3호선,독립문,7484,7892,15376
13047,2020-10-26,3호선,경복궁,19165,19222,38387
13048,2020-10-26,3호선,안국,19723,20530,40253
13049,2020-10-26,3호선,종로3가,9733,11667,21400
13050,2020-10-26,3호선,을지로3가,10588,11046,21634
13051,2020-10-26,3호선,충무로,1,0,1
13052,2020-10-26,3호선,동대입구,7338,7897,15235
13053,2020-10-26,3호선,약수,12999,12970,25969
13054,2020-10-26,3호선,금호,8335,7715,16050
13055,2020-10-26,3호선,옥수,9316,9520,18836
13056,2020-10-26,3호선,압구정,30978,33582,64560
13057,2020-10-26,3호선,신사,29565,31379,60944
13058,2020-10-26,3호선,잠원,5227,5216,10443
13059,2020-10-26,3호선,고속터미널,37371,36291,73662
13060,2020-10-26,3호선,교대,14755,9851,24606
13061,2020-10-26,3호선,남부터미널,29238,30153,59391
13062,2020-10-26,3호선,양재,39218,43180,82398
13063,2020-10-26,3호선,매봉,12681,12128,24809
13064,2020-10-26,3호선,도곡,5530,5548,11078
13065,2020-10-26,3호선,대치,11114,11011,22125
13066,2020-10-26,3호선,학여울,1796,1811,3607
13067,2020-10-26,3호선,대청,10051,9239,19290
13068,2020-10-26,3호선,일원,10305,10178,20483
13069,2020-10-26,3호선,수서,16897,17041,33938
13070,2020-10-26,3호선,가락시장,9192,9174,18366
13071,2020-10-26,3호선,경찰병원,7760,7816,15576
13072,2020-10-26,3호선,오금,6517,5727,12244
13073,2020-10-27,3호선,오금,6465,5892,12357
13074,2020-10-27,3호선,경찰병원,8023,7999,16022
13075,2020-10-27,3호선,가락시장,9493,9288,18781
13076,2020-10-27,3호선,수서,17023,17125,34148
13077,2020-10-27,3호선,일원,10317,10171,20488
13078,2020-10-27,3호선,대청,10257,9287,19544
13079,2020-10-27,3호선,학여울,1871,1896,3767
13080,2020-10-27,3호선,대치,10901,10877,21778
13081,2020-10-27,3호선,도곡,5527,5622,11149
13082,2020-10-27,3호선,매봉,12795,12386,25181
13083,2020-10-27,3호선,양재,40677,44269,84946
13084,2020-10-27,3호선,남부터미널,29338,30274,59612
13085,2020-10-27,3호선,교대,15006,10022,25028
13086,2020-10-27,3호선,고속터미널,37590,36666,74256
13087,2020-10-27,3호선,잠원,5224,5136,10360
13088,2020-10-27,3호선,신사,30186,32622,62808
13089,2020-10-27,3호선,압구정,31987,34692,66679
13090,2020-10-27,3호선,옥수,9343,9733,19076
13091,2020-10-27,3호선,금호,8625,7895,16520
13092,2020-10-27,3호선,약수,13553,13334,26887
13093,2020-10-27,3호선,동대입구,7581,8356,15937
13094,2020-10-27,3호선,을지로3가,10708,11313,22021
13095,2020-10-27,3호선,종로3가,10173,12099,22272
13096,2020-10-27,3호선,안국,21226,22185,43411
13097,2020-10-27,3호선,경복궁,19403,18971,38374
13098,2020-10-27,3호선,독립문,7629,7815,15444
13099,2020-10-27,3호선,무악재,4067,4077,8144
13100,2020-10-27,3호선,홍제,18186,17072,35258
13101,2020-10-27,3호선,녹번,15270,13991,29261
13102,2020-10-27,3호선,불광,17306,18433,35739
13103,2020-10-27,3호선,연신내,39229,36510,75739
13104,2020-10-27,3호선,구파발,21897,20585,42482
13105,2020-10-27,3호선,지축,3422,3318,6740
13106,2020-10-27,3호선,대화,14037,10769,24806
13107,2020-10-27,3호선,주엽,8914,8896,17810
13108,2020-10-27,3호선,정발산,6986,7043,14029
13109,2020-10-27,3호선,마두,7758,8018,15776
13110,2020-10-27,3호선,백석,10198,10262,20460
13111,2020-10-27,3호선,대곡,1978,1516,3494
13112,2020-10-27,3호선,화정,17023,17560,34583
13113,2020-10-27,3호선,원당,11610,11003,22613
13114,2020-10-27,3호선,삼송,18460,17775,36235
13115,2020-10-27,3호선,원흥,9693,9243,18936
13116,2020-10-28,3호선,오금,6558,5796,12354
13117,2020-10-28,3호선,경찰병원,8002,8034,16036
13118,2020-10-28,3호선,가락시장,9581,9438,19019
13119,2020-10-28,3호선,수서,17054,16991,34045
13120,2020-10-28,3호선,일원,10246,9905,20151
13121,2020-10-28,3호선,대청,10391,9524,19915
13122,2020-10-28,3호선,학여울,1966,1935,3901
13123,2020-10-28,3호선,대치,10806,10867,21673
13124,2020-10-28,3호선,도곡,5580,5638,11218
13125,2020-10-28,3호선,매봉,12688,12255,24943
13126,2020-10-28,3호선,양재,40294,44191,84485
13127,2020-10-28,3호선,남부터미널,29634,30477,60111
13128,2020-10-28,3호선,교대,15481,10171,25652
13129,2020-10-28,3호선,고속터미널,38091,37020,75111
13130,2020-10-28,3호선,잠원,5293,5215,10508
13131,2020-10-28,3호선,신사,30260,32560,62820
13132,2020-10-28,3호선,압구정,31846,34753,66599
13133,2020-10-28,3호선,옥수,9581,9904,19485
13134,2020-10-28,3호선,금호,8515,7843,16358
13135,2020-10-28,3호선,약수,13451,13245,26696
13136,2020-10-28,3호선,동대입구,7779,8439,16218
13137,2020-10-28,3호선,충무로,1,0,1
13138,2020-10-28,3호선,을지로3가,10899,11456,22355
13139,2020-10-28,3호선,종로3가,10209,12258,22467
13140,2020-10-28,3호선,안국,21950,22796,44746
13141,2020-10-28,3호선,경복궁,20688,20615,41303
13142,2020-10-28,3호선,독립문,7437,7814,15251
13143,2020-10-28,3호선,무악재,4103,4146,8249
13144,2020-10-28,3호선,홍제,18250,17312,35562
13145,2020-10-28,3호선,녹번,15661,14120,29781
13146,2020-10-28,3호선,불광,17098,18437,35535
13147,2020-10-28,3호선,연신내,39152,36475,75627
13148,2020-10-28,3호선,구파발,21842,20745,42587
13149,2020-10-28,3호선,지축,3456,3401,6857
13150,2020-10-28,3호선,대화,14341,11319,25660
13151,2020-10-28,3호선,주엽,8957,9082,18039
13152,2020-10-28,3호선,정발산,7190,7207,14397
13153,2020-10-28,3호선,마두,7847,8171,16018
13154,2020-10-28,3호선,백석,10299,10054,20353
13155,2020-10-28,3호선,대곡,1992,1568,3560
13156,2020-10-28,3호선,화정,17206,17789,34995
13157,2020-10-28,3호선,원당,11601,10958,22559
13158,2020-10-28,3호선,삼송,18327,17581,35908
13159,2020-10-28,3호선,원흥,9796,9191,18987
13160,2020-10-29,3호선,주엽,8920,8955,17875
13161,2020-10-29,3호선,대화,14504,11280,25784
13162,2020-10-29,3호선,백석,10200,10177,20377
13163,2020-10-29,3호선,오금,6591,5746,12337
13164,2020-10-29,3호선,경찰병원,7867,7981,15848
13165,2020-10-29,3호선,가락시장,9562,9447,19009
13166,2020-10-29,3호선,수서,17632,17517,35149
13167,2020-10-29,3호선,일원,10256,10131,20387
13168,2020-10-29,3호선,대청,10312,9376,19688
13169,2020-10-29,3호선,학여울,2029,2082,4111
13170,2020-10-29,3호선,대치,11140,11093,22233
13171,2020-10-29,3호선,도곡,5453,5646,11099
13172,2020-10-29,3호선,매봉,12622,12171,24793
13173,2020-10-29,3호선,양재,40356,44606,84962
13174,2020-10-29,3호선,남부터미널,29839,30723,60562
13175,2020-10-29,3호선,교대,15180,10018,25198
13176,2020-10-29,3호선,고속터미널,39220,38084,77304
13177,2020-10-29,3호선,잠원,5174,5141,10315
13178,2020-10-29,3호선,신사,30140,32735,62875
13179,2020-10-29,3호선,압구정,30969,33874,64843
13180,2020-10-29,3호선,옥수,9662,9830,19492
13181,2020-10-29,3호선,금호,8553,7919,16472
13182,2020-10-29,3호선,약수,13815,13426,27241
13183,2020-10-29,3호선,동대입구,7827,8579,16406
13184,2020-10-29,3호선,을지로3가,10674,11572,22246
13185,2020-10-29,3호선,종로3가,10029,12145,22174
13186,2020-10-29,3호선,안국,21323,22537,43860
13187,2020-10-29,3호선,경복궁,20635,20686,41321
13188,2020-10-29,3호선,독립문,7382,7852,15234
13189,2020-10-29,3호선,무악재,4089,4089,8178
13190,2020-10-29,3호선,홍제,18303,17422,35725
13191,2020-10-29,3호선,녹번,15765,13953,29718
13192,2020-10-29,3호선,불광,17171,18440,35611
13193,2020-10-29,3호선,연신내,39351,36387,75738
13194,2020-10-29,3호선,구파발,21740,20650,42390
13195,2020-10-29,3호선,지축,3431,3302,6733
13196,2020-10-29,3호선,마두,7724,7991,15715
13197,2020-10-29,3호선,정발산,7083,7263,14346
13198,2020-10-29,3호선,대곡,1959,1467,3426
13199,2020-10-29,3호선,화정,17002,17556,34558
13200,2020-10-29,3호선,원당,11550,10788,22338
13201,2020-10-29,3호선,삼송,18692,17954,36646
13202,2020-10-29,3호선,원흥,9888,9201,19089
13203,2020-10-30,3호선,정발산,7634,8032,15666
13204,2020-10-30,3호선,주엽,9287,9340,18627
13205,2020-10-30,3호선,대화,15209,11638,26847
13206,2020-10-30,3호선,지축,3523,3305,6828
13207,2020-10-30,3호선,구파발,21888,20434,42322
13208,2020-10-30,3호선,연신내,40441,37489,77930
13209,2020-10-30,3호선,불광,17642,18547,36189
13210,2020-10-30,3호선,녹번,15946,13871,29817
13211,2020-10-30,3호선,홍제,18847,17564,36411
13212,2020-10-30,3호선,무악재,4213,4165,8378
13213,2020-10-30,3호선,독립문,7935,8199,16134
13214,2020-10-30,3호선,경복궁,21626,21432,43058
13215,2020-10-30,3호선,안국,22055,23249,45304
13216,2020-10-30,3호선,종로3가,10167,12893,23060
13217,2020-10-30,3호선,을지로3가,11064,12141,23205
13218,2020-10-30,3호선,동대입구,8022,8753,16775
13219,2020-10-30,3호선,약수,14220,13845,28065
13220,2020-10-30,3호선,금호,8807,7985,16792
13221,2020-10-30,3호선,옥수,10001,10162,20163
13222,2020-10-30,3호선,압구정,32958,36366,69324
13223,2020-10-30,3호선,신사,33241,37514,70755
13224,2020-10-30,3호선,잠원,5498,5419,10917
13225,2020-10-30,3호선,고속터미널,46781,49832,96613
13226,2020-10-30,3호선,교대,15662,10310,25972
13227,2020-10-30,3호선,남부터미널,32839,33285,66124
13228,2020-10-30,3호선,양재,42694,45116,87810
13229,2020-10-30,3호선,매봉,12682,12214,24896
13230,2020-10-30,3호선,도곡,5571,5610,11181
13231,2020-10-30,3호선,대치,11882,11881,23763
13232,2020-10-30,3호선,학여울,3139,3278,6417
13233,2020-10-30,3호선,대청,10356,9420,19776
13234,2020-10-30,3호선,일원,10184,9770,19954
13235,2020-10-30,3호선,수서,18954,18983,37937
13236,2020-10-30,3호선,가락시장,10109,10051,20160
13237,2020-10-30,3호선,경찰병원,7853,7766,15619
13238,2020-10-30,3호선,오금,6702,5808,12510
13239,2020-10-30,3호선,원흥,9909,9236,19145
13240,2020-10-30,3호선,삼송,19217,18364,37581
13241,2020-10-30,3호선,원당,11938,11011,22949
13242,2020-10-30,3호선,화정,17670,18272,35942
13243,2020-10-30,3호선,대곡,2072,1528,3600
13244,2020-10-30,3호선,백석,10575,10456,21031
13245,2020-10-30,3호선,마두,8028,8317,16345
13246,2020-10-31,3호선,백석,7866,8012,15878
13247,2020-10-31,3호선,대곡,1550,1257,2807
13248,2020-10-31,3호선,화정,12723,13169,25892
13249,2020-10-31,3호선,원당,8833,7964,16797
13250,2020-10-31,3호선,삼송,13839,13042,26881
13251,2020-10-31,3호선,원흥,6751,6173,12924
13252,2020-10-31,3호선,주엽,6558,6523,13081
13253,2020-10-31,3호선,대화,9590,8365,17955
13254,2020-10-31,3호선,정발산,6701,7246,13947
13255,2020-10-31,3호선,오금,3843,3617,7460
13256,2020-10-31,3호선,경찰병원,4084,3762,7846
13257,2020-10-31,3호선,가락시장,6692,6552,13244
13258,2020-10-31,3호선,수서,13591,13293,26884
13259,2020-10-31,3호선,일원,4867,4763,9630
13260,2020-10-31,3호선,대청,6035,5492,11527
13261,2020-10-31,3호선,학여울,2128,2240,4368
13262,2020-10-31,3호선,대치,9697,8621,18318
13263,2020-10-31,3호선,도곡,3931,4017,7948
13264,2020-10-31,3호선,매봉,6208,5924,12132
13265,2020-10-31,3호선,양재,21791,23697,45488
13266,2020-10-31,3호선,남부터미널,21719,21699,43418
13267,2020-10-31,3호선,교대,6932,4388,11320
13268,2020-10-31,3호선,고속터미널,48233,49823,98056
13269,2020-10-31,3호선,잠원,3749,3728,7477
13270,2020-10-31,3호선,신사,25942,28465,54407
13271,2020-10-31,3호선,압구정,24942,26894,51836
13272,2020-10-31,3호선,옥수,7568,7616,15184
13273,2020-10-31,3호선,금호,6296,5569,11865
13274,2020-10-31,3호선,마두,5438,5321,10759
13275,2020-10-31,3호선,약수,9575,8908,18483
13276,2020-10-31,3호선,동대입구,7193,8639,15832
13277,2020-10-31,3호선,충무로,1,0,1
13278,2020-10-31,3호선,을지로3가,4932,5980,10912
13279,2020-10-31,3호선,종로3가,5562,8893,14455
13280,2020-10-31,3호선,안국,15022,18164,33186
13281,2020-10-31,3호선,경복궁,17641,19055,36696
13282,2020-10-31,3호선,독립문,6263,6948,13211
13283,2020-10-31,3호선,무악재,2732,2754,5486
13284,2020-10-31,3호선,홍제,13690,12580,26270
13285,2020-10-31,3호선,녹번,10490,8854,19344
13286,2020-10-31,3호선,불광,13483,15502,28985
13287,2020-10-31,3호선,연신내,31780,29426,61206
13288,2020-10-31,3호선,구파발,16657,16656,33313
13289,2020-10-31,3호선,지축,2491,2430,4921
13290,2020-11-01,3호선,대화,6365,5428,11793
13291,2020-11-01,3호선,주엽,3833,3821,7654
13292,2020-11-01,3호선,정발산,4293,4338,8631
13293,2020-11-01,3호선,마두,3145,3046,6191
13294,2020-11-01,3호선,백석,5166,5153,10319
13295,2020-11-01,3호선,대곡,981,801,1782
13296,2020-11-01,3호선,화정,8015,8308,16323
13297,2020-11-01,3호선,원당,5496,5217,10713
13298,2020-11-01,3호선,삼송,9069,8895,17964
13299,2020-11-01,3호선,원흥,4134,3914,8048
13300,2020-11-01,3호선,오금,2524,2497,5021
13301,2020-11-01,3호선,경찰병원,2622,2645,5267
13302,2020-11-01,3호선,가락시장,3499,3973,7472
13303,2020-11-01,3호선,수서,9596,9505,19101
13304,2020-11-01,3호선,일원,2832,3168,6000
13305,2020-11-01,3호선,대청,3747,3554,7301
13306,2020-11-01,3호선,학여울,1581,1714,3295
13307,2020-11-01,3호선,대치,5787,5081,10868
13308,2020-11-01,3호선,도곡,1886,1998,3884
13309,2020-11-01,3호선,매봉,3570,3544,7114
13310,2020-11-01,3호선,양재,13448,15471,28919
13311,2020-11-01,3호선,남부터미널,14104,15032,29136
13312,2020-11-01,3호선,교대,4062,2379,6441
13313,2020-11-01,3호선,고속터미널,37965,37460,75425
13314,2020-11-01,3호선,잠원,1978,2017,3995
13315,2020-11-01,3호선,신사,13264,13623,26887
13316,2020-11-01,3호선,압구정,12339,13012,25351
13317,2020-11-01,3호선,옥수,4376,4727,9103
13318,2020-11-01,3호선,금호,3917,3765,7682
13319,2020-11-01,3호선,약수,6189,6034,12223
13320,2020-11-01,3호선,동대입구,6286,6475,12761
13321,2020-11-01,3호선,충무로,1,0,1
13322,2020-11-01,3호선,을지로3가,2683,2595,5278
13323,2020-11-01,3호선,종로3가,3419,4576,7995
13324,2020-11-01,3호선,안국,7641,8721,16362
13325,2020-11-01,3호선,경복궁,9189,9394,18583
13326,2020-11-01,3호선,독립문,3657,3995,7652
13327,2020-11-01,3호선,무악재,1671,1758,3429
13328,2020-11-01,3호선,홍제,8064,7710,15774
13329,2020-11-01,3호선,녹번,6036,5533,11569
13330,2020-11-01,3호선,불광,8180,9371,17551
13331,2020-11-01,3호선,연신내,19076,18194,37270
13332,2020-11-01,3호선,구파발,9688,9959,19647
13333,2020-11-01,3호선,지축,1470,1392,2862
13334,2020-11-02,3호선,지축,3388,3313,6701
13335,2020-11-02,3호선,구파발,21412,20119,41531
13336,2020-11-02,3호선,연신내,38751,35950,74701
13337,2020-11-02,3호선,불광,17051,18023,35074
13338,2020-11-02,3호선,녹번,15248,13877,29125
13339,2020-11-02,3호선,홍제,18009,17337,35346
13340,2020-11-02,3호선,무악재,4078,4076,8154
13341,2020-11-02,3호선,독립문,7302,7749,15051
13342,2020-11-02,3호선,경복궁,19675,19687,39362
13343,2020-11-02,3호선,안국,20461,21160,41621
13344,2020-11-02,3호선,종로3가,9858,11567,21425
13345,2020-11-02,3호선,을지로3가,10564,11097,21661
13346,2020-11-02,3호선,동대입구,7427,8033,15460
13347,2020-11-02,3호선,약수,13312,13198,26510
13348,2020-11-02,3호선,금호,8430,7736,16166
13349,2020-11-02,3호선,옥수,9143,9487,18630
13350,2020-11-02,3호선,압구정,30411,32587,62998
13351,2020-11-02,3호선,신사,29606,31803,61409
13352,2020-11-02,3호선,잠원,5156,5093,10249
13353,2020-11-02,3호선,고속터미널,38183,36597,74780
13354,2020-11-02,3호선,교대,14483,9742,24225
13355,2020-11-02,3호선,남부터미널,29503,30416,59919
13356,2020-11-02,3호선,양재,38985,43227,82212
13357,2020-11-02,3호선,매봉,12714,12236,24950
13358,2020-11-02,3호선,도곡,5677,5722,11399
13359,2020-11-02,3호선,대치,11116,11141,22257
13360,2020-11-02,3호선,학여울,1788,1807,3595
13361,2020-11-02,3호선,대청,10228,9260,19488
13362,2020-11-02,3호선,일원,10284,10291,20575
13363,2020-11-02,3호선,수서,16899,17114,34013
13364,2020-11-02,3호선,가락시장,9315,9157,18472
13365,2020-11-02,3호선,경찰병원,7850,7964,15814
13366,2020-11-02,3호선,오금,6501,5780,12281
13367,2020-11-02,3호선,원흥,9508,8984,18492
13368,2020-11-02,3호선,삼송,18359,17701,36060
13369,2020-11-02,3호선,원당,11546,10847,22393
13370,2020-11-02,3호선,화정,16957,17377,34334
13371,2020-11-02,3호선,대곡,1911,1500,3411
13372,2020-11-02,3호선,백석,10111,10115,20226
13373,2020-11-02,3호선,마두,7740,7960,15700
13374,2020-11-02,3호선,정발산,6923,6889,13812
13375,2020-11-02,3호선,주엽,8940,8992,17932
13376,2020-11-02,3호선,대화,13858,10678,24536
13377,2020-11-03,3호선,지축,3304,3248,6552
13378,2020-11-03,3호선,구파발,21809,20465,42274
13379,2020-11-03,3호선,연신내,38713,36351,75064
13380,2020-11-03,3호선,불광,16837,18072,34909
13381,2020-11-03,3호선,녹번,15493,14116,29609
13382,2020-11-03,3호선,홍제,18230,17341,35571
13383,2020-11-03,3호선,무악재,3979,4123,8102
13384,2020-11-03,3호선,독립문,7452,7985,15437
13385,2020-11-03,3호선,경복궁,19844,19891,39735
13386,2020-11-03,3호선,안국,22543,23270,45813
13387,2020-11-03,3호선,종로3가,10325,11887,22212
13388,2020-11-03,3호선,을지로3가,10793,11281,22074
13389,2020-11-03,3호선,충무로,1,0,1
13390,2020-11-03,3호선,동대입구,7889,8550,16439
13391,2020-11-03,3호선,약수,13453,13252,26705
13392,2020-11-03,3호선,금호,8470,7958,16428
13393,2020-11-03,3호선,옥수,9382,9652,19034
13394,2020-11-03,3호선,압구정,31137,33432,64569
13395,2020-11-03,3호선,신사,30493,32471,62964
13396,2020-11-03,3호선,잠원,5181,5103,10284
13397,2020-11-03,3호선,고속터미널,37716,36743,74459
13398,2020-11-03,3호선,교대,14800,9852,24652
13399,2020-11-03,3호선,남부터미널,29311,30034,59345
13400,2020-11-03,3호선,양재,40681,44079,84760
13401,2020-11-03,3호선,매봉,12790,12266,25056
13402,2020-11-03,3호선,도곡,5569,5647,11216
13403,2020-11-03,3호선,대치,10936,10909,21845
13404,2020-11-03,3호선,학여울,1887,1868,3755
13405,2020-11-03,3호선,대청,10210,9407,19617
13406,2020-11-03,3호선,일원,10220,10173,20393
13407,2020-11-03,3호선,수서,16974,17173,34147
13408,2020-11-03,3호선,가락시장,9385,9223,18608
13409,2020-11-03,3호선,경찰병원,7895,7858,15753
13410,2020-11-03,3호선,오금,6451,5716,12167
13411,2020-11-03,3호선,원흥,9583,9123,18706
13412,2020-11-03,3호선,삼송,18460,17899,36359
13413,2020-11-03,3호선,원당,11592,10964,22556
13414,2020-11-03,3호선,화정,16935,17596,34531
13415,2020-11-03,3호선,대곡,1893,1479,3372
13416,2020-11-03,3호선,백석,10056,10067,20123
13417,2020-11-03,3호선,마두,7685,7940,15625
13418,2020-11-03,3호선,정발산,6807,6819,13626
13419,2020-11-03,3호선,주엽,8821,8871,17692
13420,2020-11-03,3호선,대화,13703,10600,24303
13421,2020-11-04,3호선,지축,3316,3270,6586
13422,2020-11-04,3호선,구파발,21367,20160,41527
13423,2020-11-04,3호선,연신내,38471,36136,74607
13424,2020-11-04,3호선,불광,17181,18430,35611
13425,2020-11-04,3호선,녹번,15418,13924,29342
13426,2020-11-04,3호선,홍제,18174,17290,35464
13427,2020-11-04,3호선,무악재,4104,4086,8190
13428,2020-11-04,3호선,독립문,7322,7833,15155
13429,2020-11-04,3호선,경복궁,20590,20483,41073
13430,2020-11-04,3호선,안국,21873,22865,44738
13431,2020-11-04,3호선,종로3가,10155,11962,22117
13432,2020-11-04,3호선,을지로3가,10897,11368,22265
13433,2020-11-04,3호선,충무로,1,0,1
13434,2020-11-04,3호선,동대입구,7837,8429,16266
13435,2020-11-04,3호선,약수,13375,13253,26628
13436,2020-11-04,3호선,금호,8538,7824,16362
13437,2020-11-04,3호선,옥수,9245,9565,18810
13438,2020-11-04,3호선,압구정,30630,32986,63616
13439,2020-11-04,3호선,신사,30149,32462,62611
13440,2020-11-04,3호선,잠원,5208,5068,10276
13441,2020-11-04,3호선,고속터미널,37761,36445,74206
13442,2020-11-04,3호선,교대,14823,9947,24770
13443,2020-11-04,3호선,남부터미널,30329,31199,61528
13444,2020-11-04,3호선,양재,40174,43526,83700
13445,2020-11-04,3호선,매봉,12669,12176,24845
13446,2020-11-04,3호선,도곡,5469,5558,11027
13447,2020-11-04,3호선,대치,10922,11081,22003
13448,2020-11-04,3호선,학여울,1900,1929,3829
13449,2020-11-04,3호선,대청,10363,9339,19702
13450,2020-11-04,3호선,일원,10295,10260,20555
13451,2020-11-04,3호선,수서,17129,17111,34240
13452,2020-11-04,3호선,가락시장,9438,9309,18747
13453,2020-11-04,3호선,경찰병원,7913,7924,15837
13454,2020-11-04,3호선,오금,6538,5923,12461
13455,2020-11-04,3호선,원흥,9673,9208,18881
13456,2020-11-04,3호선,삼송,18291,17696,35987
13457,2020-11-04,3호선,원당,11575,10876,22451
13458,2020-11-04,3호선,화정,17021,17498,34519
13459,2020-11-04,3호선,대곡,1888,1484,3372
13460,2020-11-04,3호선,백석,10118,10037,20155
13461,2020-11-04,3호선,마두,7892,8295,16187
13462,2020-11-04,3호선,정발산,6995,7085,14080
13463,2020-11-04,3호선,주엽,8907,8823,17730
13464,2020-11-04,3호선,대화,13704,10644,24348
13465,2020-11-05,3호선,지축,3560,3387,6947
13466,2020-11-05,3호선,구파발,21379,20371,41750
13467,2020-11-05,3호선,연신내,39142,36243,75385
13468,2020-11-05,3호선,불광,17072,18211,35283
13469,2020-11-05,3호선,녹번,15576,14070,29646
13470,2020-11-05,3호선,홍제,18316,17135,35451
13471,2020-11-05,3호선,무악재,4169,4171,8340
13472,2020-11-05,3호선,독립문,7438,7941,15379
13473,2020-11-05,3호선,경복궁,20853,21133,41986
13474,2020-11-05,3호선,안국,21921,23314,45235
13475,2020-11-05,3호선,종로3가,10149,12142,22291
13476,2020-11-05,3호선,을지로3가,10666,11373,22039
13477,2020-11-05,3호선,충무로,2,0,2
13478,2020-11-05,3호선,동대입구,7771,8583,16354
13479,2020-11-05,3호선,약수,13646,13320,26966
13480,2020-11-05,3호선,금호,8625,7826,16451
13481,2020-11-05,3호선,옥수,9614,9790,19404
13482,2020-11-05,3호선,압구정,30509,33137,63646
13483,2020-11-05,3호선,신사,30054,32657,62711
13484,2020-11-05,3호선,잠원,5210,5015,10225
13485,2020-11-05,3호선,고속터미널,39180,37692,76872
13486,2020-11-05,3호선,교대,15551,10177,25728
13487,2020-11-05,3호선,남부터미널,29764,30170,59934
13488,2020-11-05,3호선,양재,40289,44123,84412
13489,2020-11-05,3호선,매봉,12721,12188,24909
13490,2020-11-05,3호선,도곡,5557,5693,11250
13491,2020-11-05,3호선,대치,11138,11054,22192
13492,2020-11-05,3호선,학여울,2708,2981,5689
13493,2020-11-05,3호선,대청,10360,9395,19755
13494,2020-11-05,3호선,일원,10391,10112,20503
13495,2020-11-05,3호선,수서,17254,17610,34864
13496,2020-11-05,3호선,가락시장,9703,9622,19325
13497,2020-11-05,3호선,경찰병원,7905,7933,15838
13498,2020-11-05,3호선,오금,6568,5836,12404
13499,2020-11-05,3호선,원흥,9764,9162,18926
13500,2020-11-05,3호선,삼송,18705,17811,36516
13501,2020-11-05,3호선,원당,11805,10983,22788
13502,2020-11-05,3호선,화정,17078,17536,34614
13503,2020-11-05,3호선,대곡,1998,1489,3487
13504,2020-11-05,3호선,백석,10127,10198,20325
13505,2020-11-05,3호선,마두,7737,8087,15824
13506,2020-11-05,3호선,정발산,7088,7155,14243
13507,2020-11-05,3호선,주엽,9083,9054,18137
13508,2020-11-05,3호선,대화,14736,11485,26221
13509,2020-11-06,3호선,대화,15034,11634,26668
13510,2020-11-06,3호선,주엽,9209,9289,18498
13511,2020-11-06,3호선,정발산,7405,7871,15276
13512,2020-11-06,3호선,마두,7922,8315,16237
13513,2020-11-06,3호선,백석,10426,10396,20822
13514,2020-11-06,3호선,대곡,1948,1610,3558
13515,2020-11-06,3호선,화정,17433,17804,35237
13516,2020-11-06,3호선,원당,12008,11015,23023
13517,2020-11-06,3호선,삼송,18923,17987,36910
13518,2020-11-06,3호선,지축,1,0,1
13519,2020-11-06,3호선,원흥,9878,9045,18923
13520,2020-11-06,3호선,오금,6585,5775,12360
13521,2020-11-06,3호선,경찰병원,7835,7796,15631
13522,2020-11-06,3호선,가락시장,9973,10031,20004
13523,2020-11-06,3호선,수서,18988,18931,37919
13524,2020-11-06,3호선,일원,10363,9716,20079
13525,2020-11-06,3호선,대청,10388,9474,19862
13526,2020-11-06,3호선,학여울,2779,2860,5639
13527,2020-11-06,3호선,대치,11451,11680,23131
13528,2020-11-06,3호선,도곡,5493,5539,11032
13529,2020-11-06,3호선,매봉,12497,12015,24512
13530,2020-11-06,3호선,양재,42345,44408,86753
13531,2020-11-06,3호선,남부터미널,32847,33388,66235
13532,2020-11-06,3호선,교대,15521,10235,25756
13533,2020-11-06,3호선,고속터미널,45932,49174,95106
13534,2020-11-06,3호선,잠원,5440,5171,10611
13535,2020-11-06,3호선,신사,32131,36164,68295
13536,2020-11-06,3호선,압구정,32679,35820,68499
13537,2020-11-06,3호선,옥수,9689,9829,19518
13538,2020-11-06,3호선,금호,8852,8040,16892
13539,2020-11-06,3호선,약수,14001,13701,27702
13540,2020-11-06,3호선,동대입구,7824,8449,16273
13541,2020-11-06,3호선,충무로,1,0,1
13542,2020-11-06,3호선,을지로3가,10925,11790,22715
13543,2020-11-06,3호선,종로3가,10006,12650,22656
13544,2020-11-06,3호선,안국,22046,23286,45332
13545,2020-11-06,3호선,경복궁,21262,21203,42465
13546,2020-11-06,3호선,독립문,7476,8027,15503
13547,2020-11-06,3호선,무악재,4201,4061,8262
13548,2020-11-06,3호선,홍제,18726,17324,36050
13549,2020-11-06,3호선,녹번,15659,13684,29343
13550,2020-11-06,3호선,불광,17225,18292,35517
13551,2020-11-06,3호선,연신내,39739,36982,76721
13552,2020-11-06,3호선,구파발,21512,20152,41664
13553,2020-11-06,3호선,지축,3452,3181,6633
13554,2020-11-07,3호선,주엽,6414,6257,12671
13555,2020-11-07,3호선,대화,10194,8937,19131
13556,2020-11-07,3호선,원흥,6610,6075,12685
13557,2020-11-07,3호선,삼송,13695,12997,26692
13558,2020-11-07,3호선,원당,8549,7971,16520
13559,2020-11-07,3호선,화정,12964,13556,26520
13560,2020-11-07,3호선,대곡,1408,1222,2630
13561,2020-11-07,3호선,백석,7846,7952,15798
13562,2020-11-07,3호선,마두,5047,5157,10204
13563,2020-11-07,3호선,정발산,6157,6745,12902
13564,2020-11-07,3호선,지축,2440,2338,4778
13565,2020-11-07,3호선,구파발,15726,15286,31012
13566,2020-11-07,3호선,연신내,30548,28358,58906
13567,2020-11-07,3호선,불광,13068,14927,27995
13568,2020-11-07,3호선,녹번,10055,8734,18789
13569,2020-11-07,3호선,홍제,13296,12242,25538
13570,2020-11-07,3호선,무악재,2712,2734,5446
13571,2020-11-07,3호선,독립문,6108,6604,12712
13572,2020-11-07,3호선,경복궁,17390,19472,36862
13573,2020-11-07,3호선,안국,15143,17852,32995
13574,2020-11-07,3호선,종로3가,5835,9218,15053
13575,2020-11-07,3호선,을지로3가,4885,5777,10662
13576,2020-11-07,3호선,충무로,1,0,1
13577,2020-11-07,3호선,동대입구,7463,8644,16107
13578,2020-11-07,3호선,약수,9466,8797,18263
13579,2020-11-07,3호선,금호,6248,5468,11716
13580,2020-11-07,3호선,옥수,7267,7076,14343
13581,2020-11-07,3호선,압구정,24081,25681,49762
13582,2020-11-07,3호선,신사,25888,28395,54283
13583,2020-11-07,3호선,잠원,4031,3856,7887
13584,2020-11-07,3호선,고속터미널,48682,50369,99051
13585,2020-11-07,3호선,교대,7315,4497,11812
13586,2020-11-07,3호선,남부터미널,22599,22735,45334
13587,2020-11-07,3호선,양재,22191,23786,45977
13588,2020-11-07,3호선,매봉,6023,5658,11681
13589,2020-11-07,3호선,도곡,4258,4550,8808
13590,2020-11-07,3호선,대치,9596,8495,18091
13591,2020-11-07,3호선,학여울,2010,2166,4176
13592,2020-11-07,3호선,대청,6039,5419,11458
13593,2020-11-07,3호선,일원,4857,4574,9431
13594,2020-11-07,3호선,수서,13349,13342,26691
13595,2020-11-07,3호선,가락시장,6705,6450,13155
13596,2020-11-07,3호선,경찰병원,4318,4020,8338
13597,2020-11-07,3호선,오금,3956,3747,7703
13598,2020-11-08,3호선,원흥,4764,4443,9207
13599,2020-11-08,3호선,삼송,10017,9963,19980
13600,2020-11-08,3호선,원당,6148,5825,11973
13601,2020-11-08,3호선,화정,9083,9467,18550
13602,2020-11-08,3호선,대곡,1055,846,1901
13603,2020-11-08,3호선,백석,5822,5699,11521
13604,2020-11-08,3호선,마두,3491,3429,6920
13605,2020-11-08,3호선,정발산,4939,5040,9979
13606,2020-11-08,3호선,주엽,4490,4396,8886
13607,2020-11-08,3호선,대화,7564,6990,14554
13608,2020-11-08,3호선,지축,1676,1635,3311
13609,2020-11-08,3호선,구파발,11791,12127,23918
13610,2020-11-08,3호선,연신내,22224,20768,42992
13611,2020-11-08,3호선,불광,9971,11952,21923
13612,2020-11-08,3호선,녹번,6992,6320,13312
13613,2020-11-08,3호선,홍제,9119,8927,18046
13614,2020-11-08,3호선,무악재,1949,2103,4052
13615,2020-11-08,3호선,독립문,4482,5420,9902
13616,2020-11-08,3호선,경복궁,13895,14966,28861
13617,2020-11-08,3호선,안국,11478,12619,24097
13618,2020-11-08,3호선,종로3가,3889,5479,9368
13619,2020-11-08,3호선,을지로3가,2995,2955,5950
13620,2020-11-08,3호선,동대입구,5707,6696,12403
13621,2020-11-08,3호선,약수,6691,6594,13285
13622,2020-11-08,3호선,금호,4343,4124,8467
13623,2020-11-08,3호선,옥수,4847,5251,10098
13624,2020-11-08,3호선,압구정,13010,13408,26418
13625,2020-11-08,3호선,신사,15045,15401,30446
13626,2020-11-08,3호선,잠원,2355,2359,4714
13627,2020-11-08,3호선,고속터미널,40613,39379,79992
13628,2020-11-08,3호선,교대,4427,2622,7049
13629,2020-11-08,3호선,남부터미널,15826,16409,32235
13630,2020-11-08,3호선,양재,14208,16215,30423
13631,2020-11-08,3호선,매봉,4079,4047,8126
13632,2020-11-08,3호선,도곡,1955,2202,4157
13633,2020-11-08,3호선,대치,6172,5449,11621
13634,2020-11-08,3호선,학여울,925,927,1852
13635,2020-11-08,3호선,대청,4065,3936,8001
13636,2020-11-08,3호선,일원,3278,3470,6748
13637,2020-11-08,3호선,수서,9942,9834,19776
13638,2020-11-08,3호선,가락시장,3962,4153,8115
13639,2020-11-08,3호선,경찰병원,2851,2897,5748
13640,2020-11-08,3호선,오금,2721,2760,5481
13641,2020-11-09,3호선,대화,13901,10419,24320
13642,2020-11-09,3호선,주엽,8930,8888,17818
13643,2020-11-09,3호선,정발산,6279,6376,12655
13644,2020-11-09,3호선,마두,7708,7941,15649
13645,2020-11-09,3호선,백석,9959,9932,19891
13646,2020-11-09,3호선,대곡,1897,1456,3353
13647,2020-11-09,3호선,화정,16939,17285,34224
13648,2020-11-09,3호선,원당,11279,10644,21923
13649,2020-11-09,3호선,삼송,18118,17576,35694
13650,2020-11-09,3호선,원흥,9533,9018,18551
13651,2020-11-09,3호선,지축,3283,3212,6495
13652,2020-11-09,3호선,구파발,21163,19882,41045
13653,2020-11-09,3호선,연신내,38085,35622,73707
13654,2020-11-09,3호선,불광,16816,17757,34573
13655,2020-11-09,3호선,녹번,15036,13893,28929
13656,2020-11-09,3호선,홍제,17946,17233,35179
13657,2020-11-09,3호선,무악재,4017,4078,8095
13658,2020-11-09,3호선,독립문,7210,7678,14888
13659,2020-11-09,3호선,경복궁,19415,19712,39127
13660,2020-11-09,3호선,안국,20334,21055,41389
13661,2020-11-09,3호선,종로3가,9825,11681,21506
13662,2020-11-09,3호선,을지로3가,10634,10992,21626
13663,2020-11-09,3호선,동대입구,7409,8099,15508
13664,2020-11-09,3호선,약수,13257,13118,26375
13665,2020-11-09,3호선,금호,8379,7676,16055
13666,2020-11-09,3호선,옥수,9009,9432,18441
13667,2020-11-09,3호선,압구정,30508,32712,63220
13668,2020-11-09,3호선,신사,29523,31431,60954
13669,2020-11-09,3호선,잠원,4999,4935,9934
13670,2020-11-09,3호선,고속터미널,39065,37065,76130
13671,2020-11-09,3호선,교대,14606,9750,24356
13672,2020-11-09,3호선,남부터미널,29363,30435,59798
13673,2020-11-09,3호선,양재,39614,43447,83061
13674,2020-11-09,3호선,매봉,12527,12170,24697
13675,2020-11-09,3호선,도곡,5743,5795,11538
13676,2020-11-09,3호선,대치,10994,11090,22084
13677,2020-11-09,3호선,학여울,2515,2519,5034
13678,2020-11-09,3호선,대청,10186,9269,19455
13679,2020-11-09,3호선,일원,10386,10329,20715
13680,2020-11-09,3호선,수서,17052,17354,34406
13681,2020-11-09,3호선,가락시장,9262,9164,18426
13682,2020-11-09,3호선,경찰병원,7959,8022,15981
13683,2020-11-09,3호선,오금,6490,5757,12247
13684,2020-11-10,3호선,원흥,9844,9339,19183
13685,2020-11-10,3호선,삼송,18676,17905,36581
13686,2020-11-10,3호선,원당,11693,10992,22685
13687,2020-11-10,3호선,화정,16977,17671,34648
13688,2020-11-10,3호선,대곡,2036,1554,3590
13689,2020-11-10,3호선,백석,10327,10303,20630
13690,2020-11-10,3호선,마두,7862,8170,16032
13691,2020-11-10,3호선,정발산,7070,7135,14205
13692,2020-11-10,3호선,주엽,9143,9100,18243
13693,2020-11-10,3호선,대화,13878,10538,24416
13694,2020-11-10,3호선,오금,6669,5881,12550
13695,2020-11-10,3호선,경찰병원,8069,8030,16099
13696,2020-11-10,3호선,가락시장,9817,9563,19380
13697,2020-11-10,3호선,수서,17258,17463,34721
13698,2020-11-10,3호선,일원,10529,10311,20840
13699,2020-11-10,3호선,대청,10346,9454,19800
13700,2020-11-10,3호선,학여울,2376,2445,4821
13701,2020-11-10,3호선,대치,11195,11210,22405
13702,2020-11-10,3호선,도곡,5742,5761,11503
13703,2020-11-10,3호선,매봉,13043,12527,25570
13704,2020-11-10,3호선,양재,41043,44830,85873
13705,2020-11-10,3호선,남부터미널,30377,31132,61509
13706,2020-11-10,3호선,교대,15337,10124,25461
13707,2020-11-10,3호선,고속터미널,38600,37243,75843
13708,2020-11-10,3호선,잠원,5280,5141,10421
13709,2020-11-10,3호선,신사,30876,32899,63775
13710,2020-11-10,3호선,압구정,31757,34266,66023
13711,2020-11-10,3호선,옥수,9489,9637,19126
13712,2020-11-10,3호선,금호,8447,7895,16342
13713,2020-11-10,3호선,약수,13780,13594,27374
13714,2020-11-10,3호선,동대입구,7867,8585,16452
13715,2020-11-10,3호선,충무로,2,0,2
13716,2020-11-10,3호선,을지로3가,10711,11425,22136
13717,2020-11-10,3호선,종로3가,10238,12039,22277
13718,2020-11-10,3호선,안국,22264,23196,45460
13719,2020-11-10,3호선,경복궁,19881,20003,39884
13720,2020-11-10,3호선,독립문,7642,7921,15563
13721,2020-11-10,3호선,무악재,4087,4132,8219
13722,2020-11-10,3호선,홍제,18399,17310,35709
13723,2020-11-10,3호선,녹번,15614,14304,29918
13724,2020-11-10,3호선,불광,17270,18285,35555
13725,2020-11-10,3호선,연신내,38968,36342,75310
13726,2020-11-10,3호선,구파발,21983,20606,42589
13727,2020-11-10,3호선,지축,3413,3383,6796
13728,2020-11-11,3호선,충무로,1,0,1
13729,2020-11-11,3호선,지축,3432,3336,6768
13730,2020-11-11,3호선,구파발,21896,20936,42832
13731,2020-11-11,3호선,연신내,39632,37040,76672
13732,2020-11-11,3호선,불광,17415,18613,36028
13733,2020-11-11,3호선,녹번,15734,14361,30095
13734,2020-11-11,3호선,홍제,18413,17293,35706
13735,2020-11-11,3호선,무악재,4150,4121,8271
13736,2020-11-11,3호선,독립문,7647,8118,15765
13737,2020-11-11,3호선,경복궁,21988,22151,44139
13738,2020-11-11,3호선,안국,22712,23739,46451
13739,2020-11-11,3호선,종로3가,10310,12450,22760
13740,2020-11-11,3호선,을지로3가,11112,11618,22730
13741,2020-11-11,3호선,동대입구,9382,9949,19331
13742,2020-11-11,3호선,약수,13781,13542,27323
13743,2020-11-11,3호선,금호,8667,8025,16692
13744,2020-11-11,3호선,옥수,9693,9957,19650
13745,2020-11-11,3호선,압구정,32200,35008,67208
13746,2020-11-11,3호선,신사,31488,33754,65242
13747,2020-11-11,3호선,잠원,5321,5175,10496
13748,2020-11-11,3호선,고속터미널,39496,38311,77807
13749,2020-11-11,3호선,교대,15741,10431,26172
13750,2020-11-11,3호선,남부터미널,30060,30662,60722
13751,2020-11-11,3호선,양재,41302,44841,86143
13752,2020-11-11,3호선,매봉,12867,12487,25354
13753,2020-11-11,3호선,도곡,5777,5826,11603
13754,2020-11-11,3호선,대치,11185,11204,22389
13755,2020-11-11,3호선,학여울,2506,2600,5106
13756,2020-11-11,3호선,대청,10513,9561,20074
13757,2020-11-11,3호선,일원,10163,10043,20206
13758,2020-11-11,3호선,수서,17425,17659,35084
13759,2020-11-11,3호선,가락시장,9758,9585,19343
13760,2020-11-11,3호선,경찰병원,7951,8037,15988
13761,2020-11-11,3호선,오금,6745,5974,12719
13762,2020-11-11,3호선,대화,14356,11105,25461
13763,2020-11-11,3호선,주엽,9205,9285,18490
13764,2020-11-11,3호선,정발산,7276,7324,14600
13765,2020-11-11,3호선,마두,8099,8324,16423
13766,2020-11-11,3호선,백석,10152,10124,20276
13767,2020-11-11,3호선,대곡,2035,1562,3597
13768,2020-11-11,3호선,화정,17645,18199,35844
13769,2020-11-11,3호선,원당,11909,11209,23118
13770,2020-11-11,3호선,삼송,18836,18116,36952
13771,2020-11-11,3호선,원흥,9940,9396,19336
13772,2020-11-12,3호선,원흥,9792,9223,19015
13773,2020-11-12,3호선,삼송,18826,17909,36735
13774,2020-11-12,3호선,원당,11801,10948,22749
13775,2020-11-12,3호선,화정,17221,17779,35000
13776,2020-11-12,3호선,대곡,2113,1615,3728
13777,2020-11-12,3호선,백석,10351,10359,20710
13778,2020-11-12,3호선,마두,7697,8024,15721
13779,2020-11-12,3호선,정발산,7328,7541,14869
13780,2020-11-12,3호선,주엽,9045,9001,18046
13781,2020-11-12,3호선,대화,14934,11556,26490
13782,2020-11-12,3호선,오금,6641,6001,12642
13783,2020-11-12,3호선,경찰병원,8034,8051,16085
13784,2020-11-12,3호선,가락시장,9703,9746,19449
13785,2020-11-12,3호선,수서,17837,17673,35510
13786,2020-11-12,3호선,일원,10104,9998,20102
13787,2020-11-12,3호선,대청,10459,9520,19979
13788,2020-11-12,3호선,학여울,2470,2539,5009
13789,2020-11-12,3호선,대치,11394,11565,22959
13790,2020-11-12,3호선,도곡,5723,5798,11521
13791,2020-11-12,3호선,매봉,12874,12470,25344
13792,2020-11-12,3호선,양재,40964,44862,85826
13793,2020-11-12,3호선,남부터미널,31010,31421,62431
13794,2020-11-12,3호선,교대,15810,10383,26193
13795,2020-11-12,3호선,고속터미널,40004,39282,79286
13796,2020-11-12,3호선,잠원,5332,5108,10440
13797,2020-11-12,3호선,신사,31100,33711,64811
13798,2020-11-12,3호선,압구정,31828,34665,66493
13799,2020-11-12,3호선,옥수,9700,9870,19570
13800,2020-11-12,3호선,금호,8568,7993,16561
13801,2020-11-12,3호선,약수,13462,13532,26994
13802,2020-11-12,3호선,동대입구,8187,9140,17327
13803,2020-11-12,3호선,을지로3가,10854,11760,22614
13804,2020-11-12,3호선,종로3가,10371,12344,22715
13805,2020-11-12,3호선,안국,22169,23331,45500
13806,2020-11-12,3호선,경복궁,21711,21778,43489
13807,2020-11-12,3호선,독립문,7590,8066,15656
13808,2020-11-12,3호선,무악재,4045,4110,8155
13809,2020-11-12,3호선,홍제,18538,17392,35930
13810,2020-11-12,3호선,녹번,15787,14176,29963
13811,2020-11-12,3호선,불광,17229,18174,35403
13812,2020-11-12,3호선,연신내,39464,36811,76275
13813,2020-11-12,3호선,구파발,21596,20286,41882
13814,2020-11-12,3호선,지축,3445,3363,6808
13815,2020-11-13,3호선,원흥,9987,9071,19058
13816,2020-11-13,3호선,삼송,19159,17955,37114
13817,2020-11-13,3호선,원당,11964,11179,23143
13818,2020-11-13,3호선,화정,17504,18026,35530
13819,2020-11-13,3호선,대곡,1960,1513,3473
13820,2020-11-13,3호선,백석,10475,10615,21090
13821,2020-11-13,3호선,마두,8079,8197,16276
13822,2020-11-13,3호선,정발산,7527,7963,15490
13823,2020-11-13,3호선,주엽,9246,9258,18504
13824,2020-11-13,3호선,대화,14785,11464,26249
13825,2020-11-13,3호선,지축,3423,3206,6629
13826,2020-11-13,3호선,구파발,21739,20052,41791
13827,2020-11-13,3호선,연신내,39760,37063,76823
13828,2020-11-13,3호선,불광,17246,18331,35577
13829,2020-11-13,3호선,녹번,15875,13771,29646
13830,2020-11-13,3호선,홍제,18673,17170,35843
13831,2020-11-13,3호선,무악재,4087,4064,8151
13832,2020-11-13,3호선,독립문,7830,7871,15701
13833,2020-11-13,3호선,경복궁,22090,21722,43812
13834,2020-11-13,3호선,안국,22346,23305,45651
13835,2020-11-13,3호선,종로3가,9906,12552,22458
13836,2020-11-13,3호선,을지로3가,11203,12287,23490
13837,2020-11-13,3호선,동대입구,7927,8465,16392
13838,2020-11-13,3호선,약수,13559,13582,27141
13839,2020-11-13,3호선,금호,8884,7945,16829
13840,2020-11-13,3호선,옥수,9959,10044,20003
13841,2020-11-13,3호선,압구정,33652,37172,70824
13842,2020-11-13,3호선,신사,33031,36988,70019
13843,2020-11-13,3호선,잠원,5551,5295,10846
13844,2020-11-13,3호선,고속터미널,47313,51030,98343
13845,2020-11-13,3호선,교대,15908,10507,26415
13846,2020-11-13,3호선,남부터미널,33391,34334,67725
13847,2020-11-13,3호선,양재,43761,45668,89429
13848,2020-11-13,3호선,매봉,13033,12472,25505
13849,2020-11-13,3호선,도곡,5698,5583,11281
13850,2020-11-13,3호선,대치,11792,11891,23683
13851,2020-11-13,3호선,학여울,2079,1975,4054
13852,2020-11-13,3호선,대청,10797,9683,20480
13853,2020-11-13,3호선,일원,10304,9715,20019
13854,2020-11-13,3호선,수서,19241,19316,38557
13855,2020-11-13,3호선,가락시장,10150,10141,20291
13856,2020-11-13,3호선,경찰병원,7978,7762,15740
13857,2020-11-13,3호선,오금,6689,5970,12659
13858,2020-11-14,3호선,원흥,6480,5923,12403
13859,2020-11-14,3호선,삼송,13271,12843,26114
13860,2020-11-14,3호선,원당,8433,7765,16198
13861,2020-11-14,3호선,화정,12842,13212,26054
13862,2020-11-14,3호선,대곡,1438,1130,2568
13863,2020-11-14,3호선,백석,7813,7867,15680
13864,2020-11-14,3호선,마두,5096,4881,9977
13865,2020-11-14,3호선,정발산,6454,6860,13314
13866,2020-11-14,3호선,주엽,6286,6206,12492
13867,2020-11-14,3호선,대화,9649,8479,18128
13868,2020-11-14,3호선,오금,3930,3654,7584
13869,2020-11-14,3호선,경찰병원,4169,3925,8094
13870,2020-11-14,3호선,가락시장,6694,6476,13170
13871,2020-11-14,3호선,수서,13548,13333,26881
13872,2020-11-14,3호선,일원,4903,4784,9687
13873,2020-11-14,3호선,대청,5977,5463,11440
13874,2020-11-14,3호선,학여울,1404,1523,2927
13875,2020-11-14,3호선,대치,9607,8616,18223
13876,2020-11-14,3호선,도곡,3454,3457,6911
13877,2020-11-14,3호선,매봉,6048,5693,11741
13878,2020-11-14,3호선,양재,22486,24137,46623
13879,2020-11-14,3호선,남부터미널,22053,22726,44779
13880,2020-11-14,3호선,교대,7229,4439,11668
13881,2020-11-14,3호선,고속터미널,47697,50127,97824
13882,2020-11-14,3호선,잠원,3429,3348,6777
13883,2020-11-14,3호선,신사,25654,27976,53630
13884,2020-11-14,3호선,압구정,24703,26532,51235
13885,2020-11-14,3호선,옥수,7144,7186,14330
13886,2020-11-14,3호선,금호,6116,5425,11541
13887,2020-11-14,3호선,약수,9243,8761,18004
13888,2020-11-14,3호선,동대입구,7592,8750,16342
13889,2020-11-14,3호선,충무로,1,0,1
13890,2020-11-14,3호선,을지로3가,4902,5888,10790
13891,2020-11-14,3호선,종로3가,5308,8413,13721
13892,2020-11-14,3호선,안국,14663,17608,32271
13893,2020-11-14,3호선,경복궁,17388,19255,36643
13894,2020-11-14,3호선,독립문,6171,6779,12950
13895,2020-11-14,3호선,무악재,2762,2769,5531
13896,2020-11-14,3호선,홍제,13533,12413,25946
13897,2020-11-14,3호선,녹번,10265,8598,18863
13898,2020-11-14,3호선,불광,12945,14397,27342
13899,2020-11-14,3호선,연신내,30582,28222,58804
13900,2020-11-14,3호선,구파발,15064,14635,29699
13901,2020-11-14,3호선,지축,2398,2261,4659
13902,2020-11-15,3호선,원흥,4614,4465,9079
13903,2020-11-15,3호선,삼송,9729,9476,19205
13904,2020-11-15,3호선,원당,6306,5972,12278
13905,2020-11-15,3호선,화정,8968,9180,18148
13906,2020-11-15,3호선,대곡,985,854,1839
13907,2020-11-15,3호선,백석,5538,5325,10863
13908,2020-11-15,3호선,마두,3294,3302,6596
13909,2020-11-15,3호선,정발산,5044,5111,10155
13910,2020-11-15,3호선,주엽,4152,4083,8235
13911,2020-11-15,3호선,대화,6573,6117,12690
13912,2020-11-15,3호선,오금,2783,2731,5514
13913,2020-11-15,3호선,경찰병원,2608,2709,5317
13914,2020-11-15,3호선,가락시장,3864,4162,8026
13915,2020-11-15,3호선,수서,9922,9845,19767
13916,2020-11-15,3호선,일원,3119,3425,6544
13917,2020-11-15,3호선,대청,3986,3955,7941
13918,2020-11-15,3호선,학여울,914,973,1887
13919,2020-11-15,3호선,대치,5967,5340,11307
13920,2020-11-15,3호선,도곡,1927,2038,3965
13921,2020-11-15,3호선,매봉,3942,3944,7886
13922,2020-11-15,3호선,양재,14087,16242,30329
13923,2020-11-15,3호선,남부터미널,14566,15250,29816
13924,2020-11-15,3호선,교대,4341,2670,7011
13925,2020-11-15,3호선,고속터미널,38479,37349,75828
13926,2020-11-15,3호선,잠원,2205,2214,4419
13927,2020-11-15,3호선,신사,14313,14825,29138
13928,2020-11-15,3호선,압구정,13090,13879,26969
13929,2020-11-15,3호선,옥수,4948,5337,10285
13930,2020-11-15,3호선,금호,4327,4018,8345
13931,2020-11-15,3호선,약수,6442,6434,12876
13932,2020-11-15,3호선,동대입구,5044,5769,10813
13933,2020-11-15,3호선,을지로3가,2988,3003,5991
13934,2020-11-15,3호선,종로3가,3660,5121,8781
13935,2020-11-15,3호선,안국,9995,11128,21123
13936,2020-11-15,3호선,경복궁,11742,12980,24722
13937,2020-11-15,3호선,독립문,4205,4881,9086
13938,2020-11-15,3호선,무악재,1893,2029,3922
13939,2020-11-15,3호선,홍제,9003,8623,17626
13940,2020-11-15,3호선,녹번,6732,6159,12891
13941,2020-11-15,3호선,불광,9443,11251,20694
13942,2020-11-15,3호선,연신내,21778,20360,42138
13943,2020-11-15,3호선,구파발,11272,11436,22708
13944,2020-11-15,3호선,지축,1594,1597,3191
13945,2020-11-16,3호선,대곡,1893,1445,3338
13946,2020-11-16,3호선,대화,13887,10398,24285
13947,2020-11-16,3호선,주엽,8799,8758,17557
13948,2020-11-16,3호선,정발산,6671,6649,13320
13949,2020-11-16,3호선,마두,7760,7834,15594
13950,2020-11-16,3호선,백석,9947,9848,19795
13951,2020-11-16,3호선,화정,16887,17138,34025
13952,2020-11-16,3호선,원당,11507,10769,22276
13953,2020-11-16,3호선,삼송,18133,17480,35613
13954,2020-11-16,3호선,원흥,9475,9111,18586
13955,2020-11-16,3호선,오금,6446,5688,12134
13956,2020-11-16,3호선,경찰병원,7837,7899,15736
13957,2020-11-16,3호선,가락시장,9376,9312,18688
13958,2020-11-16,3호선,수서,17080,17136,34216
13959,2020-11-16,3호선,일원,10197,9962,20159
13960,2020-11-16,3호선,대청,10217,9237,19454
13961,2020-11-16,3호선,학여울,1864,1852,3716
13962,2020-11-16,3호선,대치,11203,11237,22440
13963,2020-11-16,3호선,도곡,5610,5723,11333
13964,2020-11-16,3호선,매봉,12655,12067,24722
13965,2020-11-16,3호선,양재,38886,43008,81894
13966,2020-11-16,3호선,남부터미널,29404,30157,59561
13967,2020-11-16,3호선,교대,14988,9950,24938
13968,2020-11-16,3호선,고속터미널,33815,31699,65514
13969,2020-11-16,3호선,잠원,5091,5008,10099
13970,2020-11-16,3호선,신사,29550,31947,61497
13971,2020-11-16,3호선,압구정,30729,32920,63649
13972,2020-11-16,3호선,옥수,9166,9513,18679
13973,2020-11-16,3호선,금호,8300,7745,16045
13974,2020-11-16,3호선,약수,12750,13145,25895
13975,2020-11-16,3호선,동대입구,7417,7911,15328
13976,2020-11-16,3호선,충무로,1,0,1
13977,2020-11-16,3호선,을지로3가,10583,10990,21573
13978,2020-11-16,3호선,종로3가,9766,11438,21204
13979,2020-11-16,3호선,안국,19938,20628,40566
13980,2020-11-16,3호선,경복궁,19575,19895,39470
13981,2020-11-16,3호선,독립문,7425,7655,15080
13982,2020-11-16,3호선,무악재,4042,4109,8151
13983,2020-11-16,3호선,홍제,17773,17033,34806
13984,2020-11-16,3호선,녹번,15110,13993,29103
13985,2020-11-16,3호선,불광,16708,17834,34542
13986,2020-11-16,3호선,연신내,38030,35250,73280
13987,2020-11-16,3호선,구파발,21114,19804,40918
13988,2020-11-16,3호선,지축,3393,3281,6674
13989,2020-11-17,3호선,원흥,9584,9067,18651
13990,2020-11-17,3호선,삼송,18204,17440,35644
13991,2020-11-17,3호선,원당,11422,10638,22060
13992,2020-11-17,3호선,화정,16436,17147,33583
13993,2020-11-17,3호선,대곡,1953,1484,3437
13994,2020-11-17,3호선,백석,10011,10010,20021
13995,2020-11-17,3호선,마두,7556,7804,15360
13996,2020-11-17,3호선,정발산,6635,6689,13324
13997,2020-11-17,3호선,주엽,8793,8776,17569
13998,2020-11-17,3호선,대화,13661,10650,24311
13999,2020-11-17,3호선,오금,6529,5846,12375
14000,2020-11-17,3호선,경찰병원,7753,7927,15680
14001,2020-11-17,3호선,가락시장,9597,9429,19026
14002,2020-11-17,3호선,수서,17038,17339,34377
14003,2020-11-17,3호선,일원,10286,10123,20409
14004,2020-11-17,3호선,대청,10364,9397,19761
14005,2020-11-17,3호선,학여울,1918,1903,3821
14006,2020-11-17,3호선,대치,11051,11344,22395
14007,2020-11-17,3호선,도곡,5461,5681,11142
14008,2020-11-17,3호선,매봉,12909,12367,25276
14009,2020-11-17,3호선,양재,40630,44123,84753
14010,2020-11-17,3호선,남부터미널,29223,30131,59354
14011,2020-11-17,3호선,교대,15353,10138,25491
14012,2020-11-17,3호선,고속터미널,36821,35602,72423
14013,2020-11-17,3호선,잠원,5202,5116,10318
14014,2020-11-17,3호선,신사,30246,32483,62729
14015,2020-11-17,3호선,압구정,31297,33761,65058
14016,2020-11-17,3호선,옥수,9218,9444,18662
14017,2020-11-17,3호선,금호,8374,7800,16174
14018,2020-11-17,3호선,약수,13072,13196,26268
14019,2020-11-17,3호선,동대입구,7743,8377,16120
14020,2020-11-17,3호선,충무로,2,0,2
14021,2020-11-17,3호선,을지로3가,10543,11056,21599
14022,2020-11-17,3호선,종로3가,10093,11820,21913
14023,2020-11-17,3호선,안국,21912,22866,44778
14024,2020-11-17,3호선,경복궁,19807,19659,39466
14025,2020-11-17,3호선,독립문,7627,8016,15643
14026,2020-11-17,3호선,무악재,3986,4006,7992
14027,2020-11-17,3호선,홍제,18151,17074,35225
14028,2020-11-17,3호선,녹번,15363,14037,29400
14029,2020-11-17,3호선,불광,16733,17817,34550
14030,2020-11-17,3호선,연신내,38075,35708,73783
14031,2020-11-17,3호선,구파발,21239,19725,40964
14032,2020-11-17,3호선,지축,3343,3253,6596
14033,2020-11-18,3호선,대화,13801,10751,24552
14034,2020-11-18,3호선,주엽,8425,8509,16934
14035,2020-11-18,3호선,정발산,6631,6556,13187
14036,2020-11-18,3호선,마두,7417,7722,15139
14037,2020-11-18,3호선,백석,9647,9623,19270
14038,2020-11-18,3호선,대곡,1846,1444,3290
14039,2020-11-18,3호선,화정,16138,16692,32830
14040,2020-11-18,3호선,원흥,9311,8744,18055
14041,2020-11-18,3호선,삼송,17593,17169,34762
14042,2020-11-18,3호선,원당,11090,10358,21448
14043,2020-11-18,3호선,지축,3281,3211,6492
14044,2020-11-18,3호선,구파발,20558,19282,39840
14045,2020-11-18,3호선,연신내,37208,34683,71891
14046,2020-11-18,3호선,불광,16413,17359,33772
14047,2020-11-18,3호선,녹번,15215,13704,28919
14048,2020-11-18,3호선,홍제,17415,16512,33927
14049,2020-11-18,3호선,무악재,3984,4028,8012
14050,2020-11-18,3호선,독립문,6999,7411,14410
14051,2020-11-18,3호선,경복궁,19635,19284,38919
14052,2020-11-18,3호선,안국,20841,21122,41963
14053,2020-11-18,3호선,종로3가,10188,11768,21956
14054,2020-11-18,3호선,을지로3가,10824,11302,22126
14055,2020-11-18,3호선,충무로,1,0,1
14056,2020-11-18,3호선,동대입구,7669,8131,15800
14057,2020-11-18,3호선,약수,13190,13021,26211
14058,2020-11-18,3호선,금호,8271,7689,15960
14059,2020-11-18,3호선,옥수,9056,9501,18557
14060,2020-11-18,3호선,압구정,30462,32945,63407
14061,2020-11-18,3호선,신사,29290,31426,60716
14062,2020-11-18,3호선,잠원,4984,4998,9982
14063,2020-11-18,3호선,고속터미널,35934,34930,70864
14064,2020-11-18,3호선,교대,15218,10121,25339
14065,2020-11-18,3호선,남부터미널,29200,30011,59211
14066,2020-11-18,3호선,양재,39459,42858,82317
14067,2020-11-18,3호선,매봉,12906,12160,25066
14068,2020-11-18,3호선,도곡,5622,5658,11280
14069,2020-11-18,3호선,대치,10690,10885,21575
14070,2020-11-18,3호선,학여울,1921,1964,3885
14071,2020-11-18,3호선,대청,10393,9497,19890
14072,2020-11-18,3호선,일원,10168,9911,20079
14073,2020-11-18,3호선,수서,16937,17114,34051
14074,2020-11-18,3호선,가락시장,9228,9223,18451
14075,2020-11-18,3호선,경찰병원,8074,8018,16092
14076,2020-11-18,3호선,오금,6518,5778,12296
14077,2020-11-19,3호선,지축,1,0,1
14078,2020-11-19,3호선,지축,2980,3001,5981
14079,2020-11-19,3호선,구파발,19787,18578,38365
14080,2020-11-19,3호선,연신내,35437,33251,68688
14081,2020-11-19,3호선,불광,15471,16213,31684
14082,2020-11-19,3호선,녹번,14667,13066,27733
14083,2020-11-19,3호선,홍제,16745,15673,32418
14084,2020-11-19,3호선,무악재,3806,3820,7626
14085,2020-11-19,3호선,독립문,6506,6647,13153
14086,2020-11-19,3호선,경복궁,18443,18160,36603
14087,2020-11-19,3호선,안국,19889,20665,40554
14088,2020-11-19,3호선,종로3가,9522,11153,20675
14089,2020-11-19,3호선,을지로3가,10054,11043,21097
14090,2020-11-19,3호선,동대입구,7244,7576,14820
14091,2020-11-19,3호선,약수,12821,12438,25259
14092,2020-11-19,3호선,금호,7975,7137,15112
14093,2020-11-19,3호선,옥수,8742,8898,17640
14094,2020-11-19,3호선,압구정,29037,31676,60713
14095,2020-11-19,3호선,신사,28133,30644,58777
14096,2020-11-19,3호선,잠원,4709,4703,9412
14097,2020-11-19,3호선,고속터미널,34725,34599,69324
14098,2020-11-19,3호선,교대,14585,9802,24387
14099,2020-11-19,3호선,남부터미널,28667,29515,58182
14100,2020-11-19,3호선,양재,38273,42056,80329
14101,2020-11-19,3호선,매봉,12138,11809,23947
14102,2020-11-19,3호선,도곡,5454,5455,10909
14103,2020-11-19,3호선,대치,10794,10872,21666
14104,2020-11-19,3호선,학여울,2047,1969,4016
14105,2020-11-19,3호선,대청,10046,9129,19175
14106,2020-11-19,3호선,일원,9642,9429,19071
14107,2020-11-19,3호선,수서,16748,16915,33663
14108,2020-11-19,3호선,가락시장,8964,8682,17646
14109,2020-11-19,3호선,경찰병원,7626,7574,15200
14110,2020-11-19,3호선,오금,6342,5616,11958
14111,2020-11-19,3호선,원흥,8909,8294,17203
14112,2020-11-19,3호선,삼송,16938,16221,33159
14113,2020-11-19,3호선,원당,10271,9757,20028
14114,2020-11-19,3호선,화정,15185,15710,30895
14115,2020-11-19,3호선,대곡,1694,1268,2962
14116,2020-11-19,3호선,백석,9272,9151,18423
14117,2020-11-19,3호선,마두,6965,7151,14116
14118,2020-11-19,3호선,정발산,6022,6128,12150
14119,2020-11-19,3호선,주엽,7900,7856,15756
14120,2020-11-19,3호선,대화,13468,10512,23980
14121,2020-11-20,3호선,원흥,9582,8882,18464
14122,2020-11-20,3호선,백석,10009,10177,20186
14123,2020-11-20,3호선,대곡,1849,1424,3273
14124,2020-11-20,3호선,삼송,18334,17481,35815
14125,2020-11-20,3호선,원당,11223,10375,21598
14126,2020-11-20,3호선,화정,16302,17091,33393
14127,2020-11-20,3호선,대화,14763,11882,26645
14128,2020-11-20,3호선,주엽,8758,8777,17535
14129,2020-11-20,3호선,정발산,7024,7418,14442
14130,2020-11-20,3호선,마두,7718,7910,15628
14131,2020-11-20,3호선,지축,3318,3158,6476
14132,2020-11-20,3호선,구파발,20885,19257,40142
14133,2020-11-20,3호선,연신내,38914,36546,75460
14134,2020-11-20,3호선,불광,16893,17803,34696
14135,2020-11-20,3호선,녹번,15371,13676,29047
14136,2020-11-20,3호선,홍제,18017,16888,34905
14137,2020-11-20,3호선,무악재,3994,4024,8018
14138,2020-11-20,3호선,독립문,7366,7503,14869
14139,2020-11-20,3호선,경복궁,20616,20416,41032
14140,2020-11-20,3호선,안국,21328,22035,43363
14141,2020-11-20,3호선,종로3가,9755,11962,21717
14142,2020-11-20,3호선,을지로3가,10636,11547,22183
14143,2020-11-20,3호선,충무로,1,0,1
14144,2020-11-20,3호선,동대입구,7852,8320,16172
14145,2020-11-20,3호선,약수,13792,13375,27167
14146,2020-11-20,3호선,금호,8457,7848,16305
14147,2020-11-20,3호선,옥수,9270,9559,18829
14148,2020-11-20,3호선,압구정,32404,35575,67979
14149,2020-11-20,3호선,신사,32245,35687,67932
14150,2020-11-20,3호선,잠원,5022,4868,9890
14151,2020-11-20,3호선,고속터미널,44073,47969,92042
14152,2020-11-20,3호선,교대,15150,10046,25196
14153,2020-11-20,3호선,남부터미널,31622,32841,64463
14154,2020-11-20,3호선,양재,41885,43736,85621
14155,2020-11-20,3호선,매봉,12771,12169,24940
14156,2020-11-20,3호선,도곡,5602,5634,11236
14157,2020-11-20,3호선,대치,11123,11493,22616
14158,2020-11-20,3호선,학여울,2015,2031,4046
14159,2020-11-20,3호선,대청,10424,9406,19830
14160,2020-11-20,3호선,일원,9723,9066,18789
14161,2020-11-20,3호선,수서,18605,18875,37480
14162,2020-11-20,3호선,가락시장,9874,9803,19677
14163,2020-11-20,3호선,경찰병원,7787,7645,15432
14164,2020-11-20,3호선,오금,6415,5624,12039
14165,2020-11-21,3호선,원흥,6061,5699,11760
14166,2020-11-21,3호선,대화,9021,7921,16942
14167,2020-11-21,3호선,주엽,5568,5437,11005
14168,2020-11-21,3호선,정발산,5293,5704,10997
14169,2020-11-21,3호선,마두,4642,4629,9271
14170,2020-11-21,3호선,백석,6919,7023,13942
14171,2020-11-21,3호선,대곡,1141,957,2098
14172,2020-11-21,3호선,화정,11147,11577,22724
14173,2020-11-21,3호선,원당,7308,6797,14105
14174,2020-11-21,3호선,삼송,11972,11508,23480
14175,2020-11-21,3호선,지축,2064,2040,4104
14176,2020-11-21,3호선,구파발,13343,12908,26251
14177,2020-11-21,3호선,연신내,28096,25838,53934
14178,2020-11-21,3호선,불광,11632,12979,24611
14179,2020-11-21,3호선,녹번,9207,8026,17233
14180,2020-11-21,3호선,홍제,12085,11242,23327
14181,2020-11-21,3호선,무악재,2436,2457,4893
14182,2020-11-21,3호선,독립문,5225,5416,10641
14183,2020-11-21,3호선,경복궁,14030,14518,28548
14184,2020-11-21,3호선,안국,11659,13867,25526
14185,2020-11-21,3호선,종로3가,4787,7137,11924
14186,2020-11-21,3호선,을지로3가,4437,5158,9595
14187,2020-11-21,3호선,동대입구,5945,6628,12573
14188,2020-11-21,3호선,약수,8673,8135,16808
14189,2020-11-21,3호선,금호,5466,4949,10415
14190,2020-11-21,3호선,옥수,6546,6540,13086
14191,2020-11-21,3호선,압구정,22997,24411,47408
14192,2020-11-21,3호선,신사,22755,24804,47559
14193,2020-11-21,3호선,잠원,3417,3323,6740
14194,2020-11-21,3호선,고속터미널,41537,43405,84942
14195,2020-11-21,3호선,교대,6401,4022,10423
14196,2020-11-21,3호선,남부터미널,19263,19743,39006
14197,2020-11-21,3호선,양재,19919,21640,41559
14198,2020-11-21,3호선,매봉,5645,5380,11025
14199,2020-11-21,3호선,도곡,3463,3433,6896
14200,2020-11-21,3호선,대치,8642,7900,16542
14201,2020-11-21,3호선,학여울,1267,1270,2537
14202,2020-11-21,3호선,대청,5258,4754,10012
14203,2020-11-21,3호선,일원,4603,4526,9129
14204,2020-11-21,3호선,수서,11708,11743,23451
14205,2020-11-21,3호선,가락시장,5851,5785,11636
14206,2020-11-21,3호선,경찰병원,3790,3595,7385
14207,2020-11-21,3호선,오금,3664,3403,7067
14208,2020-11-22,3호선,오금,2300,2332,4632
14209,2020-11-22,3호선,대화,6052,5571,11623
14210,2020-11-22,3호선,주엽,3590,3480,7070
14211,2020-11-22,3호선,정발산,4079,4024,8103
14212,2020-11-22,3호선,마두,2836,2747,5583
14213,2020-11-22,3호선,백석,4791,4659,9450
14214,2020-11-22,3호선,대곡,818,695,1513
14215,2020-11-22,3호선,화정,7611,7731,15342
14216,2020-11-22,3호선,원당,5098,4861,9959
14217,2020-11-22,3호선,삼송,8215,8049,16264
14218,2020-11-22,3호선,원흥,4308,4086,8394
14219,2020-11-22,3호선,지축,1335,1309,2644
14220,2020-11-22,3호선,구파발,9105,9000,18105
14221,2020-11-22,3호선,연신내,18662,17781,36443
14222,2020-11-22,3호선,불광,7653,8787,16440
14223,2020-11-22,3호선,녹번,5887,5333,11220
14224,2020-11-22,3호선,홍제,7631,7549,15180
14225,2020-11-22,3호선,무악재,1539,1692,3231
14226,2020-11-22,3호선,독립문,3149,3533,6682
14227,2020-11-22,3호선,경복궁,8387,8825,17212
14228,2020-11-22,3호선,안국,7914,8518,16432
14229,2020-11-22,3호선,종로3가,3090,4000,7090
14230,2020-11-22,3호선,을지로3가,2345,2514,4859
14231,2020-11-22,3호선,동대입구,3794,4293,8087
14232,2020-11-22,3호선,약수,5840,5596,11436
14233,2020-11-22,3호선,금호,3610,3447,7057
14234,2020-11-22,3호선,옥수,4040,4355,8395
14235,2020-11-22,3호선,압구정,12332,12994,25326
14236,2020-11-22,3호선,신사,12578,12822,25400
14237,2020-11-22,3호선,잠원,1719,1784,3503
14238,2020-11-22,3호선,고속터미널,33234,31869,65103
14239,2020-11-22,3호선,교대,3924,2324,6248
14240,2020-11-22,3호선,남부터미널,12715,13509,26224
14241,2020-11-22,3호선,양재,12356,14321,26677
14242,2020-11-22,3호선,매봉,3600,3517,7117
14243,2020-11-22,3호선,도곡,1727,1872,3599
14244,2020-11-22,3호선,대치,5182,4602,9784
14245,2020-11-22,3호선,학여울,731,756,1487
14246,2020-11-22,3호선,대청,3275,3118,6393
14247,2020-11-22,3호선,일원,2729,2885,5614
14248,2020-11-22,3호선,수서,8666,8261,16927
14249,2020-11-22,3호선,가락시장,3231,3588,6819
14250,2020-11-22,3호선,경찰병원,2258,2366,4624
14251,2020-11-23,3호선,대화,12959,9869,22828
14252,2020-11-23,3호선,주엽,8345,8301,16646
14253,2020-11-23,3호선,정발산,6321,6170,12491
14254,2020-11-23,3호선,마두,7160,7393,14553
14255,2020-11-23,3호선,백석,9400,9456,18856
14256,2020-11-23,3호선,대곡,1776,1284,3060
14257,2020-11-23,3호선,화정,15431,16014,31445
14258,2020-11-23,3호선,원당,10619,10129,20748
14259,2020-11-23,3호선,삼송,17313,16598,33911
14260,2020-11-23,3호선,원흥,8930,8410,17340
14261,2020-11-23,3호선,오금,6128,5397,11525
14262,2020-11-23,3호선,경찰병원,7491,7671,15162
14263,2020-11-23,3호선,가락시장,8922,8710,17632
14264,2020-11-23,3호선,수서,16269,16370,32639
14265,2020-11-23,3호선,일원,9448,9267,18715
14266,2020-11-23,3호선,대청,9770,9055,18825
14267,2020-11-23,3호선,학여울,1723,1757,3480
14268,2020-11-23,3호선,대치,10317,10515,20832
14269,2020-11-23,3호선,도곡,5481,5373,10854
14270,2020-11-23,3호선,매봉,12123,11577,23700
14271,2020-11-23,3호선,양재,37410,40981,78391
14272,2020-11-23,3호선,남부터미널,27790,28722,56512
14273,2020-11-23,3호선,교대,13831,9405,23236
14274,2020-11-23,3호선,고속터미널,34750,33112,67862
14275,2020-11-23,3호선,잠원,4722,4741,9463
14276,2020-11-23,3호선,신사,28049,29890,57939
14277,2020-11-23,3호선,압구정,27180,29380,56560
14278,2020-11-23,3호선,옥수,8556,8849,17405
14279,2020-11-23,3호선,금호,7987,7456,15443
14280,2020-11-23,3호선,약수,12671,12494,25165
14281,2020-11-23,3호선,동대입구,6862,7197,14059
14282,2020-11-23,3호선,충무로,1,0,1
14283,2020-11-23,3호선,을지로3가,10072,10529,20601
14284,2020-11-23,3호선,종로3가,9458,10892,20350
14285,2020-11-23,3호선,안국,17841,18550,36391
14286,2020-11-23,3호선,경복궁,17781,17552,35333
14287,2020-11-23,3호선,독립문,6783,7089,13872
14288,2020-11-23,3호선,무악재,3760,3829,7589
14289,2020-11-23,3호선,홍제,16870,16295,33165
14290,2020-11-23,3호선,녹번,14491,13370,27861
14291,2020-11-23,3호선,불광,15945,16923,32868
14292,2020-11-23,3호선,연신내,36191,34035,70226
14293,2020-11-23,3호선,구파발,20027,18656,38683
14294,2020-11-23,3호선,지축,3197,3125,6322
14295,2020-11-24,3호선,원당,10517,9938,20455
14296,2020-11-24,3호선,삼송,16775,16648,33423
14297,2020-11-24,3호선,원흥,8648,8364,17012
14298,2020-11-24,3호선,정발산,6073,5976,12049
14299,2020-11-24,3호선,주엽,8120,8285,16405
14300,2020-11-24,3호선,대화,12391,9731,22122
14301,2020-11-24,3호선,오금,6040,5462,11502
14302,2020-11-24,3호선,경찰병원,7290,7355,14645
14303,2020-11-24,3호선,가락시장,8713,8506,17219
14304,2020-11-24,3호선,수서,15531,15647,31178
14305,2020-11-24,3호선,일원,9236,9211,18447
14306,2020-11-24,3호선,대청,9616,8848,18464
14307,2020-11-24,3호선,학여울,1792,1791,3583
14308,2020-11-24,3호선,대치,10126,10262,20388
14309,2020-11-24,3호선,도곡,5110,5250,10360
14310,2020-11-24,3호선,매봉,12023,11267,23290
14311,2020-11-24,3호선,양재,37575,40189,77764
14312,2020-11-24,3호선,남부터미널,27646,28358,56004
14313,2020-11-24,3호선,교대,13751,9176,22927
14314,2020-11-24,3호선,고속터미널,32464,31664,64128
14315,2020-11-24,3호선,잠원,4623,4538,9161
14316,2020-11-24,3호선,신사,27591,28559,56150
14317,2020-11-24,3호선,압구정,29662,31204,60866
14318,2020-11-24,3호선,옥수,8543,8898,17441
14319,2020-11-24,3호선,금호,7730,7368,15098
14320,2020-11-24,3호선,약수,12278,12037,24315
14321,2020-11-24,3호선,동대입구,7016,7350,14366
14322,2020-11-24,3호선,을지로3가,9758,10085,19843
14323,2020-11-24,3호선,종로3가,9277,10401,19678
14324,2020-11-24,3호선,안국,18494,19018,37512
14325,2020-11-24,3호선,경복궁,17114,16465,33579
14326,2020-11-24,3호선,독립문,6811,6989,13800
14327,2020-11-24,3호선,무악재,3715,3811,7526
14328,2020-11-24,3호선,홍제,16601,15980,32581
14329,2020-11-24,3호선,녹번,14160,13267,27427
14330,2020-11-24,3호선,불광,15764,16800,32564
14331,2020-11-24,3호선,연신내,35800,33269,69069
14332,2020-11-24,3호선,구파발,19622,18500,38122
14333,2020-11-24,3호선,지축,3116,3080,6196
14334,2020-11-24,3호선,마두,6897,7189,14086
14335,2020-11-24,3호선,백석,9320,9415,18735
14336,2020-11-24,3호선,대곡,1754,1276,3030
14337,2020-11-24,3호선,화정,15215,15814,31029
14338,2020-11-25,3호선,금호,7691,7303,14994
14339,2020-11-25,3호선,지축,3145,3059,6204
14340,2020-11-25,3호선,구파발,19559,18406,37965
14341,2020-11-25,3호선,연신내,35717,33430,69147
14342,2020-11-25,3호선,불광,15870,16842,32712
14343,2020-11-25,3호선,녹번,14239,13237,27476
14344,2020-11-25,3호선,홍제,16615,16180,32795
14345,2020-11-25,3호선,무악재,3818,3854,7672
14346,2020-11-25,3호선,독립문,6847,7132,13979
14347,2020-11-25,3호선,경복궁,17840,17463,35303
14348,2020-11-25,3호선,안국,18137,18624,36761
14349,2020-11-25,3호선,종로3가,9366,10614,19980
14350,2020-11-25,3호선,을지로3가,9868,10161,20029
14351,2020-11-25,3호선,동대입구,6939,7304,14243
14352,2020-11-25,3호선,약수,12408,12164,24572
14353,2020-11-25,3호선,옥수,8524,8938,17462
14354,2020-11-25,3호선,압구정,28955,30754,59709
14355,2020-11-25,3호선,신사,26858,27920,54778
14356,2020-11-25,3호선,잠원,4531,4544,9075
14357,2020-11-25,3호선,고속터미널,32493,31832,64325
14358,2020-11-25,3호선,교대,13834,9214,23048
14359,2020-11-25,3호선,남부터미널,27249,27859,55108
14360,2020-11-25,3호선,양재,37428,40141,77569
14361,2020-11-25,3호선,매봉,11948,11366,23314
14362,2020-11-25,3호선,도곡,5067,5083,10150
14363,2020-11-25,3호선,대치,9699,9745,19444
14364,2020-11-25,3호선,학여울,1699,1782,3481
14365,2020-11-25,3호선,대청,9530,8590,18120
14366,2020-11-25,3호선,일원,9267,9165,18432
14367,2020-11-25,3호선,수서,15538,15720,31258
14368,2020-11-25,3호선,가락시장,8688,8641,17329
14369,2020-11-25,3호선,경찰병원,7472,7443,14915
14370,2020-11-25,3호선,오금,6009,5355,11364
14371,2020-11-25,3호선,원흥,8836,8481,17317
14372,2020-11-25,3호선,삼송,16667,16475,33142
14373,2020-11-25,3호선,원당,10407,9997,20404
14374,2020-11-25,3호선,화정,15311,15811,31122
14375,2020-11-25,3호선,대곡,1648,1242,2890
14376,2020-11-25,3호선,백석,9178,9113,18291
14377,2020-11-25,3호선,마두,6896,7278,14174
14378,2020-11-25,3호선,정발산,6346,6161,12507
14379,2020-11-25,3호선,주엽,8001,8299,16300
14380,2020-11-25,3호선,대화,12313,9729,22042
14381,2020-11-26,3호선,을지로3가,9586,9864,19450
14382,2020-11-26,3호선,종로3가,9161,10381,19542
14383,2020-11-26,3호선,안국,17084,17449,34533
14384,2020-11-26,3호선,경복궁,16742,16308,33050
14385,2020-11-26,3호선,독립문,6308,6652,12960
14386,2020-11-26,3호선,무악재,3605,3692,7297
14387,2020-11-26,3호선,원흥,8483,8119,16602
14388,2020-11-26,3호선,삼송,16430,16016,32446
14389,2020-11-26,3호선,원당,10183,9852,20035
14390,2020-11-26,3호선,화정,14937,15339,30276
14391,2020-11-26,3호선,대곡,1618,1204,2822
14392,2020-11-26,3호선,백석,9172,9242,18414
14393,2020-11-26,3호선,마두,6752,7154,13906
14394,2020-11-26,3호선,정발산,6166,6111,12277
14395,2020-11-26,3호선,주엽,7934,8077,16011
14396,2020-11-26,3호선,대화,12219,9514,21733
14397,2020-11-26,3호선,오금,5825,5203,11028
14398,2020-11-26,3호선,경찰병원,7080,7113,14193
14399,2020-11-26,3호선,가락시장,8502,8468,16970
14400,2020-11-26,3호선,수서,15335,15682,31017
14401,2020-11-26,3호선,일원,9240,9074,18314
14402,2020-11-26,3호선,대청,8930,8299,17229
14403,2020-11-26,3호선,학여울,2943,2992,5935
14404,2020-11-26,3호선,대치,9672,9654,19326
14405,2020-11-26,3호선,도곡,4932,5003,9935
14406,2020-11-26,3호선,매봉,11899,11255,23154
14407,2020-11-26,3호선,양재,36478,39156,75634
14408,2020-11-26,3호선,남부터미널,26912,27635,54547
14409,2020-11-26,3호선,교대,13729,9035,22764
14410,2020-11-26,3호선,고속터미널,31984,31935,63919
14411,2020-11-26,3호선,잠원,4321,4339,8660
14412,2020-11-26,3호선,신사,27025,28089,55114
14413,2020-11-26,3호선,압구정,28384,30058,58442
14414,2020-11-26,3호선,옥수,8427,8654,17081
14415,2020-11-26,3호선,금호,7516,7167,14683
14416,2020-11-26,3호선,약수,11957,11656,23613
14417,2020-11-26,3호선,동대입구,6896,7242,14138
14418,2020-11-26,3호선,홍제,15995,15387,31382
14419,2020-11-26,3호선,녹번,13930,12825,26755
14420,2020-11-26,3호선,불광,15139,16194,31333
14421,2020-11-26,3호선,연신내,34643,32672,67315
14422,2020-11-26,3호선,구파발,18965,17865,36830
14423,2020-11-26,3호선,지축,3002,3013,6015
14424,2020-11-27,3호선,대화,12080,9900,21980
14425,2020-11-27,3호선,주엽,7750,7983,15733
14426,2020-11-27,3호선,정발산,6086,6072,12158
14427,2020-11-27,3호선,마두,6727,6930,13657
14428,2020-11-27,3호선,백석,9100,9352,18452
14429,2020-11-27,3호선,대곡,1617,1243,2860
14430,2020-11-27,3호선,화정,14677,15379,30056
14431,2020-11-27,3호선,원당,10116,9755,19871
14432,2020-11-27,3호선,삼송,16033,15857,31890
14433,2020-11-27,3호선,원흥,8562,8104,16666
14434,2020-11-27,3호선,오금,5714,5035,10749
14435,2020-11-27,3호선,경찰병원,6959,6916,13875
14436,2020-11-27,3호선,가락시장,8654,8502,17156
14437,2020-11-27,3호선,수서,15761,16580,32341
14438,2020-11-27,3호선,일원,8806,8417,17223
14439,2020-11-27,3호선,대청,8860,8135,16995
14440,2020-11-27,3호선,학여울,2782,2757,5539
14441,2020-11-27,3호선,대치,9726,9837,19563
14442,2020-11-27,3호선,도곡,4784,4717,9501
14443,2020-11-27,3호선,매봉,11722,10855,22577
14444,2020-11-27,3호선,양재,36494,38255,74749
14445,2020-11-27,3호선,남부터미널,27639,28969,56608
14446,2020-11-27,3호선,교대,13399,8842,22241
14447,2020-11-27,3호선,고속터미널,36086,39831,75917
14448,2020-11-27,3호선,잠원,4405,4385,8790
14449,2020-11-27,3호선,신사,27700,28677,56377
14450,2020-11-27,3호선,압구정,29893,31674,61567
14451,2020-11-27,3호선,옥수,8326,8570,16896
14452,2020-11-27,3호선,금호,7514,7087,14601
14453,2020-11-27,3호선,약수,11977,11763,23740
14454,2020-11-27,3호선,동대입구,6563,6837,13400
14455,2020-11-27,3호선,충무로,4,0,4
14456,2020-11-27,3호선,을지로3가,9505,9757,19262
14457,2020-11-27,3호선,종로3가,8821,10028,18849
14458,2020-11-27,3호선,안국,16514,16766,33280
14459,2020-11-27,3호선,경복궁,16713,16241,32954
14460,2020-11-27,3호선,독립문,6266,6540,12806
14461,2020-11-27,3호선,무악재,3550,3585,7135
14462,2020-11-27,3호선,홍제,16013,15397,31410
14463,2020-11-27,3호선,녹번,13874,12671,26545
14464,2020-11-27,3호선,불광,15014,15946,30960
14465,2020-11-27,3호선,연신내,34434,32192,66626
14466,2020-11-27,3호선,구파발,18560,17563,36123
14467,2020-11-27,3호선,지축,2961,2907,5868
14468,2020-11-28,3호선,오금,2863,2629,5492
14469,2020-11-28,3호선,경찰병원,3220,3016,6236
14470,2020-11-28,3호선,가락시장,5060,4854,9914
14471,2020-11-28,3호선,수서,9052,9532,18584
14472,2020-11-28,3호선,일원,3567,3618,7185
14473,2020-11-28,3호선,대청,4495,4193,8688
14474,2020-11-28,3호선,학여울,1984,2018,4002
14475,2020-11-28,3호선,대치,6482,5920,12402
14476,2020-11-28,3호선,도곡,2697,2644,5341
14477,2020-11-28,3호선,매봉,4650,4302,8952
14478,2020-11-28,3호선,양재,15980,17270,33250
14479,2020-11-28,3호선,남부터미널,14699,15484,30183
14480,2020-11-28,3호선,교대,4869,3145,8014
14481,2020-11-28,3호선,고속터미널,32392,33529,65921
14482,2020-11-28,3호선,잠원,2601,2492,5093
14483,2020-11-28,3호선,신사,17209,17574,34783
14484,2020-11-28,3호선,압구정,19809,20367,40176
14485,2020-11-28,3호선,옥수,5237,5269,10506
14486,2020-11-28,3호선,금호,4583,4320,8903
14487,2020-11-28,3호선,약수,7141,6736,13877
14488,2020-11-28,3호선,동대입구,4560,4941,9501
14489,2020-11-28,3호선,충무로,1,0,1
14490,2020-11-28,3호선,을지로3가,3304,3666,6970
14491,2020-11-28,3호선,종로3가,3681,4835,8516
14492,2020-11-28,3호선,안국,8385,9241,17626
14493,2020-11-28,3호선,경복궁,8950,9132,18082
14494,2020-11-28,3호선,독립문,4112,4275,8387
14495,2020-11-28,3호선,무악재,1990,2133,4123
14496,2020-11-28,3호선,홍제,10068,9677,19745
14497,2020-11-28,3호선,녹번,7687,6907,14594
14498,2020-11-28,3호선,불광,9890,10943,20833
14499,2020-11-28,3호선,연신내,23391,21845,45236
14500,2020-11-28,3호선,구파발,11174,11098,22272
14501,2020-11-28,3호선,지축,1687,1740,3427
14502,2020-11-28,3호선,원흥,4837,4646,9483
14503,2020-11-28,3호선,삼송,9957,9960,19917
14504,2020-11-28,3호선,원당,6181,6039,12220
14505,2020-11-28,3호선,화정,9065,9543,18608
14506,2020-11-28,3호선,대곡,917,750,1667
14507,2020-11-28,3호선,백석,5933,6062,11995
14508,2020-11-28,3호선,마두,3786,3835,7621
14509,2020-11-28,3호선,정발산,4185,4206,8391
14510,2020-11-28,3호선,주엽,4535,4533,9068
14511,2020-11-28,3호선,대화,6521,5904,12425
14512,2020-11-29,3호선,대화,4504,4131,8635
14513,2020-11-29,3호선,주엽,3047,3089,6136
14514,2020-11-29,3호선,정발산,3239,3051,6290
14515,2020-11-29,3호선,마두,2372,2434,4806
14516,2020-11-29,3호선,백석,4216,4073,8289
14517,2020-11-29,3호선,대곡,753,545,1298
14518,2020-11-29,3호선,화정,6544,6806,13350
14519,2020-11-29,3호선,원당,4432,4321,8753
14520,2020-11-29,3호선,오금,2150,2148,4298
14521,2020-11-29,3호선,경찰병원,2017,2145,4162
14522,2020-11-29,3호선,가락시장,3009,3287,6296
14523,2020-11-29,3호선,수서,7610,6859,14469
14524,2020-11-29,3호선,일원,2360,2461,4821
14525,2020-11-29,3호선,대청,2941,2826,5767
14526,2020-11-29,3호선,학여울,1360,1433,2793
14527,2020-11-29,3호선,대치,3749,3420,7169
14528,2020-11-29,3호선,도곡,1514,1582,3096
14529,2020-11-29,3호선,매봉,3166,3097,6263
14530,2020-11-29,3호선,양재,10248,11944,22192
14531,2020-11-29,3호선,남부터미널,10450,10563,21013
14532,2020-11-29,3호선,교대,2836,1805,4641
14533,2020-11-29,3호선,고속터미널,26154,24046,50200
14534,2020-11-29,3호선,잠원,1603,1672,3275
14535,2020-11-29,3호선,신사,8714,8898,17612
14536,2020-11-29,3호선,압구정,10345,10824,21169
14537,2020-11-29,3호선,옥수,3443,3767,7210
14538,2020-11-29,3호선,금호,3117,3091,6208
14539,2020-11-29,3호선,약수,4691,4634,9325
14540,2020-11-29,3호선,동대입구,3134,3401,6535
14541,2020-11-29,3호선,을지로3가,1827,1755,3582
14542,2020-11-29,3호선,종로3가,2166,2803,4969
14543,2020-11-29,3호선,안국,5500,5932,11432
14544,2020-11-29,3호선,경복궁,6250,6417,12667
14545,2020-11-29,3호선,독립문,2931,3027,5958
14546,2020-11-29,3호선,무악재,1334,1417,2751
14547,2020-11-29,3호선,홍제,6673,6528,13201
14548,2020-11-29,3호선,녹번,5009,4597,9606
14549,2020-11-29,3호선,불광,7066,8133,15199
14550,2020-11-29,3호선,연신내,16817,15670,32487
14551,2020-11-29,3호선,구파발,8654,8726,17380
14552,2020-11-29,3호선,지축,1096,1084,2180
14553,2020-11-29,3호선,삼송,7107,6967,14074
14554,2020-11-29,3호선,원흥,3409,3275,6684
14555,2020-11-30,3호선,대화,11756,9115,20871
14556,2020-11-30,3호선,원흥,8195,7813,16008
14557,2020-11-30,3호선,지축,1,0,1
14558,2020-11-30,3호선,삼송,15835,15469,31304
14559,2020-11-30,3호선,원당,9847,9338,19185
14560,2020-11-30,3호선,화정,14410,14909,29319
14561,2020-11-30,3호선,대곡,1576,1171,2747
14562,2020-11-30,3호선,백석,8850,8926,17776
14563,2020-11-30,3호선,마두,6527,6913,13440
14564,2020-11-30,3호선,정발산,5907,5691,11598
14565,2020-11-30,3호선,지축,2981,2904,5885
14566,2020-11-30,3호선,구파발,18219,17101,35320
14567,2020-11-30,3호선,연신내,33559,31498,65057
14568,2020-11-30,3호선,불광,14971,15946,30917
14569,2020-11-30,3호선,녹번,13406,12580,25986
14570,2020-11-30,3호선,홍제,15547,15179,30726
14571,2020-11-30,3호선,무악재,3465,3527,6992
14572,2020-11-30,3호선,독립문,5957,6195,12152
14573,2020-11-30,3호선,경복궁,15193,14868,30061
14574,2020-11-30,3호선,안국,15349,15571,30920
14575,2020-11-30,3호선,종로3가,8882,9906,18788
14576,2020-11-30,3호선,을지로3가,9483,9739,19222
14577,2020-11-30,3호선,동대입구,6331,6615,12946
14578,2020-11-30,3호선,약수,11464,11234,22698
14579,2020-11-30,3호선,금호,7135,6750,13885
14580,2020-11-30,3호선,옥수,7777,8165,15942
14581,2020-11-30,3호선,압구정,27659,29372,57031
14582,2020-11-30,3호선,신사,25331,26469,51800
14583,2020-11-30,3호선,잠원,4151,4180,8331
14584,2020-11-30,3호선,고속터미널,31471,29481,60952
14585,2020-11-30,3호선,교대,12365,8315,20680
14586,2020-11-30,3호선,남부터미널,25603,26313,51916
14587,2020-11-30,3호선,양재,33871,37076,70947
14588,2020-11-30,3호선,매봉,11227,10738,21965
14589,2020-11-30,3호선,도곡,4909,4937,9846
14590,2020-11-30,3호선,대치,9179,9123,18302
14591,2020-11-30,3호선,학여울,1641,1617,3258
14592,2020-11-30,3호선,대청,8639,7958,16597
14593,2020-11-30,3호선,일원,8632,8508,17140
14594,2020-11-30,3호선,수서,14378,14599,28977
14595,2020-11-30,3호선,가락시장,8060,7875,15935
14596,2020-11-30,3호선,경찰병원,7079,7143,14222
14597,2020-11-30,3호선,오금,5620,4992,10612
14598,2020-11-30,3호선,주엽,7653,7612,15265
14599,2020-12-01,3호선,오금,5621,4994,10615
14600,2020-12-01,3호선,경찰병원,6969,7089,14058
14601,2020-12-01,3호선,가락시장,8172,7954,16126
14602,2020-12-01,3호선,수서,13695,13992,27687
14603,2020-12-01,3호선,일원,8669,8507,17176
14604,2020-12-01,3호선,대청,8529,7878,16407
14605,2020-12-01,3호선,학여울,1566,1578,3144
14606,2020-12-01,3호선,대치,8758,8800,17558
14607,2020-12-01,3호선,도곡,4788,4787,9575
14608,2020-12-01,3호선,매봉,11519,10902,22421
14609,2020-12-01,3호선,양재,34668,37303,71971
14610,2020-12-01,3호선,남부터미널,24971,25765,50736
14611,2020-12-01,3호선,교대,12384,8337,20721
14612,2020-12-01,3호선,고속터미널,30320,28993,59313
14613,2020-12-01,3호선,신사,25702,27050,52752
14614,2020-12-01,3호선,압구정,27951,29556,57507
14615,2020-12-01,3호선,옥수,7925,8232,16157
14616,2020-12-01,3호선,금호,7090,6783,13873
14617,2020-12-01,3호선,약수,11339,11211,22550
14618,2020-12-01,3호선,동대입구,6436,6737,13173
14619,2020-12-01,3호선,을지로3가,9447,9731,19178
14620,2020-12-01,3호선,종로3가,8799,10033,18832
14621,2020-12-01,3호선,안국,16326,16595,32921
14622,2020-12-01,3호선,경복궁,15472,15133,30605
14623,2020-12-01,3호선,독립문,6381,6536,12917
14624,2020-12-01,3호선,무악재,3537,3597,7134
14625,2020-12-01,3호선,홍제,15292,14749,30041
14626,2020-12-01,3호선,녹번,13440,12605,26045
14627,2020-12-01,3호선,불광,14888,15917,30805
14628,2020-12-01,3호선,연신내,33155,31236,64391
14629,2020-12-01,3호선,구파발,18233,17136,35369
14630,2020-12-01,3호선,지축,2946,2912,5858
14631,2020-12-01,3호선,잠원,4130,4123,8253
14632,2020-12-01,3호선,대화,11557,8926,20483
14633,2020-12-01,3호선,주엽,7669,7674,15343
14634,2020-12-01,3호선,정발산,5798,5715,11513
14635,2020-12-01,3호선,마두,6652,6920,13572
14636,2020-12-01,3호선,백석,8861,8996,17857
14637,2020-12-01,3호선,대곡,1586,1156,2742
14638,2020-12-01,3호선,화정,14390,15082,29472
14639,2020-12-01,3호선,원당,9950,9641,19591
14640,2020-12-01,3호선,삼송,15917,15659,31576
14641,2020-12-01,3호선,원흥,8262,7930,16192
14642,2020-12-02,3호선,지축,2914,2855,5769
14643,2020-12-02,3호선,구파발,18450,17286,35736
14644,2020-12-02,3호선,연신내,33921,31909,65830
14645,2020-12-02,3호선,불광,15043,16109,31152
14646,2020-12-02,3호선,녹번,13706,12791,26497
14647,2020-12-02,3호선,홍제,15557,15309,30866
14648,2020-12-02,3호선,무악재,3581,3653,7234
14649,2020-12-02,3호선,독립문,6480,6747,13227
14650,2020-12-02,3호선,경복궁,16458,15894,32352
14651,2020-12-02,3호선,안국,16455,16638,33093
14652,2020-12-02,3호선,종로3가,8936,10081,19017
14653,2020-12-02,3호선,을지로3가,9336,9487,18823
14654,2020-12-02,3호선,충무로,1,0,1
14655,2020-12-02,3호선,동대입구,6497,6754,13251
14656,2020-12-02,3호선,약수,11590,11363,22953
14657,2020-12-02,3호선,금호,7178,6970,14148
14658,2020-12-02,3호선,옥수,8044,8362,16406
14659,2020-12-02,3호선,압구정,28219,29820,58039
14660,2020-12-02,3호선,신사,25513,26585,52098
14661,2020-12-02,3호선,잠원,4138,4085,8223
14662,2020-12-02,3호선,고속터미널,30800,29762,60562
14663,2020-12-02,3호선,교대,12674,8462,21136
14664,2020-12-02,3호선,남부터미널,25129,25794,50923
14665,2020-12-02,3호선,양재,35174,37770,72944
14666,2020-12-02,3호선,매봉,11385,10721,22106
14667,2020-12-02,3호선,도곡,4986,4924,9910
14668,2020-12-02,3호선,대치,8974,8897,17871
14669,2020-12-02,3호선,학여울,1546,1573,3119
14670,2020-12-02,3호선,대청,9020,8352,17372
14671,2020-12-02,3호선,일원,8852,8773,17625
14672,2020-12-02,3호선,수서,13917,14029,27946
14673,2020-12-02,3호선,가락시장,8155,8121,16276
14674,2020-12-02,3호선,경찰병원,7207,7212,14419
14675,2020-12-02,3호선,오금,5572,5077,10649
14676,2020-12-02,3호선,원흥,8289,7993,16282
14677,2020-12-02,3호선,삼송,16161,15757,31918
14678,2020-12-02,3호선,원당,10122,9663,19785
14679,2020-12-02,3호선,화정,14723,15271,29994
14680,2020-12-02,3호선,대곡,1546,1189,2735
14681,2020-12-02,3호선,백석,8845,9126,17971
14682,2020-12-02,3호선,마두,6670,6900,13570
14683,2020-12-02,3호선,정발산,5981,5835,11816
14684,2020-12-02,3호선,주엽,7686,7879,15565
14685,2020-12-02,3호선,대화,11744,9335,21079
14686,2020-12-03,3호선,원흥,8258,7971,16229
14687,2020-12-03,3호선,삼송,16007,15739,31746
14688,2020-12-03,3호선,원당,9938,9608,19546
14689,2020-12-03,3호선,화정,14380,14992,29372
14690,2020-12-03,3호선,대곡,1515,1153,2668
14691,2020-12-03,3호선,백석,9065,8973,18038
14692,2020-12-03,3호선,마두,6583,6711,13294
14693,2020-12-03,3호선,정발산,5906,5773,11679
14694,2020-12-03,3호선,주엽,7487,7554,15041
14695,2020-12-03,3호선,대화,11298,9101,20399
14696,2020-12-03,3호선,오금,5585,4979,10564
14697,2020-12-03,3호선,경찰병원,6917,6950,13867
14698,2020-12-03,3호선,가락시장,8109,8022,16131
14699,2020-12-03,3호선,수서,14201,14350,28551
14700,2020-12-03,3호선,일원,8874,8691,17565
14701,2020-12-03,3호선,대청,8946,8215,17161
14702,2020-12-03,3호선,학여울,1606,1677,3283
14703,2020-12-03,3호선,대치,8761,8891,17652
14704,2020-12-03,3호선,도곡,5114,5108,10222
14705,2020-12-03,3호선,매봉,11236,10836,22072
14706,2020-12-03,3호선,양재,35062,37648,72710
14707,2020-12-03,3호선,남부터미널,25389,25812,51201
14708,2020-12-03,3호선,교대,12579,8385,20964
14709,2020-12-03,3호선,고속터미널,30969,30066,61035
14710,2020-12-03,3호선,잠원,4109,4143,8252
14711,2020-12-03,3호선,신사,25433,26471,51904
14712,2020-12-03,3호선,압구정,27799,29104,56903
14713,2020-12-03,3호선,옥수,7936,8273,16209
14714,2020-12-03,3호선,금호,7267,6951,14218
14715,2020-12-03,3호선,약수,11503,11258,22761
14716,2020-12-03,3호선,동대입구,6406,6845,13251
14717,2020-12-03,3호선,충무로,1,0,1
14718,2020-12-03,3호선,을지로3가,9274,9445,18719
14719,2020-12-03,3호선,종로3가,8882,9961,18843
14720,2020-12-03,3호선,안국,16222,16372,32594
14721,2020-12-03,3호선,경복궁,16257,15951,32208
14722,2020-12-03,3호선,독립문,6359,6555,12914
14723,2020-12-03,3호선,무악재,3442,3584,7026
14724,2020-12-03,3호선,홍제,15465,14815,30280
14725,2020-12-03,3호선,녹번,13459,12474,25933
14726,2020-12-03,3호선,불광,14938,15786,30724
14727,2020-12-03,3호선,연신내,33453,31572,65025
14728,2020-12-03,3호선,구파발,18394,17461,35855
14729,2020-12-03,3호선,지축,2924,2877,5801
14730,2020-12-04,3호선,화정,14539,15162,29701
14731,2020-12-04,3호선,대화,11687,9519,21206
14732,2020-12-04,3호선,주엽,7797,7899,15696
14733,2020-12-04,3호선,정발산,6195,6219,12414
14734,2020-12-04,3호선,마두,6709,6963,13672
14735,2020-12-04,3호선,백석,9039,9210,18249
14736,2020-12-04,3호선,원당,9991,9513,19504
14737,2020-12-04,3호선,삼송,15936,15711,31647
14738,2020-12-04,3호선,원흥,8261,7885,16146
14739,2020-12-04,3호선,대곡,1599,1201,2800
14740,2020-12-04,3호선,지축,2933,2893,5826
14741,2020-12-04,3호선,구파발,18174,17021,35195
14742,2020-12-04,3호선,연신내,33827,31931,65758
14743,2020-12-04,3호선,불광,14719,15952,30671
14744,2020-12-04,3호선,녹번,13652,12368,26020
14745,2020-12-04,3호선,홍제,15398,14995,30393
14746,2020-12-04,3호선,무악재,3503,3683,7186
14747,2020-12-04,3호선,독립문,6217,6430,12647
14748,2020-12-04,3호선,경복궁,16528,15868,32396
14749,2020-12-04,3호선,안국,15732,16174,31906
14750,2020-12-04,3호선,종로3가,8625,9719,18344
14751,2020-12-04,3호선,을지로3가,9393,9629,19022
14752,2020-12-04,3호선,충무로,3,0,3
14753,2020-12-04,3호선,동대입구,6261,6617,12878
14754,2020-12-04,3호선,약수,11772,11301,23073
14755,2020-12-04,3호선,금호,7315,6901,14216
14756,2020-12-04,3호선,옥수,8055,8273,16328
14757,2020-12-04,3호선,압구정,29243,31129,60372
14758,2020-12-04,3호선,신사,27626,28635,56261
14759,2020-12-04,3호선,잠원,4277,4181,8458
14760,2020-12-04,3호선,고속터미널,35847,38767,74614
14761,2020-12-04,3호선,교대,12986,8455,21441
14762,2020-12-04,3호선,남부터미널,27015,27770,54785
14763,2020-12-04,3호선,양재,36111,37479,73590
14764,2020-12-04,3호선,매봉,11517,10715,22232
14765,2020-12-04,3호선,도곡,4625,4659,9284
14766,2020-12-04,3호선,대치,9998,10051,20049
14767,2020-12-04,3호선,학여울,1595,1634,3229
14768,2020-12-04,3호선,대청,8818,8069,16887
14769,2020-12-04,3호선,일원,8443,8206,16649
14770,2020-12-04,3호선,수서,15289,15935,31224
14771,2020-12-04,3호선,가락시장,8431,8427,16858
14772,2020-12-04,3호선,경찰병원,6857,6889,13746
14773,2020-12-04,3호선,오금,5690,5076,10766
14774,2020-12-05,3호선,지축,1797,1784,3581
14775,2020-12-05,3호선,구파발,10927,10943,21870
14776,2020-12-05,3호선,연신내,23809,22247,46056
14777,2020-12-05,3호선,불광,9966,11193,21159
14778,2020-12-05,3호선,녹번,7660,6833,14493
14779,2020-12-05,3호선,홍제,9969,9558,19527
14780,2020-12-05,3호선,무악재,1996,2130,4126
14781,2020-12-05,3호선,독립문,4246,4228,8474
14782,2020-12-05,3호선,경복궁,8366,8652,17018
14783,2020-12-05,3호선,안국,7728,8709,16437
14784,2020-12-05,3호선,종로3가,3252,4426,7678
14785,2020-12-05,3호선,을지로3가,3230,3615,6845
14786,2020-12-05,3호선,동대입구,4280,4683,8963
14787,2020-12-05,3호선,약수,6989,6535,13524
14788,2020-12-05,3호선,금호,4612,4353,8965
14789,2020-12-05,3호선,옥수,5225,5343,10568
14790,2020-12-05,3호선,압구정,19064,19693,38757
14791,2020-12-05,3호선,신사,17458,17833,35291
14792,2020-12-05,3호선,잠원,2488,2368,4856
14793,2020-12-05,3호선,고속터미널,31759,32561,64320
14794,2020-12-05,3호선,교대,4937,3135,8072
14795,2020-12-05,3호선,남부터미널,14293,14494,28787
14796,2020-12-05,3호선,양재,15644,16985,32629
14797,2020-12-05,3호선,매봉,4558,4340,8898
14798,2020-12-05,3호선,도곡,2558,2558,5116
14799,2020-12-05,3호선,대치,6571,6159,12730
14800,2020-12-05,3호선,학여울,901,937,1838
14801,2020-12-05,3호선,대청,4524,4229,8753
14802,2020-12-05,3호선,일원,3654,3668,7322
14803,2020-12-05,3호선,수서,8961,9513,18474
14804,2020-12-05,3호선,가락시장,4998,4842,9840
14805,2020-12-05,3호선,경찰병원,3112,3060,6172
14806,2020-12-05,3호선,오금,2950,2721,5671
14807,2020-12-05,3호선,대화,6748,5983,12731
14808,2020-12-05,3호선,주엽,4624,4697,9321
14809,2020-12-05,3호선,정발산,4467,4459,8926
14810,2020-12-05,3호선,마두,3724,3827,7551
14811,2020-12-05,3호선,백석,6074,6273,12347
14812,2020-12-05,3호선,대곡,858,724,1582
14813,2020-12-05,3호선,화정,9365,9914,19279
14814,2020-12-05,3호선,원당,6253,6082,12335
14815,2020-12-05,3호선,삼송,10074,10037,20111
14816,2020-12-05,3호선,원흥,4977,4795,9772
14817,2020-12-06,3호선,정발산,3176,3086,6262
14818,2020-12-06,3호선,마두,2458,2495,4953
14819,2020-12-06,3호선,백석,4143,4077,8220
14820,2020-12-06,3호선,대곡,684,557,1241
14821,2020-12-06,3호선,화정,6702,6985,13687
14822,2020-12-06,3호선,원당,4514,4475,8989
14823,2020-12-06,3호선,삼송,7307,7155,14462
14824,2020-12-06,3호선,원흥,3497,3435,6932
14825,2020-12-06,3호선,대치,3993,3763,7756
14826,2020-12-06,3호선,도곡,1513,1619,3132
14827,2020-12-06,3호선,매봉,2966,2950,5916
14828,2020-12-06,3호선,양재,10200,11833,22033
14829,2020-12-06,3호선,남부터미널,9219,9767,18986
14830,2020-12-06,3호선,교대,2790,1808,4598
14831,2020-12-06,3호선,고속터미널,25639,24154,49793
14832,2020-12-06,3호선,잠원,1527,1607,3134
14833,2020-12-06,3호선,신사,8807,8994,17801
14834,2020-12-06,3호선,압구정,9723,10092,19815
14835,2020-12-06,3호선,옥수,3449,3774,7223
14836,2020-12-06,3호선,금호,3165,3086,6251
14837,2020-12-06,3호선,약수,4669,4515,9184
14838,2020-12-06,3호선,동대입구,9167,8758,17925
14839,2020-12-06,3호선,을지로3가,1763,1749,3512
14840,2020-12-06,3호선,종로3가,1976,2644,4620
14841,2020-12-06,3호선,안국,5194,5529,10723
14842,2020-12-06,3호선,경복궁,5934,6197,12131
14843,2020-12-06,3호선,독립문,2759,3102,5861
14844,2020-12-06,3호선,무악재,1367,1435,2802
14845,2020-12-06,3호선,홍제,6608,6446,13054
14846,2020-12-06,3호선,녹번,4940,4500,9440
14847,2020-12-06,3호선,불광,7301,8364,15665
14848,2020-12-06,3호선,연신내,16252,15234,31486
14849,2020-12-06,3호선,구파발,7954,8196,16150
14850,2020-12-06,3호선,지축,1228,1187,2415
14851,2020-12-06,3호선,오금,2028,1984,4012
14852,2020-12-06,3호선,경찰병원,1977,2033,4010
14853,2020-12-06,3호선,가락시장,2805,3106,5911
14854,2020-12-06,3호선,수서,7294,6754,14048
14855,2020-12-06,3호선,일원,2441,2651,5092
14856,2020-12-06,3호선,대청,2982,2878,5860
14857,2020-12-06,3호선,학여울,572,558,1130
14858,2020-12-06,3호선,대화,4692,4266,8958
14859,2020-12-06,3호선,주엽,3123,3052,6175
14860,2020-12-07,3호선,대화,11921,9338,21259
14861,2020-12-07,3호선,주엽,7753,7815,15568
14862,2020-12-07,3호선,정발산,5900,5622,11522
14863,2020-12-07,3호선,마두,6576,6858,13434
14864,2020-12-07,3호선,백석,8859,8896,17755
14865,2020-12-07,3호선,대곡,1596,1199,2795
14866,2020-12-07,3호선,화정,14506,15022,29528
14867,2020-12-07,3호선,원당,9851,9571,19422
14868,2020-12-07,3호선,삼송,16046,15769,31815
14869,2020-12-07,3호선,원흥,8106,7795,15901
14870,2020-12-07,3호선,지축,2996,3000,5996
14871,2020-12-07,3호선,구파발,18038,16796,34834
14872,2020-12-07,3호선,연신내,33092,31322,64414
14873,2020-12-07,3호선,불광,14396,15333,29729
14874,2020-12-07,3호선,녹번,13335,12419,25754
14875,2020-12-07,3호선,홍제,15391,14851,30242
14876,2020-12-07,3호선,무악재,3419,3511,6930
14877,2020-12-07,3호선,독립문,6209,6384,12593
14878,2020-12-07,3호선,경복궁,14855,14567,29422
14879,2020-12-07,3호선,안국,15031,15308,30339
14880,2020-12-07,3호선,종로3가,8273,9246,17519
14881,2020-12-07,3호선,을지로3가,9027,9213,18240
14882,2020-12-07,3호선,충무로,1,0,1
14883,2020-12-07,3호선,동대입구,6141,6346,12487
14884,2020-12-07,3호선,약수,11418,11113,22531
14885,2020-12-07,3호선,금호,7017,6737,13754
14886,2020-12-07,3호선,옥수,7601,8080,15681
14887,2020-12-07,3호선,압구정,26639,28245,54884
14888,2020-12-07,3호선,신사,24841,25918,50759
14889,2020-12-07,3호선,잠원,4047,4020,8067
14890,2020-12-07,3호선,고속터미널,30274,28783,59057
14891,2020-12-07,3호선,교대,12306,8385,20691
14892,2020-12-07,3호선,남부터미널,25158,25742,50900
14893,2020-12-07,3호선,오금,5679,4979,10658
14894,2020-12-07,3호선,경찰병원,7002,7072,14074
14895,2020-12-07,3호선,가락시장,7882,7710,15592
14896,2020-12-07,3호선,수서,14156,14322,28478
14897,2020-12-07,3호선,일원,8477,8395,16872
14898,2020-12-07,3호선,대청,8706,8021,16727
14899,2020-12-07,3호선,학여울,1555,1602,3157
14900,2020-12-07,3호선,대치,9567,9600,19167
14901,2020-12-07,3호선,도곡,4775,4724,9499
14902,2020-12-07,3호선,매봉,11089,10483,21572
14903,2020-12-07,3호선,양재,33610,36795,70405
14904,2020-12-08,3호선,지축,2809,2873,5682
14905,2020-12-08,3호선,구파발,17410,16328,33738
14906,2020-12-08,3호선,연신내,31993,29909,61902
14907,2020-12-08,3호선,불광,13789,14792,28581
14908,2020-12-08,3호선,녹번,12954,12192,25146
14909,2020-12-08,3호선,홍제,14947,14359,29306
14910,2020-12-08,3호선,무악재,3318,3379,6697
14911,2020-12-08,3호선,독립문,6056,6380,12436
14912,2020-12-08,3호선,경복궁,14932,14319,29251
14913,2020-12-08,3호선,안국,15174,15364,30538
14914,2020-12-08,3호선,종로3가,8292,9270,17562
14915,2020-12-08,3호선,을지로3가,8935,9207,18142
14916,2020-12-08,3호선,동대입구,6241,6575,12816
14917,2020-12-08,3호선,약수,10961,10691,21652
14918,2020-12-08,3호선,금호,6751,6464,13215
14919,2020-12-08,3호선,옥수,7256,7754,15010
14920,2020-12-08,3호선,압구정,26147,27631,53778
14921,2020-12-08,3호선,신사,24508,25560,50068
14922,2020-12-08,3호선,잠원,3873,3815,7688
14923,2020-12-08,3호선,고속터미널,28382,27837,56219
14924,2020-12-08,3호선,교대,11934,7983,19917
14925,2020-12-08,3호선,남부터미널,23799,24726,48525
14926,2020-12-08,3호선,양재,33536,35913,69449
14927,2020-12-08,3호선,매봉,10839,10320,21159
14928,2020-12-08,3호선,도곡,4539,4538,9077
14929,2020-12-08,3호선,대치,8727,8794,17521
14930,2020-12-08,3호선,학여울,1417,1444,2861
14931,2020-12-08,3호선,대청,8777,8074,16851
14932,2020-12-08,3호선,일원,8235,8185,16420
14933,2020-12-08,3호선,수서,13270,13341,26611
14934,2020-12-08,3호선,가락시장,7595,7469,15064
14935,2020-12-08,3호선,경찰병원,6711,6751,13462
14936,2020-12-08,3호선,오금,5439,4900,10339
14937,2020-12-08,3호선,대화,11241,9020,20261
14938,2020-12-08,3호선,주엽,7212,7362,14574
14939,2020-12-08,3호선,정발산,5614,5367,10981
14940,2020-12-08,3호선,마두,6102,6365,12467
14941,2020-12-08,3호선,백석,8668,8659,17327
14942,2020-12-08,3호선,대곡,1563,1151,2714
14943,2020-12-08,3호선,화정,13930,14445,28375
14944,2020-12-08,3호선,원당,9528,9083,18611
14945,2020-12-08,3호선,삼송,15256,15211,30467
14946,2020-12-08,3호선,원흥,7848,7569,15417
14947,2020-12-09,3호선,대화,10976,8775,19751
14948,2020-12-09,3호선,주엽,7195,7278,14473
14949,2020-12-09,3호선,정발산,5679,5510,11189
14950,2020-12-09,3호선,마두,6171,6374,12545
14951,2020-12-09,3호선,백석,8239,8349,16588
14952,2020-12-09,3호선,대곡,1472,1132,2604
14953,2020-12-09,3호선,화정,13643,14131,27774
14954,2020-12-09,3호선,원당,9399,9014,18413
14955,2020-12-09,3호선,삼송,15029,14987,30016
14956,2020-12-09,3호선,원흥,7846,7518,15364
14957,2020-12-09,3호선,오금,5325,4764,10089
14958,2020-12-09,3호선,경찰병원,6686,6657,13343
14959,2020-12-09,3호선,가락시장,7733,7554,15287
14960,2020-12-09,3호선,수서,13173,13374,26547
14961,2020-12-09,3호선,일원,8200,7964,16164
14962,2020-12-09,3호선,대청,8553,7871,16424
14963,2020-12-09,3호선,학여울,1434,1444,2878
14964,2020-12-09,3호선,대치,8557,8605,17162
14965,2020-12-09,3호선,도곡,4625,4584,9209
14966,2020-12-09,3호선,매봉,10843,10318,21161
14967,2020-12-09,3호선,양재,32844,35283,68127
14968,2020-12-09,3호선,남부터미널,23598,24297,47895
14969,2020-12-09,3호선,교대,11778,7964,19742
14970,2020-12-09,3호선,고속터미널,28589,27677,56266
14971,2020-12-09,3호선,잠원,3792,3726,7518
14972,2020-12-09,3호선,신사,23494,24679,48173
14973,2020-12-09,3호선,압구정,25199,26909,52108
14974,2020-12-09,3호선,옥수,7212,7621,14833
14975,2020-12-09,3호선,금호,6699,6427,13126
14976,2020-12-09,3호선,약수,10773,10535,21308
14977,2020-12-09,3호선,동대입구,6008,6350,12358
14978,2020-12-09,3호선,을지로3가,8824,9060,17884
14979,2020-12-09,3호선,종로3가,8218,9118,17336
14980,2020-12-09,3호선,안국,14696,15043,29739
14981,2020-12-09,3호선,경복궁,14995,14429,29424
14982,2020-12-09,3호선,독립문,5887,6193,12080
14983,2020-12-09,3호선,무악재,3331,3378,6709
14984,2020-12-09,3호선,홍제,15006,14482,29488
14985,2020-12-09,3호선,녹번,12792,11959,24751
14986,2020-12-09,3호선,불광,13941,14874,28815
14987,2020-12-09,3호선,연신내,31944,30032,61976
14988,2020-12-09,3호선,구파발,17445,16415,33860
14989,2020-12-09,3호선,지축,2801,2761,5562
14990,2020-12-10,3호선,대화,10870,8499,19369
14991,2020-12-10,3호선,주엽,7124,7251,14375
14992,2020-12-10,3호선,정발산,5511,5381,10892
14993,2020-12-10,3호선,마두,6100,6323,12423
14994,2020-12-10,3호선,백석,8520,8583,17103
14995,2020-12-10,3호선,대곡,1438,1087,2525
14996,2020-12-10,3호선,화정,13755,14114,27869
14997,2020-12-10,3호선,원당,9447,9057,18504
14998,2020-12-10,3호선,삼송,15186,15149,30335
14999,2020-12-10,3호선,원흥,7795,7627,15422
15000,2020-12-10,3호선,오금,5374,4837,10211
15001,2020-12-10,3호선,경찰병원,6542,6585,13127
15002,2020-12-10,3호선,가락시장,7851,7623,15474
15003,2020-12-10,3호선,수서,13118,13391,26509
15004,2020-12-10,3호선,일원,8149,7971,16120
15005,2020-12-10,3호선,대청,8407,7805,16212
15006,2020-12-10,3호선,학여울,1485,1467,2952
15007,2020-12-10,3호선,대치,8503,8463,16966
15008,2020-12-10,3호선,도곡,4560,4536,9096
15009,2020-12-10,3호선,매봉,10677,10192,20869
15010,2020-12-10,3호선,양재,33242,35921,69163
15011,2020-12-10,3호선,남부터미널,23810,24601,48411
15012,2020-12-10,3호선,교대,11931,8159,20090
15013,2020-12-10,3호선,고속터미널,29150,28752,57902
15014,2020-12-10,3호선,잠원,3866,3793,7659
15015,2020-12-10,3호선,신사,24054,25228,49282
15016,2020-12-10,3호선,압구정,25385,26880,52265
15017,2020-12-10,3호선,옥수,7349,7587,14936
15018,2020-12-10,3호선,금호,6750,6431,13181
15019,2020-12-10,3호선,약수,10957,10699,21656
15020,2020-12-10,3호선,동대입구,6044,6479,12523
15021,2020-12-10,3호선,충무로,1,0,1
15022,2020-12-10,3호선,을지로3가,8595,8958,17553
15023,2020-12-10,3호선,종로3가,8084,9107,17191
15024,2020-12-10,3호선,안국,14732,15062,29794
15025,2020-12-10,3호선,경복궁,14724,14557,29281
15026,2020-12-10,3호선,독립문,5963,6327,12290
15027,2020-12-10,3호선,무악재,3317,3389,6706
15028,2020-12-10,3호선,홍제,15030,14293,29323
15029,2020-12-10,3호선,녹번,12938,11903,24841
15030,2020-12-10,3호선,불광,13652,14815,28467
15031,2020-12-10,3호선,연신내,31874,29932,61806
15032,2020-12-10,3호선,구파발,17318,16253,33571
15033,2020-12-10,3호선,지축,2737,2732,5469
15034,2020-12-11,3호선,대화,11097,8866,19963
15035,2020-12-11,3호선,주엽,7276,7336,14612
15036,2020-12-11,3호선,정발산,5689,5637,11326
15037,2020-12-11,3호선,마두,6145,6442,12587
15038,2020-12-11,3호선,백석,8573,8867,17440
15039,2020-12-11,3호선,대곡,1457,1153,2610
15040,2020-12-11,3호선,화정,13949,14498,28447
15041,2020-12-11,3호선,원당,9572,9219,18791
15042,2020-12-11,3호선,삼송,15181,15044,30225
15043,2020-12-11,3호선,원흥,7897,7638,15535
15044,2020-12-11,3호선,오금,5483,4792,10275
15045,2020-12-11,3호선,경찰병원,6594,6596,13190
15046,2020-12-11,3호선,가락시장,8021,7882,15903
15047,2020-12-11,3호선,수서,13950,14335,28285
15048,2020-12-11,3호선,일원,7927,7665,15592
15049,2020-12-11,3호선,대청,8604,7752,16356
15050,2020-12-11,3호선,학여울,1490,1470,2960
15051,2020-12-11,3호선,대치,8684,8749,17433
15052,2020-12-11,3호선,도곡,4405,4416,8821
15053,2020-12-11,3호선,매봉,10607,10168,20775
15054,2020-12-11,3호선,양재,33979,35255,69234
15055,2020-12-11,3호선,남부터미널,25268,26166,51434
15056,2020-12-11,3호선,교대,12028,7992,20020
15057,2020-12-11,3호선,고속터미널,33818,36480,70298
15058,2020-12-11,3호선,잠원,4029,3974,8003
15059,2020-12-11,3호선,신사,25313,26658,51971
15060,2020-12-11,3호선,압구정,27109,28674,55783
15061,2020-12-11,3호선,옥수,7636,7774,15410
15062,2020-12-11,3호선,금호,6995,6627,13622
15063,2020-12-11,3호선,약수,11088,10868,21956
15064,2020-12-11,3호선,동대입구,5982,6242,12224
15065,2020-12-11,3호선,충무로,3,0,3
15066,2020-12-11,3호선,을지로3가,8705,8911,17616
15067,2020-12-11,3호선,종로3가,7812,8965,16777
15068,2020-12-11,3호선,안국,14544,14944,29488
15069,2020-12-11,3호선,경복궁,14766,14617,29383
15070,2020-12-11,3호선,독립문,5990,6123,12113
15071,2020-12-11,3호선,무악재,3357,3381,6738
15072,2020-12-11,3호선,홍제,15070,14550,29620
15073,2020-12-11,3호선,녹번,12926,11809,24735
15074,2020-12-11,3호선,불광,13792,14625,28417
15075,2020-12-11,3호선,연신내,32589,30626,63215
15076,2020-12-11,3호선,구파발,17384,16189,33573
15077,2020-12-11,3호선,지축,2847,2791,5638
15078,2020-12-12,3호선,대곡,869,737,1606
15079,2020-12-12,3호선,화정,8586,8955,17541
15080,2020-12-12,3호선,원당,5826,5605,11431
15081,2020-12-12,3호선,삼송,9179,9091,18270
15082,2020-12-12,3호선,원흥,4405,4274,8679
15083,2020-12-12,3호선,오금,2381,2239,4620
15084,2020-12-12,3호선,경찰병원,2812,2701,5513
15085,2020-12-12,3호선,가락시장,4585,4394,8979
15086,2020-12-12,3호선,수서,7872,8076,15948
15087,2020-12-12,3호선,일원,3242,3222,6464
15088,2020-12-12,3호선,대청,3988,3679,7667
15089,2020-12-12,3호선,학여울,719,683,1402
15090,2020-12-12,3호선,대치,5053,4836,9889
15091,2020-12-12,3호선,도곡,2173,2156,4329
15092,2020-12-12,3호선,매봉,4024,3798,7822
15093,2020-12-12,3호선,양재,13199,14171,27370
15094,2020-12-12,3호선,남부터미널,12844,13212,26056
15095,2020-12-12,3호선,교대,4158,2625,6783
15096,2020-12-12,3호선,고속터미널,28371,29403,57774
15097,2020-12-12,3호선,잠원,2153,2073,4226
15098,2020-12-12,3호선,신사,14868,15317,30185
15099,2020-12-12,3호선,압구정,16856,17433,34289
15100,2020-12-12,3호선,옥수,4699,4737,9436
15101,2020-12-12,3호선,금호,4248,3947,8195
15102,2020-12-12,3호선,약수,6397,5963,12360
15103,2020-12-12,3호선,동대입구,4085,4413,8498
15104,2020-12-12,3호선,을지로3가,2928,3260,6188
15105,2020-12-12,3호선,종로3가,2769,3679,6448
15106,2020-12-12,3호선,안국,6173,6784,12957
15107,2020-12-12,3호선,경복궁,7527,7665,15192
15108,2020-12-12,3호선,독립문,3915,4060,7975
15109,2020-12-12,3호선,무악재,1857,1907,3764
15110,2020-12-12,3호선,홍제,9271,8990,18261
15111,2020-12-12,3호선,녹번,6980,6295,13275
15112,2020-12-12,3호선,불광,9410,10648,20058
15113,2020-12-12,3호선,연신내,21433,20150,41583
15114,2020-12-12,3호선,구파발,9932,10004,19936
15115,2020-12-12,3호선,지축,1656,1639,3295
15116,2020-12-12,3호선,백석,5449,5644,11093
15117,2020-12-12,3호선,마두,3439,3509,6948
15118,2020-12-12,3호선,정발산,3857,3852,7709
15119,2020-12-12,3호선,주엽,4150,4236,8386
15120,2020-12-12,3호선,대화,5771,5338,11109
15121,2020-12-13,3호선,지축,1023,983,2006
15122,2020-12-13,3호선,구파발,6488,6422,12910
15123,2020-12-13,3호선,연신내,13525,12852,26377
15124,2020-12-13,3호선,불광,5906,6978,12884
15125,2020-12-13,3호선,녹번,4354,3821,8175
15126,2020-12-13,3호선,홍제,5613,5483,11096
15127,2020-12-13,3호선,무악재,1144,1177,2321
15128,2020-12-13,3호선,독립문,2402,2482,4884
15129,2020-12-13,3호선,경복궁,4877,5041,9918
15130,2020-12-13,3호선,안국,3823,4031,7854
15131,2020-12-13,3호선,종로3가,1602,1975,3577
15132,2020-12-13,3호선,을지로3가,1504,1481,2985
15133,2020-12-13,3호선,동대입구,2934,3223,6157
15134,2020-12-13,3호선,약수,3647,3517,7164
15135,2020-12-13,3호선,금호,2556,2551,5107
15136,2020-12-13,3호선,옥수,2711,3010,5721
15137,2020-12-13,3호선,압구정,7443,7912,15355
15138,2020-12-13,3호선,신사,6745,7006,13751
15139,2020-12-13,3호선,잠원,1096,1156,2252
15140,2020-12-13,3호선,고속터미널,22064,20735,42799
15141,2020-12-13,3호선,교대,2085,1480,3565
15142,2020-12-13,3호선,남부터미널,8365,8542,16907
15143,2020-12-13,3호선,양재,7559,8888,16447
15144,2020-12-13,3호선,매봉,2461,2539,5000
15145,2020-12-13,3호선,도곡,1204,1161,2365
15146,2020-12-13,3호선,대치,2576,2585,5161
15147,2020-12-13,3호선,학여울,397,425,822
15148,2020-12-13,3호선,대청,2414,2335,4749
15149,2020-12-13,3호선,일원,2008,2034,4042
15150,2020-12-13,3호선,수서,5739,5437,11176
15151,2020-12-13,3호선,가락시장,2256,2509,4765
15152,2020-12-13,3호선,경찰병원,1813,1802,3615
15153,2020-12-13,3호선,오금,1657,1606,3263
15154,2020-12-13,3호선,원흥,2928,2791,5719
15155,2020-12-13,3호선,삼송,6177,6020,12197
15156,2020-12-13,3호선,원당,3730,3563,7293
15157,2020-12-13,3호선,화정,5580,5848,11428
15158,2020-12-13,3호선,대곡,576,468,1044
15159,2020-12-13,3호선,백석,3794,3697,7491
15160,2020-12-13,3호선,마두,2064,2085,4149
15161,2020-12-13,3호선,정발산,2847,2642,5489
15162,2020-12-13,3호선,주엽,2580,2540,5120
15163,2020-12-13,3호선,대화,4059,3732,7791
15164,2020-12-14,3호선,지축,2540,2546,5086
15165,2020-12-14,3호선,구파발,16130,15078,31208
15166,2020-12-14,3호선,연신내,29395,27565,56960
15167,2020-12-14,3호선,불광,12616,13386,26002
15168,2020-12-14,3호선,녹번,11895,11115,23010
15169,2020-12-14,3호선,홍제,13203,13009,26212
15170,2020-12-14,3호선,무악재,3075,3154,6229
15171,2020-12-14,3호선,독립문,5169,5364,10533
15172,2020-12-14,3호선,경복궁,13235,12970,26205
15173,2020-12-14,3호선,안국,13580,13426,27006
15174,2020-12-14,3호선,종로3가,7689,8560,16249
15175,2020-12-14,3호선,을지로3가,8343,8546,16889
15176,2020-12-14,3호선,동대입구,5454,5745,11199
15177,2020-12-14,3호선,약수,10103,9928,20031
15178,2020-12-14,3호선,금호,6153,6059,12212
15179,2020-12-14,3호선,옥수,6469,6952,13421
15180,2020-12-14,3호선,압구정,24002,25490,49492
15181,2020-12-14,3호선,신사,22638,23484,46122
15182,2020-12-14,3호선,잠원,3570,3636,7206
15183,2020-12-14,3호선,고속터미널,27265,25549,52814
15184,2020-12-14,3호선,교대,10875,7356,18231
15185,2020-12-14,3호선,남부터미널,22357,23196,45553
15186,2020-12-14,3호선,양재,30654,33248,63902
15187,2020-12-14,3호선,매봉,9996,9364,19360
15188,2020-12-14,3호선,도곡,4216,4286,8502
15189,2020-12-14,3호선,대치,7554,7524,15078
15190,2020-12-14,3호선,학여울,1307,1358,2665
15191,2020-12-14,3호선,대청,7634,7001,14635
15192,2020-12-14,3호선,일원,7803,7707,15510
15193,2020-12-14,3호선,수서,12384,12693,25077
15194,2020-12-14,3호선,가락시장,7078,6781,13859
15195,2020-12-14,3호선,경찰병원,6403,6494,12897
15196,2020-12-14,3호선,오금,4947,4456,9403
15197,2020-12-14,3호선,삼송,13757,13647,27404
15198,2020-12-14,3호선,원당,8611,8188,16799
15199,2020-12-14,3호선,화정,12631,13054,25685
15200,2020-12-14,3호선,대곡,1389,1037,2426
15201,2020-12-14,3호선,백석,7881,7966,15847
15202,2020-12-14,3호선,마두,5535,5724,11259
15203,2020-12-14,3호선,정발산,4975,4835,9810
15204,2020-12-14,3호선,주엽,6534,6521,13055
15205,2020-12-14,3호선,대화,10232,8090,18322
15206,2020-12-14,3호선,원흥,7133,6882,14015
15207,2020-12-15,3호선,오금,4987,4431,9418
15208,2020-12-15,3호선,경찰병원,6231,6326,12557
15209,2020-12-15,3호선,가락시장,6973,6818,13791
15210,2020-12-15,3호선,수서,11698,12168,23866
15211,2020-12-15,3호선,일원,7579,7554,15133
15212,2020-12-15,3호선,대청,7660,7020,14680
15213,2020-12-15,3호선,학여울,1227,1287,2514
15214,2020-12-15,3호선,대치,7539,7560,15099
15215,2020-12-15,3호선,도곡,4152,4158,8310
15216,2020-12-15,3호선,매봉,9988,9525,19513
15217,2020-12-15,3호선,양재,30765,32737,63502
15218,2020-12-15,3호선,남부터미널,21968,22495,44463
15219,2020-12-15,3호선,교대,10594,7337,17931
15220,2020-12-15,3호선,고속터미널,26161,25182,51343
15221,2020-12-15,3호선,잠원,3526,3506,7032
15222,2020-12-15,3호선,신사,22936,23683,46619
15223,2020-12-15,3호선,압구정,24076,25459,49535
15224,2020-12-15,3호선,옥수,6508,6913,13421
15225,2020-12-15,3호선,금호,6116,5946,12062
15226,2020-12-15,3호선,약수,9894,9723,19617
15227,2020-12-15,3호선,동대입구,5658,5771,11429
15228,2020-12-15,3호선,을지로3가,8384,8587,16971
15229,2020-12-15,3호선,종로3가,7848,8630,16478
15230,2020-12-15,3호선,안국,13868,13598,27466
15231,2020-12-15,3호선,경복궁,13165,12797,25962
15232,2020-12-15,3호선,독립문,5092,5401,10493
15233,2020-12-15,3호선,무악재,2963,3045,6008
15234,2020-12-15,3호선,홍제,13277,13081,26358
15235,2020-12-15,3호선,녹번,11979,11200,23179
15236,2020-12-15,3호선,불광,12538,13181,25719
15237,2020-12-15,3호선,연신내,29271,27630,56901
15238,2020-12-15,3호선,구파발,15914,14918,30832
15239,2020-12-15,3호선,지축,2506,2516,5022
15240,2020-12-15,3호선,원흥,7011,6667,13678
15241,2020-12-15,3호선,지축,1,0,1
15242,2020-12-15,3호선,삼송,13347,13403,26750
15243,2020-12-15,3호선,원당,8378,8057,16435
15244,2020-12-15,3호선,화정,12444,13102,25546
15245,2020-12-15,3호선,대곡,1268,914,2182
15246,2020-12-15,3호선,백석,7833,7934,15767
15247,2020-12-15,3호선,마두,5415,5645,11060
15248,2020-12-15,3호선,정발산,4982,4806,9788
15249,2020-12-15,3호선,주엽,6329,6324,12653
15250,2020-12-15,3호선,대화,9969,7954,17923
15251,2020-12-16,3호선,대화,9874,7983,17857
15252,2020-12-16,3호선,주엽,6232,6268,12500
15253,2020-12-16,3호선,정발산,4842,4779,9621
15254,2020-12-16,3호선,마두,5347,5627,10974
15255,2020-12-16,3호선,백석,7677,7686,15363
15256,2020-12-16,3호선,대곡,1306,946,2252
15257,2020-12-16,3호선,화정,12138,12655,24793
15258,2020-12-16,3호선,원당,8344,7948,16292
15259,2020-12-16,3호선,삼송,13378,13382,26760
15260,2020-12-16,3호선,원흥,6869,6651,13520
15261,2020-12-16,3호선,지축,2380,2368,4748
15262,2020-12-16,3호선,구파발,15475,14518,29993
15263,2020-12-16,3호선,연신내,29012,27310,56322
15264,2020-12-16,3호선,불광,12434,13246,25680
15265,2020-12-16,3호선,녹번,11909,10926,22835
15266,2020-12-16,3호선,홍제,13250,12746,25996
15267,2020-12-16,3호선,무악재,2982,3095,6077
15268,2020-12-16,3호선,독립문,5128,5371,10499
15269,2020-12-16,3호선,경복궁,13352,12876,26228
15270,2020-12-16,3호선,안국,13624,13497,27121
15271,2020-12-16,3호선,종로3가,7705,8628,16333
15272,2020-12-16,3호선,을지로3가,8335,8496,16831
15273,2020-12-16,3호선,동대입구,5431,5714,11145
15274,2020-12-16,3호선,약수,9898,9713,19611
15275,2020-12-16,3호선,금호,6125,5872,11997
15276,2020-12-16,3호선,옥수,6386,6774,13160
15277,2020-12-16,3호선,압구정,23591,25001,48592
15278,2020-12-16,3호선,신사,22138,23102,45240
15279,2020-12-16,3호선,잠원,3433,3439,6872
15280,2020-12-16,3호선,고속터미널,26282,25342,51624
15281,2020-12-16,3호선,교대,10805,7266,18071
15282,2020-12-16,3호선,남부터미널,21667,22348,44015
15283,2020-12-16,3호선,양재,30579,32850,63429
15284,2020-12-16,3호선,매봉,9873,9310,19183
15285,2020-12-16,3호선,도곡,4172,4122,8294
15286,2020-12-16,3호선,대치,7414,7440,14854
15287,2020-12-16,3호선,학여울,1246,1277,2523
15288,2020-12-16,3호선,대청,7155,6489,13644
15289,2020-12-16,3호선,일원,7509,7399,14908
15290,2020-12-16,3호선,수서,11723,12030,23753
15291,2020-12-16,3호선,가락시장,6889,6701,13590
15292,2020-12-16,3호선,경찰병원,6125,6156,12281
15293,2020-12-16,3호선,오금,4917,4352,9269
15294,2020-12-17,3호선,대화,9952,7959,17911
15295,2020-12-17,3호선,주엽,6276,6391,12667
15296,2020-12-17,3호선,정발산,4965,4902,9867
15297,2020-12-17,3호선,마두,5463,5681,11144
15298,2020-12-17,3호선,백석,7820,7926,15746
15299,2020-12-17,3호선,대곡,1297,929,2226
15300,2020-12-17,3호선,화정,12339,12874,25213
15301,2020-12-17,3호선,원당,8497,8059,16556
15302,2020-12-17,3호선,삼송,13719,13626,27345
15303,2020-12-17,3호선,원흥,7070,6752,13822
15304,2020-12-17,3호선,오금,4798,4361,9159
15305,2020-12-17,3호선,경찰병원,6143,6319,12462
15306,2020-12-17,3호선,가락시장,6974,6875,13849
15307,2020-12-17,3호선,수서,11917,12275,24192
15308,2020-12-17,3호선,일원,7746,7624,15370
15309,2020-12-17,3호선,대청,7403,6823,14226
15310,2020-12-17,3호선,학여울,1361,1339,2700
15311,2020-12-17,3호선,대치,7487,7515,15002
15312,2020-12-17,3호선,도곡,4094,4294,8388
15313,2020-12-17,3호선,매봉,9902,9332,19234
15314,2020-12-17,3호선,양재,30548,32775,63323
15315,2020-12-17,3호선,남부터미널,21849,22488,44337
15316,2020-12-17,3호선,교대,10827,7285,18112
15317,2020-12-17,3호선,고속터미널,26806,26323,53129
15318,2020-12-17,3호선,잠원,3536,3517,7053
15319,2020-12-17,3호선,신사,22362,23331,45693
15320,2020-12-17,3호선,압구정,23584,24846,48430
15321,2020-12-17,3호선,옥수,6665,6954,13619
15322,2020-12-17,3호선,금호,6368,6104,12472
15323,2020-12-17,3호선,약수,10052,9844,19896
15324,2020-12-17,3호선,동대입구,5423,5715,11138
15325,2020-12-17,3호선,충무로,2,0,2
15326,2020-12-17,3호선,을지로3가,8322,8574,16896
15327,2020-12-17,3호선,종로3가,7785,8689,16474
15328,2020-12-17,3호선,안국,13717,13775,27492
15329,2020-12-17,3호선,경복궁,13389,12936,26325
15330,2020-12-17,3호선,독립문,5496,5720,11216
15331,2020-12-17,3호선,무악재,3030,3039,6069
15332,2020-12-17,3호선,홍제,13501,12999,26500
15333,2020-12-17,3호선,녹번,12056,11088,23144
15334,2020-12-17,3호선,불광,12675,13580,26255
15335,2020-12-17,3호선,연신내,29190,27525,56715
15336,2020-12-17,3호선,구파발,16079,15067,31146
15337,2020-12-17,3호선,지축,2457,2437,4894
15338,2020-12-18,3호선,오금,5054,4485,9539
15339,2020-12-18,3호선,경찰병원,6266,6345,12611
15340,2020-12-18,3호선,가락시장,7572,7430,15002
15341,2020-12-18,3호선,수서,12799,13255,26054
15342,2020-12-18,3호선,일원,8010,7735,15745
15343,2020-12-18,3호선,대청,7525,7004,14529
15344,2020-12-18,3호선,학여울,1376,1397,2773
15345,2020-12-18,3호선,대치,7967,7894,15861
15346,2020-12-18,3호선,도곡,4238,4231,8469
15347,2020-12-18,3호선,매봉,10096,9427,19523
15348,2020-12-18,3호선,양재,32332,33660,65992
15349,2020-12-18,3호선,남부터미널,23634,24367,48001
15350,2020-12-18,3호선,교대,11339,7531,18870
15351,2020-12-18,3호선,고속터미널,30784,32645,63429
15352,2020-12-18,3호선,잠원,3676,3657,7333
15353,2020-12-18,3호선,신사,24103,24862,48965
15354,2020-12-18,3호선,압구정,26158,27646,53804
15355,2020-12-18,3호선,옥수,6926,7300,14226
15356,2020-12-18,3호선,금호,6554,6211,12765
15357,2020-12-18,3호선,약수,10527,10333,20860
15358,2020-12-18,3호선,동대입구,5712,5935,11647
15359,2020-12-18,3호선,을지로3가,8419,8747,17166
15360,2020-12-18,3호선,종로3가,7701,8690,16391
15361,2020-12-18,3호선,안국,14168,14323,28491
15362,2020-12-18,3호선,경복궁,14165,13564,27729
15363,2020-12-18,3호선,독립문,5749,5905,11654
15364,2020-12-18,3호선,무악재,3161,3190,6351
15365,2020-12-18,3호선,홍제,14421,13971,28392
15366,2020-12-18,3호선,녹번,12344,11382,23726
15367,2020-12-18,3호선,불광,13383,14381,27764
15368,2020-12-18,3호선,연신내,31053,29184,60237
15369,2020-12-18,3호선,구파발,16458,15612,32070
15370,2020-12-18,3호선,지축,2614,2525,5139
15371,2020-12-18,3호선,원흥,7337,7027,14364
15372,2020-12-18,3호선,삼송,14255,14364,28619
15373,2020-12-18,3호선,원당,8875,8590,17465
15374,2020-12-18,3호선,화정,13348,13882,27230
15375,2020-12-18,3호선,대곡,1419,1011,2430
15376,2020-12-18,3호선,백석,8179,8373,16552
15377,2020-12-18,3호선,마두,5879,6229,12108
15378,2020-12-18,3호선,정발산,5408,5274,10682
15379,2020-12-18,3호선,주엽,6713,7032,13745
15380,2020-12-18,3호선,대화,10319,8310,18629
15381,2020-12-18,3호선,지축,1,0,1
15382,2020-12-19,3호선,대화,5389,4967,10356
15383,2020-12-19,3호선,지축,1549,1506,3055
15384,2020-12-19,3호선,구파발,9192,9173,18365
15385,2020-12-19,3호선,연신내,19489,18504,37993
15386,2020-12-19,3호선,불광,8704,9594,18298
15387,2020-12-19,3호선,녹번,6436,5796,12232
15388,2020-12-19,3호선,홍제,8444,8158,16602
15389,2020-12-19,3호선,무악재,1708,1710,3418
15390,2020-12-19,3호선,독립문,3302,3355,6657
15391,2020-12-19,3호선,경복궁,6279,6175,12454
15392,2020-12-19,3호선,안국,5368,5797,11165
15393,2020-12-19,3호선,종로3가,2673,3510,6183
15394,2020-12-19,3호선,을지로3가,2808,3098,5906
15395,2020-12-19,3호선,충무로,1,0,1
15396,2020-12-19,3호선,동대입구,4096,4250,8346
15397,2020-12-19,3호선,약수,5942,5611,11553
15398,2020-12-19,3호선,금호,3900,3716,7616
15399,2020-12-19,3호선,옥수,4177,4273,8450
15400,2020-12-19,3호선,압구정,16349,16786,33135
15401,2020-12-19,3호선,신사,13934,14477,28411
15402,2020-12-19,3호선,잠원,1989,1883,3872
15403,2020-12-19,3호선,고속터미널,25550,26467,52017
15404,2020-12-19,3호선,교대,3664,2279,5943
15405,2020-12-19,3호선,남부터미널,11336,11547,22883
15406,2020-12-19,3호선,양재,12178,13137,25315
15407,2020-12-19,3호선,매봉,3798,3641,7439
15408,2020-12-19,3호선,도곡,2180,2076,4256
15409,2020-12-19,3호선,대치,4554,4365,8919
15410,2020-12-19,3호선,학여울,613,578,1191
15411,2020-12-19,3호선,대청,3937,3641,7578
15412,2020-12-19,3호선,일원,2944,2950,5894
15413,2020-12-19,3호선,수서,6897,7025,13922
15414,2020-12-19,3호선,가락시장,4231,3972,8203
15415,2020-12-19,3호선,경찰병원,2667,2631,5298
15416,2020-12-19,3호선,오금,2283,2117,4400
15417,2020-12-19,3호선,원흥,4106,3819,7925
15418,2020-12-19,3호선,삼송,8547,8507,17054
15419,2020-12-19,3호선,원당,5177,5124,10301
15420,2020-12-19,3호선,화정,7712,8361,16073
15421,2020-12-19,3호선,대곡,745,615,1360
15422,2020-12-19,3호선,백석,5168,5269,10437
15423,2020-12-19,3호선,마두,3050,3151,6201
15424,2020-12-19,3호선,정발산,3577,3646,7223
15425,2020-12-19,3호선,주엽,3648,3771,7419
15426,2020-12-20,3호선,지축,997,948,1945
15427,2020-12-20,3호선,오금,1594,1549,3143
15428,2020-12-20,3호선,경찰병원,1608,1635,3243
15429,2020-12-20,3호선,가락시장,2306,2559,4865
15430,2020-12-20,3호선,수서,5323,5175,10498
15431,2020-12-20,3호선,일원,1793,1956,3749
15432,2020-12-20,3호선,대청,2327,2256,4583
15433,2020-12-20,3호선,학여울,407,407,814
15434,2020-12-20,3호선,대치,2388,2312,4700
15435,2020-12-20,3호선,도곡,1118,1151,2269
15436,2020-12-20,3호선,매봉,2356,2337,4693
15437,2020-12-20,3호선,양재,7357,8602,15959
15438,2020-12-20,3호선,남부터미널,7239,7516,14755
15439,2020-12-20,3호선,교대,2003,1341,3344
15440,2020-12-20,3호선,고속터미널,20142,18736,38878
15441,2020-12-20,3호선,잠원,1120,1164,2284
15442,2020-12-20,3호선,신사,6927,7175,14102
15443,2020-12-20,3호선,압구정,7547,7882,15429
15444,2020-12-20,3호선,옥수,2717,2959,5676
15445,2020-12-20,3호선,금호,2567,2532,5099
15446,2020-12-20,3호선,약수,3763,3604,7367
15447,2020-12-20,3호선,동대입구,3127,3404,6531
15448,2020-12-20,3호선,을지로3가,1305,1341,2646
15449,2020-12-20,3호선,종로3가,1547,1975,3522
15450,2020-12-20,3호선,안국,3583,3630,7213
15451,2020-12-20,3호선,경복궁,4385,4630,9015
15452,2020-12-20,3호선,독립문,2316,2472,4788
15453,2020-12-20,3호선,무악재,1045,1124,2169
15454,2020-12-20,3호선,홍제,5440,5136,10576
15455,2020-12-20,3호선,녹번,4086,3670,7756
15456,2020-12-20,3호선,불광,5860,6756,12616
15457,2020-12-20,3호선,연신내,13214,12268,25482
15458,2020-12-20,3호선,구파발,6513,6786,13299
15459,2020-12-20,3호선,대화,3651,3335,6986
15460,2020-12-20,3호선,주엽,2388,2340,4728
15461,2020-12-20,3호선,정발산,2697,2614,5311
15462,2020-12-20,3호선,마두,1888,1915,3803
15463,2020-12-20,3호선,백석,3584,3544,7128
15464,2020-12-20,3호선,대곡,553,484,1037
15465,2020-12-20,3호선,화정,5397,5612,11009
15466,2020-12-20,3호선,원당,3581,3509,7090
15467,2020-12-20,3호선,삼송,6015,6012,12027
15468,2020-12-20,3호선,지축,1,0,1
15469,2020-12-20,3호선,원흥,2926,2742,5668
15470,2020-12-21,3호선,가락시장,7058,6918,13976
15471,2020-12-21,3호선,주엽,6680,6650,13330
15472,2020-12-21,3호선,대화,10325,8139,18464
15473,2020-12-21,3호선,원흥,7391,7087,14478
15474,2020-12-21,3호선,삼송,14084,14054,28138
15475,2020-12-21,3호선,원당,8955,8657,17612
15476,2020-12-21,3호선,화정,13040,13412,26452
15477,2020-12-21,3호선,대곡,1298,959,2257
15478,2020-12-21,3호선,백석,8031,8121,16152
15479,2020-12-21,3호선,마두,5630,5840,11470
15480,2020-12-21,3호선,정발산,5145,5068,10213
15481,2020-12-21,3호선,금호,6384,6209,12593
15482,2020-12-21,3호선,오금,5137,4582,9719
15483,2020-12-21,3호선,경찰병원,6236,6279,12515
15484,2020-12-21,3호선,수서,12262,12629,24891
15485,2020-12-21,3호선,일원,8033,7928,15961
15486,2020-12-21,3호선,대청,7871,7093,14964
15487,2020-12-21,3호선,학여울,1397,1378,2775
15488,2020-12-21,3호선,대치,7822,7784,15606
15489,2020-12-21,3호선,도곡,4407,4551,8958
15490,2020-12-21,3호선,매봉,10142,9683,19825
15491,2020-12-21,3호선,양재,31201,33648,64849
15492,2020-12-21,3호선,남부터미널,22681,23619,46300
15493,2020-12-21,3호선,교대,11219,7519,18738
15494,2020-12-21,3호선,고속터미널,28013,26195,54208
15495,2020-12-21,3호선,잠원,3663,3719,7382
15496,2020-12-21,3호선,신사,23832,24855,48687
15497,2020-12-21,3호선,압구정,25201,26457,51658
15498,2020-12-21,3호선,옥수,6907,7342,14249
15499,2020-12-21,3호선,약수,10540,10287,20827
15500,2020-12-21,3호선,동대입구,5389,5656,11045
15501,2020-12-21,3호선,을지로3가,8443,8707,17150
15502,2020-12-21,3호선,종로3가,7817,8908,16725
15503,2020-12-21,3호선,안국,14227,14480,28707
15504,2020-12-21,3호선,경복궁,13350,12935,26285
15505,2020-12-21,3호선,독립문,5713,5869,11582
15506,2020-12-21,3호선,무악재,3179,3267,6446
15507,2020-12-21,3호선,홍제,13981,13651,27632
15508,2020-12-21,3호선,녹번,12228,11355,23583
15509,2020-12-21,3호선,불광,13272,14143,27415
15510,2020-12-21,3호선,연신내,30473,28769,59242
15511,2020-12-21,3호선,구파발,16754,15701,32455
15512,2020-12-21,3호선,지축,2657,2681,5338
15513,2020-12-22,3호선,녹번,12317,11348,23665
15514,2020-12-22,3호선,대화,10245,8199,18444
15515,2020-12-22,3호선,주엽,6605,6702,13307
15516,2020-12-22,3호선,정발산,5336,5248,10584
15517,2020-12-22,3호선,마두,5652,5818,11470
15518,2020-12-22,3호선,백석,8151,5582,13733
15519,2020-12-22,3호선,대곡,1374,978,2352
15520,2020-12-22,3호선,화정,13355,13834,27189
15521,2020-12-22,3호선,원당,8898,8535,17433
15522,2020-12-22,3호선,삼송,14319,14296,28615
15523,2020-12-22,3호선,원흥,7375,7166,14541
15524,2020-12-22,3호선,오금,5094,4649,9743
15525,2020-12-22,3호선,경찰병원,6244,6324,12568
15526,2020-12-22,3호선,가락시장,7405,7256,14661
15527,2020-12-22,3호선,수서,12453,12745,25198
15528,2020-12-22,3호선,일원,8074,7783,15857
15529,2020-12-22,3호선,대청,7908,7264,15172
15530,2020-12-22,3호선,학여울,1417,1391,2808
15531,2020-12-22,3호선,대치,7759,7727,15486
15532,2020-12-22,3호선,도곡,4367,4389,8756
15533,2020-12-22,3호선,매봉,10280,9861,20141
15534,2020-12-22,3호선,양재,31586,33774,65360
15535,2020-12-22,3호선,남부터미널,22533,23228,45761
15536,2020-12-22,3호선,교대,11272,7605,18877
15537,2020-12-22,3호선,고속터미널,28669,27849,56518
15538,2020-12-22,3호선,잠원,3683,3676,7359
15539,2020-12-22,3호선,불광,13136,14154,27290
15540,2020-12-22,3호선,연신내,30732,28891,59623
15541,2020-12-22,3호선,구파발,16574,15636,32210
15542,2020-12-22,3호선,지축,2673,2647,5320
15543,2020-12-22,3호선,신사,24258,25221,49479
15544,2020-12-22,3호선,압구정,26153,27452,53605
15545,2020-12-22,3호선,옥수,6903,7355,14258
15546,2020-12-22,3호선,금호,6503,6271,12774
15547,2020-12-22,3호선,약수,10425,10187,20612
15548,2020-12-22,3호선,동대입구,5437,5747,11184
15549,2020-12-22,3호선,을지로3가,8357,8818,17175
15550,2020-12-22,3호선,종로3가,7973,8980,16953
15551,2020-12-22,3호선,안국,14224,14629,28853
15552,2020-12-22,3호선,경복궁,13864,13167,27031
15553,2020-12-22,3호선,독립문,5811,5975,11786
15554,2020-12-22,3호선,무악재,3197,3285,6482
15555,2020-12-22,3호선,홍제,14107,13503,27610
15556,2020-12-23,3호선,대화,10252,8214,18466
15557,2020-12-23,3호선,주엽,6625,6721,13346
15558,2020-12-23,3호선,정발산,5331,5334,10665
15559,2020-12-23,3호선,마두,5762,5925,11687
15560,2020-12-23,3호선,백석,7930,7997,15927
15561,2020-12-23,3호선,대곡,1359,1069,2428
15562,2020-12-23,3호선,화정,12950,13364,26314
15563,2020-12-23,3호선,원당,8771,8427,17198
15564,2020-12-23,3호선,삼송,14163,14159,28322
15565,2020-12-23,3호선,원흥,7395,7021,14416
15566,2020-12-23,3호선,오금,5018,4499,9517
15567,2020-12-23,3호선,경찰병원,6249,6239,12488
15568,2020-12-23,3호선,가락시장,7187,7110,14297
15569,2020-12-23,3호선,수서,12234,12831,25065
15570,2020-12-23,3호선,일원,8020,7764,15784
15571,2020-12-23,3호선,대청,7814,7248,15062
15572,2020-12-23,3호선,학여울,1337,1366,2703
15573,2020-12-23,3호선,대치,7465,7396,14861
15574,2020-12-23,3호선,도곡,4360,4412,8772
15575,2020-12-23,3호선,매봉,10289,9811,20100
15576,2020-12-23,3호선,양재,31542,33570,65112
15577,2020-12-23,3호선,남부터미널,22707,23565,46272
15578,2020-12-23,3호선,교대,11187,7473,18660
15579,2020-12-23,3호선,고속터미널,30057,29802,59859
15580,2020-12-23,3호선,잠원,3617,3631,7248
15581,2020-12-23,3호선,신사,24011,24956,48967
15582,2020-12-23,3호선,압구정,26328,27340,53668
15583,2020-12-23,3호선,옥수,6923,7436,14359
15584,2020-12-23,3호선,금호,6547,6317,12864
15585,2020-12-23,3호선,약수,10251,10095,20346
15586,2020-12-23,3호선,동대입구,5543,5727,11270
15587,2020-12-23,3호선,을지로3가,8552,8855,17407
15588,2020-12-23,3호선,종로3가,8036,9061,17097
15589,2020-12-23,3호선,안국,14330,14760,29090
15590,2020-12-23,3호선,경복궁,13807,13395,27202
15591,2020-12-23,3호선,독립문,5926,5975,11901
15592,2020-12-23,3호선,무악재,3246,3234,6480
15593,2020-12-23,3호선,홍제,14151,13638,27789
15594,2020-12-23,3호선,녹번,12287,11396,23683
15595,2020-12-23,3호선,불광,13251,14145,27396
15596,2020-12-23,3호선,연신내,30718,29133,59851
15597,2020-12-23,3호선,구파발,16615,15736,32351
15598,2020-12-23,3호선,지축,2696,2634,5330
15599,2020-12-24,3호선,대화,9990,8429,18419
15600,2020-12-24,3호선,주엽,6561,6808,13369
15601,2020-12-24,3호선,정발산,5436,5526,10962
15602,2020-12-24,3호선,마두,5739,5959,11698
15603,2020-12-24,3호선,백석,8436,8759,17195
15604,2020-12-24,3호선,대곡,1331,982,2313
15605,2020-12-24,3호선,화정,13138,13657,26795
15606,2020-12-24,3호선,원당,8667,8333,17000
15607,2020-12-24,3호선,삼송,14426,14633,29059
15608,2020-12-24,3호선,원흥,7278,6972,14250
15609,2020-12-24,3호선,오금,4816,4334,9150
15610,2020-12-24,3호선,경찰병원,6049,5914,11963
15611,2020-12-24,3호선,가락시장,7378,7241,14619
15612,2020-12-24,3호선,수서,11969,12403,24372
15613,2020-12-24,3호선,일원,7698,7305,15003
15614,2020-12-24,3호선,대청,7431,6965,14396
15615,2020-12-24,3호선,학여울,1311,1255,2566
15616,2020-12-24,3호선,대치,7511,7410,14921
15617,2020-12-24,3호선,도곡,4234,4312,8546
15618,2020-12-24,3호선,매봉,9934,9253,19187
15619,2020-12-24,3호선,양재,30678,31382,62060
15620,2020-12-24,3호선,남부터미널,23320,24299,47619
15621,2020-12-24,3호선,교대,10490,6773,17263
15622,2020-12-24,3호선,고속터미널,34817,39504,74321
15623,2020-12-24,3호선,잠원,3515,3585,7100
15624,2020-12-24,3호선,신사,24427,24929,49356
15625,2020-12-24,3호선,압구정,26392,27557,53949
15626,2020-12-24,3호선,옥수,7116,7434,14550
15627,2020-12-24,3호선,금호,6594,6240,12834
15628,2020-12-24,3호선,약수,10647,10269,20916
15629,2020-12-24,3호선,동대입구,5710,5803,11513
15630,2020-12-24,3호선,을지로3가,8140,8607,16747
15631,2020-12-24,3호선,종로3가,8064,9361,17425
15632,2020-12-24,3호선,안국,13490,13392,26882
15633,2020-12-24,3호선,경복궁,13591,12923,26514
15634,2020-12-24,3호선,독립문,5613,5661,11274
15635,2020-12-24,3호선,무악재,3128,3218,6346
15636,2020-12-24,3호선,홍제,14044,13640,27684
15637,2020-12-24,3호선,녹번,12126,11159,23285
15638,2020-12-24,3호선,불광,13418,14112,27530
15639,2020-12-24,3호선,연신내,31232,29368,60600
15640,2020-12-24,3호선,구파발,16438,15761,32199
15641,2020-12-24,3호선,지축,2549,2514,5063
15642,2020-12-25,3호선,오금,1571,1482,3053
15643,2020-12-25,3호선,경찰병원,1755,1734,3489
15644,2020-12-25,3호선,가락시장,3049,3036,6085
15645,2020-12-25,3호선,수서,4983,5458,10441
15646,2020-12-25,3호선,일원,1881,1963,3844
15647,2020-12-25,3호선,대청,2792,2510,5302
15648,2020-12-25,3호선,학여울,463,437,900
15649,2020-12-25,3호선,대치,2754,2663,5417
15650,2020-12-25,3호선,도곡,1360,1285,2645
15651,2020-12-25,3호선,매봉,2633,2495,5128
15652,2020-12-25,3호선,양재,7045,7814,14859
15653,2020-12-25,3호선,남부터미널,7961,8260,16221
15654,2020-12-25,3호선,교대,2124,1392,3516
15655,2020-12-25,3호선,고속터미널,20800,22429,43229
15656,2020-12-25,3호선,잠원,1318,1247,2565
15657,2020-12-25,3호선,신사,7898,8346,16244
15658,2020-12-25,3호선,압구정,8877,9179,18056
15659,2020-12-25,3호선,옥수,3116,3181,6297
15660,2020-12-25,3호선,금호,2877,2741,5618
15661,2020-12-25,3호선,약수,4328,4116,8444
15662,2020-12-25,3호선,동대입구,3089,3461,6550
15663,2020-12-25,3호선,을지로3가,2037,2141,4178
15664,2020-12-25,3호선,종로3가,2103,3055,5158
15665,2020-12-25,3호선,안국,4358,4794,9152
15666,2020-12-25,3호선,경복궁,4856,4965,9821
15667,2020-12-25,3호선,독립문,2461,2536,4997
15668,2020-12-25,3호선,무악재,1320,1342,2662
15669,2020-12-25,3호선,홍제,6320,6035,12355
15670,2020-12-25,3호선,녹번,4769,4275,9044
15671,2020-12-25,3호선,불광,6567,7292,13859
15672,2020-12-25,3호선,연신내,15738,14745,30483
15673,2020-12-25,3호선,구파발,7137,7290,14427
15674,2020-12-25,3호선,지축,989,994,1983
15675,2020-12-25,3호선,대화,4276,3876,8152
15676,2020-12-25,3호선,주엽,2776,2854,5630
15677,2020-12-25,3호선,정발산,3309,3327,6636
15678,2020-12-25,3호선,마두,2179,2278,4457
15679,2020-12-25,3호선,백석,4065,4041,8106
15680,2020-12-25,3호선,대곡,635,550,1185
15681,2020-12-25,3호선,화정,6350,6629,12979
15682,2020-12-25,3호선,원당,4120,4031,8151
15683,2020-12-25,3호선,삼송,7362,7406,14768
15684,2020-12-25,3호선,원흥,3330,3139,6469
15685,2020-12-26,3호선,지축,1321,1299,2620
15686,2020-12-26,3호선,구파발,8448,8479,16927
15687,2020-12-26,3호선,연신내,18372,17524,35896
15688,2020-12-26,3호선,불광,8029,8973,17002
15689,2020-12-26,3호선,녹번,5885,5422,11307
15690,2020-12-26,3호선,홍제,7865,7742,15607
15691,2020-12-26,3호선,무악재,1617,1673,3290
15692,2020-12-26,3호선,독립문,3202,3462,6664
15693,2020-12-26,3호선,경복궁,5862,5718,11580
15694,2020-12-26,3호선,안국,4776,4952,9728
15695,2020-12-26,3호선,종로3가,2453,3080,5533
15696,2020-12-26,3호선,을지로3가,2511,2588,5099
15697,2020-12-26,3호선,동대입구,3240,3612,6852
15698,2020-12-26,3호선,약수,5268,5017,10285
15699,2020-12-26,3호선,금호,3664,3516,7180
15700,2020-12-26,3호선,옥수,3884,3951,7835
15701,2020-12-26,3호선,압구정,14626,14871,29497
15702,2020-12-26,3호선,신사,12756,12926,25682
15703,2020-12-26,3호선,잠원,1846,1753,3599
15704,2020-12-26,3호선,고속터미널,23053,22990,46043
15705,2020-12-26,3호선,교대,2996,1918,4914
15706,2020-12-26,3호선,남부터미널,9792,10077,19869
15707,2020-12-26,3호선,양재,9785,10656,20441
15708,2020-12-26,3호선,매봉,3328,3186,6514
15709,2020-12-26,3호선,도곡,1788,1747,3535
15710,2020-12-26,3호선,대치,4095,3942,8037
15711,2020-12-26,3호선,학여울,599,630,1229
15712,2020-12-26,3호선,대청,3196,3046,6242
15713,2020-12-26,3호선,일원,2490,2487,4977
15714,2020-12-26,3호선,수서,6307,6447,12754
15715,2020-12-26,3호선,가락시장,3870,3611,7481
15716,2020-12-26,3호선,경찰병원,2181,2205,4386
15717,2020-12-26,3호선,오금,1983,1886,3869
15718,2020-12-26,3호선,원흥,3971,3819,7790
15719,2020-12-26,3호선,삼송,8052,8106,16158
15720,2020-12-26,3호선,원당,4882,4772,9654
15721,2020-12-26,3호선,화정,7556,7873,15429
15722,2020-12-26,3호선,대곡,689,590,1279
15723,2020-12-26,3호선,백석,4665,4813,9478
15724,2020-12-26,3호선,마두,3021,3062,6083
15725,2020-12-26,3호선,정발산,3606,3572,7178
15726,2020-12-26,3호선,주엽,3576,3665,7241
15727,2020-12-26,3호선,대화,4862,4544,9406
15728,2020-12-27,3호선,지축,888,881,1769
15729,2020-12-27,3호선,구파발,6065,6032,12097
15730,2020-12-27,3호선,연신내,13041,12020,25061
15731,2020-12-27,3호선,불광,5673,6670,12343
15732,2020-12-27,3호선,녹번,3787,3595,7382
15733,2020-12-27,3호선,홍제,5207,5097,10304
15734,2020-12-27,3호선,무악재,1060,1067,2127
15735,2020-12-27,3호선,독립문,2268,2481,4749
15736,2020-12-27,3호선,경복궁,4335,4518,8853
15737,2020-12-27,3호선,안국,3287,3628,6915
15738,2020-12-27,3호선,종로3가,1456,1866,3322
15739,2020-12-27,3호선,을지로3가,1261,1362,2623
15740,2020-12-27,3호선,동대입구,2555,2954,5509
15741,2020-12-27,3호선,약수,3566,3523,7089
15742,2020-12-27,3호선,금호,2581,2525,5106
15743,2020-12-27,3호선,옥수,2858,3018,5876
15744,2020-12-27,3호선,압구정,7278,7735,15013
15745,2020-12-27,3호선,신사,6565,6851,13416
15746,2020-12-27,3호선,잠원,1123,1130,2253
15747,2020-12-27,3호선,고속터미널,21271,18519,39790
15748,2020-12-27,3호선,교대,1838,1344,3182
15749,2020-12-27,3호선,남부터미널,7675,7487,15162
15750,2020-12-27,3호선,양재,6208,7325,13533
15751,2020-12-27,3호선,매봉,2237,2207,4444
15752,2020-12-27,3호선,도곡,1120,1146,2266
15753,2020-12-27,3호선,대치,2363,2337,4700
15754,2020-12-27,3호선,학여울,442,393,835
15755,2020-12-27,3호선,대청,2237,2140,4377
15756,2020-12-27,3호선,일원,1723,1841,3564
15757,2020-12-27,3호선,수서,5210,5076,10286
15758,2020-12-27,3호선,가락시장,2139,2379,4518
15759,2020-12-27,3호선,경찰병원,1459,1546,3005
15760,2020-12-27,3호선,오금,1459,1358,2817
15761,2020-12-27,3호선,대화,3534,3318,6852
15762,2020-12-27,3호선,주엽,2437,2318,4755
15763,2020-12-27,3호선,정발산,2758,2671,5429
15764,2020-12-27,3호선,마두,1890,1789,3679
15765,2020-12-27,3호선,백석,3395,3325,6720
15766,2020-12-27,3호선,대곡,538,473,1011
15767,2020-12-27,3호선,화정,5333,5496,10829
15768,2020-12-27,3호선,원당,3589,3510,7099
15769,2020-12-27,3호선,삼송,5795,5797,11592
15770,2020-12-27,3호선,원흥,2892,2733,5625
15771,2020-12-28,3호선,오금,4971,4507,9478
15772,2020-12-28,3호선,경찰병원,6114,6135,12249
15773,2020-12-28,3호선,가락시장,7148,6921,14069
15774,2020-12-28,3호선,수서,11894,12339,24233
15775,2020-12-28,3호선,일원,7488,7365,14853
15776,2020-12-28,3호선,대청,7941,7260,15201
15777,2020-12-28,3호선,학여울,1272,1329,2601
15778,2020-12-28,3호선,대치,7830,7790,15620
15779,2020-12-28,3호선,도곡,4024,4140,8164
15780,2020-12-28,3호선,매봉,9903,9219,19122
15781,2020-12-28,3호선,양재,29702,32219,61921
15782,2020-12-28,3호선,남부터미널,22290,22794,45084
15783,2020-12-28,3호선,교대,10821,7167,17988
15784,2020-12-28,3호선,고속터미널,27932,26458,54390
15785,2020-12-28,3호선,잠원,3578,3509,7087
15786,2020-12-28,3호선,신사,23470,24654,48124
15787,2020-12-28,3호선,압구정,25574,27072,52646
15788,2020-12-28,3호선,옥수,6791,7171,13962
15789,2020-12-28,3호선,금호,6393,6168,12561
15790,2020-12-28,3호선,약수,10253,10002,20255
15791,2020-12-28,3호선,동대입구,5398,5579,10977
15792,2020-12-28,3호선,충무로,1,0,1
15793,2020-12-28,3호선,을지로3가,8250,8506,16756
15794,2020-12-28,3호선,종로3가,7780,8900,16680
15795,2020-12-28,3호선,안국,13287,13561,26848
15796,2020-12-28,3호선,경복궁,13116,12661,25777
15797,2020-12-28,3호선,독립문,5548,5722,11270
15798,2020-12-28,3호선,무악재,3045,3208,6253
15799,2020-12-28,3호선,홍제,13898,13476,27374
15800,2020-12-28,3호선,녹번,11999,11108,23107
15801,2020-12-28,3호선,불광,13407,14308,27715
15802,2020-12-28,3호선,연신내,30213,28520,58733
15803,2020-12-28,3호선,구파발,16055,15089,31144
15804,2020-12-28,3호선,지축,2564,2642,5206
15805,2020-12-28,3호선,대화,10227,7934,18161
15806,2020-12-28,3호선,주엽,6925,6985,13910
15807,2020-12-28,3호선,정발산,5381,5254,10635
15808,2020-12-28,3호선,마두,5682,6023,11705
15809,2020-12-28,3호선,백석,8037,8205,16242
15810,2020-12-28,3호선,대곡,1415,1040,2455
15811,2020-12-28,3호선,화정,13091,13486,26577
15812,2020-12-28,3호선,원당,8879,8538,17417
15813,2020-12-28,3호선,삼송,14300,14047,28347
15814,2020-12-28,3호선,원흥,7259,7055,14314
15815,2020-12-29,3호선,지축,2603,2554,5157
15816,2020-12-29,3호선,구파발,16164,15241,31405
15817,2020-12-29,3호선,연신내,30201,28411,58612
15818,2020-12-29,3호선,불광,13220,14308,27528
15819,2020-12-29,3호선,녹번,12266,11317,23583
15820,2020-12-29,3호선,홍제,13888,13498,27386
15821,2020-12-29,3호선,무악재,3171,3207,6378
15822,2020-12-29,3호선,독립문,5583,5928,11511
15823,2020-12-29,3호선,경복궁,13217,12729,25946
15824,2020-12-29,3호선,안국,13384,13481,26865
15825,2020-12-29,3호선,종로3가,7973,8924,16897
15826,2020-12-29,3호선,을지로3가,8356,8522,16878
15827,2020-12-29,3호선,동대입구,5299,5581,10880
15828,2020-12-29,3호선,약수,10280,10027,20307
15829,2020-12-29,3호선,금호,6376,6110,12486
15830,2020-12-29,3호선,옥수,6667,7086,13753
15831,2020-12-29,3호선,압구정,25679,27105,52784
15832,2020-12-29,3호선,신사,24275,24889,49164
15833,2020-12-29,3호선,잠원,3517,3504,7021
15834,2020-12-29,3호선,고속터미널,28119,27397,55516
15835,2020-12-29,3호선,교대,10776,7190,17966
15836,2020-12-29,3호선,남부터미널,22112,22926,45038
15837,2020-12-29,3호선,양재,30020,32167,62187
15838,2020-12-29,3호선,매봉,9977,9544,19521
15839,2020-12-29,3호선,도곡,4009,4145,8154
15840,2020-12-29,3호선,대치,7744,7807,15551
15841,2020-12-29,3호선,학여울,1300,1363,2663
15842,2020-12-29,3호선,대청,7982,7138,15120
15843,2020-12-29,3호선,일원,7650,7559,15209
15844,2020-12-29,3호선,수서,11677,12118,23795
15845,2020-12-29,3호선,가락시장,7357,7192,14549
15846,2020-12-29,3호선,경찰병원,6169,6157,12326
15847,2020-12-29,3호선,오금,5019,4539,9558
15848,2020-12-29,3호선,대화,9935,8078,18013
15849,2020-12-29,3호선,주엽,6610,6657,13267
15850,2020-12-29,3호선,정발산,5173,5104,10277
15851,2020-12-29,3호선,마두,5664,5884,11548
15852,2020-12-29,3호선,백석,8043,8194,16237
15853,2020-12-29,3호선,대곡,1308,995,2303
15854,2020-12-29,3호선,화정,12996,13523,26519
15855,2020-12-29,3호선,원당,8710,8336,17046
15856,2020-12-29,3호선,삼송,13933,13767,27700
15857,2020-12-29,3호선,원흥,7362,7130,14492
15858,2020-12-30,3호선,학여울,1220,1241,2461
15859,2020-12-30,3호선,대청,7180,6690,13870
15860,2020-12-30,3호선,일원,7113,6973,14086
15861,2020-12-30,3호선,수서,11317,11684,23001
15862,2020-12-30,3호선,가락시장,6669,6482,13151
15863,2020-12-30,3호선,경찰병원,5758,5825,11583
15864,2020-12-30,3호선,오금,4645,4240,8885
15865,2020-12-30,3호선,약수,9689,9418,19107
15866,2020-12-30,3호선,금호,5972,5853,11825
15867,2020-12-30,3호선,옥수,6290,6755,13045
15868,2020-12-30,3호선,압구정,24284,25721,50005
15869,2020-12-30,3호선,신사,23332,23968,47300
15870,2020-12-30,3호선,잠원,3411,3439,6850
15871,2020-12-30,3호선,고속터미널,28142,29702,57844
15872,2020-12-30,3호선,교대,10181,6950,17131
15873,2020-12-30,3호선,남부터미널,21547,22316,43863
15874,2020-12-30,3호선,양재,28665,30565,59230
15875,2020-12-30,3호선,매봉,9499,9014,18513
15876,2020-12-30,3호선,도곡,3710,3778,7488
15877,2020-12-30,3호선,대화,9457,7788,17245
15878,2020-12-30,3호선,주엽,6085,6049,12134
15879,2020-12-30,3호선,정발산,4872,4803,9675
15880,2020-12-30,3호선,마두,5368,5550,10918
15881,2020-12-30,3호선,백석,7649,7777,15426
15882,2020-12-30,3호선,대곡,1166,871,2037
15883,2020-12-30,3호선,화정,11965,12546,24511
15884,2020-12-30,3호선,원당,8094,7770,15864
15885,2020-12-30,3호선,삼송,12776,12919,25695
15886,2020-12-30,3호선,지축,1,0,1
15887,2020-12-30,3호선,원흥,6917,6542,13459
15888,2020-12-30,3호선,지축,2412,2340,4752
15889,2020-12-30,3호선,구파발,15009,14120,29129
15890,2020-12-30,3호선,연신내,28898,27224,56122
15891,2020-12-30,3호선,불광,12355,13055,25410
15892,2020-12-30,3호선,녹번,11553,10629,22182
15893,2020-12-30,3호선,홍제,12936,12593,25529
15894,2020-12-30,3호선,무악재,2966,3021,5987
15895,2020-12-30,3호선,독립문,4973,5146,10119
15896,2020-12-30,3호선,경복궁,12504,12030,24534
15897,2020-12-30,3호선,안국,10745,11255,22000
15898,2020-12-30,3호선,종로3가,7817,8721,16538
15899,2020-12-30,3호선,을지로3가,8325,8634,16959
15900,2020-12-30,3호선,동대입구,5054,5161,10215
15901,2020-12-30,3호선,대치,7362,7272,14634
15902,2020-12-31,3호선,오금,4209,3793,8002
15903,2020-12-31,3호선,경찰병원,5122,5002,10124
15904,2020-12-31,3호선,가락시장,6626,6241,12867
15905,2020-12-31,3호선,수서,10844,11321,22165
15906,2020-12-31,3호선,일원,6902,6400,13302
15907,2020-12-31,3호선,대청,7224,6406,13630
15908,2020-12-31,3호선,학여울,1159,1162,2321
15909,2020-12-31,3호선,대치,7074,7085,14159
15910,2020-12-31,3호선,도곡,3564,3582,7146
15911,2020-12-31,3호선,매봉,8567,8012,16579
15912,2020-12-31,3호선,양재,26250,26556,52806
15913,2020-12-31,3호선,남부터미널,20317,22271,42588
15914,2020-12-31,3호선,교대,9179,6005,15184
15915,2020-12-31,3호선,고속터미널,30872,40368,71240
15916,2020-12-31,3호선,잠원,3187,3088,6275
15917,2020-12-31,3호선,신사,20990,21585,42575
15918,2020-12-31,3호선,압구정,23327,24261,47588
15919,2020-12-31,3호선,옥수,6211,6531,12742
15920,2020-12-31,3호선,금호,6111,5702,11813
15921,2020-12-31,3호선,약수,9397,8854,18251
15922,2020-12-31,3호선,동대입구,4849,4917,9766
15923,2020-12-31,3호선,충무로,1,0,1
15924,2020-12-31,3호선,을지로3가,7690,7902,15592
15925,2020-12-31,3호선,종로3가,7461,8504,15965
15926,2020-12-31,3호선,안국,9691,9998,19689
15927,2020-12-31,3호선,경복궁,11645,11096,22741
15928,2020-12-31,3호선,독립문,5029,5073,10102
15929,2020-12-31,3호선,무악재,2814,2914,5728
15930,2020-12-31,3호선,홍제,12692,12367,25059
15931,2020-12-31,3호선,녹번,10971,9901,20872
15932,2020-12-31,3호선,불광,12092,13008,25100
15933,2020-12-31,3호선,연신내,28496,26899,55395
15934,2020-12-31,3호선,구파발,14670,13979,28649
15935,2020-12-31,3호선,지축,2280,2189,4469
15936,2020-12-31,3호선,대화,8989,7554,16543
15937,2020-12-31,3호선,주엽,5648,6010,11658
15938,2020-12-31,3호선,정발산,4911,4885,9796
15939,2020-12-31,3호선,마두,5098,5226,10324
15940,2020-12-31,3호선,백석,7446,7673,15119
15941,2020-12-31,3호선,대곡,1087,816,1903
15942,2020-12-31,3호선,화정,11738,12310,24048
15943,2020-12-31,3호선,원당,7679,7549,15228
15944,2020-12-31,3호선,삼송,12487,12707,25194
15945,2020-12-31,3호선,원흥,6582,6191,12773
