,사용일자,호선명,지하철역,승차총승객수,하차총승객수,승하차총승객수
0,20200101,수인분당선,인천,1109,1571,2680
1,20200101,수인분당선,신포,1111,1117,2228
2,20200101,수인분당선,숭의,1789,1605,3394
3,20200101,수인분당선,인하대,2319,2306,4625
4,20200101,수인분당선,송도,1598,1586,3184
5,20200101,수인분당선,연수,3056,2945,6001
6,20200101,수인분당선,원인재,2417,2516,4933
7,20200101,수인분당선,남동인더스파크,477,476,953
8,20200101,수인분당선,호구포,1629,1737,3366
9,20200101,수인분당선,인천논현,2958,3138,6096
10,20200101,수인분당선,소래포구,3483,3220,6703
11,20200101,수인분당선,월곶,1615,1497,3112
12,20200101,수인분당선,달월,39,37,76
13,20200101,수인분당선,매교,982,1061,2043
14,20200101,수인분당선,수원시청,7916,6075,13991
15,20200101,수인분당선,매탄권선,2100,2204,4304
16,20200101,수인분당선,망포,5445,6235,11680
17,20200101,수인분당선,영통,4684,5088,9772
18,20200101,수인분당선,청명,1567,1878,3445
19,20200101,수인분당선,상갈,2755,2912,5667
20,20200101,수인분당선,기흥,4643,4639,9282
21,20200101,수인분당선,신갈,1759,1935,3694
22,20200101,수인분당선,구성,1970,2115,4085
23,20200101,수인분당선,죽전,6371,7489,13860
24,20200101,수인분당선,보정,1101,1014,2115
25,20200101,수인분당선,이매,2473,2629,5102
26,20200101,수인분당선,오리,5265,4627,9892
27,20200101,수인분당선,미금,7780,8614,16394
28,20200101,수인분당선,정자,6244,6615,12859
29,20200101,수인분당선,수내,4630,4720,9350
30,20200101,수인분당선,서현,13363,12778,26141
31,20200101,수인분당선,야탑,13790,14130,27920
32,20200101,수인분당선,모란,10572,10899,21471
33,20200101,수인분당선,태평,7649,7461,15110
34,20200101,수인분당선,가천대,2871,3742,6613
35,20200101,수인분당선,선정릉,1676,1640,3316
36,20200101,수인분당선,강남구청,2176,2431,4607
37,20200101,수인분당선,압구정로데오,4953,5406,10359
38,20200101,수인분당선,서울숲,2775,2832,5607
39,20200101,수인분당선,수원,4933,3437,8370
40,20200101,수인분당선,수서,7186,6991,14177
41,20200101,수인분당선,대모산입구,1205,1216,2421
42,20200101,수인분당선,개포동,1375,1439,2814
43,20200101,수인분당선,구룡,440,485,925
44,20200101,수인분당선,도곡,2185,2246,4431
45,20200101,수인분당선,한티,5839,5989,11828
46,20200101,수인분당선,선릉,2279,3268,5547
47,20200102,수인분당선,선릉,13838,22412,36250
48,20200102,수인분당선,한티,16300,17248,33548
49,20200102,수인분당선,도곡,7502,7484,14986
50,20200102,수인분당선,구룡,1406,1396,2802
51,20200102,수인분당선,개포동,3780,3924,7704
52,20200102,수인분당선,대모산입구,3685,3378,7063
53,20200102,수인분당선,수서,15312,15310,30622
54,20200102,수인분당선,수원,9026,6532,15558
55,20200102,수인분당선,서울숲,9266,9457,18723
56,20200102,수인분당선,압구정로데오,18458,20810,39268
57,20200102,수인분당선,강남구청,10709,12377,23086
58,20200102,수인분당선,선정릉,8828,9395,18223
59,20200102,수인분당선,가천대,7985,9151,17136
60,20200102,수인분당선,태평,14768,14637,29405
61,20200102,수인분당선,모란,22296,22292,44588
62,20200102,수인분당선,야탑,31717,33013,64730
63,20200102,수인분당선,서현,30391,30778,61169
64,20200102,수인분당선,수내,15559,15423,30982
65,20200102,수인분당선,정자,19060,20335,39395
66,20200102,수인분당선,미금,18907,20114,39021
67,20200102,수인분당선,오리,13824,11807,25631
68,20200102,수인분당선,이매,6297,6050,12347
69,20200102,수인분당선,보정,2968,2555,5523
70,20200102,수인분당선,죽전,15663,17358,33021
71,20200102,수인분당선,구성,5511,5397,10908
72,20200102,수인분당선,신갈,5408,5163,10571
73,20200102,수인분당선,기흥,11116,10540,21656
74,20200102,수인분당선,상갈,6107,5671,11778
75,20200102,수인분당선,청명,4750,4407,9157
76,20200102,수인분당선,영통,9611,9858,19469
77,20200102,수인분당선,망포,14984,14170,29154
78,20200102,수인분당선,매탄권선,4976,4653,9629
79,20200102,수인분당선,수원시청,12492,13898,26390
80,20200102,수인분당선,매교,2883,2898,5781
81,20200102,수인분당선,달월,76,51,127
82,20200102,수인분당선,월곶,2607,2515,5122
83,20200102,수인분당선,소래포구,4655,4213,8868
84,20200102,수인분당선,인천논현,6285,6688,12973
85,20200102,수인분당선,호구포,3713,3800,7513
86,20200102,수인분당선,남동인더스파크,2157,2414,4571
87,20200102,수인분당선,원인재,4506,4656,9162
88,20200102,수인분당선,연수,4954,4948,9902
89,20200102,수인분당선,송도,2754,2558,5312
90,20200102,수인분당선,인하대,5524,5315,10839
91,20200102,수인분당선,숭의,3985,3759,7744
92,20200102,수인분당선,신포,1941,1956,3897
93,20200102,수인분당선,인천,992,1675,2667
94,20200103,수인분당선,선릉,14556,23802,38358
95,20200103,수인분당선,한티,17545,18427,35972
96,20200103,수인분당선,도곡,7996,7930,15926
97,20200103,수인분당선,구룡,1545,1513,3058
98,20200103,수인분당선,개포동,4155,4300,8455
99,20200103,수인분당선,대모산입구,3791,3436,7227
100,20200103,수인분당선,수서,16925,17198,34123
101,20200103,수인분당선,수원,9988,7134,17122
102,20200103,수인분당선,서울숲,9719,9767,19486
103,20200103,수인분당선,압구정로데오,20260,23415,43675
104,20200103,수인분당선,강남구청,11495,13124,24619
105,20200103,수인분당선,선정릉,9403,9968,19371
106,20200103,수인분당선,가천대,8030,8776,16806
107,20200103,수인분당선,태평,15700,15462,31162
108,20200103,수인분당선,모란,24068,24684,48752
109,20200103,수인분당선,야탑,33522,35380,68902
110,20200103,수인분당선,서현,34042,34695,68737
111,20200103,수인분당선,수내,16534,16425,32959
112,20200103,수인분당선,정자,20520,22061,42581
113,20200103,수인분당선,미금,19842,21255,41097
114,20200103,수인분당선,오리,14653,12093,26746
115,20200103,수인분당선,이매,6789,6626,13415
116,20200103,수인분당선,보정,3126,2677,5803
117,20200103,수인분당선,죽전,17411,18419,35830
118,20200103,수인분당선,구성,5847,5707,11554
119,20200103,수인분당선,신갈,5785,5591,11376
120,20200103,수인분당선,기흥,11815,10974,22789
121,20200103,수인분당선,상갈,6685,6157,12842
122,20200103,수인분당선,청명,5247,4626,9873
123,20200103,수인분당선,영통,10939,11059,21998
124,20200103,수인분당선,망포,16845,15152,31997
125,20200103,수인분당선,매탄권선,5494,4901,10395
126,20200103,수인분당선,수원시청,13410,16738,30148
127,20200103,수인분당선,매교,2813,3092,5905
128,20200103,수인분당선,달월,77,52,129
129,20200103,수인분당선,월곶,2571,2330,4901
130,20200103,수인분당선,소래포구,5053,4781,9834
131,20200103,수인분당선,인천논현,6859,7234,14093
132,20200103,수인분당선,호구포,4001,3954,7955
133,20200103,수인분당선,남동인더스파크,2264,2437,4701
134,20200103,수인분당선,원인재,4875,4929,9804
135,20200103,수인분당선,연수,5535,5514,11049
136,20200103,수인분당선,송도,2919,2648,5567
137,20200103,수인분당선,인하대,5963,5591,11554
138,20200103,수인분당선,숭의,4188,3928,8116
139,20200103,수인분당선,신포,2088,2146,4234
140,20200103,수인분당선,인천,1065,1785,2850
141,20200104,수인분당선,선릉,6047,9958,16005
142,20200104,수인분당선,한티,14882,14056,28938
143,20200104,수인분당선,도곡,5200,4825,10025
144,20200104,수인분당선,구룡,1037,1020,2057
145,20200104,수인분당선,개포동,2791,2847,5638
146,20200104,수인분당선,대모산입구,2716,2329,5045
147,20200104,수인분당선,수서,12654,12548,25202
148,20200104,수인분당선,수원,8136,5948,14084
149,20200104,수인분당선,서울숲,6653,6760,13413
150,20200104,수인분당선,압구정로데오,16232,18714,34946
151,20200104,수인분당선,강남구청,6113,7273,13386
152,20200104,수인분당선,선정릉,4237,4333,8570
153,20200104,수인분당선,가천대,5285,5870,11155
154,20200104,수인분당선,태평,12760,12505,25265
155,20200104,수인분당선,모란,26566,27577,54143
156,20200104,수인분당선,야탑,23732,25151,48883
157,20200104,수인분당선,서현,25584,25803,51387
158,20200104,수인분당선,수내,10939,10323,21262
159,20200104,수인분당선,정자,12743,13153,25896
160,20200104,수인분당선,미금,13953,14560,28513
161,20200104,수인분당선,오리,10007,8157,18164
162,20200104,수인분당선,이매,5052,5114,10166
163,20200104,수인분당선,보정,2145,1830,3975
164,20200104,수인분당선,죽전,12227,13916,26143
165,20200104,수인분당선,구성,3984,3893,7877
166,20200104,수인분당선,신갈,3659,3562,7221
167,20200104,수인분당선,기흥,8141,7719,15860
168,20200104,수인분당선,상갈,4881,4498,9379
169,20200104,수인분당선,청명,3312,3193,6505
170,20200104,수인분당선,영통,8337,8130,16467
171,20200104,수인분당선,망포,10754,9554,20308
172,20200104,수인분당선,매탄권선,3722,3374,7096
173,20200104,수인분당선,수원시청,12366,14853,27219
174,20200104,수인분당선,매교,1774,1895,3669
175,20200104,수인분당선,달월,43,38,81
176,20200104,수인분당선,월곶,2128,2068,4196
177,20200104,수인분당선,소래포구,4893,4857,9750
178,20200104,수인분당선,인천논현,5151,5183,10334
179,20200104,수인분당선,호구포,2575,2500,5075
180,20200104,수인분당선,남동인더스파크,970,822,1792
181,20200104,수인분당선,원인재,3887,3919,7806
182,20200104,수인분당선,연수,4884,4917,9801
183,20200104,수인분당선,송도,2404,2275,4679
184,20200104,수인분당선,인하대,4111,3793,7904
185,20200104,수인분당선,숭의,2877,2659,5536
186,20200104,수인분당선,신포,1553,1730,3283
187,20200104,수인분당선,인천,1238,2167,3405
188,20200105,수인분당선,선릉,2974,4676,7650
189,20200105,수인분당선,한티,10538,9963,20501
190,20200105,수인분당선,도곡,3064,3010,6074
191,20200105,수인분당선,구룡,739,787,1526
192,20200105,수인분당선,개포동,2334,2284,4618
193,20200105,수인분당선,대모산입구,1812,1715,3527
194,20200105,수인분당선,수서,9696,9216,18912
195,20200105,수인분당선,복정,1,0,1
196,20200105,수인분당선,수원,5971,4204,10175
197,20200105,수인분당선,서울숲,4191,4329,8520
198,20200105,수인분당선,압구정로데오,8778,9495,18273
199,20200105,수인분당선,강남구청,3550,4181,7731
200,20200105,수인분당선,선정릉,2438,2526,4964
201,20200105,수인분당선,가천대,3618,4510,8128
202,20200105,수인분당선,태평,9529,9018,18547
203,20200105,수인분당선,모란,13301,13624,26925
204,20200105,수인분당선,야탑,18076,17952,36028
205,20200105,수인분당선,서현,19026,18871,37897
206,20200105,수인분당선,수내,7793,7437,15230
207,20200105,수인분당선,정자,8664,9184,17848
208,20200105,수인분당선,미금,10301,10849,21150
209,20200105,수인분당선,오리,7041,6116,13157
210,20200105,수인분당선,이매,4910,4969,9879
211,20200105,수인분당선,보정,1398,1307,2705
212,20200105,수인분당선,죽전,9541,10988,20529
213,20200105,수인분당선,구성,2795,2973,5768
214,20200105,수인분당선,신갈,2514,2576,5090
215,20200105,수인분당선,기흥,5959,5922,11881
216,20200105,수인분당선,상갈,3573,3583,7156
217,20200105,수인분당선,청명,2313,2433,4746
218,20200105,수인분당선,영통,5737,5908,11645
219,20200105,수인분당선,망포,7183,7477,14660
220,20200105,수인분당선,매탄권선,2645,2585,5230
221,20200105,수인분당선,수원시청,8468,8405,16873
222,20200105,수인분당선,매교,1377,1419,2796
223,20200105,수인분당선,달월,25,22,47
224,20200105,수인분당선,월곶,1732,1616,3348
225,20200105,수인분당선,소래포구,3808,3694,7502
226,20200105,수인분당선,인천논현,3507,3721,7228
227,20200105,수인분당선,호구포,2153,2164,4317
228,20200105,수인분당선,남동인더스파크,612,702,1314
229,20200105,수인분당선,원인재,3078,3254,6332
230,20200105,수인분당선,연수,4035,4039,8074
231,20200105,수인분당선,송도,1893,1835,3728
232,20200105,수인분당선,인하대,4278,3712,7990
233,20200105,수인분당선,숭의,2085,1964,4049
234,20200105,수인분당선,신포,1368,1270,2638
235,20200105,수인분당선,인천,1114,1792,2906
236,20200106,수인분당선,선릉,15270,24661,39931
237,20200106,수인분당선,한티,16722,17685,34407
238,20200106,수인분당선,도곡,7883,8129,16012
239,20200106,수인분당선,구룡,1807,1752,3559
240,20200106,수인분당선,개포동,4012,4344,8356
241,20200106,수인분당선,대모산입구,3884,3586,7470
242,20200106,수인분당선,수서,15502,16155,31657
243,20200106,수인분당선,복정,1,0,1
244,20200106,수인분당선,수원,9142,6202,15344
245,20200106,수인분당선,서울숲,9346,9433,18779
246,20200106,수인분당선,압구정로데오,17729,19798,37527
247,20200106,수인분당선,강남구청,11062,12938,24000
248,20200106,수인분당선,선정릉,9556,10108,19664
249,20200106,수인분당선,가천대,8330,9471,17801
250,20200106,수인분당선,태평,15252,15034,30286
251,20200106,수인분당선,모란,22970,23055,46025
252,20200106,수인분당선,야탑,31430,33035,64465
253,20200106,수인분당선,서현,31889,32079,63968
254,20200106,수인분당선,수내,15724,15676,31400
255,20200106,수인분당선,정자,19896,21307,41203
256,20200106,수인분당선,미금,19591,20764,40355
257,20200106,수인분당선,오리,13823,11756,25579
258,20200106,수인분당선,이매,6287,6110,12397
259,20200106,수인분당선,보정,3153,2774,5927
260,20200106,수인분당선,죽전,15584,17341,32925
261,20200106,수인분당선,구성,5781,5804,11585
262,20200106,수인분당선,신갈,5652,5493,11145
263,20200106,수인분당선,기흥,11175,10626,21801
264,20200106,수인분당선,상갈,6319,5810,12129
265,20200106,수인분당선,청명,4807,4535,9342
266,20200106,수인분당선,영통,9759,9877,19636
267,20200106,수인분당선,망포,15383,14507,29890
268,20200106,수인분당선,매탄권선,4982,4745,9727
269,20200106,수인분당선,수원시청,12342,13688,26030
270,20200106,수인분당선,매교,2596,2652,5248
271,20200106,수인분당선,달월,70,39,109
272,20200106,수인분당선,월곶,2425,2351,4776
273,20200106,수인분당선,소래포구,4463,4137,8600
274,20200106,수인분당선,인천논현,6299,6603,12902
275,20200106,수인분당선,호구포,3895,3983,7878
276,20200106,수인분당선,남동인더스파크,2338,2505,4843
277,20200106,수인분당선,원인재,4516,4600,9116
278,20200106,수인분당선,연수,4837,4876,9713
279,20200106,수인분당선,송도,2817,2513,5330
280,20200106,수인분당선,인하대,5659,5385,11044
281,20200106,수인분당선,숭의,4083,3769,7852
282,20200106,수인분당선,신포,1791,1911,3702
283,20200106,수인분당선,인천,938,1521,2459
284,20200107,수인분당선,선릉,15502,24489,39991
285,20200107,수인분당선,한티,17081,17939,35020
286,20200107,수인분당선,도곡,7794,7873,15667
287,20200107,수인분당선,구룡,1751,1824,3575
288,20200107,수인분당선,개포동,3809,4009,7818
289,20200107,수인분당선,대모산입구,3573,3355,6928
290,20200107,수인분당선,수서,15403,15928,31331
291,20200107,수인분당선,수원,8730,6117,14847
292,20200107,수인분당선,서울숲,9268,9269,18537
293,20200107,수인분당선,압구정로데오,18547,20579,39126
294,20200107,수인분당선,강남구청,11299,12956,24255
295,20200107,수인분당선,선정릉,9471,10043,19514
296,20200107,수인분당선,가천대,8030,9220,17250
297,20200107,수인분당선,태평,14861,14479,29340
298,20200107,수인분당선,모란,21682,21828,43510
299,20200107,수인분당선,야탑,30783,32578,63361
300,20200107,수인분당선,서현,30633,31085,61718
301,20200107,수인분당선,수내,15484,15624,31108
302,20200107,수인분당선,정자,19792,21290,41082
303,20200107,수인분당선,미금,18477,19864,38341
304,20200107,수인분당선,오리,13760,11625,25385
305,20200107,수인분당선,이매,6309,5990,12299
306,20200107,수인분당선,보정,3131,2665,5796
307,20200107,수인분당선,죽전,15194,16902,32096
308,20200107,수인분당선,구성,5492,5540,11032
309,20200107,수인분당선,신갈,5545,5330,10875
310,20200107,수인분당선,기흥,10714,10358,21072
311,20200107,수인분당선,상갈,6191,5770,11961
312,20200107,수인분당선,청명,4929,4624,9553
313,20200107,수인분당선,영통,9537,9670,19207
314,20200107,수인분당선,망포,15272,14465,29737
315,20200107,수인분당선,매탄권선,4887,4781,9668
316,20200107,수인분당선,수원시청,12436,13648,26084
317,20200107,수인분당선,매교,2463,2499,4962
318,20200107,수인분당선,달월,76,46,122
319,20200107,수인분당선,월곶,2322,2174,4496
320,20200107,수인분당선,소래포구,4230,3854,8084
321,20200107,수인분당선,인천논현,6050,6336,12386
322,20200107,수인분당선,호구포,3642,3737,7379
323,20200107,수인분당선,남동인더스파크,2385,2649,5034
324,20200107,수인분당선,원인재,4232,4417,8649
325,20200107,수인분당선,연수,4655,4635,9290
326,20200107,수인분당선,송도,2606,2371,4977
327,20200107,수인분당선,인하대,5478,5254,10732
328,20200107,수인분당선,숭의,3791,3557,7348
329,20200107,수인분당선,신포,1800,1771,3571
330,20200107,수인분당선,인천,796,1419,2215
331,20200108,수인분당선,선릉,15117,24527,39644
332,20200108,수인분당선,한티,17105,18108,35213
333,20200108,수인분당선,도곡,7948,8096,16044
334,20200108,수인분당선,구룡,1737,1755,3492
335,20200108,수인분당선,개포동,4190,4355,8545
336,20200108,수인분당선,대모산입구,3878,3473,7351
337,20200108,수인분당선,수서,15892,16120,32012
338,20200108,수인분당선,복정,1,0,1
339,20200108,수인분당선,수원,9316,6705,16021
340,20200108,수인분당선,서울숲,9594,9807,19401
341,20200108,수인분당선,압구정로데오,18588,20954,39542
342,20200108,수인분당선,강남구청,11430,13336,24766
343,20200108,수인분당선,선정릉,9334,10036,19370
344,20200108,수인분당선,가천대,8072,9296,17368
345,20200108,수인분당선,태평,15488,15147,30635
346,20200108,수인분당선,모란,23176,23294,46470
347,20200108,수인분당선,야탑,33170,34953,68123
348,20200108,수인분당선,서현,32294,32587,64881
349,20200108,수인분당선,수내,16285,16320,32605
350,20200108,수인분당선,정자,20777,22258,43035
351,20200108,수인분당선,미금,19932,21382,41314
352,20200108,수인분당선,오리,14434,12162,26596
353,20200108,수인분당선,이매,6833,6428,13261
354,20200108,수인분당선,보정,3289,2757,6046
355,20200108,수인분당선,죽전,16239,17991,34230
356,20200108,수인분당선,구성,5748,5847,11595
357,20200108,수인분당선,신갈,5827,5618,11445
358,20200108,수인분당선,기흥,11568,10880,22448
359,20200108,수인분당선,상갈,6535,5996,12531
360,20200108,수인분당선,청명,4982,4691,9673
361,20200108,수인분당선,영통,10240,10182,20422
362,20200108,수인분당선,망포,15820,14763,30583
363,20200108,수인분당선,매탄권선,5082,4771,9853
364,20200108,수인분당선,수원시청,13016,14291,27307
365,20200108,수인분당선,매교,2668,2650,5318
366,20200108,수인분당선,달월,72,52,124
367,20200108,수인분당선,월곶,2812,2652,5464
368,20200108,수인분당선,소래포구,4823,4346,9169
369,20200108,수인분당선,인천논현,6578,6948,13526
370,20200108,수인분당선,호구포,3925,3947,7872
371,20200108,수인분당선,남동인더스파크,2321,2554,4875
372,20200108,수인분당선,원인재,4794,4918,9712
373,20200108,수인분당선,연수,5260,5339,10599
374,20200108,수인분당선,송도,2888,2703,5591
375,20200108,수인분당선,인하대,6017,5647,11664
376,20200108,수인분당선,숭의,4233,3983,8216
377,20200108,수인분당선,신포,1897,2073,3970
378,20200108,수인분당선,인천,951,1649,2600
379,20200109,수인분당선,선릉,15255,24816,40071
380,20200109,수인분당선,한티,17207,18178,35385
381,20200109,수인분당선,도곡,7979,7937,15916
382,20200109,수인분당선,구룡,1827,1743,3570
383,20200109,수인분당선,개포동,4032,4164,8196
384,20200109,수인분당선,대모산입구,3950,3699,7649
385,20200109,수인분당선,수서,16513,16902,33415
386,20200109,수인분당선,수원,9565,6892,16457
387,20200109,수인분당선,서울숲,9776,9888,19664
388,20200109,수인분당선,압구정로데오,19323,21823,41146
389,20200109,수인분당선,강남구청,11443,13269,24712
390,20200109,수인분당선,선정릉,9432,10138,19570
391,20200109,수인분당선,가천대,8485,9491,17976
392,20200109,수인분당선,태평,15899,15762,31661
393,20200109,수인분당선,모란,30291,31632,61923
394,20200109,수인분당선,야탑,33473,34667,68140
395,20200109,수인분당선,서현,32984,33389,66373
396,20200109,수인분당선,수내,16684,16767,33451
397,20200109,수인분당선,정자,21015,22393,43408
398,20200109,수인분당선,미금,20330,21543,41873
399,20200109,수인분당선,오리,15085,12718,27803
400,20200109,수인분당선,이매,6820,6599,13419
401,20200109,수인분당선,보정,3156,2774,5930
402,20200109,수인분당선,죽전,16808,18304,35112
403,20200109,수인분당선,구성,5839,5923,11762
404,20200109,수인분당선,신갈,5816,5658,11474
405,20200109,수인분당선,기흥,11862,11134,22996
406,20200109,수인분당선,상갈,6692,6156,12848
407,20200109,수인분당선,청명,5223,4862,10085
408,20200109,수인분당선,영통,10488,10465,20953
409,20200109,수인분당선,망포,16081,15199,31280
410,20200109,수인분당선,매탄권선,5142,4911,10053
411,20200109,수인분당선,수원시청,13118,14556,27674
412,20200109,수인분당선,매교,2619,2647,5266
413,20200109,수인분당선,달월,69,49,118
414,20200109,수인분당선,월곶,2762,2570,5332
415,20200109,수인분당선,소래포구,5123,4658,9781
416,20200109,수인분당선,인천논현,6599,7106,13705
417,20200109,수인분당선,호구포,4059,3991,8050
418,20200109,수인분당선,남동인더스파크,2332,2556,4888
419,20200109,수인분당선,원인재,4739,4883,9622
420,20200109,수인분당선,연수,5063,5070,10133
421,20200109,수인분당선,송도,2805,2672,5477
422,20200109,수인분당선,인하대,5859,5492,11351
423,20200109,수인분당선,숭의,4174,3925,8099
424,20200109,수인분당선,신포,1974,2015,3989
425,20200109,수인분당선,인천,1085,1826,2911
426,20200110,수인분당선,선릉,15202,24680,39882
427,20200110,수인분당선,한티,17890,18829,36719
428,20200110,수인분당선,도곡,8286,8241,16527
429,20200110,수인분당선,구룡,1946,1853,3799
430,20200110,수인분당선,개포동,4276,4570,8846
431,20200110,수인분당선,대모산입구,4060,3677,7737
432,20200110,수인분당선,수서,18149,18324,36473
433,20200110,수인분당선,복정,2,0,2
434,20200110,수인분당선,수원,10442,7388,17830
435,20200110,수인분당선,서울숲,9875,9967,19842
436,20200110,수인분당선,압구정로데오,20516,24014,44530
437,20200110,수인분당선,강남구청,12046,13880,25926
438,20200110,수인분당선,선정릉,9659,10261,19920
439,20200110,수인분당선,가천대,8363,8995,17358
440,20200110,수인분당선,태평,16166,15707,31873
441,20200110,수인분당선,모란,24915,25341,50256
442,20200110,수인분당선,야탑,34427,36289,70716
443,20200110,수인분당선,서현,34453,35344,69797
444,20200110,수인분당선,수내,17214,17031,34245
445,20200110,수인분당선,정자,21417,23186,44603
446,20200110,수인분당선,미금,20579,21976,42555
447,20200110,수인분당선,오리,15192,12613,27805
448,20200110,수인분당선,이매,7309,6747,14056
449,20200110,수인분당선,보정,3076,2515,5591
450,20200110,수인분당선,죽전,17879,19060,36939
451,20200110,수인분당선,구성,6087,5923,12010
452,20200110,수인분당선,신갈,5986,5734,11720
453,20200110,수인분당선,기흥,12061,11197,23258
454,20200110,수인분당선,상갈,7132,6333,13465
455,20200110,수인분당선,청명,5366,4731,10097
456,20200110,수인분당선,영통,11315,11356,22671
457,20200110,수인분당선,망포,17845,15733,33578
458,20200110,수인분당선,매탄권선,5539,5067,10606
459,20200110,수인분당선,수원시청,14271,17486,31757
460,20200110,수인분당선,매교,2709,2835,5544
461,20200110,수인분당선,달월,75,43,118
462,20200110,수인분당선,월곶,2642,2397,5039
463,20200110,수인분당선,소래포구,5365,4952,10317
464,20200110,수인분당선,인천논현,7008,7352,14360
465,20200110,수인분당선,호구포,4158,4022,8180
466,20200110,수인분당선,남동인더스파크,2320,2558,4878
467,20200110,수인분당선,원인재,4998,5020,10018
468,20200110,수인분당선,연수,5466,5698,11164
469,20200110,수인분당선,송도,3084,2817,5901
470,20200110,수인분당선,인하대,6101,5680,11781
471,20200110,수인분당선,숭의,4306,3865,8171
472,20200110,수인분당선,신포,1969,2074,4043
473,20200110,수인분당선,인천,1158,1964,3122
474,20200111,수인분당선,선릉,6367,10703,17070
475,20200111,수인분당선,한티,15800,15278,31078
476,20200111,수인분당선,도곡,5440,4978,10418
477,20200111,수인분당선,구룡,1109,1069,2178
478,20200111,수인분당선,개포동,2871,2920,5791
479,20200111,수인분당선,대모산입구,2872,2563,5435
480,20200111,수인분당선,수서,13129,13136,26265
481,20200111,수인분당선,복정,1,0,1
482,20200111,수인분당선,수원,8836,6239,15075
483,20200111,수인분당선,서울숲,6655,6826,13481
484,20200111,수인분당선,압구정로데오,17532,20305,37837
485,20200111,수인분당선,강남구청,6773,7956,14729
486,20200111,수인분당선,선정릉,4623,4700,9323
487,20200111,수인분당선,가천대,5764,6307,12071
488,20200111,수인분당선,태평,12768,12258,25026
489,20200111,수인분당선,모란,21066,21263,42329
490,20200111,수인분당선,야탑,24942,26754,51696
491,20200111,수인분당선,서현,25425,25363,50788
492,20200111,수인분당선,수내,11090,10404,21494
493,20200111,수인분당선,정자,13310,13529,26839
494,20200111,수인분당선,미금,14240,14996,29236
495,20200111,수인분당선,오리,10373,8372,18745
496,20200111,수인분당선,이매,5348,5278,10626
497,20200111,수인분당선,보정,2191,1943,4134
498,20200111,수인분당선,죽전,12745,14316,27061
499,20200111,수인분당선,구성,4131,4059,8190
500,20200111,수인분당선,신갈,3989,3875,7864
501,20200111,수인분당선,기흥,8642,8084,16726
502,20200111,수인분당선,상갈,5018,4807,9825
503,20200111,수인분당선,청명,3494,3289,6783
504,20200111,수인분당선,영통,8781,8617,17398
505,20200111,수인분당선,망포,11544,10328,21872
506,20200111,수인분당선,매탄권선,3968,3598,7566
507,20200111,수인분당선,수원시청,13328,16275,29603
508,20200111,수인분당선,매교,1893,2052,3945
509,20200111,수인분당선,달월,50,32,82
510,20200111,수인분당선,월곶,2380,2174,4554
511,20200111,수인분당선,소래포구,5315,5288,10603
512,20200111,수인분당선,인천논현,5119,5276,10395
513,20200111,수인분당선,호구포,2732,2717,5449
514,20200111,수인분당선,남동인더스파크,1000,897,1897
515,20200111,수인분당선,원인재,4085,3999,8084
516,20200111,수인분당선,연수,4926,4946,9872
517,20200111,수인분당선,송도,2477,2366,4843
518,20200111,수인분당선,인하대,4334,4134,8468
519,20200111,수인분당선,숭의,2972,2749,5721
520,20200111,수인분당선,신포,1605,1822,3427
521,20200111,수인분당선,인천,1301,2453,3754
522,20200112,수인분당선,선릉,3111,4958,8069
523,20200112,수인분당선,한티,10933,10324,21257
524,20200112,수인분당선,도곡,2898,2940,5838
525,20200112,수인분당선,구룡,726,771,1497
526,20200112,수인분당선,개포동,2436,2363,4799
527,20200112,수인분당선,대모산입구,1819,1685,3504
528,20200112,수인분당선,수서,9883,9736,19619
529,20200112,수인분당선,복정,1,0,1
530,20200112,수인분당선,수원,6408,4470,10878
531,20200112,수인분당선,서울숲,4341,4480,8821
532,20200112,수인분당선,압구정로데오,9374,10191,19565
533,20200112,수인분당선,강남구청,3907,4711,8618
534,20200112,수인분당선,선정릉,2726,2933,5659
535,20200112,수인분당선,가천대,4140,4948,9088
536,20200112,수인분당선,태평,9819,9443,19262
537,20200112,수인분당선,모란,14044,14285,28329
538,20200112,수인분당선,야탑,18639,18694,37333
539,20200112,수인분당선,서현,19052,17290,36342
540,20200112,수인분당선,수내,7743,7487,15230
541,20200112,수인분당선,정자,8635,9241,17876
542,20200112,수인분당선,미금,10259,11068,21327
543,20200112,수인분당선,오리,7379,6330,13709
544,20200112,수인분당선,이매,5101,5181,10282
545,20200112,수인분당선,보정,1360,1296,2656
546,20200112,수인분당선,죽전,9505,10904,20409
547,20200112,수인분당선,구성,2742,3060,5802
548,20200112,수인분당선,신갈,2510,2572,5082
549,20200112,수인분당선,기흥,6013,6112,12125
550,20200112,수인분당선,상갈,3595,3650,7245
551,20200112,수인분당선,청명,2451,2451,4902
552,20200112,수인분당선,영통,5667,5730,11397
553,20200112,수인분당선,망포,7430,7616,15046
554,20200112,수인분당선,매탄권선,2789,2749,5538
555,20200112,수인분당선,수원시청,8959,8882,17841
556,20200112,수인분당선,매교,1611,1602,3213
557,20200112,수인분당선,달월,29,23,52
558,20200112,수인분당선,월곶,1689,1608,3297
559,20200112,수인분당선,소래포구,4107,4001,8108
560,20200112,수인분당선,인천논현,3502,3678,7180
561,20200112,수인분당선,호구포,2543,2477,5020
562,20200112,수인분당선,남동인더스파크,580,616,1196
563,20200112,수인분당선,원인재,3032,3287,6319
564,20200112,수인분당선,연수,4042,4003,8045
565,20200112,수인분당선,송도,1757,1795,3552
566,20200112,수인분당선,인하대,3335,3164,6499
567,20200112,수인분당선,숭의,2032,1912,3944
568,20200112,수인분당선,신포,1399,1347,2746
569,20200112,수인분당선,인천,1105,1701,2806
570,20200113,수인분당선,선릉,15071,24753,39824
571,20200113,수인분당선,한티,16967,18077,35044
572,20200113,수인분당선,도곡,7978,8105,16083
573,20200113,수인분당선,구룡,1849,1779,3628
574,20200113,수인분당선,개포동,3955,4157,8112
575,20200113,수인분당선,대모산입구,3860,3563,7423
576,20200113,수인분당선,수서,15726,16362,32088
577,20200113,수인분당선,수원,9235,6584,15819
578,20200113,수인분당선,서울숲,9222,9252,18474
579,20200113,수인분당선,압구정로데오,17761,20049,37810
580,20200113,수인분당선,강남구청,11190,13010,24200
581,20200113,수인분당선,선정릉,9816,10374,20190
582,20200113,수인분당선,가천대,8256,9458,17714
583,20200113,수인분당선,태평,15534,15291,30825
584,20200113,수인분당선,모란,23314,23447,46761
585,20200113,수인분당선,야탑,32464,33943,66407
586,20200113,수인분당선,서현,31674,31978,63652
587,20200113,수인분당선,수내,15911,15714,31625
588,20200113,수인분당선,정자,20030,21345,41375
589,20200113,수인분당선,미금,19925,21189,41114
590,20200113,수인분당선,오리,14386,12360,26746
591,20200113,수인분당선,이매,6420,6211,12631
592,20200113,수인분당선,보정,3004,2537,5541
593,20200113,수인분당선,죽전,15953,17537,33490
594,20200113,수인분당선,구성,5928,5949,11877
595,20200113,수인분당선,신갈,5957,5623,11580
596,20200113,수인분당선,기흥,11319,10917,22236
597,20200113,수인분당선,상갈,6459,6046,12505
598,20200113,수인분당선,청명,4836,4571,9407
599,20200113,수인분당선,영통,10067,10367,20434
600,20200113,수인분당선,망포,15716,14537,30253
601,20200113,수인분당선,매탄권선,5016,4743,9759
602,20200113,수인분당선,수원시청,12856,14054,26910
603,20200113,수인분당선,매교,2642,2707,5349
604,20200113,수인분당선,달월,87,65,152
605,20200113,수인분당선,월곶,2552,2390,4942
606,20200113,수인분당선,소래포구,4788,4351,9139
607,20200113,수인분당선,인천논현,6470,6848,13318
608,20200113,수인분당선,호구포,3849,3950,7799
609,20200113,수인분당선,남동인더스파크,2294,2527,4821
610,20200113,수인분당선,원인재,4771,4811,9582
611,20200113,수인분당선,연수,5095,5041,10136
612,20200113,수인분당선,송도,2721,2577,5298
613,20200113,수인분당선,인하대,5852,5490,11342
614,20200113,수인분당선,숭의,4044,3890,7934
615,20200113,수인분당선,신포,1840,1883,3723
616,20200113,수인분당선,인천,1081,1873,2954
617,20200114,수인분당선,인천,1049,1845,2894
618,20200114,수인분당선,신포,1833,1960,3793
619,20200114,수인분당선,숭의,4186,3925,8111
620,20200114,수인분당선,인하대,5857,5597,11454
621,20200114,수인분당선,송도,2841,2668,5509
622,20200114,수인분당선,연수,5113,5183,10296
623,20200114,수인분당선,원인재,4753,4768,9521
624,20200114,수인분당선,남동인더스파크,2303,2579,4882
625,20200114,수인분당선,호구포,3887,3856,7743
626,20200114,수인분당선,인천논현,6423,6659,13082
627,20200114,수인분당선,소래포구,4898,4548,9446
628,20200114,수인분당선,월곶,2427,2333,4760
629,20200114,수인분당선,달월,80,51,131
630,20200114,수인분당선,매교,2669,2696,5365
631,20200114,수인분당선,수원시청,13244,14496,27740
632,20200114,수인분당선,매탄권선,5052,4840,9892
633,20200114,수인분당선,망포,15920,14822,30742
634,20200114,수인분당선,영통,10311,10396,20707
635,20200114,수인분당선,청명,4954,4558,9512
636,20200114,수인분당선,상갈,6683,6167,12850
637,20200114,수인분당선,기흥,11680,11013,22693
638,20200114,수인분당선,신갈,5798,5609,11407
639,20200114,수인분당선,구성,5991,6040,12031
640,20200114,수인분당선,죽전,16598,18229,34827
641,20200114,수인분당선,보정,3170,2637,5807
642,20200114,수인분당선,이매,6605,6432,13037
643,20200114,수인분당선,오리,14992,12441,27433
644,20200114,수인분당선,미금,19947,21599,41546
645,20200114,수인분당선,정자,20731,21936,42667
646,20200114,수인분당선,수내,16481,16463,32944
647,20200114,수인분당선,서현,32125,32522,64647
648,20200114,수인분당선,야탑,32703,34411,67114
649,20200114,수인분당선,모란,30555,31589,62144
650,20200114,수인분당선,태평,16003,15609,31612
651,20200114,수인분당선,가천대,8043,9243,17286
652,20200114,수인분당선,선정릉,9852,10573,20425
653,20200114,수인분당선,강남구청,11548,13284,24832
654,20200114,수인분당선,압구정로데오,19455,21765,41220
655,20200114,수인분당선,서울숲,9697,9761,19458
656,20200114,수인분당선,수원,9193,6495,15688
657,20200114,수인분당선,복정,1,0,1
658,20200114,수인분당선,수서,16273,16477,32750
659,20200114,수인분당선,대모산입구,4023,3760,7783
660,20200114,수인분당선,개포동,3998,4250,8248
661,20200114,수인분당선,구룡,1886,1852,3738
662,20200114,수인분당선,도곡,8088,8235,16323
663,20200114,수인분당선,한티,17671,18608,36279
664,20200114,수인분당선,선릉,15671,24797,40468
665,20200115,수인분당선,선릉,15524,24828,40352
666,20200115,수인분당선,한티,17536,18646,36182
667,20200115,수인분당선,도곡,8308,8131,16439
668,20200115,수인분당선,구룡,1869,1857,3726
669,20200115,수인분당선,개포동,4299,4491,8790
670,20200115,수인분당선,대모산입구,3950,3697,7647
671,20200115,수인분당선,수서,15951,16585,32536
672,20200115,수인분당선,수원,9435,6826,16261
673,20200115,수인분당선,서울숲,10331,10457,20788
674,20200115,수인분당선,압구정로데오,19108,21531,40639
675,20200115,수인분당선,강남구청,11755,13492,25247
676,20200115,수인분당선,선정릉,9939,10588,20527
677,20200115,수인분당선,가천대,7995,9049,17044
678,20200115,수인분당선,태평,15660,15543,31203
679,20200115,수인분당선,모란,23614,23880,47494
680,20200115,수인분당선,야탑,33448,34997,68445
681,20200115,수인분당선,서현,31834,32063,63897
682,20200115,수인분당선,수내,16750,16638,33388
683,20200115,수인분당선,정자,20968,22252,43220
684,20200115,수인분당선,미금,20147,21635,41782
685,20200115,수인분당선,오리,14877,12569,27446
686,20200115,수인분당선,이매,6859,6627,13486
687,20200115,수인분당선,보정,3077,2551,5628
688,20200115,수인분당선,죽전,16444,18071,34515
689,20200115,수인분당선,구성,5958,5919,11877
690,20200115,수인분당선,신갈,5820,5626,11446
691,20200115,수인분당선,기흥,11643,10980,22623
692,20200115,수인분당선,상갈,6633,6079,12712
693,20200115,수인분당선,청명,4940,4662,9602
694,20200115,수인분당선,영통,10253,10320,20573
695,20200115,수인분당선,망포,16041,14870,30911
696,20200115,수인분당선,매탄권선,5127,4905,10032
697,20200115,수인분당선,수원시청,13591,14873,28464
698,20200115,수인분당선,매교,2603,2601,5204
699,20200115,수인분당선,달월,73,54,127
700,20200115,수인분당선,월곶,2749,2533,5282
701,20200115,수인분당선,소래포구,4715,4405,9120
702,20200115,수인분당선,인천논현,6403,6661,13064
703,20200115,수인분당선,호구포,3940,3917,7857
704,20200115,수인분당선,남동인더스파크,2379,2626,5005
705,20200115,수인분당선,원인재,4793,4863,9656
706,20200115,수인분당선,연수,5229,5290,10519
707,20200115,수인분당선,송도,2946,2753,5699
708,20200115,수인분당선,인하대,5783,5540,11323
709,20200115,수인분당선,숭의,4208,3974,8182
710,20200115,수인분당선,신포,1929,2106,4035
711,20200115,수인분당선,인천,1065,1799,2864
712,20200116,수인분당선,인천,1031,1799,2830
713,20200116,수인분당선,신포,1868,1935,3803
714,20200116,수인분당선,숭의,4140,3922,8062
715,20200116,수인분당선,인하대,5786,5407,11193
716,20200116,수인분당선,송도,2826,2638,5464
717,20200116,수인분당선,연수,5312,5295,10607
718,20200116,수인분당선,원인재,4846,4956,9802
719,20200116,수인분당선,남동인더스파크,2309,2568,4877
720,20200116,수인분당선,호구포,3855,3971,7826
721,20200116,수인분당선,인천논현,6470,6669,13139
722,20200116,수인분당선,소래포구,4816,4469,9285
723,20200116,수인분당선,월곶,2717,2565,5282
724,20200116,수인분당선,달월,70,46,116
725,20200116,수인분당선,매교,2616,2647,5263
726,20200116,수인분당선,수원시청,13325,14818,28143
727,20200116,수인분당선,매탄권선,5221,4880,10101
728,20200116,수인분당선,망포,16114,14911,31025
729,20200116,수인분당선,영통,10233,10240,20473
730,20200116,수인분당선,청명,4948,4604,9552
731,20200116,수인분당선,상갈,6472,5983,12455
732,20200116,수인분당선,기흥,11372,10865,22237
733,20200116,수인분당선,신갈,5844,5568,11412
734,20200116,수인분당선,구성,5929,5864,11793
735,20200116,수인분당선,죽전,16309,17968,34277
736,20200116,수인분당선,보정,3016,2487,5503
737,20200116,수인분당선,이매,6687,6396,13083
738,20200116,수인분당선,오리,15092,12942,28034
739,20200116,수인분당선,미금,20299,21645,41944
740,20200116,수인분당선,정자,20626,22029,42655
741,20200116,수인분당선,수내,16537,16673,33210
742,20200116,수인분당선,서현,31917,31997,63914
743,20200116,수인분당선,야탑,33491,34833,68324
744,20200116,수인분당선,모란,23923,24054,47977
745,20200116,수인분당선,태평,15928,15531,31459
746,20200116,수인분당선,가천대,8123,9149,17272
747,20200116,수인분당선,선정릉,9711,10552,20263
748,20200116,수인분당선,강남구청,11889,13791,25680
749,20200116,수인분당선,압구정로데오,19380,22250,41630
750,20200116,수인분당선,서울숲,10015,10031,20046
751,20200116,수인분당선,수원,9306,6496,15802
752,20200116,수인분당선,수서,16401,16616,33017
753,20200116,수인분당선,대모산입구,3981,3658,7639
754,20200116,수인분당선,개포동,4252,4348,8600
755,20200116,수인분당선,구룡,1874,1766,3640
756,20200116,수인분당선,도곡,7941,8056,15997
757,20200116,수인분당선,한티,17423,18437,35860
758,20200116,수인분당선,선릉,15594,25108,40702
759,20200117,수인분당선,선릉,15459,25082,40541
760,20200117,수인분당선,한티,18233,19027,37260
761,20200117,수인분당선,도곡,8399,8166,16565
762,20200117,수인분당선,구룡,1914,1768,3682
763,20200117,수인분당선,개포동,4337,4550,8887
764,20200117,수인분당선,대모산입구,3995,3658,7653
765,20200117,수인분당선,수서,18311,18205,36516
766,20200117,수인분당선,복정,1,0,1
767,20200117,수인분당선,수원,10364,7319,17683
768,20200117,수인분당선,서울숲,10024,10032,20056
769,20200117,수인분당선,압구정로데오,21458,25057,46515
770,20200117,수인분당선,강남구청,12111,13782,25893
771,20200117,수인분당선,선정릉,9809,10553,20362
772,20200117,수인분당선,가천대,8384,8952,17336
773,20200117,수인분당선,태평,16273,16022,32295
774,20200117,수인분당선,모란,24918,25272,50190
775,20200117,수인분당선,야탑,35072,36806,71878
776,20200117,수인분당선,서현,34642,35428,70070
777,20200117,수인분당선,수내,17243,17167,34410
778,20200117,수인분당선,정자,21935,23225,45160
779,20200117,수인분당선,미금,20613,22095,42708
780,20200117,수인분당선,오리,15232,12901,28133
781,20200117,수인분당선,이매,7070,6790,13860
782,20200117,수인분당선,보정,3131,2562,5693
783,20200117,수인분당선,죽전,17547,18614,36161
784,20200117,수인분당선,구성,6172,5871,12043
785,20200117,수인분당선,신갈,6058,5745,11803
786,20200117,수인분당선,기흥,12008,11243,23251
787,20200117,수인분당선,상갈,6947,6253,13200
788,20200117,수인분당선,청명,5374,4899,10273
789,20200117,수인분당선,영통,11010,11215,22225
790,20200117,수인분당선,망포,17515,15517,33032
791,20200117,수인분당선,매탄권선,5450,4989,10439
792,20200117,수인분당선,수원시청,14552,18011,32563
793,20200117,수인분당선,매교,2711,2760,5471
794,20200117,수인분당선,달월,75,47,122
795,20200117,수인분당선,월곶,2623,2475,5098
796,20200117,수인분당선,소래포구,5122,4734,9856
797,20200117,수인분당선,인천논현,6767,7119,13886
798,20200117,수인분당선,호구포,3945,3985,7930
799,20200117,수인분당선,남동인더스파크,2351,2581,4932
800,20200117,수인분당선,원인재,5083,5115,10198
801,20200117,수인분당선,연수,5687,5680,11367
802,20200117,수인분당선,송도,2879,2670,5549
803,20200117,수인분당선,인하대,5954,5488,11442
804,20200117,수인분당선,숭의,4312,3974,8286
805,20200117,수인분당선,신포,1889,2051,3940
806,20200117,수인분당선,인천,1108,1855,2963
807,20200118,수인분당선,선릉,6646,10954,17600
808,20200118,수인분당선,한티,15124,14615,29739
809,20200118,수인분당선,도곡,5764,5364,11128
810,20200118,수인분당선,구룡,1067,1055,2122
811,20200118,수인분당선,개포동,3074,2980,6054
812,20200118,수인분당선,대모산입구,3178,2952,6130
813,20200118,수인분당선,수서,12803,12888,25691
814,20200118,수인분당선,복정,1,0,1
815,20200118,수인분당선,수원,8571,6030,14601
816,20200118,수인분당선,서울숲,6988,7161,14149
817,20200118,수인분당선,압구정로데오,18099,20862,38961
818,20200118,수인분당선,강남구청,6665,8067,14732
819,20200118,수인분당선,선정릉,4958,5072,10030
820,20200118,수인분당선,가천대,5814,6290,12104
821,20200118,수인분당선,태평,12783,12494,25277
822,20200118,수인분당선,모란,19952,20461,40413
823,20200118,수인분당선,야탑,24733,25974,50707
824,20200118,수인분당선,서현,25281,25714,50995
825,20200118,수인분당선,수내,11195,10459,21654
826,20200118,수인분당선,정자,13500,13682,27182
827,20200118,수인분당선,미금,14133,14836,28969
828,20200118,수인분당선,오리,10523,8602,19125
829,20200118,수인분당선,이매,5082,4886,9968
830,20200118,수인분당선,보정,2193,1896,4089
831,20200118,수인분당선,죽전,12958,14501,27459
832,20200118,수인분당선,구성,4050,4023,8073
833,20200118,수인분당선,신갈,3601,3592,7193
834,20200118,수인분당선,기흥,8437,7897,16334
835,20200118,수인분당선,상갈,4907,4639,9546
836,20200118,수인분당선,청명,3594,3454,7048
837,20200118,수인분당선,영통,9533,8921,18454
838,20200118,수인분당선,망포,11336,10241,21577
839,20200118,수인분당선,매탄권선,3839,3508,7347
840,20200118,수인분당선,수원시청,13258,16101,29359
841,20200118,수인분당선,매교,1875,1984,3859
842,20200118,수인분당선,달월,31,28,59
843,20200118,수인분당선,월곶,2202,2167,4369
844,20200118,수인분당선,소래포구,4917,4914,9831
845,20200118,수인분당선,인천논현,5196,5322,10518
846,20200118,수인분당선,호구포,2772,2708,5480
847,20200118,수인분당선,남동인더스파크,1066,974,2040
848,20200118,수인분당선,원인재,4090,4205,8295
849,20200118,수인분당선,연수,4863,4920,9783
850,20200118,수인분당선,송도,2430,2333,4763
851,20200118,수인분당선,인하대,4243,3948,8191
852,20200118,수인분당선,숭의,2972,2766,5738
853,20200118,수인분당선,신포,1655,1869,3524
854,20200118,수인분당선,인천,1298,2249,3547
855,20200119,수인분당선,선릉,3022,4725,7747
856,20200119,수인분당선,한티,10780,10245,21025
857,20200119,수인분당선,도곡,2986,3108,6094
858,20200119,수인분당선,구룡,720,743,1463
859,20200119,수인분당선,개포동,2392,2335,4727
860,20200119,수인분당선,대모산입구,1942,1855,3797
861,20200119,수인분당선,수서,10069,9983,20052
862,20200119,수인분당선,수원,6340,4371,10711
863,20200119,수인분당선,서울숲,4160,4235,8395
864,20200119,수인분당선,압구정로데오,9657,10708,20365
865,20200119,수인분당선,강남구청,3609,4448,8057
866,20200119,수인분당선,선정릉,2674,2792,5466
867,20200119,수인분당선,가천대,4009,4876,8885
868,20200119,수인분당선,태평,9940,9769,19709
869,20200119,수인분당선,모란,23159,24431,47590
870,20200119,수인분당선,야탑,18673,18857,37530
871,20200119,수인분당선,서현,19754,19225,38979
872,20200119,수인분당선,수내,7635,7571,15206
873,20200119,수인분당선,정자,8968,9214,18182
874,20200119,수인분당선,미금,10591,11331,21922
875,20200119,수인분당선,오리,7665,6751,14416
876,20200119,수인분당선,이매,5153,5255,10408
877,20200119,수인분당선,보정,1436,1344,2780
878,20200119,수인분당선,죽전,10212,11730,21942
879,20200119,수인분당선,구성,3032,3158,6190
880,20200119,수인분당선,신갈,2600,2670,5270
881,20200119,수인분당선,기흥,6193,6135,12328
882,20200119,수인분당선,상갈,3596,3581,7177
883,20200119,수인분당선,청명,2498,2496,4994
884,20200119,수인분당선,영통,5979,5889,11868
885,20200119,수인분당선,망포,7344,7713,15057
886,20200119,수인분당선,매탄권선,2750,2697,5447
887,20200119,수인분당선,수원시청,9416,9201,18617
888,20200119,수인분당선,매교,1365,1437,2802
889,20200119,수인분당선,달월,24,19,43
890,20200119,수인분당선,월곶,1651,1497,3148
891,20200119,수인분당선,소래포구,3420,3354,6774
892,20200119,수인분당선,인천논현,3540,3674,7214
893,20200119,수인분당선,호구포,2095,2084,4179
894,20200119,수인분당선,남동인더스파크,731,781,1512
895,20200119,수인분당선,원인재,2987,3117,6104
896,20200119,수인분당선,연수,3922,3844,7766
897,20200119,수인분당선,송도,1828,1737,3565
898,20200119,수인분당선,인하대,2924,2858,5782
899,20200119,수인분당선,숭의,1987,1913,3900
900,20200119,수인분당선,신포,1292,1290,2582
901,20200119,수인분당선,인천,1127,1631,2758
902,20200120,수인분당선,인천,982,1674,2656
903,20200120,수인분당선,신포,1811,1898,3709
904,20200120,수인분당선,숭의,4101,3925,8026
905,20200120,수인분당선,인하대,5678,5319,10997
906,20200120,수인분당선,송도,2875,2734,5609
907,20200120,수인분당선,연수,5039,5004,10043
908,20200120,수인분당선,원인재,4873,4830,9703
909,20200120,수인분당선,남동인더스파크,2414,2607,5021
910,20200120,수인분당선,호구포,3808,3859,7667
911,20200120,수인분당선,인천논현,6429,6635,13064
912,20200120,수인분당선,소래포구,4760,4310,9070
913,20200120,수인분당선,월곶,2488,2341,4829
914,20200120,수인분당선,달월,83,54,137
915,20200120,수인분당선,매교,2683,2664,5347
916,20200120,수인분당선,수원시청,13221,14559,27780
917,20200120,수인분당선,매탄권선,5119,4814,9933
918,20200120,수인분당선,망포,15929,14689,30618
919,20200120,수인분당선,영통,9894,10102,19996
920,20200120,수인분당선,청명,4921,4503,9424
921,20200120,수인분당선,상갈,6633,6118,12751
922,20200120,수인분당선,기흥,11536,10966,22502
923,20200120,수인분당선,신갈,5821,5619,11440
924,20200120,수인분당선,구성,5907,5804,11711
925,20200120,수인분당선,죽전,16166,17716,33882
926,20200120,수인분당선,보정,3067,2544,5611
927,20200120,수인분당선,이매,6535,6375,12910
928,20200120,수인분당선,오리,14666,12627,27293
929,20200120,수인분당선,미금,20290,21579,41869
930,20200120,수인분당선,정자,20071,21694,41765
931,20200120,수인분당선,수내,16217,16134,32351
932,20200120,수인분당선,서현,32455,32764,65219
933,20200120,수인분당선,야탑,32549,34160,66709
934,20200120,수인분당선,모란,23631,23727,47358
935,20200120,수인분당선,태평,15812,15488,31300
936,20200120,수인분당선,가천대,8240,9203,17443
937,20200120,수인분당선,선정릉,10095,10739,20834
938,20200120,수인분당선,강남구청,11535,13373,24908
939,20200120,수인분당선,압구정로데오,18751,20896,39647
940,20200120,수인분당선,서울숲,9270,9374,18644
941,20200120,수인분당선,수원,9312,6541,15853
942,20200120,수인분당선,복정,1,0,1
943,20200120,수인분당선,수서,15874,16712,32586
944,20200120,수인분당선,대모산입구,4028,3734,7762
945,20200120,수인분당선,개포동,4402,4587,8989
946,20200120,수인분당선,구룡,1741,1751,3492
947,20200120,수인분당선,도곡,8133,8141,16274
948,20200120,수인분당선,한티,17050,18081,35131
949,20200120,수인분당선,선릉,15438,24938,40376
950,20200121,수인분당선,선릉,15459,24668,40127
951,20200121,수인분당선,한티,17457,18565,36022
952,20200121,수인분당선,도곡,8126,8062,16188
953,20200121,수인분당선,구룡,1668,1617,3285
954,20200121,수인분당선,개포동,4385,4440,8825
955,20200121,수인분당선,대모산입구,3947,3736,7683
956,20200121,수인분당선,수서,16046,16645,32691
957,20200121,수인분당선,수원,9322,6708,16030
958,20200121,수인분당선,서울숲,9944,10078,20022
959,20200121,수인분당선,압구정로데오,20074,22368,42442
960,20200121,수인분당선,강남구청,11533,13456,24989
961,20200121,수인분당선,선정릉,10195,10631,20826
962,20200121,수인분당선,가천대,8272,9171,17443
963,20200121,수인분당선,태평,16001,15632,31633
964,20200121,수인분당선,모란,23942,23845,47787
965,20200121,수인분당선,야탑,32398,33953,66351
966,20200121,수인분당선,서현,32129,32571,64700
967,20200121,수인분당선,수내,16790,16740,33530
968,20200121,수인분당선,정자,20539,21801,42340
969,20200121,수인분당선,미금,20241,21554,41795
970,20200121,수인분당선,오리,14927,12836,27763
971,20200121,수인분당선,이매,6699,6361,13060
972,20200121,수인분당선,보정,3050,2594,5644
973,20200121,수인분당선,죽전,16438,18047,34485
974,20200121,수인분당선,구성,5776,5710,11486
975,20200121,수인분당선,신갈,5733,5608,11341
976,20200121,수인분당선,기흥,11546,10809,22355
977,20200121,수인분당선,상갈,6556,6025,12581
978,20200121,수인분당선,청명,5043,4604,9647
979,20200121,수인분당선,영통,10507,10372,20879
980,20200121,수인분당선,망포,16042,15007,31049
981,20200121,수인분당선,매탄권선,5127,4856,9983
982,20200121,수인분당선,수원시청,13517,14839,28356
983,20200121,수인분당선,매교,2676,2632,5308
984,20200121,수인분당선,달월,90,58,148
985,20200121,수인분당선,월곶,2428,2326,4754
986,20200121,수인분당선,소래포구,4770,4412,9182
987,20200121,수인분당선,인천논현,6358,6657,13015
988,20200121,수인분당선,호구포,3847,3851,7698
989,20200121,수인분당선,남동인더스파크,2461,2663,5124
990,20200121,수인분당선,원인재,4897,4967,9864
991,20200121,수인분당선,연수,5049,5019,10068
992,20200121,수인분당선,송도,2813,2671,5484
993,20200121,수인분당선,인하대,5558,5212,10770
994,20200121,수인분당선,숭의,4131,3919,8050
995,20200121,수인분당선,신포,1909,1936,3845
996,20200121,수인분당선,인천,1021,1696,2717
997,20200122,수인분당선,선릉,15053,24242,39295
998,20200122,수인분당선,한티,17580,18454,36034
999,20200122,수인분당선,도곡,7827,7847,15674
1000,20200122,수인분당선,구룡,1610,1584,3194
1001,20200122,수인분당선,개포동,4581,4769,9350
1002,20200122,수인분당선,대모산입구,4006,3651,7657
1003,20200122,수인분당선,수서,15618,16771,32389
1004,20200122,수인분당선,복정,1,0,1
1005,20200122,수인분당선,수원,9333,6765,16098
1006,20200122,수인분당선,서울숲,9712,9759,19471
1007,20200122,수인분당선,압구정로데오,19443,21879,41322
1008,20200122,수인분당선,강남구청,11875,13612,25487
1009,20200122,수인분당선,선정릉,9653,10283,19936
1010,20200122,수인분당선,가천대,7486,8212,15698
1011,20200122,수인분당선,태평,16209,15820,32029
1012,20200122,수인분당선,모란,23743,23945,47688
1013,20200122,수인분당선,야탑,33546,35539,69085
1014,20200122,수인분당선,서현,32498,32863,65361
1015,20200122,수인분당선,수내,16630,16723,33353
1016,20200122,수인분당선,정자,20730,21846,42576
1017,20200122,수인분당선,미금,20311,21514,41825
1018,20200122,수인분당선,오리,14974,12766,27740
1019,20200122,수인분당선,이매,6727,6504,13231
1020,20200122,수인분당선,보정,2971,2522,5493
1021,20200122,수인분당선,죽전,16524,18119,34643
1022,20200122,수인분당선,구성,5797,5827,11624
1023,20200122,수인분당선,신갈,5787,5598,11385
1024,20200122,수인분당선,기흥,11360,10701,22061
1025,20200122,수인분당선,상갈,6599,6054,12653
1026,20200122,수인분당선,청명,5020,4519,9539
1027,20200122,수인분당선,영통,10439,10336,20775
1028,20200122,수인분당선,망포,16266,14783,31049
1029,20200122,수인분당선,매탄권선,5074,4773,9847
1030,20200122,수인분당선,수원시청,13371,14656,28027
1031,20200122,수인분당선,매교,2582,2671,5253
1032,20200122,수인분당선,달월,72,48,120
1033,20200122,수인분당선,월곶,2718,2616,5334
1034,20200122,수인분당선,소래포구,4793,4365,9158
1035,20200122,수인분당선,인천논현,6455,6828,13283
1036,20200122,수인분당선,호구포,3954,3862,7816
1037,20200122,수인분당선,남동인더스파크,2250,2533,4783
1038,20200122,수인분당선,원인재,4825,4887,9712
1039,20200122,수인분당선,연수,5086,5284,10370
1040,20200122,수인분당선,송도,2871,2621,5492
1041,20200122,수인분당선,인하대,5606,5203,10809
1042,20200122,수인분당선,숭의,4167,3842,8009
1043,20200122,수인분당선,신포,1852,1964,3816
1044,20200122,수인분당선,인천,957,1645,2602
1045,20200123,수인분당선,선릉,12850,20624,33474
1046,20200123,수인분당선,한티,16750,17350,34100
1047,20200123,수인분당선,도곡,7484,7145,14629
1048,20200123,수인분당선,구룡,1435,1334,2769
1049,20200123,수인분당선,개포동,3884,3954,7838
1050,20200123,수인분당선,대모산입구,3624,3278,6902
1051,20200123,수인분당선,수서,14718,18357,33075
1052,20200123,수인분당선,수원,9635,7360,16995
1053,20200123,수인분당선,서울숲,8923,8567,17490
1054,20200123,수인분당선,압구정로데오,18443,21003,39446
1055,20200123,수인분당선,강남구청,10520,11627,22147
1056,20200123,수인분당선,선정릉,8445,9030,17475
1057,20200123,수인분당선,가천대,6944,7058,14002
1058,20200123,수인분당선,태평,16153,15546,31699
1059,20200123,수인분당선,모란,23473,23766,47239
1060,20200123,수인분당선,야탑,32123,36956,69079
1061,20200123,수인분당선,서현,31405,30538,61943
1062,20200123,수인분당선,수내,15462,15157,30619
1063,20200123,수인분당선,정자,19356,20303,39659
1064,20200123,수인분당선,미금,19176,19811,38987
1065,20200123,수인분당선,오리,14125,12051,26176
1066,20200123,수인분당선,이매,6310,5933,12243
1067,20200123,수인분당선,보정,2738,2339,5077
1068,20200123,수인분당선,죽전,16593,17412,34005
1069,20200123,수인분당선,구성,5466,5300,10766
1070,20200123,수인분당선,신갈,5469,5158,10627
1071,20200123,수인분당선,기흥,11034,10382,21416
1072,20200123,수인분당선,상갈,6390,5673,12063
1073,20200123,수인분당선,청명,4659,4218,8877
1074,20200123,수인분당선,영통,10109,9877,19986
1075,20200123,수인분당선,망포,16381,14101,30482
1076,20200123,수인분당선,매탄권선,5629,4581,10210
1077,20200123,수인분당선,수원시청,13113,15770,28883
1078,20200123,수인분당선,매교,2365,2443,4808
1079,20200123,수인분당선,달월,84,62,146
1080,20200123,수인분당선,월곶,2765,2479,5244
1081,20200123,수인분당선,소래포구,4560,4346,8906
1082,20200123,수인분당선,인천논현,6328,6539,12867
1083,20200123,수인분당선,호구포,3692,3619,7311
1084,20200123,수인분당선,남동인더스파크,2187,2304,4491
1085,20200123,수인분당선,원인재,4766,4872,9638
1086,20200123,수인분당선,연수,4928,5078,10006
1087,20200123,수인분당선,송도,2766,2555,5321
1088,20200123,수인분당선,인하대,5192,4778,9970
1089,20200123,수인분당선,숭의,3952,3574,7526
1090,20200123,수인분당선,신포,1730,1803,3533
1091,20200123,수인분당선,인천,908,1532,2440
1092,20200124,수인분당선,인천,847,1328,2175
1093,20200124,수인분당선,신포,897,918,1815
1094,20200124,수인분당선,숭의,1617,1573,3190
1095,20200124,수인분당선,인하대,2043,1987,4030
1096,20200124,수인분당선,송도,1445,1393,2838
1097,20200124,수인분당선,연수,2734,2627,5361
1098,20200124,수인분당선,원인재,2492,2419,4911
1099,20200124,수인분당선,남동인더스파크,698,586,1284
1100,20200124,수인분당선,호구포,1770,1561,3331
1101,20200124,수인분당선,인천논현,2828,2881,5709
1102,20200124,수인분당선,소래포구,3106,3145,6251
1103,20200124,수인분당선,월곶,1670,1586,3256
1104,20200124,수인분당선,달월,37,34,71
1105,20200124,수인분당선,매교,964,987,1951
1106,20200124,수인분당선,수원시청,5504,5331,10835
1107,20200124,수인분당선,매탄권선,2023,1715,3738
1108,20200124,수인분당선,망포,5437,4299,9736
1109,20200124,수인분당선,영통,4170,3527,7697
1110,20200124,수인분당선,청명,1775,1459,3234
1111,20200124,수인분당선,상갈,2707,2738,5445
1112,20200124,수인분당선,기흥,4377,4332,8709
1113,20200124,수인분당선,신갈,1872,1820,3692
1114,20200124,수인분당선,구성,2026,2287,4313
1115,20200124,수인분당선,죽전,6349,6425,12774
1116,20200124,수인분당선,보정,1045,919,1964
1117,20200124,수인분당선,이매,2673,2556,5229
1118,20200124,수인분당선,오리,5862,4793,10655
1119,20200124,수인분당선,미금,7616,6998,14614
1120,20200124,수인분당선,정자,6452,5780,12232
1121,20200124,수인분당선,수내,5690,4993,10683
1122,20200124,수인분당선,서현,11077,10870,21947
1123,20200124,수인분당선,야탑,13290,16373,29663
1124,20200124,수인분당선,모란,14718,15264,29982
1125,20200124,수인분당선,태평,8480,8026,16506
1126,20200124,수인분당선,가천대,3118,2845,5963
1127,20200124,수인분당선,선정릉,1596,1305,2901
1128,20200124,수인분당선,강남구청,2045,2152,4197
1129,20200124,수인분당선,압구정로데오,5916,6626,12542
1130,20200124,수인분당선,서울숲,2828,2615,5443
1131,20200124,수인분당선,수원,4618,3304,7922
1132,20200124,수인분당선,수서,6273,9943,16216
1133,20200124,수인분당선,대모산입구,1321,1075,2396
1134,20200124,수인분당선,개포동,1613,1413,3026
1135,20200124,수인분당선,구룡,511,437,948
1136,20200124,수인분당선,도곡,2292,2035,4327
1137,20200124,수인분당선,한티,5814,4971,10785
1138,20200124,수인분당선,선릉,1899,2599,4498
1139,20200125,수인분당선,선릉,1098,1746,2844
1140,20200125,수인분당선,한티,3891,3825,7716
1141,20200125,수인분당선,도곡,1345,1326,2671
1142,20200125,수인분당선,구룡,363,396,759
1143,20200125,수인분당선,개포동,1042,1127,2169
1144,20200125,수인분당선,대모산입구,1051,1009,2060
1145,20200125,수인분당선,수서,7221,6885,14106
1146,20200125,수인분당선,수원,4224,2355,6579
1147,20200125,수인분당선,서울숲,1961,2163,4124
1148,20200125,수인분당선,압구정로데오,2244,2724,4968
1149,20200125,수인분당선,강남구청,1180,1370,2550
1150,20200125,수인분당선,선정릉,996,1027,2023
1151,20200125,수인분당선,가천대,2331,2818,5149
1152,20200125,수인분당선,태평,6724,6489,13213
1153,20200125,수인분당선,모란,8000,8403,16403
1154,20200125,수인분당선,야탑,9849,9770,19619
1155,20200125,수인분당선,서현,7050,7461,14511
1156,20200125,수인분당선,수내,2768,2642,5410
1157,20200125,수인분당선,정자,4095,4302,8397
1158,20200125,수인분당선,미금,4712,5099,9811
1159,20200125,수인분당선,오리,3790,3254,7044
1160,20200125,수인분당선,이매,2079,2182,4261
1161,20200125,수인분당선,보정,863,728,1591
1162,20200125,수인분당선,죽전,4298,4886,9184
1163,20200125,수인분당선,구성,1803,1712,3515
1164,20200125,수인분당선,신갈,1541,1531,3072
1165,20200125,수인분당선,기흥,4022,3669,7691
1166,20200125,수인분당선,상갈,2373,2285,4658
1167,20200125,수인분당선,청명,1430,1316,2746
1168,20200125,수인분당선,영통,2755,2830,5585
1169,20200125,수인분당선,망포,3830,3535,7365
1170,20200125,수인분당선,매탄권선,1609,1556,3165
1171,20200125,수인분당선,수원시청,3539,4856,8395
1172,20200125,수인분당선,매교,794,860,1654
1173,20200125,수인분당선,달월,29,21,50
1174,20200125,수인분당선,월곶,1054,965,2019
1175,20200125,수인분당선,소래포구,2668,2623,5291
1176,20200125,수인분당선,인천논현,2224,2369,4593
1177,20200125,수인분당선,호구포,1454,1463,2917
1178,20200125,수인분당선,남동인더스파크,489,471,960
1179,20200125,수인분당선,원인재,2216,2222,4438
1180,20200125,수인분당선,연수,2308,2399,4707
1181,20200125,수인분당선,송도,1278,1205,2483
1182,20200125,수인분당선,인하대,1707,1669,3376
1183,20200125,수인분당선,숭의,1484,1349,2833
1184,20200125,수인분당선,신포,615,657,1272
1185,20200125,수인분당선,인천,999,1354,2353
1186,20200126,수인분당선,선릉,1623,2777,4400
1187,20200126,수인분당선,한티,6525,6804,13329
1188,20200126,수인분당선,도곡,1972,1958,3930
1189,20200126,수인분당선,구룡,513,453,966
1190,20200126,수인분당선,개포동,1863,1898,3761
1191,20200126,수인분당선,대모산입구,1338,1262,2600
1192,20200126,수인분당선,수서,9496,6226,15722
1193,20200126,수인분당선,복정,1,0,1
1194,20200126,수인분당선,수원,6288,3541,9829
1195,20200126,수인분당선,서울숲,3180,3371,6551
1196,20200126,수인분당선,압구정로데오,4444,5430,9874
1197,20200126,수인분당선,강남구청,1914,2314,4228
1198,20200126,수인분당선,선정릉,1307,1515,2822
1199,20200126,수인분당선,가천대,2668,3581,6249
1200,20200126,수인분당선,태평,8167,7689,15856
1201,20200126,수인분당선,모란,11007,11613,22620
1202,20200126,수인분당선,야탑,16055,14857,30912
1203,20200126,수인분당선,서현,14294,14960,29254
1204,20200126,수인분당선,수내,4466,4569,9035
1205,20200126,수인분당선,정자,6364,7221,13585
1206,20200126,수인분당선,미금,7910,8482,16392
1207,20200126,수인분당선,오리,5472,4810,10282
1208,20200126,수인분당선,이매,3502,3655,7157
1209,20200126,수인분당선,보정,1177,1091,2268
1210,20200126,수인분당선,죽전,7570,8906,16476
1211,20200126,수인분당선,구성,2317,2454,4771
1212,20200126,수인분당선,신갈,2021,2043,4064
1213,20200126,수인분당선,기흥,5256,4892,10148
1214,20200126,수인분당선,상갈,3208,3120,6328
1215,20200126,수인분당선,청명,1958,1864,3822
1216,20200126,수인분당선,영통,3916,4334,8250
1217,20200126,수인분당선,망포,5714,5714,11428
1218,20200126,수인분당선,매탄권선,2189,2136,4325
1219,20200126,수인분당선,수원시청,5765,7745,13510
1220,20200126,수인분당선,매교,1112,1098,2210
1221,20200126,수인분당선,달월,38,37,75
1222,20200126,수인분당선,월곶,1614,1555,3169
1223,20200126,수인분당선,소래포구,3785,3823,7608
1224,20200126,수인분당선,인천논현,2960,3147,6107
1225,20200126,수인분당선,호구포,1740,1857,3597
1226,20200126,수인분당선,남동인더스파크,531,608,1139
1227,20200126,수인분당선,원인재,2629,2834,5463
1228,20200126,수인분당선,연수,3141,3180,6321
1229,20200126,수인분당선,송도,1689,1562,3251
1230,20200126,수인분당선,인하대,2381,2310,4691
1231,20200126,수인분당선,숭의,1830,1722,3552
1232,20200126,수인분당선,신포,1024,1078,2102
1233,20200126,수인분당선,인천,1105,1700,2805
1234,20200127,수인분당선,선릉,2539,4321,6860
1235,20200127,수인분당선,한티,7352,7787,15139
1236,20200127,수인분당선,도곡,2775,2749,5524
1237,20200127,수인분당선,구룡,485,555,1040
1238,20200127,수인분당선,개포동,1782,1768,3550
1239,20200127,수인분당선,대모산입구,1372,1298,2670
1240,20200127,수인분당선,수서,10733,7212,17945
1241,20200127,수인분당선,수원,6296,3980,10276
1242,20200127,수인분당선,서울숲,3151,3479,6630
1243,20200127,수인분당선,압구정로데오,7497,8281,15778
1244,20200127,수인분당선,강남구청,2418,3040,5458
1245,20200127,수인분당선,선정릉,1771,1939,3710
1246,20200127,수인분당선,가천대,3112,4083,7195
1247,20200127,수인분당선,태평,8495,8357,16852
1248,20200127,수인분당선,모란,12091,12809,24900
1249,20200127,수인분당선,야탑,17548,16674,34222
1250,20200127,수인분당선,서현,17358,17345,34703
1251,20200127,수인분당선,수내,6462,6549,13011
1252,20200127,수인분당선,정자,7573,8382,15955
1253,20200127,수인분당선,미금,8600,9572,18172
1254,20200127,수인분당선,오리,6067,5528,11595
1255,20200127,수인분당선,이매,2987,3095,6082
1256,20200127,수인분당선,보정,1167,1135,2302
1257,20200127,수인분당선,죽전,8624,10119,18743
1258,20200127,수인분당선,구성,2604,2650,5254
1259,20200127,수인분당선,신갈,2223,2268,4491
1260,20200127,수인분당선,기흥,5663,5673,11336
1261,20200127,수인분당선,상갈,3255,3216,6471
1262,20200127,수인분당선,청명,2029,2041,4070
1263,20200127,수인분당선,영통,5077,5456,10533
1264,20200127,수인분당선,망포,6450,6993,13443
1265,20200127,수인분당선,매탄권선,2335,2341,4676
1266,20200127,수인분당선,수원시청,7092,7528,14620
1267,20200127,수인분당선,매교,1113,1172,2285
1268,20200127,수인분당선,달월,36,29,65
1269,20200127,수인분당선,월곶,1679,1559,3238
1270,20200127,수인분당선,소래포구,3225,3107,6332
1271,20200127,수인분당선,인천논현,3257,3428,6685
1272,20200127,수인분당선,호구포,1614,1727,3341
1273,20200127,수인분당선,남동인더스파크,605,657,1262
1274,20200127,수인분당선,원인재,2607,2642,5249
1275,20200127,수인분당선,연수,2998,3003,6001
1276,20200127,수인분당선,송도,1738,1601,3339
1277,20200127,수인분당선,인하대,2550,2487,5037
1278,20200127,수인분당선,숭의,1777,1741,3518
1279,20200127,수인분당선,신포,952,916,1868
1280,20200127,수인분당선,인천,823,1280,2103
1281,20200128,수인분당선,선릉,13262,21307,34569
1282,20200128,수인분당선,한티,15031,15976,31007
1283,20200128,수인분당선,도곡,6796,6934,13730
1284,20200128,수인분당선,구룡,1417,1432,2849
1285,20200128,수인분당선,개포동,3834,3981,7815
1286,20200128,수인분당선,대모산입구,3469,3274,6743
1287,20200128,수인분당선,수서,14899,13629,28528
1288,20200128,수인분당선,수원,8318,5858,14176
1289,20200128,수인분당선,서울숲,8563,8760,17323
1290,20200128,수인분당선,압구정로데오,17113,19154,36267
1291,20200128,수인분당선,강남구청,10046,11533,21579
1292,20200128,수인분당선,선정릉,8698,9138,17836
1293,20200128,수인분당선,가천대,6306,7674,13980
1294,20200128,수인분당선,태평,14440,14300,28740
1295,20200128,수인분당선,모란,21105,21505,42610
1296,20200128,수인분당선,야탑,29570,30401,59971
1297,20200128,수인분당선,서현,28740,28963,57703
1298,20200128,수인분당선,수내,14080,14197,28277
1299,20200128,수인분당선,정자,18062,19218,37280
1300,20200128,수인분당선,미금,17725,18947,36672
1301,20200128,수인분당선,오리,12687,11049,23736
1302,20200128,수인분당선,이매,5852,5602,11454
1303,20200128,수인분당선,보정,2650,2254,4904
1304,20200128,수인분당선,죽전,14293,15895,30188
1305,20200128,수인분당선,구성,4987,5107,10094
1306,20200128,수인분당선,신갈,5064,4923,9987
1307,20200128,수인분당선,기흥,9998,9516,19514
1308,20200128,수인분당선,상갈,5714,5214,10928
1309,20200128,수인분당선,청명,4213,3952,8165
1310,20200128,수인분당선,영통,8700,9096,17796
1311,20200128,수인분당선,망포,13673,13061,26734
1312,20200128,수인분당선,매탄권선,4531,4297,8828
1313,20200128,수인분당선,수원시청,11617,12991,24608
1314,20200128,수인분당선,매교,2232,2239,4471
1315,20200128,수인분당선,달월,75,54,129
1316,20200128,수인분당선,월곶,2239,2101,4340
1317,20200128,수인분당선,소래포구,4201,3826,8027
1318,20200128,수인분당선,인천논현,6212,6593,12805
1319,20200128,수인분당선,호구포,3504,3633,7137
1320,20200128,수인분당선,남동인더스파크,2153,2354,4507
1321,20200128,수인분당선,원인재,4375,4398,8773
1322,20200128,수인분당선,연수,4688,4744,9432
1323,20200128,수인분당선,송도,2602,2489,5091
1324,20200128,수인분당선,인하대,5015,4816,9831
1325,20200128,수인분당선,숭의,3785,3522,7307
1326,20200128,수인분당선,신포,1626,1652,3278
1327,20200128,수인분당선,인천,821,1445,2266
1328,20200129,수인분당선,선릉,14616,23611,38227
1329,20200129,수인분당선,한티,15680,16545,32225
1330,20200129,수인분당선,도곡,7227,7453,14680
1331,20200129,수인분당선,구룡,1464,1448,2912
1332,20200129,수인분당선,개포동,4117,4276,8393
1333,20200129,수인분당선,대모산입구,3790,3622,7412
1334,20200129,수인분당선,수서,15445,15216,30661
1335,20200129,수인분당선,수원,8623,5958,14581
1336,20200129,수인분당선,서울숲,9432,9547,18979
1337,20200129,수인분당선,압구정로데오,17795,19989,37784
1338,20200129,수인분당선,강남구청,10825,12538,23363
1339,20200129,수인분당선,선정릉,9371,9938,19309
1340,20200129,수인분당선,가천대,6695,7879,14574
1341,20200129,수인분당선,태평,15173,14908,30081
1342,20200129,수인분당선,모란,26484,27565,54049
1343,20200129,수인분당선,야탑,30985,32355,63340
1344,20200129,수인분당선,서현,30047,30451,60498
1345,20200129,수인분당선,수내,15092,15056,30148
1346,20200129,수인분당선,정자,19260,20601,39861
1347,20200129,수인분당선,미금,18627,19624,38251
1348,20200129,수인분당선,오리,13749,11452,25201
1349,20200129,수인분당선,이매,6303,6121,12424
1350,20200129,수인분당선,보정,2719,2372,5091
1351,20200129,수인분당선,죽전,15227,16661,31888
1352,20200129,수인분당선,구성,5285,5387,10672
1353,20200129,수인분당선,신갈,5336,5195,10531
1354,20200129,수인분당선,기흥,10416,9949,20365
1355,20200129,수인분당선,상갈,6059,5673,11732
1356,20200129,수인분당선,청명,4532,4201,8733
1357,20200129,수인분당선,영통,8894,9222,18116
1358,20200129,수인분당선,망포,14749,13779,28528
1359,20200129,수인분당선,매탄권선,4643,4487,9130
1360,20200129,수인분당선,수원시청,12333,13580,25913
1361,20200129,수인분당선,매교,2350,2364,4714
1362,20200129,수인분당선,달월,74,60,134
1363,20200129,수인분당선,월곶,2518,2347,4865
1364,20200129,수인분당선,소래포구,4432,4030,8462
1365,20200129,수인분당선,인천논현,6217,6567,12784
1366,20200129,수인분당선,호구포,3797,3840,7637
1367,20200129,수인분당선,남동인더스파크,2360,2611,4971
1368,20200129,수인분당선,원인재,4566,4652,9218
1369,20200129,수인분당선,연수,5171,5169,10340
1370,20200129,수인분당선,송도,2767,2588,5355
1371,20200129,수인분당선,인하대,5489,5114,10603
1372,20200129,수인분당선,숭의,4040,3724,7764
1373,20200129,수인분당선,신포,1733,1784,3517
1374,20200129,수인분당선,인천,933,1552,2485
1375,20200130,수인분당선,인천,825,1348,2173
1376,20200130,수인분당선,신포,1691,1778,3469
1377,20200130,수인분당선,숭의,3902,3593,7495
1378,20200130,수인분당선,인하대,5294,5142,10436
1379,20200130,수인분당선,송도,2701,2501,5202
1380,20200130,수인분당선,연수,4832,4877,9709
1381,20200130,수인분당선,원인재,4546,4623,9169
1382,20200130,수인분당선,남동인더스파크,2429,2636,5065
1383,20200130,수인분당선,호구포,3941,3909,7850
1384,20200130,수인분당선,인천논현,6214,6544,12758
1385,20200130,수인분당선,소래포구,4478,4079,8557
1386,20200130,수인분당선,월곶,2541,2421,4962
1387,20200130,수인분당선,달월,85,55,140
1388,20200130,수인분당선,매교,2422,2384,4806
1389,20200130,수인분당선,수원시청,12230,13545,25775
1390,20200130,수인분당선,매탄권선,4662,4414,9076
1391,20200130,수인분당선,망포,14870,13953,28823
1392,20200130,수인분당선,영통,9115,9165,18280
1393,20200130,수인분당선,청명,4509,4227,8736
1394,20200130,수인분당선,상갈,5945,5478,11423
1395,20200130,수인분당선,기흥,10408,9880,20288
1396,20200130,수인분당선,신갈,5198,5028,10226
1397,20200130,수인분당선,구성,5435,5356,10791
1398,20200130,수인분당선,죽전,14993,16473,31466
1399,20200130,수인분당선,보정,2660,2293,4953
1400,20200130,수인분당선,이매,6466,6203,12669
1401,20200130,수인분당선,오리,13729,11613,25342
1402,20200130,수인분당선,미금,18204,19308,37512
1403,20200130,수인분당선,정자,19188,20623,39811
1404,20200130,수인분당선,수내,15229,15215,30444
1405,20200130,수인분당선,서현,29852,30381,60233
1406,20200130,수인분당선,야탑,30642,32005,62647
1407,20200130,수인분당선,모란,22449,22551,45000
1408,20200130,수인분당선,태평,14812,14629,29441
1409,20200130,수인분당선,가천대,6831,7915,14746
1410,20200130,수인분당선,선정릉,9250,10040,19290
1411,20200130,수인분당선,강남구청,10831,12440,23271
1412,20200130,수인분당선,압구정로데오,18182,20609,38791
1413,20200130,수인분당선,서울숲,9298,9493,18791
1414,20200130,수인분당선,수원,8501,5913,14414
1415,20200130,수인분당선,수서,15137,15453,30590
1416,20200130,수인분당선,대모산입구,3738,3470,7208
1417,20200130,수인분당선,개포동,4082,4217,8299
1418,20200130,수인분당선,구룡,1547,1491,3038
1419,20200130,수인분당선,도곡,7346,7499,14845
1420,20200130,수인분당선,한티,15485,16427,31912
1421,20200130,수인분당선,선릉,14703,23597,38300
1422,20200131,수인분당선,선릉,14315,23336,37651
1423,20200131,수인분당선,한티,16092,17146,33238
1424,20200131,수인분당선,도곡,7500,7402,14902
1425,20200131,수인분당선,구룡,1460,1477,2937
1426,20200131,수인분당선,개포동,4149,4298,8447
1427,20200131,수인분당선,대모산입구,3741,3473,7214
1428,20200131,수인분당선,수서,16794,16836,33630
1429,20200131,수인분당선,수원,9231,6351,15582
1430,20200131,수인분당선,서울숲,9370,9445,18815
1431,20200131,수인분당선,압구정로데오,18580,21845,40425
1432,20200131,수인분당선,강남구청,11115,12681,23796
1433,20200131,수인분당선,선정릉,9207,9817,19024
1434,20200131,수인분당선,가천대,6955,7694,14649
1435,20200131,수인분당선,태평,15153,14696,29849
1436,20200131,수인분당선,모란,23009,23462,46471
1437,20200131,수인분당선,야탑,31204,33017,64221
1438,20200131,수인분당선,서현,31865,32450,64315
1439,20200131,수인분당선,수내,15468,15552,31020
1440,20200131,수인분당선,정자,19921,21288,41209
1441,20200131,수인분당선,미금,18440,19717,38157
1442,20200131,수인분당선,오리,13782,11570,25352
1443,20200131,수인분당선,이매,6562,6197,12759
1444,20200131,수인분당선,보정,2736,2263,4999
1445,20200131,수인분당선,죽전,15900,16915,32815
1446,20200131,수인분당선,구성,5370,5330,10700
1447,20200131,수인분당선,신갈,5487,5290,10777
1448,20200131,수인분당선,기흥,10720,10041,20761
1449,20200131,수인분당선,상갈,6245,5636,11881
1450,20200131,수인분당선,청명,4709,4229,8938
1451,20200131,수인분당선,영통,9772,9876,19648
1452,20200131,수인분당선,망포,15701,14134,29835
1453,20200131,수인분당선,매탄권선,5015,4556,9571
1454,20200131,수인분당선,수원시청,12465,15409,27874
1455,20200131,수인분당선,매교,2564,2595,5159
1456,20200131,수인분당선,달월,71,55,126
1457,20200131,수인분당선,월곶,2484,2294,4778
1458,20200131,수인분당선,소래포구,4493,4149,8642
1459,20200131,수인분당선,인천논현,6275,6579,12854
1460,20200131,수인분당선,호구포,3889,3830,7719
1461,20200131,수인분당선,남동인더스파크,2392,2644,5036
1462,20200131,수인분당선,원인재,4625,4681,9306
1463,20200131,수인분당선,연수,5204,5495,10699
1464,20200131,수인분당선,송도,2770,2481,5251
1465,20200131,수인분당선,인하대,5348,4951,10299
1466,20200131,수인분당선,숭의,3929,3599,7528
1467,20200131,수인분당선,신포,1775,1870,3645
1468,20200131,수인분당선,인천,928,1459,2387
1469,20200201,수인분당선,선릉,5028,8499,13527
1470,20200201,수인분당선,한티,12036,11462,23498
1471,20200201,수인분당선,도곡,4091,3740,7831
1472,20200201,수인분당선,구룡,906,891,1797
1473,20200201,수인분당선,개포동,2474,2531,5005
1474,20200201,수인분당선,대모산입구,2158,1970,4128
1475,20200201,수인분당선,수서,10186,10418,20604
1476,20200201,수인분당선,수원,6372,4245,10617
1477,20200201,수인분당선,서울숲,5684,5867,11551
1478,20200201,수인분당선,압구정로데오,14038,16174,30212
1479,20200201,수인분당선,강남구청,5326,6472,11798
1480,20200201,수인분당선,선정릉,3501,3677,7178
1481,20200201,수인분당선,가천대,4688,5250,9938
1482,20200201,수인분당선,태평,10764,10418,21182
1483,20200201,수인분당선,모란,16894,17032,33926
1484,20200201,수인분당선,야탑,19504,20778,40282
1485,20200201,수인분당선,서현,21237,21818,43055
1486,20200201,수인분당선,수내,9321,8575,17896
1487,20200201,수인분당선,정자,11023,11195,22218
1488,20200201,수인분당선,미금,11508,11961,23469
1489,20200201,수인분당선,오리,8136,6737,14873
1490,20200201,수인분당선,이매,4342,4337,8679
1491,20200201,수인분당선,보정,1678,1468,3146
1492,20200201,수인분당선,죽전,10183,11497,21680
1493,20200201,수인분당선,구성,3055,3063,6118
1494,20200201,수인분당선,신갈,2745,2682,5427
1495,20200201,수인분당선,기흥,6619,6437,13056
1496,20200201,수인분당선,상갈,3734,3652,7386
1497,20200201,수인분당선,청명,2593,2515,5108
1498,20200201,수인분당선,영통,6969,6857,13826
1499,20200201,수인분당선,망포,8591,7666,16257
1500,20200201,수인분당선,매탄권선,3063,2804,5867
1501,20200201,수인분당선,수원시청,10120,12218,22338
1502,20200201,수인분당선,매교,1603,1680,3283
1503,20200201,수인분당선,달월,31,28,59
1504,20200201,수인분당선,월곶,1813,1738,3551
1505,20200201,수인분당선,소래포구,3748,3611,7359
1506,20200201,수인분당선,인천논현,4548,4618,9166
1507,20200201,수인분당선,호구포,2244,2143,4387
1508,20200201,수인분당선,남동인더스파크,980,925,1905
1509,20200201,수인분당선,원인재,3454,3547,7001
1510,20200201,수인분당선,연수,4044,4239,8283
1511,20200201,수인분당선,송도,2123,2050,4173
1512,20200201,수인분당선,인하대,3475,3397,6872
1513,20200201,수인분당선,숭의,2491,2277,4768
1514,20200201,수인분당선,신포,1302,1331,2633
1515,20200201,수인분당선,인천,784,1242,2026
1516,20200202,수인분당선,선릉,2535,4219,6754
1517,20200202,수인분당선,한티,8586,8078,16664
1518,20200202,수인분당선,도곡,2502,2537,5039
1519,20200202,수인분당선,구룡,560,673,1233
1520,20200202,수인분당선,개포동,2260,2290,4550
1521,20200202,수인분당선,대모산입구,1437,1425,2862
1522,20200202,수인분당선,수서,8213,7702,15915
1523,20200202,수인분당선,수원,4543,3031,7574
1524,20200202,수인분당선,서울숲,3586,3777,7363
1525,20200202,수인분당선,압구정로데오,7767,8458,16225
1526,20200202,수인분당선,강남구청,3179,3767,6946
1527,20200202,수인분당선,선정릉,2295,2431,4726
1528,20200202,수인분당선,가천대,3246,4034,7280
1529,20200202,수인분당선,태평,7967,7489,15456
1530,20200202,수인분당선,모란,11580,11876,23456
1531,20200202,수인분당선,야탑,14784,15079,29863
1532,20200202,수인분당선,서현,16277,16019,32296
1533,20200202,수인분당선,수내,6299,6102,12401
1534,20200202,수인분당선,정자,7137,7530,14667
1535,20200202,수인분당선,미금,8375,8849,17224
1536,20200202,수인분당선,오리,5966,5163,11129
1537,20200202,수인분당선,이매,3862,3947,7809
1538,20200202,수인분당선,보정,1089,1036,2125
1539,20200202,수인분당선,죽전,7924,9080,17004
1540,20200202,수인분당선,구성,2180,2397,4577
1541,20200202,수인분당선,신갈,1930,1968,3898
1542,20200202,수인분당선,기흥,4744,4809,9553
1543,20200202,수인분당선,상갈,2859,2873,5732
1544,20200202,수인분당선,청명,1809,1803,3612
1545,20200202,수인분당선,영통,4787,4713,9500
1546,20200202,수인분당선,망포,5409,5750,11159
1547,20200202,수인분당선,매탄권선,2047,2096,4143
1548,20200202,수인분당선,수원시청,6869,6896,13765
1549,20200202,수인분당선,매교,1205,1312,2517
1550,20200202,수인분당선,달월,21,29,50
1551,20200202,수인분당선,월곶,1371,1294,2665
1552,20200202,수인분당선,소래포구,2747,2609,5356
1553,20200202,수인분당선,인천논현,2969,3080,6049
1554,20200202,수인분당선,호구포,1835,1919,3754
1555,20200202,수인분당선,남동인더스파크,529,519,1048
1556,20200202,수인분당선,원인재,2522,2587,5109
1557,20200202,수인분당선,연수,3368,3319,6687
1558,20200202,수인분당선,송도,1532,1536,3068
1559,20200202,수인분당선,인하대,2510,2433,4943
1560,20200202,수인분당선,숭의,1857,1706,3563
1561,20200202,수인분당선,신포,1007,1018,2025
1562,20200202,수인분당선,인천,719,985,1704
1563,20200203,수인분당선,선릉,14173,22705,36878
1564,20200203,수인분당선,한티,14376,15519,29895
1565,20200203,수인분당선,도곡,6795,7020,13815
1566,20200203,수인분당선,구룡,1741,1726,3467
1567,20200203,수인분당선,개포동,3785,3950,7735
1568,20200203,수인분당선,대모산입구,3660,3307,6967
1569,20200203,수인분당선,수서,14216,14832,29048
1570,20200203,수인분당선,수원,7312,4987,12299
1571,20200203,수인분당선,서울숲,8455,8463,16918
1572,20200203,수인분당선,압구정로데오,15887,17724,33611
1573,20200203,수인분당선,강남구청,10274,11811,22085
1574,20200203,수인분당선,선정릉,9095,9616,18711
1575,20200203,수인분당선,가천대,6489,7533,14022
1576,20200203,수인분당선,태평,13975,13857,27832
1577,20200203,수인분당선,모란,20805,20947,41752
1578,20200203,수인분당선,야탑,27806,29281,57087
1579,20200203,수인분당선,서현,28580,28833,57413
1580,20200203,수인분당선,수내,13926,13880,27806
1581,20200203,수인분당선,정자,17728,19024,36752
1582,20200203,수인분당선,미금,17517,18635,36152
1583,20200203,수인분당선,오리,12595,10680,23275
1584,20200203,수인분당선,이매,5845,5476,11321
1585,20200203,수인분당선,보정,2613,2347,4960
1586,20200203,수인분당선,죽전,13846,15075,28921
1587,20200203,수인분당선,구성,5034,5061,10095
1588,20200203,수인분당선,신갈,4894,4693,9587
1589,20200203,수인분당선,기흥,9867,9309,19176
1590,20200203,수인분당선,상갈,5468,5149,10617
1591,20200203,수인분당선,청명,4009,3727,7736
1592,20200203,수인분당선,영통,8407,8522,16929
1593,20200203,수인분당선,망포,13314,12782,26096
1594,20200203,수인분당선,매탄권선,4179,4015,8194
1595,20200203,수인분당선,수원시청,10767,11603,22370
1596,20200203,수인분당선,매교,2291,2281,4572
1597,20200203,수인분당선,달월,77,53,130
1598,20200203,수인분당선,월곶,2130,2087,4217
1599,20200203,수인분당선,소래포구,3915,3438,7353
1600,20200203,수인분당선,인천논현,5817,6017,11834
1601,20200203,수인분당선,호구포,3569,3690,7259
1602,20200203,수인분당선,남동인더스파크,2265,2484,4749
1603,20200203,수인분당선,원인재,4339,4357,8696
1604,20200203,수인분당선,연수,4440,4456,8896
1605,20200203,수인분당선,송도,2543,2350,4893
1606,20200203,수인분당선,인하대,4969,4774,9743
1607,20200203,수인분당선,숭의,3712,3483,7195
1608,20200203,수인분당선,신포,1534,1556,3090
1609,20200203,수인분당선,인천,755,1344,2099
1610,20200204,수인분당선,선릉,14304,22741,37045
1611,20200204,수인분당선,한티,14693,15864,30557
1612,20200204,수인분당선,도곡,7103,7295,14398
1613,20200204,수인분당선,구룡,1718,1703,3421
1614,20200204,수인분당선,개포동,3881,4109,7990
1615,20200204,수인분당선,대모산입구,3620,3476,7096
1616,20200204,수인분당선,수서,14573,14764,29337
1617,20200204,수인분당선,복정,1,0,1
1618,20200204,수인분당선,수원,7471,5268,12739
1619,20200204,수인분당선,서울숲,8958,9046,18004
1620,20200204,수인분당선,압구정로데오,17362,19116,36478
1621,20200204,수인분당선,강남구청,10733,12291,23024
1622,20200204,수인분당선,선정릉,9123,9519,18642
1623,20200204,수인분당선,가천대,6612,7710,14322
1624,20200204,수인분당선,태평,14452,14205,28657
1625,20200204,수인분당선,모란,24878,25417,50295
1626,20200204,수인분당선,야탑,28243,29559,57802
1627,20200204,수인분당선,서현,28424,28715,57139
1628,20200204,수인분당선,수내,14657,14547,29204
1629,20200204,수인분당선,정자,18314,19590,37904
1630,20200204,수인분당선,미금,17599,18847,36446
1631,20200204,수인분당선,오리,12787,10889,23676
1632,20200204,수인분당선,이매,5790,5590,11380
1633,20200204,수인분당선,보정,2628,2228,4856
1634,20200204,수인분당선,죽전,13856,15322,29178
1635,20200204,수인분당선,구성,5112,5165,10277
1636,20200204,수인분당선,신갈,4935,4871,9806
1637,20200204,수인분당선,기흥,9939,9526,19465
1638,20200204,수인분당선,상갈,5642,5306,10948
1639,20200204,수인분당선,청명,4176,3913,8089
1640,20200204,수인분당선,영통,8264,8410,16674
1641,20200204,수인분당선,망포,13434,12797,26231
1642,20200204,수인분당선,매탄권선,4262,4138,8400
1643,20200204,수인분당선,수원시청,10972,11909,22881
1644,20200204,수인분당선,매교,2136,2167,4303
1645,20200204,수인분당선,달월,86,48,134
1646,20200204,수인분당선,월곶,2174,2047,4221
1647,20200204,수인분당선,소래포구,3854,3613,7467
1648,20200204,수인분당선,인천논현,5700,5922,11622
1649,20200204,수인분당선,호구포,3590,3663,7253
1650,20200204,수인분당선,남동인더스파크,2400,2539,4939
1651,20200204,수인분당선,원인재,4070,4292,8362
1652,20200204,수인분당선,연수,4416,4499,8915
1653,20200204,수인분당선,송도,2537,2295,4832
1654,20200204,수인분당선,인하대,5127,4832,9959
1655,20200204,수인분당선,숭의,3587,3383,6970
1656,20200204,수인분당선,신포,1535,1577,3112
1657,20200204,수인분당선,인천,774,1332,2106
1658,20200205,수인분당선,선릉,13964,22417,36381
1659,20200205,수인분당선,한티,14362,15681,30043
1660,20200205,수인분당선,도곡,6720,6998,13718
1661,20200205,수인분당선,구룡,1683,1668,3351
1662,20200205,수인분당선,개포동,3924,4197,8121
1663,20200205,수인분당선,대모산입구,3534,3294,6828
1664,20200205,수인분당선,수서,14079,14329,28408
1665,20200205,수인분당선,복정,1,0,1
1666,20200205,수인분당선,수원,7384,5175,12559
1667,20200205,수인분당선,서울숲,8784,8910,17694
1668,20200205,수인분당선,압구정로데오,16641,18657,35298
1669,20200205,수인분당선,강남구청,10563,12152,22715
1670,20200205,수인분당선,선정릉,9049,9606,18655
1671,20200205,수인분당선,가천대,6462,7510,13972
1672,20200205,수인분당선,태평,13801,13504,27305
1673,20200205,수인분당선,모란,20457,20125,40582
1674,20200205,수인분당선,야탑,28367,29885,58252
1675,20200205,수인분당선,서현,27671,27994,55665
1676,20200205,수인분당선,수내,14054,14087,28141
1677,20200205,수인분당선,정자,18117,19189,37306
1678,20200205,수인분당선,미금,17122,18216,35338
1679,20200205,수인분당선,오리,12355,10392,22747
1680,20200205,수인분당선,이매,5496,5357,10853
1681,20200205,수인분당선,보정,2448,2062,4510
1682,20200205,수인분당선,죽전,13410,15008,28418
1683,20200205,수인분당선,구성,4877,5003,9880
1684,20200205,수인분당선,신갈,4728,4596,9324
1685,20200205,수인분당선,기흥,9874,9208,19082
1686,20200205,수인분당선,상갈,5625,5100,10725
1687,20200205,수인분당선,청명,4095,3818,7913
1688,20200205,수인분당선,영통,8039,8146,16185
1689,20200205,수인분당선,망포,13560,12853,26413
1690,20200205,수인분당선,매탄권선,4206,3968,8174
1691,20200205,수인분당선,수원시청,10696,11872,22568
1692,20200205,수인분당선,매교,2053,2032,4085
1693,20200205,수인분당선,달월,70,48,118
1694,20200205,수인분당선,월곶,2242,2078,4320
1695,20200205,수인분당선,소래포구,3635,3285,6920
1696,20200205,수인분당선,인천논현,5626,5803,11429
1697,20200205,수인분당선,호구포,3464,3530,6994
1698,20200205,수인분당선,남동인더스파크,2378,2556,4934
1699,20200205,수인분당선,원인재,4047,4168,8215
1700,20200205,수인분당선,연수,4437,4533,8970
1701,20200205,수인분당선,송도,2288,2141,4429
1702,20200205,수인분당선,인하대,4771,4658,9429
1703,20200205,수인분당선,숭의,3554,3220,6774
1704,20200205,수인분당선,신포,1499,1503,3002
1705,20200205,수인분당선,인천,772,1307,2079
1706,20200206,수인분당선,선릉,13735,22333,36068
1707,20200206,수인분당선,한티,14220,15309,29529
1708,20200206,수인분당선,도곡,6797,6997,13794
1709,20200206,수인분당선,구룡,1636,1605,3241
1710,20200206,수인분당선,개포동,3723,4003,7726
1711,20200206,수인분당선,대모산입구,3407,3151,6558
1712,20200206,수인분당선,수서,14320,14252,28572
1713,20200206,수인분당선,복정,2,0,2
1714,20200206,수인분당선,수원,7330,5163,12493
1715,20200206,수인분당선,서울숲,8713,8806,17519
1716,20200206,수인분당선,압구정로데오,16981,19024,36005
1717,20200206,수인분당선,강남구청,10141,11832,21973
1718,20200206,수인분당선,선정릉,8692,9326,18018
1719,20200206,수인분당선,가천대,6389,7432,13821
1720,20200206,수인분당선,태평,13599,13317,26916
1721,20200206,수인분당선,모란,20270,20358,40628
1722,20200206,수인분당선,야탑,27597,28970,56567
1723,20200206,수인분당선,서현,27456,27956,55412
1724,20200206,수인분당선,수내,13854,13924,27778
1725,20200206,수인분당선,정자,17596,19048,36644
1726,20200206,수인분당선,미금,16710,17648,34358
1727,20200206,수인분당선,오리,12416,10715,23131
1728,20200206,수인분당선,이매,5507,5234,10741
1729,20200206,수인분당선,보정,2438,2002,4440
1730,20200206,수인분당선,죽전,13139,14493,27632
1731,20200206,수인분당선,구성,4768,4803,9571
1732,20200206,수인분당선,신갈,4726,4570,9296
1733,20200206,수인분당선,기흥,9627,9170,18797
1734,20200206,수인분당선,상갈,5329,5004,10333
1735,20200206,수인분당선,청명,3905,3643,7548
1736,20200206,수인분당선,영통,8148,8256,16404
1737,20200206,수인분당선,망포,13091,12340,25431
1738,20200206,수인분당선,매탄권선,4123,4003,8126
1739,20200206,수인분당선,수원시청,10616,11759,22375
1740,20200206,수인분당선,매교,1993,1996,3989
1741,20200206,수인분당선,달월,72,52,124
1742,20200206,수인분당선,월곶,2164,2024,4188
1743,20200206,수인분당선,소래포구,3739,3490,7229
1744,20200206,수인분당선,인천논현,5510,5794,11304
1745,20200206,수인분당선,호구포,3450,3484,6934
1746,20200206,수인분당선,남동인더스파크,2279,2447,4726
1747,20200206,수인분당선,원인재,4078,4161,8239
1748,20200206,수인분당선,연수,4278,4392,8670
1749,20200206,수인분당선,송도,2288,2140,4428
1750,20200206,수인분당선,인하대,4761,4533,9294
1751,20200206,수인분당선,숭의,3410,3242,6652
1752,20200206,수인분당선,신포,1435,1425,2860
1753,20200206,수인분당선,인천,731,1259,1990
1754,20200207,수인분당선,선릉,13750,22186,35936
1755,20200207,수인분당선,한티,15032,16075,31107
1756,20200207,수인분당선,도곡,7099,7300,14399
1757,20200207,수인분당선,구룡,1860,1712,3572
1758,20200207,수인분당선,개포동,3774,4115,7889
1759,20200207,수인분당선,대모산입구,3566,3217,6783
1760,20200207,수인분당선,수서,15837,16316,32153
1761,20200207,수인분당선,수원,8204,5580,13784
1762,20200207,수인분당선,서울숲,9049,9174,18223
1763,20200207,수인분당선,압구정로데오,18133,20991,39124
1764,20200207,수인분당선,강남구청,10635,11967,22602
1765,20200207,수인분당선,선정릉,8777,9456,18233
1766,20200207,수인분당선,가천대,6522,7309,13831
1767,20200207,수인분당선,태평,14369,14045,28414
1768,20200207,수인분당선,모란,21991,22444,44435
1769,20200207,수인분당선,야탑,29296,31170,60466
1770,20200207,수인분당선,서현,30267,30786,61053
1771,20200207,수인분당선,수내,14125,13938,28063
1772,20200207,수인분당선,정자,18680,20001,38681
1773,20200207,수인분당선,미금,17563,18824,36387
1774,20200207,수인분당선,오리,12936,10758,23694
1775,20200207,수인분당선,이매,5738,5547,11285
1776,20200207,수인분당선,보정,2688,2210,4898
1777,20200207,수인분당선,죽전,14884,15797,30681
1778,20200207,수인분당선,구성,4950,5048,9998
1779,20200207,수인분당선,신갈,4995,4732,9727
1780,20200207,수인분당선,기흥,10311,9711,20022
1781,20200207,수인분당선,상갈,5752,5227,10979
1782,20200207,수인분당선,청명,4338,3969,8307
1783,20200207,수인분당선,영통,9013,9237,18250
1784,20200207,수인분당선,망포,14518,13171,27689
1785,20200207,수인분당선,매탄권선,4542,4274,8816
1786,20200207,수인분당선,수원시청,11595,14053,25648
1787,20200207,수인분당선,매교,2149,2095,4244
1788,20200207,수인분당선,달월,68,44,112
1789,20200207,수인분당선,월곶,2175,2069,4244
1790,20200207,수인분당선,소래포구,3814,3560,7374
1791,20200207,수인분당선,인천논현,5821,6095,11916
1792,20200207,수인분당선,호구포,3627,3657,7284
1793,20200207,수인분당선,남동인더스파크,2135,2342,4477
1794,20200207,수인분당선,원인재,4235,4385,8620
1795,20200207,수인분당선,연수,4658,4751,9409
1796,20200207,수인분당선,송도,2383,2256,4639
1797,20200207,수인분당선,인하대,4998,4646,9644
1798,20200207,수인분당선,숭의,3663,3323,6986
1799,20200207,수인분당선,신포,1563,1621,3184
1800,20200207,수인분당선,인천,800,1325,2125
1801,20200208,수인분당선,선릉,5030,8725,13755
1802,20200208,수인분당선,한티,11937,11394,23331
1803,20200208,수인분당선,도곡,4143,3717,7860
1804,20200208,수인분당선,구룡,1144,1013,2157
1805,20200208,수인분당선,개포동,2394,2455,4849
1806,20200208,수인분당선,대모산입구,2349,2193,4542
1807,20200208,수인분당선,수서,9478,9762,19240
1808,20200208,수인분당선,수원,6013,4050,10063
1809,20200208,수인분당선,서울숲,5774,5989,11763
1810,20200208,수인분당선,압구정로데오,14334,16444,30778
1811,20200208,수인분당선,강남구청,5087,6385,11472
1812,20200208,수인분당선,선정릉,3664,3798,7462
1813,20200208,수인분당선,가천대,5059,5565,10624
1814,20200208,수인분당선,태평,10359,9949,20308
1815,20200208,수인분당선,모란,15713,16067,31780
1816,20200208,수인분당선,야탑,18429,19816,38245
1817,20200208,수인분당선,서현,19975,20307,40282
1818,20200208,수인분당선,수내,7735,7247,14982
1819,20200208,수인분당선,정자,10188,10447,20635
1820,20200208,수인분당선,미금,11263,11643,22906
1821,20200208,수인분당선,오리,7948,6501,14449
1822,20200208,수인분당선,이매,3843,3626,7469
1823,20200208,수인분당선,보정,1549,1431,2980
1824,20200208,수인분당선,죽전,9711,11096,20807
1825,20200208,수인분당선,구성,2930,2847,5777
1826,20200208,수인분당선,신갈,2765,2811,5576
1827,20200208,수인분당선,기흥,6513,6107,12620
1828,20200208,수인분당선,상갈,3583,3515,7098
1829,20200208,수인분당선,청명,2554,2501,5055
1830,20200208,수인분당선,영통,6613,6536,13149
1831,20200208,수인분당선,망포,8234,7329,15563
1832,20200208,수인분당선,매탄권선,2950,2701,5651
1833,20200208,수인분당선,수원시청,9261,11505,20766
1834,20200208,수인분당선,매교,1506,1591,3097
1835,20200208,수인분당선,달월,39,32,71
1836,20200208,수인분당선,월곶,1679,1591,3270
1837,20200208,수인분당선,소래포구,3199,3220,6419
1838,20200208,수인분당선,인천논현,4206,4205,8411
1839,20200208,수인분당선,호구포,2188,2092,4280
1840,20200208,수인분당선,남동인더스파크,964,870,1834
1841,20200208,수인분당선,원인재,3196,3162,6358
1842,20200208,수인분당선,연수,3804,3916,7720
1843,20200208,수인분당선,송도,1806,1706,3512
1844,20200208,수인분당선,인하대,3164,2914,6078
1845,20200208,수인분당선,숭의,2331,2186,4517
1846,20200208,수인분당선,신포,1119,1252,2371
1847,20200208,수인분당선,인천,696,1099,1795
1848,20200209,수인분당선,선릉,2537,4200,6737
1849,20200209,수인분당선,한티,8734,8287,17021
1850,20200209,수인분당선,도곡,2208,2126,4334
1851,20200209,수인분당선,구룡,596,654,1250
1852,20200209,수인분당선,개포동,2150,2020,4170
1853,20200209,수인분당선,대모산입구,1728,1660,3388
1854,20200209,수인분당선,수서,8043,7826,15869
1855,20200209,수인분당선,수원,4642,3030,7672
1856,20200209,수인분당선,서울숲,3726,3799,7525
1857,20200209,수인분당선,압구정로데오,8555,9526,18081
1858,20200209,수인분당선,강남구청,3277,3821,7098
1859,20200209,수인분당선,선정릉,2264,2423,4687
1860,20200209,수인분당선,가천대,3373,4187,7560
1861,20200209,수인분당선,태평,7797,7444,15241
1862,20200209,수인분당선,모란,15273,15925,31198
1863,20200209,수인분당선,야탑,14428,14632,29060
1864,20200209,수인분당선,서현,16085,15918,32003
1865,20200209,수인분당선,수내,5560,5486,11046
1866,20200209,수인분당선,정자,7207,7684,14891
1867,20200209,수인분당선,미금,8057,8664,16721
1868,20200209,수인분당선,오리,5955,5152,11107
1869,20200209,수인분당선,이매,3878,3820,7698
1870,20200209,수인분당선,보정,1000,947,1947
1871,20200209,수인분당선,죽전,7424,8723,16147
1872,20200209,수인분당선,구성,2238,2427,4665
1873,20200209,수인분당선,신갈,2035,1999,4034
1874,20200209,수인분당선,기흥,4735,4856,9591
1875,20200209,수인분당선,상갈,2808,2963,5771
1876,20200209,수인분당선,청명,2003,1952,3955
1877,20200209,수인분당선,영통,4541,4494,9035
1878,20200209,수인분당선,망포,5645,5866,11511
1879,20200209,수인분당선,매탄권선,2060,1979,4039
1880,20200209,수인분당선,수원시청,6673,6951,13624
1881,20200209,수인분당선,매교,1032,1110,2142
1882,20200209,수인분당선,달월,19,21,40
1883,20200209,수인분당선,월곶,1293,1304,2597
1884,20200209,수인분당선,소래포구,2540,2413,4953
1885,20200209,수인분당선,인천논현,2815,2992,5807
1886,20200209,수인분당선,호구포,1651,1657,3308
1887,20200209,수인분당선,남동인더스파크,575,555,1130
1888,20200209,수인분당선,원인재,2454,2510,4964
1889,20200209,수인분당선,연수,3211,3138,6349
1890,20200209,수인분당선,송도,1441,1404,2845
1891,20200209,수인분당선,인하대,2350,2343,4693
1892,20200209,수인분당선,숭의,1657,1578,3235
1893,20200209,수인분당선,신포,920,886,1806
1894,20200209,수인분당선,인천,682,911,1593
1895,20200210,수인분당선,선릉,14070,22642,36712
1896,20200210,수인분당선,한티,13565,14573,28138
1897,20200210,수인분당선,도곡,6984,7163,14147
1898,20200210,수인분당선,구룡,1665,1677,3342
1899,20200210,수인분당선,개포동,3630,3881,7511
1900,20200210,수인분당선,대모산입구,3511,3310,6821
1901,20200210,수인분당선,수서,14050,14248,28298
1902,20200210,수인분당선,복정,1,0,1
1903,20200210,수인분당선,수원,7710,5423,13133
1904,20200210,수인분당선,서울숲,8718,8710,17428
1905,20200210,수인분당선,압구정로데오,15903,17896,33799
1906,20200210,수인분당선,강남구청,10261,11730,21991
1907,20200210,수인분당선,선정릉,8543,9296,17839
1908,20200210,수인분당선,가천대,6442,7617,14059
1909,20200210,수인분당선,태평,13856,13564,27420
1910,20200210,수인분당선,모란,20316,20413,40729
1911,20200210,수인분당선,야탑,27635,29313,56948
1912,20200210,수인분당선,서현,27164,27356,54520
1913,20200210,수인분당선,수내,12886,12621,25507
1914,20200210,수인분당선,정자,17625,18872,36497
1915,20200210,수인분당선,미금,16914,18118,35032
1916,20200210,수인분당선,오리,12549,10722,23271
1917,20200210,수인분당선,이매,5636,5269,10905
1918,20200210,수인분당선,보정,2493,2274,4767
1919,20200210,수인분당선,죽전,12856,14026,26882
1920,20200210,수인분당선,구성,4986,5068,10054
1921,20200210,수인분당선,신갈,4986,4882,9868
1922,20200210,수인분당선,기흥,9853,9413,19266
1923,20200210,수인분당선,상갈,5590,5154,10744
1924,20200210,수인분당선,청명,4090,3843,7933
1925,20200210,수인분당선,영통,8450,8664,17114
1926,20200210,수인분당선,망포,13737,12976,26713
1927,20200210,수인분당선,매탄권선,4168,4063,8231
1928,20200210,수인분당선,수원시청,11388,12287,23675
1929,20200210,수인분당선,매교,2179,2210,4389
1930,20200210,수인분당선,달월,75,46,121
1931,20200210,수인분당선,월곶,2167,2032,4199
1932,20200210,수인분당선,소래포구,4004,3617,7621
1933,20200210,수인분당선,인천논현,5768,6014,11782
1934,20200210,수인분당선,호구포,3619,3663,7282
1935,20200210,수인분당선,남동인더스파크,2352,2604,4956
1936,20200210,수인분당선,원인재,4157,4246,8403
1937,20200210,수인분당선,연수,4614,4543,9157
1938,20200210,수인분당선,송도,2482,2307,4789
1939,20200210,수인분당선,인하대,4859,4717,9576
1940,20200210,수인분당선,숭의,3631,3327,6958
1941,20200210,수인분당선,신포,1553,1572,3125
1942,20200210,수인분당선,인천,790,1285,2075
1943,20200211,수인분당선,선릉,14469,23218,37687
1944,20200211,수인분당선,한티,14980,15941,30921
1945,20200211,수인분당선,도곡,7059,7195,14254
1946,20200211,수인분당선,구룡,1666,1655,3321
1947,20200211,수인분당선,개포동,3799,3927,7726
1948,20200211,수인분당선,대모산입구,3522,3277,6799
1949,20200211,수인분당선,수서,14120,14228,28348
1950,20200211,수인분당선,수원,8018,5486,13504
1951,20200211,수인분당선,서울숲,9354,9650,19004
1952,20200211,수인분당선,압구정로데오,17332,19504,36836
1953,20200211,수인분당선,강남구청,10631,12360,22991
1954,20200211,수인분당선,선정릉,8745,9510,18255
1955,20200211,수인분당선,가천대,6697,7682,14379
1956,20200211,수인분당선,태평,14291,13985,28276
1957,20200211,수인분당선,모란,21594,21357,42951
1958,20200211,수인분당선,야탑,28239,29850,58089
1959,20200211,수인분당선,서현,28828,29320,58148
1960,20200211,수인분당선,수내,14392,14498,28890
1961,20200211,수인분당선,정자,18262,19636,37898
1962,20200211,수인분당선,미금,17605,18645,36250
1963,20200211,수인분당선,오리,13046,10971,24017
1964,20200211,수인분당선,이매,5778,5539,11317
1965,20200211,수인분당선,보정,2619,2308,4927
1966,20200211,수인분당선,죽전,14511,16012,30523
1967,20200211,수인분당선,구성,5115,5071,10186
1968,20200211,수인분당선,신갈,4957,4783,9740
1969,20200211,수인분당선,기흥,10190,9641,19831
1970,20200211,수인분당선,상갈,5783,5448,11231
1971,20200211,수인분당선,청명,4306,4019,8325
1972,20200211,수인분당선,영통,8726,8850,17576
1973,20200211,수인분당선,망포,14171,13488,27659
1974,20200211,수인분당선,매탄권선,4522,4204,8726
1975,20200211,수인분당선,수원시청,11534,12727,24261
1976,20200211,수인분당선,매교,2207,2252,4459
1977,20200211,수인분당선,달월,83,54,137
1978,20200211,수인분당선,월곶,2170,2093,4263
1979,20200211,수인분당선,소래포구,4263,3906,8169
1980,20200211,수인분당선,인천논현,5912,6184,12096
1981,20200211,수인분당선,호구포,3606,3637,7243
1982,20200211,수인분당선,남동인더스파크,2357,2607,4964
1983,20200211,수인분당선,원인재,4345,4456,8801
1984,20200211,수인분당선,연수,4609,4593,9202
1985,20200211,수인분당선,송도,2578,2376,4954
1986,20200211,수인분당선,인하대,5196,4944,10140
1987,20200211,수인분당선,숭의,3730,3500,7230
1988,20200211,수인분당선,신포,1619,1652,3271
1989,20200211,수인분당선,인천,800,1343,2143
1990,20200212,수인분당선,선릉,14283,22690,36973
1991,20200212,수인분당선,한티,14830,15779,30609
1992,20200212,수인분당선,도곡,6858,7040,13898
1993,20200212,수인분당선,구룡,1621,1586,3207
1994,20200212,수인분당선,개포동,3765,4042,7807
1995,20200212,수인분당선,대모산입구,3333,3108,6441
1996,20200212,수인분당선,수서,13924,14189,28113
1997,20200212,수인분당선,복정,1,0,1
1998,20200212,수인분당선,수원,7744,5402,13146
1999,20200212,수인분당선,서울숲,9013,9156,18169
2000,20200212,수인분당선,압구정로데오,16736,18871,35607
2001,20200212,수인분당선,강남구청,10532,11993,22525
2002,20200212,수인분당선,선정릉,8822,9393,18215
2003,20200212,수인분당선,가천대,6524,7542,14066
2004,20200212,수인분당선,태평,13788,13463,27251
2005,20200212,수인분당선,모란,20405,20585,40990
2006,20200212,수인분당선,야탑,28486,30084,58570
2007,20200212,수인분당선,서현,28157,28321,56478
2008,20200212,수인분당선,수내,13889,13876,27765
2009,20200212,수인분당선,정자,18254,19326,37580
2010,20200212,수인분당선,미금,17088,18199,35287
2011,20200212,수인분당선,오리,12600,10808,23408
2012,20200212,수인분당선,이매,5548,5283,10831
2013,20200212,수인분당선,보정,2570,2178,4748
2014,20200212,수인분당선,죽전,13896,15367,29263
2015,20200212,수인분당선,구성,4862,4986,9848
2016,20200212,수인분당선,신갈,4795,4660,9455
2017,20200212,수인분당선,기흥,9860,9390,19250
2018,20200212,수인분당선,상갈,5585,5222,10807
2019,20200212,수인분당선,청명,4243,3903,8146
2020,20200212,수인분당선,영통,8348,8576,16924
2021,20200212,수인분당선,망포,13866,13110,26976
2022,20200212,수인분당선,매탄권선,4392,4205,8597
2023,20200212,수인분당선,수원시청,11210,12313,23523
2024,20200212,수인분당선,매교,2171,2223,4394
2025,20200212,수인분당선,달월,89,68,157
2026,20200212,수인분당선,월곶,2175,2094,4269
2027,20200212,수인분당선,소래포구,3768,3465,7233
2028,20200212,수인분당선,인천논현,5680,5974,11654
2029,20200212,수인분당선,호구포,3523,3540,7063
2030,20200212,수인분당선,남동인더스파크,2391,2538,4929
2031,20200212,수인분당선,원인재,4047,4110,8157
2032,20200212,수인분당선,연수,4498,4608,9106
2033,20200212,수인분당선,송도,2377,2175,4552
2034,20200212,수인분당선,인하대,4851,4584,9435
2035,20200212,수인분당선,숭의,3513,3326,6839
2036,20200212,수인분당선,신포,1477,1514,2991
2037,20200212,수인분당선,인천,732,1232,1964
2038,20200213,수인분당선,선릉,14332,23266,37598
2039,20200213,수인분당선,한티,15464,16317,31781
2040,20200213,수인분당선,도곡,6927,7114,14041
2041,20200213,수인분당선,구룡,1766,1687,3453
2042,20200213,수인분당선,개포동,3802,3951,7753
2043,20200213,수인분당선,대모산입구,3450,3257,6707
2044,20200213,수인분당선,수서,14597,14618,29215
2045,20200213,수인분당선,복정,1,0,1
2046,20200213,수인분당선,수원,8174,5776,13950
2047,20200213,수인분당선,서울숲,9271,9381,18652
2048,20200213,수인분당선,압구정로데오,17639,20266,37905
2049,20200213,수인분당선,강남구청,10607,12310,22917
2050,20200213,수인분당선,선정릉,8930,9584,18514
2051,20200213,수인분당선,가천대,6642,7691,14333
2052,20200213,수인분당선,태평,14595,14225,28820
2053,20200213,수인분당선,모란,21699,21645,43344
2054,20200213,수인분당선,야탑,29569,30952,60521
2055,20200213,수인분당선,서현,29434,29935,59369
2056,20200213,수인분당선,수내,14493,14535,29028
2057,20200213,수인분당선,정자,18863,20066,38929
2058,20200213,수인분당선,미금,17603,18699,36302
2059,20200213,수인분당선,오리,13169,11243,24412
2060,20200213,수인분당선,이매,5905,5721,11626
2061,20200213,수인분당선,보정,2658,2198,4856
2062,20200213,수인분당선,죽전,14961,16384,31345
2063,20200213,수인분당선,구성,5211,5106,10317
2064,20200213,수인분당선,신갈,5013,4739,9752
2065,20200213,수인분당선,기흥,10306,9742,20048
2066,20200213,수인분당선,상갈,5849,5420,11269
2067,20200213,수인분당선,청명,4439,4139,8578
2068,20200213,수인분당선,영통,8827,9036,17863
2069,20200213,수인분당선,망포,14385,13599,27984
2070,20200213,수인분당선,매탄권선,4559,4295,8854
2071,20200213,수인분당선,수원시청,11962,13312,25274
2072,20200213,수인분당선,매교,2242,2128,4370
2073,20200213,수인분당선,달월,71,56,127
2074,20200213,수인분당선,월곶,2403,2222,4625
2075,20200213,수인분당선,소래포구,4156,3864,8020
2076,20200213,수인분당선,인천논현,6029,6229,12258
2077,20200213,수인분당선,호구포,3587,3624,7211
2078,20200213,수인분당선,남동인더스파크,2341,2600,4941
2079,20200213,수인분당선,원인재,4249,4469,8718
2080,20200213,수인분당선,연수,4586,4586,9172
2081,20200213,수인분당선,송도,2608,2422,5030
2082,20200213,수인분당선,인하대,5163,4916,10079
2083,20200213,수인분당선,숭의,3742,3527,7269
2084,20200213,수인분당선,신포,1644,1654,3298
2085,20200213,수인분당선,인천,779,1361,2140
2086,20200214,수인분당선,선릉,14270,23208,37478
2087,20200214,수인분당선,한티,16187,17107,33294
2088,20200214,수인분당선,도곡,7317,7263,14580
2089,20200214,수인분당선,구룡,1918,1854,3772
2090,20200214,수인분당선,개포동,3961,4141,8102
2091,20200214,수인분당선,대모산입구,3599,3356,6955
2092,20200214,수인분당선,수서,16572,16960,33532
2093,20200214,수인분당선,수원,9285,6507,15792
2094,20200214,수인분당선,서울숲,9973,9935,19908
2095,20200214,수인분당선,압구정로데오,19380,22791,42171
2096,20200214,수인분당선,강남구청,11136,12740,23876
2097,20200214,수인분당선,선정릉,8888,9622,18510
2098,20200214,수인분당선,가천대,6867,7709,14576
2099,20200214,수인분당선,태평,15497,14917,30414
2100,20200214,수인분당선,모란,28489,29865,58354
2101,20200214,수인분당선,야탑,31563,33122,64685
2102,20200214,수인분당선,서현,32411,32941,65352
2103,20200214,수인분당선,수내,15198,15138,30336
2104,20200214,수인분당선,정자,19941,21356,41297
2105,20200214,수인분당선,미금,18757,20023,38780
2106,20200214,수인분당선,오리,13854,11678,25532
2107,20200214,수인분당선,이매,6353,5999,12352
2108,20200214,수인분당선,보정,2887,2323,5210
2109,20200214,수인분당선,죽전,16467,17496,33963
2110,20200214,수인분당선,구성,5591,5502,11093
2111,20200214,수인분당선,신갈,5367,5067,10434
2112,20200214,수인분당선,기흥,11026,10455,21481
2113,20200214,수인분당선,상갈,6240,5582,11822
2114,20200214,수인분당선,청명,4733,4302,9035
2115,20200214,수인분당선,영통,10204,10112,20316
2116,20200214,수인분당선,망포,16067,14480,30547
2117,20200214,수인분당선,매탄권선,5239,4603,9842
2118,20200214,수인분당선,수원시청,13018,16219,29237
2119,20200214,수인분당선,매교,2409,2455,4864
2120,20200214,수인분당선,달월,80,54,134
2121,20200214,수인분당선,월곶,2491,2302,4793
2122,20200214,수인분당선,소래포구,4658,4438,9096
2123,20200214,수인분당선,인천논현,6409,6758,13167
2124,20200214,수인분당선,호구포,3844,3793,7637
2125,20200214,수인분당선,남동인더스파크,2457,2646,5103
2126,20200214,수인분당선,원인재,4767,4747,9514
2127,20200214,수인분당선,연수,5245,5405,10650
2128,20200214,수인분당선,송도,2804,2531,5335
2129,20200214,수인분당선,인하대,5555,5130,10685
2130,20200214,수인분당선,숭의,3907,3680,7587
2131,20200214,수인분당선,신포,1717,1766,3483
2132,20200214,수인분당선,인천,980,1581,2561
2133,20200215,수인분당선,선릉,5522,9433,14955
2134,20200215,수인분당선,한티,12735,12227,24962
2135,20200215,수인분당선,도곡,4844,4568,9412
2136,20200215,수인분당선,구룡,1003,916,1919
2137,20200215,수인분당선,개포동,2555,2611,5166
2138,20200215,수인분당선,대모산입구,2355,2115,4470
2139,20200215,수인분당선,수서,10761,11112,21873
2140,20200215,수인분당선,수원,7161,4986,12147
2141,20200215,수인분당선,서울숲,6838,6931,13769
2142,20200215,수인분당선,압구정로데오,15454,17833,33287
2143,20200215,수인분당선,강남구청,5685,6999,12684
2144,20200215,수인분당선,선정릉,4246,4478,8724
2145,20200215,수인분당선,가천대,5077,5709,10786
2146,20200215,수인분당선,태평,11369,10764,22133
2147,20200215,수인분당선,모란,17452,17765,35217
2148,20200215,수인분당선,야탑,21212,22561,43773
2149,20200215,수인분당선,서현,22188,22495,44683
2150,20200215,수인분당선,수내,9073,8620,17693
2151,20200215,수인분당선,정자,11425,11697,23122
2152,20200215,수인분당선,미금,12180,12656,24836
2153,20200215,수인분당선,오리,9327,7644,16971
2154,20200215,수인분당선,이매,4213,4043,8256
2155,20200215,수인분당선,보정,1761,1541,3302
2156,20200215,수인분당선,죽전,11270,12576,23846
2157,20200215,수인분당선,구성,3358,3376,6734
2158,20200215,수인분당선,신갈,3074,2927,6001
2159,20200215,수인분당선,기흥,7432,7067,14499
2160,20200215,수인분당선,상갈,4110,4043,8153
2161,20200215,수인분당선,청명,2964,2971,5935
2162,20200215,수인분당선,영통,7396,7164,14560
2163,20200215,수인분당선,망포,9582,8410,17992
2164,20200215,수인분당선,매탄권선,3595,3270,6865
2165,20200215,수인분당선,수원시청,10777,13242,24019
2166,20200215,수인분당선,매교,1623,1802,3425
2167,20200215,수인분당선,달월,46,27,73
2168,20200215,수인분당선,월곶,1984,1887,3871
2169,20200215,수인분당선,소래포구,4174,4221,8395
2170,20200215,수인분당선,인천논현,4765,4898,9663
2171,20200215,수인분당선,호구포,2362,2190,4552
2172,20200215,수인분당선,남동인더스파크,1007,970,1977
2173,20200215,수인분당선,원인재,3734,3757,7491
2174,20200215,수인분당선,연수,4161,4306,8467
2175,20200215,수인분당선,송도,2083,1916,3999
2176,20200215,수인분당선,인하대,3567,3393,6960
2177,20200215,수인분당선,숭의,2585,2378,4963
2178,20200215,수인분당선,신포,1311,1423,2734
2179,20200215,수인분당선,인천,749,1234,1983
2180,20200216,수인분당선,선릉,2800,4630,7430
2181,20200216,수인분당선,한티,9232,8703,17935
2182,20200216,수인분당선,도곡,2575,2529,5104
2183,20200216,수인분당선,구룡,574,622,1196
2184,20200216,수인분당선,개포동,2051,2015,4066
2185,20200216,수인분당선,대모산입구,1568,1412,2980
2186,20200216,수인분당선,수서,9001,8423,17424
2187,20200216,수인분당선,수원,5059,3471,8530
2188,20200216,수인분당선,서울숲,3814,3964,7778
2189,20200216,수인분당선,압구정로데오,7868,8521,16389
2190,20200216,수인분당선,강남구청,3301,3906,7207
2191,20200216,수인분당선,선정릉,2299,2478,4777
2192,20200216,수인분당선,가천대,3209,4048,7257
2193,20200216,수인분당선,태평,8093,7858,15951
2194,20200216,수인분당선,모란,11593,12223,23816
2195,20200216,수인분당선,야탑,15763,16006,31769
2196,20200216,수인분당선,서현,17219,16762,33981
2197,20200216,수인분당선,수내,6294,6237,12531
2198,20200216,수인분당선,정자,7611,7897,15508
2199,20200216,수인분당선,미금,8857,9393,18250
2200,20200216,수인분당선,오리,6286,5531,11817
2201,20200216,수인분당선,이매,4134,4154,8288
2202,20200216,수인분당선,보정,1135,1038,2173
2203,20200216,수인분당선,죽전,8124,9574,17698
2204,20200216,수인분당선,구성,2272,2480,4752
2205,20200216,수인분당선,신갈,2117,2081,4198
2206,20200216,수인분당선,기흥,5173,5217,10390
2207,20200216,수인분당선,상갈,2939,3057,5996
2208,20200216,수인분당선,청명,2002,1966,3968
2209,20200216,수인분당선,영통,4979,4999,9978
2210,20200216,수인분당선,망포,6276,6589,12865
2211,20200216,수인분당선,매탄권선,2360,2313,4673
2212,20200216,수인분당선,수원시청,7294,7564,14858
2213,20200216,수인분당선,매교,1066,1100,2166
2214,20200216,수인분당선,달월,23,26,49
2215,20200216,수인분당선,월곶,1315,1293,2608
2216,20200216,수인분당선,소래포구,2754,2657,5411
2217,20200216,수인분당선,인천논현,3008,3173,6181
2218,20200216,수인분당선,호구포,1797,1821,3618
2219,20200216,수인분당선,남동인더스파크,605,645,1250
2220,20200216,수인분당선,원인재,2645,2686,5331
2221,20200216,수인분당선,연수,3434,3359,6793
2222,20200216,수인분당선,송도,1436,1372,2808
2223,20200216,수인분당선,인하대,2479,2417,4896
2224,20200216,수인분당선,숭의,1652,1559,3211
2225,20200216,수인분당선,신포,978,947,1925
2226,20200216,수인분당선,인천,700,981,1681
2227,20200217,수인분당선,선릉,14593,23447,38040
2228,20200217,수인분당선,한티,15436,16575,32011
2229,20200217,수인분당선,도곡,7047,7242,14289
2230,20200217,수인분당선,구룡,1467,1414,2881
2231,20200217,수인분당선,개포동,3938,4074,8012
2232,20200217,수인분당선,대모산입구,3751,3360,7111
2233,20200217,수인분당선,수서,15388,15877,31265
2234,20200217,수인분당선,수원,8260,5759,14019
2235,20200217,수인분당선,서울숲,9058,9109,18167
2236,20200217,수인분당선,압구정로데오,16421,18681,35102
2237,20200217,수인분당선,강남구청,10533,12111,22644
2238,20200217,수인분당선,선정릉,9122,9775,18897
2239,20200217,수인분당선,가천대,6548,7838,14386
2240,20200217,수인분당선,태평,14722,14240,28962
2241,20200217,수인분당선,모란,21553,21586,43139
2242,20200217,수인분당선,야탑,29748,31504,61252
2243,20200217,수인분당선,서현,30583,30671,61254
2244,20200217,수인분당선,수내,15318,15131,30449
2245,20200217,수인분당선,정자,20048,21090,41138
2246,20200217,수인분당선,미금,18688,19864,38552
2247,20200217,수인분당선,오리,14255,11751,26006
2248,20200217,수인분당선,이매,6478,6215,12693
2249,20200217,수인분당선,보정,2975,2375,5350
2250,20200217,수인분당선,죽전,15090,16334,31424
2251,20200217,수인분당선,구성,5562,5434,10996
2252,20200217,수인분당선,신갈,5069,4885,9954
2253,20200217,수인분당선,기흥,10946,10315,21261
2254,20200217,수인분당선,상갈,6081,5705,11786
2255,20200217,수인분당선,청명,4643,4356,8999
2256,20200217,수인분당선,영통,8995,9245,18240
2257,20200217,수인분당선,망포,14906,14251,29157
2258,20200217,수인분당선,매탄권선,4809,4576,9385
2259,20200217,수인분당선,수원시청,12097,13019,25116
2260,20200217,수인분당선,매교,2294,2274,4568
2261,20200217,수인분당선,달월,75,41,116
2262,20200217,수인분당선,월곶,2160,1982,4142
2263,20200217,수인분당선,소래포구,3868,3603,7471
2264,20200217,수인분당선,인천논현,5720,6000,11720
2265,20200217,수인분당선,호구포,3560,3759,7319
2266,20200217,수인분당선,남동인더스파크,2373,2729,5102
2267,20200217,수인분당선,원인재,4221,4364,8585
2268,20200217,수인분당선,연수,4494,4389,8883
2269,20200217,수인분당선,송도,2401,2196,4597
2270,20200217,수인분당선,인하대,4867,4616,9483
2271,20200217,수인분당선,숭의,3657,3388,7045
2272,20200217,수인분당선,신포,1430,1449,2879
2273,20200217,수인분당선,인천,742,1305,2047
2274,20200218,수인분당선,선릉,14556,23498,38054
2275,20200218,수인분당선,한티,15458,16315,31773
2276,20200218,수인분당선,도곡,6982,7013,13995
2277,20200218,수인분당선,구룡,1404,1389,2793
2278,20200218,수인분당선,개포동,3551,3762,7313
2279,20200218,수인분당선,대모산입구,3490,3206,6696
2280,20200218,수인분당선,수서,14758,14777,29535
2281,20200218,수인분당선,수원,8292,5649,13941
2282,20200218,수인분당선,서울숲,9259,9370,18629
2283,20200218,수인분당선,압구정로데오,17849,19939,37788
2284,20200218,수인분당선,강남구청,10665,12308,22973
2285,20200218,수인분당선,선정릉,8896,9573,18469
2286,20200218,수인분당선,가천대,6973,8220,15193
2287,20200218,수인분당선,태평,14354,13997,28351
2288,20200218,수인분당선,모란,21166,21300,42466
2289,20200218,수인분당선,야탑,29114,30436,59550
2290,20200218,수인분당선,서현,29337,29588,58925
2291,20200218,수인분당선,수내,14679,14705,29384
2292,20200218,수인분당선,정자,18950,20213,39163
2293,20200218,수인분당선,미금,17928,19150,37078
2294,20200218,수인분당선,오리,13266,11240,24506
2295,20200218,수인분당선,이매,6036,5839,11875
2296,20200218,수인분당선,보정,2716,2337,5053
2297,20200218,수인분당선,죽전,14655,16129,30784
2298,20200218,수인분당선,구성,5119,5113,10232
2299,20200218,수인분당선,신갈,5093,4937,10030
2300,20200218,수인분당선,기흥,10409,9901,20310
2301,20200218,수인분당선,상갈,5832,5485,11317
2302,20200218,수인분당선,청명,4323,4110,8433
2303,20200218,수인분당선,영통,8975,9181,18156
2304,20200218,수인분당선,망포,14653,13781,28434
2305,20200218,수인분당선,매탄권선,4651,4414,9065
2306,20200218,수인분당선,수원시청,11970,13069,25039
2307,20200218,수인분당선,매교,2284,2350,4634
2308,20200218,수인분당선,달월,75,56,131
2309,20200218,수인분당선,월곶,2176,2036,4212
2310,20200218,수인분당선,소래포구,4069,3750,7819
2311,20200218,수인분당선,인천논현,5853,5941,11794
2312,20200218,수인분당선,호구포,3621,3641,7262
2313,20200218,수인분당선,남동인더스파크,2420,2660,5080
2314,20200218,수인분당선,원인재,4179,4288,8467
2315,20200218,수인분당선,연수,4424,4530,8954
2316,20200218,수인분당선,송도,2436,2216,4652
2317,20200218,수인분당선,인하대,4869,4662,9531
2318,20200218,수인분당선,숭의,3650,3426,7076
2319,20200218,수인분당선,신포,1542,1548,3090
2320,20200218,수인분당선,인천,770,1251,2021
2321,20200219,수인분당선,선릉,14628,23502,38130
2322,20200219,수인분당선,한티,15223,16143,31366
2323,20200219,수인분당선,도곡,6929,7101,14030
2324,20200219,수인분당선,구룡,1451,1426,2877
2325,20200219,수인분당선,개포동,3742,3855,7597
2326,20200219,수인분당선,대모산입구,3612,3304,6916
2327,20200219,수인분당선,수서,14929,15199,30128
2328,20200219,수인분당선,수원,8404,5769,14173
2329,20200219,수인분당선,서울숲,9231,9494,18725
2330,20200219,수인분당선,압구정로데오,17823,19831,37654
2331,20200219,수인분당선,강남구청,10848,12383,23231
2332,20200219,수인분당선,선정릉,8808,9632,18440
2333,20200219,수인분당선,가천대,6995,8050,15045
2334,20200219,수인분당선,태평,14797,14361,29158
2335,20200219,수인분당선,모란,26222,26866,53088
2336,20200219,수인분당선,야탑,30250,31708,61958
2337,20200219,수인분당선,서현,29559,29832,59391
2338,20200219,수인분당선,수내,15095,15013,30108
2339,20200219,수인분당선,정자,19163,20467,39630
2340,20200219,수인분당선,미금,18165,19246,37411
2341,20200219,수인분당선,오리,13344,11345,24689
2342,20200219,수인분당선,이매,6205,5973,12178
2343,20200219,수인분당선,보정,2849,2379,5228
2344,20200219,수인분당선,죽전,14888,16302,31190
2345,20200219,수인분당선,구성,5279,5219,10498
2346,20200219,수인분당선,신갈,5141,5025,10166
2347,20200219,수인분당선,기흥,10532,9934,20466
2348,20200219,수인분당선,상갈,5977,5517,11494
2349,20200219,수인분당선,청명,4465,4246,8711
2350,20200219,수인분당선,영통,9208,9426,18634
2351,20200219,수인분당선,망포,14872,14085,28957
2352,20200219,수인분당선,매탄권선,4727,4486,9213
2353,20200219,수인분당선,수원시청,12256,13580,25836
2354,20200219,수인분당선,매교,2696,2661,5357
2355,20200219,수인분당선,달월,76,50,126
2356,20200219,수인분당선,월곶,2478,2335,4813
2357,20200219,수인분당선,소래포구,4336,3990,8326
2358,20200219,수인분당선,인천논현,5973,6234,12207
2359,20200219,수인분당선,호구포,3663,3659,7322
2360,20200219,수인분당선,남동인더스파크,2428,2700,5128
2361,20200219,수인분당선,원인재,4405,4540,8945
2362,20200219,수인분당선,연수,4606,4772,9378
2363,20200219,수인분당선,송도,2642,2465,5107
2364,20200219,수인분당선,인하대,5234,4982,10216
2365,20200219,수인분당선,숭의,3849,3585,7434
2366,20200219,수인분당선,신포,1650,1720,3370
2367,20200219,수인분당선,인천,822,1356,2178
2368,20200220,수인분당선,선릉,14164,23091,37255
2369,20200220,수인분당선,한티,14940,15800,30740
2370,20200220,수인분당선,도곡,6671,6808,13479
2371,20200220,수인분당선,구룡,1407,1357,2764
2372,20200220,수인분당선,개포동,3464,3716,7180
2373,20200220,수인분당선,대모산입구,3503,3295,6798
2374,20200220,수인분당선,수서,14584,14772,29356
2375,20200220,수인분당선,복정,1,0,1
2376,20200220,수인분당선,수원,8130,5561,13691
2377,20200220,수인분당선,서울숲,9191,9297,18488
2378,20200220,수인분당선,압구정로데오,17689,20137,37826
2379,20200220,수인분당선,강남구청,10340,12110,22450
2380,20200220,수인분당선,선정릉,8681,9454,18135
2381,20200220,수인분당선,가천대,7237,8317,15554
2382,20200220,수인분당선,태평,14308,14195,28503
2383,20200220,수인분당선,모란,21090,21092,42182
2384,20200220,수인분당선,야탑,29216,30436,59652
2385,20200220,수인분당선,서현,28383,28788,57171
2386,20200220,수인분당선,수내,14380,14338,28718
2387,20200220,수인분당선,정자,18993,19998,38991
2388,20200220,수인분당선,미금,17573,18552,36125
2389,20200220,수인분당선,오리,13076,11113,24189
2390,20200220,수인분당선,이매,5831,5627,11458
2391,20200220,수인분당선,보정,2690,2248,4938
2392,20200220,수인분당선,죽전,14963,16341,31304
2393,20200220,수인분당선,구성,5074,5210,10284
2394,20200220,수인분당선,신갈,4985,4807,9792
2395,20200220,수인분당선,기흥,10181,9792,19973
2396,20200220,수인분당선,상갈,5777,5320,11097
2397,20200220,수인분당선,청명,4284,4055,8339
2398,20200220,수인분당선,영통,8926,9091,18017
2399,20200220,수인분당선,망포,14514,13685,28199
2400,20200220,수인분당선,매탄권선,4669,4396,9065
2401,20200220,수인분당선,수원시청,11913,13051,24964
2402,20200220,수인분당선,매교,2571,2596,5167
2403,20200220,수인분당선,달월,73,53,126
2404,20200220,수인분당선,월곶,2316,2197,4513
2405,20200220,수인분당선,소래포구,4249,3912,8161
2406,20200220,수인분당선,인천논현,5860,6085,11945
2407,20200220,수인분당선,호구포,3667,3612,7279
2408,20200220,수인분당선,남동인더스파크,2335,2580,4915
2409,20200220,수인분당선,원인재,4344,4462,8806
2410,20200220,수인분당선,연수,4514,4572,9086
2411,20200220,수인분당선,송도,2579,2415,4994
2412,20200220,수인분당선,인하대,5084,4842,9926
2413,20200220,수인분당선,숭의,3800,3494,7294
2414,20200220,수인분당선,신포,1675,1625,3300
2415,20200220,수인분당선,인천,801,1352,2153
2416,20200221,수인분당선,선릉,13913,21629,35542
2417,20200221,수인분당선,한티,14794,15716,30510
2418,20200221,수인분당선,도곡,6558,6601,13159
2419,20200221,수인분당선,구룡,1342,1310,2652
2420,20200221,수인분당선,개포동,3410,3619,7029
2421,20200221,수인분당선,대모산입구,3352,3036,6388
2422,20200221,수인분당선,수서,14903,15279,30182
2423,20200221,수인분당선,수원,8582,5842,14424
2424,20200221,수인분당선,서울숲,8689,8441,17130
2425,20200221,수인분당선,압구정로데오,18003,20725,38728
2426,20200221,수인분당선,강남구청,10138,11595,21733
2427,20200221,수인분당선,선정릉,8513,9099,17612
2428,20200221,수인분당선,가천대,6441,7262,13703
2429,20200221,수인분당선,태평,14386,13922,28308
2430,20200221,수인분당선,모란,20845,21342,42187
2431,20200221,수인분당선,야탑,28336,30224,58560
2432,20200221,수인분당선,서현,28866,29119,57985
2433,20200221,수인분당선,수내,13927,13984,27911
2434,20200221,수인분당선,정자,18322,19898,38220
2435,20200221,수인분당선,미금,16889,17665,34554
2436,20200221,수인분당선,오리,12589,10673,23262
2437,20200221,수인분당선,이매,5656,5385,11041
2438,20200221,수인분당선,보정,2535,2110,4645
2439,20200221,수인분당선,죽전,14599,15558,30157
2440,20200221,수인분당선,구성,5098,4999,10097
2441,20200221,수인분당선,신갈,4776,4601,9377
2442,20200221,수인분당선,기흥,9926,9276,19202
2443,20200221,수인분당선,상갈,5674,5282,10956
2444,20200221,수인분당선,청명,4371,3988,8359
2445,20200221,수인분당선,영통,9202,9277,18479
2446,20200221,수인분당선,망포,14760,13328,28088
2447,20200221,수인분당선,매탄권선,4778,4268,9046
2448,20200221,수인분당선,수원시청,11691,14445,26136
2449,20200221,수인분당선,매교,2204,2238,4442
2450,20200221,수인분당선,달월,76,51,127
2451,20200221,수인분당선,월곶,2278,2163,4441
2452,20200221,수인분당선,소래포구,3971,3653,7624
2453,20200221,수인분당선,인천논현,5864,6042,11906
2454,20200221,수인분당선,호구포,3666,3551,7217
2455,20200221,수인분당선,남동인더스파크,2339,2645,4984
2456,20200221,수인분당선,원인재,4262,4293,8555
2457,20200221,수인분당선,연수,4555,4731,9286
2458,20200221,수인분당선,송도,2461,2257,4718
2459,20200221,수인분당선,인하대,5087,4839,9926
2460,20200221,수인분당선,숭의,3613,3350,6963
2461,20200221,수인분당선,신포,1546,1614,3160
2462,20200221,수인분당선,인천,785,1339,2124
2463,20200222,수인분당선,선릉,4618,7657,12275
2464,20200222,수인분당선,한티,10829,10400,21229
2465,20200222,수인분당선,도곡,3845,3358,7203
2466,20200222,수인분당선,구룡,1011,912,1923
2467,20200222,수인분당선,개포동,1994,1940,3934
2468,20200222,수인분당선,대모산입구,1958,1773,3731
2469,20200222,수인분당선,수서,7919,7726,15645
2470,20200222,수인분당선,복정,1,0,1
2471,20200222,수인분당선,수원,5818,3936,9754
2472,20200222,수인분당선,서울숲,4842,4925,9767
2473,20200222,수인분당선,압구정로데오,12702,14860,27562
2474,20200222,수인분당선,강남구청,4750,5790,10540
2475,20200222,수인분당선,선정릉,3446,3737,7183
2476,20200222,수인분당선,가천대,4180,4635,8815
2477,20200222,수인분당선,태평,9610,9281,18891
2478,20200222,수인분당선,모란,14177,14525,28702
2479,20200222,수인분당선,야탑,16778,17826,34604
2480,20200222,수인분당선,서현,17677,18280,35957
2481,20200222,수인분당선,수내,7526,7052,14578
2482,20200222,수인분당선,정자,9161,9556,18717
2483,20200222,수인분당선,미금,9979,10209,20188
2484,20200222,수인분당선,오리,7393,6105,13498
2485,20200222,수인분당선,이매,3448,3254,6702
2486,20200222,수인분당선,보정,1293,1138,2431
2487,20200222,수인분당선,죽전,8597,9748,18345
2488,20200222,수인분당선,구성,2626,2610,5236
2489,20200222,수인분당선,신갈,2333,2372,4705
2490,20200222,수인분당선,기흥,5870,5587,11457
2491,20200222,수인분당선,상갈,3278,3127,6405
2492,20200222,수인분당선,청명,2497,2381,4878
2493,20200222,수인분당선,영통,6174,6006,12180
2494,20200222,수인분당선,망포,7662,6864,14526
2495,20200222,수인분당선,매탄권선,2589,2417,5006
2496,20200222,수인분당선,수원시청,8823,10701,19524
2497,20200222,수인분당선,매교,1283,1319,2602
2498,20200222,수인분당선,달월,42,28,70
2499,20200222,수인분당선,월곶,1590,1489,3079
2500,20200222,수인분당선,소래포구,2965,2963,5928
2501,20200222,수인분당선,인천논현,3897,3980,7877
2502,20200222,수인분당선,호구포,2008,1940,3948
2503,20200222,수인분당선,남동인더스파크,830,825,1655
2504,20200222,수인분당선,원인재,2986,3160,6146
2505,20200222,수인분당선,연수,3643,3819,7462
2506,20200222,수인분당선,송도,1694,1655,3349
2507,20200222,수인분당선,인하대,2945,2726,5671
2508,20200222,수인분당선,숭의,2176,2037,4213
2509,20200222,수인분당선,신포,1036,1038,2074
2510,20200222,수인분당선,인천,566,969,1535
2511,20200223,수인분당선,선릉,2137,3488,5625
2512,20200223,수인분당선,한티,6963,6647,13610
2513,20200223,수인분당선,도곡,1823,1812,3635
2514,20200223,수인분당선,구룡,498,474,972
2515,20200223,수인분당선,개포동,1373,1342,2715
2516,20200223,수인분당선,대모산입구,1095,1062,2157
2517,20200223,수인분당선,수서,5863,5640,11503
2518,20200223,수인분당선,수원,3726,2382,6108
2519,20200223,수인분당선,서울숲,3142,3240,6382
2520,20200223,수인분당선,압구정로데오,6743,7459,14202
2521,20200223,수인분당선,강남구청,2582,3110,5692
2522,20200223,수인분당선,선정릉,1925,1956,3881
2523,20200223,수인분당선,가천대,2615,3231,5846
2524,20200223,수인분당선,태평,6446,6006,12452
2525,20200223,수인분당선,모란,9046,9256,18302
2526,20200223,수인분당선,야탑,11099,11457,22556
2527,20200223,수인분당선,서현,11382,11166,22548
2528,20200223,수인분당선,수내,4860,4735,9595
2529,20200223,수인분당선,정자,5789,6023,11812
2530,20200223,수인분당선,미금,5952,6390,12342
2531,20200223,수인분당선,오리,4599,4098,8697
2532,20200223,수인분당선,이매,2192,2276,4468
2533,20200223,수인분당선,보정,736,717,1453
2534,20200223,수인분당선,죽전,5748,6627,12375
2535,20200223,수인분당선,구성,1575,1788,3363
2536,20200223,수인분당선,신갈,1476,1510,2986
2537,20200223,수인분당선,기흥,3731,3724,7455
2538,20200223,수인분당선,상갈,2150,2282,4432
2539,20200223,수인분당선,청명,1358,1386,2744
2540,20200223,수인분당선,영통,3552,3472,7024
2541,20200223,수인분당선,망포,4534,4790,9324
2542,20200223,수인분당선,매탄권선,1635,1612,3247
2543,20200223,수인분당선,수원시청,5682,5629,11311
2544,20200223,수인분당선,매교,838,870,1708
2545,20200223,수인분당선,달월,23,22,45
2546,20200223,수인분당선,월곶,1093,1077,2170
2547,20200223,수인분당선,소래포구,2087,1964,4051
2548,20200223,수인분당선,인천논현,2281,2355,4636
2549,20200223,수인분당선,호구포,1287,1339,2626
2550,20200223,수인분당선,남동인더스파크,395,444,839
2551,20200223,수인분당선,원인재,1961,2043,4004
2552,20200223,수인분당선,연수,2271,2261,4532
2553,20200223,수인분당선,송도,1094,1081,2175
2554,20200223,수인분당선,인하대,1812,1716,3528
2555,20200223,수인분당선,숭의,1361,1280,2641
2556,20200223,수인분당선,신포,720,727,1447
2557,20200223,수인분당선,인천,535,764,1299
2558,20200224,수인분당선,선릉,12769,19818,32587
2559,20200224,수인분당선,한티,11417,12190,23607
2560,20200224,수인분당선,도곡,5585,5684,11269
2561,20200224,수인분당선,구룡,1197,1192,2389
2562,20200224,수인분당선,개포동,2872,3025,5897
2563,20200224,수인분당선,대모산입구,3058,2799,5857
2564,20200224,수인분당선,수서,11168,11219,22387
2565,20200224,수인분당선,수원,6477,4425,10902
2566,20200224,수인분당선,서울숲,7692,7653,15345
2567,20200224,수인분당선,압구정로데오,13866,15483,29349
2568,20200224,수인분당선,강남구청,8607,9914,18521
2569,20200224,수인분당선,선정릉,7751,8312,16063
2570,20200224,수인분당선,가천대,5458,6441,11899
2571,20200224,수인분당선,태평,12462,12257,24719
2572,20200224,수인분당선,모란,19289,19388,38677
2573,20200224,수인분당선,야탑,22772,24036,46808
2574,20200224,수인분당선,서현,22238,22407,44645
2575,20200224,수인분당선,수내,10770,10888,21658
2576,20200224,수인분당선,정자,14745,15804,30549
2577,20200224,수인분당선,미금,13257,14163,27420
2578,20200224,수인분당선,오리,10263,8837,19100
2579,20200224,수인분당선,이매,4463,4309,8772
2580,20200224,수인분당선,보정,1880,1635,3515
2581,20200224,수인분당선,죽전,10454,11232,21686
2582,20200224,수인분당선,구성,4019,4021,8040
2583,20200224,수인분당선,신갈,3792,3692,7484
2584,20200224,수인분당선,기흥,7807,7484,15291
2585,20200224,수인분당선,상갈,4349,4084,8433
2586,20200224,수인분당선,청명,3356,3118,6474
2587,20200224,수인분당선,영통,6474,6592,13066
2588,20200224,수인분당선,망포,11403,10846,22249
2589,20200224,수인분당선,매탄권선,3677,3407,7084
2590,20200224,수인분당선,수원시청,9225,10131,19356
2591,20200224,수인분당선,매교,1893,1869,3762
2592,20200224,수인분당선,달월,80,46,126
2593,20200224,수인분당선,월곶,1831,1744,3575
2594,20200224,수인분당선,소래포구,3300,2933,6233
2595,20200224,수인분당선,인천논현,4795,4991,9786
2596,20200224,수인분당선,호구포,3156,3209,6365
2597,20200224,수인분당선,남동인더스파크,2131,2416,4547
2598,20200224,수인분당선,원인재,3601,3673,7274
2599,20200224,수인분당선,연수,3795,3826,7621
2600,20200224,수인분당선,송도,2128,1967,4095
2601,20200224,수인분당선,인하대,4270,4025,8295
2602,20200224,수인분당선,숭의,3259,3029,6288
2603,20200224,수인분당선,신포,1281,1361,2642
2604,20200224,수인분당선,인천,611,1058,1669
2605,20200225,수인분당선,선릉,11779,18592,30371
2606,20200225,수인분당선,한티,10067,10813,20880
2607,20200225,수인분당선,도곡,4854,5042,9896
2608,20200225,수인분당선,구룡,1033,1024,2057
2609,20200225,수인분당선,개포동,2539,2720,5259
2610,20200225,수인분당선,대모산입구,2637,2407,5044
2611,20200225,수인분당선,수서,9559,9706,19265
2612,20200225,수인분당선,복정,1,0,1
2613,20200225,수인분당선,수원,5752,3948,9700
2614,20200225,수인분당선,서울숲,7163,7255,14418
2615,20200225,수인분당선,압구정로데오,13976,15718,29694
2616,20200225,수인분당선,강남구청,8108,9392,17500
2617,20200225,수인분당선,선정릉,7314,7976,15290
2618,20200225,수인분당선,가천대,5027,5908,10935
2619,20200225,수인분당선,태평,11185,11003,22188
2620,20200225,수인분당선,모란,15882,15967,31849
2621,20200225,수인분당선,야탑,19164,20019,39183
2622,20200225,수인분당선,서현,19429,19855,39284
2623,20200225,수인분당선,수내,9931,10071,20002
2624,20200225,수인분당선,정자,13530,14427,27957
2625,20200225,수인분당선,미금,11755,12751,24506
2626,20200225,수인분당선,오리,9412,8003,17415
2627,20200225,수인분당선,이매,3918,3826,7744
2628,20200225,수인분당선,보정,1765,1500,3265
2629,20200225,수인분당선,죽전,9515,10268,19783
2630,20200225,수인분당선,구성,3575,3508,7083
2631,20200225,수인분당선,신갈,3364,3303,6667
2632,20200225,수인분당선,기흥,7145,6749,13894
2633,20200225,수인분당선,상갈,3963,3678,7641
2634,20200225,수인분당선,청명,3118,2861,5979
2635,20200225,수인분당선,영통,5728,5888,11616
2636,20200225,수인분당선,망포,10506,10110,20616
2637,20200225,수인분당선,매탄권선,3307,3078,6385
2638,20200225,수인분당선,수원시청,8453,9092,17545
2639,20200225,수인분당선,매교,1651,1639,3290
2640,20200225,수인분당선,달월,68,45,113
2641,20200225,수인분당선,월곶,1732,1604,3336
2642,20200225,수인분당선,소래포구,2794,2525,5319
2643,20200225,수인분당선,인천논현,4356,4487,8843
2644,20200225,수인분당선,호구포,3014,3001,6015
2645,20200225,수인분당선,남동인더스파크,2134,2384,4518
2646,20200225,수인분당선,원인재,3344,3308,6652
2647,20200225,수인분당선,연수,3320,3380,6700
2648,20200225,수인분당선,송도,1794,1680,3474
2649,20200225,수인분당선,인하대,3777,3606,7383
2650,20200225,수인분당선,숭의,3010,2794,5804
2651,20200225,수인분당선,신포,1141,1191,2332
2652,20200225,수인분당선,인천,537,934,1471
2653,20200226,수인분당선,선릉,11530,17888,29418
2654,20200226,수인분당선,한티,9822,10293,20115
2655,20200226,수인분당선,도곡,4871,5006,9877
2656,20200226,수인분당선,구룡,1044,1057,2101
2657,20200226,수인분당선,개포동,2467,2638,5105
2658,20200226,수인분당선,대모산입구,2744,2564,5308
2659,20200226,수인분당선,수서,9401,9587,18988
2660,20200226,수인분당선,수원,5939,4038,9977
2661,20200226,수인분당선,서울숲,7355,7378,14733
2662,20200226,수인분당선,압구정로데오,13647,15123,28770
2663,20200226,수인분당선,강남구청,7999,9224,17223
2664,20200226,수인분당선,선정릉,7016,7574,14590
2665,20200226,수인분당선,가천대,4928,5857,10785
2666,20200226,수인분당선,태평,11291,11107,22398
2667,20200226,수인분당선,모란,16083,16164,32247
2668,20200226,수인분당선,야탑,18679,19380,38059
2669,20200226,수인분당선,서현,19076,19289,38365
2670,20200226,수인분당선,수내,9661,9688,19349
2671,20200226,수인분당선,정자,12139,13169,25308
2672,20200226,수인분당선,미금,11854,12600,24454
2673,20200226,수인분당선,오리,9283,7933,17216
2674,20200226,수인분당선,이매,3687,3531,7218
2675,20200226,수인분당선,보정,1733,1480,3213
2676,20200226,수인분당선,죽전,9264,9940,19204
2677,20200226,수인분당선,구성,3564,3618,7182
2678,20200226,수인분당선,신갈,3321,3274,6595
2679,20200226,수인분당선,기흥,7136,6834,13970
2680,20200226,수인분당선,상갈,3976,3687,7663
2681,20200226,수인분당선,청명,3023,2852,5875
2682,20200226,수인분당선,영통,5693,5901,11594
2683,20200226,수인분당선,망포,10454,10011,20465
2684,20200226,수인분당선,매탄권선,3337,3090,6427
2685,20200226,수인분당선,수원시청,8564,9374,17938
2686,20200226,수인분당선,매교,1673,1720,3393
2687,20200226,수인분당선,달월,70,50,120
2688,20200226,수인분당선,월곶,1778,1648,3426
2689,20200226,수인분당선,소래포구,3006,2768,5774
2690,20200226,수인분당선,인천논현,4395,4685,9080
2691,20200226,수인분당선,호구포,3106,3103,6209
2692,20200226,수인분당선,남동인더스파크,2180,2351,4531
2693,20200226,수인분당선,원인재,3455,3470,6925
2694,20200226,수인분당선,연수,3534,3567,7101
2695,20200226,수인분당선,송도,2042,1867,3909
2696,20200226,수인분당선,인하대,3969,3720,7689
2697,20200226,수인분당선,숭의,3038,2861,5899
2698,20200226,수인분당선,신포,1276,1311,2587
2699,20200226,수인분당선,인천,577,995,1572
2700,20200227,수인분당선,선릉,11248,17216,28464
2701,20200227,수인분당선,한티,9270,9930,19200
2702,20200227,수인분당선,도곡,4711,4729,9440
2703,20200227,수인분당선,구룡,1024,978,2002
2704,20200227,수인분당선,개포동,2383,2558,4941
2705,20200227,수인분당선,대모산입구,2647,2410,5057
2706,20200227,수인분당선,수서,8986,9302,18288
2707,20200227,수인분당선,복정,1,0,1
2708,20200227,수인분당선,수원,5599,3742,9341
2709,20200227,수인분당선,서울숲,7121,7258,14379
2710,20200227,수인분당선,압구정로데오,13078,14791,27869
2711,20200227,수인분당선,강남구청,7409,8574,15983
2712,20200227,수인분당선,선정릉,6713,7387,14100
2713,20200227,수인분당선,가천대,4766,5589,10355
2714,20200227,수인분당선,태평,11044,10757,21801
2715,20200227,수인분당선,모란,15671,15701,31372
2716,20200227,수인분당선,야탑,18333,19047,37380
2717,20200227,수인분당선,서현,18337,18748,37085
2718,20200227,수인분당선,수내,9207,9302,18509
2719,20200227,수인분당선,정자,11672,12536,24208
2720,20200227,수인분당선,미금,10649,11556,22205
2721,20200227,수인분당선,오리,8582,7244,15826
2722,20200227,수인분당선,이매,3591,3532,7123
2723,20200227,수인분당선,보정,1545,1327,2872
2724,20200227,수인분당선,죽전,8977,9358,18335
2725,20200227,수인분당선,구성,3290,3366,6656
2726,20200227,수인분당선,신갈,3081,3001,6082
2727,20200227,수인분당선,기흥,6608,6238,12846
2728,20200227,수인분당선,상갈,3745,3502,7247
2729,20200227,수인분당선,청명,2803,2599,5402
2730,20200227,수인분당선,영통,5516,5554,11070
2731,20200227,수인분당선,망포,9930,9510,19440
2732,20200227,수인분당선,매탄권선,3126,3001,6127
2733,20200227,수인분당선,수원시청,8156,8905,17061
2734,20200227,수인분당선,매교,1632,1647,3279
2735,20200227,수인분당선,달월,69,49,118
2736,20200227,수인분당선,월곶,1728,1657,3385
2737,20200227,수인분당선,소래포구,3027,2733,5760
2738,20200227,수인분당선,인천논현,4426,4686,9112
2739,20200227,수인분당선,호구포,3038,3108,6146
2740,20200227,수인분당선,남동인더스파크,2168,2383,4551
2741,20200227,수인분당선,원인재,3328,3424,6752
2742,20200227,수인분당선,연수,3452,3569,7021
2743,20200227,수인분당선,송도,1954,1797,3751
2744,20200227,수인분당선,인하대,4010,3784,7794
2745,20200227,수인분당선,숭의,3081,2806,5887
2746,20200227,수인분당선,신포,1237,1290,2527
2747,20200227,수인분당선,인천,627,1030,1657
2748,20200228,수인분당선,선릉,10563,16317,26880
2749,20200228,수인분당선,한티,9286,9777,19063
2750,20200228,수인분당선,도곡,4654,4777,9431
2751,20200228,수인분당선,구룡,907,929,1836
2752,20200228,수인분당선,개포동,2240,2411,4651
2753,20200228,수인분당선,대모산입구,2428,2289,4717
2754,20200228,수인분당선,수서,9299,9677,18976
2755,20200228,수인분당선,수원,5502,3868,9370
2756,20200228,수인분당선,서울숲,6606,6746,13352
2757,20200228,수인분당선,압구정로데오,12827,14630,27457
2758,20200228,수인분당선,강남구청,7413,8510,15923
2759,20200228,수인분당선,선정릉,6529,6953,13482
2760,20200228,수인분당선,가천대,4690,5297,9987
2761,20200228,수인분당선,태평,10735,10436,21171
2762,20200228,수인분당선,모란,15055,14974,30029
2763,20200228,수인분당선,야탑,18198,18834,37032
2764,20200228,수인분당선,서현,18029,18608,36637
2765,20200228,수인분당선,수내,8978,9003,17981
2766,20200228,수인분당선,정자,10869,11704,22573
2767,20200228,수인분당선,미금,10483,11136,21619
2768,20200228,수인분당선,오리,8480,7239,15719
2769,20200228,수인분당선,이매,3428,3368,6796
2770,20200228,수인분당선,보정,1483,1238,2721
2771,20200228,수인분당선,죽전,8703,9074,17777
2772,20200228,수인분당선,구성,3066,3080,6146
2773,20200228,수인분당선,신갈,2940,2875,5815
2774,20200228,수인분당선,기흥,6427,5983,12410
2775,20200228,수인분당선,상갈,3533,3182,6715
2776,20200228,수인분당선,청명,2776,2564,5340
2777,20200228,수인분당선,영통,5490,5629,11119
2778,20200228,수인분당선,망포,10234,9093,19327
2779,20200228,수인분당선,매탄권선,3199,2919,6118
2780,20200228,수인분당선,수원시청,7973,9547,17520
2781,20200228,수인분당선,매교,1505,1559,3064
2782,20200228,수인분당선,달월,63,41,104
2783,20200228,수인분당선,월곶,1672,1588,3260
2784,20200228,수인분당선,소래포구,2706,2500,5206
2785,20200228,수인분당선,인천논현,4109,4415,8524
2786,20200228,수인분당선,호구포,2930,2940,5870
2787,20200228,수인분당선,남동인더스파크,2040,2228,4268
2788,20200228,수인분당선,원인재,3079,3177,6256
2789,20200228,수인분당선,연수,3144,3341,6485
2790,20200228,수인분당선,송도,1831,1574,3405
2791,20200228,수인분당선,인하대,3817,3516,7333
2792,20200228,수인분당선,숭의,2911,2665,5576
2793,20200228,수인분당선,신포,1142,1243,2385
2794,20200228,수인분당선,인천,588,954,1542
2795,20200229,수인분당선,선릉,2769,4615,7384
2796,20200229,수인분당선,한티,5528,5600,11128
2797,20200229,수인분당선,도곡,2254,2133,4387
2798,20200229,수인분당선,구룡,604,564,1168
2799,20200229,수인분당선,개포동,1259,1190,2449
2800,20200229,수인분당선,대모산입구,1377,1304,2681
2801,20200229,수인분당선,수서,4530,4610,9140
2802,20200229,수인분당선,복정,1,0,1
2803,20200229,수인분당선,수원,3582,2380,5962
2804,20200229,수인분당선,서울숲,3577,3662,7239
2805,20200229,수인분당선,압구정로데오,8702,10241,18943
2806,20200229,수인분당선,강남구청,2991,3522,6513
2807,20200229,수인분당선,선정릉,2157,2295,4452
2808,20200229,수인분당선,가천대,2708,2960,5668
2809,20200229,수인분당선,태평,7116,6845,13961
2810,20200229,수인분당선,모란,11248,11616,22864
2811,20200229,수인분당선,야탑,9455,9919,19374
2812,20200229,수인분당선,서현,11020,11211,22231
2813,20200229,수인분당선,수내,4726,4574,9300
2814,20200229,수인분당선,정자,5684,5911,11595
2815,20200229,수인분당선,미금,6202,6375,12577
2816,20200229,수인분당선,오리,4533,3775,8308
2817,20200229,수인분당선,이매,1982,1966,3948
2818,20200229,수인분당선,보정,775,673,1448
2819,20200229,수인분당선,죽전,5255,5872,11127
2820,20200229,수인분당선,구성,1535,1598,3133
2821,20200229,수인분당선,신갈,1406,1427,2833
2822,20200229,수인분당선,기흥,3514,3305,6819
2823,20200229,수인분당선,상갈,1988,1890,3878
2824,20200229,수인분당선,청명,1244,1181,2425
2825,20200229,수인분당선,영통,3566,3523,7089
2826,20200229,수인분당선,망포,4784,4393,9177
2827,20200229,수인분당선,매탄권선,1720,1504,3224
2828,20200229,수인분당선,수원시청,5348,6377,11725
2829,20200229,수인분당선,매교,934,982,1916
2830,20200229,수인분당선,달월,34,29,63
2831,20200229,수인분당선,월곶,1187,1187,2374
2832,20200229,수인분당선,소래포구,2146,2165,4311
2833,20200229,수인분당선,인천논현,2842,2984,5826
2834,20200229,수인분당선,호구포,1508,1452,2960
2835,20200229,수인분당선,남동인더스파크,788,761,1549
2836,20200229,수인분당선,원인재,2199,2177,4376
2837,20200229,수인분당선,연수,2366,2408,4774
2838,20200229,수인분당선,송도,1234,1210,2444
2839,20200229,수인분당선,인하대,2268,2166,4434
2840,20200229,수인분당선,숭의,1693,1625,3318
2841,20200229,수인분당선,신포,797,836,1633
2842,20200229,수인분당선,인천,481,757,1238
2843,20200301,수인분당선,선릉,1309,2141,3450
2844,20200301,수인분당선,한티,3657,3772,7429
2845,20200301,수인분당선,도곡,1256,1222,2478
2846,20200301,수인분당선,구룡,320,331,651
2847,20200301,수인분당선,개포동,826,792,1618
2848,20200301,수인분당선,대모산입구,665,649,1314
2849,20200301,수인분당선,수서,3330,3374,6704
2850,20200301,수인분당선,복정,1,0,1
2851,20200301,수인분당선,수원,2429,1630,4059
2852,20200301,수인분당선,서울숲,2140,2179,4319
2853,20200301,수인분당선,압구정로데오,4739,5229,9968
2854,20200301,수인분당선,강남구청,1574,1933,3507
2855,20200301,수인분당선,선정릉,1176,1263,2439
2856,20200301,수인분당선,가천대,1818,2191,4009
2857,20200301,수인분당선,태평,4664,4321,8985
2858,20200301,수인분당선,모란,6205,6263,12468
2859,20200301,수인분당선,야탑,6594,6976,13570
2860,20200301,수인분당선,서현,7445,7272,14717
2861,20200301,수인분당선,수내,2985,3002,5987
2862,20200301,수인분당선,정자,3723,3839,7562
2863,20200301,수인분당선,미금,3787,3919,7706
2864,20200301,수인분당선,오리,3133,2801,5934
2865,20200301,수인분당선,이매,1235,1250,2485
2866,20200301,수인분당선,보정,475,450,925
2867,20200301,수인분당선,죽전,3874,4315,8189
2868,20200301,수인분당선,구성,958,1090,2048
2869,20200301,수인분당선,신갈,865,874,1739
2870,20200301,수인분당선,기흥,2327,2402,4729
2871,20200301,수인분당선,상갈,1327,1345,2672
2872,20200301,수인분당선,청명,853,835,1688
2873,20200301,수인분당선,영통,2146,2134,4280
2874,20200301,수인분당선,망포,2881,3076,5957
2875,20200301,수인분당선,매탄권선,1154,1084,2238
2876,20200301,수인분당선,수원시청,3542,3558,7100
2877,20200301,수인분당선,매교,561,587,1148
2878,20200301,수인분당선,달월,22,22,44
2879,20200301,수인분당선,월곶,791,718,1509
2880,20200301,수인분당선,소래포구,1627,1526,3153
2881,20200301,수인분당선,인천논현,1802,1890,3692
2882,20200301,수인분당선,호구포,950,948,1898
2883,20200301,수인분당선,남동인더스파크,330,336,666
2884,20200301,수인분당선,원인재,1385,1508,2893
2885,20200301,수인분당선,연수,1702,1672,3374
2886,20200301,수인분당선,송도,873,887,1760
2887,20200301,수인분당선,인하대,1535,1514,3049
2888,20200301,수인분당선,숭의,1085,1063,2148
2889,20200301,수인분당선,신포,503,540,1043
2890,20200301,수인분당선,인천,398,565,963
2891,20200302,수인분당선,선릉,10518,16417,26935
2892,20200302,수인분당선,한티,8268,8960,17228
2893,20200302,수인분당선,도곡,4580,4814,9394
2894,20200302,수인분당선,구룡,979,974,1953
2895,20200302,수인분당선,개포동,2309,2479,4788
2896,20200302,수인분당선,대모산입구,2528,2294,4822
2897,20200302,수인분당선,수서,8772,9026,17798
2898,20200302,수인분당선,수원,5296,3659,8955
2899,20200302,수인분당선,서울숲,6783,6819,13602
2900,20200302,수인분당선,압구정로데오,11805,13068,24873
2901,20200302,수인분당선,강남구청,6993,8083,15076
2902,20200302,수인분당선,선정릉,6524,6955,13479
2903,20200302,수인분당선,가천대,4675,5515,10190
2904,20200302,수인분당선,태평,10698,10516,21214
2905,20200302,수인분당선,모란,15405,15454,30859
2906,20200302,수인분당선,야탑,18145,19089,37234
2907,20200302,수인분당선,서현,18488,18358,36846
2908,20200302,수인분당선,수내,8418,8305,16723
2909,20200302,수인분당선,정자,11115,12091,23206
2910,20200302,수인분당선,미금,10978,11824,22802
2911,20200302,수인분당선,오리,8696,7555,16251
2912,20200302,수인분당선,이매,3569,3478,7047
2913,20200302,수인분당선,보정,1637,1405,3042
2914,20200302,수인분당선,죽전,8959,9567,18526
2915,20200302,수인분당선,구성,3271,3348,6619
2916,20200302,수인분당선,신갈,3067,2963,6030
2917,20200302,수인분당선,기흥,6516,6237,12753
2918,20200302,수인분당선,상갈,3523,3299,6822
2919,20200302,수인분당선,청명,2730,2556,5286
2920,20200302,수인분당선,영통,5294,5418,10712
2921,20200302,수인분당선,망포,9479,9081,18560
2922,20200302,수인분당선,매탄권선,3089,2890,5979
2923,20200302,수인분당선,수원시청,7682,8323,16005
2924,20200302,수인분당선,매교,1587,1535,3122
2925,20200302,수인분당선,달월,66,43,109
2926,20200302,수인분당선,월곶,1646,1558,3204
2927,20200302,수인분당선,소래포구,2802,2547,5349
2928,20200302,수인분당선,인천논현,4172,4296,8468
2929,20200302,수인분당선,호구포,2878,2947,5825
2930,20200302,수인분당선,남동인더스파크,2016,2260,4276
2931,20200302,수인분당선,원인재,3200,3220,6420
2932,20200302,수인분당선,연수,3219,3228,6447
2933,20200302,수인분당선,송도,1907,1743,3650
2934,20200302,수인분당선,인하대,3875,3740,7615
2935,20200302,수인분당선,숭의,3064,2785,5849
2936,20200302,수인분당선,신포,1172,1233,2405
2937,20200302,수인분당선,인천,589,972,1561
2938,20200303,수인분당선,선릉,10422,16188,26610
2939,20200303,수인분당선,한티,9361,9987,19348
2940,20200303,수인분당선,도곡,4527,4554,9081
2941,20200303,수인분당선,구룡,952,948,1900
2942,20200303,수인분당선,개포동,2281,2459,4740
2943,20200303,수인분당선,대모산입구,2497,2371,4868
2944,20200303,수인분당선,수서,8335,8677,17012
2945,20200303,수인분당선,수원,5156,3652,8808
2946,20200303,수인분당선,서울숲,6865,7041,13906
2947,20200303,수인분당선,압구정로데오,12475,13862,26337
2948,20200303,수인분당선,강남구청,7207,8212,15419
2949,20200303,수인분당선,선정릉,6355,6874,13229
2950,20200303,수인분당선,가천대,4662,5727,10389
2951,20200303,수인분당선,태평,10680,10271,20951
2952,20200303,수인분당선,모란,15215,15271,30486
2953,20200303,수인분당선,야탑,18581,19366,37947
2954,20200303,수인분당선,서현,18019,17518,35537
2955,20200303,수인분당선,수내,8975,8999,17974
2956,20200303,수인분당선,정자,11280,11894,23174
2957,20200303,수인분당선,미금,10928,11723,22651
2958,20200303,수인분당선,오리,8904,7475,16379
2959,20200303,수인분당선,이매,3522,3481,7003
2960,20200303,수인분당선,보정,1562,1357,2919
2961,20200303,수인분당선,죽전,8851,9513,18364
2962,20200303,수인분당선,구성,3188,3233,6421
2963,20200303,수인분당선,신갈,3054,2918,5972
2964,20200303,수인분당선,기흥,6503,6271,12774
2965,20200303,수인분당선,상갈,3599,3405,7004
2966,20200303,수인분당선,청명,2708,2627,5335
2967,20200303,수인분당선,영통,5182,5237,10419
2968,20200303,수인분당선,망포,9235,8834,18069
2969,20200303,수인분당선,매탄권선,3081,2912,5993
2970,20200303,수인분당선,수원시청,7613,8380,15993
2971,20200303,수인분당선,매교,1531,1544,3075
2972,20200303,수인분당선,달월,68,44,112
2973,20200303,수인분당선,월곶,1699,1585,3284
2974,20200303,수인분당선,소래포구,2925,2738,5663
2975,20200303,수인분당선,인천논현,4255,4467,8722
2976,20200303,수인분당선,호구포,2963,2974,5937
2977,20200303,수인분당선,남동인더스파크,2059,2276,4335
2978,20200303,수인분당선,원인재,3194,3212,6406
2979,20200303,수인분당선,연수,3220,3300,6520
2980,20200303,수인분당선,송도,1883,1790,3673
2981,20200303,수인분당선,인하대,3836,3662,7498
2982,20200303,수인분당선,숭의,2904,2747,5651
2983,20200303,수인분당선,신포,1208,1253,2461
2984,20200303,수인분당선,인천,576,967,1543
2985,20200304,수인분당선,선릉,10380,16231,26611
2986,20200304,수인분당선,한티,9332,10020,19352
2987,20200304,수인분당선,도곡,4553,4677,9230
2988,20200304,수인분당선,구룡,984,986,1970
2989,20200304,수인분당선,개포동,2324,2483,4807
2990,20200304,수인분당선,대모산입구,2546,2402,4948
2991,20200304,수인분당선,수서,8532,8798,17330
2992,20200304,수인분당선,수원,5271,3676,8947
2993,20200304,수인분당선,서울숲,6932,6931,13863
2994,20200304,수인분당선,압구정로데오,12152,13771,25923
2995,20200304,수인분당선,강남구청,7125,8323,15448
2996,20200304,수인분당선,선정릉,6251,6773,13024
2997,20200304,수인분당선,가천대,4551,5379,9930
2998,20200304,수인분당선,태평,10742,10567,21309
2999,20200304,수인분당선,모란,16436,16737,33173
3000,20200304,수인분당선,야탑,18603,19562,38165
3001,20200304,수인분당선,서현,18277,18402,36679
3002,20200304,수인분당선,수내,9049,9140,18189
3003,20200304,수인분당선,정자,11331,12093,23424
3004,20200304,수인분당선,미금,11165,12044,23209
3005,20200304,수인분당선,오리,8855,7532,16387
3006,20200304,수인분당선,이매,3495,3402,6897
3007,20200304,수인분당선,보정,1584,1333,2917
3008,20200304,수인분당선,죽전,8800,9487,18287
3009,20200304,수인분당선,구성,3191,3284,6475
3010,20200304,수인분당선,신갈,2976,2905,5881
3011,20200304,수인분당선,기흥,6553,6213,12766
3012,20200304,수인분당선,상갈,3572,3379,6951
3013,20200304,수인분당선,청명,2798,2553,5351
3014,20200304,수인분당선,영통,5239,5390,10629
3015,20200304,수인분당선,망포,9178,8817,17995
3016,20200304,수인분당선,매탄권선,2963,2924,5887
3017,20200304,수인분당선,수원시청,7771,8384,16155
3018,20200304,수인분당선,매교,1462,1501,2963
3019,20200304,수인분당선,달월,71,47,118
3020,20200304,수인분당선,월곶,1693,1597,3290
3021,20200304,수인분당선,소래포구,2847,2593,5440
3022,20200304,수인분당선,인천논현,4168,4366,8534
3023,20200304,수인분당선,호구포,2886,3011,5897
3024,20200304,수인분당선,남동인더스파크,2080,2302,4382
3025,20200304,수인분당선,원인재,3106,3109,6215
3026,20200304,수인분당선,연수,3228,3263,6491
3027,20200304,수인분당선,송도,1872,1696,3568
3028,20200304,수인분당선,인하대,3808,3584,7392
3029,20200304,수인분당선,숭의,2902,2690,5592
3030,20200304,수인분당선,신포,1141,1251,2392
3031,20200304,수인분당선,인천,583,998,1581
3032,20200305,수인분당선,선릉,10635,16259,26894
3033,20200305,수인분당선,한티,9381,9941,19322
3034,20200305,수인분당선,도곡,4552,4667,9219
3035,20200305,수인분당선,구룡,955,964,1919
3036,20200305,수인분당선,개포동,2319,2454,4773
3037,20200305,수인분당선,대모산입구,2481,2354,4835
3038,20200305,수인분당선,수서,8554,8907,17461
3039,20200305,수인분당선,수원,5305,3683,8988
3040,20200305,수인분당선,서울숲,6824,6863,13687
3041,20200305,수인분당선,압구정로데오,12438,14027,26465
3042,20200305,수인분당선,강남구청,7039,8272,15311
3043,20200305,수인분당선,선정릉,6386,6812,13198
3044,20200305,수인분당선,가천대,4538,5440,9978
3045,20200305,수인분당선,태평,10694,10432,21126
3046,20200305,수인분당선,모란,15332,15437,30769
3047,20200305,수인분당선,야탑,18282,19027,37309
3048,20200305,수인분당선,서현,18261,18470,36731
3049,20200305,수인분당선,수내,8816,8904,17720
3050,20200305,수인분당선,정자,11404,12072,23476
3051,20200305,수인분당선,미금,11020,11768,22788
3052,20200305,수인분당선,오리,8934,7730,16664
3053,20200305,수인분당선,이매,3565,3360,6925
3054,20200305,수인분당선,보정,1547,1341,2888
3055,20200305,수인분당선,죽전,8966,9457,18423
3056,20200305,수인분당선,구성,3211,3320,6531
3057,20200305,수인분당선,신갈,2994,2932,5926
3058,20200305,수인분당선,기흥,6620,6333,12953
3059,20200305,수인분당선,상갈,3637,3293,6930
3060,20200305,수인분당선,청명,2756,2637,5393
3061,20200305,수인분당선,영통,5253,5203,10456
3062,20200305,수인분당선,망포,9286,8837,18123
3063,20200305,수인분당선,매탄권선,3081,2906,5987
3064,20200305,수인분당선,수원시청,7555,8351,15906
3065,20200305,수인분당선,매교,1524,1552,3076
3066,20200305,수인분당선,달월,66,41,107
3067,20200305,수인분당선,월곶,1691,1600,3291
3068,20200305,수인분당선,소래포구,2873,2617,5490
3069,20200305,수인분당선,인천논현,4189,4437,8626
3070,20200305,수인분당선,호구포,2946,3023,5969
3071,20200305,수인분당선,남동인더스파크,2004,2256,4260
3072,20200305,수인분당선,원인재,3174,3207,6381
3073,20200305,수인분당선,연수,3226,3319,6545
3074,20200305,수인분당선,송도,1852,1690,3542
3075,20200305,수인분당선,인하대,3944,3696,7640
3076,20200305,수인분당선,숭의,2960,2758,5718
3077,20200305,수인분당선,신포,1185,1269,2454
3078,20200305,수인분당선,인천,569,973,1542
3079,20200306,수인분당선,선릉,10492,16398,26890
3080,20200306,수인분당선,한티,9876,10461,20337
3081,20200306,수인분당선,도곡,4699,4727,9426
3082,20200306,수인분당선,구룡,1041,991,2032
3083,20200306,수인분당선,개포동,2426,2535,4961
3084,20200306,수인분당선,대모산입구,2520,2353,4873
3085,20200306,수인분당선,수서,9818,10056,19874
3086,20200306,수인분당선,수원,5850,3925,9775
3087,20200306,수인분당선,서울숲,7012,6925,13937
3088,20200306,수인분당선,압구정로데오,13394,15570,28964
3089,20200306,수인분당선,강남구청,7373,8344,15717
3090,20200306,수인분당선,선정릉,6373,6848,13221
3091,20200306,수인분당선,가천대,4724,5436,10160
3092,20200306,수인분당선,태평,10899,10557,21456
3093,20200306,수인분당선,모란,15929,16160,32089
3094,20200306,수인분당선,야탑,18836,19654,38490
3095,20200306,수인분당선,서현,17555,17829,35384
3096,20200306,수인분당선,수내,9161,9239,18400
3097,20200306,수인분당선,정자,11815,12715,24530
3098,20200306,수인분당선,미금,11244,12051,23295
3099,20200306,수인분당선,오리,8995,7588,16583
3100,20200306,수인분당선,이매,3661,3427,7088
3101,20200306,수인분당선,보정,1626,1361,2987
3102,20200306,수인분당선,죽전,9712,9732,19444
3103,20200306,수인분당선,구성,3358,3384,6742
3104,20200306,수인분당선,신갈,3107,3065,6172
3105,20200306,수인분당선,기흥,6885,6391,13276
3106,20200306,수인분당선,상갈,3813,3444,7257
3107,20200306,수인분당선,청명,2907,2698,5605
3108,20200306,수인분당선,영통,5605,5795,11400
3109,20200306,수인분당선,망포,10107,9257,19364
3110,20200306,수인분당선,매탄권선,3231,3056,6287
3111,20200306,수인분당선,수원시청,8231,10022,18253
3112,20200306,수인분당선,매교,1631,1619,3250
3113,20200306,수인분당선,달월,62,45,107
3114,20200306,수인분당선,월곶,1827,1678,3505
3115,20200306,수인분당선,소래포구,3112,2856,5968
3116,20200306,수인분당선,인천논현,4469,4601,9070
3117,20200306,수인분당선,호구포,2958,3036,5994
3118,20200306,수인분당선,남동인더스파크,2005,2267,4272
3119,20200306,수인분당선,원인재,3254,3278,6532
3120,20200306,수인분당선,연수,3382,3517,6899
3121,20200306,수인분당선,송도,1997,1749,3746
3122,20200306,수인분당선,인하대,3994,3722,7716
3123,20200306,수인분당선,숭의,2959,2705,5664
3124,20200306,수인분당선,신포,1230,1346,2576
3125,20200306,수인분당선,인천,626,1002,1628
3126,20200307,수인분당선,선릉,3144,5094,8238
3127,20200307,수인분당선,한티,6258,6297,12555
3128,20200307,수인분당선,도곡,2571,2417,4988
3129,20200307,수인분당선,구룡,616,618,1234
3130,20200307,수인분당선,개포동,1386,1339,2725
3131,20200307,수인분당선,대모산입구,1444,1332,2776
3132,20200307,수인분당선,수서,4899,5011,9910
3133,20200307,수인분당선,수원,3868,2615,6483
3134,20200307,수인분당선,서울숲,3828,3937,7765
3135,20200307,수인분당선,압구정로데오,9709,11270,20979
3136,20200307,수인분당선,강남구청,3085,3676,6761
3137,20200307,수인분당선,선정릉,2254,2314,4568
3138,20200307,수인분당선,가천대,2870,3183,6053
3139,20200307,수인분당선,태평,7163,6888,14051
3140,20200307,수인분당선,모란,10199,10473,20672
3141,20200307,수인분당선,야탑,9990,10299,20289
3142,20200307,수인분당선,서현,9886,10140,20026
3143,20200307,수인분당선,수내,5059,4799,9858
3144,20200307,수인분당선,정자,6300,6626,12926
3145,20200307,수인분당선,미금,6757,6826,13583
3146,20200307,수인분당선,오리,4806,4006,8812
3147,20200307,수인분당선,이매,2000,1967,3967
3148,20200307,수인분당선,보정,785,731,1516
3149,20200307,수인분당선,죽전,5605,6125,11730
3150,20200307,수인분당선,구성,1731,1888,3619
3151,20200307,수인분당선,신갈,1464,1488,2952
3152,20200307,수인분당선,기흥,3952,3778,7730
3153,20200307,수인분당선,상갈,2105,2113,4218
3154,20200307,수인분당선,청명,1440,1389,2829
3155,20200307,수인분당선,영통,3576,3536,7112
3156,20200307,수인분당선,망포,5153,4593,9746
3157,20200307,수인분당선,매탄권선,1923,1720,3643
3158,20200307,수인분당선,수원시청,5883,7033,12916
3159,20200307,수인분당선,매교,860,941,1801
3160,20200307,수인분당선,달월,32,20,52
3161,20200307,수인분당선,월곶,1314,1239,2553
3162,20200307,수인분당선,소래포구,2431,2543,4974
3163,20200307,수인분당선,인천논현,3039,3179,6218
3164,20200307,수인분당선,호구포,1599,1545,3144
3165,20200307,수인분당선,남동인더스파크,758,731,1489
3166,20200307,수인분당선,원인재,2400,2436,4836
3167,20200307,수인분당선,연수,2628,2741,5369
3168,20200307,수인분당선,송도,1399,1319,2718
3169,20200307,수인분당선,인하대,2471,2320,4791
3170,20200307,수인분당선,숭의,1786,1663,3449
3171,20200307,수인분당선,신포,882,967,1849
3172,20200307,수인분당선,인천,508,790,1298
3173,20200308,수인분당선,선릉,1614,2490,4104
3174,20200308,수인분당선,한티,4112,4143,8255
3175,20200308,수인분당선,도곡,1287,1356,2643
3176,20200308,수인분당선,구룡,360,387,747
3177,20200308,수인분당선,개포동,972,937,1909
3178,20200308,수인분당선,대모산입구,844,776,1620
3179,20200308,수인분당선,수서,3967,4026,7993
3180,20200308,수인분당선,수원,2738,1704,4442
3181,20200308,수인분당선,서울숲,3087,3149,6236
3182,20200308,수인분당선,압구정로데오,5524,6163,11687
3183,20200308,수인분당선,강남구청,1777,2006,3783
3184,20200308,수인분당선,선정릉,1244,1395,2639
3185,20200308,수인분당선,가천대,1943,2316,4259
3186,20200308,수인분당선,태평,4923,4654,9577
3187,20200308,수인분당선,모란,6855,6902,13757
3188,20200308,수인분당선,야탑,6971,7251,14222
3189,20200308,수인분당선,서현,6867,6801,13668
3190,20200308,수인분당선,수내,3376,3326,6702
3191,20200308,수인분당선,정자,4254,4389,8643
3192,20200308,수인분당선,미금,4109,4331,8440
3193,20200308,수인분당선,오리,3231,2846,6077
3194,20200308,수인분당선,이매,1350,1357,2707
3195,20200308,수인분당선,보정,511,512,1023
3196,20200308,수인분당선,죽전,4106,4586,8692
3197,20200308,수인분당선,구성,1177,1277,2454
3198,20200308,수인분당선,신갈,1040,1031,2071
3199,20200308,수인분당선,기흥,2730,2667,5397
3200,20200308,수인분당선,상갈,1587,1569,3156
3201,20200308,수인분당선,청명,955,935,1890
3202,20200308,수인분당선,영통,2366,2337,4703
3203,20200308,수인분당선,망포,3335,3501,6836
3204,20200308,수인분당선,매탄권선,1271,1185,2456
3205,20200308,수인분당선,수원시청,3782,3935,7717
3206,20200308,수인분당선,매교,593,604,1197
3207,20200308,수인분당선,달월,26,31,57
3208,20200308,수인분당선,월곶,972,901,1873
3209,20200308,수인분당선,소래포구,2206,2107,4313
3210,20200308,수인분당선,인천논현,2005,2063,4068
3211,20200308,수인분당선,호구포,1064,1060,2124
3212,20200308,수인분당선,남동인더스파크,352,362,714
3213,20200308,수인분당선,원인재,1675,1666,3341
3214,20200308,수인분당선,연수,1928,1907,3835
3215,20200308,수인분당선,송도,1058,1009,2067
3216,20200308,수인분당선,인하대,1782,1721,3503
3217,20200308,수인분당선,숭의,1200,1131,2331
3218,20200308,수인분당선,신포,650,661,1311
3219,20200308,수인분당선,인천,453,666,1119
3220,20200309,수인분당선,선릉,11336,17723,29059
3221,20200309,수인분당선,한티,9436,10012,19448
3222,20200309,수인분당선,도곡,4971,5079,10050
3223,20200309,수인분당선,구룡,992,991,1983
3224,20200309,수인분당선,개포동,2453,2615,5068
3225,20200309,수인분당선,대모산입구,2695,2521,5216
3226,20200309,수인분당선,수서,9558,9766,19324
3227,20200309,수인분당선,수원,5807,3933,9740
3228,20200309,수인분당선,서울숲,7044,7301,14345
3229,20200309,수인분당선,압구정로데오,12066,13521,25587
3230,20200309,수인분당선,강남구청,7416,8562,15978
3231,20200309,수인분당선,선정릉,6792,7371,14163
3232,20200309,수인분당선,가천대,4999,5810,10809
3233,20200309,수인분당선,태평,10974,10746,21720
3234,20200309,수인분당선,모란,17511,17860,35371
3235,20200309,수인분당선,야탑,18987,20011,38998
3236,20200309,수인분당선,서현,17393,17375,34768
3237,20200309,수인분당선,수내,9300,9318,18618
3238,20200309,수인분당선,정자,11709,12587,24296
3239,20200309,수인분당선,미금,11430,12299,23729
3240,20200309,수인분당선,오리,9136,7784,16920
3241,20200309,수인분당선,이매,3714,3532,7246
3242,20200309,수인분당선,보정,1741,1452,3193
3243,20200309,수인분당선,죽전,9450,10197,19647
3244,20200309,수인분당선,구성,3480,3623,7103
3245,20200309,수인분당선,신갈,3256,3182,6438
3246,20200309,수인분당선,기흥,6988,6665,13653
3247,20200309,수인분당선,상갈,3867,3608,7475
3248,20200309,수인분당선,청명,2945,2741,5686
3249,20200309,수인분당선,영통,5516,5744,11260
3250,20200309,수인분당선,망포,9932,9542,19474
3251,20200309,수인분당선,매탄권선,3307,3056,6363
3252,20200309,수인분당선,수원시청,8086,8763,16849
3253,20200309,수인분당선,매교,1764,1734,3498
3254,20200309,수인분당선,달월,84,59,143
3255,20200309,수인분당선,월곶,1740,1708,3448
3256,20200309,수인분당선,소래포구,3058,2822,5880
3257,20200309,수인분당선,인천논현,4477,4627,9104
3258,20200309,수인분당선,호구포,2925,3016,5941
3259,20200309,수인분당선,남동인더스파크,1987,2271,4258
3260,20200309,수인분당선,원인재,3353,3389,6742
3261,20200309,수인분당선,연수,3414,3443,6857
3262,20200309,수인분당선,송도,2007,1801,3808
3263,20200309,수인분당선,인하대,4099,3899,7998
3264,20200309,수인분당선,숭의,3010,2763,5773
3265,20200309,수인분당선,신포,1255,1284,2539
3266,20200309,수인분당선,인천,615,1062,1677
3267,20200310,수인분당선,선릉,11138,17210,28348
3268,20200310,수인분당선,한티,9366,9999,19365
3269,20200310,수인분당선,도곡,4631,4763,9394
3270,20200310,수인분당선,구룡,936,955,1891
3271,20200310,수인분당선,개포동,2341,2498,4839
3272,20200310,수인분당선,대모산입구,2511,2308,4819
3273,20200310,수인분당선,수서,8948,9104,18052
3274,20200310,수인분당선,복정,1,0,1
3275,20200310,수인분당선,수원,5450,3749,9199
3276,20200310,수인분당선,서울숲,6743,6839,13582
3277,20200310,수인분당선,압구정로데오,12704,14208,26912
3278,20200310,수인분당선,강남구청,7465,8629,16094
3279,20200310,수인분당선,선정릉,6914,7320,14234
3280,20200310,수인분당선,가천대,4604,5552,10156
3281,20200310,수인분당선,태평,10562,10277,20839
3282,20200310,수인분당선,모란,14943,14894,29837
3283,20200310,수인분당선,야탑,18468,19269,37737
3284,20200310,수인분당선,서현,16801,16847,33648
3285,20200310,수인분당선,수내,9035,9200,18235
3286,20200310,수인분당선,정자,11482,12297,23779
3287,20200310,수인분당선,미금,10818,11609,22427
3288,20200310,수인분당선,오리,8849,7390,16239
3289,20200310,수인분당선,이매,3505,3361,6866
3290,20200310,수인분당선,보정,1621,1338,2959
3291,20200310,수인분당선,죽전,9002,9781,18783
3292,20200310,수인분당선,구성,3317,3370,6687
3293,20200310,수인분당선,신갈,3148,3082,6230
3294,20200310,수인분당선,기흥,6723,6422,13145
3295,20200310,수인분당선,상갈,3742,3472,7214
3296,20200310,수인분당선,청명,2797,2617,5414
3297,20200310,수인분당선,영통,5153,5329,10482
3298,20200310,수인분당선,망포,9719,9363,19082
3299,20200310,수인분당선,매탄권선,3053,2935,5988
3300,20200310,수인분당선,수원시청,7817,8561,16378
3301,20200310,수인분당선,매교,1608,1581,3189
3302,20200310,수인분당선,달월,68,40,108
3303,20200310,수인분당선,월곶,1621,1567,3188
3304,20200310,수인분당선,소래포구,2743,2556,5299
3305,20200310,수인분당선,인천논현,4154,4290,8444
3306,20200310,수인분당선,호구포,2877,2883,5760
3307,20200310,수인분당선,남동인더스파크,2020,2249,4269
3308,20200310,수인분당선,원인재,3112,3123,6235
3309,20200310,수인분당선,연수,3128,3213,6341
3310,20200310,수인분당선,송도,1637,1470,3107
3311,20200310,수인분당선,인하대,3668,3498,7166
3312,20200310,수인분당선,숭의,2783,2554,5337
3313,20200310,수인분당선,신포,1057,1145,2202
3314,20200310,수인분당선,인천,535,942,1477
3315,20200311,수인분당선,선릉,11150,17361,28511
3316,20200311,수인분당선,한티,9492,10135,19627
3317,20200311,수인분당선,도곡,4671,4745,9416
3318,20200311,수인분당선,구룡,998,1008,2006
3319,20200311,수인분당선,개포동,2452,2661,5113
3320,20200311,수인분당선,대모산입구,2580,2421,5001
3321,20200311,수인분당선,수서,9155,9392,18547
3322,20200311,수인분당선,수원,5782,3998,9780
3323,20200311,수인분당선,서울숲,7303,7506,14809
3324,20200311,수인분당선,압구정로데오,13051,14561,27612
3325,20200311,수인분당선,강남구청,7667,9044,16711
3326,20200311,수인분당선,선정릉,6827,7397,14224
3327,20200311,수인분당선,가천대,4850,5819,10669
3328,20200311,수인분당선,태평,11152,10705,21857
3329,20200311,수인분당선,모란,15761,16022,31783
3330,20200311,수인분당선,야탑,19252,20132,39384
3331,20200311,수인분당선,서현,17852,17827,35679
3332,20200311,수인분당선,수내,9459,9521,18980
3333,20200311,수인분당선,정자,11947,12876,24823
3334,20200311,수인분당선,미금,11641,12499,24140
3335,20200311,수인분당선,오리,9309,7905,17214
3336,20200311,수인분당선,이매,3544,3436,6980
3337,20200311,수인분당선,보정,1710,1394,3104
3338,20200311,수인분당선,죽전,9681,10341,20022
3339,20200311,수인분당선,구성,3476,3550,7026
3340,20200311,수인분당선,신갈,3264,3170,6434
3341,20200311,수인분당선,기흥,7037,6676,13713
3342,20200311,수인분당선,상갈,3980,3626,7606
3343,20200311,수인분당선,청명,2913,2740,5653
3344,20200311,수인분당선,영통,5575,5733,11308
3345,20200311,수인분당선,망포,10094,9562,19656
3346,20200311,수인분당선,매탄권선,3186,3027,6213
3347,20200311,수인분당선,수원시청,8278,9236,17514
3348,20200311,수인분당선,매교,1619,1639,3258
3349,20200311,수인분당선,달월,63,43,106
3350,20200311,수인분당선,월곶,1799,1704,3503
3351,20200311,수인분당선,소래포구,2843,2681,5524
3352,20200311,수인분당선,인천논현,4363,4543,8906
3353,20200311,수인분당선,호구포,2943,2976,5919
3354,20200311,수인분당선,남동인더스파크,2007,2243,4250
3355,20200311,수인분당선,원인재,3229,3294,6523
3356,20200311,수인분당선,연수,3294,3350,6644
3357,20200311,수인분당선,송도,1871,1691,3562
3358,20200311,수인분당선,인하대,3788,3585,7373
3359,20200311,수인분당선,숭의,2886,2616,5502
3360,20200311,수인분당선,신포,1246,1278,2524
3361,20200311,수인분당선,인천,567,966,1533
3362,20200312,수인분당선,선릉,10791,17068,27859
3363,20200312,수인분당선,한티,9347,9989,19336
3364,20200312,수인분당선,도곡,4629,4725,9354
3365,20200312,수인분당선,구룡,1062,1033,2095
3366,20200312,수인분당선,개포동,2424,2585,5009
3367,20200312,수인분당선,대모산입구,2509,2332,4841
3368,20200312,수인분당선,수서,9312,9413,18725
3369,20200312,수인분당선,복정,1,0,1
3370,20200312,수인분당선,수원,5781,3925,9706
3371,20200312,수인분당선,서울숲,7249,7378,14627
3372,20200312,수인분당선,압구정로데오,12803,14526,27329
3373,20200312,수인분당선,강남구청,7312,8473,15785
3374,20200312,수인분당선,선정릉,6650,7142,13792
3375,20200312,수인분당선,가천대,4771,5602,10373
3376,20200312,수인분당선,태평,10954,10693,21647
3377,20200312,수인분당선,모란,15572,15748,31320
3378,20200312,수인분당선,야탑,18745,19714,38459
3379,20200312,수인분당선,서현,17350,17563,34913
3380,20200312,수인분당선,수내,9139,9204,18343
3381,20200312,수인분당선,정자,11811,12772,24583
3382,20200312,수인분당선,미금,11283,12147,23430
3383,20200312,수인분당선,오리,9220,7613,16833
3384,20200312,수인분당선,이매,3582,3417,6999
3385,20200312,수인분당선,보정,1694,1383,3077
3386,20200312,수인분당선,죽전,9600,10541,20141
3387,20200312,수인분당선,구성,3382,3479,6861
3388,20200312,수인분당선,신갈,3091,3017,6108
3389,20200312,수인분당선,기흥,6957,6574,13531
3390,20200312,수인분당선,상갈,3853,3593,7446
3391,20200312,수인분당선,청명,2901,2682,5583
3392,20200312,수인분당선,영통,5650,5782,11432
3393,20200312,수인분당선,망포,9858,9418,19276
3394,20200312,수인분당선,매탄권선,3273,3059,6332
3395,20200312,수인분당선,수원시청,8254,9125,17379
3396,20200312,수인분당선,매교,1588,1619,3207
3397,20200312,수인분당선,달월,79,51,130
3398,20200312,수인분당선,월곶,1725,1648,3373
3399,20200312,수인분당선,소래포구,2875,2631,5506
3400,20200312,수인분당선,인천논현,4230,4408,8638
3401,20200312,수인분당선,호구포,2857,2981,5838
3402,20200312,수인분당선,남동인더스파크,1945,2258,4203
3403,20200312,수인분당선,원인재,3220,3288,6508
3404,20200312,수인분당선,연수,3242,3266,6508
3405,20200312,수인분당선,송도,1850,1613,3463
3406,20200312,수인분당선,인하대,3888,3658,7546
3407,20200312,수인분당선,숭의,2869,2640,5509
3408,20200312,수인분당선,신포,1153,1210,2363
3409,20200312,수인분당선,인천,618,1017,1635
3410,20200313,수인분당선,선릉,10844,17039,27883
3411,20200313,수인분당선,한티,9934,10426,20360
3412,20200313,수인분당선,도곡,4805,4821,9626
3413,20200313,수인분당선,구룡,1041,1022,2063
3414,20200313,수인분당선,개포동,2457,2609,5066
3415,20200313,수인분당선,대모산입구,2634,2376,5010
3416,20200313,수인분당선,수서,10227,10562,20789
3417,20200313,수인분당선,수원,6390,4427,10817
3418,20200313,수인분당선,서울숲,7258,7295,14553
3419,20200313,수인분당선,압구정로데오,13821,16076,29897
3420,20200313,수인분당선,강남구청,7644,8757,16401
3421,20200313,수인분당선,선정릉,6722,7282,14004
3422,20200313,수인분당선,가천대,4983,5558,10541
3423,20200313,수인분당선,태평,11273,10814,22087
3424,20200313,수인분당선,모란,16327,16609,32936
3425,20200313,수인분당선,야탑,19966,20927,40893
3426,20200313,수인분당선,서현,18569,18986,37555
3427,20200313,수인분당선,수내,9748,9696,19444
3428,20200313,수인분당선,정자,12421,13335,25756
3429,20200313,수인분당선,미금,11748,12594,24342
3430,20200313,수인분당선,오리,9280,7830,17110
3431,20200313,수인분당선,이매,3724,3515,7239
3432,20200313,수인분당선,보정,1718,1399,3117
3433,20200313,수인분당선,죽전,10374,10739,21113
3434,20200313,수인분당선,구성,3507,3495,7002
3435,20200313,수인분당선,신갈,3314,3245,6559
3436,20200313,수인분당선,기흥,7228,6858,14086
3437,20200313,수인분당선,상갈,4189,3725,7914
3438,20200313,수인분당선,청명,3078,2845,5923
3439,20200313,수인분당선,영통,6057,6235,12292
3440,20200313,수인분당선,망포,10961,9949,20910
3441,20200313,수인분당선,매탄권선,3493,3207,6700
3442,20200313,수인분당선,수원시청,8805,11049,19854
3443,20200313,수인분당선,매교,1692,1694,3386
3444,20200313,수인분당선,달월,69,49,118
3445,20200313,수인분당선,월곶,1767,1649,3416
3446,20200313,수인분당선,소래포구,3009,2824,5833
3447,20200313,수인분당선,인천논현,4406,4667,9073
3448,20200313,수인분당선,호구포,2870,2887,5757
3449,20200313,수인분당선,남동인더스파크,1970,2179,4149
3450,20200313,수인분당선,원인재,3295,3323,6618
3451,20200313,수인분당선,연수,3354,3502,6856
3452,20200313,수인분당선,송도,1867,1600,3467
3453,20200313,수인분당선,인하대,3927,3697,7624
3454,20200313,수인분당선,숭의,2951,2662,5613
3455,20200313,수인분당선,신포,1191,1269,2460
3456,20200313,수인분당선,인천,599,980,1579
3457,20200314,수인분당선,선릉,3466,5423,8889
3458,20200314,수인분당선,한티,6558,6531,13089
3459,20200314,수인분당선,도곡,2545,2423,4968
3460,20200314,수인분당선,구룡,666,626,1292
3461,20200314,수인분당선,개포동,1502,1511,3013
3462,20200314,수인분당선,대모산입구,1590,1440,3030
3463,20200314,수인분당선,수서,5290,5614,10904
3464,20200314,수인분당선,수원,4385,2987,7372
3465,20200314,수인분당선,서울숲,4377,4497,8874
3466,20200314,수인분당선,압구정로데오,10125,11710,21835
3467,20200314,수인분당선,강남구청,3212,3929,7141
3468,20200314,수인분당선,선정릉,2464,2566,5030
3469,20200314,수인분당선,가천대,3083,3382,6465
3470,20200314,수인분당선,태평,7889,7433,15322
3471,20200314,수인분당선,모란,13664,14214,27878
3472,20200314,수인분당선,야탑,11186,11818,23004
3473,20200314,수인분당선,서현,11626,11791,23417
3474,20200314,수인분당선,수내,5508,5180,10688
3475,20200314,수인분당선,정자,7023,7079,14102
3476,20200314,수인분당선,미금,7463,7610,15073
3477,20200314,수인분당선,오리,5153,4400,9553
3478,20200314,수인분당선,이매,2197,2213,4410
3479,20200314,수인분당선,보정,907,851,1758
3480,20200314,수인분당선,죽전,6425,7280,13705
3481,20200314,수인분당선,구성,1922,1963,3885
3482,20200314,수인분당선,신갈,1684,1695,3379
3483,20200314,수인분당선,기흥,4331,4129,8460
3484,20200314,수인분당선,상갈,2457,2371,4828
3485,20200314,수인분당선,청명,1558,1447,3005
3486,20200314,수인분당선,영통,4259,4184,8443
3487,20200314,수인분당선,망포,5920,5291,11211
3488,20200314,수인분당선,매탄권선,2048,1860,3908
3489,20200314,수인분당선,수원시청,6620,7912,14532
3490,20200314,수인분당선,매교,1108,1132,2240
3491,20200314,수인분당선,달월,35,33,68
3492,20200314,수인분당선,월곶,1350,1279,2629
3493,20200314,수인분당선,소래포구,2619,2634,5253
3494,20200314,수인분당선,인천논현,3205,3302,6507
3495,20200314,수인분당선,호구포,1676,1631,3307
3496,20200314,수인분당선,남동인더스파크,733,722,1455
3497,20200314,수인분당선,원인재,2567,2538,5105
3498,20200314,수인분당선,연수,2600,2682,5282
3499,20200314,수인분당선,송도,1333,1257,2590
3500,20200314,수인분당선,인하대,2552,2336,4888
3501,20200314,수인분당선,숭의,1824,1690,3514
3502,20200314,수인분당선,신포,827,972,1799
3503,20200314,수인분당선,인천,564,912,1476
3504,20200315,수인분당선,선릉,1598,2534,4132
3505,20200315,수인분당선,한티,4490,4491,8981
3506,20200315,수인분당선,도곡,1381,1420,2801
3507,20200315,수인분당선,구룡,351,408,759
3508,20200315,수인분당선,개포동,905,927,1832
3509,20200315,수인분당선,대모산입구,823,802,1625
3510,20200315,수인분당선,수서,4321,4290,8611
3511,20200315,수인분당선,수원,2903,1928,4831
3512,20200315,수인분당선,서울숲,2496,2538,5034
3513,20200315,수인분당선,압구정로데오,5521,6071,11592
3514,20200315,수인분당선,강남구청,1771,2134,3905
3515,20200315,수인분당선,선정릉,1310,1417,2727
3516,20200315,수인분당선,가천대,2013,2587,4600
3517,20200315,수인분당선,태평,5008,4758,9766
3518,20200315,수인분당선,모란,7081,7308,14389
3519,20200315,수인분당선,야탑,7730,7837,15567
3520,20200315,수인분당선,서현,7691,7556,15247
3521,20200315,수인분당선,수내,3706,3554,7260
3522,20200315,수인분당선,정자,4430,4587,9017
3523,20200315,수인분당선,미금,4286,4485,8771
3524,20200315,수인분당선,오리,3437,3008,6445
3525,20200315,수인분당선,이매,1425,1468,2893
3526,20200315,수인분당선,보정,589,560,1149
3527,20200315,수인분당선,죽전,4560,5368,9928
3528,20200315,수인분당선,구성,1245,1350,2595
3529,20200315,수인분당선,신갈,1028,1071,2099
3530,20200315,수인분당선,기흥,2922,2867,5789
3531,20200315,수인분당선,상갈,1569,1734,3303
3532,20200315,수인분당선,청명,1101,1008,2109
3533,20200315,수인분당선,영통,2774,2731,5505
3534,20200315,수인분당선,망포,3583,3752,7335
3535,20200315,수인분당선,매탄권선,1361,1296,2657
3536,20200315,수인분당선,수원시청,4215,4091,8306
3537,20200315,수인분당선,매교,660,632,1292
3538,20200315,수인분당선,달월,20,17,37
3539,20200315,수인분당선,월곶,945,898,1843
3540,20200315,수인분당선,소래포구,1953,1887,3840
3541,20200315,수인분당선,인천논현,1753,1884,3637
3542,20200315,수인분당선,호구포,967,980,1947
3543,20200315,수인분당선,남동인더스파크,332,340,672
3544,20200315,수인분당선,원인재,1538,1591,3129
3545,20200315,수인분당선,연수,1869,1795,3664
3546,20200315,수인분당선,송도,975,966,1941
3547,20200315,수인분당선,인하대,1674,1524,3198
3548,20200315,수인분당선,숭의,1136,1083,2219
3549,20200315,수인분당선,신포,603,622,1225
3550,20200315,수인분당선,인천,444,591,1035
3551,20200316,수인분당선,선릉,11331,17748,29079
3552,20200316,수인분당선,한티,9609,10207,19816
3553,20200316,수인분당선,도곡,4717,4950,9667
3554,20200316,수인분당선,구룡,1035,1032,2067
3555,20200316,수인분당선,개포동,2427,2614,5041
3556,20200316,수인분당선,대모산입구,2661,2474,5135
3557,20200316,수인분당선,수서,9592,9712,19304
3558,20200316,수인분당선,수원,5792,4137,9929
3559,20200316,수인분당선,서울숲,6966,7012,13978
3560,20200316,수인분당선,압구정로데오,12442,13722,26164
3561,20200316,수인분당선,강남구청,7392,8584,15976
3562,20200316,수인분당선,선정릉,6919,7449,14368
3563,20200316,수인분당선,가천대,4846,5650,10496
3564,20200316,수인분당선,태평,10821,10623,21444
3565,20200316,수인분당선,모란,15396,15629,31025
3566,20200316,수인분당선,야탑,19297,19978,39275
3567,20200316,수인분당선,서현,17381,17378,34759
3568,20200316,수인분당선,수내,9590,9547,19137
3569,20200316,수인분당선,정자,11818,12654,24472
3570,20200316,수인분당선,미금,11630,12579,24209
3571,20200316,수인분당선,오리,9001,7782,16783
3572,20200316,수인분당선,이매,3685,3515,7200
3573,20200316,수인분당선,보정,1755,1394,3149
3574,20200316,수인분당선,죽전,8880,9582,18462
3575,20200316,수인분당선,구성,3493,3583,7076
3576,20200316,수인분당선,신갈,3284,3205,6489
3577,20200316,수인분당선,기흥,6990,6704,13694
3578,20200316,수인분당선,상갈,3981,3702,7683
3579,20200316,수인분당선,청명,2996,2747,5743
3580,20200316,수인분당선,영통,5608,5763,11371
3581,20200316,수인분당선,망포,10204,9697,19901
3582,20200316,수인분당선,매탄권선,3242,3126,6368
3583,20200316,수인분당선,수원시청,8362,8960,17322
3584,20200316,수인분당선,매교,1722,1735,3457
3585,20200316,수인분당선,달월,78,56,134
3586,20200316,수인분당선,월곶,1806,1718,3524
3587,20200316,수인분당선,소래포구,2966,2751,5717
3588,20200316,수인분당선,인천논현,4197,4271,8468
3589,20200316,수인분당선,호구포,2855,2905,5760
3590,20200316,수인분당선,남동인더스파크,1964,2224,4188
3591,20200316,수인분당선,원인재,3207,3216,6423
3592,20200316,수인분당선,연수,3340,3359,6699
3593,20200316,수인분당선,송도,1871,1720,3591
3594,20200316,수인분당선,인하대,4003,3816,7819
3595,20200316,수인분당선,숭의,2989,2709,5698
3596,20200316,수인분당선,신포,1166,1249,2415
3597,20200316,수인분당선,인천,615,1005,1620
3598,20200317,수인분당선,선릉,11241,17648,28889
3599,20200317,수인분당선,한티,9675,10298,19973
3600,20200317,수인분당선,도곡,4660,4814,9474
3601,20200317,수인분당선,구룡,1030,1084,2114
3602,20200317,수인분당선,개포동,2416,2575,4991
3603,20200317,수인분당선,대모산입구,2660,2475,5135
3604,20200317,수인분당선,수서,9157,9252,18409
3605,20200317,수인분당선,수원,5724,3908,9632
3606,20200317,수인분당선,서울숲,7032,7121,14153
3607,20200317,수인분당선,압구정로데오,13139,14674,27813
3608,20200317,수인분당선,강남구청,7542,8612,16154
3609,20200317,수인분당선,선정릉,6859,7459,14318
3610,20200317,수인분당선,가천대,4864,5649,10513
3611,20200317,수인분당선,태평,10774,10460,21234
3612,20200317,수인분당선,모란,15164,15211,30375
3613,20200317,수인분당선,야탑,18776,19536,38312
3614,20200317,수인분당선,서현,16893,17133,34026
3615,20200317,수인분당선,수내,9251,9392,18643
3616,20200317,수인분당선,정자,11914,12664,24578
3617,20200317,수인분당선,미금,11312,12198,23510
3618,20200317,수인분당선,오리,8901,7656,16557
3619,20200317,수인분당선,이매,3684,3498,7182
3620,20200317,수인분당선,보정,1681,1384,3065
3621,20200317,수인분당선,죽전,9492,10269,19761
3622,20200317,수인분당선,구성,3461,3532,6993
3623,20200317,수인분당선,신갈,3112,3058,6170
3624,20200317,수인분당선,기흥,6898,6558,13456
3625,20200317,수인분당선,상갈,4050,3758,7808
3626,20200317,수인분당선,청명,2872,2710,5582
3627,20200317,수인분당선,영통,5449,5728,11177
3628,20200317,수인분당선,망포,10138,9676,19814
3629,20200317,수인분당선,매탄권선,3267,3025,6292
3630,20200317,수인분당선,수원시청,8109,8969,17078
3631,20200317,수인분당선,매교,1690,1689,3379
3632,20200317,수인분당선,달월,76,57,133
3633,20200317,수인분당선,월곶,1736,1642,3378
3634,20200317,수인분당선,소래포구,2940,2720,5660
3635,20200317,수인분당선,인천논현,4019,4221,8240
3636,20200317,수인분당선,호구포,2806,2874,5680
3637,20200317,수인분당선,남동인더스파크,2041,2223,4264
3638,20200317,수인분당선,원인재,3176,3201,6377
3639,20200317,수인분당선,연수,3215,3279,6494
3640,20200317,수인분당선,송도,1746,1640,3386
3641,20200317,수인분당선,인하대,3915,3765,7680
3642,20200317,수인분당선,숭의,2975,2664,5639
3643,20200317,수인분당선,신포,1183,1226,2409
3644,20200317,수인분당선,인천,605,993,1598
3645,20200318,수인분당선,선릉,11338,17658,28996
3646,20200318,수인분당선,한티,9960,10567,20527
3647,20200318,수인분당선,도곡,4722,4800,9522
3648,20200318,수인분당선,구룡,993,1063,2056
3649,20200318,수인분당선,개포동,2516,2660,5176
3650,20200318,수인분당선,대모산입구,2692,2516,5208
3651,20200318,수인분당선,수서,9274,9435,18709
3652,20200318,수인분당선,수원,5998,4087,10085
3653,20200318,수인분당선,서울숲,7530,7503,15033
3654,20200318,수인분당선,압구정로데오,12967,14703,27670
3655,20200318,수인분당선,강남구청,7518,8826,16344
3656,20200318,수인분당선,선정릉,6888,7332,14220
3657,20200318,수인분당선,가천대,4971,5833,10804
3658,20200318,수인분당선,태평,10938,10492,21430
3659,20200318,수인분당선,모란,15676,15768,31444
3660,20200318,수인분당선,야탑,19012,20050,39062
3661,20200318,수인분당선,서현,17290,17502,34792
3662,20200318,수인분당선,수내,9510,9498,19008
3663,20200318,수인분당선,정자,12035,12835,24870
3664,20200318,수인분당선,미금,11606,12374,23980
3665,20200318,수인분당선,오리,9152,7814,16966
3666,20200318,수인분당선,이매,3769,3632,7401
3667,20200318,수인분당선,보정,1789,1509,3298
3668,20200318,수인분당선,죽전,9835,10573,20408
3669,20200318,수인분당선,구성,3544,3634,7178
3670,20200318,수인분당선,신갈,3364,3275,6639
3671,20200318,수인분당선,기흥,7106,6767,13873
3672,20200318,수인분당선,상갈,4058,3806,7864
3673,20200318,수인분당선,청명,3008,2858,5866
3674,20200318,수인분당선,영통,5865,5935,11800
3675,20200318,수인분당선,망포,10369,9817,20186
3676,20200318,수인분당선,매탄권선,3312,3185,6497
3677,20200318,수인분당선,수원시청,8610,9489,18099
3678,20200318,수인분당선,매교,1717,1764,3481
3679,20200318,수인분당선,달월,82,55,137
3680,20200318,수인분당선,월곶,1797,1670,3467
3681,20200318,수인분당선,소래포구,3206,3008,6214
3682,20200318,수인분당선,인천논현,4378,4502,8880
3683,20200318,수인분당선,호구포,2897,2960,5857
3684,20200318,수인분당선,남동인더스파크,2000,2233,4233
3685,20200318,수인분당선,원인재,3331,3442,6773
3686,20200318,수인분당선,연수,3375,3431,6806
3687,20200318,수인분당선,송도,1966,1769,3735
3688,20200318,수인분당선,인하대,4005,3858,7863
3689,20200318,수인분당선,숭의,2980,2785,5765
3690,20200318,수인분당선,신포,1202,1312,2514
3691,20200318,수인분당선,인천,659,1118,1777
3692,20200319,수인분당선,선릉,10888,17041,27929
3693,20200319,수인분당선,한티,9449,9943,19392
3694,20200319,수인분당선,도곡,4599,4691,9290
3695,20200319,수인분당선,구룡,954,986,1940
3696,20200319,수인분당선,개포동,2325,2495,4820
3697,20200319,수인분당선,대모산입구,2599,2437,5036
3698,20200319,수인분당선,수서,9307,9535,18842
3699,20200319,수인분당선,수원,5526,3750,9276
3700,20200319,수인분당선,서울숲,6817,6804,13621
3701,20200319,수인분당선,압구정로데오,12801,14302,27103
3702,20200319,수인분당선,강남구청,7356,8644,16000
3703,20200319,수인분당선,선정릉,6885,7441,14326
3704,20200319,수인분당선,가천대,4796,5684,10480
3705,20200319,수인분당선,태평,10610,10266,20876
3706,20200319,수인분당선,모란,16495,16789,33284
3707,20200319,수인분당선,야탑,18622,19268,37890
3708,20200319,수인분당선,서현,16433,16647,33080
3709,20200319,수인분당선,수내,9212,9310,18522
3710,20200319,수인분당선,정자,11538,12328,23866
3711,20200319,수인분당선,미금,10847,11727,22574
3712,20200319,수인분당선,오리,8774,7493,16267
3713,20200319,수인분당선,이매,3517,3352,6869
3714,20200319,수인분당선,보정,1706,1368,3074
3715,20200319,수인분당선,죽전,9299,10098,19397
3716,20200319,수인분당선,구성,3289,3392,6681
3717,20200319,수인분당선,신갈,3121,3047,6168
3718,20200319,수인분당선,기흥,6782,6399,13181
3719,20200319,수인분당선,상갈,3808,3578,7386
3720,20200319,수인분당선,청명,2840,2723,5563
3721,20200319,수인분당선,영통,5448,5536,10984
3722,20200319,수인분당선,망포,9823,9343,19166
3723,20200319,수인분당선,매탄권선,3185,3063,6248
3724,20200319,수인분당선,수원시청,8233,9024,17257
3725,20200319,수인분당선,매교,1604,1572,3176
3726,20200319,수인분당선,달월,62,41,103
3727,20200319,수인분당선,월곶,1691,1574,3265
3728,20200319,수인분당선,소래포구,2694,2470,5164
3729,20200319,수인분당선,인천논현,4065,4223,8288
3730,20200319,수인분당선,호구포,2773,2854,5627
3731,20200319,수인분당선,남동인더스파크,2018,2245,4263
3732,20200319,수인분당선,원인재,3157,3192,6349
3733,20200319,수인분당선,연수,3150,3206,6356
3734,20200319,수인분당선,송도,1726,1541,3267
3735,20200319,수인분당선,인하대,3700,3509,7209
3736,20200319,수인분당선,숭의,2758,2571,5329
3737,20200319,수인분당선,신포,1160,1183,2343
3738,20200319,수인분당선,인천,550,965,1515
3739,20200320,수인분당선,상갈,4190,3763,7953
3740,20200320,수인분당선,선릉,11049,17469,28518
3741,20200320,수인분당선,한티,10367,10879,21246
3742,20200320,수인분당선,도곡,5021,5008,10029
3743,20200320,수인분당선,구룡,1091,1064,2155
3744,20200320,수인분당선,개포동,2615,2772,5387
3745,20200320,수인분당선,대모산입구,2739,2518,5257
3746,20200320,수인분당선,수서,10757,11328,22085
3747,20200320,수인분당선,수원,6448,4310,10758
3748,20200320,수인분당선,서울숲,7582,7735,15317
3749,20200320,수인분당선,압구정로데오,14245,16757,31002
3750,20200320,수인분당선,강남구청,7893,9220,17113
3751,20200320,수인분당선,선정릉,6930,7464,14394
3752,20200320,수인분당선,가천대,5044,5642,10686
3753,20200320,수인분당선,태평,11392,10858,22250
3754,20200320,수인분당선,모란,16459,16725,33184
3755,20200320,수인분당선,야탑,19955,21003,40958
3756,20200320,수인분당선,서현,18406,18873,37279
3757,20200320,수인분당선,수내,9892,9872,19764
3758,20200320,수인분당선,정자,12479,13280,25759
3759,20200320,수인분당선,미금,12042,12751,24793
3760,20200320,수인분당선,오리,9440,7959,17399
3761,20200320,수인분당선,이매,3832,3720,7552
3762,20200320,수인분당선,보정,1810,1477,3287
3763,20200320,수인분당선,죽전,10713,11056,21769
3764,20200320,수인분당선,구성,3595,3782,7377
3765,20200320,수인분당선,신갈,3518,3341,6859
3766,20200320,수인분당선,기흥,7517,7129,14646
3767,20200320,수인분당선,청명,3235,2923,6158
3768,20200320,수인분당선,영통,6499,6679,13178
3769,20200320,수인분당선,망포,11603,10314,21917
3770,20200320,수인분당선,매탄권선,3685,3312,6997
3771,20200320,수인분당선,수원시청,9247,11475,20722
3772,20200320,수인분당선,매교,1770,1819,3589
3773,20200320,수인분당선,달월,85,68,153
3774,20200320,수인분당선,월곶,1878,1816,3694
3775,20200320,수인분당선,소래포구,3200,3047,6247
3776,20200320,수인분당선,인천논현,4538,4809,9347
3777,20200320,수인분당선,호구포,2964,3011,5975
3778,20200320,수인분당선,남동인더스파크,1992,2182,4174
3779,20200320,수인분당선,원인재,3440,3470,6910
3780,20200320,수인분당선,연수,3486,3583,7069
3781,20200320,수인분당선,송도,2013,1859,3872
3782,20200320,수인분당선,인하대,4253,3985,8238
3783,20200320,수인분당선,숭의,3077,2760,5837
3784,20200320,수인분당선,신포,1309,1410,2719
3785,20200320,수인분당선,인천,631,1072,1703
3786,20200321,수인분당선,선릉,3419,5449,8868
3787,20200321,수인분당선,한티,6807,6835,13642
3788,20200321,수인분당선,도곡,2536,2379,4915
3789,20200321,수인분당선,구룡,679,691,1370
3790,20200321,수인분당선,개포동,1538,1512,3050
3791,20200321,수인분당선,대모산입구,1606,1487,3093
3792,20200321,수인분당선,수서,5578,5682,11260
3793,20200321,수인분당선,수원,4509,2374,6883
3794,20200321,수인분당선,서울숲,5028,5454,10482
3795,20200321,수인분당선,압구정로데오,10451,12277,22728
3796,20200321,수인분당선,강남구청,3247,3983,7230
3797,20200321,수인분당선,선정릉,2478,2619,5097
3798,20200321,수인분당선,가천대,3000,3310,6310
3799,20200321,수인분당선,태평,7630,7181,14811
3800,20200321,수인분당선,모란,10869,11346,22215
3801,20200321,수인분당선,야탑,11060,11559,22619
3802,20200321,수인분당선,서현,10945,11211,22156
3803,20200321,수인분당선,수내,5616,5228,10844
3804,20200321,수인분당선,정자,6938,7101,14039
3805,20200321,수인분당선,미금,7236,7388,14624
3806,20200321,수인분당선,오리,5157,4267,9424
3807,20200321,수인분당선,이매,2387,2215,4602
3808,20200321,수인분당선,보정,945,888,1833
3809,20200321,수인분당선,죽전,6463,7429,13892
3810,20200321,수인분당선,구성,1963,2048,4011
3811,20200321,수인분당선,신갈,1772,1789,3561
3812,20200321,수인분당선,기흥,4488,4255,8743
3813,20200321,수인분당선,상갈,2540,2457,4997
3814,20200321,수인분당선,청명,1684,1562,3246
3815,20200321,수인분당선,영통,4319,4338,8657
3816,20200321,수인분당선,망포,6068,5310,11378
3817,20200321,수인분당선,매탄권선,2197,2010,4207
3818,20200321,수인분당선,수원시청,6449,8038,14487
3819,20200321,수인분당선,매교,1078,1123,2201
3820,20200321,수인분당선,달월,47,49,96
3821,20200321,수인분당선,월곶,1390,1329,2719
3822,20200321,수인분당선,소래포구,2866,2906,5772
3823,20200321,수인분당선,인천논현,3196,3259,6455
3824,20200321,수인분당선,호구포,1686,1648,3334
3825,20200321,수인분당선,남동인더스파크,706,705,1411
3826,20200321,수인분당선,원인재,2524,2572,5096
3827,20200321,수인분당선,연수,2666,2708,5374
3828,20200321,수인분당선,송도,1422,1289,2711
3829,20200321,수인분당선,인하대,2541,2413,4954
3830,20200321,수인분당선,숭의,1772,1625,3397
3831,20200321,수인분당선,신포,957,1074,2031
3832,20200321,수인분당선,인천,558,954,1512
3833,20200322,수인분당선,선릉,1736,2585,4321
3834,20200322,수인분당선,한티,4606,4609,9215
3835,20200322,수인분당선,도곡,1363,1350,2713
3836,20200322,수인분당선,구룡,378,379,757
3837,20200322,수인분당선,개포동,1047,1045,2092
3838,20200322,수인분당선,대모산입구,928,847,1775
3839,20200322,수인분당선,수서,4636,4671,9307
3840,20200322,수인분당선,수원,3062,1753,4815
3841,20200322,수인분당선,서울숲,3889,4165,8054
3842,20200322,수인분당선,압구정로데오,5772,6512,12284
3843,20200322,수인분당선,강남구청,1920,2190,4110
3844,20200322,수인분당선,선정릉,1490,1503,2993
3845,20200322,수인분당선,가천대,2131,2544,4675
3846,20200322,수인분당선,태평,5035,4945,9980
3847,20200322,수인분당선,모란,7259,7490,14749
3848,20200322,수인분당선,야탑,7570,7669,15239
3849,20200322,수인분당선,서현,7812,7558,15370
3850,20200322,수인분당선,수내,3845,3699,7544
3851,20200322,수인분당선,정자,4658,4737,9395
3852,20200322,수인분당선,미금,4247,4666,8913
3853,20200322,수인분당선,오리,3516,3081,6597
3854,20200322,수인분당선,이매,1514,1635,3149
3855,20200322,수인분당선,보정,605,563,1168
3856,20200322,수인분당선,죽전,4444,5059,9503
3857,20200322,수인분당선,구성,1299,1426,2725
3858,20200322,수인분당선,신갈,1125,1116,2241
3859,20200322,수인분당선,기흥,2948,2879,5827
3860,20200322,수인분당선,상갈,1713,1748,3461
3861,20200322,수인분당선,청명,1051,1003,2054
3862,20200322,수인분당선,영통,2829,2882,5711
3863,20200322,수인분당선,망포,3786,3980,7766
3864,20200322,수인분당선,매탄권선,1419,1334,2753
3865,20200322,수인분당선,수원시청,4523,4409,8932
3866,20200322,수인분당선,매교,726,734,1460
3867,20200322,수인분당선,달월,44,47,91
3868,20200322,수인분당선,월곶,1038,985,2023
3869,20200322,수인분당선,소래포구,2406,2325,4731
3870,20200322,수인분당선,인천논현,1993,2073,4066
3871,20200322,수인분당선,호구포,1102,1100,2202
3872,20200322,수인분당선,남동인더스파크,333,374,707
3873,20200322,수인분당선,원인재,1716,1791,3507
3874,20200322,수인분당선,연수,1975,1873,3848
3875,20200322,수인분당선,송도,1011,992,2003
3876,20200322,수인분당선,인하대,1781,1741,3522
3877,20200322,수인분당선,숭의,1255,1189,2444
3878,20200322,수인분당선,신포,638,664,1302
3879,20200322,수인분당선,인천,501,716,1217
3880,20200323,수인분당선,선릉,11341,17914,29255
3881,20200323,수인분당선,한티,9904,10477,20381
3882,20200323,수인분당선,도곡,4896,5048,9944
3883,20200323,수인분당선,구룡,1001,1009,2010
3884,20200323,수인분당선,개포동,2434,2665,5099
3885,20200323,수인분당선,대모산입구,2764,2566,5330
3886,20200323,수인분당선,수서,10031,10086,20117
3887,20200323,수인분당선,수원,5974,4041,10015
3888,20200323,수인분당선,서울숲,7406,7630,15036
3889,20200323,수인분당선,압구정로데오,12420,13845,26265
3890,20200323,수인분당선,강남구청,7541,8675,16216
3891,20200323,수인분당선,선정릉,7036,7554,14590
3892,20200323,수인분당선,가천대,5022,5899,10921
3893,20200323,수인분당선,태평,11168,10883,22051
3894,20200323,수인분당선,모란,15805,15979,31784
3895,20200323,수인분당선,야탑,19340,20089,39429
3896,20200323,수인분당선,서현,17743,17706,35449
3897,20200323,수인분당선,수내,9615,9492,19107
3898,20200323,수인분당선,정자,11903,12769,24672
3899,20200323,수인분당선,미금,11619,12578,24197
3900,20200323,수인분당선,오리,9131,7709,16840
3901,20200323,수인분당선,이매,3820,3538,7358
3902,20200323,수인분당선,보정,1806,1428,3234
3903,20200323,수인분당선,죽전,9704,10413,20117
3904,20200323,수인분당선,구성,3462,3603,7065
3905,20200323,수인분당선,신갈,3450,3350,6800
3906,20200323,수인분당선,기흥,7088,6795,13883
3907,20200323,수인분당선,상갈,4010,3744,7754
3908,20200323,수인분당선,청명,2985,2785,5770
3909,20200323,수인분당선,영통,5842,5980,11822
3910,20200323,수인분당선,망포,10224,9791,20015
3911,20200323,수인분당선,매탄권선,3321,3241,6562
3912,20200323,수인분당선,수원시청,8676,9446,18122
3913,20200323,수인분당선,매교,1755,1756,3511
3914,20200323,수인분당선,달월,90,64,154
3915,20200323,수인분당선,월곶,1793,1708,3501
3916,20200323,수인분당선,소래포구,3314,3077,6391
3917,20200323,수인분당선,인천논현,4341,4530,8871
3918,20200323,수인분당선,호구포,2874,2952,5826
3919,20200323,수인분당선,남동인더스파크,1937,2219,4156
3920,20200323,수인분당선,원인재,3285,3312,6597
3921,20200323,수인분당선,연수,3418,3318,6736
3922,20200323,수인분당선,송도,1936,1793,3729
3923,20200323,수인분당선,인하대,4057,3823,7880
3924,20200323,수인분당선,숭의,2988,2726,5714
3925,20200323,수인분당선,신포,1249,1284,2533
3926,20200323,수인분당선,인천,614,1073,1687
3927,20200324,수인분당선,선릉,11343,17708,29051
3928,20200324,수인분당선,한티,9664,10190,19854
3929,20200324,수인분당선,도곡,4778,4911,9689
3930,20200324,수인분당선,구룡,1011,1047,2058
3931,20200324,수인분당선,개포동,2478,2636,5114
3932,20200324,수인분당선,대모산입구,2795,2596,5391
3933,20200324,수인분당선,수서,9682,9911,19593
3934,20200324,수인분당선,복정,1,0,1
3935,20200324,수인분당선,수원,6037,3985,10022
3936,20200324,수인분당선,서울숲,7636,7942,15578
3937,20200324,수인분당선,압구정로데오,12989,14594,27583
3938,20200324,수인분당선,강남구청,7680,8874,16554
3939,20200324,수인분당선,선정릉,6943,7556,14499
3940,20200324,수인분당선,가천대,5033,5887,10920
3941,20200324,수인분당선,태평,11343,11027,22370
3942,20200324,수인분당선,모란,18088,18447,36535
3943,20200324,수인분당선,야탑,19450,20472,39922
3944,20200324,수인분당선,서현,17408,17735,35143
3945,20200324,수인분당선,수내,9653,9711,19364
3946,20200324,수인분당선,정자,12117,13015,25132
3947,20200324,수인분당선,미금,11705,12647,24352
3948,20200324,수인분당선,오리,8980,7578,16558
3949,20200324,수인분당선,이매,3847,3632,7479
3950,20200324,수인분당선,보정,1746,1444,3190
3951,20200324,수인분당선,죽전,9725,10476,20201
3952,20200324,수인분당선,구성,3610,3688,7298
3953,20200324,수인분당선,신갈,3347,3273,6620
3954,20200324,수인분당선,기흥,7216,6891,14107
3955,20200324,수인분당선,상갈,4086,3760,7846
3956,20200324,수인분당선,청명,3027,2852,5879
3957,20200324,수인분당선,영통,5801,5968,11769
3958,20200324,수인분당선,망포,10236,9785,20021
3959,20200324,수인분당선,매탄권선,3361,3179,6540
3960,20200324,수인분당선,수원시청,8458,9217,17675
3961,20200324,수인분당선,매교,1709,1740,3449
3962,20200324,수인분당선,달월,81,51,132
3963,20200324,수인분당선,월곶,1828,1733,3561
3964,20200324,수인분당선,소래포구,3367,3174,6541
3965,20200324,수인분당선,인천논현,4239,4432,8671
3966,20200324,수인분당선,호구포,2980,2927,5907
3967,20200324,수인분당선,남동인더스파크,1975,2303,4278
3968,20200324,수인분당선,원인재,3236,3327,6563
3969,20200324,수인분당선,연수,3351,3374,6725
3970,20200324,수인분당선,송도,1914,1727,3641
3971,20200324,수인분당선,인하대,4037,3843,7880
3972,20200324,수인분당선,숭의,3030,2812,5842
3973,20200324,수인분당선,신포,1235,1322,2557
3974,20200324,수인분당선,인천,677,1133,1810
3975,20200325,수인분당선,선릉,11444,17833,29277
3976,20200325,수인분당선,한티,10125,10658,20783
3977,20200325,수인분당선,도곡,4837,4833,9670
3978,20200325,수인분당선,구룡,1025,1105,2130
3979,20200325,수인분당선,개포동,2495,2670,5165
3980,20200325,수인분당선,대모산입구,2685,2583,5268
3981,20200325,수인분당선,수서,9539,9834,19373
3982,20200325,수인분당선,수원,6188,4101,10289
3983,20200325,수인분당선,서울숲,8080,8301,16381
3984,20200325,수인분당선,압구정로데오,13046,14660,27706
3985,20200325,수인분당선,강남구청,7733,9156,16889
3986,20200325,수인분당선,선정릉,7036,7651,14687
3987,20200325,수인분당선,가천대,5064,5912,10976
3988,20200325,수인분당선,태평,11263,10794,22057
3989,20200325,수인분당선,모란,16105,16195,32300
3990,20200325,수인분당선,야탑,19672,20653,40325
3991,20200325,수인분당선,서현,18144,18262,36406
3992,20200325,수인분당선,수내,9728,9721,19449
3993,20200325,수인분당선,정자,12136,13012,25148
3994,20200325,수인분당선,미금,11837,12719,24556
3995,20200325,수인분당선,오리,9324,8005,17329
3996,20200325,수인분당선,이매,3854,3736,7590
3997,20200325,수인분당선,보정,1847,1518,3365
3998,20200325,수인분당선,죽전,10028,10685,20713
3999,20200325,수인분당선,구성,3612,3742,7354
4000,20200325,수인분당선,신갈,3322,3278,6600
4001,20200325,수인분당선,기흥,7204,6798,14002
4002,20200325,수인분당선,상갈,4074,3891,7965
4003,20200325,수인분당선,청명,3125,2949,6074
4004,20200325,수인분당선,영통,6010,6077,12087
4005,20200325,수인분당선,망포,10524,10062,20586
4006,20200325,수인분당선,매탄권선,3424,3153,6577
4007,20200325,수인분당선,수원시청,8626,9592,18218
4008,20200325,수인분당선,매교,1710,1780,3490
4009,20200325,수인분당선,달월,88,73,161
4010,20200325,수인분당선,월곶,1844,1723,3567
4011,20200325,수인분당선,소래포구,3474,3275,6749
4012,20200325,수인분당선,인천논현,4445,4603,9048
4013,20200325,수인분당선,호구포,2944,3015,5959
4014,20200325,수인분당선,남동인더스파크,1987,2219,4206
4015,20200325,수인분당선,원인재,3364,3443,6807
4016,20200325,수인분당선,연수,3448,3501,6949
4017,20200325,수인분당선,송도,1993,1785,3778
4018,20200325,수인분당선,인하대,4127,3922,8049
4019,20200325,수인분당선,숭의,3131,2760,5891
4020,20200325,수인분당선,신포,1313,1325,2638
4021,20200325,수인분당선,인천,670,1094,1764
4022,20200326,수인분당선,선릉,11251,17721,28972
4023,20200326,수인분당선,한티,9771,10308,20079
4024,20200326,수인분당선,도곡,4613,4681,9294
4025,20200326,수인분당선,구룡,995,971,1966
4026,20200326,수인분당선,개포동,2428,2605,5033
4027,20200326,수인분당선,대모산입구,2664,2485,5149
4028,20200326,수인분당선,수서,9580,9858,19438
4029,20200326,수인분당선,복정,2,0,2
4030,20200326,수인분당선,수원,5908,3973,9881
4031,20200326,수인분당선,서울숲,7492,7564,15056
4032,20200326,수인분당선,압구정로데오,13026,14845,27871
4033,20200326,수인분당선,강남구청,7696,8936,16632
4034,20200326,수인분당선,선정릉,6968,7528,14496
4035,20200326,수인분당선,가천대,5100,5983,11083
4036,20200326,수인분당선,태평,10986,10570,21556
4037,20200326,수인분당선,모란,15675,15856,31531
4038,20200326,수인분당선,야탑,18986,19875,38861
4039,20200326,수인분당선,서현,17753,17887,35640
4040,20200326,수인분당선,수내,9588,9610,19198
4041,20200326,수인분당선,정자,12029,13090,25119
4042,20200326,수인분당선,미금,11575,12391,23966
4043,20200326,수인분당선,오리,9057,7666,16723
4044,20200326,수인분당선,이매,3727,3450,7177
4045,20200326,수인분당선,보정,1756,1466,3222
4046,20200326,수인분당선,죽전,9684,10551,20235
4047,20200326,수인분당선,구성,3475,3615,7090
4048,20200326,수인분당선,신갈,3273,3223,6496
4049,20200326,수인분당선,기흥,7100,6732,13832
4050,20200326,수인분당선,상갈,4018,3704,7722
4051,20200326,수인분당선,청명,3033,2834,5867
4052,20200326,수인분당선,영통,5791,5913,11704
4053,20200326,수인분당선,망포,10259,9748,20007
4054,20200326,수인분당선,매탄권선,3332,3092,6424
4055,20200326,수인분당선,수원시청,8314,9351,17665
4056,20200326,수인분당선,매교,1657,1686,3343
4057,20200326,수인분당선,달월,71,51,122
4058,20200326,수인분당선,월곶,1780,1679,3459
4059,20200326,수인분당선,소래포구,3243,3070,6313
4060,20200326,수인분당선,인천논현,4233,4358,8591
4061,20200326,수인분당선,호구포,2886,2920,5806
4062,20200326,수인분당선,남동인더스파크,2071,2357,4428
4063,20200326,수인분당선,원인재,3181,3346,6527
4064,20200326,수인분당선,연수,3395,3343,6738
4065,20200326,수인분당선,송도,1883,1722,3605
4066,20200326,수인분당선,인하대,4021,3832,7853
4067,20200326,수인분당선,숭의,2996,2835,5831
4068,20200326,수인분당선,신포,1181,1302,2483
4069,20200326,수인분당선,인천,609,1067,1676
4070,20200327,수인분당선,선릉,11057,17710,28767
4071,20200327,수인분당선,한티,10422,10841,21263
4072,20200327,수인분당선,도곡,4858,4799,9657
4073,20200327,수인분당선,구룡,1032,1031,2063
4074,20200327,수인분당선,개포동,2504,2693,5197
4075,20200327,수인분당선,대모산입구,2628,2459,5087
4076,20200327,수인분당선,수서,10845,11398,22243
4077,20200327,수인분당선,복정,1,0,1
4078,20200327,수인분당선,수원,6527,4499,11026
4079,20200327,수인분당선,서울숲,8049,8018,16067
4080,20200327,수인분당선,압구정로데오,14250,16492,30742
4081,20200327,수인분당선,강남구청,7833,8980,16813
4082,20200327,수인분당선,선정릉,6832,7465,14297
4083,20200327,수인분당선,가천대,5371,5915,11286
4084,20200327,수인분당선,태평,11409,10823,22232
4085,20200327,수인분당선,모란,16477,16866,33343
4086,20200327,수인분당선,야탑,20046,21031,41077
4087,20200327,수인분당선,서현,18750,19367,38117
4088,20200327,수인분당선,수내,9928,9844,19772
4089,20200327,수인분당선,정자,12628,13612,26240
4090,20200327,수인분당선,미금,12025,12852,24877
4091,20200327,수인분당선,오리,9266,7885,17151
4092,20200327,수인분당선,이매,3821,3568,7389
4093,20200327,수인분당선,보정,1780,1478,3258
4094,20200327,수인분당선,죽전,10715,11047,21762
4095,20200327,수인분당선,구성,3590,3692,7282
4096,20200327,수인분당선,신갈,3372,3289,6661
4097,20200327,수인분당선,기흥,7403,6926,14329
4098,20200327,수인분당선,상갈,4220,3819,8039
4099,20200327,수인분당선,청명,3177,2946,6123
4100,20200327,수인분당선,영통,6500,6661,13161
4101,20200327,수인분당선,망포,11460,10603,22063
4102,20200327,수인분당선,매탄권선,3686,3333,7019
4103,20200327,수인분당선,수원시청,9144,11124,20268
4104,20200327,수인분당선,매교,1748,1639,3387
4105,20200327,수인분당선,달월,82,55,137
4106,20200327,수인분당선,월곶,1884,1838,3722
4107,20200327,수인분당선,소래포구,3377,3219,6596
4108,20200327,수인분당선,인천논현,4534,4726,9260
4109,20200327,수인분당선,호구포,2974,2957,5931
4110,20200327,수인분당선,남동인더스파크,1970,2215,4185
4111,20200327,수인분당선,원인재,3356,3446,6802
4112,20200327,수인분당선,연수,3470,3524,6994
4113,20200327,수인분당선,송도,2005,1829,3834
4114,20200327,수인분당선,인하대,4143,3926,8069
4115,20200327,수인분당선,숭의,3016,2736,5752
4116,20200327,수인분당선,신포,1280,1424,2704
4117,20200327,수인분당선,인천,668,1107,1775
4118,20200328,수인분당선,선릉,3480,5418,8898
4119,20200328,수인분당선,한티,6895,6933,13828
4120,20200328,수인분당선,도곡,2575,2400,4975
4121,20200328,수인분당선,구룡,614,625,1239
4122,20200328,수인분당선,개포동,1521,1577,3098
4123,20200328,수인분당선,대모산입구,1700,1560,3260
4124,20200328,수인분당선,수서,5787,5988,11775
4125,20200328,수인분당선,수원,4434,3056,7490
4126,20200328,수인분당선,서울숲,5815,6220,12035
4127,20200328,수인분당선,압구정로데오,10364,12176,22540
4128,20200328,수인분당선,강남구청,3222,3969,7191
4129,20200328,수인분당선,선정릉,2513,2631,5144
4130,20200328,수인분당선,가천대,3218,3626,6844
4131,20200328,수인분당선,태평,8098,7664,15762
4132,20200328,수인분당선,모란,11266,11695,22961
4133,20200328,수인분당선,야탑,11558,12299,23857
4134,20200328,수인분당선,서현,11865,12145,24010
4135,20200328,수인분당선,수내,5757,5324,11081
4136,20200328,수인분당선,정자,7332,7386,14718
4137,20200328,수인분당선,미금,7647,7778,15425
4138,20200328,수인분당선,오리,5233,4372,9605
4139,20200328,수인분당선,이매,2405,2289,4694
4140,20200328,수인분당선,보정,983,892,1875
4141,20200328,수인분당선,죽전,6770,7582,14352
4142,20200328,수인분당선,구성,2018,2071,4089
4143,20200328,수인분당선,신갈,1772,1733,3505
4144,20200328,수인분당선,기흥,4634,4339,8973
4145,20200328,수인분당선,상갈,2478,2516,4994
4146,20200328,수인분당선,청명,1646,1570,3216
4147,20200328,수인분당선,영통,4385,4317,8702
4148,20200328,수인분당선,망포,6229,5497,11726
4149,20200328,수인분당선,매탄권선,2124,1965,4089
4150,20200328,수인분당선,수원시청,6543,7673,14216
4151,20200328,수인분당선,매교,1072,1137,2209
4152,20200328,수인분당선,달월,53,41,94
4153,20200328,수인분당선,월곶,1383,1350,2733
4154,20200328,수인분당선,소래포구,3069,3039,6108
4155,20200328,수인분당선,인천논현,3217,3283,6500
4156,20200328,수인분당선,호구포,1649,1555,3204
4157,20200328,수인분당선,남동인더스파크,718,710,1428
4158,20200328,수인분당선,원인재,2471,2553,5024
4159,20200328,수인분당선,연수,2600,2604,5204
4160,20200328,수인분당선,송도,1424,1388,2812
4161,20200328,수인분당선,인하대,2534,2454,4988
4162,20200328,수인분당선,숭의,1778,1643,3421
4163,20200328,수인분당선,신포,924,1016,1940
4164,20200328,수인분당선,인천,567,950,1517
4165,20200329,수인분당선,선릉,1815,2729,4544
4166,20200329,수인분당선,한티,4555,4542,9097
4167,20200329,수인분당선,도곡,1619,1530,3149
4168,20200329,수인분당선,구룡,397,388,785
4169,20200329,수인분당선,개포동,1051,1027,2078
4170,20200329,수인분당선,대모산입구,967,933,1900
4171,20200329,수인분당선,수서,5077,4972,10049
4172,20200329,수인분당선,수원,3128,2141,5269
4173,20200329,수인분당선,서울숲,4370,4862,9232
4174,20200329,수인분당선,압구정로데오,5767,6421,12188
4175,20200329,수인분당선,강남구청,1929,2266,4195
4176,20200329,수인분당선,선정릉,1478,1620,3098
4177,20200329,수인분당선,가천대,2324,2888,5212
4178,20200329,수인분당선,태평,5565,5355,10920
4179,20200329,수인분당선,모란,10415,10768,21183
4180,20200329,수인분당선,야탑,8320,8458,16778
4181,20200329,수인분당선,서현,8366,8257,16623
4182,20200329,수인분당선,수내,3962,3807,7769
4183,20200329,수인분당선,정자,4759,4925,9684
4184,20200329,수인분당선,미금,4624,5039,9663
4185,20200329,수인분당선,오리,3686,3183,6869
4186,20200329,수인분당선,이매,1641,1675,3316
4187,20200329,수인분당선,보정,637,623,1260
4188,20200329,수인분당선,죽전,4879,5636,10515
4189,20200329,수인분당선,구성,1425,1562,2987
4190,20200329,수인분당선,신갈,1189,1189,2378
4191,20200329,수인분당선,기흥,3046,3014,6060
4192,20200329,수인분당선,상갈,1757,1910,3667
4193,20200329,수인분당선,청명,1090,1061,2151
4194,20200329,수인분당선,영통,2910,2967,5877
4195,20200329,수인분당선,망포,3905,4136,8041
4196,20200329,수인분당선,매탄권선,1434,1407,2841
4197,20200329,수인분당선,수원시청,4391,4146,8537
4198,20200329,수인분당선,매교,722,742,1464
4199,20200329,수인분당선,달월,29,44,73
4200,20200329,수인분당선,월곶,1077,1072,2149
4201,20200329,수인분당선,소래포구,2570,2513,5083
4202,20200329,수인분당선,인천논현,2155,2174,4329
4203,20200329,수인분당선,호구포,1143,1198,2341
4204,20200329,수인분당선,남동인더스파크,346,388,734
4205,20200329,수인분당선,원인재,1702,1736,3438
4206,20200329,수인분당선,연수,1972,1934,3906
4207,20200329,수인분당선,송도,1043,996,2039
4208,20200329,수인분당선,인하대,1926,1809,3735
4209,20200329,수인분당선,숭의,1260,1213,2473
4210,20200329,수인분당선,신포,711,724,1435
4211,20200329,수인분당선,인천,557,803,1360
4212,20200330,수인분당선,선릉,11457,18049,29506
4213,20200330,수인분당선,한티,9826,10423,20249
4214,20200330,수인분당선,도곡,4874,4941,9815
4215,20200330,수인분당선,구룡,1027,1041,2068
4216,20200330,수인분당선,개포동,2429,2674,5103
4217,20200330,수인분당선,대모산입구,2745,2535,5280
4218,20200330,수인분당선,수서,10120,10185,20305
4219,20200330,수인분당선,수원,5981,4224,10205
4220,20200330,수인분당선,서울숲,7883,8082,15965
4221,20200330,수인분당선,압구정로데오,12414,13822,26236
4222,20200330,수인분당선,강남구청,7442,8644,16086
4223,20200330,수인분당선,선정릉,7167,7602,14769
4224,20200330,수인분당선,가천대,5131,6112,11243
4225,20200330,수인분당선,태평,11334,10962,22296
4226,20200330,수인분당선,모란,15898,16242,32140
4227,20200330,수인분당선,야탑,19861,20633,40494
4228,20200330,수인분당선,서현,18019,18030,36049
4229,20200330,수인분당선,수내,9727,9595,19322
4230,20200330,수인분당선,정자,12137,13046,25183
4231,20200330,수인분당선,미금,11755,12672,24427
4232,20200330,수인분당선,오리,9108,7520,16628
4233,20200330,수인분당선,이매,3841,3742,7583
4234,20200330,수인분당선,보정,1789,1408,3197
4235,20200330,수인분당선,죽전,9874,10654,20528
4236,20200330,수인분당선,구성,3680,3674,7354
4237,20200330,수인분당선,신갈,3497,3395,6892
4238,20200330,수인분당선,기흥,7158,6901,14059
4239,20200330,수인분당선,상갈,4108,3787,7895
4240,20200330,수인분당선,청명,3083,2903,5986
4241,20200330,수인분당선,영통,5832,6065,11897
4242,20200330,수인분당선,망포,10517,10111,20628
4243,20200330,수인분당선,매탄권선,3339,3064,6403
4244,20200330,수인분당선,수원시청,8690,9298,17988
4245,20200330,수인분당선,매교,1737,1815,3552
4246,20200330,수인분당선,달월,78,54,132
4247,20200330,수인분당선,월곶,1860,1786,3646
4248,20200330,수인분당선,소래포구,3391,3168,6559
4249,20200330,수인분당선,인천논현,4449,4597,9046
4250,20200330,수인분당선,호구포,2859,2947,5806
4251,20200330,수인분당선,남동인더스파크,1954,2226,4180
4252,20200330,수인분당선,원인재,3348,3420,6768
4253,20200330,수인분당선,연수,3436,3360,6796
4254,20200330,수인분당선,송도,1918,1781,3699
4255,20200330,수인분당선,인하대,4017,3798,7815
4256,20200330,수인분당선,숭의,3075,2844,5919
4257,20200330,수인분당선,신포,1193,1314,2507
4258,20200330,수인분당선,인천,652,1129,1781
4259,20200331,수인분당선,선릉,11555,18056,29611
4260,20200331,수인분당선,한티,10113,10632,20745
4261,20200331,수인분당선,도곡,4846,4749,9595
4262,20200331,수인분당선,구룡,999,1000,1999
4263,20200331,수인분당선,개포동,2429,2709,5138
4264,20200331,수인분당선,대모산입구,2698,2505,5203
4265,20200331,수인분당선,수서,9735,9844,19579
4266,20200331,수인분당선,수원,5943,4174,10117
4267,20200331,수인분당선,서울숲,8296,8607,16903
4268,20200331,수인분당선,압구정로데오,13196,14910,28106
4269,20200331,수인분당선,강남구청,7640,9055,16695
4270,20200331,수인분당선,선정릉,6994,7683,14677
4271,20200331,수인분당선,가천대,5155,5976,11131
4272,20200331,수인분당선,태평,11327,10941,22268
4273,20200331,수인분당선,모란,16120,16208,32328
4274,20200331,수인분당선,야탑,19895,20815,40710
4275,20200331,수인분당선,서현,17995,18197,36192
4276,20200331,수인분당선,수내,9628,9763,19391
4277,20200331,수인분당선,정자,12485,13425,25910
4278,20200331,수인분당선,미금,12000,12758,24758
4279,20200331,수인분당선,오리,9297,7780,17077
4280,20200331,수인분당선,이매,3837,3633,7470
4281,20200331,수인분당선,보정,1766,1499,3265
4282,20200331,수인분당선,죽전,10122,10902,21024
4283,20200331,수인분당선,구성,3620,3737,7357
4284,20200331,수인분당선,신갈,3369,3303,6672
4285,20200331,수인분당선,기흥,7318,6957,14275
4286,20200331,수인분당선,상갈,4206,3812,8018
4287,20200331,수인분당선,청명,3085,2972,6057
4288,20200331,수인분당선,영통,5920,6057,11977
4289,20200331,수인분당선,망포,10577,10064,20641
4290,20200331,수인분당선,매탄권선,3435,3207,6642
4291,20200331,수인분당선,수원시청,8400,9109,17509
4292,20200331,수인분당선,매교,1742,1758,3500
4293,20200331,수인분당선,달월,85,61,146
4294,20200331,수인분당선,월곶,1783,1715,3498
4295,20200331,수인분당선,소래포구,3345,3140,6485
4296,20200331,수인분당선,인천논현,4351,4520,8871
4297,20200331,수인분당선,호구포,2957,3025,5982
4298,20200331,수인분당선,남동인더스파크,1989,2229,4218
4299,20200331,수인분당선,원인재,3322,3402,6724
4300,20200331,수인분당선,연수,3343,3333,6676
4301,20200331,수인분당선,송도,1929,1790,3719
4302,20200331,수인분당선,인하대,4038,3820,7858
4303,20200331,수인분당선,숭의,3016,2906,5922
4304,20200331,수인분당선,신포,1282,1344,2626
4305,20200331,수인분당선,인천,639,1056,1695
4306,20200401,수인분당선,선릉,11293,17757,29050
4307,20200401,수인분당선,한티,10002,10700,20702
4308,20200401,수인분당선,도곡,4958,4943,9901
4309,20200401,수인분당선,구룡,1067,1051,2118
4310,20200401,수인분당선,개포동,2579,2754,5333
4311,20200401,수인분당선,대모산입구,2749,2581,5330
4312,20200401,수인분당선,수서,9737,9923,19660
4313,20200401,수인분당선,수원,6037,4090,10127
4314,20200401,수인분당선,서울숲,8390,8544,16934
4315,20200401,수인분당선,압구정로데오,13450,15099,28549
4316,20200401,수인분당선,강남구청,7735,9119,16854
4317,20200401,수인분당선,선정릉,7095,7642,14737
4318,20200401,수인분당선,가천대,5266,6228,11494
4319,20200401,수인분당선,태평,11249,10924,22173
4320,20200401,수인분당선,모란,16228,16278,32506
4321,20200401,수인분당선,야탑,19992,20880,40872
4322,20200401,수인분당선,서현,18223,18477,36700
4323,20200401,수인분당선,수내,9894,9921,19815
4324,20200401,수인분당선,정자,12516,13494,26010
4325,20200401,수인분당선,미금,12011,12794,24805
4326,20200401,수인분당선,오리,9389,7814,17203
4327,20200401,수인분당선,이매,3867,3655,7522
4328,20200401,수인분당선,보정,1862,1541,3403
4329,20200401,수인분당선,죽전,10024,10885,20909
4330,20200401,수인분당선,구성,3700,3880,7580
4331,20200401,수인분당선,신갈,3368,3266,6634
4332,20200401,수인분당선,기흥,7469,7102,14571
4333,20200401,수인분당선,상갈,4107,3860,7967
4334,20200401,수인분당선,청명,3044,2855,5899
4335,20200401,수인분당선,영통,5970,6137,12107
4336,20200401,수인분당선,망포,10563,10119,20682
4337,20200401,수인분당선,매탄권선,3448,3242,6690
4338,20200401,수인분당선,수원시청,8440,9267,17707
4339,20200401,수인분당선,매교,1734,1781,3515
4340,20200401,수인분당선,달월,72,56,128
4341,20200401,수인분당선,월곶,1862,1740,3602
4342,20200401,수인분당선,소래포구,3276,3119,6395
4343,20200401,수인분당선,인천논현,4467,4588,9055
4344,20200401,수인분당선,호구포,2907,2999,5906
4345,20200401,수인분당선,남동인더스파크,1968,2148,4116
4346,20200401,수인분당선,원인재,3399,3338,6737
4347,20200401,수인분당선,연수,3309,3356,6665
4348,20200401,수인분당선,송도,1961,1786,3747
4349,20200401,수인분당선,인하대,4063,3910,7973
4350,20200401,수인분당선,숭의,3016,2767,5783
4351,20200401,수인분당선,신포,1299,1354,2653
4352,20200401,수인분당선,인천,657,1178,1835
4353,20200402,수인분당선,선릉,11338,17916,29254
4354,20200402,수인분당선,한티,10052,10591,20643
4355,20200402,수인분당선,도곡,4898,4896,9794
4356,20200402,수인분당선,구룡,1063,1045,2108
4357,20200402,수인분당선,개포동,2517,2668,5185
4358,20200402,수인분당선,대모산입구,2706,2556,5262
4359,20200402,수인분당선,수서,10095,10287,20382
4360,20200402,수인분당선,수원,6026,4252,10278
4361,20200402,수인분당선,서울숲,8702,9010,17712
4362,20200402,수인분당선,압구정로데오,13616,15301,28917
4363,20200402,수인분당선,강남구청,7585,8868,16453
4364,20200402,수인분당선,선정릉,7075,7664,14739
4365,20200402,수인분당선,가천대,5364,6133,11497
4366,20200402,수인분당선,태평,11245,10935,22180
4367,20200402,수인분당선,모란,16148,16375,32523
4368,20200402,수인분당선,야탑,20030,20983,41013
4369,20200402,수인분당선,서현,18354,18373,36727
4370,20200402,수인분당선,수내,9787,9958,19745
4371,20200402,수인분당선,정자,12779,13544,26323
4372,20200402,수인분당선,미금,11968,12757,24725
4373,20200402,수인분당선,오리,9516,8123,17639
4374,20200402,수인분당선,이매,3986,3708,7694
4375,20200402,수인분당선,보정,1825,1490,3315
4376,20200402,수인분당선,죽전,10266,11143,21409
4377,20200402,수인분당선,구성,3669,3740,7409
4378,20200402,수인분당선,신갈,3371,3318,6689
4379,20200402,수인분당선,기흥,7397,6974,14371
4380,20200402,수인분당선,상갈,4139,3848,7987
4381,20200402,수인분당선,청명,3063,2859,5922
4382,20200402,수인분당선,영통,5954,6092,12046
4383,20200402,수인분당선,망포,10511,10073,20584
4384,20200402,수인분당선,매탄권선,3357,3268,6625
4385,20200402,수인분당선,수원시청,8384,9239,17623
4386,20200402,수인분당선,매교,1741,1779,3520
4387,20200402,수인분당선,달월,80,58,138
4388,20200402,수인분당선,월곶,1880,1759,3639
4389,20200402,수인분당선,소래포구,3368,3225,6593
4390,20200402,수인분당선,인천논현,4489,4640,9129
4391,20200402,수인분당선,호구포,2968,2981,5949
4392,20200402,수인분당선,남동인더스파크,1974,2211,4185
4393,20200402,수인분당선,원인재,3382,3399,6781
4394,20200402,수인분당선,연수,3260,3368,6628
4395,20200402,수인분당선,송도,1972,1778,3750
4396,20200402,수인분당선,인하대,4132,3881,8013
4397,20200402,수인분당선,숭의,3028,2832,5860
4398,20200402,수인분당선,신포,1285,1319,2604
4399,20200402,수인분당선,인천,659,1155,1814
4400,20200403,수인분당선,선릉,11379,17860,29239
4401,20200403,수인분당선,한티,10599,11182,21781
4402,20200403,수인분당선,도곡,5227,5102,10329
4403,20200403,수인분당선,구룡,1129,1139,2268
4404,20200403,수인분당선,개포동,2644,2875,5519
4405,20200403,수인분당선,대모산입구,2788,2612,5400
4406,20200403,수인분당선,수서,11221,11834,23055
4407,20200403,수인분당선,수원,6620,4626,11246
4408,20200403,수인분당선,서울숲,9205,9559,18764
4409,20200403,수인분당선,압구정로데오,14600,16779,31379
4410,20200403,수인분당선,강남구청,7834,9070,16904
4411,20200403,수인분당선,선정릉,7023,7517,14540
4412,20200403,수인분당선,가천대,5766,6362,12128
4413,20200403,수인분당선,태평,11563,11073,22636
4414,20200403,수인분당선,모란,17273,17925,35198
4415,20200403,수인분당선,야탑,21182,22111,43293
4416,20200403,수인분당선,서현,19133,19490,38623
4417,20200403,수인분당선,수내,10374,10327,20701
4418,20200403,수인분당선,정자,13118,14249,27367
4419,20200403,수인분당선,미금,12491,13368,25859
4420,20200403,수인분당선,오리,9892,8300,18192
4421,20200403,수인분당선,이매,4152,3987,8139
4422,20200403,수인분당선,보정,1875,1563,3438
4423,20200403,수인분당선,죽전,11082,11736,22818
4424,20200403,수인분당선,구성,3804,3792,7596
4425,20200403,수인분당선,신갈,3590,3477,7067
4426,20200403,수인분당선,기흥,7767,7252,15019
4427,20200403,수인분당선,상갈,4287,3966,8253
4428,20200403,수인분당선,청명,3313,3072,6385
4429,20200403,수인분당선,영통,6658,6716,13374
4430,20200403,수인분당선,망포,11593,10502,22095
4431,20200403,수인분당선,매탄권선,3711,3371,7082
4432,20200403,수인분당선,수원시청,9029,11077,20106
4433,20200403,수인분당선,매교,1832,1821,3653
4434,20200403,수인분당선,달월,85,62,147
4435,20200403,수인분당선,월곶,1951,1768,3719
4436,20200403,수인분당선,소래포구,3570,3338,6908
4437,20200403,수인분당선,인천논현,4582,4951,9533
4438,20200403,수인분당선,호구포,3081,3089,6170
4439,20200403,수인분당선,남동인더스파크,1978,2152,4130
4440,20200403,수인분당선,원인재,3667,3711,7378
4441,20200403,수인분당선,연수,3547,3538,7085
4442,20200403,수인분당선,송도,2037,1896,3933
4443,20200403,수인분당선,인하대,4163,4026,8189
4444,20200403,수인분당선,숭의,3121,2880,6001
4445,20200403,수인분당선,신포,1282,1395,2677
4446,20200403,수인분당선,인천,714,1199,1913
4447,20200404,수인분당선,선릉,3511,5739,9250
4448,20200404,수인분당선,한티,7266,7076,14342
4449,20200404,수인분당선,도곡,2601,2340,4941
4450,20200404,수인분당선,구룡,650,659,1309
4451,20200404,수인분당선,개포동,1565,1497,3062
4452,20200404,수인분당선,대모산입구,1730,1538,3268
4453,20200404,수인분당선,수서,6037,6436,12473
4454,20200404,수인분당선,수원,4615,3045,7660
4455,20200404,수인분당선,서울숲,7539,8699,16238
4456,20200404,수인분당선,압구정로데오,10758,12268,23026
4457,20200404,수인분당선,강남구청,3539,4170,7709
4458,20200404,수인분당선,선정릉,2329,2394,4723
4459,20200404,수인분당선,가천대,3364,3783,7147
4460,20200404,수인분당선,태평,8300,7993,16293
4461,20200404,수인분당선,모란,15093,15787,30880
4462,20200404,수인분당선,야탑,12163,12828,24991
4463,20200404,수인분당선,서현,12742,12991,25733
4464,20200404,수인분당선,수내,6147,5791,11938
4465,20200404,수인분당선,정자,7590,7701,15291
4466,20200404,수인분당선,미금,7971,8280,16251
4467,20200404,수인분당선,오리,5465,4575,10040
4468,20200404,수인분당선,이매,2696,2538,5234
4469,20200404,수인분당선,보정,965,868,1833
4470,20200404,수인분당선,죽전,7171,7920,15091
4471,20200404,수인분당선,구성,2194,2190,4384
4472,20200404,수인분당선,신갈,1840,1876,3716
4473,20200404,수인분당선,기흥,4658,4563,9221
4474,20200404,수인분당선,상갈,2602,2575,5177
4475,20200404,수인분당선,청명,1812,1726,3538
4476,20200404,수인분당선,영통,4561,4518,9079
4477,20200404,수인분당선,망포,6155,5346,11501
4478,20200404,수인분당선,매탄권선,2179,2038,4217
4479,20200404,수인분당선,수원시청,6470,7634,14104
4480,20200404,수인분당선,매교,1032,1190,2222
4481,20200404,수인분당선,달월,40,38,78
4482,20200404,수인분당선,월곶,1470,1383,2853
4483,20200404,수인분당선,소래포구,3267,3303,6570
4484,20200404,수인분당선,인천논현,3290,3399,6689
4485,20200404,수인분당선,호구포,1795,1707,3502
4486,20200404,수인분당선,남동인더스파크,707,639,1346
4487,20200404,수인분당선,원인재,2647,2729,5376
4488,20200404,수인분당선,연수,2634,2720,5354
4489,20200404,수인분당선,송도,1374,1365,2739
4490,20200404,수인분당선,인하대,2651,2494,5145
4491,20200404,수인분당선,숭의,1798,1707,3505
4492,20200404,수인분당선,신포,931,1000,1931
4493,20200404,수인분당선,인천,573,938,1511
4494,20200405,수인분당선,선릉,1880,2893,4773
4495,20200405,수인분당선,한티,4670,4755,9425
4496,20200405,수인분당선,도곡,1429,1423,2852
4497,20200405,수인분당선,구룡,377,410,787
4498,20200405,수인분당선,개포동,1025,993,2018
4499,20200405,수인분당선,대모산입구,878,853,1731
4500,20200405,수인분당선,수서,5243,4996,10239
4501,20200405,수인분당선,수원,3282,2197,5479
4502,20200405,수인분당선,서울숲,5351,6035,11386
4503,20200405,수인분당선,압구정로데오,5798,6590,12388
4504,20200405,수인분당선,강남구청,1955,2303,4258
4505,20200405,수인분당선,선정릉,1359,1438,2797
4506,20200405,수인분당선,가천대,2400,2968,5368
4507,20200405,수인분당선,태평,5624,5420,11044
4508,20200405,수인분당선,모란,7606,7893,15499
4509,20200405,수인분당선,야탑,8603,8814,17417
4510,20200405,수인분당선,서현,8893,8754,17647
4511,20200405,수인분당선,수내,4164,3875,8039
4512,20200405,수인분당선,정자,4914,5104,10018
4513,20200405,수인분당선,미금,4727,4966,9693
4514,20200405,수인분당선,오리,3767,3340,7107
4515,20200405,수인분당선,이매,1691,1774,3465
4516,20200405,수인분당선,보정,644,626,1270
4517,20200405,수인분당선,죽전,5200,5949,11149
4518,20200405,수인분당선,구성,1441,1582,3023
4519,20200405,수인분당선,신갈,1222,1239,2461
4520,20200405,수인분당선,기흥,3228,3096,6324
4521,20200405,수인분당선,상갈,1717,1850,3567
4522,20200405,수인분당선,청명,1145,1147,2292
4523,20200405,수인분당선,영통,3138,3057,6195
4524,20200405,수인분당선,망포,3974,4187,8161
4525,20200405,수인분당선,매탄권선,1513,1477,2990
4526,20200405,수인분당선,수원시청,4503,4331,8834
4527,20200405,수인분당선,매교,789,798,1587
4528,20200405,수인분당선,달월,36,38,74
4529,20200405,수인분당선,월곶,1076,999,2075
4530,20200405,수인분당선,소래포구,2623,2542,5165
4531,20200405,수인분당선,인천논현,2103,2159,4262
4532,20200405,수인분당선,호구포,1117,1207,2324
4533,20200405,수인분당선,남동인더스파크,359,384,743
4534,20200405,수인분당선,원인재,1939,2143,4082
4535,20200405,수인분당선,연수,2073,1952,4025
4536,20200405,수인분당선,송도,1093,1055,2148
4537,20200405,수인분당선,인하대,1894,1835,3729
4538,20200405,수인분당선,숭의,1304,1138,2442
4539,20200405,수인분당선,신포,679,703,1382
4540,20200405,수인분당선,인천,505,757,1262
4541,20200406,수인분당선,선릉,11986,18714,30700
4542,20200406,수인분당선,한티,10199,10837,21036
4543,20200406,수인분당선,도곡,5008,5172,10180
4544,20200406,수인분당선,구룡,1145,1170,2315
4545,20200406,수인분당선,개포동,2621,2831,5452
4546,20200406,수인분당선,대모산입구,2855,2589,5444
4547,20200406,수인분당선,수서,10705,10777,21482
4548,20200406,수인분당선,수원,6231,4369,10600
4549,20200406,수인분당선,서울숲,8235,8492,16727
4550,20200406,수인분당선,압구정로데오,13001,14434,27435
4551,20200406,수인분당선,강남구청,7805,9017,16822
4552,20200406,수인분당선,선정릉,7137,7814,14951
4553,20200406,수인분당선,가천대,5606,6354,11960
4554,20200406,수인분당선,태평,11462,11179,22641
4555,20200406,수인분당선,모란,16545,16806,33351
4556,20200406,수인분당선,야탑,20704,21677,42381
4557,20200406,수인분당선,서현,18973,19087,38060
4558,20200406,수인분당선,수내,10179,10123,20302
4559,20200406,수인분당선,정자,12837,13737,26574
4560,20200406,수인분당선,미금,12220,13293,25513
4561,20200406,수인분당선,오리,9471,8102,17573
4562,20200406,수인분당선,이매,4287,3990,8277
4563,20200406,수인분당선,보정,1882,1599,3481
4564,20200406,수인분당선,죽전,10170,10992,21162
4565,20200406,수인분당선,구성,3866,3992,7858
4566,20200406,수인분당선,신갈,3661,3609,7270
4567,20200406,수인분당선,기흥,7533,7298,14831
4568,20200406,수인분당선,상갈,4238,3991,8229
4569,20200406,수인분당선,청명,3190,3009,6199
4570,20200406,수인분당선,영통,6282,6357,12639
4571,20200406,수인분당선,망포,10825,10483,21308
4572,20200406,수인분당선,매탄권선,3434,3245,6679
4573,20200406,수인분당선,수원시청,8982,9664,18646
4574,20200406,수인분당선,매교,1867,1902,3769
4575,20200406,수인분당선,달월,70,56,126
4576,20200406,수인분당선,월곶,1844,1768,3612
4577,20200406,수인분당선,소래포구,3458,3236,6694
4578,20200406,수인분당선,인천논현,4513,4766,9279
4579,20200406,수인분당선,호구포,2974,3083,6057
4580,20200406,수인분당선,남동인더스파크,2083,2278,4361
4581,20200406,수인분당선,원인재,3511,3610,7121
4582,20200406,수인분당선,연수,3467,3330,6797
4583,20200406,수인분당선,송도,2004,1849,3853
4584,20200406,수인분당선,인하대,4102,3920,8022
4585,20200406,수인분당선,숭의,3146,2902,6048
4586,20200406,수인분당선,신포,1265,1310,2575
4587,20200406,수인분당선,인천,705,1118,1823
4588,20200407,수인분당선,선릉,11788,18589,30377
4589,20200407,수인분당선,한티,10635,11286,21921
4590,20200407,수인분당선,도곡,5038,5055,10093
4591,20200407,수인분당선,구룡,1180,1184,2364
4592,20200407,수인분당선,개포동,2611,2844,5455
4593,20200407,수인분당선,대모산입구,2822,2608,5430
4594,20200407,수인분당선,수서,10217,10484,20701
4595,20200407,수인분당선,수원,6151,4290,10441
4596,20200407,수인분당선,서울숲,8525,8697,17222
4597,20200407,수인분당선,압구정로데오,13859,15493,29352
4598,20200407,수인분당선,강남구청,8026,9181,17207
4599,20200407,수인분당선,선정릉,7196,7777,14973
4600,20200407,수인분당선,가천대,5488,6378,11866
4601,20200407,수인분당선,태평,11522,11268,22790
4602,20200407,수인분당선,모란,16411,16659,33070
4603,20200407,수인분당선,야탑,20794,21914,42708
4604,20200407,수인분당선,서현,18866,19253,38119
4605,20200407,수인분당선,수내,10253,10274,20527
4606,20200407,수인분당선,정자,13190,14116,27306
4607,20200407,수인분당선,미금,12580,13372,25952
4608,20200407,수인분당선,오리,9648,8111,17759
4609,20200407,수인분당선,이매,4305,4127,8432
4610,20200407,수인분당선,보정,1906,1607,3513
4611,20200407,수인분당선,죽전,10337,11336,21673
4612,20200407,수인분당선,구성,3873,3939,7812
4613,20200407,수인분당선,신갈,3575,3502,7077
4614,20200407,수인분당선,기흥,7525,7164,14689
4615,20200407,수인분당선,상갈,4200,3964,8164
4616,20200407,수인분당선,청명,3274,3113,6387
4617,20200407,수인분당선,영통,5990,6134,12124
4618,20200407,수인분당선,망포,10840,10311,21151
4619,20200407,수인분당선,매탄권선,3443,3285,6728
4620,20200407,수인분당선,수원시청,8815,9642,18457
4621,20200407,수인분당선,매교,1775,1836,3611
4622,20200407,수인분당선,달월,90,72,162
4623,20200407,수인분당선,월곶,1930,1848,3778
4624,20200407,수인분당선,소래포구,3771,3529,7300
4625,20200407,수인분당선,인천논현,4521,4773,9294
4626,20200407,수인분당선,호구포,3069,3138,6207
4627,20200407,수인분당선,남동인더스파크,2085,2288,4373
4628,20200407,수인분당선,원인재,3590,3743,7333
4629,20200407,수인분당선,연수,3515,3520,7035
4630,20200407,수인분당선,송도,2006,1808,3814
4631,20200407,수인분당선,인하대,4239,3917,8156
4632,20200407,수인분당선,숭의,3171,2913,6084
4633,20200407,수인분당선,신포,1298,1327,2625
4634,20200407,수인분당선,인천,593,1084,1677
4635,20200408,수인분당선,선릉,11790,18526,30316
4636,20200408,수인분당선,한티,10486,11261,21747
4637,20200408,수인분당선,도곡,5011,5018,10029
4638,20200408,수인분당선,구룡,1112,1138,2250
4639,20200408,수인분당선,개포동,2692,2872,5564
4640,20200408,수인분당선,대모산입구,2816,2636,5452
4641,20200408,수인분당선,수서,10341,10500,20841
4642,20200408,수인분당선,복정,1,0,1
4643,20200408,수인분당선,수원,6342,4379,10721
4644,20200408,수인분당선,서울숲,8594,8761,17355
4645,20200408,수인분당선,압구정로데오,13796,15448,29244
4646,20200408,수인분당선,강남구청,7998,9366,17364
4647,20200408,수인분당선,선정릉,7217,7832,15049
4648,20200408,수인분당선,가천대,5497,6297,11794
4649,20200408,수인분당선,태평,11479,11268,22747
4650,20200408,수인분당선,모란,16418,16509,32927
4651,20200408,수인분당선,야탑,20866,21877,42743
4652,20200408,수인분당선,서현,19265,19286,38551
4653,20200408,수인분당선,수내,10296,10349,20645
4654,20200408,수인분당선,정자,13233,14201,27434
4655,20200408,수인분당선,미금,12584,13461,26045
4656,20200408,수인분당선,오리,9747,8203,17950
4657,20200408,수인분당선,이매,4278,4085,8363
4658,20200408,수인분당선,보정,1952,1642,3594
4659,20200408,수인분당선,죽전,10414,11364,21778
4660,20200408,수인분당선,구성,3929,4011,7940
4661,20200408,수인분당선,신갈,3617,3595,7212
4662,20200408,수인분당선,기흥,7661,7245,14906
4663,20200408,수인분당선,상갈,4256,3978,8234
4664,20200408,수인분당선,청명,3174,3032,6206
4665,20200408,수인분당선,영통,6136,6398,12534
4666,20200408,수인분당선,망포,10895,10453,21348
4667,20200408,수인분당선,매탄권선,3504,3399,6903
4668,20200408,수인분당선,수원시청,9077,9941,19018
4669,20200408,수인분당선,매교,1793,1835,3628
4670,20200408,수인분당선,달월,73,52,125
4671,20200408,수인분당선,월곶,1909,1794,3703
4672,20200408,수인분당선,소래포구,3789,3511,7300
4673,20200408,수인분당선,인천논현,4647,4892,9539
4674,20200408,수인분당선,호구포,3124,3096,6220
4675,20200408,수인분당선,남동인더스파크,2087,2347,4434
4676,20200408,수인분당선,원인재,3635,3742,7377
4677,20200408,수인분당선,연수,3473,3548,7021
4678,20200408,수인분당선,송도,2022,1911,3933
4679,20200408,수인분당선,인하대,4299,4164,8463
4680,20200408,수인분당선,숭의,3110,2893,6003
4681,20200408,수인분당선,신포,1313,1405,2718
4682,20200408,수인분당선,인천,708,1167,1875
4683,20200409,수인분당선,선릉,11900,18733,30633
4684,20200409,수인분당선,한티,10442,11116,21558
4685,20200409,수인분당선,도곡,4884,4967,9851
4686,20200409,수인분당선,구룡,1159,1156,2315
4687,20200409,수인분당선,개포동,2667,2924,5591
4688,20200409,수인분당선,대모산입구,2839,2692,5531
4689,20200409,수인분당선,수서,10777,10926,21703
4690,20200409,수인분당선,수원,6377,4407,10784
4691,20200409,수인분당선,서울숲,8271,8411,16682
4692,20200409,수인분당선,압구정로데오,14176,15788,29964
4693,20200409,수인분당선,강남구청,8037,9320,17357
4694,20200409,수인분당선,선정릉,7139,7855,14994
4695,20200409,수인분당선,가천대,5543,6420,11963
4696,20200409,수인분당선,태평,11732,11441,23173
4697,20200409,수인분당선,모란,20629,21394,42023
4698,20200409,수인분당선,야탑,21112,22109,43221
4699,20200409,수인분당선,서현,19301,19533,38834
4700,20200409,수인분당선,수내,10305,10434,20739
4701,20200409,수인분당선,정자,13361,14366,27727
4702,20200409,수인분당선,미금,12542,13455,25997
4703,20200409,수인분당선,오리,9718,8252,17970
4704,20200409,수인분당선,이매,4419,4036,8455
4705,20200409,수인분당선,보정,1895,1573,3468
4706,20200409,수인분당선,죽전,10590,11429,22019
4707,20200409,수인분당선,구성,3843,3996,7839
4708,20200409,수인분당선,신갈,3619,3485,7104
4709,20200409,수인분당선,기흥,7596,7308,14904
4710,20200409,수인분당선,상갈,4259,4022,8281
4711,20200409,수인분당선,청명,3284,3086,6370
4712,20200409,수인분당선,영통,6208,6339,12547
4713,20200409,수인분당선,망포,11014,10370,21384
4714,20200409,수인분당선,매탄권선,3513,3378,6891
4715,20200409,수인분당선,수원시청,8935,9981,18916
4716,20200409,수인분당선,매교,1796,1820,3616
4717,20200409,수인분당선,달월,78,56,134
4718,20200409,수인분당선,월곶,1808,1742,3550
4719,20200409,수인분당선,소래포구,3660,3513,7173
4720,20200409,수인분당선,인천논현,4494,4711,9205
4721,20200409,수인분당선,호구포,3092,3098,6190
4722,20200409,수인분당선,남동인더스파크,2018,2246,4264
4723,20200409,수인분당선,원인재,3659,3774,7433
4724,20200409,수인분당선,연수,3391,3500,6891
4725,20200409,수인분당선,송도,1996,1877,3873
4726,20200409,수인분당선,인하대,4198,3983,8181
4727,20200409,수인분당선,숭의,3176,2889,6065
4728,20200409,수인분당선,신포,1317,1412,2729
4729,20200409,수인분당선,인천,666,1137,1803
4730,20200410,수인분당선,선릉,11852,18739,30591
4731,20200410,수인분당선,한티,11034,11623,22657
4732,20200410,수인분당선,도곡,5272,5237,10509
4733,20200410,수인분당선,구룡,1151,1152,2303
4734,20200410,수인분당선,개포동,2701,2899,5600
4735,20200410,수인분당선,대모산입구,2862,2704,5566
4736,20200410,수인분당선,수서,11936,12689,24625
4737,20200410,수인분당선,수원,6932,4921,11853
4738,20200410,수인분당선,서울숲,8443,8561,17004
4739,20200410,수인분당선,압구정로데오,15216,17547,32763
4740,20200410,수인분당선,강남구청,8296,9455,17751
4741,20200410,수인분당선,선정릉,7289,7899,15188
4742,20200410,수인분당선,가천대,5823,6344,12167
4743,20200410,수인분당선,태평,12136,11606,23742
4744,20200410,수인분당선,모란,17593,18064,35657
4745,20200410,수인분당선,야탑,21983,23168,45151
4746,20200410,수인분당선,서현,20299,20993,41292
4747,20200410,수인분당선,수내,10859,10779,21638
4748,20200410,수인분당선,정자,13814,15055,28869
4749,20200410,수인분당선,미금,13085,13972,27057
4750,20200410,수인분당선,오리,10040,8389,18429
4751,20200410,수인분당선,이매,4390,4087,8477
4752,20200410,수인분당선,보정,1952,1568,3520
4753,20200410,수인분당선,죽전,11496,11982,23478
4754,20200410,수인분당선,구성,3955,4038,7993
4755,20200410,수인분당선,신갈,3613,3611,7224
4756,20200410,수인분당선,기흥,7978,7420,15398
4757,20200410,수인분당선,상갈,4515,4087,8602
4758,20200410,수인분당선,청명,3523,3139,6662
4759,20200410,수인분당선,영통,6992,7102,14094
4760,20200410,수인분당선,망포,12175,11012,23187
4761,20200410,수인분당선,매탄권선,3760,3510,7270
4762,20200410,수인분당선,수원시청,9759,11948,21707
4763,20200410,수인분당선,매교,1821,1878,3699
4764,20200410,수인분당선,달월,83,69,152
4765,20200410,수인분당선,월곶,2026,1939,3965
4766,20200410,수인분당선,소래포구,3929,3757,7686
4767,20200410,수인분당선,인천논현,4860,5077,9937
4768,20200410,수인분당선,호구포,3234,3255,6489
4769,20200410,수인분당선,남동인더스파크,2056,2234,4290
4770,20200410,수인분당선,원인재,3769,3829,7598
4771,20200410,수인분당선,연수,3727,3787,7514
4772,20200410,수인분당선,송도,2139,1965,4104
4773,20200410,수인분당선,인하대,4490,4210,8700
4774,20200410,수인분당선,숭의,3151,2888,6039
4775,20200410,수인분당선,신포,1399,1498,2897
4776,20200410,수인분당선,인천,690,1206,1896
4777,20200411,수인분당선,선릉,3603,5804,9407
4778,20200411,수인분당선,한티,8022,7734,15756
4779,20200411,수인분당선,도곡,2714,2400,5114
4780,20200411,수인분당선,구룡,668,673,1341
4781,20200411,수인분당선,개포동,1722,1627,3349
4782,20200411,수인분당선,대모산입구,1725,1574,3299
4783,20200411,수인분당선,수서,6105,6546,12651
4784,20200411,수인분당선,복정,1,0,1
4785,20200411,수인분당선,수원,4882,3358,8240
4786,20200411,수인분당선,서울숲,5944,6383,12327
4787,20200411,수인분당선,압구정로데오,11008,12907,23915
4788,20200411,수인분당선,강남구청,3509,4131,7640
4789,20200411,수인분당선,선정릉,2718,2784,5502
4790,20200411,수인분당선,가천대,3335,3787,7122
4791,20200411,수인분당선,태평,8509,7985,16494
4792,20200411,수인분당선,모란,12169,12526,24695
4793,20200411,수인분당선,야탑,12663,13359,26022
4794,20200411,수인분당선,서현,13175,13530,26705
4795,20200411,수인분당선,수내,6309,5809,12118
4796,20200411,수인분당선,정자,7901,8110,16011
4797,20200411,수인분당선,미금,8246,8431,16677
4798,20200411,수인분당선,오리,5688,4779,10467
4799,20200411,수인분당선,이매,2833,2653,5486
4800,20200411,수인분당선,보정,1077,979,2056
4801,20200411,수인분당선,죽전,7537,8326,15863
4802,20200411,수인분당선,구성,2257,2335,4592
4803,20200411,수인분당선,신갈,1971,1993,3964
4804,20200411,수인분당선,기흥,4952,4742,9694
4805,20200411,수인분당선,상갈,2822,2718,5540
4806,20200411,수인분당선,청명,1794,1734,3528
4807,20200411,수인분당선,영통,4702,4500,9202
4808,20200411,수인분당선,망포,6451,5928,12379
4809,20200411,수인분당선,매탄권선,2287,2097,4384
4810,20200411,수인분당선,수원시청,7438,8760,16198
4811,20200411,수인분당선,매교,1083,1185,2268
4812,20200411,수인분당선,달월,43,39,82
4813,20200411,수인분당선,월곶,1521,1424,2945
4814,20200411,수인분당선,소래포구,3579,3651,7230
4815,20200411,수인분당선,인천논현,3515,3563,7078
4816,20200411,수인분당선,호구포,1842,1751,3593
4817,20200411,수인분당선,남동인더스파크,783,759,1542
4818,20200411,수인분당선,원인재,2927,2918,5845
4819,20200411,수인분당선,연수,2894,2867,5761
4820,20200411,수인분당선,송도,1551,1515,3066
4821,20200411,수인분당선,인하대,2892,2701,5593
4822,20200411,수인분당선,숭의,1987,1833,3820
4823,20200411,수인분당선,신포,974,1106,2080
4824,20200411,수인분당선,인천,649,1037,1686
4825,20200412,수인분당선,선릉,1819,2852,4671
4826,20200412,수인분당선,한티,5645,5514,11159
4827,20200412,수인분당선,도곡,1400,1420,2820
4828,20200412,수인분당선,구룡,435,411,846
4829,20200412,수인분당선,개포동,1163,1076,2239
4830,20200412,수인분당선,대모산입구,1010,933,1943
4831,20200412,수인분당선,수서,5581,5338,10919
4832,20200412,수인분당선,수원,3383,2263,5646
4833,20200412,수인분당선,서울숲,3663,3866,7529
4834,20200412,수인분당선,압구정로데오,6454,7169,13623
4835,20200412,수인분당선,강남구청,2142,2494,4636
4836,20200412,수인분당선,선정릉,1551,1586,3137
4837,20200412,수인분당선,가천대,2499,3041,5540
4838,20200412,수인분당선,태평,5642,5366,11008
4839,20200412,수인분당선,모란,8046,8313,16359
4840,20200412,수인분당선,야탑,8996,9154,18150
4841,20200412,수인분당선,서현,9191,9223,18414
4842,20200412,수인분당선,수내,4216,4113,8329
4843,20200412,수인분당선,정자,5150,5274,10424
4844,20200412,수인분당선,미금,5030,5411,10441
4845,20200412,수인분당선,오리,3938,3494,7432
4846,20200412,수인분당선,이매,1860,1836,3696
4847,20200412,수인분당선,보정,633,595,1228
4848,20200412,수인분당선,죽전,5180,5836,11016
4849,20200412,수인분당선,구성,1461,1607,3068
4850,20200412,수인분당선,신갈,1249,1304,2553
4851,20200412,수인분당선,기흥,3314,3274,6588
4852,20200412,수인분당선,상갈,1877,1939,3816
4853,20200412,수인분당선,청명,1177,1239,2416
4854,20200412,수인분당선,영통,3028,3045,6073
4855,20200412,수인분당선,망포,4169,4336,8505
4856,20200412,수인분당선,매탄권선,1468,1411,2879
4857,20200412,수인분당선,수원시청,5002,4796,9798
4858,20200412,수인분당선,매교,749,764,1513
4859,20200412,수인분당선,달월,33,44,77
4860,20200412,수인분당선,월곶,1123,1068,2191
4861,20200412,수인분당선,소래포구,3169,2976,6145
4862,20200412,수인분당선,인천논현,2230,2238,4468
4863,20200412,수인분당선,호구포,1316,1350,2666
4864,20200412,수인분당선,남동인더스파크,350,368,718
4865,20200412,수인분당선,원인재,1913,2064,3977
4866,20200412,수인분당선,연수,2116,2072,4188
4867,20200412,수인분당선,송도,1158,1125,2283
4868,20200412,수인분당선,인하대,1948,1893,3841
4869,20200412,수인분당선,숭의,1372,1305,2677
4870,20200412,수인분당선,신포,748,753,1501
4871,20200412,수인분당선,인천,536,836,1372
4872,20200413,수인분당선,선릉,12042,19035,31077
4873,20200413,수인분당선,한티,10536,11197,21733
4874,20200413,수인분당선,도곡,5248,5299,10547
4875,20200413,수인분당선,구룡,1121,1129,2250
4876,20200413,수인분당선,개포동,2735,2847,5582
4877,20200413,수인분당선,대모산입구,2923,2644,5567
4878,20200413,수인분당선,수서,11008,11202,22210
4879,20200413,수인분당선,복정,1,0,1
4880,20200413,수인분당선,수원,6560,4431,10991
4881,20200413,수인분당선,서울숲,7973,8159,16132
4882,20200413,수인분당선,압구정로데오,12998,14530,27528
4883,20200413,수인분당선,강남구청,7750,9022,16772
4884,20200413,수인분당선,선정릉,7272,7948,15220
4885,20200413,수인분당선,가천대,5417,6309,11726
4886,20200413,수인분당선,태평,11642,11339,22981
4887,20200413,수인분당선,모란,16843,17084,33927
4888,20200413,수인분당선,야탑,21217,22325,43542
4889,20200413,수인분당선,서현,19476,19609,39085
4890,20200413,수인분당선,수내,10401,10347,20748
4891,20200413,수인분당선,정자,13540,14511,28051
4892,20200413,수인분당선,미금,12922,13928,26850
4893,20200413,수인분당선,오리,9713,8351,18064
4894,20200413,수인분당선,이매,4322,4028,8350
4895,20200413,수인분당선,보정,1948,1593,3541
4896,20200413,수인분당선,죽전,10724,11688,22412
4897,20200413,수인분당선,구성,3987,4116,8103
4898,20200413,수인분당선,신갈,3710,3554,7264
4899,20200413,수인분당선,기흥,7997,7420,15417
4900,20200413,수인분당선,상갈,4435,4158,8593
4901,20200413,수인분당선,청명,3311,3160,6471
4902,20200413,수인분당선,영통,6330,6437,12767
4903,20200413,수인분당선,망포,11080,10622,21702
4904,20200413,수인분당선,매탄권선,3541,3404,6945
4905,20200413,수인분당선,수원시청,9363,10016,19379
4906,20200413,수인분당선,매교,1931,1976,3907
4907,20200413,수인분당선,달월,80,64,144
4908,20200413,수인분당선,월곶,1926,1820,3746
4909,20200413,수인분당선,소래포구,3742,3464,7206
4910,20200413,수인분당선,인천논현,4676,4808,9484
4911,20200413,수인분당선,호구포,3060,3219,6279
4912,20200413,수인분당선,남동인더스파크,2064,2341,4405
4913,20200413,수인분당선,원인재,3594,3649,7243
4914,20200413,수인분당선,연수,3603,3558,7161
4915,20200413,수인분당선,송도,2115,1946,4061
4916,20200413,수인분당선,인하대,4211,3975,8186
4917,20200413,수인분당선,숭의,3187,2951,6138
4918,20200413,수인분당선,신포,1373,1418,2791
4919,20200413,수인분당선,인천,695,1113,1808
4920,20200414,수인분당선,선릉,11921,19173,31094
4921,20200414,수인분당선,한티,10995,11618,22613
4922,20200414,수인분당선,도곡,5275,5186,10461
4923,20200414,수인분당선,구룡,1184,1175,2359
4924,20200414,수인분당선,개포동,2777,2930,5707
4925,20200414,수인분당선,대모산입구,2969,2721,5690
4926,20200414,수인분당선,수서,11446,11763,23209
4927,20200414,수인분당선,수원,6961,4723,11684
4928,20200414,수인분당선,서울숲,8459,8461,16920
4929,20200414,수인분당선,압구정로데오,14895,16923,31818
4930,20200414,수인분당선,강남구청,8319,9605,17924
4931,20200414,수인분당선,선정릉,7328,8162,15490
4932,20200414,수인분당선,가천대,5644,6268,11912
4933,20200414,수인분당선,태평,12478,11802,24280
4934,20200414,수인분당선,모란,21850,22971,44821
4935,20200414,수인분당선,야탑,22636,23627,46263
4936,20200414,수인분당선,서현,20416,20792,41208
4937,20200414,수인분당선,수내,10868,10813,21681
4938,20200414,수인분당선,정자,14241,15568,29809
4939,20200414,수인분당선,미금,13464,14319,27783
4940,20200414,수인분당선,오리,10322,8579,18901
4941,20200414,수인분당선,이매,4532,4311,8843
4942,20200414,수인분당선,보정,2022,1696,3718
4943,20200414,수인분당선,죽전,11444,12288,23732
4944,20200414,수인분당선,구성,4163,4194,8357
4945,20200414,수인분당선,신갈,3828,3684,7512
4946,20200414,수인분당선,기흥,8168,7586,15754
4947,20200414,수인분당선,상갈,4613,4271,8884
4948,20200414,수인분당선,청명,3459,3189,6648
4949,20200414,수인분당선,영통,6630,6819,13449
4950,20200414,수인분당선,망포,11920,10851,22771
4951,20200414,수인분당선,매탄권선,3823,3508,7331
4952,20200414,수인분당선,수원시청,9589,11416,21005
4953,20200414,수인분당선,매교,1976,1976,3952
4954,20200414,수인분당선,달월,78,56,134
4955,20200414,수인분당선,월곶,2054,1897,3951
4956,20200414,수인분당선,소래포구,4098,3982,8080
4957,20200414,수인분당선,인천논현,4855,5079,9934
4958,20200414,수인분당선,호구포,3137,3177,6314
4959,20200414,수인분당선,남동인더스파크,2081,2303,4384
4960,20200414,수인분당선,원인재,3691,3877,7568
4961,20200414,수인분당선,연수,3750,3875,7625
4962,20200414,수인분당선,송도,2109,1910,4019
4963,20200414,수인분당선,인하대,4407,4161,8568
4964,20200414,수인분당선,숭의,3346,3019,6365
4965,20200414,수인분당선,신포,1416,1494,2910
4966,20200414,수인분당선,인천,676,1172,1848
4967,20200415,수인분당선,선릉,2980,4829,7809
4968,20200415,수인분당선,한티,6507,6591,13098
4969,20200415,수인분당선,도곡,2377,2296,4673
4970,20200415,수인분당선,구룡,607,649,1256
4971,20200415,수인분당선,개포동,1504,1476,2980
4972,20200415,수인분당선,대모산입구,1494,1395,2889
4973,20200415,수인분당선,수서,5287,5390,10677
4974,20200415,수인분당선,복정,2,0,2
4975,20200415,수인분당선,수원,4182,2771,6953
4976,20200415,수인분당선,서울숲,5401,5904,11305
4977,20200415,수인분당선,압구정로데오,8665,9908,18573
4978,20200415,수인분당선,강남구청,2900,3370,6270
4979,20200415,수인분당선,선정릉,2190,2252,4442
4980,20200415,수인분당선,가천대,2985,3566,6551
4981,20200415,수인분당선,태평,7674,7250,14924
4982,20200415,수인분당선,모란,10771,11000,21771
4983,20200415,수인분당선,야탑,10959,11700,22659
4984,20200415,수인분당선,서현,11521,11475,22996
4985,20200415,수인분당선,수내,5366,5276,10642
4986,20200415,수인분당선,정자,6948,7147,14095
4987,20200415,수인분당선,미금,7008,7422,14430
4988,20200415,수인분당선,오리,4926,4110,9036
4989,20200415,수인분당선,이매,2463,2380,4843
4990,20200415,수인분당선,보정,903,840,1743
4991,20200415,수인분당선,죽전,6564,7365,13929
4992,20200415,수인분당선,구성,1987,2115,4102
4993,20200415,수인분당선,신갈,1769,1821,3590
4994,20200415,수인분당선,기흥,4344,4284,8628
4995,20200415,수인분당선,상갈,2498,2539,5037
4996,20200415,수인분당선,청명,1501,1536,3037
4997,20200415,수인분당선,영통,4148,4082,8230
4998,20200415,수인분당선,망포,5673,5571,11244
4999,20200415,수인분당선,매탄권선,1989,1930,3919
5000,20200415,수인분당선,수원시청,5778,5997,11775
5001,20200415,수인분당선,매교,1006,1080,2086
5002,20200415,수인분당선,달월,47,51,98
5003,20200415,수인분당선,월곶,1531,1409,2940
5004,20200415,수인분당선,소래포구,3512,3563,7075
5005,20200415,수인분당선,인천논현,3238,3309,6547
5006,20200415,수인분당선,호구포,1820,1910,3730
5007,20200415,수인분당선,남동인더스파크,879,949,1828
5008,20200415,수인분당선,원인재,2643,2607,5250
5009,20200415,수인분당선,연수,2643,2632,5275
5010,20200415,수인분당선,송도,1476,1438,2914
5011,20200415,수인분당선,인하대,2694,2566,5260
5012,20200415,수인분당선,숭의,1832,1708,3540
5013,20200415,수인분당선,신포,987,1017,2004
5014,20200415,수인분당선,인천,635,980,1615
5015,20200416,수인분당선,선릉,12070,18983,31053
5016,20200416,수인분당선,한티,10682,11313,21995
5017,20200416,수인분당선,도곡,5119,5136,10255
5018,20200416,수인분당선,구룡,1169,1098,2267
5019,20200416,수인분당선,개포동,2737,2890,5627
5020,20200416,수인분당선,대모산입구,2853,2721,5574
5021,20200416,수인분당선,수서,11213,11227,22440
5022,20200416,수인분당선,복정,1,0,1
5023,20200416,수인분당선,수원,6482,4570,11052
5024,20200416,수인분당선,서울숲,8528,8632,17160
5025,20200416,수인분당선,압구정로데오,14530,16218,30748
5026,20200416,수인분당선,강남구청,8132,9430,17562
5027,20200416,수인분당선,선정릉,7301,7877,15178
5028,20200416,수인분당선,가천대,5464,6392,11856
5029,20200416,수인분당선,태평,11810,11623,23433
5030,20200416,수인분당선,모란,17031,17253,34284
5031,20200416,수인분당선,야탑,21760,22519,44279
5032,20200416,수인분당선,서현,19757,20007,39764
5033,20200416,수인분당선,수내,10557,10722,21279
5034,20200416,수인분당선,정자,13347,14310,27657
5035,20200416,수인분당선,미금,12925,13845,26770
5036,20200416,수인분당선,오리,9932,8578,18510
5037,20200416,수인분당선,이매,4299,4079,8378
5038,20200416,수인분당선,보정,1901,1626,3527
5039,20200416,수인분당선,죽전,10971,11842,22813
5040,20200416,수인분당선,구성,4015,4049,8064
5041,20200416,수인분당선,신갈,3694,3621,7315
5042,20200416,수인분당선,기흥,7987,7551,15538
5043,20200416,수인분당선,상갈,4403,4141,8544
5044,20200416,수인분당선,청명,3346,3125,6471
5045,20200416,수인분당선,영통,6473,6600,13073
5046,20200416,수인분당선,망포,11115,10513,21628
5047,20200416,수인분당선,매탄권선,3635,3469,7104
5048,20200416,수인분당선,수원시청,9289,10185,19474
5049,20200416,수인분당선,매교,1882,1912,3794
5050,20200416,수인분당선,달월,83,58,141
5051,20200416,수인분당선,월곶,1975,1840,3815
5052,20200416,수인분당선,소래포구,3895,3734,7629
5053,20200416,수인분당선,인천논현,4698,4878,9576
5054,20200416,수인분당선,호구포,3150,3205,6355
5055,20200416,수인분당선,남동인더스파크,2033,2287,4320
5056,20200416,수인분당선,원인재,3686,3861,7547
5057,20200416,수인분당선,연수,3518,3566,7084
5058,20200416,수인분당선,송도,2103,1925,4028
5059,20200416,수인분당선,인하대,4359,4090,8449
5060,20200416,수인분당선,숭의,3265,2967,6232
5061,20200416,수인분당선,신포,1435,1465,2900
5062,20200416,수인분당선,인천,673,1135,1808
5063,20200417,수인분당선,선릉,11986,18996,30982
5064,20200417,수인분당선,한티,11153,11871,23024
5065,20200417,수인분당선,도곡,5260,5289,10549
5066,20200417,수인분당선,구룡,1156,1104,2260
5067,20200417,수인분당선,개포동,2698,2979,5677
5068,20200417,수인분당선,대모산입구,2827,2576,5403
5069,20200417,수인분당선,수서,12045,12563,24608
5070,20200417,수인분당선,수원,6890,4861,11751
5071,20200417,수인분당선,서울숲,7725,7803,15528
5072,20200417,수인분당선,압구정로데오,14725,17326,32051
5073,20200417,수인분당선,강남구청,8314,9520,17834
5074,20200417,수인분당선,선정릉,7313,7813,15126
5075,20200417,수인분당선,가천대,5783,6346,12129
5076,20200417,수인분당선,태평,11945,11464,23409
5077,20200417,수인분당선,모란,17183,17488,34671
5078,20200417,수인분당선,야탑,21832,23242,45074
5079,20200417,수인분당선,서현,20374,21075,41449
5080,20200417,수인분당선,수내,10793,10833,21626
5081,20200417,수인분당선,정자,13708,14846,28554
5082,20200417,수인분당선,미금,12979,13807,26786
5083,20200417,수인분당선,오리,10165,8511,18676
5084,20200417,수인분당선,이매,4346,4095,8441
5085,20200417,수인분당선,보정,1956,1677,3633
5086,20200417,수인분당선,죽전,11509,12172,23681
5087,20200417,수인분당선,구성,4054,4101,8155
5088,20200417,수인분당선,신갈,3640,3565,7205
5089,20200417,수인분당선,기흥,8105,7492,15597
5090,20200417,수인분당선,상갈,4507,4050,8557
5091,20200417,수인분당선,청명,3453,3102,6555
5092,20200417,수인분당선,영통,6721,6858,13579
5093,20200417,수인분당선,망포,12096,10907,23003
5094,20200417,수인분당선,매탄권선,3883,3523,7406
5095,20200417,수인분당선,수원시청,9615,11765,21380
5096,20200417,수인분당선,매교,1809,1843,3652
5097,20200417,수인분당선,달월,72,55,127
5098,20200417,수인분당선,월곶,1911,1805,3716
5099,20200417,수인분당선,소래포구,3416,3189,6605
5100,20200417,수인분당선,인천논현,4643,4789,9432
5101,20200417,수인분당선,호구포,3119,3063,6182
5102,20200417,수인분당선,남동인더스파크,1948,2215,4163
5103,20200417,수인분당선,원인재,3637,3668,7305
5104,20200417,수인분당선,연수,3541,3745,7286
5105,20200417,수인분당선,송도,1949,1870,3819
5106,20200417,수인분당선,인하대,4225,3963,8188
5107,20200417,수인분당선,숭의,3117,2807,5924
5108,20200417,수인분당선,신포,1321,1415,2736
5109,20200417,수인분당선,인천,650,1064,1714
5110,20200418,수인분당선,선릉,3996,6470,10466
5111,20200418,수인분당선,한티,8741,8375,17116
5112,20200418,수인분당선,도곡,2937,2672,5609
5113,20200418,수인분당선,구룡,695,705,1400
5114,20200418,수인분당선,개포동,1731,1718,3449
5115,20200418,수인분당선,대모산입구,1884,1674,3558
5116,20200418,수인분당선,수서,6991,7149,14140
5117,20200418,수인분당선,수원,5261,3575,8836
5118,20200418,수인분당선,서울숲,6706,7275,13981
5119,20200418,수인분당선,압구정로데오,11807,13930,25737
5120,20200418,수인분당선,강남구청,3816,4685,8501
5121,20200418,수인분당선,선정릉,2675,2877,5552
5122,20200418,수인분당선,가천대,3638,3987,7625
5123,20200418,수인분당선,태평,8978,8406,17384
5124,20200418,수인분당선,모란,13092,13637,26729
5125,20200418,수인분당선,야탑,13783,14453,28236
5126,20200418,수인분당선,서현,14248,14983,29231
5127,20200418,수인분당선,수내,7048,6536,13584
5128,20200418,수인분당선,정자,8754,8685,17439
5129,20200418,수인분당선,미금,8779,9143,17922
5130,20200418,수인분당선,오리,6205,5135,11340
5131,20200418,수인분당선,이매,3002,2766,5768
5132,20200418,수인분당선,보정,1158,1032,2190
5133,20200418,수인분당선,죽전,8063,8911,16974
5134,20200418,수인분당선,구성,2522,2564,5086
5135,20200418,수인분당선,신갈,2040,2129,4169
5136,20200418,수인분당선,기흥,5213,4998,10211
5137,20200418,수인분당선,상갈,2927,2931,5858
5138,20200418,수인분당선,청명,2032,1901,3933
5139,20200418,수인분당선,영통,5250,5155,10405
5140,20200418,수인분당선,망포,7198,6350,13548
5141,20200418,수인분당선,매탄권선,2596,2394,4990
5142,20200418,수인분당선,수원시청,7617,9380,16997
5143,20200418,수인분당선,매교,1226,1284,2510
5144,20200418,수인분당선,달월,49,50,99
5145,20200418,수인분당선,월곶,1692,1636,3328
5146,20200418,수인분당선,소래포구,4607,4653,9260
5147,20200418,수인분당선,인천논현,3730,3761,7491
5148,20200418,수인분당선,호구포,1934,1911,3845
5149,20200418,수인분당선,남동인더스파크,780,712,1492
5150,20200418,수인분당선,원인재,3011,2939,5950
5151,20200418,수인분당선,연수,3052,3206,6258
5152,20200418,수인분당선,송도,1745,1700,3445
5153,20200418,수인분당선,인하대,3162,2963,6125
5154,20200418,수인분당선,숭의,2128,2001,4129
5155,20200418,수인분당선,신포,1140,1202,2342
5156,20200418,수인분당선,인천,759,1258,2017
5157,20200419,수인분당선,선릉,1970,3003,4973
5158,20200419,수인분당선,한티,5940,5614,11554
5159,20200419,수인분당선,도곡,1578,1563,3141
5160,20200419,수인분당선,구룡,385,381,766
5161,20200419,수인분당선,개포동,1124,1131,2255
5162,20200419,수인분당선,대모산입구,1089,1044,2133
5163,20200419,수인분당선,수서,6099,5745,11844
5164,20200419,수인분당선,수원,3474,2295,5769
5165,20200419,수인분당선,서울숲,3022,3070,6092
5166,20200419,수인분당선,압구정로데오,6018,6774,12792
5167,20200419,수인분당선,강남구청,2150,2513,4663
5168,20200419,수인분당선,선정릉,1436,1533,2969
5169,20200419,수인분당선,가천대,2507,3245,5752
5170,20200419,수인분당선,태평,6221,5910,12131
5171,20200419,수인분당선,모란,13584,14050,27634
5172,20200419,수인분당선,야탑,9186,9603,18789
5173,20200419,수인분당선,서현,9778,9653,19431
5174,20200419,수인분당선,수내,4411,4264,8675
5175,20200419,수인분당선,정자,5266,5538,10804
5176,20200419,수인분당선,미금,5323,5656,10979
5177,20200419,수인분당선,오리,4044,3555,7599
5178,20200419,수인분당선,이매,2049,2123,4172
5179,20200419,수인분당선,보정,733,677,1410
5180,20200419,수인분당선,죽전,5619,6397,12016
5181,20200419,수인분당선,구성,1570,1775,3345
5182,20200419,수인분당선,신갈,1377,1407,2784
5183,20200419,수인분당선,기흥,3390,3499,6889
5184,20200419,수인분당선,상갈,1994,2046,4040
5185,20200419,수인분당선,청명,1215,1210,2425
5186,20200419,수인분당선,영통,3187,3170,6357
5187,20200419,수인분당선,망포,4193,4665,8858
5188,20200419,수인분당선,매탄권선,1706,1552,3258
5189,20200419,수인분당선,수원시청,5047,4838,9885
5190,20200419,수인분당선,매교,778,762,1540
5191,20200419,수인분당선,달월,48,49,97
5192,20200419,수인분당선,월곶,1049,1053,2102
5193,20200419,수인분당선,소래포구,3231,3024,6255
5194,20200419,수인분당선,인천논현,2157,2253,4410
5195,20200419,수인분당선,호구포,1268,1329,2597
5196,20200419,수인분당선,남동인더스파크,419,456,875
5197,20200419,수인분당선,원인재,1925,2016,3941
5198,20200419,수인분당선,연수,2139,2014,4153
5199,20200419,수인분당선,송도,1118,1178,2296
5200,20200419,수인분당선,인하대,1827,1788,3615
5201,20200419,수인분당선,숭의,1293,1233,2526
5202,20200419,수인분당선,신포,717,734,1451
5203,20200419,수인분당선,인천,552,820,1372
5204,20200420,수인분당선,선릉,12308,19896,32204
5205,20200420,수인분당선,한티,10902,11566,22468
5206,20200420,수인분당선,도곡,5412,5485,10897
5207,20200420,수인분당선,구룡,1144,1166,2310
5208,20200420,수인분당선,개포동,2763,2975,5738
5209,20200420,수인분당선,대모산입구,2924,2818,5742
5210,20200420,수인분당선,수서,11376,11582,22958
5211,20200420,수인분당선,수원,6474,4508,10982
5212,20200420,수인분당선,서울숲,7649,7711,15360
5213,20200420,수인분당선,압구정로데오,13487,14823,28310
5214,20200420,수인분당선,강남구청,8044,9258,17302
5215,20200420,수인분당선,선정릉,7401,8074,15475
5216,20200420,수인분당선,가천대,5924,6925,12849
5217,20200420,수인분당선,태평,12030,11897,23927
5218,20200420,수인분당선,모란,17315,17498,34813
5219,20200420,수인분당선,야탑,22319,23216,45535
5220,20200420,수인분당선,서현,20737,20691,41428
5221,20200420,수인분당선,수내,11094,11002,22096
5222,20200420,수인분당선,정자,14191,15135,29326
5223,20200420,수인분당선,미금,13365,14376,27741
5224,20200420,수인분당선,오리,10035,8582,18617
5225,20200420,수인분당선,이매,4436,4236,8672
5226,20200420,수인분당선,보정,2026,1668,3694
5227,20200420,수인분당선,죽전,10877,11856,22733
5228,20200420,수인분당선,구성,4196,4182,8378
5229,20200420,수인분당선,신갈,3867,3752,7619
5230,20200420,수인분당선,기흥,8058,7516,15574
5231,20200420,수인분당선,상갈,4441,4226,8667
5232,20200420,수인분당선,청명,3358,3123,6481
5233,20200420,수인분당선,영통,6434,6709,13143
5234,20200420,수인분당선,망포,11268,10767,22035
5235,20200420,수인분당선,매탄권선,3702,3540,7242
5236,20200420,수인분당선,수원시청,9364,10090,19454
5237,20200420,수인분당선,매교,1872,1922,3794
5238,20200420,수인분당선,달월,81,48,129
5239,20200420,수인분당선,월곶,1948,1837,3785
5240,20200420,수인분당선,소래포구,3799,3542,7341
5241,20200420,수인분당선,인천논현,4795,4916,9711
5242,20200420,수인분당선,호구포,3056,3178,6234
5243,20200420,수인분당선,남동인더스파크,2153,2393,4546
5244,20200420,수인분당선,원인재,3636,3690,7326
5245,20200420,수인분당선,연수,3609,3634,7243
5246,20200420,수인분당선,송도,2024,1905,3929
5247,20200420,수인분당선,인하대,4249,4048,8297
5248,20200420,수인분당선,숭의,3227,3003,6230
5249,20200420,수인분당선,신포,1331,1297,2628
5250,20200420,수인분당선,인천,691,1099,1790
5251,20200421,수인분당선,선릉,12452,19757,32209
5252,20200421,수인분당선,한티,11157,11826,22983
5253,20200421,수인분당선,도곡,5404,5529,10933
5254,20200421,수인분당선,구룡,1148,1159,2307
5255,20200421,수인분당선,개포동,2800,3009,5809
5256,20200421,수인분당선,대모산입구,2996,2781,5777
5257,20200421,수인분당선,수서,11453,11608,23061
5258,20200421,수인분당선,복정,1,0,1
5259,20200421,수인분당선,수원,6548,4543,11091
5260,20200421,수인분당선,서울숲,8233,8360,16593
5261,20200421,수인분당선,압구정로데오,14720,16359,31079
5262,20200421,수인분당선,강남구청,8496,9947,18443
5263,20200421,수인분당선,선정릉,7675,8073,15748
5264,20200421,수인분당선,가천대,6242,7151,13393
5265,20200421,수인분당선,태평,12093,11876,23969
5266,20200421,수인분당선,모란,17537,17943,35480
5267,20200421,수인분당선,야탑,22380,23670,46050
5268,20200421,수인분당선,서현,21125,21262,42387
5269,20200421,수인분당선,수내,11111,11104,22215
5270,20200421,수인분당선,정자,14680,15645,30325
5271,20200421,수인분당선,미금,13514,14621,28135
5272,20200421,수인분당선,오리,10364,8649,19013
5273,20200421,수인분당선,이매,4611,4433,9044
5274,20200421,수인분당선,보정,2013,1685,3698
5275,20200421,수인분당선,죽전,11266,12289,23555
5276,20200421,수인분당선,구성,4189,4403,8592
5277,20200421,수인분당선,신갈,3926,3825,7751
5278,20200421,수인분당선,기흥,8173,7682,15855
5279,20200421,수인분당선,상갈,4588,4309,8897
5280,20200421,수인분당선,청명,3395,3273,6668
5281,20200421,수인분당선,영통,6515,6685,13200
5282,20200421,수인분당선,망포,11525,11046,22571
5283,20200421,수인분당선,매탄권선,3733,3549,7282
5284,20200421,수인분당선,수원시청,9607,10466,20073
5285,20200421,수인분당선,매교,1936,1975,3911
5286,20200421,수인분당선,달월,102,82,184
5287,20200421,수인분당선,월곶,1968,1836,3804
5288,20200421,수인분당선,소래포구,4192,4016,8208
5289,20200421,수인분당선,인천논현,4762,4958,9720
5290,20200421,수인분당선,호구포,3089,3175,6264
5291,20200421,수인분당선,남동인더스파크,2214,2484,4698
5292,20200421,수인분당선,원인재,3645,3803,7448
5293,20200421,수인분당선,연수,3621,3712,7333
5294,20200421,수인분당선,송도,2007,1919,3926
5295,20200421,수인분당선,인하대,4381,4134,8515
5296,20200421,수인분당선,숭의,3300,3077,6377
5297,20200421,수인분당선,신포,1432,1438,2870
5298,20200421,수인분당선,인천,731,1180,1911
5299,20200422,수인분당선,선릉,12411,19628,32039
5300,20200422,수인분당선,한티,11358,12001,23359
5301,20200422,수인분당선,도곡,5244,5452,10696
5302,20200422,수인분당선,구룡,1192,1157,2349
5303,20200422,수인분당선,개포동,2834,3075,5909
5304,20200422,수인분당선,대모산입구,3002,2807,5809
5305,20200422,수인분당선,수서,11178,11577,22755
5306,20200422,수인분당선,수원,6513,4556,11069
5307,20200422,수인분당선,서울숲,8015,8130,16145
5308,20200422,수인분당선,압구정로데오,14451,16206,30657
5309,20200422,수인분당선,강남구청,8539,9951,18490
5310,20200422,수인분당선,선정릉,7630,8160,15790
5311,20200422,수인분당선,가천대,6066,7035,13101
5312,20200422,수인분당선,태평,12150,11842,23992
5313,20200422,수인분당선,모란,17493,17708,35201
5314,20200422,수인분당선,야탑,22940,24277,47217
5315,20200422,수인분당선,서현,21000,21253,42253
5316,20200422,수인분당선,수내,10921,11115,22036
5317,20200422,수인분당선,정자,14667,15751,30418
5318,20200422,수인분당선,미금,13732,14619,28351
5319,20200422,수인분당선,오리,10421,8660,19081
5320,20200422,수인분당선,이매,4606,4349,8955
5321,20200422,수인분당선,보정,2081,1735,3816
5322,20200422,수인분당선,죽전,11183,12167,23350
5323,20200422,수인분당선,구성,4120,4224,8344
5324,20200422,수인분당선,신갈,3821,3754,7575
5325,20200422,수인분당선,기흥,7965,7660,15625
5326,20200422,수인분당선,상갈,4473,4247,8720
5327,20200422,수인분당선,청명,3485,3306,6791
5328,20200422,수인분당선,영통,6514,6599,13113
5329,20200422,수인분당선,망포,11415,10864,22279
5330,20200422,수인분당선,매탄권선,3681,3561,7242
5331,20200422,수인분당선,수원시청,9639,10321,19960
5332,20200422,수인분당선,매교,1864,1875,3739
5333,20200422,수인분당선,달월,82,54,136
5334,20200422,수인분당선,월곶,1960,1801,3761
5335,20200422,수인분당선,소래포구,3743,3481,7224
5336,20200422,수인분당선,인천논현,4622,4899,9521
5337,20200422,수인분당선,호구포,3112,3106,6218
5338,20200422,수인분당선,남동인더스파크,2247,2400,4647
5339,20200422,수인분당선,원인재,3560,3562,7122
5340,20200422,수인분당선,연수,3543,3607,7150
5341,20200422,수인분당선,송도,1943,1819,3762
5342,20200422,수인분당선,인하대,4262,4042,8304
5343,20200422,수인분당선,숭의,3187,2956,6143
5344,20200422,수인분당선,신포,1340,1407,2747
5345,20200422,수인분당선,인천,672,1159,1831
5346,20200423,수인분당선,선릉,12665,20120,32785
5347,20200423,수인분당선,한티,11318,12109,23427
5348,20200423,수인분당선,도곡,5440,5492,10932
5349,20200423,수인분당선,구룡,1240,1218,2458
5350,20200423,수인분당선,개포동,2800,3037,5837
5351,20200423,수인분당선,대모산입구,3029,2904,5933
5352,20200423,수인분당선,수서,11690,11922,23612
5353,20200423,수인분당선,수원,6697,4617,11314
5354,20200423,수인분당선,서울숲,8241,8201,16442
5355,20200423,수인분당선,압구정로데오,15034,16769,31803
5356,20200423,수인분당선,강남구청,8484,9791,18275
5357,20200423,수인분당선,선정릉,7600,8140,15740
5358,20200423,수인분당선,가천대,6261,6973,13234
5359,20200423,수인분당선,태평,12349,11950,24299
5360,20200423,수인분당선,모란,17616,17875,35491
5361,20200423,수인분당선,야탑,22978,24104,47082
5362,20200423,수인분당선,서현,21397,21749,43146
5363,20200423,수인분당선,수내,11221,11226,22447
5364,20200423,수인분당선,정자,14977,15859,30836
5365,20200423,수인분당선,미금,13536,14383,27919
5366,20200423,수인분당선,오리,10413,8817,19230
5367,20200423,수인분당선,이매,4558,4302,8860
5368,20200423,수인분당선,보정,2031,1689,3720
5369,20200423,수인분당선,죽전,11436,12522,23958
5370,20200423,수인분당선,구성,4208,4272,8480
5371,20200423,수인분당선,신갈,3919,3823,7742
5372,20200423,수인분당선,기흥,8147,7680,15827
5373,20200423,수인분당선,상갈,4664,4407,9071
5374,20200423,수인분당선,청명,3471,3256,6727
5375,20200423,수인분당선,영통,6588,6744,13332
5376,20200423,수인분당선,망포,11658,11053,22711
5377,20200423,수인분당선,매탄권선,3715,3533,7248
5378,20200423,수인분당선,수원시청,9493,10473,19966
5379,20200423,수인분당선,매교,1924,1934,3858
5380,20200423,수인분당선,달월,84,67,151
5381,20200423,수인분당선,월곶,1972,1836,3808
5382,20200423,수인분당선,소래포구,4854,4634,9488
5383,20200423,수인분당선,인천논현,4766,4977,9743
5384,20200423,수인분당선,호구포,3172,3275,6447
5385,20200423,수인분당선,남동인더스파크,2250,2483,4733
5386,20200423,수인분당선,원인재,3639,3789,7428
5387,20200423,수인분당선,연수,3729,3750,7479
5388,20200423,수인분당선,송도,2099,1964,4063
5389,20200423,수인분당선,인하대,4541,4210,8751
5390,20200423,수인분당선,숭의,3228,3049,6277
5391,20200423,수인분당선,신포,1393,1531,2924
5392,20200423,수인분당선,인천,699,1188,1887
5393,20200424,수인분당선,선릉,12651,20373,33024
5394,20200424,수인분당선,한티,12148,12795,24943
5395,20200424,수인분당선,도곡,5734,5759,11493
5396,20200424,수인분당선,구룡,1365,1289,2654
5397,20200424,수인분당선,개포동,2975,3147,6122
5398,20200424,수인분당선,대모산입구,3074,2903,5977
5399,20200424,수인분당선,수서,13341,13896,27237
5400,20200424,수인분당선,수원,7600,5352,12952
5401,20200424,수인분당선,서울숲,8802,8827,17629
5402,20200424,수인분당선,압구정로데오,16270,19245,35515
5403,20200424,수인분당선,강남구청,8867,10224,19091
5404,20200424,수인분당선,선정릉,7748,8297,16045
5405,20200424,수인분당선,가천대,6627,7029,13656
5406,20200424,수인분당선,태평,13129,12698,25827
5407,20200424,수인분당선,모란,24415,25597,50012
5408,20200424,수인분당선,야탑,24229,25528,49757
5409,20200424,수인분당선,서현,23457,23910,47367
5410,20200424,수인분당선,수내,11769,11771,23540
5411,20200424,수인분당선,정자,15621,16991,32612
5412,20200424,수인분당선,미금,14600,15522,30122
5413,20200424,수인분당선,오리,11126,9286,20412
5414,20200424,수인분당선,이매,4967,4710,9677
5415,20200424,수인분당선,보정,2230,1815,4045
5416,20200424,수인분당선,죽전,12746,13447,26193
5417,20200424,수인분당선,구성,4490,4512,9002
5418,20200424,수인분당선,신갈,4150,4041,8191
5419,20200424,수인분당선,기흥,8623,8158,16781
5420,20200424,수인분당선,상갈,4992,4569,9561
5421,20200424,수인분당선,청명,3704,3421,7125
5422,20200424,수인분당선,영통,7415,7591,15006
5423,20200424,수인분당선,망포,13193,11837,25030
5424,20200424,수인분당선,매탄권선,4296,3871,8167
5425,20200424,수인분당선,수원시청,10342,12979,23321
5426,20200424,수인분당선,매교,2042,2135,4177
5427,20200424,수인분당선,달월,85,55,140
5428,20200424,수인분당선,월곶,2082,1947,4029
5429,20200424,수인분당선,소래포구,5054,4880,9934
5430,20200424,수인분당선,인천논현,5034,5345,10379
5431,20200424,수인분당선,호구포,3324,3252,6576
5432,20200424,수인분당선,남동인더스파크,2123,2331,4454
5433,20200424,수인분당선,원인재,3925,4068,7993
5434,20200424,수인분당선,연수,3866,3891,7757
5435,20200424,수인분당선,송도,2204,2058,4262
5436,20200424,수인분당선,인하대,4552,4251,8803
5437,20200424,수인분당선,숭의,3421,3114,6535
5438,20200424,수인분당선,신포,1456,1539,2995
5439,20200424,수인분당선,인천,743,1301,2044
5440,20200425,수인분당선,선릉,4353,7271,11624
5441,20200425,수인분당선,한티,9348,8994,18342
5442,20200425,수인분당선,도곡,3299,3034,6333
5443,20200425,수인분당선,구룡,707,672,1379
5444,20200425,수인분당선,개포동,1908,1799,3707
5445,20200425,수인분당선,대모산입구,1942,1773,3715
5446,20200425,수인분당선,수서,7715,7782,15497
5447,20200425,수인분당선,수원,5719,3920,9639
5448,20200425,수인분당선,서울숲,6834,7341,14175
5449,20200425,수인분당선,압구정로데오,12571,14826,27397
5450,20200425,수인분당선,강남구청,4248,5330,9578
5451,20200425,수인분당선,선정릉,2946,3128,6074
5452,20200425,수인분당선,가천대,3987,4386,8373
5453,20200425,수인분당선,태평,9283,8601,17884
5454,20200425,수인분당선,모란,14047,14216,28263
5455,20200425,수인분당선,야탑,14884,15801,30685
5456,20200425,수인분당선,서현,15279,15827,31106
5457,20200425,수인분당선,수내,7208,6713,13921
5458,20200425,수인분당선,정자,9192,9349,18541
5459,20200425,수인분당선,미금,9238,9615,18853
5460,20200425,수인분당선,오리,6599,5430,12029
5461,20200425,수인분당선,이매,3307,3143,6450
5462,20200425,수인분당선,보정,1380,1255,2635
5463,20200425,수인분당선,죽전,8577,9581,18158
5464,20200425,수인분당선,구성,2679,2719,5398
5465,20200425,수인분당선,신갈,2345,2291,4636
5466,20200425,수인분당선,기흥,5763,5556,11319
5467,20200425,수인분당선,상갈,3216,3094,6310
5468,20200425,수인분당선,청명,2188,2095,4283
5469,20200425,수인분당선,영통,5467,5392,10859
5470,20200425,수인분당선,망포,7417,6664,14081
5471,20200425,수인분당선,매탄권선,2779,2497,5276
5472,20200425,수인분당선,수원시청,8741,10395,19136
5473,20200425,수인분당선,매교,1349,1374,2723
5474,20200425,수인분당선,달월,74,46,120
5475,20200425,수인분당선,월곶,1655,1632,3287
5476,20200425,수인분당선,소래포구,4969,5110,10079
5477,20200425,수인분당선,인천논현,3890,3895,7785
5478,20200425,수인분당선,호구포,2035,1915,3950
5479,20200425,수인분당선,남동인더스파크,836,813,1649
5480,20200425,수인분당선,원인재,3026,3029,6055
5481,20200425,수인분당선,연수,3268,3287,6555
5482,20200425,수인분당선,송도,1763,1619,3382
5483,20200425,수인분당선,인하대,3225,2969,6194
5484,20200425,수인분당선,숭의,2207,2045,4252
5485,20200425,수인분당선,신포,1118,1268,2386
5486,20200425,수인분당선,인천,765,1246,2011
5487,20200426,수인분당선,선릉,2248,3565,5813
5488,20200426,수인분당선,한티,6573,6287,12860
5489,20200426,수인분당선,도곡,1837,1720,3557
5490,20200426,수인분당선,구룡,432,447,879
5491,20200426,수인분당선,개포동,1309,1279,2588
5492,20200426,수인분당선,대모산입구,1182,1168,2350
5493,20200426,수인분당선,수서,6424,6258,12682
5494,20200426,수인분당선,복정,1,0,1
5495,20200426,수인분당선,수원,4137,2797,6934
5496,20200426,수인분당선,서울숲,5136,5471,10607
5497,20200426,수인분당선,압구정로데오,6956,7887,14843
5498,20200426,수인분당선,강남구청,2576,2967,5543
5499,20200426,수인분당선,선정릉,1643,1683,3326
5500,20200426,수인분당선,가천대,2788,3442,6230
5501,20200426,수인분당선,태평,6752,6265,13017
5502,20200426,수인분당선,모란,9459,9840,19299
5503,20200426,수인분당선,야탑,10619,10931,21550
5504,20200426,수인분당선,서현,10624,10679,21303
5505,20200426,수인분당선,수내,4911,4809,9720
5506,20200426,수인분당선,정자,6099,6354,12453
5507,20200426,수인분당선,미금,5832,6319,12151
5508,20200426,수인분당선,오리,4632,4032,8664
5509,20200426,수인분당선,이매,2227,2259,4486
5510,20200426,수인분당선,보정,926,926,1852
5511,20200426,수인분당선,죽전,5999,6935,12934
5512,20200426,수인분당선,구성,1827,1947,3774
5513,20200426,수인분당선,신갈,1524,1524,3048
5514,20200426,수인분당선,기흥,3960,3985,7945
5515,20200426,수인분당선,상갈,2236,2417,4653
5516,20200426,수인분당선,청명,1532,1451,2983
5517,20200426,수인분당선,영통,3475,3395,6870
5518,20200426,수인분당선,망포,4857,5048,9905
5519,20200426,수인분당선,매탄권선,1816,1774,3590
5520,20200426,수인분당선,수원시청,5850,5746,11596
5521,20200426,수인분당선,매교,891,925,1816
5522,20200426,수인분당선,달월,39,35,74
5523,20200426,수인분당선,월곶,1318,1253,2571
5524,20200426,수인분당선,소래포구,4629,4553,9182
5525,20200426,수인분당선,인천논현,2597,2651,5248
5526,20200426,수인분당선,호구포,1392,1495,2887
5527,20200426,수인분당선,남동인더스파크,460,455,915
5528,20200426,수인분당선,원인재,2277,2367,4644
5529,20200426,수인분당선,연수,2386,2366,4752
5530,20200426,수인분당선,송도,1370,1380,2750
5531,20200426,수인분당선,인하대,2204,2112,4316
5532,20200426,수인분당선,숭의,1573,1508,3081
5533,20200426,수인분당선,신포,934,922,1856
5534,20200426,수인분당선,인천,716,1081,1797
5535,20200427,수인분당선,선릉,12847,20455,33302
5536,20200427,수인분당선,한티,11460,12232,23692
5537,20200427,수인분당선,도곡,5864,5900,11764
5538,20200427,수인분당선,구룡,1246,1267,2513
5539,20200427,수인분당선,개포동,2896,3125,6021
5540,20200427,수인분당선,대모산입구,3059,2898,5957
5541,20200427,수인분당선,수서,12122,12202,24324
5542,20200427,수인분당선,수원,6757,4674,11431
5543,20200427,수인분당선,서울숲,8230,8508,16738
5544,20200427,수인분당선,압구정로데오,14132,15933,30065
5545,20200427,수인분당선,강남구청,8440,9878,18318
5546,20200427,수인분당선,선정릉,7671,8326,15997
5547,20200427,수인분당선,가천대,6433,7327,13760
5548,20200427,수인분당선,태평,12621,12299,24920
5549,20200427,수인분당선,모란,18257,18558,36815
5550,20200427,수인분당선,야탑,23461,24378,47839
5551,20200427,수인분당선,서현,21932,22027,43959
5552,20200427,수인분당선,수내,11264,11402,22666
5553,20200427,수인분당선,정자,15178,16271,31449
5554,20200427,수인분당선,미금,14217,15154,29371
5555,20200427,수인분당선,오리,10664,9131,19795
5556,20200427,수인분당선,이매,4784,4521,9305
5557,20200427,수인분당선,보정,2123,1821,3944
5558,20200427,수인분당선,죽전,11778,12830,24608
5559,20200427,수인분당선,구성,4306,4390,8696
5560,20200427,수인분당선,신갈,3970,3944,7914
5561,20200427,수인분당선,기흥,8515,8079,16594
5562,20200427,수인분당선,상갈,4807,4493,9300
5563,20200427,수인분당선,청명,3494,3309,6803
5564,20200427,수인분당선,영통,6823,6861,13684
5565,20200427,수인분당선,망포,11886,11209,23095
5566,20200427,수인분당선,매탄권선,3855,3687,7542
5567,20200427,수인분당선,수원시청,9833,10670,20503
5568,20200427,수인분당선,매교,2030,2015,4045
5569,20200427,수인분당선,달월,88,63,151
5570,20200427,수인분당선,월곶,2034,1903,3937
5571,20200427,수인분당선,소래포구,4922,4586,9508
5572,20200427,수인분당선,인천논현,4876,5195,10071
5573,20200427,수인분당선,호구포,3198,3203,6401
5574,20200427,수인분당선,남동인더스파크,2072,2339,4411
5575,20200427,수인분당선,원인재,3885,4019,7904
5576,20200427,수인분당선,연수,3809,3795,7604
5577,20200427,수인분당선,송도,2247,2059,4306
5578,20200427,수인분당선,인하대,4532,4314,8846
5579,20200427,수인분당선,숭의,3515,3140,6655
5580,20200427,수인분당선,신포,1426,1556,2982
5581,20200427,수인분당선,인천,750,1228,1978
5582,20200428,수인분당선,선릉,13173,20611,33784
5583,20200428,수인분당선,한티,12044,12550,24594
5584,20200428,수인분당선,도곡,5909,5855,11764
5585,20200428,수인분당선,구룡,1561,1569,3130
5586,20200428,수인분당선,개포동,2962,3100,6062
5587,20200428,수인분당선,대모산입구,3088,2957,6045
5588,20200428,수인분당선,수서,12203,12545,24748
5589,20200428,수인분당선,복정,1,0,1
5590,20200428,수인분당선,수원,6875,4688,11563
5591,20200428,수인분당선,서울숲,8858,9101,17959
5592,20200428,수인분당선,압구정로데오,15494,17455,32949
5593,20200428,수인분당선,강남구청,8773,10129,18902
5594,20200428,수인분당선,선정릉,7868,8509,16377
5595,20200428,수인분당선,가천대,6585,7367,13952
5596,20200428,수인분당선,태평,12723,12297,25020
5597,20200428,수인분당선,모란,18511,18637,37148
5598,20200428,수인분당선,야탑,24073,25245,49318
5599,20200428,수인분당선,서현,22050,22630,44680
5600,20200428,수인분당선,수내,11738,11754,23492
5601,20200428,수인분당선,정자,15569,16677,32246
5602,20200428,수인분당선,미금,14572,15448,30020
5603,20200428,수인분당선,오리,10914,9192,20106
5604,20200428,수인분당선,이매,4796,4588,9384
5605,20200428,수인분당선,보정,2166,1805,3971
5606,20200428,수인분당선,죽전,12241,13130,25371
5607,20200428,수인분당선,구성,4450,4466,8916
5608,20200428,수인분당선,신갈,4058,3982,8040
5609,20200428,수인분당선,기흥,8637,8169,16806
5610,20200428,수인분당선,상갈,4989,4682,9671
5611,20200428,수인분당선,청명,3615,3409,7024
5612,20200428,수인분당선,영통,6826,7048,13874
5613,20200428,수인분당선,망포,12026,11367,23393
5614,20200428,수인분당선,매탄권선,3950,3740,7690
5615,20200428,수인분당선,수원시청,9899,10724,20623
5616,20200428,수인분당선,매교,2055,2038,4093
5617,20200428,수인분당선,달월,85,64,149
5618,20200428,수인분당선,월곶,2084,1912,3996
5619,20200428,수인분당선,소래포구,5025,4850,9875
5620,20200428,수인분당선,인천논현,4904,5101,10005
5621,20200428,수인분당선,호구포,3211,3237,6448
5622,20200428,수인분당선,남동인더스파크,2128,2312,4440
5623,20200428,수인분당선,원인재,3867,3964,7831
5624,20200428,수인분당선,연수,3929,3906,7835
5625,20200428,수인분당선,송도,2181,2118,4299
5626,20200428,수인분당선,인하대,4582,4432,9014
5627,20200428,수인분당선,숭의,3534,3270,6804
5628,20200428,수인분당선,신포,1499,1492,2991
5629,20200428,수인분당선,인천,728,1268,1996
5630,20200429,수인분당선,선릉,12886,20936,33822
5631,20200429,수인분당선,한티,12505,13057,25562
5632,20200429,수인분당선,도곡,5988,6022,12010
5633,20200429,수인분당선,구룡,1318,1363,2681
5634,20200429,수인분당선,개포동,3165,3348,6513
5635,20200429,수인분당선,대모산입구,3245,3099,6344
5636,20200429,수인분당선,수서,13811,15504,29315
5637,20200429,수인분당선,복정,1,0,1
5638,20200429,수인분당선,수원,7759,5419,13178
5639,20200429,수인분당선,서울숲,9689,9680,19369
5640,20200429,수인분당선,압구정로데오,15967,18859,34826
5641,20200429,수인분당선,강남구청,9085,10551,19636
5642,20200429,수인분당선,선정릉,7861,8511,16372
5643,20200429,수인분당선,가천대,6958,7534,14492
5644,20200429,수인분당선,태평,13563,13112,26675
5645,20200429,수인분당선,모란,26171,27371,53542
5646,20200429,수인분당선,야탑,25769,27060,52829
5647,20200429,수인분당선,서현,23999,24500,48499
5648,20200429,수인분당선,수내,12295,12210,24505
5649,20200429,수인분당선,정자,16314,17569,33883
5650,20200429,수인분당선,미금,15847,16825,32672
5651,20200429,수인분당선,오리,11650,9654,21304
5652,20200429,수인분당선,이매,5182,4820,10002
5653,20200429,수인분당선,보정,2331,1904,4235
5654,20200429,수인분당선,죽전,13481,14171,27652
5655,20200429,수인분당선,구성,4656,4678,9334
5656,20200429,수인분당선,신갈,4306,4166,8472
5657,20200429,수인분당선,기흥,9144,8498,17642
5658,20200429,수인분당선,상갈,5241,4791,10032
5659,20200429,수인분당선,청명,3953,3605,7558
5660,20200429,수인분당선,영통,7714,7865,15579
5661,20200429,수인분당선,망포,13422,12048,25470
5662,20200429,수인분당선,매탄권선,4411,3941,8352
5663,20200429,수인분당선,수원시청,10512,12699,23211
5664,20200429,수인분당선,매교,2020,2071,4091
5665,20200429,수인분당선,달월,79,64,143
5666,20200429,수인분당선,월곶,2259,2082,4341
5667,20200429,수인분당선,소래포구,5204,4888,10092
5668,20200429,수인분당선,인천논현,5313,5554,10867
5669,20200429,수인분당선,호구포,3285,3299,6584
5670,20200429,수인분당선,남동인더스파크,2194,2333,4527
5671,20200429,수인분당선,원인재,4125,4154,8279
5672,20200429,수인분당선,연수,4050,4132,8182
5673,20200429,수인분당선,송도,2302,2168,4470
5674,20200429,수인분당선,인하대,4869,4539,9408
5675,20200429,수인분당선,숭의,3611,3261,6872
5676,20200429,수인분당선,신포,1512,1679,3191
5677,20200429,수인분당선,인천,784,1368,2152
5678,20200430,수인분당선,선릉,3177,5030,8207
5679,20200430,수인분당선,한티,6865,6675,13540
5680,20200430,수인분당선,도곡,2644,2437,5081
5681,20200430,수인분당선,구룡,663,625,1288
5682,20200430,수인분당선,개포동,1666,1602,3268
5683,20200430,수인분당선,대모산입구,1729,1528,3257
5684,20200430,수인분당선,수서,6600,8887,15487
5685,20200430,수인분당선,수원,4978,3516,8494
5686,20200430,수인분당선,서울숲,7249,8044,15293
5687,20200430,수인분당선,압구정로데오,9851,11792,21643
5688,20200430,수인분당선,강남구청,3188,4121,7309
5689,20200430,수인분당선,선정릉,2343,2428,4771
5690,20200430,수인분당선,가천대,3766,3928,7694
5691,20200430,수인분당선,태평,8662,7948,16610
5692,20200430,수인분당선,모란,12323,12552,24875
5693,20200430,수인분당선,야탑,13193,14107,27300
5694,20200430,수인분당선,서현,13401,13695,27096
5695,20200430,수인분당선,수내,6264,6054,12318
5696,20200430,수인분당선,정자,8076,8027,16103
5697,20200430,수인분당선,미금,8176,8281,16457
5698,20200430,수인분당선,오리,5771,4614,10385
5699,20200430,수인분당선,이매,3030,2891,5921
5700,20200430,수인분당선,보정,1176,1032,2208
5701,20200430,수인분당선,죽전,8377,8912,17289
5702,20200430,수인분당선,구성,2513,2539,5052
5703,20200430,수인분당선,신갈,2147,2121,4268
5704,20200430,수인분당선,기흥,5278,4896,10174
5705,20200430,수인분당선,상갈,3094,2960,6054
5706,20200430,수인분당선,청명,1970,1801,3771
5707,20200430,수인분당선,영통,4547,4542,9089
5708,20200430,수인분당선,망포,6687,5799,12486
5709,20200430,수인분당선,매탄권선,2423,2221,4644
5710,20200430,수인분당선,수원시청,6101,6877,12978
5711,20200430,수인분당선,매교,1165,1225,2390
5712,20200430,수인분당선,달월,62,54,116
5713,20200430,수인분당선,월곶,1744,1546,3290
5714,20200430,수인분당선,소래포구,5900,6016,11916
5715,20200430,수인분당선,인천논현,3380,3360,6740
5716,20200430,수인분당선,호구포,1895,1696,3591
5717,20200430,수인분당선,남동인더스파크,775,736,1511
5718,20200430,수인분당선,원인재,2782,2896,5678
5719,20200430,수인분당선,연수,2909,2932,5841
5720,20200430,수인분당선,송도,1814,1708,3522
5721,20200430,수인분당선,인하대,3101,2878,5979
5722,20200430,수인분당선,숭의,2033,1908,3941
5723,20200430,수인분당선,신포,1155,1230,2385
5724,20200430,수인분당선,인천,920,1654,2574
5725,20200501,수인분당선,인천,1012,1612,2624
5726,20200501,수인분당선,신포,1235,1410,2645
5727,20200501,수인분당선,숭의,2251,2023,4274
5728,20200501,수인분당선,인하대,3357,3151,6508
5729,20200501,수인분당선,송도,1733,1627,3360
5730,20200501,수인분당선,연수,3286,3213,6499
5731,20200501,수인분당선,원인재,3058,3084,6142
5732,20200501,수인분당선,남동인더스파크,698,670,1368
5733,20200501,수인분당선,호구포,1881,1756,3637
5734,20200501,수인분당선,인천논현,3844,4026,7870
5735,20200501,수인분당선,소래포구,5744,5675,11419
5736,20200501,수인분당선,월곶,1707,1644,3351
5737,20200501,수인분당선,달월,43,37,80
5738,20200501,수인분당선,매교,1327,1367,2694
5739,20200501,수인분당선,수원시청,7202,8555,15757
5740,20200501,수인분당선,매탄권선,2589,2359,4948
5741,20200501,수인분당선,망포,7062,6484,13546
5742,20200501,수인분당선,영통,5566,5398,10964
5743,20200501,수인분당선,청명,2185,2107,4292
5744,20200501,수인분당선,상갈,3314,3112,6426
5745,20200501,수인분당선,기흥,5644,5521,11165
5746,20200501,수인분당선,신갈,2402,2298,4700
5747,20200501,수인분당선,구성,2778,2833,5611
5748,20200501,수인분당선,죽전,8719,9677,18396
5749,20200501,수인분당선,보정,1250,1098,2348
5750,20200501,수인분당선,이매,3214,3147,6361
5751,20200501,수인분당선,오리,6409,5290,11699
5752,20200501,수인분당선,미금,9759,10036,19795
5753,20200501,수인분당선,정자,8671,8902,17573
5754,20200501,수인분당선,수내,7148,6892,14040
5755,20200501,수인분당선,서현,15344,15749,31093
5756,20200501,수인분당선,야탑,15279,16143,31422
5757,20200501,수인분당선,모란,13566,14034,27600
5758,20200501,수인분당선,태평,9577,8824,18401
5759,20200501,수인분당선,가천대,4533,4648,9181
5760,20200501,수인분당선,선정릉,2816,2919,5735
5761,20200501,수인분당선,강남구청,4141,4961,9102
5762,20200501,수인분당선,압구정로데오,11079,13242,24321
5763,20200501,수인분당선,서울숲,6455,6846,13301
5764,20200501,수인분당선,수원,5603,2995,8598
5765,20200501,수인분당선,수서,7668,8724,16392
5766,20200501,수인분당선,대모산입구,1675,1566,3241
5767,20200501,수인분당선,개포동,1982,1987,3969
5768,20200501,수인분당선,구룡,681,708,1389
5769,20200501,수인분당선,도곡,3513,3281,6794
5770,20200501,수인분당선,한티,8385,8670,17055
5771,20200501,수인분당선,선릉,4325,6839,11164
5772,20200502,수인분당선,모란,12876,13607,26483
5773,20200502,수인분당선,가천대,3661,4038,7699
5774,20200502,수인분당선,태평,8928,8478,17406
5775,20200502,수인분당선,선정릉,2583,2626,5209
5776,20200502,수인분당선,강남구청,3672,4468,8140
5777,20200502,수인분당선,압구정로데오,10855,12837,23692
5778,20200502,수인분당선,서울숲,6302,6860,13162
5779,20200502,수인분당선,수원,5314,3132,8446
5780,20200502,수인분당선,수서,8345,8112,16457
5781,20200502,수인분당선,대모산입구,1692,1545,3237
5782,20200502,수인분당선,개포동,1806,1778,3584
5783,20200502,수인분당선,구룡,677,651,1328
5784,20200502,수인분당선,도곡,3054,2816,5870
5785,20200502,수인분당선,한티,9146,8630,17776
5786,20200502,수인분당선,선릉,3740,5877,9617
5787,20200502,수인분당선,야탑,14215,14874,29089
5788,20200502,수인분당선,서현,14545,15004,29549
5789,20200502,수인분당선,수내,7116,6629,13745
5790,20200502,수인분당선,정자,8517,8811,17328
5791,20200502,수인분당선,미금,8950,9343,18293
5792,20200502,수인분당선,오리,6207,5257,11464
5793,20200502,수인분당선,이매,3192,3123,6315
5794,20200502,수인분당선,보정,1160,1087,2247
5795,20200502,수인분당선,죽전,8268,9215,17483
5796,20200502,수인분당선,구성,2660,2575,5235
5797,20200502,수인분당선,신갈,2194,2179,4373
5798,20200502,수인분당선,기흥,5395,5096,10491
5799,20200502,수인분당선,상갈,3098,3097,6195
5800,20200502,수인분당선,청명,1931,2022,3953
5801,20200502,수인분당선,영통,4857,4798,9655
5802,20200502,수인분당선,망포,6394,5893,12287
5803,20200502,수인분당선,매탄권선,2390,2176,4566
5804,20200502,수인분당선,수원시청,7559,8829,16388
5805,20200502,수인분당선,매교,1217,1253,2470
5806,20200502,수인분당선,달월,64,68,132
5807,20200502,수인분당선,월곶,1675,1558,3233
5808,20200502,수인분당선,소래포구,4764,4859,9623
5809,20200502,수인분당선,인천논현,3722,3836,7558
5810,20200502,수인분당선,호구포,1798,1721,3519
5811,20200502,수인분당선,남동인더스파크,658,646,1304
5812,20200502,수인분당선,원인재,2945,2977,5922
5813,20200502,수인분당선,연수,3010,3141,6151
5814,20200502,수인분당선,송도,1684,1565,3249
5815,20200502,수인분당선,인하대,2959,2844,5803
5816,20200502,수인분당선,숭의,2091,1829,3920
5817,20200502,수인분당선,신포,1225,1272,2497
5818,20200502,수인분당선,인천,1000,1552,2552
5819,20200503,수인분당선,인천,887,1269,2156
5820,20200503,수인분당선,신포,1070,989,2059
5821,20200503,수인분당선,숭의,1647,1448,3095
5822,20200503,수인분당선,인하대,2294,2300,4594
5823,20200503,수인분당선,송도,1412,1371,2783
5824,20200503,수인분당선,연수,2452,2419,4871
5825,20200503,수인분당선,원인재,2248,2352,4600
5826,20200503,수인분당선,남동인더스파크,438,463,901
5827,20200503,수인분당선,호구포,1373,1451,2824
5828,20200503,수인분당선,인천논현,2670,2773,5443
5829,20200503,수인분당선,소래포구,4560,4577,9137
5830,20200503,수인분당선,월곶,1399,1274,2673
5831,20200503,수인분당선,달월,39,47,86
5832,20200503,수인분당선,매교,968,944,1912
5833,20200503,수인분당선,수원시청,5136,5481,10617
5834,20200503,수인분당선,매탄권선,1932,1890,3822
5835,20200503,수인분당선,망포,4804,4941,9745
5836,20200503,수인분당선,영통,3673,3697,7370
5837,20200503,수인분당선,청명,1503,1442,2945
5838,20200503,수인분당선,상갈,2298,2372,4670
5839,20200503,수인분당선,기흥,4041,3988,8029
5840,20200503,수인분당선,신갈,1573,1573,3146
5841,20200503,수인분당선,구성,1968,2176,4144
5842,20200503,수인분당선,죽전,6573,7571,14144
5843,20200503,수인분당선,보정,856,829,1685
5844,20200503,수인분당선,이매,2464,2400,4864
5845,20200503,수인분당선,오리,4577,3975,8552
5846,20200503,수인분당선,미금,6060,6563,12623
5847,20200503,수인분당선,정자,5805,6203,12008
5848,20200503,수인분당선,수내,5121,4948,10069
5849,20200503,수인분당선,서현,10964,11353,22317
5850,20200503,수인분당선,야탑,11146,11480,22626
5851,20200503,수인분당선,모란,9728,10031,19759
5852,20200503,수인분당선,태평,6807,6385,13192
5853,20200503,수인분당선,가천대,2749,3480,6229
5854,20200503,수인분당선,선정릉,1798,1805,3603
5855,20200503,수인분당선,강남구청,2447,2888,5335
5856,20200503,수인분당선,압구정로데오,6413,7376,13789
5857,20200503,수인분당선,서울숲,4842,5095,9937
5858,20200503,수인분당선,수원,4170,2293,6463
5859,20200503,수인분당선,복정,1,0,1
5860,20200503,수인분당선,수서,7920,6495,14415
5861,20200503,수인분당선,대모산입구,1520,1479,2999
5862,20200503,수인분당선,개포동,1376,1350,2726
5863,20200503,수인분당선,구룡,503,529,1032
5864,20200503,수인분당선,도곡,1967,1906,3873
5865,20200503,수인분당선,한티,6836,6641,13477
5866,20200503,수인분당선,선릉,2078,3308,5386
5867,20200504,수인분당선,인천,894,1481,2375
5868,20200504,수인분당선,신포,1479,1503,2982
5869,20200504,수인분당선,숭의,3184,2847,6031
5870,20200504,수인분당선,인하대,4134,3899,8033
5871,20200504,수인분당선,송도,2130,2018,4148
5872,20200504,수인분당선,연수,3854,3870,7724
5873,20200504,수인분당선,원인재,3638,3674,7312
5874,20200504,수인분당선,남동인더스파크,1383,1523,2906
5875,20200504,수인분당선,호구포,2630,2632,5262
5876,20200504,수인분당선,인천논현,4805,5020,9825
5877,20200504,수인분당선,소래포구,4807,4669,9476
5878,20200504,수인분당선,월곶,1953,1825,3778
5879,20200504,수인분당선,달월,56,43,99
5880,20200504,수인분당선,매교,1819,1823,3642
5881,20200504,수인분당선,수원시청,9721,11703,21424
5882,20200504,수인분당선,매탄권선,3462,3219,6681
5883,20200504,수인분당선,망포,10168,9452,19620
5884,20200504,수인분당선,영통,6797,7044,13841
5885,20200504,수인분당선,청명,3140,2897,6037
5886,20200504,수인분당선,상갈,4345,4096,8441
5887,20200504,수인분당선,기흥,7636,7119,14755
5888,20200504,수인분당선,신갈,3757,3581,7338
5889,20200504,수인분당선,구성,3857,3880,7737
5890,20200504,수인분당선,죽전,11192,12259,23451
5891,20200504,수인분당선,보정,1905,1623,3528
5892,20200504,수인분당선,이매,4488,4161,8649
5893,20200504,수인분당선,오리,9264,7778,17042
5894,20200504,수인분당선,미금,13968,14758,28726
5895,20200504,수인분당선,정자,12864,13834,26698
5896,20200504,수인분당선,수내,9842,9966,19808
5897,20200504,수인분당선,서현,21300,21666,42966
5898,20200504,수인분당선,야탑,21270,22222,43492
5899,20200504,수인분당선,모란,22917,24400,47317
5900,20200504,수인분당선,태평,12405,11879,24284
5901,20200504,수인분당선,가천대,5965,6571,12536
5902,20200504,수인분당선,선정릉,5379,5828,11207
5903,20200504,수인분당선,강남구청,6704,7654,14358
5904,20200504,수인분당선,압구정로데오,12498,14655,27153
5905,20200504,수인분당선,서울숲,7840,7946,15786
5906,20200504,수인분당선,수원,6852,4322,11174
5907,20200504,수인분당선,수서,11110,10298,21408
5908,20200504,수인분당선,대모산입구,2919,2636,5555
5909,20200504,수인분당선,개포동,2708,2795,5503
5910,20200504,수인분당선,구룡,1129,1052,2181
5911,20200504,수인분당선,도곡,5052,4908,9960
5912,20200504,수인분당선,한티,10976,11425,22401
5913,20200504,수인분당선,선릉,9113,14805,23918
5914,20200505,수인분당선,청명,1631,1542,3173
5915,20200505,수인분당선,선릉,2620,4279,6899
5916,20200505,수인분당선,한티,6292,6446,12738
5917,20200505,수인분당선,도곡,2388,2327,4715
5918,20200505,수인분당선,구룡,547,612,1159
5919,20200505,수인분당선,개포동,1428,1378,2806
5920,20200505,수인분당선,대모산입구,1540,1465,3005
5921,20200505,수인분당선,수서,7394,6098,13492
5922,20200505,수인분당선,복정,1,0,1
5923,20200505,수인분당선,수원,4333,2638,6971
5924,20200505,수인분당선,서울숲,5607,6041,11648
5925,20200505,수인분당선,압구정로데오,8195,9453,17648
5926,20200505,수인분당선,강남구청,2790,3345,6135
5927,20200505,수인분당선,선정릉,1942,2038,3980
5928,20200505,수인분당선,가천대,3369,3917,7286
5929,20200505,수인분당선,태평,7715,7431,15146
5930,20200505,수인분당선,모란,10806,11259,22065
5931,20200505,수인분당선,야탑,11751,12239,23990
5932,20200505,수인분당선,서현,12486,12623,25109
5933,20200505,수인분당선,수내,5538,5606,11144
5934,20200505,수인분당선,정자,6867,7149,14016
5935,20200505,수인분당선,미금,7298,7868,15166
5936,20200505,수인분당선,오리,4967,4253,9220
5937,20200505,수인분당선,이매,2483,2514,4997
5938,20200505,수인분당선,보정,912,835,1747
5939,20200505,수인분당선,죽전,7162,8221,15383
5940,20200505,수인분당선,구성,2123,2262,4385
5941,20200505,수인분당선,신갈,1865,1854,3719
5942,20200505,수인분당선,기흥,4626,4453,9079
5943,20200505,수인분당선,인천,920,1464,2384
5944,20200505,수인분당선,신포,1033,1057,2090
5945,20200505,수인분당선,숭의,1747,1576,3323
5946,20200505,수인분당선,인하대,2623,2515,5138
5947,20200505,수인분당선,송도,1377,1389,2766
5948,20200505,수인분당선,연수,2608,2583,5191
5949,20200505,수인분당선,원인재,2393,2543,4936
5950,20200505,수인분당선,남동인더스파크,489,572,1061
5951,20200505,수인분당선,호구포,1503,1531,3034
5952,20200505,수인분당선,인천논현,2954,3110,6064
5953,20200505,수인분당선,소래포구,4742,4711,9453
5954,20200505,수인분당선,월곶,1435,1354,2789
5955,20200505,수인분당선,달월,45,41,86
5956,20200505,수인분당선,매교,1028,973,2001
5957,20200505,수인분당선,수원시청,5269,5504,10773
5958,20200505,수인분당선,매탄권선,2037,1930,3967
5959,20200505,수인분당선,망포,5195,5353,10548
5960,20200505,수인분당선,영통,3882,3964,7846
5961,20200505,수인분당선,상갈,2711,2748,5459
5962,20200506,수인분당선,선릉,13377,21151,34528
5963,20200506,수인분당선,한티,12596,13432,26028
5964,20200506,수인분당선,도곡,6124,6231,12355
5965,20200506,수인분당선,구룡,1327,1368,2695
5966,20200506,수인분당선,개포동,3326,3474,6800
5967,20200506,수인분당선,대모산입구,3265,3102,6367
5968,20200506,수인분당선,수서,12679,12657,25336
5969,20200506,수인분당선,복정,1,0,1
5970,20200506,수인분당선,수원,7445,4766,12211
5971,20200506,수인분당선,서울숲,9302,9503,18805
5972,20200506,수인분당선,압구정로데오,15681,17609,33290
5973,20200506,수인분당선,강남구청,9112,10587,19699
5974,20200506,수인분당선,선정릉,8228,8832,17060
5975,20200506,수인분당선,가천대,6790,7633,14423
5976,20200506,수인분당선,태평,13257,12918,26175
5977,20200506,수인분당선,모란,19292,19458,38750
5978,20200506,수인분당선,야탑,25164,26446,51610
5979,20200506,수인분당선,서현,23870,24304,48174
5980,20200506,수인분당선,수내,12377,12528,24905
5981,20200506,수인분당선,정자,16198,17535,33733
5982,20200506,수인분당선,미금,15413,16353,31766
5983,20200506,수인분당선,오리,11604,9758,21362
5984,20200506,수인분당선,이매,5195,4835,10030
5985,20200506,수인분당선,보정,2361,1969,4330
5986,20200506,수인분당선,죽전,12929,14061,26990
5987,20200506,수인분당선,구성,4805,4852,9657
5988,20200506,수인분당선,신갈,4444,4332,8776
5989,20200506,수인분당선,기흥,9162,8719,17881
5990,20200506,수인분당선,상갈,5183,4887,10070
5991,20200506,수인분당선,청명,3930,3663,7593
5992,20200506,수인분당선,영통,7477,7716,15193
5993,20200506,수인분당선,망포,12614,12004,24618
5994,20200506,수인분당선,매탄권선,4050,3904,7954
5995,20200506,수인분당선,수원시청,10401,11291,21692
5996,20200506,수인분당선,매교,2186,2181,4367
5997,20200506,수인분당선,달월,87,54,141
5998,20200506,수인분당선,월곶,2187,2061,4248
5999,20200506,수인분당선,소래포구,5695,5444,11139
6000,20200506,수인분당선,인천논현,5190,5624,10814
6001,20200506,수인분당선,호구포,3322,3343,6665
6002,20200506,수인분당선,남동인더스파크,2206,2386,4592
6003,20200506,수인분당선,원인재,4094,4218,8312
6004,20200506,수인분당선,연수,4185,4084,8269
6005,20200506,수인분당선,송도,2385,2219,4604
6006,20200506,수인분당선,인하대,4854,4604,9458
6007,20200506,수인분당선,숭의,3517,3337,6854
6008,20200506,수인분당선,신포,1577,1617,3194
6009,20200506,수인분당선,인천,879,1489,2368
6010,20200507,수인분당선,선릉,13390,21166,34556
6011,20200507,수인분당선,한티,12616,13465,26081
6012,20200507,수인분당선,도곡,6219,6332,12551
6013,20200507,수인분당선,구룡,1374,1286,2660
6014,20200507,수인분당선,개포동,3131,3367,6498
6015,20200507,수인분당선,대모산입구,3398,3150,6548
6016,20200507,수인분당선,수서,13035,13477,26512
6017,20200507,수인분당선,수원,7503,5215,12718
6018,20200507,수인분당선,서울숲,9275,9411,18686
6019,20200507,수인분당선,압구정로데오,15925,18148,34073
6020,20200507,수인분당선,강남구청,9218,10801,20019
6021,20200507,수인분당선,선정릉,8123,8801,16924
6022,20200507,수인분당선,가천대,6983,7755,14738
6023,20200507,수인분당선,태평,13448,13061,26509
6024,20200507,수인분당선,모란,19398,19599,38997
6025,20200507,수인분당선,야탑,25647,26949,52596
6026,20200507,수인분당선,서현,24441,24637,49078
6027,20200507,수인분당선,수내,12437,12745,25182
6028,20200507,수인분당선,정자,16605,17866,34471
6029,20200507,수인분당선,미금,15594,16530,32124
6030,20200507,수인분당선,오리,11465,9727,21192
6031,20200507,수인분당선,이매,5241,4904,10145
6032,20200507,수인분당선,보정,2389,2017,4406
6033,20200507,수인분당선,죽전,13378,14290,27668
6034,20200507,수인분당선,구성,4770,4877,9647
6035,20200507,수인분당선,신갈,4452,4367,8819
6036,20200507,수인분당선,기흥,9240,8759,17999
6037,20200507,수인분당선,상갈,5268,4952,10220
6038,20200507,수인분당선,청명,3963,3664,7627
6039,20200507,수인분당선,영통,7747,7799,15546
6040,20200507,수인분당선,망포,12901,12149,25050
6041,20200507,수인분당선,매탄권선,4277,4005,8282
6042,20200507,수인분당선,수원시청,10351,11381,21732
6043,20200507,수인분당선,매교,2084,2043,4127
6044,20200507,수인분당선,달월,75,50,125
6045,20200507,수인분당선,월곶,2171,2072,4243
6046,20200507,수인분당선,소래포구,6582,6277,12859
6047,20200507,수인분당선,인천논현,5378,5602,10980
6048,20200507,수인분당선,호구포,3450,3393,6843
6049,20200507,수인분당선,남동인더스파크,2185,2388,4573
6050,20200507,수인분당선,원인재,4257,4268,8525
6051,20200507,수인분당선,연수,4135,4114,8249
6052,20200507,수인분당선,송도,2403,2294,4697
6053,20200507,수인분당선,인하대,4865,4703,9568
6054,20200507,수인분당선,숭의,3573,3360,6933
6055,20200507,수인분당선,신포,1571,1648,3219
6056,20200507,수인분당선,인천,855,1368,2223
6057,20200508,수인분당선,선릉,13659,20717,34376
6058,20200508,수인분당선,한티,13555,14342,27897
6059,20200508,수인분당선,도곡,6409,6731,13140
6060,20200508,수인분당선,구룡,1312,1334,2646
6061,20200508,수인분당선,개포동,3297,3555,6852
6062,20200508,수인분당선,대모산입구,3293,3187,6480
6063,20200508,수인분당선,수서,14364,15735,30099
6064,20200508,수인분당선,수원,8031,5727,13758
6065,20200508,수인분당선,서울숲,9292,9133,18425
6066,20200508,수인분당선,압구정로데오,17421,19307,36728
6067,20200508,수인분당선,강남구청,9861,10959,20820
6068,20200508,수인분당선,선정릉,8589,8847,17436
6069,20200508,수인분당선,가천대,7158,7464,14622
6070,20200508,수인분당선,태평,13505,13486,26991
6071,20200508,수인분당선,모란,19691,19955,39646
6072,20200508,수인분당선,야탑,26010,28196,54206
6073,20200508,수인분당선,서현,24876,25484,50360
6074,20200508,수인분당선,수내,12747,12848,25595
6075,20200508,수인분당선,정자,16680,18175,34855
6076,20200508,수인분당선,미금,15503,16607,32110
6077,20200508,수인분당선,오리,11690,9795,21485
6078,20200508,수인분당선,이매,5223,5009,10232
6079,20200508,수인분당선,보정,2299,1943,4242
6080,20200508,수인분당선,죽전,13836,14619,28455
6081,20200508,수인분당선,구성,4861,4950,9811
6082,20200508,수인분당선,신갈,4501,4460,8961
6083,20200508,수인분당선,기흥,9480,9017,18497
6084,20200508,수인분당선,상갈,5363,5000,10363
6085,20200508,수인분당선,청명,4049,3847,7896
6086,20200508,수인분당선,영통,8043,8253,16296
6087,20200508,수인분당선,망포,13800,12738,26538
6088,20200508,수인분당선,매탄권선,4451,4216,8667
6089,20200508,수인분당선,수원시청,10605,12518,23123
6090,20200508,수인분당선,매교,2192,2171,4363
6091,20200508,수인분당선,달월,87,55,142
6092,20200508,수인분당선,월곶,2214,2133,4347
6093,20200508,수인분당선,소래포구,5412,5272,10684
6094,20200508,수인분당선,인천논현,5460,5769,11229
6095,20200508,수인분당선,호구포,3474,3505,6979
6096,20200508,수인분당선,남동인더스파크,2273,2355,4628
6097,20200508,수인분당선,인천,850,1376,2226
6098,20200508,수인분당선,신포,1553,1652,3205
6099,20200508,수인분당선,숭의,3596,3289,6885
6100,20200508,수인분당선,인하대,4970,4679,9649
6101,20200508,수인분당선,송도,2283,2230,4513
6102,20200508,수인분당선,연수,4091,4255,8346
6103,20200508,수인분당선,원인재,4107,4320,8427
6104,20200509,수인분당선,선릉,4396,7402,11798
6105,20200509,수인분당선,한티,9800,9287,19087
6106,20200509,수인분당선,도곡,3413,3133,6546
6107,20200509,수인분당선,구룡,968,880,1848
6108,20200509,수인분당선,개포동,1935,1923,3858
6109,20200509,수인분당선,대모산입구,1974,1717,3691
6110,20200509,수인분당선,수서,8497,8729,17226
6111,20200509,수인분당선,수원,5202,3495,8697
6112,20200509,수인분당선,서울숲,4553,4639,9192
6113,20200509,수인분당선,압구정로데오,11723,13545,25268
6114,20200509,수인분당선,강남구청,4194,5218,9412
6115,20200509,수인분당선,선정릉,3198,3396,6594
6116,20200509,수인분당선,가천대,3719,4263,7982
6117,20200509,수인분당선,태평,9091,8586,17677
6118,20200509,수인분당선,모란,15162,15953,31115
6119,20200509,수인분당선,야탑,14557,15319,29876
6120,20200509,수인분당선,서현,14736,14979,29715
6121,20200509,수인분당선,수내,6972,6581,13553
6122,20200509,수인분당선,정자,8710,8833,17543
6123,20200509,수인분당선,미금,8898,9277,18175
6124,20200509,수인분당선,오리,6043,4943,10986
6125,20200509,수인분당선,이매,3364,2970,6334
6126,20200509,수인분당선,보정,1200,1137,2337
6127,20200509,수인분당선,죽전,7727,8784,16511
6128,20200509,수인분당선,구성,2597,2595,5192
6129,20200509,수인분당선,신갈,2112,2108,4220
6130,20200509,수인분당선,기흥,5267,4957,10224
6131,20200509,수인분당선,상갈,2902,2870,5772
6132,20200509,수인분당선,청명,2231,2115,4346
6133,20200509,수인분당선,영통,5115,5193,10308
6134,20200509,수인분당선,망포,7101,6375,13476
6135,20200509,수인분당선,매탄권선,2523,2271,4794
6136,20200509,수인분당선,수원시청,7913,9435,17348
6137,20200509,수인분당선,매교,1180,1183,2363
6138,20200509,수인분당선,달월,35,28,63
6139,20200509,수인분당선,월곶,1431,1361,2792
6140,20200509,수인분당선,소래포구,3149,3287,6436
6141,20200509,수인분당선,인천논현,3483,3534,7017
6142,20200509,수인분당선,호구포,1843,1807,3650
6143,20200509,수인분당선,남동인더스파크,715,733,1448
6144,20200509,수인분당선,원인재,2653,2701,5354
6145,20200509,수인분당선,연수,2846,3040,5886
6146,20200509,수인분당선,송도,1442,1439,2881
6147,20200509,수인분당선,인하대,2733,2522,5255
6148,20200509,수인분당선,숭의,1868,1757,3625
6149,20200509,수인분당선,신포,996,996,1992
6150,20200509,수인분당선,인천,565,949,1514
6151,20200510,수인분당선,선릉,2359,3777,6136
6152,20200510,수인분당선,한티,7072,6892,13964
6153,20200510,수인분당선,도곡,2004,2053,4057
6154,20200510,수인분당선,구룡,490,492,982
6155,20200510,수인분당선,개포동,1420,1574,2994
6156,20200510,수인분당선,대모산입구,1299,1246,2545
6157,20200510,수인분당선,수서,7822,6806,14628
6158,20200510,수인분당선,복정,2,0,2
6159,20200510,수인분당선,수원,4428,3011,7439
6160,20200510,수인분당선,서울숲,4387,4640,9027
6161,20200510,수인분당선,압구정로데오,7147,8016,15163
6162,20200510,수인분당선,강남구청,2549,3178,5727
6163,20200510,수인분당선,선정릉,1932,2114,4046
6164,20200510,수인분당선,가천대,3010,3928,6938
6165,20200510,수인분당선,태평,7050,6685,13735
6166,20200510,수인분당선,모란,9872,10196,20068
6167,20200510,수인분당선,야탑,11727,12080,23807
6168,20200510,수인분당선,서현,11648,11736,23384
6169,20200510,수인분당선,수내,5159,5017,10176
6170,20200510,수인분당선,정자,6179,6528,12707
6171,20200510,수인분당선,미금,6113,6623,12736
6172,20200510,수인분당선,오리,4760,4092,8852
6173,20200510,수인분당선,이매,2446,2576,5022
6174,20200510,수인분당선,보정,880,830,1710
6175,20200510,수인분당선,죽전,6549,7542,14091
6176,20200510,수인분당선,구성,1975,2059,4034
6177,20200510,수인분당선,신갈,1661,1691,3352
6178,20200510,수인분당선,기흥,4226,3911,8137
6179,20200510,수인분당선,상갈,2427,2515,4942
6180,20200510,수인분당선,청명,1581,1581,3162
6181,20200510,수인분당선,영통,3661,3737,7398
6182,20200510,수인분당선,망포,5146,5452,10598
6183,20200510,수인분당선,매탄권선,1914,1888,3802
6184,20200510,수인분당선,수원시청,5800,5935,11735
6185,20200510,수인분당선,매교,960,950,1910
6186,20200510,수인분당선,달월,34,29,63
6187,20200510,수인분당선,월곶,1333,1242,2575
6188,20200510,수인분당선,소래포구,3794,3652,7446
6189,20200510,수인분당선,인천논현,2769,2820,5589
6190,20200510,수인분당선,호구포,1527,1573,3100
6191,20200510,수인분당선,남동인더스파크,503,520,1023
6192,20200510,수인분당선,원인재,2349,2439,4788
6193,20200510,수인분당선,연수,2666,2564,5230
6194,20200510,수인분당선,송도,1327,1324,2651
6195,20200510,수인분당선,인하대,2319,2326,4645
6196,20200510,수인분당선,숭의,1662,1594,3256
6197,20200510,수인분당선,신포,986,945,1931
6198,20200510,수인분당선,인천,821,1239,2060
6199,20200511,수인분당선,인천,865,1404,2269
6200,20200511,수인분당선,신포,1544,1627,3171
6201,20200511,수인분당선,숭의,3595,3355,6950
6202,20200511,수인분당선,인하대,4919,4668,9587
6203,20200511,수인분당선,송도,2310,2154,4464
6204,20200511,수인분당선,연수,4087,4088,8175
6205,20200511,수인분당선,원인재,3931,4143,8074
6206,20200511,수인분당선,남동인더스파크,2186,2409,4595
6207,20200511,수인분당선,호구포,3300,3403,6703
6208,20200511,수인분당선,인천논현,5291,5458,10749
6209,20200511,수인분당선,소래포구,4937,4477,9414
6210,20200511,수인분당선,월곶,2105,2055,4160
6211,20200511,수인분당선,달월,82,46,128
6212,20200511,수인분당선,매교,2217,2197,4414
6213,20200511,수인분당선,수원시청,10088,10934,21022
6214,20200511,수인분당선,매탄권선,4066,3917,7983
6215,20200511,수인분당선,망포,12437,11866,24303
6216,20200511,수인분당선,영통,7344,7652,14996
6217,20200511,수인분당선,청명,3843,3582,7425
6218,20200511,수인분당선,상갈,5091,4806,9897
6219,20200511,수인분당선,기흥,9019,8489,17508
6220,20200511,수인분당선,신갈,4354,4148,8502
6221,20200511,수인분당선,구성,4597,4841,9438
6222,20200511,수인분당선,죽전,12339,13516,25855
6223,20200511,수인분당선,보정,2302,1940,4242
6224,20200511,수인분당선,이매,5015,4708,9723
6225,20200511,수인분당선,오리,11174,9304,20478
6226,20200511,수인분당선,미금,14790,15701,30491
6227,20200511,수인분당선,정자,15814,17033,32847
6228,20200511,수인분당선,수내,11790,11834,23624
6229,20200511,수인분당선,서현,23080,23349,46429
6230,20200511,수인분당선,야탑,24534,25693,50227
6231,20200511,수인분당선,모란,18824,19185,38009
6232,20200511,수인분당선,태평,13004,12794,25798
6233,20200511,수인분당선,가천대,7083,8054,15137
6234,20200511,수인분당선,선정릉,8067,8631,16698
6235,20200511,수인분당선,강남구청,9003,10385,19388
6236,20200511,수인분당선,압구정로데오,14584,16286,30870
6237,20200511,수인분당선,서울숲,8514,8645,17159
6238,20200511,수인분당선,수원,7310,5086,12396
6239,20200511,수인분당선,복정,1,0,1
6240,20200511,수인분당선,수서,12764,12940,25704
6241,20200511,수인분당선,대모산입구,3297,3107,6404
6242,20200511,수인분당선,개포동,3082,3333,6415
6243,20200511,수인분당선,구룡,1360,1302,2662
6244,20200511,수인분당선,도곡,6129,6287,12416
6245,20200511,수인분당선,한티,12035,13012,25047
6246,20200511,수인분당선,선릉,13321,20954,34275
6247,20200512,수인분당선,선릉,13112,20755,33867
6248,20200512,수인분당선,한티,12203,12941,25144
6249,20200512,수인분당선,도곡,6145,6103,12248
6250,20200512,수인분당선,구룡,1306,1293,2599
6251,20200512,수인분당선,개포동,3037,3198,6235
6252,20200512,수인분당선,대모산입구,3282,3061,6343
6253,20200512,수인분당선,수서,12494,12565,25059
6254,20200512,수인분당선,수원,7084,4945,12029
6255,20200512,수인분당선,서울숲,8700,8906,17606
6256,20200512,수인분당선,압구정로데오,15632,17569,33201
6257,20200512,수인분당선,강남구청,9183,10568,19751
6258,20200512,수인분당선,선정릉,7863,8478,16341
6259,20200512,수인분당선,가천대,6918,7732,14650
6260,20200512,수인분당선,태평,12943,12701,25644
6261,20200512,수인분당선,모란,18679,18977,37656
6262,20200512,수인분당선,야탑,24496,25674,50170
6263,20200512,수인분당선,서현,22665,23228,45893
6264,20200512,수인분당선,수내,11705,11743,23448
6265,20200512,수인분당선,정자,16013,17070,33083
6266,20200512,수인분당선,미금,14794,15714,30508
6267,20200512,수인분당선,오리,11110,9373,20483
6268,20200512,수인분당선,이매,5029,4864,9893
6269,20200512,수인분당선,보정,2292,1911,4203
6270,20200512,수인분당선,죽전,12625,13473,26098
6271,20200512,수인분당선,구성,4677,4736,9413
6272,20200512,수인분당선,신갈,4302,4269,8571
6273,20200512,수인분당선,기흥,8851,8409,17260
6274,20200512,수인분당선,상갈,5068,4748,9816
6275,20200512,수인분당선,청명,3720,3569,7289
6276,20200512,수인분당선,영통,7095,7409,14504
6277,20200512,수인분당선,망포,12374,11730,24104
6278,20200512,수인분당선,매탄권선,4009,3815,7824
6279,20200512,수인분당선,수원시청,10047,10963,21010
6280,20200512,수인분당선,매교,2172,2232,4404
6281,20200512,수인분당선,달월,78,52,130
6282,20200512,수인분당선,월곶,2108,1989,4097
6283,20200512,수인분당선,소래포구,4740,4403,9143
6284,20200512,수인분당선,인천논현,5156,5389,10545
6285,20200512,수인분당선,호구포,3321,3328,6649
6286,20200512,수인분당선,남동인더스파크,2247,2463,4710
6287,20200512,수인분당선,원인재,3968,4174,8142
6288,20200512,수인분당선,연수,4023,4088,8111
6289,20200512,수인분당선,송도,2320,2209,4529
6290,20200512,수인분당선,인하대,4882,4634,9516
6291,20200512,수인분당선,숭의,3488,3281,6769
6292,20200512,수인분당선,신포,1525,1581,3106
6293,20200512,수인분당선,인천,776,1308,2084
6294,20200513,수인분당선,선릉,13232,20766,33998
6295,20200513,수인분당선,한티,12176,13121,25297
6296,20200513,수인분당선,도곡,6128,6210,12338
6297,20200513,수인분당선,구룡,1306,1312,2618
6298,20200513,수인분당선,개포동,3245,3487,6732
6299,20200513,수인분당선,대모산입구,3251,3094,6345
6300,20200513,수인분당선,수서,12635,12955,25590
6301,20200513,수인분당선,수원,7316,5029,12345
6302,20200513,수인분당선,서울숲,9417,9485,18902
6303,20200513,수인분당선,압구정로데오,15643,17439,33082
6304,20200513,수인분당선,강남구청,9254,10657,19911
6305,20200513,수인분당선,선정릉,7973,8667,16640
6306,20200513,수인분당선,가천대,7115,7836,14951
6307,20200513,수인분당선,태평,12933,12568,25501
6308,20200513,수인분당선,모란,18718,19030,37748
6309,20200513,수인분당선,야탑,24767,26042,50809
6310,20200513,수인분당선,서현,23286,23435,46721
6311,20200513,수인분당선,수내,12065,12140,24205
6312,20200513,수인분당선,정자,15856,17177,33033
6313,20200513,수인분당선,미금,14818,15787,30605
6314,20200513,수인분당선,오리,11220,9325,20545
6315,20200513,수인분당선,이매,5041,4835,9876
6316,20200513,수인분당선,보정,2300,1937,4237
6317,20200513,수인분당선,죽전,12614,13792,26406
6318,20200513,수인분당선,구성,4620,4696,9316
6319,20200513,수인분당선,신갈,4241,4138,8379
6320,20200513,수인분당선,기흥,8846,8435,17281
6321,20200513,수인분당선,상갈,5108,4756,9864
6322,20200513,수인분당선,청명,3760,3504,7264
6323,20200513,수인분당선,영통,7197,7378,14575
6324,20200513,수인분당선,망포,12439,11981,24420
6325,20200513,수인분당선,매탄권선,4052,3831,7883
6326,20200513,수인분당선,수원시청,10233,11272,21505
6327,20200513,수인분당선,매교,2109,2181,4290
6328,20200513,수인분당선,달월,88,61,149
6329,20200513,수인분당선,인천,768,1363,2131
6330,20200513,수인분당선,신포,1505,1596,3101
6331,20200513,수인분당선,숭의,3480,3216,6696
6332,20200513,수인분당선,인하대,4589,4427,9016
6333,20200513,수인분당선,송도,2354,2209,4563
6334,20200513,수인분당선,월곶,2208,2028,4236
6335,20200513,수인분당선,소래포구,4731,4415,9146
6336,20200513,수인분당선,인천논현,5161,5461,10622
6337,20200513,수인분당선,호구포,3293,3294,6587
6338,20200513,수인분당선,남동인더스파크,2325,2497,4822
6339,20200513,수인분당선,원인재,3910,4073,7983
6340,20200513,수인분당선,연수,3989,3983,7972
6341,20200514,수인분당선,인천,722,1212,1934
6342,20200514,수인분당선,신포,1492,1540,3032
6343,20200514,수인분당선,숭의,3353,3072,6425
6344,20200514,수인분당선,인하대,4317,4031,8348
6345,20200514,수인분당선,송도,2208,2064,4272
6346,20200514,수인분당선,연수,3856,3949,7805
6347,20200514,수인분당선,원인재,3765,3854,7619
6348,20200514,수인분당선,남동인더스파크,2144,2335,4479
6349,20200514,수인분당선,호구포,3177,3252,6429
6350,20200514,수인분당선,인천논현,4843,5012,9855
6351,20200514,수인분당선,소래포구,4529,4290,8819
6352,20200514,수인분당선,월곶,2053,1948,4001
6353,20200514,수인분당선,달월,79,57,136
6354,20200514,수인분당선,매교,2093,2131,4224
6355,20200514,수인분당선,수원시청,10071,10993,21064
6356,20200514,수인분당선,매탄권선,3990,3822,7812
6357,20200514,수인분당선,망포,12403,11701,24104
6358,20200514,수인분당선,영통,7163,7384,14547
6359,20200514,수인분당선,청명,3695,3586,7281
6360,20200514,수인분당선,상갈,5145,4755,9900
6361,20200514,수인분당선,기흥,8837,8393,17230
6362,20200514,수인분당선,신갈,4312,4218,8530
6363,20200514,수인분당선,구성,4636,4722,9358
6364,20200514,수인분당선,죽전,13035,13967,27002
6365,20200514,수인분당선,보정,2308,1903,4211
6366,20200514,수인분당선,이매,5239,4850,10089
6367,20200514,수인분당선,오리,11108,9439,20547
6368,20200514,수인분당선,미금,14701,15782,30483
6369,20200514,수인분당선,정자,15785,17290,33075
6370,20200514,수인분당선,수내,11882,11969,23851
6371,20200514,수인분당선,서현,23243,23647,46890
6372,20200514,수인분당선,야탑,24825,25855,50680
6373,20200514,수인분당선,모란,24735,25671,50406
6374,20200514,수인분당선,태평,13246,12840,26086
6375,20200514,수인분당선,가천대,7112,7904,15016
6376,20200514,수인분당선,선정릉,7843,8501,16344
6377,20200514,수인분당선,강남구청,9042,10483,19525
6378,20200514,수인분당선,압구정로데오,15596,17729,33325
6379,20200514,수인분당선,서울숲,8951,9206,18157
6380,20200514,수인분당선,수원,7137,4939,12076
6381,20200514,수인분당선,수서,13101,13124,26225
6382,20200514,수인분당선,대모산입구,3349,3092,6441
6383,20200514,수인분당선,개포동,3063,3314,6377
6384,20200514,수인분당선,구룡,1331,1292,2623
6385,20200514,수인분당선,도곡,6091,6159,12250
6386,20200514,수인분당선,한티,12032,13068,25100
6387,20200514,수인분당선,선릉,13065,20518,33583
6388,20200515,수인분당선,인천,665,1081,1746
6389,20200515,수인분당선,신포,1316,1442,2758
6390,20200515,수인분당선,숭의,3080,2749,5829
6391,20200515,수인분당선,인하대,4109,3842,7951
6392,20200515,수인분당선,송도,2013,1906,3919
6393,20200515,수인분당선,연수,3643,3811,7454
6394,20200515,수인분당선,원인재,3594,3767,7361
6395,20200515,수인분당선,남동인더스파크,2184,2263,4447
6396,20200515,수인분당선,호구포,3087,3091,6178
6397,20200515,수인분당선,인천논현,4469,4874,9343
6398,20200515,수인분당선,소래포구,3645,3500,7145
6399,20200515,수인분당선,월곶,1860,1827,3687
6400,20200515,수인분당선,달월,75,47,122
6401,20200515,수인분당선,매교,2099,2098,4197
6402,20200515,수인분당선,수원시청,10230,11835,22065
6403,20200515,수인분당선,매탄권선,4065,3889,7954
6404,20200515,수인분당선,망포,13002,12023,25025
6405,20200515,수인분당선,영통,7556,7773,15329
6406,20200515,수인분당선,청명,3732,3526,7258
6407,20200515,수인분당선,상갈,4943,4697,9640
6408,20200515,수인분당선,기흥,8965,8255,17220
6409,20200515,수인분당선,신갈,4123,4024,8147
6410,20200515,수인분당선,구성,4476,4602,9078
6411,20200515,수인분당선,죽전,12889,13649,26538
6412,20200515,수인분당선,보정,2249,1844,4093
6413,20200515,수인분당선,이매,5041,4654,9695
6414,20200515,수인분당선,오리,10933,9334,20267
6415,20200515,수인분당선,미금,14559,15378,29937
6416,20200515,수인분당선,정자,16290,17512,33802
6417,20200515,수인분당선,수내,11945,12240,24185
6418,20200515,수인분당선,서현,23565,24346,47911
6419,20200515,수인분당선,야탑,24471,26106,50577
6420,20200515,수인분당선,모란,18364,18943,37307
6421,20200515,수인분당선,태평,12807,12393,25200
6422,20200515,수인분당선,가천대,6936,7459,14395
6423,20200515,수인분당선,선정릉,8117,8563,16680
6424,20200515,수인분당선,강남구청,9289,10612,19901
6425,20200515,수인분당선,압구정로데오,16490,19067,35557
6426,20200515,수인분당선,서울숲,8219,8055,16274
6427,20200515,수인분당선,수원,7192,5158,12350
6428,20200515,수인분당선,복정,1,0,1
6429,20200515,수인분당선,수서,13883,14766,28649
6430,20200515,수인분당선,대모산입구,3104,2888,5992
6431,20200515,수인분당선,개포동,3207,3472,6679
6432,20200515,수인분당선,구룡,1254,1232,2486
6433,20200515,수인분당선,도곡,6126,6271,12397
6434,20200515,수인분당선,한티,12686,13608,26294
6435,20200515,수인분당선,선릉,13109,20633,33742
6436,20200516,수인분당선,인천,691,1046,1737
6437,20200516,수인분당선,신포,1107,1191,2298
6438,20200516,수인분당선,숭의,2151,1948,4099
6439,20200516,수인분당선,인하대,3053,2738,5791
6440,20200516,수인분당선,송도,1690,1652,3342
6441,20200516,수인분당선,연수,3181,3337,6518
6442,20200516,수인분당선,원인재,3030,3060,6090
6443,20200516,수인분당선,남동인더스파크,837,851,1688
6444,20200516,수인분당선,호구포,1995,1878,3873
6445,20200516,수인분당선,인천논현,3650,3665,7315
6446,20200516,수인분당선,소래포구,3974,3939,7913
6447,20200516,수인분당선,월곶,1660,1599,3259
6448,20200516,수인분당선,달월,54,49,103
6449,20200516,수인분당선,매교,1389,1467,2856
6450,20200516,수인분당선,수원시청,8391,9718,18109
6451,20200516,수인분당선,매탄권선,2784,2566,5350
6452,20200516,수인분당선,망포,7550,6823,14373
6453,20200516,수인분당선,영통,5433,5537,10970
6454,20200516,수인분당선,청명,2163,2075,4238
6455,20200516,수인분당선,상갈,3217,3237,6454
6456,20200516,수인분당선,기흥,5807,5605,11412
6457,20200516,수인분당선,신갈,2379,2318,4697
6458,20200516,수인분당선,구성,2727,2729,5456
6459,20200516,수인분당선,죽전,9031,10251,19282
6460,20200516,수인분당선,보정,1440,1313,2753
6461,20200516,수인분당선,이매,3696,3410,7106
6462,20200516,수인분당선,오리,6925,5965,12890
6463,20200516,수인분당선,미금,9927,10192,20119
6464,20200516,수인분당선,정자,9756,9957,19713
6465,20200516,수인분당선,수내,7761,7072,14833
6466,20200516,수인분당선,서현,16484,16923,33407
6467,20200516,수인분당선,야탑,15735,16819,32554
6468,20200516,수인분당선,모란,13897,14467,28364
6469,20200516,수인분당선,태평,9749,9125,18874
6470,20200516,수인분당선,가천대,4371,4788,9159
6471,20200516,수인분당선,선정릉,3214,3255,6469
6472,20200516,수인분당선,강남구청,4524,5641,10165
6473,20200516,수인분당선,압구정로데오,12593,14736,27329
6474,20200516,수인분당선,서울숲,6208,6289,12497
6475,20200516,수인분당선,수원,5614,3814,9428
6476,20200516,수인분당선,수서,8671,9253,17924
6477,20200516,수인분당선,대모산입구,2646,2393,5039
6478,20200516,수인분당선,개포동,2022,2006,4028
6479,20200516,수인분당선,구룡,777,717,1494
6480,20200516,수인분당선,도곡,3631,3324,6955
6481,20200516,수인분당선,한티,9704,9365,19069
6482,20200516,수인분당선,선릉,4871,7940,12811
6483,20200517,수인분당선,복정,1,0,1
6484,20200517,수인분당선,인천,753,1092,1845
6485,20200517,수인분당선,신포,961,939,1900
6486,20200517,수인분당선,숭의,1633,1512,3145
6487,20200517,수인분당선,인하대,2079,2046,4125
6488,20200517,수인분당선,송도,1283,1269,2552
6489,20200517,수인분당선,연수,2482,2378,4860
6490,20200517,수인분당선,원인재,2209,2331,4540
6491,20200517,수인분당선,남동인더스파크,497,548,1045
6492,20200517,수인분당선,호구포,1537,1481,3018
6493,20200517,수인분당선,인천논현,2518,2696,5214
6494,20200517,수인분당선,소래포구,3839,3683,7522
6495,20200517,수인분당선,월곶,1312,1249,2561
6496,20200517,수인분당선,달월,45,43,88
6497,20200517,수인분당선,매교,1036,1006,2042
6498,20200517,수인분당선,수원시청,5839,5879,11718
6499,20200517,수인분당선,매탄권선,2048,1887,3935
6500,20200517,수인분당선,망포,5247,5319,10566
6501,20200517,수인분당선,영통,3858,3966,7824
6502,20200517,수인분당선,청명,1626,1544,3170
6503,20200517,수인분당선,상갈,2475,2485,4960
6504,20200517,수인분당선,기흥,4291,4142,8433
6505,20200517,수인분당선,신갈,1658,1675,3333
6506,20200517,수인분당선,구성,1992,2160,4152
6507,20200517,수인분당선,죽전,7019,7953,14972
6508,20200517,수인분당선,보정,924,878,1802
6509,20200517,수인분당선,이매,2645,2596,5241
6510,20200517,수인분당선,오리,4722,4247,8969
6511,20200517,수인분당선,미금,6466,6829,13295
6512,20200517,수인분당선,정자,6386,6631,13017
6513,20200517,수인분당선,수내,5346,5235,10581
6514,20200517,수인분당선,서현,11616,11793,23409
6515,20200517,수인분당선,야탑,11687,12067,23754
6516,20200517,수인분당선,모란,10291,10579,20870
6517,20200517,수인분당선,태평,7237,6732,13969
6518,20200517,수인분당선,가천대,3121,3789,6910
6519,20200517,수인분당선,선정릉,2002,2081,4083
6520,20200517,수인분당선,강남구청,2488,3084,5572
6521,20200517,수인분당선,압구정로데오,7201,8184,15385
6522,20200517,수인분당선,서울숲,4671,4929,9600
6523,20200517,수인분당선,수원,4257,2834,7091
6524,20200517,수인분당선,수서,7329,7038,14367
6525,20200517,수인분당선,대모산입구,1399,1355,2754
6526,20200517,수인분당선,개포동,1557,1551,3108
6527,20200517,수인분당선,구룡,535,548,1083
6528,20200517,수인분당선,도곡,2116,2024,4140
6529,20200517,수인분당선,한티,6756,6594,13350
6530,20200517,수인분당선,선릉,2422,3742,6164
6531,20200518,수인분당선,망포,11823,11436,23259
6532,20200518,수인분당선,선릉,13338,20644,33982
6533,20200518,수인분당선,한티,11960,12950,24910
6534,20200518,수인분당선,도곡,6044,6289,12333
6535,20200518,수인분당선,구룡,1261,1236,2497
6536,20200518,수인분당선,개포동,3007,3298,6305
6537,20200518,수인분당선,대모산입구,3226,3028,6254
6538,20200518,수인분당선,수서,12499,12867,25366
6539,20200518,수인분당선,수원,6718,4793,11511
6540,20200518,수인분당선,서울숲,8033,8144,16177
6541,20200518,수인분당선,압구정로데오,14395,15634,30029
6542,20200518,수인분당선,강남구청,8837,10173,19010
6543,20200518,수인분당선,선정릉,8049,8401,16450
6544,20200518,수인분당선,가천대,6580,7523,14103
6545,20200518,수인분당선,태평,12681,12266,24947
6546,20200518,수인분당선,모란,18015,18120,36135
6547,20200518,수인분당선,야탑,23848,24852,48700
6548,20200518,수인분당선,서현,22772,23115,45887
6549,20200518,수인분당선,수내,11793,11928,23721
6550,20200518,수인분당선,정자,15299,16707,32006
6551,20200518,수인분당선,미금,14266,15407,29673
6552,20200518,수인분당선,오리,10782,9160,19942
6553,20200518,수인분당선,이매,4927,4705,9632
6554,20200518,수인분당선,보정,2206,1838,4044
6555,20200518,수인분당선,죽전,11840,13077,24917
6556,20200518,수인분당선,구성,4517,4640,9157
6557,20200518,수인분당선,신갈,4140,4106,8246
6558,20200518,수인분당선,기흥,8693,8152,16845
6559,20200518,수인분당선,상갈,4869,4671,9540
6560,20200518,수인분당선,청명,3599,3548,7147
6561,20200518,수인분당선,영통,6796,7125,13921
6562,20200518,수인분당선,매탄권선,3766,3624,7390
6563,20200518,수인분당선,수원시청,9677,10415,20092
6564,20200518,수인분당선,매교,2140,2161,4301
6565,20200518,수인분당선,달월,72,46,118
6566,20200518,수인분당선,월곶,2013,1867,3880
6567,20200518,수인분당선,소래포구,3819,3502,7321
6568,20200518,수인분당선,인천논현,4590,4725,9315
6569,20200518,수인분당선,호구포,3006,3178,6184
6570,20200518,수인분당선,남동인더스파크,1926,2236,4162
6571,20200518,수인분당선,원인재,3515,3596,7111
6572,20200518,수인분당선,연수,3681,3706,7387
6573,20200518,수인분당선,송도,2012,1846,3858
6574,20200518,수인분당선,인하대,4107,3802,7909
6575,20200518,수인분당선,숭의,3229,3024,6253
6576,20200518,수인분당선,신포,1270,1302,2572
6577,20200518,수인분당선,인천,699,1168,1867
6578,20200519,수인분당선,구룡,1253,1233,2486
6579,20200519,수인분당선,도곡,6061,6139,12200
6580,20200519,수인분당선,한티,11961,12898,24859
6581,20200519,수인분당선,선릉,13204,20917,34121
6582,20200519,수인분당선,대모산입구,3260,2955,6215
6583,20200519,수인분당선,수서,12511,12563,25074
6584,20200519,수인분당선,수원,6815,4741,11556
6585,20200519,수인분당선,서울숲,8492,8510,17002
6586,20200519,수인분당선,압구정로데오,15229,17357,32586
6587,20200519,수인분당선,강남구청,9128,10518,19646
6588,20200519,수인분당선,선정릉,7888,8573,16461
6589,20200519,수인분당선,가천대,6733,7600,14333
6590,20200519,수인분당선,태평,12883,12532,25415
6591,20200519,수인분당선,모란,21292,22271,43563
6592,20200519,수인분당선,야탑,23968,25218,49186
6593,20200519,수인분당선,서현,22869,23106,45975
6594,20200519,수인분당선,수내,11760,11754,23514
6595,20200519,수인분당선,정자,15777,16946,32723
6596,20200519,수인분당선,미금,14438,15386,29824
6597,20200519,수인분당선,오리,11008,9231,20239
6598,20200519,수인분당선,이매,5001,4758,9759
6599,20200519,수인분당선,보정,2294,1867,4161
6600,20200519,수인분당선,죽전,12036,13192,25228
6601,20200519,수인분당선,구성,4553,4687,9240
6602,20200519,수인분당선,신갈,4214,4048,8262
6603,20200519,수인분당선,기흥,8661,8050,16711
6604,20200519,수인분당선,상갈,4968,4623,9591
6605,20200519,수인분당선,청명,3724,3582,7306
6606,20200519,수인분당선,영통,6857,7271,14128
6607,20200519,수인분당선,망포,12071,11374,23445
6608,20200519,수인분당선,매탄권선,3900,3695,7595
6609,20200519,수인분당선,수원시청,9959,10775,20734
6610,20200519,수인분당선,매교,2080,2076,4156
6611,20200519,수인분당선,달월,67,48,115
6612,20200519,수인분당선,월곶,1956,1896,3852
6613,20200519,수인분당선,소래포구,3766,3540,7306
6614,20200519,수인분당선,인천논현,4830,5007,9837
6615,20200519,수인분당선,호구포,3127,3149,6276
6616,20200519,수인분당선,남동인더스파크,2150,2374,4524
6617,20200519,수인분당선,원인재,3742,3815,7557
6618,20200519,수인분당선,연수,3653,3716,7369
6619,20200519,수인분당선,송도,2009,1939,3948
6620,20200519,수인분당선,인하대,4109,3897,8006
6621,20200519,수인분당선,숭의,3194,2968,6162
6622,20200519,수인분당선,신포,1371,1408,2779
6623,20200519,수인분당선,인천,662,1066,1728
6624,20200519,수인분당선,개포동,3030,3250,6280
6625,20200520,수인분당선,인천,813,1382,2195
6626,20200520,수인분당선,신포,1511,1569,3080
6627,20200520,수인분당선,숭의,3413,3140,6553
6628,20200520,수인분당선,인하대,4332,4051,8383
6629,20200520,수인분당선,송도,2327,2196,4523
6630,20200520,수인분당선,연수,3961,4056,8017
6631,20200520,수인분당선,원인재,3893,3966,7859
6632,20200520,수인분당선,남동인더스파크,2151,2346,4497
6633,20200520,수인분당선,호구포,3333,3382,6715
6634,20200520,수인분당선,인천논현,5043,5367,10410
6635,20200520,수인분당선,소래포구,4979,4657,9636
6636,20200520,수인분당선,월곶,2089,1960,4049
6637,20200520,수인분당선,달월,87,56,143
6638,20200520,수인분당선,매교,2361,2340,4701
6639,20200520,수인분당선,수원시청,10461,11358,21819
6640,20200520,수인분당선,매탄권선,4100,3947,8047
6641,20200520,수인분당선,망포,12679,12220,24899
6642,20200520,수인분당선,영통,7500,7822,15322
6643,20200520,수인분당선,청명,3854,3713,7567
6644,20200520,수인분당선,상갈,5277,4984,10261
6645,20200520,수인분당선,기흥,9170,8585,17755
6646,20200520,수인분당선,신갈,4398,4327,8725
6647,20200520,수인분당선,구성,4839,4947,9786
6648,20200520,수인분당선,죽전,13166,14081,27247
6649,20200520,수인분당선,보정,2440,1999,4439
6650,20200520,수인분당선,이매,5330,5093,10423
6651,20200520,수인분당선,오리,11490,9633,21123
6652,20200520,수인분당선,미금,15630,16476,32106
6653,20200520,수인분당선,정자,16414,17728,34142
6654,20200520,수인분당선,수내,12569,12495,25064
6655,20200520,수인분당선,서현,24044,24618,48662
6656,20200520,수인분당선,야탑,25298,26779,52077
6657,20200520,수인분당선,모란,19111,19624,38735
6658,20200520,수인분당선,태평,13457,13008,26465
6659,20200520,수인분당선,가천대,6884,7744,14628
6660,20200520,수인분당선,선정릉,8068,8782,16850
6661,20200520,수인분당선,강남구청,9421,10661,20082
6662,20200520,수인분당선,압구정로데오,15929,17985,33914
6663,20200520,수인분당선,서울숲,9289,9506,18795
6664,20200520,수인분당선,수원,7382,5099,12481
6665,20200520,수인분당선,수서,12760,13140,25900
6666,20200520,수인분당선,대모산입구,3383,3105,6488
6667,20200520,수인분당선,개포동,3225,3512,6737
6668,20200520,수인분당선,구룡,1522,1499,3021
6669,20200520,수인분당선,도곡,6245,6400,12645
6670,20200520,수인분당선,한티,12539,13507,26046
6671,20200520,수인분당선,선릉,13417,21045,34462
6672,20200521,수인분당선,인천,772,1231,2003
6673,20200521,수인분당선,신포,1392,1483,2875
6674,20200521,수인분당선,숭의,3170,2953,6123
6675,20200521,수인분당선,인하대,3997,3769,7766
6676,20200521,수인분당선,송도,2252,2127,4379
6677,20200521,수인분당선,연수,3838,3857,7695
6678,20200521,수인분당선,원인재,3848,3960,7808
6679,20200521,수인분당선,남동인더스파크,2079,2352,4431
6680,20200521,수인분당선,호구포,3207,3241,6448
6681,20200521,수인분당선,인천논현,4850,5103,9953
6682,20200521,수인분당선,소래포구,5167,4869,10036
6683,20200521,수인분당선,월곶,2058,1927,3985
6684,20200521,수인분당선,달월,80,61,141
6685,20200521,수인분당선,매교,2296,2260,4556
6686,20200521,수인분당선,수원시청,10208,11167,21375
6687,20200521,수인분당선,매탄권선,4168,3921,8089
6688,20200521,수인분당선,망포,12572,11939,24511
6689,20200521,수인분당선,영통,7324,7655,14979
6690,20200521,수인분당선,청명,3921,3637,7558
6691,20200521,수인분당선,상갈,5157,4853,10010
6692,20200521,수인분당선,기흥,8995,8401,17396
6693,20200521,수인분당선,신갈,4311,4200,8511
6694,20200521,수인분당선,구성,4742,4906,9648
6695,20200521,수인분당선,죽전,13070,14163,27233
6696,20200521,수인분당선,보정,2384,2111,4495
6697,20200521,수인분당선,이매,5418,5040,10458
6698,20200521,수인분당선,오리,11444,9670,21114
6699,20200521,수인분당선,미금,15181,16196,31377
6700,20200521,수인분당선,정자,16420,17771,34191
6701,20200521,수인분당선,수내,12250,12433,24683
6702,20200521,수인분당선,서현,23977,24328,48305
6703,20200521,수인분당선,야탑,25216,26528,51744
6704,20200521,수인분당선,모란,19277,19443,38720
6705,20200521,수인분당선,태평,13229,12868,26097
6706,20200521,수인분당선,가천대,6890,7662,14552
6707,20200521,수인분당선,선정릉,8002,8626,16628
6708,20200521,수인분당선,강남구청,9162,10564,19726
6709,20200521,수인분당선,압구정로데오,16122,18437,34559
6710,20200521,수인분당선,서울숲,9333,9669,19002
6711,20200521,수인분당선,수원,7265,5039,12304
6712,20200521,수인분당선,복정,1,0,1
6713,20200521,수인분당선,수서,13282,13352,26634
6714,20200521,수인분당선,대모산입구,3363,3082,6445
6715,20200521,수인분당선,개포동,3190,3349,6539
6716,20200521,수인분당선,구룡,1478,1421,2899
6717,20200521,수인분당선,도곡,6262,6439,12701
6718,20200521,수인분당선,한티,12347,13270,25617
6719,20200521,수인분당선,선릉,13344,21155,34499
6720,20200522,수인분당선,선릉,13339,21124,34463
6721,20200522,수인분당선,한티,13136,13937,27073
6722,20200522,수인분당선,도곡,6690,6593,13283
6723,20200522,수인분당선,구룡,1461,1451,2912
6724,20200522,수인분당선,개포동,3357,3603,6960
6725,20200522,수인분당선,대모산입구,3373,3121,6494
6726,20200522,수인분당선,수서,14462,15452,29914
6727,20200522,수인분당선,수원,7971,5700,13671
6728,20200522,수인분당선,서울숲,9483,9461,18944
6729,20200522,수인분당선,압구정로데오,17057,20420,37477
6730,20200522,수인분당선,강남구청,9583,10968,20551
6731,20200522,수인분당선,선정릉,8056,8631,16687
6732,20200522,수인분당선,가천대,6878,7377,14255
6733,20200522,수인분당선,태평,13534,13043,26577
6734,20200522,수인분당선,모란,19753,20296,40049
6735,20200522,수인분당선,야탑,25768,27420,53188
6736,20200522,수인분당선,서현,25203,26205,51408
6737,20200522,수인분당선,수내,12796,12896,25692
6738,20200522,수인분당선,정자,16863,18466,35329
6739,20200522,수인분당선,미금,15930,16891,32821
6740,20200522,수인분당선,오리,11738,9857,21595
6741,20200522,수인분당선,이매,5503,5148,10651
6742,20200522,수인분당선,보정,2478,2080,4558
6743,20200522,수인분당선,죽전,13926,14664,28590
6744,20200522,수인분당선,구성,4767,4890,9657
6745,20200522,수인분당선,신갈,4435,4336,8771
6746,20200522,수인분당선,기흥,9414,8888,18302
6747,20200522,수인분당선,상갈,5418,4959,10377
6748,20200522,수인분당선,청명,4138,3827,7965
6749,20200522,수인분당선,영통,8117,8364,16481
6750,20200522,수인분당선,망포,13799,12680,26479
6751,20200522,수인분당선,매탄권선,4447,4117,8564
6752,20200522,수인분당선,수원시청,10881,13019,23900
6753,20200522,수인분당선,매교,2337,2368,4705
6754,20200522,수인분당선,달월,76,59,135
6755,20200522,수인분당선,월곶,2167,2017,4184
6756,20200522,수인분당선,소래포구,5249,5204,10453
6757,20200522,수인분당선,인천논현,4944,5282,10226
6758,20200522,수인분당선,호구포,3316,3263,6579
6759,20200522,수인분당선,남동인더스파크,1999,2199,4198
6760,20200522,수인분당선,원인재,4005,4086,8091
6761,20200522,수인분당선,연수,3893,4013,7906
6762,20200522,수인분당선,송도,2392,2144,4536
6763,20200522,수인분당선,인하대,4110,3846,7956
6764,20200522,수인분당선,숭의,3241,2968,6209
6765,20200522,수인분당선,신포,1433,1532,2965
6766,20200522,수인분당선,인천,769,1264,2033
6767,20200523,수인분당선,선릉,5321,8775,14096
6768,20200523,수인분당선,한티,9933,9679,19612
6769,20200523,수인분당선,도곡,3849,3614,7463
6770,20200523,수인분당선,구룡,843,829,1672
6771,20200523,수인분당선,개포동,2322,2217,4539
6772,20200523,수인분당선,대모산입구,2240,1972,4212
6773,20200523,수인분당선,수서,9488,9907,19395
6774,20200523,수인분당선,수원,6137,4210,10347
6775,20200523,수인분당선,서울숲,8424,8956,17380
6776,20200523,수인분당선,압구정로데오,14024,16796,30820
6777,20200523,수인분당선,강남구청,4784,5804,10588
6778,20200523,수인분당선,선정릉,3554,3654,7208
6779,20200523,수인분당선,가천대,4921,5331,10252
6780,20200523,수인분당선,태평,10226,9658,19884
6781,20200523,수인분당선,모란,15579,15856,31435
6782,20200523,수인분당선,야탑,16522,17630,34152
6783,20200523,수인분당선,서현,17533,17703,35236
6784,20200523,수인분당선,수내,8407,7883,16290
6785,20200523,수인분당선,정자,10422,10726,21148
6786,20200523,수인분당선,미금,10302,10213,20515
6787,20200523,수인분당선,오리,7687,6479,14166
6788,20200523,수인분당선,이매,3923,3627,7550
6789,20200523,수인분당선,보정,1573,1379,2952
6790,20200523,수인분당선,죽전,10014,11106,21120
6791,20200523,수인분당선,구성,3140,3147,6287
6792,20200523,수인분당선,신갈,2553,2568,5121
6793,20200523,수인분당선,기흥,6387,6039,12426
6794,20200523,수인분당선,상갈,3630,3543,7173
6795,20200523,수인분당선,청명,2689,2578,5267
6796,20200523,수인분당선,영통,6072,6197,12269
6797,20200523,수인분당선,망포,8202,7205,15407
6798,20200523,수인분당선,매탄권선,3231,2868,6099
6799,20200523,수인분당선,수원시청,9002,10300,19302
6800,20200523,수인분당선,매교,1482,1499,2981
6801,20200523,수인분당선,달월,61,56,117
6802,20200523,수인분당선,월곶,1727,1632,3359
6803,20200523,수인분당선,소래포구,5022,5168,10190
6804,20200523,수인분당선,인천논현,3805,3871,7676
6805,20200523,수인분당선,호구포,2057,1868,3925
6806,20200523,수인분당선,남동인더스파크,774,742,1516
6807,20200523,수인분당선,원인재,3029,3082,6111
6808,20200523,수인분당선,연수,3314,3302,6616
6809,20200523,수인분당선,송도,1793,1758,3551
6810,20200523,수인분당선,인하대,2815,2561,5376
6811,20200523,수인분당선,숭의,2161,1970,4131
6812,20200523,수인분당선,신포,1117,1231,2348
6813,20200523,수인분당선,인천,782,1327,2109
6814,20200524,수인분당선,영통,3655,3618,7273
6815,20200524,수인분당선,청명,1576,1637,3213
6816,20200524,수인분당선,신포,877,837,1714
6817,20200524,수인분당선,상갈,2390,2455,4845
6818,20200524,수인분당선,기흥,4103,4047,8150
6819,20200524,수인분당선,신갈,1538,1617,3155
6820,20200524,수인분당선,구성,2007,2062,4069
6821,20200524,수인분당선,죽전,6546,7387,13933
6822,20200524,수인분당선,보정,876,898,1774
6823,20200524,수인분당선,이매,2493,2537,5030
6824,20200524,수인분당선,오리,4746,4216,8962
6825,20200524,수인분당선,미금,6434,7078,13512
6826,20200524,수인분당선,정자,6413,6737,13150
6827,20200524,수인분당선,수내,5431,5141,10572
6828,20200524,수인분당선,서현,11594,11718,23312
6829,20200524,수인분당선,야탑,11517,11690,23207
6830,20200524,수인분당선,모란,15500,16285,31785
6831,20200524,수인분당선,태평,7138,6895,14033
6832,20200524,수인분당선,가천대,3137,3838,6975
6833,20200524,수인분당선,선정릉,2055,2113,4168
6834,20200524,수인분당선,강남구청,2614,3193,5807
6835,20200524,수인분당선,압구정로데오,7433,8607,16040
6836,20200524,수인분당선,서울숲,4806,4805,9611
6837,20200524,수인분당선,수원,4056,2690,6746
6838,20200524,수인분당선,수서,7795,7187,14982
6839,20200524,수인분당선,대모산입구,1649,1556,3205
6840,20200524,수인분당선,개포동,1541,1606,3147
6841,20200524,수인분당선,구룡,517,540,1057
6842,20200524,수인분당선,도곡,1966,1975,3941
6843,20200524,수인분당선,한티,6577,6440,13017
6844,20200524,수인분당선,선릉,2325,3609,5934
6845,20200524,수인분당선,숭의,1437,1340,2777
6846,20200524,수인분당선,인하대,1814,1813,3627
6847,20200524,수인분당선,송도,1123,1117,2240
6848,20200524,수인분당선,연수,2269,2265,4534
6849,20200524,수인분당선,원인재,2137,2184,4321
6850,20200524,수인분당선,남동인더스파크,539,556,1095
6851,20200524,수인분당선,호구포,1405,1416,2821
6852,20200524,수인분당선,인천논현,2416,2532,4948
6853,20200524,수인분당선,소래포구,3277,3302,6579
6854,20200524,수인분당선,월곶,1177,1150,2327
6855,20200524,수인분당선,달월,13,15,28
6856,20200524,수인분당선,매교,945,1017,1962
6857,20200524,수인분당선,수원시청,5519,5467,10986
6858,20200524,수인분당선,매탄권선,1897,1856,3753
6859,20200524,수인분당선,망포,4991,5194,10185
6860,20200524,수인분당선,인천,662,989,1651
6861,20200525,수인분당선,인천,809,1310,2119
6862,20200525,수인분당선,신포,1546,1636,3182
6863,20200525,수인분당선,숭의,3564,3240,6804
6864,20200525,수인분당선,인하대,4511,4288,8799
6865,20200525,수인분당선,송도,2385,2151,4536
6866,20200525,수인분당선,연수,4127,4077,8204
6867,20200525,수인분당선,원인재,3919,4010,7929
6868,20200525,수인분당선,남동인더스파크,2119,2371,4490
6869,20200525,수인분당선,호구포,3265,3337,6602
6870,20200525,수인분당선,인천논현,5113,5312,10425
6871,20200525,수인분당선,소래포구,4726,4518,9244
6872,20200525,수인분당선,월곶,2035,1990,4025
6873,20200525,수인분당선,달월,78,56,134
6874,20200525,수인분당선,매교,2369,2267,4636
6875,20200525,수인분당선,수원시청,10350,11254,21604
6876,20200525,수인분당선,매탄권선,4171,4010,8181
6877,20200525,수인분당선,망포,12687,12235,24922
6878,20200525,수인분당선,영통,7444,7726,15170
6879,20200525,수인분당선,청명,3876,3591,7467
6880,20200525,수인분당선,상갈,5121,4905,10026
6881,20200525,수인분당선,기흥,9204,8561,17765
6882,20200525,수인분당선,신갈,4336,4153,8489
6883,20200525,수인분당선,구성,4793,4933,9726
6884,20200525,수인분당선,죽전,12938,14095,27033
6885,20200525,수인분당선,보정,2455,2057,4512
6886,20200525,수인분당선,이매,5335,4993,10328
6887,20200525,수인분당선,오리,11230,9500,20730
6888,20200525,수인분당선,미금,15347,16387,31734
6889,20200525,수인분당선,정자,16132,17285,33417
6890,20200525,수인분당선,수내,12282,12200,24482
6891,20200525,수인분당선,서현,24055,24288,48343
6892,20200525,수인분당선,야탑,24887,26182,51069
6893,20200525,수인분당선,모란,19298,19227,38525
6894,20200525,수인분당선,태평,13409,13119,26528
6895,20200525,수인분당선,가천대,9415,10272,19687
6896,20200525,수인분당선,선정릉,7984,8588,16572
6897,20200525,수인분당선,강남구청,9029,10376,19405
6898,20200525,수인분당선,압구정로데오,14928,16626,31554
6899,20200525,수인분당선,서울숲,8917,9100,18017
6900,20200525,수인분당선,수원,7284,5108,12392
6901,20200525,수인분당선,수서,13093,13410,26503
6902,20200525,수인분당선,대모산입구,3379,3135,6514
6903,20200525,수인분당선,개포동,3198,3392,6590
6904,20200525,수인분당선,구룡,1432,1455,2887
6905,20200525,수인분당선,도곡,6306,6447,12753
6906,20200525,수인분당선,한티,12378,13225,25603
6907,20200525,수인분당선,선릉,13392,21225,34617
6908,20200526,수인분당선,인천,732,1274,2006
6909,20200526,수인분당선,신포,1456,1527,2983
6910,20200526,수인분당선,숭의,3413,3202,6615
6911,20200526,수인분당선,인하대,4374,4130,8504
6912,20200526,수인분당선,송도,2298,2079,4377
6913,20200526,수인분당선,연수,3880,3994,7874
6914,20200526,수인분당선,원인재,3783,3993,7776
6915,20200526,수인분당선,남동인더스파크,2157,2359,4516
6916,20200526,수인분당선,호구포,3255,3310,6565
6917,20200526,수인분당선,인천논현,4953,5110,10063
6918,20200526,수인분당선,소래포구,4841,4629,9470
6919,20200526,수인분당선,월곶,2109,1944,4053
6920,20200526,수인분당선,달월,81,59,140
6921,20200526,수인분당선,매교,2233,2287,4520
6922,20200526,수인분당선,수원시청,10218,11034,21252
6923,20200526,수인분당선,매탄권선,4122,4020,8142
6924,20200526,수인분당선,망포,12598,11970,24568
6925,20200526,수인분당선,영통,7410,7636,15046
6926,20200526,수인분당선,청명,3857,3788,7645
6927,20200526,수인분당선,상갈,5154,4836,9990
6928,20200526,수인분당선,기흥,9117,8700,17817
6929,20200526,수인분당선,신갈,4376,4215,8591
6930,20200526,수인분당선,구성,4863,4887,9750
6931,20200526,수인분당선,죽전,12903,14001,26904
6932,20200526,수인분당선,보정,2477,2038,4515
6933,20200526,수인분당선,이매,5478,5198,10676
6934,20200526,수인분당선,오리,11518,9820,21338
6935,20200526,수인분당선,미금,15298,16475,31773
6936,20200526,수인분당선,정자,16195,17700,33895
6937,20200526,수인분당선,수내,12384,12616,25000
6938,20200526,수인분당선,서현,23851,24324,48175
6939,20200526,수인분당선,야탑,25014,26168,51182
6940,20200526,수인분당선,모란,18875,19043,37918
6941,20200526,수인분당선,태평,13113,12789,25902
6942,20200526,수인분당선,가천대,9446,10277,19723
6943,20200526,수인분당선,선정릉,8056,8734,16790
6944,20200526,수인분당선,강남구청,9537,10984,20521
6945,20200526,수인분당선,압구정로데오,16276,18371,34647
6946,20200526,수인분당선,서울숲,9026,8986,18012
6947,20200526,수인분당선,수원,7180,4964,12144
6948,20200526,수인분당선,수서,12878,13050,25928
6949,20200526,수인분당선,대모산입구,3383,3194,6577
6950,20200526,수인분당선,개포동,3166,3374,6540
6951,20200526,수인분당선,구룡,1487,1526,3013
6952,20200526,수인분당선,도곡,6213,6365,12578
6953,20200526,수인분당선,한티,12630,13420,26050
6954,20200526,수인분당선,선릉,13655,21367,35022
6955,20200527,수인분당선,인천,866,1403,2269
6956,20200527,수인분당선,신포,1636,1701,3337
6957,20200527,수인분당선,숭의,3648,3361,7009
6958,20200527,수인분당선,인하대,4682,4446,9128
6959,20200527,수인분당선,송도,2496,2274,4770
6960,20200527,수인분당선,연수,4333,4390,8723
6961,20200527,수인분당선,원인재,4143,4182,8325
6962,20200527,수인분당선,남동인더스파크,2151,2380,4531
6963,20200527,수인분당선,호구포,3367,3326,6693
6964,20200527,수인분당선,인천논현,5238,5501,10739
6965,20200527,수인분당선,소래포구,5091,4804,9895
6966,20200527,수인분당선,월곶,2212,2099,4311
6967,20200527,수인분당선,달월,83,57,140
6968,20200527,수인분당선,매교,2506,2457,4963
6969,20200527,수인분당선,수원시청,10573,11620,22193
6970,20200527,수인분당선,매탄권선,4339,4074,8413
6971,20200527,수인분당선,망포,12824,12243,25067
6972,20200527,수인분당선,영통,7742,8158,15900
6973,20200527,수인분당선,청명,4015,3831,7846
6974,20200527,수인분당선,상갈,5271,4941,10212
6975,20200527,수인분당선,기흥,9367,8666,18033
6976,20200527,수인분당선,신갈,4434,4320,8754
6977,20200527,수인분당선,구성,4824,5031,9855
6978,20200527,수인분당선,죽전,13314,14389,27703
6979,20200527,수인분당선,보정,2567,2138,4705
6980,20200527,수인분당선,이매,5576,5242,10818
6981,20200527,수인분당선,오리,11735,10038,21773
6982,20200527,수인분당선,미금,15711,16699,32410
6983,20200527,수인분당선,정자,16771,17980,34751
6984,20200527,수인분당선,수내,12606,12782,25388
6985,20200527,수인분당선,서현,24682,25004,49686
6986,20200527,수인분당선,야탑,25476,26875,52351
6987,20200527,수인분당선,모란,19285,19419,38704
6988,20200527,수인분당선,태평,13337,13075,26412
6989,20200527,수인분당선,가천대,9503,10250,19753
6990,20200527,수인분당선,선정릉,8014,8753,16767
6991,20200527,수인분당선,강남구청,9433,10899,20332
6992,20200527,수인분당선,압구정로데오,15909,18429,34338
6993,20200527,수인분당선,서울숲,9556,9624,19180
6994,20200527,수인분당선,수원,7416,5093,12509
6995,20200527,수인분당선,수서,13045,13229,26274
6996,20200527,수인분당선,대모산입구,3344,3199,6543
6997,20200527,수인분당선,개포동,3357,3556,6913
6998,20200527,수인분당선,구룡,1647,1605,3252
6999,20200527,수인분당선,도곡,6257,6532,12789
7000,20200527,수인분당선,한티,12962,13927,26889
7001,20200527,수인분당선,선릉,13536,21313,34849
7002,20200528,수인분당선,인천,827,1356,2183
7003,20200528,수인분당선,신포,1619,1683,3302
7004,20200528,수인분당선,숭의,3477,3306,6783
7005,20200528,수인분당선,인하대,4649,4221,8870
7006,20200528,수인분당선,송도,2370,2231,4601
7007,20200528,수인분당선,연수,4155,4227,8382
7008,20200528,수인분당선,원인재,3950,3998,7948
7009,20200528,수인분당선,남동인더스파크,2190,2366,4556
7010,20200528,수인분당선,호구포,3353,3352,6705
7011,20200528,수인분당선,인천논현,5090,5277,10367
7012,20200528,수인분당선,소래포구,4804,4569,9373
7013,20200528,수인분당선,월곶,2089,2024,4113
7014,20200528,수인분당선,달월,74,56,130
7015,20200528,수인분당선,매교,2465,2485,4950
7016,20200528,수인분당선,수원시청,10381,11418,21799
7017,20200528,수인분당선,매탄권선,4285,4060,8345
7018,20200528,수인분당선,망포,12952,12218,25170
7019,20200528,수인분당선,영통,7643,7915,15558
7020,20200528,수인분당선,청명,3963,3826,7789
7021,20200528,수인분당선,상갈,5158,4959,10117
7022,20200528,수인분당선,기흥,9375,8849,18224
7023,20200528,수인분당선,신갈,4470,4330,8800
7024,20200528,수인분당선,구성,4702,4852,9554
7025,20200528,수인분당선,죽전,13118,14253,27371
7026,20200528,수인분당선,보정,2523,2102,4625
7027,20200528,수인분당선,이매,5547,5128,10675
7028,20200528,수인분당선,오리,11661,9886,21547
7029,20200528,수인분당선,미금,15270,16439,31709
7030,20200528,수인분당선,정자,16528,17845,34373
7031,20200528,수인분당선,수내,12543,12456,24999
7032,20200528,수인분당선,서현,23767,24434,48201
7033,20200528,수인분당선,야탑,25256,26336,51592
7034,20200528,수인분당선,모란,19280,19342,38622
7035,20200528,수인분당선,태평,13196,12909,26105
7036,20200528,수인분당선,가천대,9761,10489,20250
7037,20200528,수인분당선,선정릉,7948,8781,16729
7038,20200528,수인분당선,강남구청,9147,10736,19883
7039,20200528,수인분당선,압구정로데오,16244,18388,34632
7040,20200528,수인분당선,서울숲,9170,9285,18455
7041,20200528,수인분당선,수원,7323,4983,12306
7042,20200528,수인분당선,수서,13337,13616,26953
7043,20200528,수인분당선,대모산입구,3369,3083,6452
7044,20200528,수인분당선,개포동,3198,3297,6495
7045,20200528,수인분당선,구룡,1586,1585,3171
7046,20200528,수인분당선,도곡,6410,6475,12885
7047,20200528,수인분당선,한티,12709,13451,26160
7048,20200528,수인분당선,선릉,13372,21215,34587
7049,20200529,수인분당선,선릉,13288,21103,34391
7050,20200529,수인분당선,한티,13353,14365,27718
7051,20200529,수인분당선,도곡,6435,6466,12901
7052,20200529,수인분당선,구룡,1726,1631,3357
7053,20200529,수인분당선,개포동,3339,3570,6909
7054,20200529,수인분당선,대모산입구,3418,3224,6642
7055,20200529,수인분당선,수서,14917,15767,30684
7056,20200529,수인분당선,복정,1,0,1
7057,20200529,수인분당선,수원,8163,5793,13956
7058,20200529,수인분당선,서울숲,9518,9536,19054
7059,20200529,수인분당선,압구정로데오,17174,20766,37940
7060,20200529,수인분당선,강남구청,9704,11059,20763
7061,20200529,수인분당선,선정릉,8000,8707,16707
7062,20200529,수인분당선,가천대,9209,9388,18597
7063,20200529,수인분당선,태평,13938,13365,27303
7064,20200529,수인분당선,모란,25995,27335,53330
7065,20200529,수인분당선,야탑,26394,27943,54337
7066,20200529,수인분당선,서현,25677,26452,52129
7067,20200529,수인분당선,수내,12932,13074,26006
7068,20200529,수인분당선,정자,16908,18266,35174
7069,20200529,수인분당선,미금,16046,17349,33395
7070,20200529,수인분당선,오리,12080,10130,22210
7071,20200529,수인분당선,이매,5791,5356,11147
7072,20200529,수인분당선,보정,2562,2108,4670
7073,20200529,수인분당선,죽전,14162,15132,29294
7074,20200529,수인분당선,구성,5031,5100,10131
7075,20200529,수인분당선,신갈,4502,4419,8921
7076,20200529,수인분당선,기흥,9649,9100,18749
7077,20200529,수인분당선,상갈,5420,5051,10471
7078,20200529,수인분당선,청명,4331,3912,8243
7079,20200529,수인분당선,영통,8300,8667,16967
7080,20200529,수인분당선,망포,14145,12823,26968
7081,20200529,수인분당선,매탄권선,4777,4386,9163
7082,20200529,수인분당선,수원시청,11177,13440,24617
7083,20200529,수인분당선,매교,2548,2561,5109
7084,20200529,수인분당선,달월,83,56,139
7085,20200529,수인분당선,월곶,2202,1999,4201
7086,20200529,수인분당선,소래포구,4592,4460,9052
7087,20200529,수인분당선,인천논현,5156,5592,10748
7088,20200529,수인분당선,호구포,3385,3334,6719
7089,20200529,수인분당선,남동인더스파크,2051,2227,4278
7090,20200529,수인분당선,원인재,4067,4086,8153
7091,20200529,수인분당선,연수,4367,4491,8858
7092,20200529,수인분당선,송도,2470,2328,4798
7093,20200529,수인분당선,인하대,4683,4372,9055
7094,20200529,수인분당선,숭의,3500,3147,6647
7095,20200529,수인분당선,신포,1653,1793,3446
7096,20200529,수인분당선,인천,798,1344,2142
7097,20200530,수인분당선,월곶,1609,1610,3219
7098,20200530,수인분당선,선릉,4673,7544,12217
7099,20200530,수인분당선,한티,9729,9342,19071
7100,20200530,수인분당선,도곡,3875,3598,7473
7101,20200530,수인분당선,구룡,912,801,1713
7102,20200530,수인분당선,개포동,2050,2080,4130
7103,20200530,수인분당선,대모산입구,2329,2160,4489
7104,20200530,수인분당선,수서,9063,9642,18705
7105,20200530,수인분당선,수원,6027,4075,10102
7106,20200530,수인분당선,서울숲,7361,7818,15179
7107,20200530,수인분당선,압구정로데오,13271,16025,29296
7108,20200530,수인분당선,강남구청,4488,5587,10075
7109,20200530,수인분당선,선정릉,3496,3633,7129
7110,20200530,수인분당선,가천대,4594,5017,9611
7111,20200530,수인분당선,태평,10000,9239,19239
7112,20200530,수인분당선,모란,14409,14771,29180
7113,20200530,수인분당선,야탑,16207,17274,33481
7114,20200530,수인분당선,서현,16752,17386,34138
7115,20200530,수인분당선,수내,8021,7438,15459
7116,20200530,수인분당선,정자,10293,10473,20766
7117,20200530,수인분당선,미금,10178,10488,20666
7118,20200530,수인분당선,오리,7378,6130,13508
7119,20200530,수인분당선,이매,3829,3567,7396
7120,20200530,수인분당선,보정,1402,1263,2665
7121,20200530,수인분당선,죽전,9518,10432,19950
7122,20200530,수인분당선,구성,3087,3102,6189
7123,20200530,수인분당선,신갈,2551,2569,5120
7124,20200530,수인분당선,기흥,6186,5888,12074
7125,20200530,수인분당선,상갈,3404,3372,6776
7126,20200530,수인분당선,청명,2550,2390,4940
7127,20200530,수인분당선,영통,5686,5642,11328
7128,20200530,수인분당선,망포,8000,7186,15186
7129,20200530,수인분당선,매탄권선,2872,2581,5453
7130,20200530,수인분당선,수원시청,8406,9764,18170
7131,20200530,수인분당선,매교,1649,1715,3364
7132,20200530,수인분당선,달월,55,50,105
7133,20200530,수인분당선,소래포구,4297,4373,8670
7134,20200530,수인분당선,인천논현,3777,3869,7646
7135,20200530,수인분당선,호구포,1945,1842,3787
7136,20200530,수인분당선,남동인더스파크,790,736,1526
7137,20200530,수인분당선,원인재,2992,3097,6089
7138,20200530,수인분당선,인천,718,1165,1883
7139,20200530,수인분당선,신포,1142,1301,2443
7140,20200530,수인분당선,숭의,2058,1954,4012
7141,20200530,수인분당선,인하대,2976,2655,5631
7142,20200530,수인분당선,송도,1883,1753,3636
7143,20200530,수인분당선,연수,3319,3361,6680
7144,20200531,수인분당선,인천,703,1013,1716
7145,20200531,수인분당선,신포,917,895,1812
7146,20200531,수인분당선,숭의,1555,1407,2962
7147,20200531,수인분당선,인하대,2026,1998,4024
7148,20200531,수인분당선,송도,1233,1183,2416
7149,20200531,수인분당선,연수,2332,2243,4575
7150,20200531,수인분당선,원인재,2040,2155,4195
7151,20200531,수인분당선,남동인더스파크,492,515,1007
7152,20200531,수인분당선,호구포,1389,1432,2821
7153,20200531,수인분당선,인천논현,2540,2606,5146
7154,20200531,수인분당선,소래포구,3605,3558,7163
7155,20200531,수인분당선,월곶,1194,1242,2436
7156,20200531,수인분당선,달월,23,31,54
7157,20200531,수인분당선,매교,961,980,1941
7158,20200531,수인분당선,수원시청,5653,5592,11245
7159,20200531,수인분당선,매탄권선,2032,1991,4023
7160,20200531,수인분당선,망포,5019,5250,10269
7161,20200531,수인분당선,영통,3873,3827,7700
7162,20200531,수인분당선,청명,1625,1635,3260
7163,20200531,수인분당선,상갈,2386,2505,4891
7164,20200531,수인분당선,기흥,4183,4089,8272
7165,20200531,수인분당선,신갈,1650,1609,3259
7166,20200531,수인분당선,구성,2080,2152,4232
7167,20200531,수인분당선,죽전,6870,7833,14703
7168,20200531,수인분당선,보정,938,890,1828
7169,20200531,수인분당선,이매,2559,2570,5129
7170,20200531,수인분당선,오리,4797,4208,9005
7171,20200531,수인분당선,미금,6249,6805,13054
7172,20200531,수인분당선,정자,6435,6747,13182
7173,20200531,수인분당선,수내,5336,5208,10544
7174,20200531,수인분당선,서현,11291,11508,22799
7175,20200531,수인분당선,야탑,11653,11820,23473
7176,20200531,수인분당선,모란,9798,9884,19682
7177,20200531,수인분당선,태평,6793,6384,13177
7178,20200531,수인분당선,가천대,2657,3292,5949
7179,20200531,수인분당선,선정릉,1956,2080,4036
7180,20200531,수인분당선,강남구청,2514,3071,5585
7181,20200531,수인분당선,압구정로데오,7240,8251,15491
7182,20200531,수인분당선,서울숲,4667,4901,9568
7183,20200531,수인분당선,수원,4221,2868,7089
7184,20200531,수인분당선,수서,7437,6865,14302
7185,20200531,수인분당선,대모산입구,1545,1412,2957
7186,20200531,수인분당선,개포동,1616,1619,3235
7187,20200531,수인분당선,구룡,483,523,1006
7188,20200531,수인분당선,도곡,2131,2165,4296
7189,20200531,수인분당선,한티,6228,6502,12730
7190,20200531,수인분당선,선릉,2417,3549,5966
7191,20200601,수인분당선,인천,779,1313,2092
7192,20200601,수인분당선,신포,1595,1637,3232
7193,20200601,수인분당선,숭의,3394,3181,6575
7194,20200601,수인분당선,인하대,4633,4355,8988
7195,20200601,수인분당선,송도,2301,2094,4395
7196,20200601,수인분당선,연수,4070,4098,8168
7197,20200601,수인분당선,원인재,3894,3997,7891
7198,20200601,수인분당선,남동인더스파크,2067,2298,4365
7199,20200601,수인분당선,호구포,3206,3292,6498
7200,20200601,수인분당선,인천논현,5029,5286,10315
7201,20200601,수인분당선,소래포구,4297,3956,8253
7202,20200601,수인분당선,월곶,2077,1952,4029
7203,20200601,수인분당선,달월,83,65,148
7204,20200601,수인분당선,매교,2446,2343,4789
7205,20200601,수인분당선,수원시청,9937,10632,20569
7206,20200601,수인분당선,매탄권선,4030,3949,7979
7207,20200601,수인분당선,망포,12244,11802,24046
7208,20200601,수인분당선,영통,7267,7585,14852
7209,20200601,수인분당선,청명,3904,3711,7615
7210,20200601,수인분당선,상갈,5070,4729,9799
7211,20200601,수인분당선,기흥,9061,8542,17603
7212,20200601,수인분당선,신갈,4324,4232,8556
7213,20200601,수인분당선,구성,4701,4776,9477
7214,20200601,수인분당선,죽전,12585,13725,26310
7215,20200601,수인분당선,보정,2404,2037,4441
7216,20200601,수인분당선,이매,5276,4861,10137
7217,20200601,수인분당선,오리,11061,9461,20522
7218,20200601,수인분당선,미금,14925,15905,30830
7219,20200601,수인분당선,정자,15319,16374,31693
7220,20200601,수인분당선,수내,12015,12072,24087
7221,20200601,수인분당선,서현,23584,23986,47570
7222,20200601,수인분당선,야탑,23953,25400,49353
7223,20200601,수인분당선,모란,18769,18822,37591
7224,20200601,수인분당선,태평,12859,12708,25567
7225,20200601,수인분당선,가천대,5475,6249,11724
7226,20200601,수인분당선,선정릉,7796,8398,16194
7227,20200601,수인분당선,강남구청,8993,10353,19346
7228,20200601,수인분당선,압구정로데오,14675,16490,31165
7229,20200601,수인분당선,서울숲,8639,8787,17426
7230,20200601,수인분당선,수원,7087,4935,12022
7231,20200601,수인분당선,복정,1,0,1
7232,20200601,수인분당선,수서,12738,12759,25497
7233,20200601,수인분당선,대모산입구,3327,3093,6420
7234,20200601,수인분당선,개포동,3132,3313,6445
7235,20200601,수인분당선,구룡,1609,1585,3194
7236,20200601,수인분당선,도곡,6445,6631,13076
7237,20200601,수인분당선,한티,12141,13000,25141
7238,20200601,수인분당선,선릉,13216,20758,33974
7239,20200602,수인분당선,인천,673,1167,1840
7240,20200602,수인분당선,신포,1462,1544,3006
7241,20200602,수인분당선,숭의,3321,3093,6414
7242,20200602,수인분당선,인하대,4432,4202,8634
7243,20200602,수인분당선,송도,2176,1993,4169
7244,20200602,수인분당선,연수,3816,3838,7654
7245,20200602,수인분당선,원인재,3787,3800,7587
7246,20200602,수인분당선,남동인더스파크,2016,2285,4301
7247,20200602,수인분당선,호구포,3178,3221,6399
7248,20200602,수인분당선,인천논현,4711,5064,9775
7249,20200602,수인분당선,소래포구,3820,3517,7337
7250,20200602,수인분당선,월곶,1927,1868,3795
7251,20200602,수인분당선,달월,82,52,134
7252,20200602,수인분당선,매교,2379,2319,4698
7253,20200602,수인분당선,수원시청,9661,10486,20147
7254,20200602,수인분당선,매탄권선,3991,3865,7856
7255,20200602,수인분당선,망포,11995,11612,23607
7256,20200602,수인분당선,영통,6877,7122,13999
7257,20200602,수인분당선,청명,3772,3645,7417
7258,20200602,수인분당선,상갈,4957,4712,9669
7259,20200602,수인분당선,기흥,8865,8343,17208
7260,20200602,수인분당선,신갈,4245,4085,8330
7261,20200602,수인분당선,구성,4602,4827,9429
7262,20200602,수인분당선,죽전,12148,13368,25516
7263,20200602,수인분당선,보정,2382,2005,4387
7264,20200602,수인분당선,이매,5174,4838,10012
7265,20200602,수인분당선,오리,11113,9407,20520
7266,20200602,수인분당선,미금,14629,15663,30292
7267,20200602,수인분당선,정자,15588,16905,32493
7268,20200602,수인분당선,수내,11881,12037,23918
7269,20200602,수인분당선,서현,22538,22927,45465
7270,20200602,수인분당선,야탑,23579,24863,48442
7271,20200602,수인분당선,모란,18278,18280,36558
7272,20200602,수인분당선,태평,12701,12235,24936
7273,20200602,수인분당선,가천대,5302,6194,11496
7274,20200602,수인분당선,선정릉,7770,8477,16247
7275,20200602,수인분당선,강남구청,9212,10475,19687
7276,20200602,수인분당선,압구정로데오,15466,17485,32951
7277,20200602,수인분당선,서울숲,8305,8455,16760
7278,20200602,수인분당선,수원,6866,4762,11628
7279,20200602,수인분당선,복정,1,0,1
7280,20200602,수인분당선,수서,12335,12581,24916
7281,20200602,수인분당선,대모산입구,3338,3054,6392
7282,20200602,수인분당선,개포동,3118,3277,6395
7283,20200602,수인분당선,구룡,1537,1545,3082
7284,20200602,수인분당선,도곡,6175,6331,12506
7285,20200602,수인분당선,한티,12098,13062,25160
7286,20200602,수인분당선,선릉,13260,20707,33967
7287,20200603,수인분당선,인천,735,1272,2007
7288,20200603,수인분당선,신포,1551,1618,3169
7289,20200603,수인분당선,숭의,3450,3135,6585
7290,20200603,수인분당선,인하대,4628,4377,9005
7291,20200603,수인분당선,송도,2287,2140,4427
7292,20200603,수인분당선,연수,4076,4109,8185
7293,20200603,수인분당선,원인재,3828,3968,7796
7294,20200603,수인분당선,남동인더스파크,2176,2300,4476
7295,20200603,수인분당선,호구포,3267,3288,6555
7296,20200603,수인분당선,인천논현,5070,5378,10448
7297,20200603,수인분당선,소래포구,4604,4357,8961
7298,20200603,수인분당선,월곶,2142,1992,4134
7299,20200603,수인분당선,달월,83,48,131
7300,20200603,수인분당선,매교,2383,2402,4785
7301,20200603,수인분당선,수원시청,10059,11074,21133
7302,20200603,수인분당선,매탄권선,4150,3885,8035
7303,20200603,수인분당선,망포,12510,11899,24409
7304,20200603,수인분당선,영통,7185,7601,14786
7305,20200603,수인분당선,청명,3842,3593,7435
7306,20200603,수인분당선,상갈,5185,4887,10072
7307,20200603,수인분당선,기흥,9069,8707,17776
7308,20200603,수인분당선,신갈,4337,4290,8627
7309,20200603,수인분당선,구성,4740,4830,9570
7310,20200603,수인분당선,죽전,12761,13856,26617
7311,20200603,수인분당선,보정,2486,2082,4568
7312,20200603,수인분당선,이매,5561,5099,10660
7313,20200603,수인분당선,오리,11472,9751,21223
7314,20200603,수인분당선,미금,15570,16554,32124
7315,20200603,수인분당선,정자,16208,17315,33523
7316,20200603,수인분당선,수내,12394,12502,24896
7317,20200603,수인분당선,서현,23714,24155,47869
7318,20200603,수인분당선,야탑,24719,25961,50680
7319,20200603,수인분당선,모란,18920,19303,38223
7320,20200603,수인분당선,태평,13005,12672,25677
7321,20200603,수인분당선,가천대,5614,6550,12164
7322,20200603,수인분당선,선정릉,7858,8525,16383
7323,20200603,수인분당선,강남구청,9447,10851,20298
7324,20200603,수인분당선,압구정로데오,15823,18092,33915
7325,20200603,수인분당선,서울숲,8992,9071,18063
7326,20200603,수인분당선,수원,7280,5006,12286
7327,20200603,수인분당선,수서,12681,12959,25640
7328,20200603,수인분당선,대모산입구,3316,3082,6398
7329,20200603,수인분당선,개포동,3335,3533,6868
7330,20200603,수인분당선,구룡,1631,1557,3188
7331,20200603,수인분당선,도곡,6339,6430,12769
7332,20200603,수인분당선,한티,12659,13476,26135
7333,20200603,수인분당선,선릉,13296,20883,34179
7334,20200604,수인분당선,선릉,13121,21129,34250
7335,20200604,수인분당선,한티,12432,13455,25887
7336,20200604,수인분당선,도곡,6360,6466,12826
7337,20200604,수인분당선,구룡,1630,1599,3229
7338,20200604,수인분당선,개포동,3175,3343,6518
7339,20200604,수인분당선,대모산입구,3475,3228,6703
7340,20200604,수인분당선,수서,13508,13610,27118
7341,20200604,수인분당선,수원,7336,5059,12395
7342,20200604,수인분당선,서울숲,8940,9199,18139
7343,20200604,수인분당선,압구정로데오,16014,18337,34351
7344,20200604,수인분당선,강남구청,9318,10759,20077
7345,20200604,수인분당선,선정릉,7967,8657,16624
7346,20200604,수인분당선,가천대,5635,6526,12161
7347,20200604,수인분당선,태평,13389,12882,26271
7348,20200604,수인분당선,모란,24574,25393,49967
7349,20200604,수인분당선,야탑,24893,26293,51186
7350,20200604,수인분당선,서현,23592,24060,47652
7351,20200604,수인분당선,수내,12369,12608,24977
7352,20200604,수인분당선,정자,16244,17544,33788
7353,20200604,수인분당선,미금,15374,16518,31892
7354,20200604,수인분당선,오리,11679,9787,21466
7355,20200604,수인분당선,이매,5456,5097,10553
7356,20200604,수인분당선,보정,2459,2078,4537
7357,20200604,수인분당선,죽전,12935,14083,27018
7358,20200604,수인분당선,구성,4803,4881,9684
7359,20200604,수인분당선,신갈,4323,4288,8611
7360,20200604,수인분당선,기흥,9145,8610,17755
7361,20200604,수인분당선,상갈,5213,4810,10023
7362,20200604,수인분당선,청명,3925,3696,7621
7363,20200604,수인분당선,영통,7325,7579,14904
7364,20200604,수인분당선,망포,12542,11830,24372
7365,20200604,수인분당선,매탄권선,4238,4061,8299
7366,20200604,수인분당선,수원시청,10010,10943,20953
7367,20200604,수인분당선,매교,2392,2385,4777
7368,20200604,수인분당선,달월,76,50,126
7369,20200604,수인분당선,월곶,2015,1953,3968
7370,20200604,수인분당선,소래포구,4570,4283,8853
7371,20200604,수인분당선,인천논현,4982,5287,10269
7372,20200604,수인분당선,호구포,3274,3341,6615
7373,20200604,수인분당선,남동인더스파크,2193,2395,4588
7374,20200604,수인분당선,원인재,3781,3854,7635
7375,20200604,수인분당선,연수,3925,3939,7864
7376,20200604,수인분당선,송도,2269,2119,4388
7377,20200604,수인분당선,인하대,4569,4243,8812
7378,20200604,수인분당선,숭의,3357,3141,6498
7379,20200604,수인분당선,신포,1484,1566,3050
7380,20200604,수인분당선,인천,762,1246,2008
7381,20200605,수인분당선,인천,820,1340,2160
7382,20200605,수인분당선,신포,1606,1674,3280
7383,20200605,수인분당선,숭의,3488,3117,6605
7384,20200605,수인분당선,인하대,4718,4426,9144
7385,20200605,수인분당선,송도,2366,2227,4593
7386,20200605,수인분당선,연수,4162,4269,8431
7387,20200605,수인분당선,원인재,3962,4137,8099
7388,20200605,수인분당선,남동인더스파크,1962,2175,4137
7389,20200605,수인분당선,호구포,3394,3341,6735
7390,20200605,수인분당선,인천논현,5129,5429,10558
7391,20200605,수인분당선,소래포구,4803,4636,9439
7392,20200605,수인분당선,월곶,2150,2030,4180
7393,20200605,수인분당선,달월,81,61,142
7394,20200605,수인분당선,매교,2503,2507,5010
7395,20200605,수인분당선,수원시청,10761,12941,23702
7396,20200605,수인분당선,매탄권선,4509,4137,8646
7397,20200605,수인분당선,망포,13489,12405,25894
7398,20200605,수인분당선,영통,7871,8172,16043
7399,20200605,수인분당선,청명,4257,3756,8013
7400,20200605,수인분당선,상갈,5260,4859,10119
7401,20200605,수인분당선,기흥,9609,8930,18539
7402,20200605,수인분당선,신갈,4543,4410,8953
7403,20200605,수인분당선,구성,4820,4825,9645
7404,20200605,수인분당선,죽전,13730,14533,28263
7405,20200605,수인분당선,보정,2544,2093,4637
7406,20200605,수인분당선,이매,5733,5095,10828
7407,20200605,수인분당선,오리,11812,9907,21719
7408,20200605,수인분당선,미금,16041,16811,32852
7409,20200605,수인분당선,정자,16801,18271,35072
7410,20200605,수인분당선,수내,12718,12759,25477
7411,20200605,수인분당선,서현,24976,25806,50782
7412,20200605,수인분당선,야탑,26167,27784,53951
7413,20200605,수인분당선,모란,19750,20077,39827
7414,20200605,수인분당선,태평,13462,12838,26300
7415,20200605,수인분당선,가천대,5957,6414,12371
7416,20200605,수인분당선,선정릉,8061,8708,16769
7417,20200605,수인분당선,강남구청,9573,11014,20587
7418,20200605,수인분당선,압구정로데오,17394,20838,38232
7419,20200605,수인분당선,서울숲,9557,9577,19134
7420,20200605,수인분당선,수원,7839,5685,13524
7421,20200605,수인분당선,수서,14393,15524,29917
7422,20200605,수인분당선,대모산입구,3308,3067,6375
7423,20200605,수인분당선,개포동,3325,3525,6850
7424,20200605,수인분당선,구룡,1609,1513,3122
7425,20200605,수인분당선,도곡,6544,6502,13046
7426,20200605,수인분당선,한티,13406,14028,27434
7427,20200605,수인분당선,선릉,13137,20721,33858
7428,20200606,수인분당선,인천,795,1204,1999
7429,20200606,수인분당선,신포,936,942,1878
7430,20200606,수인분당선,숭의,1856,1677,3533
7431,20200606,수인분당선,인하대,2608,2379,4987
7432,20200606,수인분당선,송도,1623,1544,3167
7433,20200606,수인분당선,연수,2796,2833,5629
7434,20200606,수인분당선,원인재,2596,2710,5306
7435,20200606,수인분당선,남동인더스파크,676,584,1260
7436,20200606,수인분당선,호구포,1675,1652,3327
7437,20200606,수인분당선,인천논현,2933,3074,6007
7438,20200606,수인분당선,소래포구,4777,4806,9583
7439,20200606,수인분당선,월곶,1483,1450,2933
7440,20200606,수인분당선,달월,50,51,101
7441,20200606,수인분당선,매교,1167,1256,2423
7442,20200606,수인분당선,수원시청,7446,8719,16165
7443,20200606,수인분당선,매탄권선,2532,2299,4831
7444,20200606,수인분당선,망포,6963,6287,13250
7445,20200606,수인분당선,영통,4876,4947,9823
7446,20200606,수인분당선,청명,2170,2000,4170
7447,20200606,수인분당선,상갈,3027,3053,6080
7448,20200606,수인분당선,기흥,5676,5415,11091
7449,20200606,수인분당선,신갈,2266,2265,4531
7450,20200606,수인분당선,구성,2756,2720,5476
7451,20200606,수인분당선,죽전,8580,9486,18066
7452,20200606,수인분당선,보정,1329,1170,2499
7453,20200606,수인분당선,이매,3474,3451,6925
7454,20200606,수인분당선,오리,6693,5557,12250
7455,20200606,수인분당선,미금,9073,9309,18382
7456,20200606,수인분당선,정자,9030,9065,18095
7457,20200606,수인분당선,수내,7445,6784,14229
7458,20200606,수인분당선,서현,14741,15232,29973
7459,20200606,수인분당선,야탑,14798,15598,30396
7460,20200606,수인분당선,모란,13031,13472,26503
7461,20200606,수인분당선,태평,8837,8250,17087
7462,20200606,수인분당선,가천대,3835,4239,8074
7463,20200606,수인분당선,선정릉,2924,3027,5951
7464,20200606,수인분당선,강남구청,4030,5133,9163
7465,20200606,수인분당선,압구정로데오,11879,14782,26661
7466,20200606,수인분당선,서울숲,6465,6928,13393
7467,20200606,수인분당선,수원,5415,3515,8930
7468,20200606,수인분당선,복정,1,0,1
7469,20200606,수인분당선,수서,8130,8714,16844
7470,20200606,수인분당선,대모산입구,2033,1801,3834
7471,20200606,수인분당선,개포동,1836,1809,3645
7472,20200606,수인분당선,구룡,1183,1129,2312
7473,20200606,수인분당선,도곡,3299,2986,6285
7474,20200606,수인분당선,한티,8184,7860,16044
7475,20200606,수인분당선,선릉,3843,6322,10165
7476,20200607,수인분당선,한티,5872,5970,11842
7477,20200607,수인분당선,선릉,2336,3747,6083
7478,20200607,수인분당선,복정,1,0,1
7479,20200607,수인분당선,인천,654,907,1561
7480,20200607,수인분당선,신포,820,865,1685
7481,20200607,수인분당선,숭의,1485,1351,2836
7482,20200607,수인분당선,인하대,2092,2082,4174
7483,20200607,수인분당선,송도,1278,1199,2477
7484,20200607,수인분당선,연수,2206,2271,4477
7485,20200607,수인분당선,원인재,2071,2149,4220
7486,20200607,수인분당선,남동인더스파크,547,578,1125
7487,20200607,수인분당선,호구포,1305,1372,2677
7488,20200607,수인분당선,인천논현,2337,2415,4752
7489,20200607,수인분당선,소래포구,3721,3593,7314
7490,20200607,수인분당선,월곶,1260,1156,2416
7491,20200607,수인분당선,달월,31,30,61
7492,20200607,수인분당선,매교,1009,949,1958
7493,20200607,수인분당선,수원시청,5594,5758,11352
7494,20200607,수인분당선,매탄권선,1959,1816,3775
7495,20200607,수인분당선,망포,5117,5242,10359
7496,20200607,수인분당선,영통,4039,4007,8046
7497,20200607,수인분당선,청명,1647,1629,3276
7498,20200607,수인분당선,상갈,2289,2409,4698
7499,20200607,수인분당선,기흥,4166,4143,8309
7500,20200607,수인분당선,신갈,1664,1719,3383
7501,20200607,수인분당선,구성,2073,2112,4185
7502,20200607,수인분당선,죽전,6795,7966,14761
7503,20200607,수인분당선,보정,898,800,1698
7504,20200607,수인분당선,이매,2713,2699,5412
7505,20200607,수인분당선,오리,4626,4278,8904
7506,20200607,수인분당선,미금,6249,6501,12750
7507,20200607,수인분당선,정자,6256,6613,12869
7508,20200607,수인분당선,수내,5317,5148,10465
7509,20200607,수인분당선,서현,11522,11827,23349
7510,20200607,수인분당선,야탑,11866,11963,23829
7511,20200607,수인분당선,모란,9669,10153,19822
7512,20200607,수인분당선,태평,7004,6587,13591
7513,20200607,수인분당선,가천대,3742,4305,8047
7514,20200607,수인분당선,선정릉,1868,1917,3785
7515,20200607,수인분당선,강남구청,2619,3229,5848
7516,20200607,수인분당선,압구정로데오,7345,8242,15587
7517,20200607,수인분당선,서울숲,4692,4776,9468
7518,20200607,수인분당선,수원,4236,2851,7087
7519,20200607,수인분당선,수서,7983,7363,15346
7520,20200607,수인분당선,대모산입구,1217,1230,2447
7521,20200607,수인분당선,개포동,1633,1596,3229
7522,20200607,수인분당선,구룡,644,650,1294
7523,20200607,수인분당선,도곡,2356,2185,4541
7524,20200608,수인분당선,선릉,12981,20801,33782
7525,20200608,수인분당선,한티,12188,13157,25345
7526,20200608,수인분당선,도곡,6443,6600,13043
7527,20200608,수인분당선,인천,771,1275,2046
7528,20200608,수인분당선,신포,1506,1544,3050
7529,20200608,수인분당선,숭의,3472,3225,6697
7530,20200608,수인분당선,인하대,4579,4338,8917
7531,20200608,수인분당선,송도,2284,2125,4409
7532,20200608,수인분당선,연수,3911,3971,7882
7533,20200608,수인분당선,원인재,3952,4039,7991
7534,20200608,수인분당선,남동인더스파크,2098,2265,4363
7535,20200608,수인분당선,호구포,3176,3248,6424
7536,20200608,수인분당선,인천논현,4935,5253,10188
7537,20200608,수인분당선,소래포구,4547,4237,8784
7538,20200608,수인분당선,월곶,2048,1951,3999
7539,20200608,수인분당선,달월,81,57,138
7540,20200608,수인분당선,매교,2349,2353,4702
7541,20200608,수인분당선,수원시청,9964,10801,20765
7542,20200608,수인분당선,매탄권선,4147,3903,8050
7543,20200608,수인분당선,망포,12423,11847,24270
7544,20200608,수인분당선,영통,7079,7466,14545
7545,20200608,수인분당선,청명,3900,3686,7586
7546,20200608,수인분당선,상갈,4979,4706,9685
7547,20200608,수인분당선,기흥,9056,8528,17584
7548,20200608,수인분당선,신갈,4416,4258,8674
7549,20200608,수인분당선,구성,4580,4773,9353
7550,20200608,수인분당선,죽전,12210,13357,25567
7551,20200608,수인분당선,보정,2444,2012,4456
7552,20200608,수인분당선,이매,5214,4894,10108
7553,20200608,수인분당선,오리,10966,9527,20493
7554,20200608,수인분당선,미금,15110,15613,30723
7555,20200608,수인분당선,정자,15706,16935,32641
7556,20200608,수인분당선,수내,12148,12203,24351
7557,20200608,수인분당선,서현,23209,23730,46939
7558,20200608,수인분당선,야탑,24169,25349,49518
7559,20200608,수인분당선,모란,18734,18768,37502
7560,20200608,수인분당선,태평,12818,12544,25362
7561,20200608,수인분당선,가천대,6121,6960,13081
7562,20200608,수인분당선,선정릉,7761,8406,16167
7563,20200608,수인분당선,강남구청,8882,10252,19134
7564,20200608,수인분당선,압구정로데오,14625,16307,30932
7565,20200608,수인분당선,서울숲,8551,8636,17187
7566,20200608,수인분당선,수원,7103,4903,12006
7567,20200608,수인분당선,수서,12791,12949,25740
7568,20200608,수인분당선,대모산입구,3418,3205,6623
7569,20200608,수인분당선,개포동,3118,3340,6458
7570,20200608,수인분당선,구룡,1570,1556,3126
7571,20200609,수인분당선,기흥,9130,8657,17787
7572,20200609,수인분당선,신갈,4331,4205,8536
7573,20200609,수인분당선,구성,4799,4852,9651
7574,20200609,수인분당선,죽전,12653,13997,26650
7575,20200609,수인분당선,상갈,5157,4771,9928
7576,20200609,수인분당선,인천,788,1246,2034
7577,20200609,수인분당선,신포,1578,1606,3184
7578,20200609,수인분당선,숭의,3453,3230,6683
7579,20200609,수인분당선,인하대,4596,4342,8938
7580,20200609,수인분당선,송도,2261,2039,4300
7581,20200609,수인분당선,연수,3881,4043,7924
7582,20200609,수인분당선,원인재,3888,3854,7742
7583,20200609,수인분당선,남동인더스파크,2116,2316,4432
7584,20200609,수인분당선,호구포,3222,3275,6497
7585,20200609,수인분당선,인천논현,4864,5181,10045
7586,20200609,수인분당선,소래포구,4538,4307,8845
7587,20200609,수인분당선,월곶,2139,2016,4155
7588,20200609,수인분당선,달월,74,56,130
7589,20200609,수인분당선,매교,2376,2361,4737
7590,20200609,수인분당선,수원시청,10014,10920,20934
7591,20200609,수인분당선,매탄권선,4208,3943,8151
7592,20200609,수인분당선,망포,12523,12034,24557
7593,20200609,수인분당선,영통,7220,7674,14894
7594,20200609,수인분당선,청명,4026,3892,7918
7595,20200609,수인분당선,보정,2443,2050,4493
7596,20200609,수인분당선,이매,5458,5259,10717
7597,20200609,수인분당선,오리,11390,9668,21058
7598,20200609,수인분당선,미금,15350,16427,31777
7599,20200609,수인분당선,정자,16243,17212,33455
7600,20200609,수인분당선,수내,12392,12455,24847
7601,20200609,수인분당선,서현,23593,24203,47796
7602,20200609,수인분당선,야탑,24598,25621,50219
7603,20200609,수인분당선,모란,23491,24165,47656
7604,20200609,수인분당선,태평,13171,12810,25981
7605,20200609,수인분당선,가천대,6319,7214,13533
7606,20200609,수인분당선,선정릉,8047,8701,16748
7607,20200609,수인분당선,강남구청,9526,11007,20533
7608,20200609,수인분당선,압구정로데오,15957,18045,34002
7609,20200609,수인분당선,서울숲,9032,9045,18077
7610,20200609,수인분당선,수원,7256,5154,12410
7611,20200609,수인분당선,수서,12963,13353,26316
7612,20200609,수인분당선,대모산입구,3466,3196,6662
7613,20200609,수인분당선,개포동,3171,3429,6600
7614,20200609,수인분당선,구룡,1595,1541,3136
7615,20200609,수인분당선,도곡,6339,6408,12747
7616,20200609,수인분당선,한티,12617,13591,26208
7617,20200609,수인분당선,선릉,13161,20967,34128
7618,20200610,수인분당선,선릉,13352,20951,34303
7619,20200610,수인분당선,한티,12623,13767,26390
7620,20200610,수인분당선,도곡,6310,6563,12873
7621,20200610,수인분당선,구룡,1664,1641,3305
7622,20200610,수인분당선,개포동,3304,3617,6921
7623,20200610,수인분당선,대모산입구,3306,3123,6429
7624,20200610,수인분당선,수서,12763,13102,25865
7625,20200610,수인분당선,수원,7318,5008,12326
7626,20200610,수인분당선,서울숲,8836,9152,17988
7627,20200610,수인분당선,압구정로데오,16465,18285,34750
7628,20200610,수인분당선,강남구청,9635,10988,20623
7629,20200610,수인분당선,선정릉,8261,8780,17041
7630,20200610,수인분당선,가천대,6230,7229,13459
7631,20200610,수인분당선,태평,12895,12416,25311
7632,20200610,수인분당선,모란,18673,18776,37449
7633,20200610,수인분당선,야탑,24204,25717,49921
7634,20200610,수인분당선,서현,23694,23952,47646
7635,20200610,수인분당선,수내,12412,12663,25075
7636,20200610,수인분당선,정자,16231,17692,33923
7637,20200610,수인분당선,미금,15255,16248,31503
7638,20200610,수인분당선,오리,11189,9526,20715
7639,20200610,수인분당선,이매,5378,5055,10433
7640,20200610,수인분당선,보정,2384,1994,4378
7641,20200610,수인분당선,죽전,12647,14062,26709
7642,20200610,수인분당선,구성,4670,4822,9492
7643,20200610,수인분당선,신갈,4407,4365,8772
7644,20200610,수인분당선,기흥,9051,8600,17651
7645,20200610,수인분당선,상갈,5129,4893,10022
7646,20200610,수인분당선,청명,3953,3725,7678
7647,20200610,수인분당선,영통,7317,7711,15028
7648,20200610,수인분당선,망포,12538,12087,24625
7649,20200610,수인분당선,매탄권선,4126,3986,8112
7650,20200610,수인분당선,수원시청,10305,11270,21575
7651,20200610,수인분당선,매교,2402,2367,4769
7652,20200610,수인분당선,달월,83,53,136
7653,20200610,수인분당선,월곶,2049,1904,3953
7654,20200610,수인분당선,소래포구,4592,4301,8893
7655,20200610,수인분당선,인천논현,4907,5154,10061
7656,20200610,수인분당선,호구포,3287,3360,6647
7657,20200610,수인분당선,남동인더스파크,2125,2277,4402
7658,20200610,수인분당선,원인재,3809,3924,7733
7659,20200610,수인분당선,연수,3998,4138,8136
7660,20200610,수인분당선,송도,2361,2131,4492
7661,20200610,수인분당선,인하대,4614,4392,9006
7662,20200610,수인분당선,숭의,3462,3224,6686
7663,20200610,수인분당선,신포,1561,1568,3129
7664,20200610,수인분당선,인천,774,1321,2095
7665,20200611,수인분당선,인천,822,1330,2152
7666,20200611,수인분당선,신포,1598,1624,3222
7667,20200611,수인분당선,숭의,3389,3168,6557
7668,20200611,수인분당선,인하대,4625,4379,9004
7669,20200611,수인분당선,송도,2362,2051,4413
7670,20200611,수인분당선,연수,3955,4085,8040
7671,20200611,수인분당선,원인재,3787,3886,7673
7672,20200611,수인분당선,남동인더스파크,2167,2352,4519
7673,20200611,수인분당선,호구포,3259,3348,6607
7674,20200611,수인분당선,인천논현,4925,5211,10136
7675,20200611,수인분당선,소래포구,4641,4380,9021
7676,20200611,수인분당선,월곶,2095,1951,4046
7677,20200611,수인분당선,달월,79,51,130
7678,20200611,수인분당선,매교,2357,2313,4670
7679,20200611,수인분당선,수원시청,10039,11037,21076
7680,20200611,수인분당선,상갈,5186,4842,10028
7681,20200611,수인분당선,기흥,9196,8628,17824
7682,20200611,수인분당선,신갈,4359,4193,8552
7683,20200611,수인분당선,구성,4704,4817,9521
7684,20200611,수인분당선,죽전,12818,13850,26668
7685,20200611,수인분당선,보정,2435,2000,4435
7686,20200611,수인분당선,이매,5394,4908,10302
7687,20200611,수인분당선,오리,11243,9656,20899
7688,20200611,수인분당선,미금,15090,16055,31145
7689,20200611,수인분당선,정자,16093,17247,33340
7690,20200611,수인분당선,수내,12233,12296,24529
7691,20200611,수인분당선,서현,23389,24028,47417
7692,20200611,수인분당선,야탑,24366,25456,49822
7693,20200611,수인분당선,모란,18549,18668,37217
7694,20200611,수인분당선,태평,12774,12385,25159
7695,20200611,수인분당선,가천대,6211,7046,13257
7696,20200611,수인분당선,선정릉,7884,8484,16368
7697,20200611,수인분당선,강남구청,9224,10798,20022
7698,20200611,수인분당선,압구정로데오,16216,18332,34548
7699,20200611,수인분당선,서울숲,8948,9153,18101
7700,20200611,수인분당선,수원,7290,5048,12338
7701,20200611,수인분당선,수서,13236,13491,26727
7702,20200611,수인분당선,대모산입구,3282,3057,6339
7703,20200611,수인분당선,개포동,3200,3396,6596
7704,20200611,수인분당선,구룡,1715,1667,3382
7705,20200611,수인분당선,도곡,6214,6326,12540
7706,20200611,수인분당선,한티,12452,13344,25796
7707,20200611,수인분당선,선릉,13166,20758,33924
7708,20200611,수인분당선,매탄권선,4127,3999,8126
7709,20200611,수인분당선,망포,12559,11933,24492
7710,20200611,수인분당선,영통,7417,7806,15223
7711,20200611,수인분당선,청명,3969,3798,7767
7712,20200612,수인분당선,인천,837,1364,2201
7713,20200612,수인분당선,신포,1674,1767,3441
7714,20200612,수인분당선,숭의,3510,3279,6789
7715,20200612,수인분당선,인하대,4854,4495,9349
7716,20200612,수인분당선,송도,2462,2199,4661
7717,20200612,수인분당선,연수,4172,4283,8455
7718,20200612,수인분당선,원인재,4041,4129,8170
7719,20200612,수인분당선,남동인더스파크,2062,2270,4332
7720,20200612,수인분당선,호구포,3338,3253,6591
7721,20200612,수인분당선,인천논현,5241,5501,10742
7722,20200612,수인분당선,소래포구,4692,4441,9133
7723,20200612,수인분당선,월곶,2158,1974,4132
7724,20200612,수인분당선,달월,67,53,120
7725,20200612,수인분당선,매교,2352,2387,4739
7726,20200612,수인분당선,수원시청,10846,13104,23950
7727,20200612,수인분당선,매탄권선,4460,4236,8696
7728,20200612,수인분당선,망포,13614,12645,26259
7729,20200612,수인분당선,영통,7899,8219,16118
7730,20200612,수인분당선,청명,4211,3812,8023
7731,20200612,수인분당선,상갈,5237,4931,10168
7732,20200612,수인분당선,기흥,9619,8850,18469
7733,20200612,수인분당선,신갈,4512,4365,8877
7734,20200612,수인분당선,구성,4867,4949,9816
7735,20200612,수인분당선,죽전,13815,14753,28568
7736,20200612,수인분당선,보정,2523,2065,4588
7737,20200612,수인분당선,이매,5588,5034,10622
7738,20200612,수인분당선,오리,11642,9825,21467
7739,20200612,수인분당선,미금,15481,16398,31879
7740,20200612,수인분당선,정자,16884,18300,35184
7741,20200612,수인분당선,수내,12627,12711,25338
7742,20200612,수인분당선,서현,24635,25515,50150
7743,20200612,수인분당선,야탑,25356,26962,52318
7744,20200612,수인분당선,모란,19488,19741,39229
7745,20200612,수인분당선,태평,13303,12720,26023
7746,20200612,수인분당선,가천대,6509,7065,13574
7747,20200612,수인분당선,선정릉,7887,8487,16374
7748,20200612,수인분당선,강남구청,9490,11058,20548
7749,20200612,수인분당선,압구정로데오,17579,20890,38469
7750,20200612,수인분당선,서울숲,9360,9391,18751
7751,20200612,수인분당선,수원,7963,5651,13614
7752,20200612,수인분당선,수서,14646,15618,30264
7753,20200612,수인분당선,대모산입구,3370,3121,6491
7754,20200612,수인분당선,개포동,3393,3603,6996
7755,20200612,수인분당선,구룡,1806,1663,3469
7756,20200612,수인분당선,도곡,6591,6632,13223
7757,20200612,수인분당선,한티,13068,13915,26983
7758,20200612,수인분당선,선릉,12912,20470,33382
7759,20200613,수인분당선,선릉,4680,7757,12437
7760,20200613,수인분당선,한티,9516,9347,18863
7761,20200613,수인분당선,도곡,4350,3848,8198
7762,20200613,수인분당선,구룡,968,917,1885
7763,20200613,수인분당선,개포동,2432,2442,4874
7764,20200613,수인분당선,대모산입구,2153,1909,4062
7765,20200613,수인분당선,수서,9112,9721,18833
7766,20200613,수인분당선,복정,2,0,2
7767,20200613,수인분당선,수원,6008,4148,10156
7768,20200613,수인분당선,서울숲,6332,6412,12744
7769,20200613,수인분당선,압구정로데오,13510,16313,29823
7770,20200613,수인분당선,강남구청,4481,5679,10160
7771,20200613,수인분당선,선정릉,3340,3450,6790
7772,20200613,수인분당선,가천대,4460,4917,9377
7773,20200613,수인분당선,태평,9717,9084,18801
7774,20200613,수인분당선,모란,14401,14664,29065
7775,20200613,수인분당선,야탑,15899,16780,32679
7776,20200613,수인분당선,서현,16762,17256,34018
7777,20200613,수인분당선,수내,8016,7550,15566
7778,20200613,수인분당선,정자,9975,10269,20244
7779,20200613,수인분당선,미금,10112,10446,20558
7780,20200613,수인분당선,오리,6965,5916,12881
7781,20200613,수인분당선,이매,3700,3440,7140
7782,20200613,수인분당선,보정,1407,1250,2657
7783,20200613,수인분당선,죽전,9189,10412,19601
7784,20200613,수인분당선,구성,2910,2858,5768
7785,20200613,수인분당선,신갈,2746,2720,5466
7786,20200613,수인분당선,기흥,6099,5939,12038
7787,20200613,수인분당선,상갈,3373,3327,6700
7788,20200613,수인분당선,청명,2512,2312,4824
7789,20200613,수인분당선,영통,5722,5741,11463
7790,20200613,수인분당선,망포,8046,7279,15325
7791,20200613,수인분당선,매탄권선,2870,2551,5421
7792,20200613,수인분당선,수원시청,8919,10203,19122
7793,20200613,수인분당선,매교,1362,1440,2802
7794,20200613,수인분당선,달월,55,45,100
7795,20200613,수인분당선,월곶,1634,1606,3240
7796,20200613,수인분당선,소래포구,4137,4112,8249
7797,20200613,수인분당선,인천논현,3953,3988,7941
7798,20200613,수인분당선,호구포,2002,1857,3859
7799,20200613,수인분당선,남동인더스파크,877,845,1722
7800,20200613,수인분당선,원인재,2965,3054,6019
7801,20200613,수인분당선,연수,3191,3260,6451
7802,20200613,수인분당선,송도,1717,1669,3386
7803,20200613,수인분당선,인하대,3065,2862,5927
7804,20200613,수인분당선,숭의,2102,1942,4044
7805,20200613,수인분당선,신포,1045,1081,2126
7806,20200613,수인분당선,인천,701,1121,1822
7807,20200614,수인분당선,인천,667,970,1637
7808,20200614,수인분당선,신포,754,780,1534
7809,20200614,수인분당선,숭의,1472,1365,2837
7810,20200614,수인분당선,인하대,2150,2066,4216
7811,20200614,수인분당선,송도,1322,1283,2605
7812,20200614,수인분당선,연수,2350,2304,4654
7813,20200614,수인분당선,원인재,2193,2237,4430
7814,20200614,수인분당선,남동인더스파크,453,469,922
7815,20200614,수인분당선,호구포,1424,1444,2868
7816,20200614,수인분당선,인천논현,2368,2482,4850
7817,20200614,수인분당선,소래포구,3488,3455,6943
7818,20200614,수인분당선,월곶,1251,1147,2398
7819,20200614,수인분당선,달월,32,41,73
7820,20200614,수인분당선,매교,956,970,1926
7821,20200614,수인분당선,수원시청,5758,5821,11579
7822,20200614,수인분당선,매탄권선,2006,1882,3888
7823,20200614,수인분당선,망포,5120,5092,10212
7824,20200614,수인분당선,영통,3653,3717,7370
7825,20200614,수인분당선,청명,1623,1671,3294
7826,20200614,수인분당선,상갈,2376,2451,4827
7827,20200614,수인분당선,기흥,4192,4201,8393
7828,20200614,수인분당선,신갈,1583,1613,3196
7829,20200614,수인분당선,구성,1982,2125,4107
7830,20200614,수인분당선,죽전,6548,7586,14134
7831,20200614,수인분당선,보정,826,825,1651
7832,20200614,수인분당선,이매,2668,2669,5337
7833,20200614,수인분당선,오리,4927,4358,9285
7834,20200614,수인분당선,미금,6385,7032,13417
7835,20200614,수인분당선,정자,6356,6616,12972
7836,20200614,수인분당선,수내,5189,4930,10119
7837,20200614,수인분당선,서현,11531,11825,23356
7838,20200614,수인분당선,야탑,11640,11865,23505
7839,20200614,수인분당선,모란,14587,15385,29972
7840,20200614,수인분당선,태평,7253,6686,13939
7841,20200614,수인분당선,가천대,5353,5901,11254
7842,20200614,수인분당선,선정릉,1740,1840,3580
7843,20200614,수인분당선,강남구청,2524,3105,5629
7844,20200614,수인분당선,압구정로데오,7325,8494,15819
7845,20200614,수인분당선,서울숲,4403,4469,8872
7846,20200614,수인분당선,수원,4433,2865,7298
7847,20200614,수인분당선,복정,1,0,1
7848,20200614,수인분당선,수서,8321,7655,15976
7849,20200614,수인분당선,대모산입구,1576,1495,3071
7850,20200614,수인분당선,개포동,1599,1607,3206
7851,20200614,수인분당선,구룡,498,578,1076
7852,20200614,수인분당선,도곡,1997,1977,3974
7853,20200614,수인분당선,한티,5950,5901,11851
7854,20200614,수인분당선,선릉,2465,3718,6183
7855,20200615,수인분당선,인천,803,1287,2090
7856,20200615,수인분당선,신포,1657,1685,3342
7857,20200615,수인분당선,숭의,3609,3298,6907
7858,20200615,수인분당선,인하대,4700,4443,9143
7859,20200615,수인분당선,송도,2459,2162,4621
7860,20200615,수인분당선,연수,4115,4092,8207
7861,20200615,수인분당선,원인재,3888,3988,7876
7862,20200615,수인분당선,남동인더스파크,2094,2270,4364
7863,20200615,수인분당선,호구포,3339,3389,6728
7864,20200615,수인분당선,인천논현,5183,5488,10671
7865,20200615,수인분당선,소래포구,4204,3925,8129
7866,20200615,수인분당선,월곶,2192,2017,4209
7867,20200615,수인분당선,달월,67,48,115
7868,20200615,수인분당선,매교,2389,2389,4778
7869,20200615,수인분당선,수원시청,10277,11172,21449
7870,20200615,수인분당선,매탄권선,4204,3975,8179
7871,20200615,수인분당선,망포,12525,12074,24599
7872,20200615,수인분당선,영통,7440,7799,15239
7873,20200615,수인분당선,청명,3896,3777,7673
7874,20200615,수인분당선,상갈,5196,4965,10161
7875,20200615,수인분당선,기흥,9476,8807,18283
7876,20200615,수인분당선,신갈,4382,4262,8644
7877,20200615,수인분당선,구성,4780,4856,9636
7878,20200615,수인분당선,죽전,12755,13878,26633
7879,20200615,수인분당선,보정,2492,1992,4484
7880,20200615,수인분당선,이매,5494,4977,10471
7881,20200615,수인분당선,오리,11152,9606,20758
7882,20200615,수인분당선,미금,15327,16525,31852
7883,20200615,수인분당선,정자,15844,17053,32897
7884,20200615,수인분당선,수내,12122,12213,24335
7885,20200615,수인분당선,서현,23969,24292,48261
7886,20200615,수인분당선,야탑,24050,25225,49275
7887,20200615,수인분당선,모란,18538,18662,37200
7888,20200615,수인분당선,태평,12985,12562,25547
7889,20200615,수인분당선,가천대,6543,7540,14083
7890,20200615,수인분당선,선정릉,7962,8514,16476
7891,20200615,수인분당선,강남구청,9094,10481,19575
7892,20200615,수인분당선,압구정로데오,14932,16718,31650
7893,20200615,수인분당선,서울숲,8474,8604,17078
7894,20200615,수인분당선,수원,7275,5016,12291
7895,20200615,수인분당선,복정,1,0,1
7896,20200615,수인분당선,수서,13197,13260,26457
7897,20200615,수인분당선,대모산입구,3367,3103,6470
7898,20200615,수인분당선,개포동,3275,3444,6719
7899,20200615,수인분당선,구룡,1594,1583,3177
7900,20200615,수인분당선,도곡,6330,6561,12891
7901,20200615,수인분당선,한티,12462,13362,25824
7902,20200615,수인분당선,선릉,13199,21126,34325
7903,20200616,수인분당선,서울숲,9083,9012,18095
7904,20200616,수인분당선,압구정로데오,16195,18336,34531
7905,20200616,수인분당선,강남구청,9494,10816,20310
7906,20200616,수인분당선,선정릉,8051,8666,16717
7907,20200616,수인분당선,가천대,6628,7522,14150
7908,20200616,수인분당선,태평,12978,12748,25726
7909,20200616,수인분당선,모란,18779,18788,37567
7910,20200616,수인분당선,야탑,24372,25312,49684
7911,20200616,수인분당선,서현,23453,24079,47532
7912,20200616,수인분당선,수내,12350,12455,24805
7913,20200616,수인분당선,정자,15982,17339,33321
7914,20200616,수인분당선,미금,15318,16252,31570
7915,20200616,수인분당선,오리,11284,9628,20912
7916,20200616,수인분당선,이매,5587,5108,10695
7917,20200616,수인분당선,보정,2452,2073,4525
7918,20200616,수인분당선,죽전,12896,14161,27057
7919,20200616,수인분당선,구성,4764,4807,9571
7920,20200616,수인분당선,신갈,4330,4294,8624
7921,20200616,수인분당선,기흥,9322,8684,18006
7922,20200616,수인분당선,상갈,5190,4978,10168
7923,20200616,수인분당선,청명,3979,3809,7788
7924,20200616,수인분당선,영통,7670,7883,15553
7925,20200616,수인분당선,망포,12773,12147,24920
7926,20200616,수인분당선,매탄권선,4202,4071,8273
7927,20200616,수인분당선,수원시청,10129,11245,21374
7928,20200616,수인분당선,매교,2375,2377,4752
7929,20200616,수인분당선,달월,81,54,135
7930,20200616,수인분당선,월곶,2104,1929,4033
7931,20200616,수인분당선,소래포구,4407,4097,8504
7932,20200616,수인분당선,인천논현,5048,5442,10490
7933,20200616,수인분당선,호구포,3278,3375,6653
7934,20200616,수인분당선,남동인더스파크,2139,2347,4486
7935,20200616,수인분당선,원인재,4057,4063,8120
7936,20200616,수인분당선,연수,3984,4085,8069
7937,20200616,수인분당선,송도,2408,2200,4608
7938,20200616,수인분당선,인하대,4914,4692,9606
7939,20200616,수인분당선,숭의,3510,3244,6754
7940,20200616,수인분당선,신포,1637,1711,3348
7941,20200616,수인분당선,인천,802,1348,2150
7942,20200616,수인분당선,선릉,13557,21181,34738
7943,20200616,수인분당선,한티,12686,13629,26315
7944,20200616,수인분당선,도곡,6376,6564,12940
7945,20200616,수인분당선,구룡,1596,1553,3149
7946,20200616,수인분당선,개포동,3303,3490,6793
7947,20200616,수인분당선,대모산입구,3432,3234,6666
7948,20200616,수인분당선,수서,12839,13285,26124
7949,20200616,수인분당선,복정,1,0,1
7950,20200616,수인분당선,수원,7449,5104,12553
7951,20200617,수인분당선,인천,823,1347,2170
7952,20200617,수인분당선,신포,1638,1767,3405
7953,20200617,수인분당선,숭의,3527,3316,6843
7954,20200617,수인분당선,인하대,5100,4726,9826
7955,20200617,수인분당선,송도,2436,2197,4633
7956,20200617,수인분당선,연수,4172,4198,8370
7957,20200617,수인분당선,원인재,3990,4006,7996
7958,20200617,수인분당선,남동인더스파크,2227,2366,4593
7959,20200617,수인분당선,호구포,3425,3428,6853
7960,20200617,수인분당선,인천논현,5184,5508,10692
7961,20200617,수인분당선,소래포구,4282,3985,8267
7962,20200617,수인분당선,월곶,2198,2048,4246
7963,20200617,수인분당선,달월,72,46,118
7964,20200617,수인분당선,매교,2371,2380,4751
7965,20200617,수인분당선,수원시청,10468,11481,21949
7966,20200617,수인분당선,매탄권선,4243,4107,8350
7967,20200617,수인분당선,망포,12848,12304,25152
7968,20200617,수인분당선,영통,7614,7909,15523
7969,20200617,수인분당선,청명,4047,3852,7899
7970,20200617,수인분당선,상갈,5287,4983,10270
7971,20200617,수인분당선,기흥,9264,8712,17976
7972,20200617,수인분당선,신갈,4413,4261,8674
7973,20200617,수인분당선,구성,4687,4888,9575
7974,20200617,수인분당선,죽전,12798,13931,26729
7975,20200617,수인분당선,보정,2519,2130,4649
7976,20200617,수인분당선,이매,5738,5176,10914
7977,20200617,수인분당선,오리,11329,9506,20835
7978,20200617,수인분당선,미금,15592,16681,32273
7979,20200617,수인분당선,정자,16443,17647,34090
7980,20200617,수인분당선,수내,12306,12466,24772
7981,20200617,수인분당선,서현,23652,24450,48102
7982,20200617,수인분당선,야탑,25006,26360,51366
7983,20200617,수인분당선,모란,18759,18982,37741
7984,20200617,수인분당선,태평,13134,12672,25806
7985,20200617,수인분당선,가천대,6765,7612,14377
7986,20200617,수인분당선,선정릉,8020,8640,16660
7987,20200617,수인분당선,강남구청,9560,11054,20614
7988,20200617,수인분당선,압구정로데오,16271,18392,34663
7989,20200617,수인분당선,서울숲,9346,9409,18755
7990,20200617,수인분당선,수원,7701,5074,12775
7991,20200617,수인분당선,수서,13255,13369,26624
7992,20200617,수인분당선,대모산입구,3384,3161,6545
7993,20200617,수인분당선,개포동,3401,3620,7021
7994,20200617,수인분당선,구룡,1606,1573,3179
7995,20200617,수인분당선,도곡,6436,6621,13057
7996,20200617,수인분당선,한티,13071,13797,26868
7997,20200617,수인분당선,선릉,13447,21266,34713
7998,20200618,수인분당선,선릉,13211,20890,34101
7999,20200618,수인분당선,한티,12903,13522,26425
8000,20200618,수인분당선,도곡,6564,6590,13154
8001,20200618,수인분당선,구룡,1631,1583,3214
8002,20200618,수인분당선,개포동,3208,3369,6577
8003,20200618,수인분당선,대모산입구,3345,3126,6471
8004,20200618,수인분당선,수서,13370,13675,27045
8005,20200618,수인분당선,수원,7418,5075,12493
8006,20200618,수인분당선,서울숲,9010,9159,18169
8007,20200618,수인분당선,압구정로데오,16073,18531,34604
8008,20200618,수인분당선,강남구청,9374,10904,20278
8009,20200618,수인분당선,선정릉,7956,8615,16571
8010,20200618,수인분당선,가천대,6800,7579,14379
8011,20200618,수인분당선,태평,12973,12418,25391
8012,20200618,수인분당선,모란,18857,19025,37882
8013,20200618,수인분당선,야탑,24528,25785,50313
8014,20200618,수인분당선,서현,23845,24510,48355
8015,20200618,수인분당선,수내,12135,12445,24580
8016,20200618,수인분당선,정자,16486,17746,34232
8017,20200618,수인분당선,미금,15348,16423,31771
8018,20200618,수인분당선,오리,11257,9663,20920
8019,20200618,수인분당선,이매,5957,5124,11081
8020,20200618,수인분당선,보정,2532,2140,4672
8021,20200618,수인분당선,죽전,13098,14215,27313
8022,20200618,수인분당선,구성,4825,4861,9686
8023,20200618,수인분당선,신갈,4388,4310,8698
8024,20200618,수인분당선,기흥,9401,8786,18187
8025,20200618,수인분당선,상갈,5215,4953,10168
8026,20200618,수인분당선,청명,4038,3828,7866
8027,20200618,수인분당선,영통,7713,7793,15506
8028,20200618,수인분당선,망포,12780,12065,24845
8029,20200618,수인분당선,매탄권선,4261,4113,8374
8030,20200618,수인분당선,수원시청,10326,11333,21659
8031,20200618,수인분당선,매교,2425,2429,4854
8032,20200618,수인분당선,달월,83,49,132
8033,20200618,수인분당선,월곶,2169,1975,4144
8034,20200618,수인분당선,소래포구,4513,4211,8724
8035,20200618,수인분당선,인천논현,5238,5500,10738
8036,20200618,수인분당선,호구포,3358,3342,6700
8037,20200618,수인분당선,남동인더스파크,2132,2385,4517
8038,20200618,수인분당선,원인재,3909,4001,7910
8039,20200618,수인분당선,연수,4231,4295,8526
8040,20200618,수인분당선,송도,2402,2164,4566
8041,20200618,수인분당선,인하대,4962,4688,9650
8042,20200618,수인분당선,숭의,3574,3305,6879
8043,20200618,수인분당선,신포,1670,1772,3442
8044,20200618,수인분당선,인천,785,1300,2085
8045,20200619,수인분당선,선릉,13413,20962,34375
8046,20200619,수인분당선,한티,14025,14861,28886
8047,20200619,수인분당선,도곡,6808,6772,13580
8048,20200619,수인분당선,구룡,1718,1582,3300
8049,20200619,수인분당선,개포동,3467,3705,7172
8050,20200619,수인분당선,대모산입구,3431,3095,6526
8051,20200619,수인분당선,수서,14878,15986,30864
8052,20200619,수인분당선,복정,1,0,1
8053,20200619,수인분당선,수원,8171,5688,13859
8054,20200619,수인분당선,서울숲,9348,9350,18698
8055,20200619,수인분당선,압구정로데오,17301,21116,38417
8056,20200619,수인분당선,강남구청,9774,11218,20992
8057,20200619,수인분당선,선정릉,7987,8622,16609
8058,20200619,수인분당선,가천대,6951,7677,14628
8059,20200619,수인분당선,태평,13844,13069,26913
8060,20200619,수인분당선,모란,24667,25768,50435
8061,20200619,수인분당선,야탑,25923,27238,53161
8062,20200619,수인분당선,서현,25500,26629,52129
8063,20200619,수인분당선,수내,12788,12802,25590
8064,20200619,수인분당선,정자,16979,18472,35451
8065,20200619,수인분당선,미금,16120,17205,33325
8066,20200619,수인분당선,오리,12022,9991,22013
8067,20200619,수인분당선,이매,5820,5274,11094
8068,20200619,수인분당선,보정,2592,2156,4748
8069,20200619,수인분당선,죽전,13896,14876,28772
8070,20200619,수인분당선,구성,4983,5010,9993
8071,20200619,수인분당선,신갈,4558,4472,9030
8072,20200619,수인분당선,기흥,9670,9095,18765
8073,20200619,수인분당선,상갈,5486,5102,10588
8074,20200619,수인분당선,청명,4364,3912,8276
8075,20200619,수인분당선,영통,8184,8583,16767
8076,20200619,수인분당선,망포,13784,12541,26325
8077,20200619,수인분당선,매탄권선,4681,4283,8964
8078,20200619,수인분당선,수원시청,11180,13484,24664
8079,20200619,수인분당선,매교,2481,2526,5007
8080,20200619,수인분당선,달월,73,46,119
8081,20200619,수인분당선,월곶,2202,2064,4266
8082,20200619,수인분당선,소래포구,4681,4417,9098
8083,20200619,수인분당선,인천논현,5380,5675,11055
8084,20200619,수인분당선,호구포,3399,3340,6739
8085,20200619,수인분당선,남동인더스파크,2029,2226,4255
8086,20200619,수인분당선,원인재,4029,4148,8177
8087,20200619,수인분당선,연수,4299,4504,8803
8088,20200619,수인분당선,송도,2513,2233,4746
8089,20200619,수인분당선,인하대,5184,4820,10004
8090,20200619,수인분당선,숭의,3525,3223,6748
8091,20200619,수인분당선,신포,1724,1874,3598
8092,20200619,수인분당선,인천,893,1401,2294
8093,20200620,수인분당선,선릉,4955,8083,13038
8094,20200620,수인분당선,한티,10628,10147,20775
8095,20200620,수인분당선,도곡,4056,3722,7778
8096,20200620,수인분당선,구룡,1177,1052,2229
8097,20200620,수인분당선,개포동,2212,2139,4351
8098,20200620,수인분당선,대모산입구,2410,2138,4548
8099,20200620,수인분당선,수서,9740,10111,19851
8100,20200620,수인분당선,복정,1,0,1
8101,20200620,수인분당선,수원,5888,4118,10006
8102,20200620,수인분당선,서울숲,7183,7338,14521
8103,20200620,수인분당선,압구정로데오,13986,16835,30821
8104,20200620,수인분당선,강남구청,4739,5743,10482
8105,20200620,수인분당선,선정릉,3567,3914,7481
8106,20200620,수인분당선,가천대,4429,4963,9392
8107,20200620,수인분당선,태평,9826,9189,19015
8108,20200620,수인분당선,모란,14558,14700,29258
8109,20200620,수인분당선,야탑,16173,17111,33284
8110,20200620,수인분당선,서현,17328,17818,35146
8111,20200620,수인분당선,수내,8258,7690,15948
8112,20200620,수인분당선,정자,10289,10522,20811
8113,20200620,수인분당선,미금,10318,10700,21018
8114,20200620,수인분당선,오리,7374,6096,13470
8115,20200620,수인분당선,이매,3767,3507,7274
8116,20200620,수인분당선,보정,1446,1216,2662
8117,20200620,수인분당선,죽전,9408,10689,20097
8118,20200620,수인분당선,구성,3090,3078,6168
8119,20200620,수인분당선,신갈,2512,2532,5044
8120,20200620,수인분당선,기흥,6207,5895,12102
8121,20200620,수인분당선,상갈,3449,3422,6871
8122,20200620,수인분당선,청명,2359,2300,4659
8123,20200620,수인분당선,영통,5904,5895,11799
8124,20200620,수인분당선,망포,8092,7017,15109
8125,20200620,수인분당선,매탄권선,2879,2558,5437
8126,20200620,수인분당선,수원시청,8882,10380,19262
8127,20200620,수인분당선,매교,1314,1384,2698
8128,20200620,수인분당선,달월,55,49,104
8129,20200620,수인분당선,월곶,1719,1581,3300
8130,20200620,수인분당선,소래포구,4591,4539,9130
8131,20200620,수인분당선,인천논현,4017,4047,8064
8132,20200620,수인분당선,호구포,2060,1914,3974
8133,20200620,수인분당선,남동인더스파크,885,835,1720
8134,20200620,수인분당선,원인재,3017,3193,6210
8135,20200620,수인분당선,연수,3235,3363,6598
8136,20200620,수인분당선,송도,1753,1715,3468
8137,20200620,수인분당선,인하대,3212,2931,6143
8138,20200620,수인분당선,숭의,2199,2054,4253
8139,20200620,수인분당선,신포,1124,1201,2325
8140,20200620,수인분당선,인천,864,1380,2244
8141,20200621,수인분당선,선릉,2487,4031,6518
8142,20200621,수인분당선,한티,7104,6951,14055
8143,20200621,수인분당선,도곡,2074,2059,4133
8144,20200621,수인분당선,구룡,854,894,1748
8145,20200621,수인분당선,개포동,1626,1717,3343
8146,20200621,수인분당선,대모산입구,1382,1326,2708
8147,20200621,수인분당선,수서,7896,7199,15095
8148,20200621,수인분당선,수원,4214,2742,6956
8149,20200621,수인분당선,서울숲,4386,4567,8953
8150,20200621,수인분당선,압구정로데오,7514,8459,15973
8151,20200621,수인분당선,강남구청,2672,3180,5852
8152,20200621,수인분당선,선정릉,2167,2242,4409
8153,20200621,수인분당선,가천대,3811,4350,8161
8154,20200621,수인분당선,태평,7047,6534,13581
8155,20200621,수인분당선,모란,9899,10288,20187
8156,20200621,수인분당선,야탑,11684,11887,23571
8157,20200621,수인분당선,서현,11953,12295,24248
8158,20200621,수인분당선,수내,5429,5228,10657
8159,20200621,수인분당선,정자,6568,6993,13561
8160,20200621,수인분당선,미금,6537,7246,13783
8161,20200621,수인분당선,오리,4871,4258,9129
8162,20200621,수인분당선,이매,2576,2628,5204
8163,20200621,수인분당선,보정,945,870,1815
8164,20200621,수인분당선,죽전,7022,7988,15010
8165,20200621,수인분당선,구성,2100,2127,4227
8166,20200621,수인분당선,신갈,1691,1688,3379
8167,20200621,수인분당선,기흥,4266,4209,8475
8168,20200621,수인분당선,상갈,2418,2548,4966
8169,20200621,수인분당선,청명,1615,1688,3303
8170,20200621,수인분당선,영통,3734,3756,7490
8171,20200621,수인분당선,망포,5103,5365,10468
8172,20200621,수인분당선,매탄권선,1993,1891,3884
8173,20200621,수인분당선,수원시청,6042,6059,12101
8174,20200621,수인분당선,매교,1004,1019,2023
8175,20200621,수인분당선,달월,25,31,56
8176,20200621,수인분당선,월곶,1299,1265,2564
8177,20200621,수인분당선,소래포구,3711,3568,7279
8178,20200621,수인분당선,인천논현,2580,2633,5213
8179,20200621,수인분당선,호구포,1461,1589,3050
8180,20200621,수인분당선,남동인더스파크,546,539,1085
8181,20200621,수인분당선,원인재,2212,2204,4416
8182,20200621,수인분당선,연수,2501,2547,5048
8183,20200621,수인분당선,송도,1245,1228,2473
8184,20200621,수인분당선,인하대,2156,2117,4273
8185,20200621,수인분당선,숭의,1582,1495,3077
8186,20200621,수인분당선,신포,921,892,1813
8187,20200621,수인분당선,인천,806,1117,1923
8188,20200622,수인분당선,인천,826,1324,2150
8189,20200622,수인분당선,신포,1638,1662,3300
8190,20200622,수인분당선,숭의,3489,3198,6687
8191,20200622,수인분당선,인하대,5447,5176,10623
8192,20200622,수인분당선,송도,2404,2127,4531
8193,20200622,수인분당선,연수,4149,4159,8308
8194,20200622,수인분당선,원인재,3900,4043,7943
8195,20200622,수인분당선,남동인더스파크,2046,2276,4322
8196,20200622,수인분당선,호구포,3342,3415,6757
8197,20200622,수인분당선,인천논현,5130,5555,10685
8198,20200622,수인분당선,소래포구,4471,4118,8589
8199,20200622,수인분당선,월곶,2125,1987,4112
8200,20200622,수인분당선,달월,73,46,119
8201,20200622,수인분당선,매교,2544,2494,5038
8202,20200622,수인분당선,수원시청,10278,11021,21299
8203,20200622,수인분당선,매탄권선,4241,3995,8236
8204,20200622,수인분당선,망포,12377,12210,24587
8205,20200622,수인분당선,영통,7923,8090,16013
8206,20200622,수인분당선,청명,3972,3876,7848
8207,20200622,수인분당선,상갈,5153,4692,9845
8208,20200622,수인분당선,기흥,9301,8780,18081
8209,20200622,수인분당선,신갈,4339,4255,8594
8210,20200622,수인분당선,구성,4735,4899,9634
8211,20200622,수인분당선,죽전,12575,13825,26400
8212,20200622,수인분당선,보정,2447,2046,4493
8213,20200622,수인분당선,이매,5411,5015,10426
8214,20200622,수인분당선,오리,11010,9499,20509
8215,20200622,수인분당선,미금,15048,16105,31153
8216,20200622,수인분당선,정자,15781,17026,32807
8217,20200622,수인분당선,수내,12213,12407,24620
8218,20200622,수인분당선,서현,23160,23701,46861
8219,20200622,수인분당선,야탑,24037,25313,49350
8220,20200622,수인분당선,모란,18702,18561,37263
8221,20200622,수인분당선,태평,12764,12339,25103
8222,20200622,수인분당선,가천대,6881,7978,14859
8223,20200622,수인분당선,선정릉,7982,8454,16436
8224,20200622,수인분당선,강남구청,9188,10411,19599
8225,20200622,수인분당선,압구정로데오,14816,16629,31445
8226,20200622,수인분당선,서울숲,8500,8513,17013
8227,20200622,수인분당선,수원,7318,5041,12359
8228,20200622,수인분당선,수서,13144,13207,26351
8229,20200622,수인분당선,대모산입구,3368,3171,6539
8230,20200622,수인분당선,개포동,3236,3418,6654
8231,20200622,수인분당선,구룡,1563,1554,3117
8232,20200622,수인분당선,도곡,6377,6651,13028
8233,20200622,수인분당선,한티,12777,13760,26537
8234,20200622,수인분당선,선릉,13229,20774,34003
8235,20200623,수인분당선,인천,820,1381,2201
8236,20200623,수인분당선,신포,1666,1694,3360
8237,20200623,수인분당선,숭의,3503,3338,6841
8238,20200623,수인분당선,인하대,5721,5360,11081
8239,20200623,수인분당선,송도,2382,2171,4553
8240,20200623,수인분당선,연수,4105,4153,8258
8241,20200623,수인분당선,원인재,4007,4035,8042
8242,20200623,수인분당선,남동인더스파크,2103,2312,4415
8243,20200623,수인분당선,호구포,3456,3438,6894
8244,20200623,수인분당선,인천논현,5147,5420,10567
8245,20200623,수인분당선,소래포구,4587,4329,8916
8246,20200623,수인분당선,월곶,2269,2142,4411
8247,20200623,수인분당선,달월,78,57,135
8248,20200623,수인분당선,매교,2647,2593,5240
8249,20200623,수인분당선,수원시청,10419,11366,21785
8250,20200623,수인분당선,매탄권선,4316,4157,8473
8251,20200623,수인분당선,망포,12863,12171,25034
8252,20200623,수인분당선,영통,8027,8364,16391
8253,20200623,수인분당선,청명,4097,4018,8115
8254,20200623,수인분당선,상갈,5239,4905,10144
8255,20200623,수인분당선,기흥,9346,8909,18255
8256,20200623,수인분당선,신갈,4398,4391,8789
8257,20200623,수인분당선,구성,4856,4946,9802
8258,20200623,수인분당선,죽전,12804,14005,26809
8259,20200623,수인분당선,보정,2499,2135,4634
8260,20200623,수인분당선,이매,5491,5096,10587
8261,20200623,수인분당선,오리,11318,9707,21025
8262,20200623,수인분당선,미금,15335,16374,31709
8263,20200623,수인분당선,정자,16370,17497,33867
8264,20200623,수인분당선,수내,12427,12612,25039
8265,20200623,수인분당선,서현,23594,24137,47731
8266,20200623,수인분당선,야탑,24646,25907,50553
8267,20200623,수인분당선,모란,18994,19035,38029
8268,20200623,수인분당선,태평,13036,12708,25744
8269,20200623,수인분당선,가천대,7042,8117,15159
8270,20200623,수인분당선,선정릉,8087,8723,16810
8271,20200623,수인분당선,강남구청,9512,11087,20599
8272,20200623,수인분당선,압구정로데오,16247,18318,34565
8273,20200623,수인분당선,서울숲,8952,8973,17925
8274,20200623,수인분당선,수원,7365,5066,12431
8275,20200623,수인분당선,복정,1,0,1
8276,20200623,수인분당선,수서,13318,13548,26866
8277,20200623,수인분당선,대모산입구,3449,3165,6614
8278,20200623,수인분당선,개포동,3275,3470,6745
8279,20200623,수인분당선,구룡,1618,1547,3165
8280,20200623,수인분당선,도곡,6563,6563,13126
8281,20200623,수인분당선,한티,13075,14083,27158
8282,20200623,수인분당선,선릉,13619,21247,34866
8283,20200624,수인분당선,선릉,13641,20931,34572
8284,20200624,수인분당선,한티,13075,14106,27181
8285,20200624,수인분당선,도곡,6337,6574,12911
8286,20200624,수인분당선,구룡,1515,1450,2965
8287,20200624,수인분당선,개포동,3295,3553,6848
8288,20200624,수인분당선,대모산입구,3263,3109,6372
8289,20200624,수인분당선,수서,12975,13313,26288
8290,20200624,수인분당선,수원,7066,4888,11954
8291,20200624,수인분당선,서울숲,8337,8357,16694
8292,20200624,수인분당선,압구정로데오,15846,17618,33464
8293,20200624,수인분당선,강남구청,9624,10968,20592
8294,20200624,수인분당선,선정릉,8217,8664,16881
8295,20200624,수인분당선,가천대,6846,8000,14846
8296,20200624,수인분당선,태평,12695,12178,24873
8297,20200624,수인분당선,모란,20228,20676,40904
8298,20200624,수인분당선,야탑,23927,25170,49097
8299,20200624,수인분당선,서현,22802,23238,46040
8300,20200624,수인분당선,수내,12143,12356,24499
8301,20200624,수인분당선,정자,15963,17269,33232
8302,20200624,수인분당선,미금,14836,15962,30798
8303,20200624,수인분당선,오리,10941,9369,20310
8304,20200624,수인분당선,이매,5257,5002,10259
8305,20200624,수인분당선,보정,2503,1997,4500
8306,20200624,수인분당선,죽전,12287,13691,25978
8307,20200624,수인분당선,구성,4623,4810,9433
8308,20200624,수인분당선,신갈,4254,4143,8397
8309,20200624,수인분당선,기흥,8969,8557,17526
8310,20200624,수인분당선,상갈,4993,4716,9709
8311,20200624,수인분당선,청명,3966,3909,7875
8312,20200624,수인분당선,영통,7786,7973,15759
8313,20200624,수인분당선,망포,12478,12009,24487
8314,20200624,수인분당선,매탄권선,4072,3902,7974
8315,20200624,수인분당선,수원시청,9993,10965,20958
8316,20200624,수인분당선,매교,2504,2482,4986
8317,20200624,수인분당선,달월,80,52,132
8318,20200624,수인분당선,월곶,2033,1917,3950
8319,20200624,수인분당선,소래포구,3795,3490,7285
8320,20200624,수인분당선,인천논현,4980,5203,10183
8321,20200624,수인분당선,호구포,3198,3300,6498
8322,20200624,수인분당선,남동인더스파크,2093,2269,4362
8323,20200624,수인분당선,원인재,3705,3765,7470
8324,20200624,수인분당선,연수,4018,4100,8118
8325,20200624,수인분당선,송도,2156,2016,4172
8326,20200624,수인분당선,인하대,5223,4883,10106
8327,20200624,수인분당선,숭의,3260,3086,6346
8328,20200624,수인분당선,신포,1483,1498,2981
8329,20200624,수인분당선,인천,681,1185,1866
8330,20200625,수인분당선,인천,815,1294,2109
8331,20200625,수인분당선,신포,1624,1733,3357
8332,20200625,수인분당선,숭의,3421,3227,6648
8333,20200625,수인분당선,인하대,5479,5193,10672
8334,20200625,수인분당선,송도,2271,2108,4379
8335,20200625,수인분당선,연수,4209,4286,8495
8336,20200625,수인분당선,원인재,3931,4048,7979
8337,20200625,수인분당선,남동인더스파크,2161,2309,4470
8338,20200625,수인분당선,호구포,3252,3247,6499
8339,20200625,수인분당선,인천논현,5051,5332,10383
8340,20200625,수인분당선,소래포구,4103,3810,7913
8341,20200625,수인분당선,월곶,2107,1955,4062
8342,20200625,수인분당선,달월,69,44,113
8343,20200625,수인분당선,매교,2558,2527,5085
8344,20200625,수인분당선,수원시청,10177,11260,21437
8345,20200625,수인분당선,매탄권선,4238,4005,8243
8346,20200625,수인분당선,망포,12861,12191,25052
8347,20200625,수인분당선,영통,8018,8273,16291
8348,20200625,수인분당선,청명,4095,3865,7960
8349,20200625,수인분당선,상갈,5238,4872,10110
8350,20200625,수인분당선,기흥,9258,8712,17970
8351,20200625,수인분당선,신갈,4393,4287,8680
8352,20200625,수인분당선,구성,4808,4868,9676
8353,20200625,수인분당선,죽전,12778,14082,26860
8354,20200625,수인분당선,보정,2508,2097,4605
8355,20200625,수인분당선,이매,5470,5026,10496
8356,20200625,수인분당선,오리,11422,9719,21141
8357,20200625,수인분당선,미금,15269,16327,31596
8358,20200625,수인분당선,정자,16437,17646,34083
8359,20200625,수인분당선,수내,12400,12607,25007
8360,20200625,수인분당선,서현,23564,24234,47798
8361,20200625,수인분당선,야탑,24712,25912,50624
8362,20200625,수인분당선,모란,18834,19103,37937
8363,20200625,수인분당선,태평,13127,12558,25685
8364,20200625,수인분당선,가천대,7083,8029,15112
8365,20200625,수인분당선,선정릉,8094,8807,16901
8366,20200625,수인분당선,강남구청,9526,11030,20556
8367,20200625,수인분당선,압구정로데오,16205,18455,34660
8368,20200625,수인분당선,서울숲,8760,8914,17674
8369,20200625,수인분당선,수원,7250,5142,12392
8370,20200625,수인분당선,복정,1,0,1
8371,20200625,수인분당선,수서,13274,13716,26990
8372,20200625,수인분당선,대모산입구,3358,3151,6509
8373,20200625,수인분당선,개포동,3219,3459,6678
8374,20200625,수인분당선,구룡,1581,1533,3114
8375,20200625,수인분당선,도곡,6363,6510,12873
8376,20200625,수인분당선,한티,12984,14028,27012
8377,20200625,수인분당선,선릉,13411,21138,34549
8378,20200626,수인분당선,선정릉,7970,8639,16609
8379,20200626,수인분당선,강남구청,9845,11375,21220
8380,20200626,수인분당선,압구정로데오,17772,21403,39175
8381,20200626,수인분당선,서울숲,9570,9542,19112
8382,20200626,수인분당선,수원,8281,5884,14165
8383,20200626,수인분당선,복정,1,0,1
8384,20200626,수인분당선,수서,15005,16096,31101
8385,20200626,수인분당선,대모산입구,3507,3259,6766
8386,20200626,수인분당선,개포동,3549,3738,7287
8387,20200626,수인분당선,구룡,1820,1665,3485
8388,20200626,수인분당선,도곡,6599,6616,13215
8389,20200626,수인분당선,한티,14227,15052,29279
8390,20200626,수인분당선,선릉,13492,21272,34764
8391,20200626,수인분당선,인천,920,1577,2497
8392,20200626,수인분당선,신포,1707,1927,3634
8393,20200626,수인분당선,숭의,3658,3349,7007
8394,20200626,수인분당선,인하대,5761,5230,10991
8395,20200626,수인분당선,송도,2537,2293,4830
8396,20200626,수인분당선,연수,4488,4564,9052
8397,20200626,수인분당선,원인재,4247,4249,8496
8398,20200626,수인분당선,남동인더스파크,2119,2322,4441
8399,20200626,수인분당선,호구포,3456,3393,6849
8400,20200626,수인분당선,인천논현,5505,5947,11452
8401,20200626,수인분당선,소래포구,4666,4457,9123
8402,20200626,수인분당선,월곶,2244,2132,4376
8403,20200626,수인분당선,달월,71,56,127
8404,20200626,수인분당선,매교,2485,2479,4964
8405,20200626,수인분당선,수원시청,11279,13762,25041
8406,20200626,수인분당선,매탄권선,4711,4334,9045
8407,20200626,수인분당선,망포,14315,12783,27098
8408,20200626,수인분당선,영통,8790,9169,17959
8409,20200626,수인분당선,청명,4362,4026,8388
8410,20200626,수인분당선,상갈,5425,5030,10455
8411,20200626,수인분당선,기흥,9848,9163,19011
8412,20200626,수인분당선,신갈,4579,4438,9017
8413,20200626,수인분당선,구성,5093,5048,10141
8414,20200626,수인분당선,죽전,14276,15364,29640
8415,20200626,수인분당선,보정,2524,2115,4639
8416,20200626,수인분당선,이매,5805,5243,11048
8417,20200626,수인분당선,오리,12083,10073,22156
8418,20200626,수인분당선,미금,16152,17155,33307
8419,20200626,수인분당선,정자,17356,18807,36163
8420,20200626,수인분당선,수내,13125,13329,26454
8421,20200626,수인분당선,서현,25823,26671,52494
8422,20200626,수인분당선,야탑,26231,27858,54089
8423,20200626,수인분당선,모란,20227,20611,40838
8424,20200626,수인분당선,태평,13763,12919,26682
8425,20200626,수인분당선,가천대,7054,7788,14842
8426,20200627,수인분당선,선릉,5150,8517,13667
8427,20200627,수인분당선,한티,11001,10405,21406
8428,20200627,수인분당선,도곡,4095,3891,7986
8429,20200627,수인분당선,구룡,1168,1069,2237
8430,20200627,수인분당선,개포동,2344,2306,4650
8431,20200627,수인분당선,대모산입구,2225,1996,4221
8432,20200627,수인분당선,수서,9650,10321,19971
8433,20200627,수인분당선,복정,1,0,1
8434,20200627,수인분당선,수원,6172,4273,10445
8435,20200627,수인분당선,서울숲,7110,7307,14417
8436,20200627,수인분당선,압구정로데오,14450,17722,32172
8437,20200627,수인분당선,강남구청,4960,6026,10986
8438,20200627,수인분당선,선정릉,3718,3759,7477
8439,20200627,수인분당선,가천대,5110,5393,10503
8440,20200627,수인분당선,태평,10157,9472,19629
8441,20200627,수인분당선,모란,14950,15105,30055
8442,20200627,수인분당선,야탑,16984,17938,34922
8443,20200627,수인분당선,서현,17985,18479,36464
8444,20200627,수인분당선,수내,8547,7874,16421
8445,20200627,수인분당선,정자,10441,10775,21216
8446,20200627,수인분당선,미금,10790,11164,21954
8447,20200627,수인분당선,오리,7586,6347,13933
8448,20200627,수인분당선,이매,3746,3480,7226
8449,20200627,수인분당선,보정,1526,1345,2871
8450,20200627,수인분당선,죽전,9834,11101,20935
8451,20200627,수인분당선,구성,3245,3248,6493
8452,20200627,수인분당선,신갈,2612,2512,5124
8453,20200627,수인분당선,기흥,6395,6003,12398
8454,20200627,수인분당선,상갈,3581,3496,7077
8455,20200627,수인분당선,청명,2520,2493,5013
8456,20200627,수인분당선,영통,6603,6271,12874
8457,20200627,수인분당선,망포,8243,7401,15644
8458,20200627,수인분당선,매탄권선,2979,2746,5725
8459,20200627,수인분당선,수원시청,9246,10872,20118
8460,20200627,수인분당선,매교,1507,1545,3052
8461,20200627,수인분당선,달월,61,57,118
8462,20200627,수인분당선,월곶,1836,1634,3470
8463,20200627,수인분당선,소래포구,4459,4548,9007
8464,20200627,수인분당선,인천논현,3979,4117,8096
8465,20200627,수인분당선,호구포,2134,1951,4085
8466,20200627,수인분당선,남동인더스파크,871,790,1661
8467,20200627,수인분당선,원인재,3102,3262,6364
8468,20200627,수인분당선,연수,3451,3601,7052
8469,20200627,수인분당선,송도,1989,1891,3880
8470,20200627,수인분당선,인하대,3638,3261,6899
8471,20200627,수인분당선,숭의,2335,2188,4523
8472,20200627,수인분당선,신포,1319,1314,2633
8473,20200627,수인분당선,인천,839,1465,2304
8474,20200628,수인분당선,인천,818,1117,1935
8475,20200628,수인분당선,신포,905,916,1821
8476,20200628,수인분당선,숭의,1571,1434,3005
8477,20200628,수인분당선,인하대,2269,2187,4456
8478,20200628,수인분당선,송도,1374,1369,2743
8479,20200628,수인분당선,연수,2482,2522,5004
8480,20200628,수인분당선,원인재,2389,2424,4813
8481,20200628,수인분당선,남동인더스파크,556,571,1127
8482,20200628,수인분당선,호구포,1463,1552,3015
8483,20200628,수인분당선,인천논현,2637,2689,5326
8484,20200628,수인분당선,소래포구,3506,3426,6932
8485,20200628,수인분당선,월곶,1360,1302,2662
8486,20200628,수인분당선,달월,46,52,98
8487,20200628,수인분당선,매교,987,965,1952
8488,20200628,수인분당선,수원시청,6195,6045,12240
8489,20200628,수인분당선,매탄권선,2033,1984,4017
8490,20200628,수인분당선,망포,5297,5519,10816
8491,20200628,수인분당선,영통,4051,4053,8104
8492,20200628,수인분당선,청명,1770,1793,3563
8493,20200628,수인분당선,상갈,2510,2603,5113
8494,20200628,수인분당선,기흥,4575,4379,8954
8495,20200628,수인분당선,신갈,1697,1760,3457
8496,20200628,수인분당선,구성,2134,2293,4427
8497,20200628,수인분당선,죽전,7021,8026,15047
8498,20200628,수인분당선,보정,971,879,1850
8499,20200628,수인분당선,이매,2742,2829,5571
8500,20200628,수인분당선,오리,5253,4603,9856
8501,20200628,수인분당선,미금,6908,7403,14311
8502,20200628,수인분당선,정자,7010,7239,14249
8503,20200628,수인분당선,수내,5711,5621,11332
8504,20200628,수인분당선,서현,12985,13295,26280
8505,20200628,수인분당선,야탑,12274,12504,24778
8506,20200628,수인분당선,모란,10309,10641,20950
8507,20200628,수인분당선,태평,7367,6891,14258
8508,20200628,수인분당선,가천대,3568,4259,7827
8509,20200628,수인분당선,선정릉,2085,2079,4164
8510,20200628,수인분당선,강남구청,2894,3585,6479
8511,20200628,수인분당선,압구정로데오,7971,9302,17273
8512,20200628,수인분당선,서울숲,4959,5053,10012
8513,20200628,수인분당선,수원,4445,2920,7365
8514,20200628,수인분당선,수서,8475,7806,16281
8515,20200628,수인분당선,대모산입구,1595,1475,3070
8516,20200628,수인분당선,개포동,1784,1773,3557
8517,20200628,수인분당선,구룡,546,588,1134
8518,20200628,수인분당선,도곡,2213,2290,4503
8519,20200628,수인분당선,한티,7686,7481,15167
8520,20200628,수인분당선,선릉,2588,4063,6651
8521,20200629,수인분당선,선릉,13434,21266,34700
8522,20200629,수인분당선,한티,13103,14205,27308
8523,20200629,수인분당선,도곡,6685,6923,13608
8524,20200629,수인분당선,구룡,1644,1630,3274
8525,20200629,수인분당선,개포동,3461,3730,7191
8526,20200629,수인분당선,대모산입구,3517,3351,6868
8527,20200629,수인분당선,수서,13596,13728,27324
8528,20200629,수인분당선,복정,1,0,1
8529,20200629,수인분당선,수원,7158,4946,12104
8530,20200629,수인분당선,서울숲,8667,8657,17324
8531,20200629,수인분당선,압구정로데오,15222,16984,32206
8532,20200629,수인분당선,강남구청,9305,10799,20104
8533,20200629,수인분당선,선정릉,8191,8668,16859
8534,20200629,수인분당선,가천대,7206,8524,15730
8535,20200629,수인분당선,태평,13459,13015,26474
8536,20200629,수인분당선,모란,23772,24464,48236
8537,20200629,수인분당선,야탑,24948,25897,50845
8538,20200629,수인분당선,서현,24183,24660,48843
8539,20200629,수인분당선,수내,12685,12741,25426
8540,20200629,수인분당선,정자,15829,17147,32976
8541,20200629,수인분당선,미금,15870,16984,32854
8542,20200629,수인분당선,오리,11596,10062,21658
8543,20200629,수인분당선,이매,5511,5133,10644
8544,20200629,수인분당선,보정,2493,2123,4616
8545,20200629,수인분당선,죽전,12929,14202,27131
8546,20200629,수인분당선,구성,4902,5051,9953
8547,20200629,수인분당선,신갈,4430,4306,8736
8548,20200629,수인분당선,기흥,9451,8936,18387
8549,20200629,수인분당선,상갈,5072,4971,10043
8550,20200629,수인분당선,청명,3890,3827,7717
8551,20200629,수인분당선,영통,7720,8008,15728
8552,20200629,수인분당선,망포,12733,11994,24727
8553,20200629,수인분당선,매탄권선,4174,4067,8241
8554,20200629,수인분당선,수원시청,10566,11200,21766
8555,20200629,수인분당선,매교,2430,2426,4856
8556,20200629,수인분당선,달월,81,51,132
8557,20200629,수인분당선,월곶,2147,2012,4159
8558,20200629,수인분당선,소래포구,4185,3831,8016
8559,20200629,수인분당선,인천논현,5158,5488,10646
8560,20200629,수인분당선,호구포,3291,3364,6655
8561,20200629,수인분당선,남동인더스파크,2272,2498,4770
8562,20200629,수인분당선,원인재,3942,4116,8058
8563,20200629,수인분당선,연수,4145,4172,8317
8564,20200629,수인분당선,송도,2409,2165,4574
8565,20200629,수인분당선,인하대,5131,4832,9963
8566,20200629,수인분당선,숭의,3556,3265,6821
8567,20200629,수인분당선,신포,1620,1689,3309
8568,20200629,수인분당선,인천,809,1367,2176
8569,20200630,수인분당선,선릉,13357,21137,34494
8570,20200630,수인분당선,한티,13209,14320,27529
8571,20200630,수인분당선,도곡,6415,6740,13155
8572,20200630,수인분당선,구룡,1614,1516,3130
8573,20200630,수인분당선,개포동,3310,3582,6892
8574,20200630,수인분당선,대모산입구,3303,2921,6224
8575,20200630,수인분당선,수서,12953,12907,25860
8576,20200630,수인분당선,수원,7097,4948,12045
8577,20200630,수인분당선,서울숲,8876,8875,17751
8578,20200630,수인분당선,압구정로데오,16350,18773,35123
8579,20200630,수인분당선,강남구청,9466,10823,20289
8580,20200630,수인분당선,선정릉,7933,8783,16716
8581,20200630,수인분당선,가천대,7057,8118,15175
8582,20200630,수인분당선,태평,12800,12403,25203
8583,20200630,수인분당선,모란,18513,18564,37077
8584,20200630,수인분당선,야탑,24576,25754,50330
8585,20200630,수인분당선,서현,23519,24283,47802
8586,20200630,수인분당선,수내,12390,12605,24995
8587,20200630,수인분당선,정자,16230,17240,33470
8588,20200630,수인분당선,미금,15301,16259,31560
8589,20200630,수인분당선,오리,11566,9943,21509
8590,20200630,수인분당선,이매,5363,4978,10341
8591,20200630,수인분당선,보정,2501,2078,4579
8592,20200630,수인분당선,죽전,12832,14043,26875
8593,20200630,수인분당선,구성,4739,4865,9604
8594,20200630,수인분당선,신갈,4440,4258,8698
8595,20200630,수인분당선,기흥,9095,8485,17580
8596,20200630,수인분당선,상갈,5094,4684,9778
8597,20200630,수인분당선,청명,3881,3787,7668
8598,20200630,수인분당선,영통,7747,8017,15764
8599,20200630,수인분당선,망포,12594,11960,24554
8600,20200630,수인분당선,매탄권선,4240,4063,8303
8601,20200630,수인분당선,수원시청,10142,11081,21223
8602,20200630,수인분당선,매교,2326,2351,4677
8603,20200630,수인분당선,달월,100,61,161
8604,20200630,수인분당선,월곶,2092,1992,4084
8605,20200630,수인분당선,소래포구,3871,3593,7464
8606,20200630,수인분당선,인천논현,5044,5353,10397
8607,20200630,수인분당선,호구포,3312,3330,6642
8608,20200630,수인분당선,남동인더스파크,2159,2392,4551
8609,20200630,수인분당선,원인재,3839,3908,7747
8610,20200630,수인분당선,연수,3982,4090,8072
8611,20200630,수인분당선,송도,2264,2052,4316
8612,20200630,수인분당선,인하대,5012,4802,9814
8613,20200630,수인분당선,숭의,3350,3083,6433
8614,20200630,수인분당선,신포,1541,1603,3144
8615,20200630,수인분당선,인천,768,1277,2045
8616,20200701,수인분당선,인천,876,1422,2298
8617,20200701,수인분당선,신포,1714,1868,3582
8618,20200701,수인분당선,숭의,3614,3390,7004
8619,20200701,수인분당선,인하대,5293,4990,10283
8620,20200701,수인분당선,송도,2507,2337,4844
8621,20200701,수인분당선,연수,4358,4364,8722
8622,20200701,수인분당선,원인재,4048,4132,8180
8623,20200701,수인분당선,남동인더스파크,2206,2408,4614
8624,20200701,수인분당선,호구포,3389,3381,6770
8625,20200701,수인분당선,인천논현,5171,5612,10783
8626,20200701,수인분당선,소래포구,4393,4067,8460
8627,20200701,수인분당선,월곶,2249,2019,4268
8628,20200701,수인분당선,달월,78,64,142
8629,20200701,수인분당선,매교,2443,2409,4852
8630,20200701,수인분당선,수원시청,10463,11741,22204
8631,20200701,수인분당선,매탄권선,4336,4118,8454
8632,20200701,수인분당선,망포,12781,12338,25119
8633,20200701,수인분당선,영통,7894,8263,16157
8634,20200701,수인분당선,청명,4095,3856,7951
8635,20200701,수인분당선,상갈,5348,4964,10312
8636,20200701,수인분당선,기흥,9511,8830,18341
8637,20200701,수인분당선,신갈,4540,4397,8937
8638,20200701,수인분당선,구성,4914,4953,9867
8639,20200701,수인분당선,죽전,13149,14432,27581
8640,20200701,수인분당선,보정,2617,2240,4857
8641,20200701,수인분당선,이매,5689,5277,10966
8642,20200701,수인분당선,오리,11668,9996,21664
8643,20200701,수인분당선,미금,15962,17097,33059
8644,20200701,수인분당선,정자,16502,17763,34265
8645,20200701,수인분당선,수내,12919,13088,26007
8646,20200701,수인분당선,서현,24545,24983,49528
8647,20200701,수인분당선,야탑,25385,26567,51952
8648,20200701,수인분당선,모란,19161,19278,38439
8649,20200701,수인분당선,태평,13238,12787,26025
8650,20200701,수인분당선,가천대,7212,8291,15503
8651,20200701,수인분당선,선정릉,8228,8826,17054
8652,20200701,수인분당선,강남구청,9445,11023,20468
8653,20200701,수인분당선,압구정로데오,16809,19194,36003
8654,20200701,수인분당선,서울숲,9402,9687,19089
8655,20200701,수인분당선,수원,7514,5265,12779
8656,20200701,수인분당선,수서,12860,13380,26240
8657,20200701,수인분당선,대모산입구,3455,3229,6684
8658,20200701,수인분당선,선릉,13246,21278,34524
8659,20200701,수인분당선,한티,13355,12184,25539
8660,20200701,수인분당선,도곡,6636,6888,13524
8661,20200701,수인분당선,구룡,1686,1618,3304
8662,20200701,수인분당선,개포동,3674,3812,7486
8663,20200702,수인분당선,인천,812,1415,2227
8664,20200702,수인분당선,신포,1683,1796,3479
8665,20200702,수인분당선,숭의,3596,3396,6992
8666,20200702,수인분당선,인하대,5316,4997,10313
8667,20200702,수인분당선,송도,2418,2227,4645
8668,20200702,수인분당선,연수,4194,4171,8365
8669,20200702,수인분당선,원인재,4030,4232,8262
8670,20200702,수인분당선,남동인더스파크,2227,2426,4653
8671,20200702,수인분당선,호구포,3324,3453,6777
8672,20200702,수인분당선,인천논현,5358,5601,10959
8673,20200702,수인분당선,소래포구,4645,4310,8955
8674,20200702,수인분당선,월곶,2203,2060,4263
8675,20200702,수인분당선,달월,87,61,148
8676,20200702,수인분당선,매교,2419,2383,4802
8677,20200702,수인분당선,수원시청,10704,11752,22456
8678,20200702,수인분당선,매탄권선,4280,4155,8435
8679,20200702,수인분당선,망포,13140,12384,25524
8680,20200702,수인분당선,영통,8058,8351,16409
8681,20200702,수인분당선,청명,4037,3909,7946
8682,20200702,수인분당선,상갈,5380,5066,10446
8683,20200702,수인분당선,기흥,9428,8894,18322
8684,20200702,수인분당선,신갈,4562,4346,8908
8685,20200702,수인분당선,구성,4900,4997,9897
8686,20200702,수인분당선,죽전,13464,14758,28222
8687,20200702,수인분당선,보정,2640,2189,4829
8688,20200702,수인분당선,이매,5675,5242,10917
8689,20200702,수인분당선,오리,11823,10084,21907
8690,20200702,수인분당선,미금,15788,16916,32704
8691,20200702,수인분당선,정자,16694,17898,34592
8692,20200702,수인분당선,수내,12728,12946,25674
8693,20200702,수인분당선,서현,24745,25380,50125
8694,20200702,수인분당선,야탑,25597,26659,52256
8695,20200702,수인분당선,모란,19329,19497,38826
8696,20200702,수인분당선,태평,13213,12742,25955
8697,20200702,수인분당선,가천대,7266,8236,15502
8698,20200702,수인분당선,선정릉,7981,8780,16761
8699,20200702,수인분당선,강남구청,9560,11043,20603
8700,20200702,수인분당선,압구정로데오,17140,19603,36743
8701,20200702,수인분당선,서울숲,9558,9575,19133
8702,20200702,수인분당선,수원,7618,5313,12931
8703,20200702,수인분당선,복정,2,0,2
8704,20200702,수인분당선,수서,13434,13813,27247
8705,20200702,수인분당선,대모산입구,3484,3232,6716
8706,20200702,수인분당선,개포동,3513,3698,7211
8707,20200702,수인분당선,구룡,1664,1566,3230
8708,20200702,수인분당선,도곡,6709,6799,13508
8709,20200702,수인분당선,한티,13412,14557,27969
8710,20200702,수인분당선,선릉,13733,21442,35175
8711,20200703,수인분당선,인천,953,1558,2511
8712,20200703,수인분당선,신포,1708,1892,3600
8713,20200703,수인분당선,숭의,3585,3287,6872
8714,20200703,수인분당선,인하대,5499,5025,10524
8715,20200703,수인분당선,송도,2465,2175,4640
8716,20200703,수인분당선,연수,4492,4595,9087
8717,20200703,수인분당선,원인재,4127,4235,8362
8718,20200703,수인분당선,남동인더스파크,2119,2306,4425
8719,20200703,수인분당선,호구포,3451,3478,6929
8720,20200703,수인분당선,인천논현,5541,5817,11358
8721,20200703,수인분당선,소래포구,4648,4316,8964
8722,20200703,수인분당선,월곶,2277,2133,4410
8723,20200703,수인분당선,달월,97,64,161
8724,20200703,수인분당선,매교,2488,2503,4991
8725,20200703,수인분당선,수원시청,11434,13902,25336
8726,20200703,수인분당선,매탄권선,4804,4281,9085
8727,20200703,수인분당선,망포,14196,12922,27118
8728,20200703,수인분당선,영통,8644,8920,17564
8729,20200703,수인분당선,청명,4414,3998,8412
8730,20200703,수인분당선,상갈,5669,5192,10861
8731,20200703,수인분당선,기흥,9804,9264,19068
8732,20200703,수인분당선,신갈,4728,4529,9257
8733,20200703,수인분당선,구성,5012,5086,10098
8734,20200703,수인분당선,죽전,14268,15165,29433
8735,20200703,수인분당선,보정,2615,2158,4773
8736,20200703,수인분당선,이매,5805,5224,11029
8737,20200703,수인분당선,오리,11980,10155,22135
8738,20200703,수인분당선,미금,16443,17354,33797
8739,20200703,수인분당선,정자,17241,18528,35769
8740,20200703,수인분당선,수내,13183,13311,26494
8741,20200703,수인분당선,서현,25848,27051,52899
8742,20200703,수인분당선,야탑,26326,28052,54378
8743,20200703,수인분당선,모란,20083,20350,40433
8744,20200703,수인분당선,태평,13734,13078,26812
8745,20200703,수인분당선,가천대,7143,7725,14868
8746,20200703,수인분당선,선정릉,8046,8629,16675
8747,20200703,수인분당선,강남구청,9931,11455,21386
8748,20200703,수인분당선,압구정로데오,18255,21963,40218
8749,20200703,수인분당선,서울숲,9912,9922,19834
8750,20200703,수인분당선,수원,8299,5946,14245
8751,20200703,수인분당선,수서,14728,15913,30641
8752,20200703,수인분당선,대모산입구,3493,3097,6590
8753,20200703,수인분당선,개포동,3834,4104,7938
8754,20200703,수인분당선,구룡,1784,1638,3422
8755,20200703,수인분당선,도곡,6789,6723,13512
8756,20200703,수인분당선,한티,14426,15314,29740
8757,20200703,수인분당선,선릉,13463,21212,34675
8758,20200704,수인분당선,인천,951,1537,2488
8759,20200704,수인분당선,신포,1158,1281,2439
8760,20200704,수인분당선,숭의,2285,2092,4377
8761,20200704,수인분당선,인하대,3531,3199,6730
8762,20200704,수인분당선,송도,1957,1899,3856
8763,20200704,수인분당선,연수,3376,3511,6887
8764,20200704,수인분당선,원인재,3133,3295,6428
8765,20200704,수인분당선,남동인더스파크,934,861,1795
8766,20200704,수인분당선,호구포,2055,1989,4044
8767,20200704,수인분당선,인천논현,4080,4110,8190
8768,20200704,수인분당선,소래포구,4285,4402,8687
8769,20200704,수인분당선,월곶,1722,1673,3395
8770,20200704,수인분당선,달월,44,38,82
8771,20200704,수인분당선,매교,1378,1459,2837
8772,20200704,수인분당선,수원시청,8927,10222,19149
8773,20200704,수인분당선,매탄권선,2855,2640,5495
8774,20200704,수인분당선,망포,8168,7390,15558
8775,20200704,수인분당선,영통,5895,5863,11758
8776,20200704,수인분당선,청명,2420,2297,4717
8777,20200704,수인분당선,상갈,3570,3475,7045
8778,20200704,수인분당선,기흥,6380,6048,12428
8779,20200704,수인분당선,신갈,2777,2627,5404
8780,20200704,수인분당선,구성,3109,3220,6329
8781,20200704,수인분당선,죽전,10036,11298,21334
8782,20200704,수인분당선,보정,1572,1306,2878
8783,20200704,수인분당선,이매,4039,3646,7685
8784,20200704,수인분당선,오리,7409,6214,13623
8785,20200704,수인분당선,미금,10755,11080,21835
8786,20200704,수인분당선,정자,10658,10875,21533
8787,20200704,수인분당선,수내,8521,7833,16354
8788,20200704,수인분당선,서현,17938,18427,36365
8789,20200704,수인분당선,야탑,16778,17833,34611
8790,20200704,수인분당선,모란,20700,21376,42076
8791,20200704,수인분당선,태평,10292,9683,19975
8792,20200704,수인분당선,가천대,5221,5593,10814
8793,20200704,수인분당선,선정릉,3616,3854,7470
8794,20200704,수인분당선,강남구청,4903,6108,11011
8795,20200704,수인분당선,압구정로데오,14945,18278,33223
8796,20200704,수인분당선,서울숲,7516,7854,15370
8797,20200704,수인분당선,수원,6058,4134,10192
8798,20200704,수인분당선,수서,9993,10683,20676
8799,20200704,수인분당선,대모산입구,2444,2229,4673
8800,20200704,수인분당선,개포동,2495,2435,4930
8801,20200704,수인분당선,구룡,1460,1373,2833
8802,20200704,수인분당선,도곡,4181,3967,8148
8803,20200704,수인분당선,한티,11241,10711,21952
8804,20200704,수인분당선,선릉,4873,7827,12700
8805,20200705,수인분당선,인천,948,1321,2269
8806,20200705,수인분당선,신포,916,951,1867
8807,20200705,수인분당선,숭의,1618,1443,3061
8808,20200705,수인분당선,인하대,2399,2324,4723
8809,20200705,수인분당선,송도,1386,1369,2755
8810,20200705,수인분당선,연수,2595,2573,5168
8811,20200705,수인분당선,원인재,2363,2336,4699
8812,20200705,수인분당선,남동인더스파크,489,476,965
8813,20200705,수인분당선,호구포,1533,1577,3110
8814,20200705,수인분당선,인천논현,2735,2812,5547
8815,20200705,수인분당선,소래포구,3921,3810,7731
8816,20200705,수인분당선,월곶,1333,1221,2554
8817,20200705,수인분당선,달월,31,39,70
8818,20200705,수인분당선,매교,1036,1020,2056
8819,20200705,수인분당선,수원시청,5881,5866,11747
8820,20200705,수인분당선,매탄권선,2032,2015,4047
8821,20200705,수인분당선,망포,5104,5407,10511
8822,20200705,수인분당선,영통,4233,4322,8555
8823,20200705,수인분당선,청명,1618,1742,3360
8824,20200705,수인분당선,상갈,2542,2675,5217
8825,20200705,수인분당선,기흥,4433,4328,8761
8826,20200705,수인분당선,신갈,1736,1853,3589
8827,20200705,수인분당선,구성,2167,2263,4430
8828,20200705,수인분당선,죽전,7318,8365,15683
8829,20200705,수인분당선,보정,984,938,1922
8830,20200705,수인분당선,이매,2760,2855,5615
8831,20200705,수인분당선,오리,4975,4362,9337
8832,20200705,수인분당선,미금,6585,7299,13884
8833,20200705,수인분당선,정자,6938,7095,14033
8834,20200705,수인분당선,수내,5521,5327,10848
8835,20200705,수인분당선,서현,12072,12325,24397
8836,20200705,수인분당선,야탑,12184,12611,24795
8837,20200705,수인분당선,모란,10077,10211,20288
8838,20200705,수인분당선,태평,7287,6821,14108
8839,20200705,수인분당선,가천대,3242,3898,7140
8840,20200705,수인분당선,선정릉,2043,2195,4238
8841,20200705,수인분당선,강남구청,2773,3300,6073
8842,20200705,수인분당선,압구정로데오,7939,9230,17169
8843,20200705,수인분당선,서울숲,4783,4960,9743
8844,20200705,수인분당선,수원,4264,2771,7035
8845,20200705,수인분당선,복정,1,0,1
8846,20200705,수인분당선,수서,8020,7397,15417
8847,20200705,수인분당선,대모산입구,1261,1236,2497
8848,20200705,수인분당선,개포동,1837,1844,3681
8849,20200705,수인분당선,구룡,566,577,1143
8850,20200705,수인분당선,도곡,2285,2261,4546
8851,20200705,수인분당선,한티,7571,7521,15092
8852,20200705,수인분당선,선릉,2551,3922,6473
8853,20200706,수인분당선,선릉,13708,21470,35178
8854,20200706,수인분당선,한티,13311,14231,27542
8855,20200706,수인분당선,도곡,6740,6897,13637
8856,20200706,수인분당선,구룡,1680,1632,3312
8857,20200706,수인분당선,개포동,3543,3775,7318
8858,20200706,수인분당선,대모산입구,3501,3221,6722
8859,20200706,수인분당선,수서,13479,13747,27226
8860,20200706,수인분당선,복정,1,0,1
8861,20200706,수인분당선,수원,7641,5282,12923
8862,20200706,수인분당선,서울숲,9001,9213,18214
8863,20200706,수인분당선,압구정로데오,15574,17633,33207
8864,20200706,수인분당선,강남구청,9114,10579,19693
8865,20200706,수인분당선,선정릉,8007,8683,16690
8866,20200706,수인분당선,가천대,10108,11138,21246
8867,20200706,수인분당선,태평,13078,12769,25847
8868,20200706,수인분당선,모란,19177,19296,38473
8869,20200706,수인분당선,야탑,25130,26170,51300
8870,20200706,수인분당선,서현,24601,25032,49633
8871,20200706,수인분당선,수내,12677,12738,25415
8872,20200706,수인분당선,정자,16196,17408,33604
8873,20200706,수인분당선,미금,15839,16971,32810
8874,20200706,수인분당선,오리,11518,9915,21433
8875,20200706,수인분당선,이매,5526,5084,10610
8876,20200706,수인분당선,보정,2544,2104,4648
8877,20200706,수인분당선,죽전,12899,14408,27307
8878,20200706,수인분당선,구성,4893,4986,9879
8879,20200706,수인분당선,신갈,4556,4382,8938
8880,20200706,수인분당선,기흥,9747,9066,18813
8881,20200706,수인분당선,상갈,5289,5044,10333
8882,20200706,수인분당선,청명,4115,3930,8045
8883,20200706,수인분당선,영통,8064,8401,16465
8884,20200706,수인분당선,망포,13023,12480,25503
8885,20200706,수인분당선,매탄권선,4314,4148,8462
8886,20200706,수인분당선,수원시청,10817,11706,22523
8887,20200706,수인분당선,매교,2461,2434,4895
8888,20200706,수인분당선,달월,86,58,144
8889,20200706,수인분당선,월곶,2229,2111,4340
8890,20200706,수인분당선,소래포구,4547,4119,8666
8891,20200706,수인분당선,인천논현,5307,5618,10925
8892,20200706,수인분당선,호구포,3374,3417,6791
8893,20200706,수인분당선,남동인더스파크,2213,2477,4690
8894,20200706,수인분당선,원인재,4038,4184,8222
8895,20200706,수인분당선,연수,4274,4272,8546
8896,20200706,수인분당선,송도,2469,2295,4764
8897,20200706,수인분당선,인하대,5058,4856,9914
8898,20200706,수인분당선,숭의,3623,3335,6958
8899,20200706,수인분당선,신포,1596,1620,3216
8900,20200706,수인분당선,인천,862,1438,2300
8901,20200707,수인분당선,인천,856,1455,2311
8902,20200707,수인분당선,신포,1609,1656,3265
8903,20200707,수인분당선,숭의,3498,3340,6838
8904,20200707,수인분당선,인하대,5143,4820,9963
8905,20200707,수인분당선,송도,2382,2170,4552
8906,20200707,수인분당선,연수,4101,4298,8399
8907,20200707,수인분당선,원인재,4040,4170,8210
8908,20200707,수인분당선,남동인더스파크,2223,2430,4653
8909,20200707,수인분당선,호구포,3354,3370,6724
8910,20200707,수인분당선,인천논현,5299,5679,10978
8911,20200707,수인분당선,소래포구,4573,4198,8771
8912,20200707,수인분당선,월곶,2159,2029,4188
8913,20200707,수인분당선,달월,86,73,159
8914,20200707,수인분당선,매교,2500,2498,4998
8915,20200707,수인분당선,수원시청,10453,11620,22073
8916,20200707,수인분당선,매탄권선,4474,4251,8725
8917,20200707,수인분당선,망포,13216,12648,25864
8918,20200707,수인분당선,영통,8009,8232,16241
8919,20200707,수인분당선,청명,4150,3932,8082
8920,20200707,수인분당선,상갈,5322,5001,10323
8921,20200707,수인분당선,기흥,9639,8960,18599
8922,20200707,수인분당선,신갈,4635,4517,9152
8923,20200707,수인분당선,구성,4917,5047,9964
8924,20200707,수인분당선,죽전,13239,14695,27934
8925,20200707,수인분당선,보정,2576,2184,4760
8926,20200707,수인분당선,이매,5706,5219,10925
8927,20200707,수인분당선,오리,11743,10023,21766
8928,20200707,수인분당선,미금,16087,17167,33254
8929,20200707,수인분당선,정자,16439,17655,34094
8930,20200707,수인분당선,수내,12716,12805,25521
8931,20200707,수인분당선,서현,24491,25349,49840
8932,20200707,수인분당선,야탑,25093,26377,51470
8933,20200707,수인분당선,모란,19195,19319,38514
8934,20200707,수인분당선,태평,13248,12925,26173
8935,20200707,수인분당선,가천대,10090,10829,20919
8936,20200707,수인분당선,선정릉,8200,8901,17101
8937,20200707,수인분당선,강남구청,9679,11096,20775
8938,20200707,수인분당선,압구정로데오,17171,19451,36622
8939,20200707,수인분당선,서울숲,9569,9627,19196
8940,20200707,수인분당선,수원,7701,5280,12981
8941,20200707,수인분당선,복정,1,0,1
8942,20200707,수인분당선,수서,13332,13522,26854
8943,20200707,수인분당선,대모산입구,3625,3231,6856
8944,20200707,수인분당선,개포동,3578,3752,7330
8945,20200707,수인분당선,구룡,1666,1650,3316
8946,20200707,수인분당선,도곡,6754,6857,13611
8947,20200707,수인분당선,한티,13781,14724,28505
8948,20200707,수인분당선,선릉,13824,21748,35572
8949,20200708,수인분당선,선릉,14081,21721,35802
8950,20200708,수인분당선,한티,13679,14700,28379
8951,20200708,수인분당선,도곡,6666,6936,13602
8952,20200708,수인분당선,구룡,1702,1636,3338
8953,20200708,수인분당선,개포동,3777,3875,7652
8954,20200708,수인분당선,대모산입구,3589,3314,6903
8955,20200708,수인분당선,수서,13567,13836,27403
8956,20200708,수인분당선,수원,7712,5413,13125
8957,20200708,수인분당선,서울숲,9939,9912,19851
8958,20200708,수인분당선,압구정로데오,16817,19401,36218
8959,20200708,수인분당선,강남구청,9690,11316,21006
8960,20200708,수인분당선,선정릉,8188,8854,17042
8961,20200708,수인분당선,가천대,9749,10454,20203
8962,20200708,수인분당선,태평,13376,12867,26243
8963,20200708,수인분당선,모란,19605,19671,39276
8964,20200708,수인분당선,야탑,25815,27149,52964
8965,20200708,수인분당선,서현,25194,25916,51110
8966,20200708,수인분당선,수내,13079,13172,26251
8967,20200708,수인분당선,정자,16554,17855,34409
8968,20200708,수인분당선,미금,16213,17101,33314
8969,20200708,수인분당선,오리,11877,9949,21826
8970,20200708,수인분당선,이매,5600,5235,10835
8971,20200708,수인분당선,보정,2584,2168,4752
8972,20200708,수인분당선,죽전,13307,14730,28037
8973,20200708,수인분당선,구성,4940,5136,10076
8974,20200708,수인분당선,신갈,4670,4535,9205
8975,20200708,수인분당선,기흥,9666,9022,18688
8976,20200708,수인분당선,상갈,5294,5016,10310
8977,20200708,수인분당선,청명,4206,3966,8172
8978,20200708,수인분당선,영통,8260,8553,16813
8979,20200708,수인분당선,망포,13142,12725,25867
8980,20200708,수인분당선,매탄권선,4461,4237,8698
8981,20200708,수인분당선,수원시청,10664,11606,22270
8982,20200708,수인분당선,매교,2558,2522,5080
8983,20200708,수인분당선,달월,91,69,160
8984,20200708,수인분당선,월곶,2258,2108,4366
8985,20200708,수인분당선,소래포구,4577,4205,8782
8986,20200708,수인분당선,인천논현,5374,5733,11107
8987,20200708,수인분당선,호구포,3407,3453,6860
8988,20200708,수인분당선,남동인더스파크,2262,2496,4758
8989,20200708,수인분당선,원인재,4056,4200,8256
8990,20200708,수인분당선,연수,4328,4352,8680
8991,20200708,수인분당선,송도,2397,2196,4593
8992,20200708,수인분당선,인하대,5191,4885,10076
8993,20200708,수인분당선,숭의,3640,3397,7037
8994,20200708,수인분당선,신포,1796,1834,3630
8995,20200708,수인분당선,인천,867,1486,2353
8996,20200709,수인분당선,구성,4909,5072,9981
8997,20200709,수인분당선,신갈,4653,4581,9234
8998,20200709,수인분당선,기흥,9749,8932,18681
8999,20200709,수인분당선,상갈,5328,5038,10366
9000,20200709,수인분당선,청명,4188,4042,8230
9001,20200709,수인분당선,영통,8331,8542,16873
9002,20200709,수인분당선,망포,13298,12566,25864
9003,20200709,수인분당선,매탄권선,4471,4300,8771
9004,20200709,수인분당선,연수,4157,4256,8413
9005,20200709,수인분당선,송도,2361,2234,4595
9006,20200709,수인분당선,인하대,5216,4911,10127
9007,20200709,수인분당선,숭의,3556,3334,6890
9008,20200709,수인분당선,신포,1685,1713,3398
9009,20200709,수인분당선,인천,895,1516,2411
9010,20200709,수인분당선,달월,83,58,141
9011,20200709,수인분당선,월곶,2206,2018,4224
9012,20200709,수인분당선,수원시청,10491,11758,22249
9013,20200709,수인분당선,소래포구,4526,4203,8729
9014,20200709,수인분당선,인천논현,5208,5532,10740
9015,20200709,수인분당선,호구포,3345,3396,6741
9016,20200709,수인분당선,매교,2499,2482,4981
9017,20200709,수인분당선,선릉,13888,21798,35686
9018,20200709,수인분당선,한티,13514,14505,28019
9019,20200709,수인분당선,도곡,6752,6817,13569
9020,20200709,수인분당선,구룡,1694,1666,3360
9021,20200709,수인분당선,개포동,3516,3659,7175
9022,20200709,수인분당선,대모산입구,3629,3295,6924
9023,20200709,수인분당선,수서,13999,14355,28354
9024,20200709,수인분당선,복정,1,0,1
9025,20200709,수인분당선,수원,7719,5323,13042
9026,20200709,수인분당선,서울숲,9629,9783,19412
9027,20200709,수인분당선,압구정로데오,17077,19713,36790
9028,20200709,수인분당선,강남구청,9656,11116,20772
9029,20200709,수인분당선,선정릉,8101,8801,16902
9030,20200709,수인분당선,가천대,10465,11154,21619
9031,20200709,수인분당선,태평,13460,13069,26529
9032,20200709,수인분당선,모란,24506,25001,49507
9033,20200709,수인분당선,야탑,25812,26859,52671
9034,20200709,수인분당선,서현,24891,25695,50586
9035,20200709,수인분당선,수내,12675,12970,25645
9036,20200709,수인분당선,정자,16304,17602,33906
9037,20200709,수인분당선,미금,15840,16996,32836
9038,20200709,수인분당선,오리,11845,10202,22047
9039,20200709,수인분당선,이매,5728,5272,11000
9040,20200709,수인분당선,보정,2541,2072,4613
9041,20200709,수인분당선,남동인더스파크,2212,2388,4600
9042,20200709,수인분당선,원인재,4086,4301,8387
9043,20200709,수인분당선,죽전,13500,14797,28297
9044,20200710,수인분당선,인천,925,1492,2417
9045,20200710,수인분당선,신포,1681,1822,3503
9046,20200710,수인분당선,숭의,3541,3144,6685
9047,20200710,수인분당선,인하대,5107,4730,9837
9048,20200710,수인분당선,송도,2359,2078,4437
9049,20200710,수인분당선,연수,4201,4339,8540
9050,20200710,수인분당선,원인재,4114,4202,8316
9051,20200710,수인분당선,남동인더스파크,2250,2410,4660
9052,20200710,수인분당선,호구포,3362,3408,6770
9053,20200710,수인분당선,인천논현,5457,5673,11130
9054,20200710,수인분당선,소래포구,4244,3903,8147
9055,20200710,수인분당선,월곶,2176,2020,4196
9056,20200710,수인분당선,달월,77,45,122
9057,20200710,수인분당선,매교,2600,2578,5178
9058,20200710,수인분당선,수원시청,11264,13769,25033
9059,20200710,수인분당선,매탄권선,4680,4341,9021
9060,20200710,수인분당선,망포,14310,13119,27429
9061,20200710,수인분당선,영통,8698,8883,17581
9062,20200710,수인분당선,청명,4498,3965,8463
9063,20200710,수인분당선,상갈,5529,5190,10719
9064,20200710,수인분당선,기흥,9883,8997,18880
9065,20200710,수인분당선,신갈,4698,4502,9200
9066,20200710,수인분당선,구성,5034,5030,10064
9067,20200710,수인분당선,죽전,14104,15080,29184
9068,20200710,수인분당선,보정,2636,2128,4764
9069,20200710,수인분당선,이매,5752,5287,11039
9070,20200710,수인분당선,오리,12114,10135,22249
9071,20200710,수인분당선,미금,16124,17212,33336
9072,20200710,수인분당선,정자,17037,18583,35620
9073,20200710,수인분당선,수내,13179,13147,26326
9074,20200710,수인분당선,서현,25915,27198,53113
9075,20200710,수인분당선,야탑,26398,27989,54387
9076,20200710,수인분당선,모란,20213,20661,40874
9077,20200710,수인분당선,태평,13499,12883,26382
9078,20200710,수인분당선,가천대,9815,10048,19863
9079,20200710,수인분당선,선정릉,8048,8656,16704
9080,20200710,수인분당선,강남구청,10080,11488,21568
9081,20200710,수인분당선,압구정로데오,17693,21629,39322
9082,20200710,수인분당선,서울숲,9673,9488,19161
9083,20200710,수인분당선,수원,8346,5909,14255
9084,20200710,수인분당선,수서,15087,16051,31138
9085,20200710,수인분당선,대모산입구,3570,3207,6777
9086,20200710,수인분당선,개포동,3699,3896,7595
9087,20200710,수인분당선,구룡,1796,1616,3412
9088,20200710,수인분당선,도곡,6694,6837,13531
9089,20200710,수인분당선,한티,14387,15272,29659
9090,20200710,수인분당선,선릉,13647,21568,35215
9091,20200711,수인분당선,선릉,5306,8686,13992
9092,20200711,수인분당선,한티,11932,11404,23336
9093,20200711,수인분당선,도곡,4432,4034,8466
9094,20200711,수인분당선,구룡,1631,1490,3121
9095,20200711,수인분당선,개포동,2402,2300,4702
9096,20200711,수인분당선,대모산입구,2586,2396,4982
9097,20200711,수인분당선,수서,9658,10330,19988
9098,20200711,수인분당선,수원,6280,4257,10537
9099,20200711,수인분당선,서울숲,7477,7752,15229
9100,20200711,수인분당선,압구정로데오,14608,17964,32572
9101,20200711,수인분당선,강남구청,4821,5837,10658
9102,20200711,수인분당선,선정릉,3463,3656,7119
9103,20200711,수인분당선,가천대,4712,5066,9778
9104,20200711,수인분당선,태평,10107,9373,19480
9105,20200711,수인분당선,모란,15116,15358,30474
9106,20200711,수인분당선,야탑,16594,17574,34168
9107,20200711,수인분당선,서현,17428,18025,35453
9108,20200711,수인분당선,수내,8641,7893,16534
9109,20200711,수인분당선,정자,10529,10537,21066
9110,20200711,수인분당선,미금,10524,10958,21482
9111,20200711,수인분당선,오리,7704,6354,14058
9112,20200711,수인분당선,이매,3807,3503,7310
9113,20200711,수인분당선,보정,1492,1323,2815
9114,20200711,수인분당선,죽전,9633,10897,20530
9115,20200711,수인분당선,구성,3223,3172,6395
9116,20200711,수인분당선,신갈,2867,2805,5672
9117,20200711,수인분당선,기흥,6302,6034,12336
9118,20200711,수인분당선,상갈,3504,3431,6935
9119,20200711,수인분당선,청명,2646,2504,5150
9120,20200711,수인분당선,영통,5924,6024,11948
9121,20200711,수인분당선,망포,8406,7537,15943
9122,20200711,수인분당선,매탄권선,3115,2871,5986
9123,20200711,수인분당선,수원시청,9370,10989,20359
9124,20200711,수인분당선,매교,1399,1501,2900
9125,20200711,수인분당선,달월,42,41,83
9126,20200711,수인분당선,월곶,1666,1665,3331
9127,20200711,수인분당선,소래포구,4214,4303,8517
9128,20200711,수인분당선,인천논현,4209,4247,8456
9129,20200711,수인분당선,호구포,2121,2035,4156
9130,20200711,수인분당선,남동인더스파크,838,800,1638
9131,20200711,수인분당선,원인재,3242,3283,6525
9132,20200711,수인분당선,연수,3439,3546,6985
9133,20200711,수인분당선,송도,1754,1743,3497
9134,20200711,수인분당선,인하대,3486,3149,6635
9135,20200711,수인분당선,숭의,2216,2093,4309
9136,20200711,수인분당선,신포,1170,1254,2424
9137,20200711,수인분당선,인천,1060,1681,2741
9138,20200712,수인분당선,인천,828,1158,1986
9139,20200712,수인분당선,신포,834,854,1688
9140,20200712,수인분당선,숭의,1479,1418,2897
9141,20200712,수인분당선,인하대,2344,2218,4562
9142,20200712,수인분당선,송도,1292,1250,2542
9143,20200712,수인분당선,연수,2517,2429,4946
9144,20200712,수인분당선,원인재,2215,2334,4549
9145,20200712,수인분당선,남동인더스파크,562,576,1138
9146,20200712,수인분당선,호구포,1423,1521,2944
9147,20200712,수인분당선,인천논현,2520,2604,5124
9148,20200712,수인분당선,소래포구,3353,3196,6549
9149,20200712,수인분당선,달월,40,47,87
9150,20200712,수인분당선,매교,1099,1039,2138
9151,20200712,수인분당선,수원시청,6033,6052,12085
9152,20200712,수인분당선,매탄권선,2047,2003,4050
9153,20200712,수인분당선,망포,5106,5403,10509
9154,20200712,수인분당선,영통,3938,3997,7935
9155,20200712,수인분당선,청명,1623,1661,3284
9156,20200712,수인분당선,상갈,2373,2430,4803
9157,20200712,수인분당선,기흥,4272,4241,8513
9158,20200712,수인분당선,신갈,1694,1744,3438
9159,20200712,수인분당선,구성,2114,2250,4364
9160,20200712,수인분당선,죽전,6868,7917,14785
9161,20200712,수인분당선,보정,980,874,1854
9162,20200712,수인분당선,이매,2748,2802,5550
9163,20200712,수인분당선,오리,4942,4390,9332
9164,20200712,수인분당선,미금,6594,7332,13926
9165,20200712,수인분당선,정자,6650,7121,13771
9166,20200712,수인분당선,수내,5668,5344,11012
9167,20200712,수인분당선,서현,12043,12238,24281
9168,20200712,수인분당선,야탑,11598,12177,23775
9169,20200712,수인분당선,모란,10243,10351,20594
9170,20200712,수인분당선,태평,6875,6398,13273
9171,20200712,수인분당선,가천대,3366,3942,7308
9172,20200712,수인분당선,선정릉,1949,2084,4033
9173,20200712,수인분당선,강남구청,2565,3221,5786
9174,20200712,수인분당선,압구정로데오,7857,9019,16876
9175,20200712,수인분당선,서울숲,4494,4570,9064
9176,20200712,수인분당선,수원,4482,2891,7373
9177,20200712,수인분당선,수서,8164,7724,15888
9178,20200712,수인분당선,대모산입구,1522,1497,3019
9179,20200712,수인분당선,개포동,1909,1883,3792
9180,20200712,수인분당선,구룡,501,550,1051
9181,20200712,수인분당선,도곡,1945,2039,3984
9182,20200712,수인분당선,한티,7589,7371,14960
9183,20200712,수인분당선,선릉,2640,3967,6607
9184,20200712,수인분당선,월곶,1222,1134,2356
9185,20200713,수인분당선,인천,743,1249,1992
9186,20200713,수인분당선,신포,1414,1470,2884
9187,20200713,수인분당선,숭의,3252,3025,6277
9188,20200713,수인분당선,인하대,4508,4213,8721
9189,20200713,수인분당선,송도,2125,1907,4032
9190,20200713,수인분당선,연수,3822,3925,7747
9191,20200713,수인분당선,원인재,3645,3659,7304
9192,20200713,수인분당선,남동인더스파크,2207,2375,4582
9193,20200713,수인분당선,호구포,3107,3179,6286
9194,20200713,수인분당선,인천논현,4839,5152,9991
9195,20200713,수인분당선,소래포구,3553,3267,6820
9196,20200713,수인분당선,월곶,1943,1791,3734
9197,20200713,수인분당선,달월,70,51,121
9198,20200713,수인분당선,매교,2284,2254,4538
9199,20200713,수인분당선,수원시청,10319,11180,21499
9200,20200713,수인분당선,매탄권선,4166,3922,8088
9201,20200713,수인분당선,망포,12475,11926,24401
9202,20200713,수인분당선,영통,7674,7777,15451
9203,20200713,수인분당선,청명,3898,3692,7590
9204,20200713,수인분당선,상갈,5040,4737,9777
9205,20200713,수인분당선,기흥,8918,8327,17245
9206,20200713,수인분당선,신갈,4377,4272,8649
9207,20200713,수인분당선,구성,4687,4790,9477
9208,20200713,수인분당선,죽전,11988,13183,25171
9209,20200713,수인분당선,보정,2381,1951,4332
9210,20200713,수인분당선,이매,5307,4891,10198
9211,20200713,수인분당선,오리,10974,9269,20243
9212,20200713,수인분당선,미금,14815,15929,30744
9213,20200713,수인분당선,정자,15941,17093,33034
9214,20200713,수인분당선,수내,12062,12054,24116
9215,20200713,수인분당선,서현,23887,24266,48153
9216,20200713,수인분당선,야탑,24043,25206,49249
9217,20200713,수인분당선,모란,17902,18056,35958
9218,20200713,수인분당선,태평,12570,12176,24746
9219,20200713,수인분당선,가천대,6158,7210,13368
9220,20200713,수인분당선,선정릉,8024,9479,17503
9221,20200713,수인분당선,강남구청,9238,10559,19797
9222,20200713,수인분당선,압구정로데오,14757,16540,31297
9223,20200713,수인분당선,서울숲,8098,8106,16204
9224,20200713,수인분당선,수원,7088,4970,12058
9225,20200713,수인분당선,수서,13107,13616,26723
9226,20200713,수인분당선,대모산입구,3315,3010,6325
9227,20200713,수인분당선,개포동,3361,3571,6932
9228,20200713,수인분당선,구룡,1540,1589,3129
9229,20200713,수인분당선,도곡,6480,6660,13140
9230,20200713,수인분당선,한티,12198,13346,25544
9231,20200713,수인분당선,선릉,13605,21871,35476
9232,20200713,수인분당선,복정,1,0,1
9233,20200714,수인분당선,선릉,13609,21574,35183
9234,20200714,수인분당선,한티,13546,14579,28125
9235,20200714,수인분당선,도곡,6757,6810,13567
9236,20200714,수인분당선,구룡,1667,1663,3330
9237,20200714,수인분당선,개포동,3639,3748,7387
9238,20200714,수인분당선,대모산입구,3639,3297,6936
9239,20200714,수인분당선,수서,13505,13705,27210
9240,20200714,수인분당선,복정,2,0,2
9241,20200714,수인분당선,수원,7551,5387,12938
9242,20200714,수인분당선,서울숲,9251,9358,18609
9243,20200714,수인분당선,압구정로데오,16724,19143,35867
9244,20200714,수인분당선,강남구청,9902,11384,21286
9245,20200714,수인분당선,선정릉,8220,8877,17097
9246,20200714,수인분당선,가천대,6451,7193,13644
9247,20200714,수인분당선,태평,13538,13136,26674
9248,20200714,수인분당선,모란,23998,24970,48968
9249,20200714,수인분당선,야탑,25551,26742,52293
9250,20200714,수인분당선,서현,24904,25540,50444
9251,20200714,수인분당선,수내,12948,13035,25983
9252,20200714,수인분당선,정자,16865,17986,34851
9253,20200714,수인분당선,미금,16266,17336,33602
9254,20200714,수인분당선,오리,12029,10275,22304
9255,20200714,수인분당선,이매,5659,5333,10992
9256,20200714,수인분당선,보정,2590,2214,4804
9257,20200714,수인분당선,죽전,13207,14548,27755
9258,20200714,수인분당선,구성,5052,5172,10224
9259,20200714,수인분당선,신갈,4690,4544,9234
9260,20200714,수인분당선,기흥,9351,8748,18099
9261,20200714,수인분당선,상갈,5358,5013,10371
9262,20200714,수인분당선,청명,4068,3841,7909
9263,20200714,수인분당선,영통,7746,7962,15708
9264,20200714,수인분당선,망포,13048,12388,25436
9265,20200714,수인분당선,매탄권선,4338,4200,8538
9266,20200714,수인분당선,수원시청,10823,11939,22762
9267,20200714,수인분당선,매교,2493,2463,4956
9268,20200714,수인분당선,달월,81,57,138
9269,20200714,수인분당선,월곶,2125,2047,4172
9270,20200714,수인분당선,소래포구,4177,3858,8035
9271,20200714,수인분당선,인천논현,5351,5557,10908
9272,20200714,수인분당선,호구포,3332,3398,6730
9273,20200714,수인분당선,남동인더스파크,2108,2290,4398
9274,20200714,수인분당선,원인재,4068,4200,8268
9275,20200714,수인분당선,연수,4259,4370,8629
9276,20200714,수인분당선,송도,2335,2177,4512
9277,20200714,수인분당선,인하대,5074,4811,9885
9278,20200714,수인분당선,숭의,3586,3391,6977
9279,20200714,수인분당선,신포,1699,1716,3415
9280,20200714,수인분당선,인천,890,1410,2300
9281,20200715,수인분당선,선릉,13707,21822,35529
9282,20200715,수인분당선,한티,14063,15030,29093
9283,20200715,수인분당선,도곡,6825,6946,13771
9284,20200715,수인분당선,구룡,1694,1639,3333
9285,20200715,수인분당선,개포동,3847,3934,7781
9286,20200715,수인분당선,대모산입구,3610,3325,6935
9287,20200715,수인분당선,수서,13648,14194,27842
9288,20200715,수인분당선,수원,7763,5513,13276
9289,20200715,수인분당선,서울숲,10102,10153,20255
9290,20200715,수인분당선,압구정로데오,17407,19995,37402
9291,20200715,수인분당선,강남구청,9911,11385,21296
9292,20200715,수인분당선,선정릉,8377,9043,17420
9293,20200715,수인분당선,가천대,6613,7449,14062
9294,20200715,수인분당선,태평,13570,13003,26573
9295,20200715,수인분당선,모란,20015,20098,40113
9296,20200715,수인분당선,야탑,26490,27630,54120
9297,20200715,수인분당선,서현,25870,26224,52094
9298,20200715,수인분당선,수내,13142,13181,26323
9299,20200715,수인분당선,정자,17002,18299,35301
9300,20200715,수인분당선,미금,16413,17602,34015
9301,20200715,수인분당선,오리,12015,10205,22220
9302,20200715,수인분당선,이매,5797,5307,11104
9303,20200715,수인분당선,보정,2649,2186,4835
9304,20200715,수인분당선,죽전,13460,14994,28454
9305,20200715,수인분당선,구성,5116,5199,10315
9306,20200715,수인분당선,신갈,4812,4708,9520
9307,20200715,수인분당선,기흥,9694,9125,18819
9308,20200715,수인분당선,상갈,5491,5160,10651
9309,20200715,수인분당선,청명,4202,3988,8190
9310,20200715,수인분당선,영통,8213,8406,16619
9311,20200715,수인분당선,망포,13430,12788,26218
9312,20200715,수인분당선,매탄권선,4474,4248,8722
9313,20200715,수인분당선,연수,4403,4487,8890
9314,20200715,수인분당선,송도,2489,2332,4821
9315,20200715,수인분당선,인하대,5212,4919,10131
9316,20200715,수인분당선,숭의,3699,3474,7173
9317,20200715,수인분당선,신포,1762,1786,3548
9318,20200715,수인분당선,인천,961,1569,2530
9319,20200715,수인분당선,수원시청,11347,12575,23922
9320,20200715,수인분당선,매교,2561,2513,5074
9321,20200715,수인분당선,달월,87,56,143
9322,20200715,수인분당선,월곶,2292,2112,4404
9323,20200715,수인분당선,소래포구,4600,4285,8885
9324,20200715,수인분당선,인천논현,5600,5848,11448
9325,20200715,수인분당선,호구포,3431,3447,6878
9326,20200715,수인분당선,남동인더스파크,2286,2396,4682
9327,20200715,수인분당선,원인재,4201,4233,8434
9328,20200716,수인분당선,인천,929,1552,2481
9329,20200716,수인분당선,신포,1641,1742,3383
9330,20200716,수인분당선,숭의,3615,3391,7006
9331,20200716,수인분당선,인하대,5198,4904,10102
9332,20200716,수인분당선,송도,2475,2285,4760
9333,20200716,수인분당선,연수,4293,4372,8665
9334,20200716,수인분당선,원인재,4156,4273,8429
9335,20200716,수인분당선,남동인더스파크,2127,2404,4531
9336,20200716,수인분당선,호구포,3474,3497,6971
9337,20200716,수인분당선,인천논현,5483,5806,11289
9338,20200716,수인분당선,소래포구,4473,4076,8549
9339,20200716,수인분당선,월곶,2226,2065,4291
9340,20200716,수인분당선,달월,92,72,164
9341,20200716,수인분당선,매교,2550,2503,5053
9342,20200716,수인분당선,수원시청,10937,12336,23273
9343,20200716,수인분당선,매탄권선,4406,4221,8627
9344,20200716,수인분당선,망포,13418,12644,26062
9345,20200716,수인분당선,영통,8051,8258,16309
9346,20200716,수인분당선,청명,4267,4056,8323
9347,20200716,수인분당선,상갈,5497,5141,10638
9348,20200716,수인분당선,기흥,9523,9088,18611
9349,20200716,수인분당선,신갈,4780,4578,9358
9350,20200716,수인분당선,구성,5040,5156,10196
9351,20200716,수인분당선,죽전,13496,14906,28402
9352,20200716,수인분당선,보정,2665,2197,4862
9353,20200716,수인분당선,이매,5628,5281,10909
9354,20200716,수인분당선,오리,12049,10235,22284
9355,20200716,수인분당선,미금,16083,17231,33314
9356,20200716,수인분당선,정자,17192,18376,35568
9357,20200716,수인분당선,수내,12880,13145,26025
9358,20200716,수인분당선,서현,25142,25896,51038
9359,20200716,수인분당선,야탑,25763,27135,52898
9360,20200716,수인분당선,모란,19898,19911,39809
9361,20200716,수인분당선,태평,13429,12936,26365
9362,20200716,수인분당선,가천대,6387,7350,13737
9363,20200716,수인분당선,선정릉,8329,8933,17262
9364,20200716,수인분당선,강남구청,9685,11276,20961
9365,20200716,수인분당선,압구정로데오,17483,20114,37597
9366,20200716,수인분당선,서울숲,9728,9887,19615
9367,20200716,수인분당선,수원,7817,5565,13382
9368,20200716,수인분당선,수서,13957,14374,28331
9369,20200716,수인분당선,대모산입구,3633,3257,6890
9370,20200716,수인분당선,개포동,3705,3757,7462
9371,20200716,수인분당선,구룡,1651,1669,3320
9372,20200716,수인분당선,도곡,6819,6847,13666
9373,20200716,수인분당선,한티,13741,14769,28510
9374,20200716,수인분당선,선릉,13767,21476,35243
9375,20200717,수인분당선,수내,13410,13353,26763
9376,20200717,수인분당선,정자,17399,18955,36354
9377,20200717,수인분당선,미금,16638,17620,34258
9378,20200717,수인분당선,오리,12248,10213,22461
9379,20200717,수인분당선,이매,5805,5306,11111
9380,20200717,수인분당선,보정,2536,2160,4696
9381,20200717,수인분당선,죽전,14303,15357,29660
9382,20200717,수인분당선,구성,5152,5055,10207
9383,20200717,수인분당선,신갈,4756,4660,9416
9384,20200717,수인분당선,기흥,9875,9285,19160
9385,20200717,수인분당선,상갈,5518,5114,10632
9386,20200717,수인분당선,청명,4460,4044,8504
9387,20200717,수인분당선,영통,8688,8867,17555
9388,20200717,수인분당선,망포,14462,13008,27470
9389,20200717,수인분당선,매탄권선,4804,4368,9172
9390,20200717,수인분당선,수원시청,11840,14470,26310
9391,20200717,수인분당선,매교,2575,2568,5143
9392,20200717,수인분당선,달월,92,67,159
9393,20200717,수인분당선,월곶,2269,2152,4421
9394,20200717,수인분당선,소래포구,4573,4229,8802
9395,20200717,수인분당선,인천논현,5625,5920,11545
9396,20200717,수인분당선,호구포,3491,3428,6919
9397,20200717,수인분당선,남동인더스파크,2172,2404,4576
9398,20200717,수인분당선,원인재,4218,4312,8530
9399,20200717,수인분당선,연수,4338,4517,8855
9400,20200717,수인분당선,송도,2469,2308,4777
9401,20200717,수인분당선,인하대,5365,5035,10400
9402,20200717,수인분당선,숭의,3632,3244,6876
9403,20200717,수인분당선,신포,1707,1812,3519
9404,20200717,수인분당선,인천,955,1582,2537
9405,20200717,수인분당선,선릉,13686,21606,35292
9406,20200717,수인분당선,한티,14340,15294,29634
9407,20200717,수인분당선,도곡,6834,6769,13603
9408,20200717,수인분당선,구룡,1720,1613,3333
9409,20200717,수인분당선,개포동,3815,3943,7758
9410,20200717,수인분당선,대모산입구,3554,3226,6780
9411,20200717,수인분당선,수서,15247,16209,31456
9412,20200717,수인분당선,수원,8309,6041,14350
9413,20200717,수인분당선,서울숲,9864,10044,19908
9414,20200717,수인분당선,압구정로데오,18265,22640,40905
9415,20200717,수인분당선,강남구청,9982,11411,21393
9416,20200717,수인분당선,선정릉,8160,8867,17027
9417,20200717,수인분당선,가천대,6646,7270,13916
9418,20200717,수인분당선,태평,13716,12911,26627
9419,20200717,수인분당선,모란,20219,20545,40764
9420,20200717,수인분당선,야탑,26779,28256,55035
9421,20200717,수인분당선,서현,26355,27177,53532
9422,20200718,수인분당선,복정,1,0,1
9423,20200718,수인분당선,선릉,4999,8113,13112
9424,20200718,수인분당선,한티,10466,10151,20617
9425,20200718,수인분당선,도곡,4173,3829,8002
9426,20200718,수인분당선,구룡,1216,1156,2372
9427,20200718,수인분당선,개포동,2390,2338,4728
9428,20200718,수인분당선,대모산입구,2390,2163,4553
9429,20200718,수인분당선,수서,10224,10615,20839
9430,20200718,수인분당선,수원,6170,4323,10493
9431,20200718,수인분당선,서울숲,7657,7783,15440
9432,20200718,수인분당선,압구정로데오,14536,17874,32410
9433,20200718,수인분당선,강남구청,4751,5800,10551
9434,20200718,수인분당선,선정릉,3557,3762,7319
9435,20200718,수인분당선,가천대,4392,4982,9374
9436,20200718,수인분당선,태평,10362,9492,19854
9437,20200718,수인분당선,모란,15401,15550,30951
9438,20200718,수인분당선,야탑,16850,17815,34665
9439,20200718,수인분당선,서현,17128,17828,34956
9440,20200718,수인분당선,수내,8639,7894,16533
9441,20200718,수인분당선,정자,10518,10615,21133
9442,20200718,수인분당선,미금,10546,10910,21456
9443,20200718,수인분당선,오리,7402,6172,13574
9444,20200718,수인분당선,이매,3996,3632,7628
9445,20200718,수인분당선,보정,1568,1370,2938
9446,20200718,수인분당선,죽전,9889,11229,21118
9447,20200718,수인분당선,구성,3036,3103,6139
9448,20200718,수인분당선,신갈,2661,2649,5310
9449,20200718,수인분당선,기흥,6253,5848,12101
9450,20200718,수인분당선,상갈,3595,3536,7131
9451,20200718,수인분당선,청명,2434,2241,4675
9452,20200718,수인분당선,영통,5898,6041,11939
9453,20200718,수인분당선,망포,8241,7365,15606
9454,20200718,수인분당선,매탄권선,3112,2832,5944
9455,20200718,수인분당선,수원시청,9128,10757,19885
9456,20200718,수인분당선,매교,1472,1480,2952
9457,20200718,수인분당선,달월,42,37,79
9458,20200718,수인분당선,월곶,1799,1689,3488
9459,20200718,수인분당선,소래포구,4364,4563,8927
9460,20200718,수인분당선,인천논현,4158,4315,8473
9461,20200718,수인분당선,호구포,2193,2028,4221
9462,20200718,수인분당선,남동인더스파크,863,845,1708
9463,20200718,수인분당선,원인재,3218,3270,6488
9464,20200718,수인분당선,연수,3544,3586,7130
9465,20200718,수인분당선,송도,1760,1820,3580
9466,20200718,수인분당선,인하대,3493,3251,6744
9467,20200718,수인분당선,숭의,2395,2095,4490
9468,20200718,수인분당선,신포,1213,1315,2528
9469,20200718,수인분당선,인천,1079,1692,2771
9470,20200719,수인분당선,선릉,2443,3781,6224
9471,20200719,수인분당선,한티,6390,6423,12813
9472,20200719,수인분당선,도곡,2083,2071,4154
9473,20200719,수인분당선,구룡,640,647,1287
9474,20200719,수인분당선,개포동,1645,1750,3395
9475,20200719,수인분당선,대모산입구,1232,1128,2360
9476,20200719,수인분당선,수서,8129,7524,15653
9477,20200719,수인분당선,복정,1,0,1
9478,20200719,수인분당선,수원,4288,2774,7062
9479,20200719,수인분당선,서울숲,3441,3320,6761
9480,20200719,수인분당선,압구정로데오,7145,8119,15264
9481,20200719,수인분당선,강남구청,2529,2942,5471
9482,20200719,수인분당선,선정릉,1702,1782,3484
9483,20200719,수인분당선,가천대,2902,3602,6504
9484,20200719,수인분당선,태평,6872,6419,13291
9485,20200719,수인분당선,모란,12926,13630,26556
9486,20200719,수인분당선,야탑,11236,11661,22897
9487,20200719,수인분당선,서현,10854,11302,22156
9488,20200719,수인분당선,수내,5311,4909,10220
9489,20200719,수인분당선,정자,6259,6668,12927
9490,20200719,수인분당선,미금,6107,6675,12782
9491,20200719,수인분당선,오리,4617,4201,8818
9492,20200719,수인분당선,이매,2559,2510,5069
9493,20200719,수인분당선,보정,894,827,1721
9494,20200719,수인분당선,죽전,6554,7697,14251
9495,20200719,수인분당선,구성,1942,2109,4051
9496,20200719,수인분당선,신갈,1671,1623,3294
9497,20200719,수인분당선,기흥,4079,3980,8059
9498,20200719,수인분당선,상갈,2383,2383,4766
9499,20200719,수인분당선,청명,1676,1694,3370
9500,20200719,수인분당선,영통,3818,3899,7717
9501,20200719,수인분당선,망포,4871,5289,10160
9502,20200719,수인분당선,매탄권선,1952,1912,3864
9503,20200719,수인분당선,수원시청,5837,5672,11509
9504,20200719,수인분당선,매교,931,884,1815
9505,20200719,수인분당선,달월,34,31,65
9506,20200719,수인분당선,월곶,1107,1057,2164
9507,20200719,수인분당선,소래포구,2684,2522,5206
9508,20200719,수인분당선,인천논현,2416,2503,4919
9509,20200719,수인분당선,호구포,1433,1503,2936
9510,20200719,수인분당선,남동인더스파크,402,454,856
9511,20200719,수인분당선,원인재,2035,2096,4131
9512,20200719,수인분당선,연수,2270,2280,4550
9513,20200719,수인분당선,송도,1105,1049,2154
9514,20200719,수인분당선,인하대,2164,2032,4196
9515,20200719,수인분당선,숭의,1349,1307,2656
9516,20200719,수인분당선,신포,792,733,1525
9517,20200719,수인분당선,인천,622,856,1478
9518,20200720,수인분당선,선릉,13551,21302,34853
9519,20200720,수인분당선,한티,13091,14132,27223
9520,20200720,수인분당선,도곡,6549,6682,13231
9521,20200720,수인분당선,구룡,1584,1547,3131
9522,20200720,수인분당선,개포동,3501,3633,7134
9523,20200720,수인분당선,대모산입구,3424,3090,6514
9524,20200720,수인분당선,수서,13603,13746,27349
9525,20200720,수인분당선,수원,7355,5111,12466
9526,20200720,수인분당선,서울숲,8700,8731,17431
9527,20200720,수인분당선,압구정로데오,15483,17672,33155
9528,20200720,수인분당선,강남구청,9331,10774,20105
9529,20200720,수인분당선,선정릉,8061,8800,16861
9530,20200720,수인분당선,가천대,6072,7127,13199
9531,20200720,수인분당선,태평,12936,12557,25493
9532,20200720,수인분당선,모란,18538,18487,37025
9533,20200720,수인분당선,야탑,24683,25929,50612
9534,20200720,수인분당선,서현,24528,24977,49505
9535,20200720,수인분당선,수내,11908,11852,23760
9536,20200720,수인분당선,정자,16287,17468,33755
9537,20200720,수인분당선,미금,15465,16470,31935
9538,20200720,수인분당선,오리,11330,9666,20996
9539,20200720,수인분당선,이매,5404,4989,10393
9540,20200720,수인분당선,보정,2457,2015,4472
9541,20200720,수인분당선,죽전,11584,12787,24371
9542,20200720,수인분당선,구성,4741,4874,9615
9543,20200720,수인분당선,신갈,4499,4387,8886
9544,20200720,수인분당선,기흥,9204,8586,17790
9545,20200720,수인분당선,상갈,5151,4887,10038
9546,20200720,수인분당선,청명,4129,3841,7970
9547,20200720,수인분당선,영통,7708,7977,15685
9548,20200720,수인분당선,망포,12693,12291,24984
9549,20200720,수인분당선,매탄권선,4176,4019,8195
9550,20200720,수인분당선,수원시청,10661,11540,22201
9551,20200720,수인분당선,매교,2464,2404,4868
9552,20200720,수인분당선,달월,73,44,117
9553,20200720,수인분당선,월곶,2157,1942,4099
9554,20200720,수인분당선,소래포구,3944,3628,7572
9555,20200720,수인분당선,인천논현,5166,5505,10671
9556,20200720,수인분당선,호구포,3271,3317,6588
9557,20200720,수인분당선,남동인더스파크,2175,2458,4633
9558,20200720,수인분당선,원인재,3879,4015,7894
9559,20200720,수인분당선,연수,4210,4069,8279
9560,20200720,수인분당선,송도,2221,2117,4338
9561,20200720,수인분당선,인하대,4946,4599,9545
9562,20200720,수인분당선,숭의,3422,3270,6692
9563,20200720,수인분당선,신포,1538,1586,3124
9564,20200720,수인분당선,인천,800,1364,2164
9565,20200721,수인분당선,선릉,13985,21986,35971
9566,20200721,수인분당선,한티,13602,14616,28218
9567,20200721,수인분당선,도곡,6806,6792,13598
9568,20200721,수인분당선,구룡,1639,1618,3257
9569,20200721,수인분당선,개포동,3724,3746,7470
9570,20200721,수인분당선,대모산입구,3613,3288,6901
9571,20200721,수인분당선,수서,13866,14188,28054
9572,20200721,수인분당선,수원,7651,5432,13083
9573,20200721,수인분당선,서울숲,9735,9788,19523
9574,20200721,수인분당선,압구정로데오,17187,19759,36946
9575,20200721,수인분당선,강남구청,9722,11269,20991
9576,20200721,수인분당선,선정릉,8382,8998,17380
9577,20200721,수인분당선,가천대,6347,7350,13697
9578,20200721,수인분당선,태평,13536,12934,26470
9579,20200721,수인분당선,모란,19550,19738,39288
9580,20200721,수인분당선,야탑,25867,27221,53088
9581,20200721,수인분당선,서현,25197,25790,50987
9582,20200721,수인분당선,수내,13259,13249,26508
9583,20200721,수인분당선,정자,17042,18259,35301
9584,20200721,수인분당선,미금,16087,17156,33243
9585,20200721,수인분당선,오리,11781,10104,21885
9586,20200721,수인분당선,이매,5745,5347,11092
9587,20200721,수인분당선,보정,2619,2195,4814
9588,20200721,수인분당선,죽전,13424,14702,28126
9589,20200721,수인분당선,구성,5090,5218,10308
9590,20200721,수인분당선,신갈,4795,4673,9468
9591,20200721,수인분당선,기흥,9406,8909,18315
9592,20200721,수인분당선,상갈,5451,5096,10547
9593,20200721,수인분당선,청명,4297,4041,8338
9594,20200721,수인분당선,영통,7994,8319,16313
9595,20200721,수인분당선,망포,13512,12718,26230
9596,20200721,수인분당선,매탄권선,4450,4275,8725
9597,20200721,수인분당선,수원시청,11083,12304,23387
9598,20200721,수인분당선,매교,2443,2442,4885
9599,20200721,수인분당선,달월,73,56,129
9600,20200721,수인분당선,월곶,2229,2083,4312
9601,20200721,수인분당선,소래포구,4591,4303,8894
9602,20200721,수인분당선,인천논현,5475,5726,11201
9603,20200721,수인분당선,호구포,3355,3524,6879
9604,20200721,수인분당선,남동인더스파크,2280,2421,4701
9605,20200721,수인분당선,원인재,4166,4294,8460
9606,20200721,수인분당선,연수,4203,4331,8534
9607,20200721,수인분당선,송도,2452,2232,4684
9608,20200721,수인분당선,인하대,5123,4891,10014
9609,20200721,수인분당선,숭의,3669,3423,7092
9610,20200721,수인분당선,신포,1727,1724,3451
9611,20200721,수인분당선,인천,925,1626,2551
9612,20200722,수인분당선,강남구청,9650,11118,20768
9613,20200722,수인분당선,압구정로데오,16945,19632,36577
9614,20200722,수인분당선,서울숲,9284,9316,18600
9615,20200722,수인분당선,수원,7316,5165,12481
9616,20200722,수인분당선,선정릉,8229,8991,17220
9617,20200722,수인분당선,수서,13603,13760,27363
9618,20200722,수인분당선,대모산입구,3513,3166,6679
9619,20200722,수인분당선,개포동,3788,3915,7703
9620,20200722,수인분당선,구룡,1599,1567,3166
9621,20200722,수인분당선,도곡,6727,6854,13581
9622,20200722,수인분당선,한티,13539,14596,28135
9623,20200722,수인분당선,선릉,13873,21753,35626
9624,20200722,수인분당선,가천대,6230,7253,13483
9625,20200722,수인분당선,인천,810,1358,2168
9626,20200722,수인분당선,신포,1576,1589,3165
9627,20200722,수인분당선,숭의,3274,2992,6266
9628,20200722,수인분당선,인하대,4797,4599,9396
9629,20200722,수인분당선,송도,2205,1990,4195
9630,20200722,수인분당선,연수,3963,4005,7968
9631,20200722,수인분당선,원인재,3883,3796,7679
9632,20200722,수인분당선,남동인더스파크,2189,2471,4660
9633,20200722,수인분당선,호구포,3296,3335,6631
9634,20200722,수인분당선,인천논현,5059,5278,10337
9635,20200722,수인분당선,소래포구,3854,3596,7450
9636,20200722,수인분당선,월곶,2040,1932,3972
9637,20200722,수인분당선,달월,78,52,130
9638,20200722,수인분당선,매교,2397,2335,4732
9639,20200722,수인분당선,수원시청,10608,11907,22515
9640,20200722,수인분당선,매탄권선,4217,3965,8182
9641,20200722,수인분당선,망포,13124,12287,25411
9642,20200722,수인분당선,영통,7720,7969,15689
9643,20200722,수인분당선,청명,4130,3876,8006
9644,20200722,수인분당선,상갈,5294,4923,10217
9645,20200722,수인분당선,기흥,9450,8616,18066
9646,20200722,수인분당선,신갈,4654,4465,9119
9647,20200722,수인분당선,구성,4806,4837,9643
9648,20200722,수인분당선,죽전,12614,13859,26473
9649,20200722,수인분당선,보정,2580,2038,4618
9650,20200722,수인분당선,이매,5578,5098,10676
9651,20200722,수인분당선,오리,11387,9893,21280
9652,20200722,수인분당선,미금,15344,16272,31616
9653,20200722,수인분당선,정자,17044,18024,35068
9654,20200722,수인분당선,수내,12647,12669,25316
9655,20200722,수인분당선,서현,24629,25207,49836
9656,20200722,수인분당선,야탑,25329,26589,51918
9657,20200722,수인분당선,모란,18921,18694,37615
9658,20200722,수인분당선,태평,13147,12588,25735
9659,20200723,수인분당선,수서,13829,14323,28152
9660,20200723,수인분당선,선릉,13980,21809,35789
9661,20200723,수인분당선,한티,13093,14622,27715
9662,20200723,수인분당선,도곡,6565,6751,13316
9663,20200723,수인분당선,구룡,1544,1514,3058
9664,20200723,수인분당선,개포동,3411,3574,6985
9665,20200723,수인분당선,대모산입구,3355,3169,6524
9666,20200723,수인분당선,수원,7031,5108,12139
9667,20200723,수인분당선,서울숲,8962,8953,17915
9668,20200723,수인분당선,압구정로데오,17463,19551,37014
9669,20200723,수인분당선,강남구청,9560,10976,20536
9670,20200723,수인분당선,선정릉,8862,9299,18161
9671,20200723,수인분당선,가천대,6270,7398,13668
9672,20200723,수인분당선,태평,12786,12230,25016
9673,20200723,수인분당선,모란,18404,18338,36742
9674,20200723,수인분당선,야탑,24788,26211,50999
9675,20200723,수인분당선,서현,24105,25045,49150
9676,20200723,수인분당선,수내,12466,12900,25366
9677,20200723,수인분당선,정자,16733,18264,34997
9678,20200723,수인분당선,미금,15094,16096,31190
9679,20200723,수인분당선,오리,11519,9760,21279
9680,20200723,수인분당선,이매,5623,5216,10839
9681,20200723,수인분당선,보정,2514,2069,4583
9682,20200723,수인분당선,죽전,12390,13866,26256
9683,20200723,수인분당선,구성,4809,4890,9699
9684,20200723,수인분당선,신갈,4598,4491,9089
9685,20200723,수인분당선,기흥,9216,8670,17886
9686,20200723,수인분당선,상갈,5144,4990,10134
9687,20200723,수인분당선,청명,4110,4025,8135
9688,20200723,수인분당선,영통,7525,7925,15450
9689,20200723,수인분당선,망포,12848,12117,24965
9690,20200723,수인분당선,매탄권선,4150,4113,8263
9691,20200723,수인분당선,수원시청,10372,11312,21684
9692,20200723,수인분당선,매교,2385,2368,4753
9693,20200723,수인분당선,달월,75,44,119
9694,20200723,수인분당선,월곶,1967,1820,3787
9695,20200723,수인분당선,소래포구,3669,3448,7117
9696,20200723,수인분당선,인천논현,4794,4932,9726
9697,20200723,수인분당선,호구포,3107,3206,6313
9698,20200723,수인분당선,남동인더스파크,2057,2317,4374
9699,20200723,수인분당선,원인재,3737,3773,7510
9700,20200723,수인분당선,연수,3703,3757,7460
9701,20200723,수인분당선,송도,2055,1902,3957
9702,20200723,수인분당선,인하대,4603,4223,8826
9703,20200723,수인분당선,숭의,3173,3094,6267
9704,20200723,수인분당선,신포,1342,1429,2771
9705,20200723,수인분당선,인천,802,1342,2144
9706,20200724,수인분당선,선릉,13501,21424,34925
9707,20200724,수인분당선,한티,14208,14902,29110
9708,20200724,수인분당선,도곡,6563,6500,13063
9709,20200724,수인분당선,구룡,1791,1618,3409
9710,20200724,수인분당선,개포동,3693,3896,7589
9711,20200724,수인분당선,대모산입구,3590,3167,6757
9712,20200724,수인분당선,수서,15372,16293,31665
9713,20200724,수인분당선,수원,8232,5965,14197
9714,20200724,수인분당선,서울숲,9301,9191,18492
9715,20200724,수인분당선,압구정로데오,18314,22315,40629
9716,20200724,수인분당선,강남구청,9860,11309,21169
9717,20200724,수인분당선,선정릉,8279,8894,17173
9718,20200724,수인분당선,가천대,6849,7482,14331
9719,20200724,수인분당선,태평,13996,13025,27021
9720,20200724,수인분당선,모란,24403,25409,49812
9721,20200724,수인분당선,야탑,26805,28008,54813
9722,20200724,수인분당선,서현,26320,27192,53512
9723,20200724,수인분당선,수내,13344,13391,26735
9724,20200724,수인분당선,정자,17318,18785,36103
9725,20200724,수인분당선,미금,16480,17343,33823
9726,20200724,수인분당선,오리,12412,10400,22812
9727,20200724,수인분당선,이매,5790,5389,11179
9728,20200724,수인분당선,보정,2622,2190,4812
9729,20200724,수인분당선,죽전,13790,14804,28594
9730,20200724,수인분당선,구성,5109,5108,10217
9731,20200724,수인분당선,신갈,4884,4625,9509
9732,20200724,수인분당선,기흥,9883,9244,19127
9733,20200724,수인분당선,상갈,5675,5201,10876
9734,20200724,수인분당선,청명,4517,4030,8547
9735,20200724,수인분당선,영통,8554,8780,17334
9736,20200724,수인분당선,망포,14442,13012,27454
9737,20200724,수인분당선,매탄권선,4752,4341,9093
9738,20200724,수인분당선,수원시청,11642,14546,26188
9739,20200724,수인분당선,매교,2530,2457,4987
9740,20200724,수인분당선,달월,70,51,121
9741,20200724,수인분당선,월곶,2185,2054,4239
9742,20200724,수인분당선,소래포구,4257,3977,8234
9743,20200724,수인분당선,인천논현,5587,5850,11437
9744,20200724,수인분당선,호구포,3445,3391,6836
9745,20200724,수인분당선,남동인더스파크,2180,2403,4583
9746,20200724,수인분당선,원인재,4339,4275,8614
9747,20200724,수인분당선,연수,4383,4447,8830
9748,20200724,수인분당선,송도,2409,2243,4652
9749,20200724,수인분당선,인하대,5033,4596,9629
9750,20200724,수인분당선,숭의,3465,3233,6698
9751,20200724,수인분당선,신포,1666,1754,3420
9752,20200724,수인분당선,인천,832,1503,2335
9753,20200725,수인분당선,선릉,4824,7579,12403
9754,20200725,수인분당선,한티,9890,9659,19549
9755,20200725,수인분당선,도곡,3792,3427,7219
9756,20200725,수인분당선,구룡,1140,1022,2162
9757,20200725,수인분당선,개포동,2455,2334,4789
9758,20200725,수인분당선,대모산입구,2394,2114,4508
9759,20200725,수인분당선,수서,9809,10207,20016
9760,20200725,수인분당선,복정,1,0,1
9761,20200725,수인분당선,수원,6322,4533,10855
9762,20200725,수인분당선,서울숲,6947,7048,13995
9763,20200725,수인분당선,압구정로데오,14629,17843,32472
9764,20200725,수인분당선,강남구청,4540,5548,10088
9765,20200725,수인분당선,선정릉,3693,3871,7564
9766,20200725,수인분당선,가천대,4588,4948,9536
9767,20200725,수인분당선,태평,10196,9419,19615
9768,20200725,수인분당선,모란,15290,15208,30498
9769,20200725,수인분당선,야탑,16470,17403,33873
9770,20200725,수인분당선,서현,17347,18004,35351
9771,20200725,수인분당선,수내,8269,7771,16040
9772,20200725,수인분당선,정자,10509,10566,21075
9773,20200725,수인분당선,미금,10558,11160,21718
9774,20200725,수인분당선,오리,7464,6172,13636
9775,20200725,수인분당선,이매,3950,3602,7552
9776,20200725,수인분당선,보정,1601,1396,2997
9777,20200725,수인분당선,죽전,9775,10943,20718
9778,20200725,수인분당선,구성,3067,3040,6107
9779,20200725,수인분당선,신갈,2711,2698,5409
9780,20200725,수인분당선,기흥,6441,6088,12529
9781,20200725,수인분당선,상갈,3609,3567,7176
9782,20200725,수인분당선,청명,2527,2358,4885
9783,20200725,수인분당선,영통,5908,5997,11905
9784,20200725,수인분당선,망포,8432,7351,15783
9785,20200725,수인분당선,매탄권선,3003,2726,5729
9786,20200725,수인분당선,수원시청,8977,10551,19528
9787,20200725,수인분당선,매교,1439,1487,2926
9788,20200725,수인분당선,달월,48,45,93
9789,20200725,수인분당선,월곶,1821,1724,3545
9790,20200725,수인분당선,소래포구,4362,4358,8720
9791,20200725,수인분당선,인천논현,4233,4359,8592
9792,20200725,수인분당선,호구포,2088,1982,4070
9793,20200725,수인분당선,남동인더스파크,850,795,1645
9794,20200725,수인분당선,원인재,3248,3273,6521
9795,20200725,수인분당선,연수,3608,3738,7346
9796,20200725,수인분당선,송도,1831,1783,3614
9797,20200725,수인분당선,인하대,3538,3315,6853
9798,20200725,수인분당선,숭의,2328,2144,4472
9799,20200725,수인분당선,신포,1235,1414,2649
9800,20200725,수인분당선,인천,923,1612,2535
9801,20200726,수인분당선,보정,997,968,1965
9802,20200726,수인분당선,죽전,7096,7965,15061
9803,20200726,수인분당선,구성,2175,2252,4427
9804,20200726,수인분당선,신갈,1839,1842,3681
9805,20200726,수인분당선,기흥,4513,4282,8795
9806,20200726,수인분당선,상갈,2560,2662,5222
9807,20200726,수인분당선,청명,1641,1661,3302
9808,20200726,수인분당선,영통,3953,3920,7873
9809,20200726,수인분당선,망포,5177,5504,10681
9810,20200726,수인분당선,매탄권선,2064,2104,4168
9811,20200726,수인분당선,연수,2718,2641,5359
9812,20200726,수인분당선,송도,1494,1385,2879
9813,20200726,수인분당선,인하대,2468,2280,4748
9814,20200726,수인분당선,숭의,1750,1565,3315
9815,20200726,수인분당선,신포,953,1003,1956
9816,20200726,수인분당선,인천,920,1259,2179
9817,20200726,수인분당선,오리,5089,4486,9575
9818,20200726,수인분당선,미금,6931,7520,14451
9819,20200726,수인분당선,정자,6832,7105,13937
9820,20200726,수인분당선,수내,5529,5408,10937
9821,20200726,수인분당선,서현,12058,12220,24278
9822,20200726,수인분당선,야탑,12132,12341,24473
9823,20200726,수인분당선,모란,10568,10823,21391
9824,20200726,수인분당선,태평,7420,6843,14263
9825,20200726,수인분당선,가천대,3006,3735,6741
9826,20200726,수인분당선,선정릉,1888,1983,3871
9827,20200726,수인분당선,강남구청,2762,3286,6048
9828,20200726,수인분당선,압구정로데오,8053,9137,17190
9829,20200726,수인분당선,서울숲,4654,4533,9187
9830,20200726,수인분당선,수원,4485,2826,7311
9831,20200726,수인분당선,수서,8323,7699,16022
9832,20200726,수인분당선,대모산입구,1496,1390,2886
9833,20200726,수인분당선,개포동,1891,1936,3827
9834,20200726,수인분당선,구룡,585,575,1160
9835,20200726,수인분당선,도곡,2114,2103,4217
9836,20200726,수인분당선,한티,6572,6557,13129
9837,20200726,수인분당선,선릉,2497,3775,6272
9838,20200726,수인분당선,원인재,2406,2489,4895
9839,20200726,수인분당선,남동인더스파크,444,520,964
9840,20200726,수인분당선,호구포,1532,1592,3124
9841,20200726,수인분당선,인천논현,2745,3046,5791
9842,20200726,수인분당선,소래포구,3390,3218,6608
9843,20200726,수인분당선,월곶,1347,1224,2571
9844,20200726,수인분당선,달월,35,31,66
9845,20200726,수인분당선,매교,953,947,1900
9846,20200726,수인분당선,수원시청,5887,5846,11733
9847,20200726,수인분당선,이매,2912,2968,5880
9848,20200727,수인분당선,송도,2226,2023,4249
9849,20200727,수인분당선,연수,4085,4192,8277
9850,20200727,수인분당선,원인재,3959,3994,7953
9851,20200727,수인분당선,남동인더스파크,2027,2266,4293
9852,20200727,수인분당선,호구포,3221,3343,6564
9853,20200727,수인분당선,인천논현,5078,5411,10489
9854,20200727,수인분당선,소래포구,3963,3625,7588
9855,20200727,수인분당선,월곶,2117,1948,4065
9856,20200727,수인분당선,달월,67,42,109
9857,20200727,수인분당선,매교,2448,2342,4790
9858,20200727,수인분당선,수원시청,10758,11608,22366
9859,20200727,수인분당선,매탄권선,4179,3998,8177
9860,20200727,수인분당선,망포,12672,12164,24836
9861,20200727,수인분당선,영통,7765,7989,15754
9862,20200727,수인분당선,청명,4083,3880,7963
9863,20200727,수인분당선,상갈,5270,4937,10207
9864,20200727,수인분당선,숭의,3443,3350,6793
9865,20200727,수인분당선,신포,1572,1623,3195
9866,20200727,수인분당선,인천,819,1324,2143
9867,20200727,수인분당선,기흥,9270,8739,18009
9868,20200727,수인분당선,선릉,13299,21307,34606
9869,20200727,수인분당선,한티,13043,14047,27090
9870,20200727,수인분당선,도곡,6624,6767,13391
9871,20200727,수인분당선,구룡,1619,1600,3219
9872,20200727,수인분당선,개포동,3556,3654,7210
9873,20200727,수인분당선,대모산입구,3467,3119,6586
9874,20200727,수인분당선,수서,13585,13573,27158
9875,20200727,수인분당선,복정,1,0,1
9876,20200727,수인분당선,수원,7255,5265,12520
9877,20200727,수인분당선,서울숲,8797,8805,17602
9878,20200727,수인분당선,압구정로데오,15584,17654,33238
9879,20200727,수인분당선,강남구청,9239,10533,19772
9880,20200727,수인분당선,선정릉,7998,8605,16603
9881,20200727,수인분당선,가천대,5949,7010,12959
9882,20200727,수인분당선,태평,13168,12759,25927
9883,20200727,수인분당선,모란,18781,18978,37759
9884,20200727,수인분당선,야탑,25111,26142,51253
9885,20200727,수인분당선,서현,24148,24566,48714
9886,20200727,수인분당선,수내,12504,12501,25005
9887,20200727,수인분당선,정자,16182,17462,33644
9888,20200727,수인분당선,미금,15265,16409,31674
9889,20200727,수인분당선,오리,11552,9879,21431
9890,20200727,수인분당선,이매,5463,5022,10485
9891,20200727,수인분당선,보정,2453,2046,4499
9892,20200727,수인분당선,죽전,12522,13868,26390
9893,20200727,수인분당선,구성,4842,4927,9769
9894,20200727,수인분당선,신갈,4660,4472,9132
9895,20200727,수인분당선,인하대,4728,4415,9143
9896,20200728,수인분당선,인천,858,1498,2356
9897,20200728,수인분당선,신포,1607,1660,3267
9898,20200728,수인분당선,숭의,3510,3368,6878
9899,20200728,수인분당선,인하대,4891,4683,9574
9900,20200728,수인분당선,송도,2240,2043,4283
9901,20200728,수인분당선,연수,4179,4259,8438
9902,20200728,수인분당선,원인재,3999,4076,8075
9903,20200728,수인분당선,남동인더스파크,2093,2298,4391
9904,20200728,수인분당선,호구포,3299,3332,6631
9905,20200728,수인분당선,인천논현,5230,5474,10704
9906,20200728,수인분당선,소래포구,4394,4070,8464
9907,20200728,수인분당선,월곶,2236,2099,4335
9908,20200728,수인분당선,달월,63,45,108
9909,20200728,수인분당선,매교,2457,2467,4924
9910,20200728,수인분당선,수원시청,10623,11587,22210
9911,20200728,수인분당선,매탄권선,4220,4037,8257
9912,20200728,수인분당선,망포,13001,12197,25198
9913,20200728,수인분당선,영통,7517,7964,15481
9914,20200728,수인분당선,청명,4072,3911,7983
9915,20200728,수인분당선,상갈,5449,5103,10552
9916,20200728,수인분당선,기흥,9333,8725,18058
9917,20200728,수인분당선,신갈,4652,4543,9195
9918,20200728,수인분당선,구성,4876,5014,9890
9919,20200728,수인분당선,죽전,12847,13976,26823
9920,20200728,수인분당선,보정,2537,2095,4632
9921,20200728,수인분당선,이매,5574,5198,10772
9922,20200728,수인분당선,오리,11517,9862,21379
9923,20200728,수인분당선,미금,15424,16361,31785
9924,20200728,수인분당선,정자,16758,17752,34510
9925,20200728,수인분당선,수내,12705,12856,25561
9926,20200728,수인분당선,서현,24261,24764,49025
9927,20200728,수인분당선,야탑,25365,26684,52049
9928,20200728,수인분당선,모란,19136,18988,38124
9929,20200728,수인분당선,태평,13119,12774,25893
9930,20200728,수인분당선,가천대,6002,6992,12994
9931,20200728,수인분당선,선정릉,8103,8784,16887
9932,20200728,수인분당선,강남구청,9620,11167,20787
9933,20200728,수인분당선,압구정로데오,17050,19556,36606
9934,20200728,수인분당선,서울숲,9256,9367,18623
9935,20200728,수인분당선,수원,7318,5091,12409
9936,20200728,수인분당선,수서,13545,13643,27188
9937,20200728,수인분당선,대모산입구,3409,3181,6590
9938,20200728,수인분당선,개포동,3626,3751,7377
9939,20200728,수인분당선,구룡,1654,1612,3266
9940,20200728,수인분당선,도곡,6640,6731,13371
9941,20200728,수인분당선,한티,13647,14339,27986
9942,20200728,수인분당선,선릉,13545,21421,34966
9943,20200729,수인분당선,인천,835,1387,2222
9944,20200729,수인분당선,신포,1556,1585,3141
9945,20200729,수인분당선,숭의,3289,3133,6422
9946,20200729,수인분당선,인하대,4756,4454,9210
9947,20200729,수인분당선,송도,2171,2047,4218
9948,20200729,수인분당선,연수,4009,4110,8119
9949,20200729,수인분당선,원인재,3887,3930,7817
9950,20200729,수인분당선,남동인더스파크,2063,2271,4334
9951,20200729,수인분당선,호구포,3222,3212,6434
9952,20200729,수인분당선,인천논현,5069,5205,10274
9953,20200729,수인분당선,소래포구,3939,3650,7589
9954,20200729,수인분당선,월곶,2045,1922,3967
9955,20200729,수인분당선,달월,81,43,124
9956,20200729,수인분당선,매교,2311,2321,4632
9957,20200729,수인분당선,수원시청,10339,11529,21868
9958,20200729,수인분당선,매탄권선,4067,3905,7972
9959,20200729,수인분당선,망포,12787,11971,24758
9960,20200729,수인분당선,영통,7566,7834,15400
9961,20200729,수인분당선,청명,4045,3759,7804
9962,20200729,수인분당선,상갈,5293,4923,10216
9963,20200729,수인분당선,기흥,9073,8515,17588
9964,20200729,수인분당선,신갈,4494,4383,8877
9965,20200729,수인분당선,구성,4833,4821,9654
9966,20200729,수인분당선,죽전,12469,14113,26582
9967,20200729,수인분당선,보정,2435,2024,4459
9968,20200729,수인분당선,이매,5659,5305,10964
9969,20200729,수인분당선,오리,11766,9945,21711
9970,20200729,수인분당선,미금,15350,16425,31775
9971,20200729,수인분당선,정자,16705,17918,34623
9972,20200729,수인분당선,수내,12666,12695,25361
9973,20200729,수인분당선,서현,25210,25493,50703
9974,20200729,수인분당선,야탑,25178,26216,51394
9975,20200729,수인분당선,모란,21896,22365,44261
9976,20200729,수인분당선,태평,13366,12772,26138
9977,20200729,수인분당선,가천대,6167,7136,13303
9978,20200729,수인분당선,선정릉,8085,8637,16722
9979,20200729,수인분당선,강남구청,9592,11133,20725
9980,20200729,수인분당선,압구정로데오,16842,19426,36268
9981,20200729,수인분당선,서울숲,8917,9029,17946
9982,20200729,수인분당선,수원,7157,5117,12274
9983,20200729,수인분당선,수서,13574,13982,27556
9984,20200729,수인분당선,대모산입구,3425,3112,6537
9985,20200729,수인분당선,개포동,3723,3789,7512
9986,20200729,수인분당선,구룡,1612,1516,3128
9987,20200729,수인분당선,도곡,6799,6737,13536
9988,20200729,수인분당선,한티,13434,14370,27804
9989,20200729,수인분당선,선릉,13435,21064,34499
9990,20200730,수인분당선,인천,869,1576,2445
9991,20200730,수인분당선,신포,1627,1731,3358
9992,20200730,수인분당선,숭의,3439,3238,6677
9993,20200730,수인분당선,인하대,5025,4600,9625
9994,20200730,수인분당선,송도,2339,2187,4526
9995,20200730,수인분당선,연수,4088,4077,8165
9996,20200730,수인분당선,원인재,4024,3971,7995
9997,20200730,수인분당선,남동인더스파크,2009,2175,4184
9998,20200730,수인분당선,호구포,3232,3209,6441
9999,20200730,수인분당선,인천논현,5185,5395,10580
10000,20200730,수인분당선,소래포구,4280,4002,8282
10001,20200730,수인분당선,월곶,2206,2017,4223
10002,20200730,수인분당선,달월,69,48,117
10003,20200730,수인분당선,매교,2395,2381,4776
10004,20200730,수인분당선,수원시청,10547,11653,22200
10005,20200730,수인분당선,매탄권선,4324,4029,8353
10006,20200730,수인분당선,망포,12842,12045,24887
10007,20200730,수인분당선,영통,7665,7823,15488
10008,20200730,수인분당선,청명,4158,3828,7986
10009,20200730,수인분당선,상갈,5125,4842,9967
10010,20200730,수인분당선,기흥,9247,8711,17958
10011,20200730,수인분당선,신갈,4644,4471,9115
10012,20200730,수인분당선,구성,4808,4782,9590
10013,20200730,수인분당선,죽전,12876,14323,27199
10014,20200730,수인분당선,보정,2579,2102,4681
10015,20200730,수인분당선,이매,5523,5052,10575
10016,20200730,수인분당선,오리,11765,9939,21704
10017,20200730,수인분당선,미금,15587,16545,32132
10018,20200730,수인분당선,정자,16535,17894,34429
10019,20200730,수인분당선,수내,12817,12820,25637
10020,20200730,수인분당선,서현,25443,25986,51429
10021,20200730,수인분당선,야탑,25026,26364,51390
10022,20200730,수인분당선,모란,19117,19192,38309
10023,20200730,수인분당선,태평,13276,12643,25919
10024,20200730,수인분당선,가천대,5979,6861,12840
10025,20200730,수인분당선,선정릉,7765,8534,16299
10026,20200730,수인분당선,강남구청,9344,10818,20162
10027,20200730,수인분당선,압구정로데오,16824,19800,36624
10028,20200730,수인분당선,서울숲,9314,9369,18683
10029,20200730,수인분당선,수원,7449,5347,12796
10030,20200730,수인분당선,수서,13596,13982,27578
10031,20200730,수인분당선,대모산입구,3465,3181,6646
10032,20200730,수인분당선,개포동,3555,3616,7171
10033,20200730,수인분당선,구룡,1655,1570,3225
10034,20200730,수인분당선,도곡,6558,6508,13066
10035,20200730,수인분당선,한티,13193,14013,27206
10036,20200730,수인분당선,선릉,13226,20889,34115
10037,20200731,수인분당선,인천,1037,1732,2769
10038,20200731,수인분당선,신포,1659,1743,3402
10039,20200731,수인분당선,숭의,3460,3206,6666
10040,20200731,수인분당선,인하대,4970,4619,9589
10041,20200731,수인분당선,송도,2425,2145,4570
10042,20200731,수인분당선,연수,4367,4379,8746
10043,20200731,수인분당선,원인재,3960,4166,8126
10044,20200731,수인분당선,남동인더스파크,2008,2117,4125
10045,20200731,수인분당선,호구포,3311,3225,6536
10046,20200731,수인분당선,인천논현,5359,5702,11061
10047,20200731,수인분당선,소래포구,4728,4372,9100
10048,20200731,수인분당선,월곶,2197,2112,4309
10049,20200731,수인분당선,달월,82,55,137
10050,20200731,수인분당선,매교,2433,2464,4897
10051,20200731,수인분당선,수원시청,11103,13855,24958
10052,20200731,수인분당선,매탄권선,4637,4201,8838
10053,20200731,수인분당선,망포,14181,12645,26826
10054,20200731,수인분당선,영통,8521,8823,17344
10055,20200731,수인분당선,청명,4465,4005,8470
10056,20200731,수인분당선,상갈,5511,5029,10540
10057,20200731,수인분당선,기흥,9644,9004,18648
10058,20200731,수인분당선,신갈,4790,4671,9461
10059,20200731,수인분당선,구성,4932,5036,9968
10060,20200731,수인분당선,죽전,13982,14902,28884
10061,20200731,수인분당선,보정,2620,2166,4786
10062,20200731,수인분당선,이매,5748,5258,11006
10063,20200731,수인분당선,오리,12016,10095,22111
10064,20200731,수인분당선,미금,15970,16817,32787
10065,20200731,수인분당선,정자,16960,18327,35287
10066,20200731,수인분당선,수내,13085,12979,26064
10067,20200731,수인분당선,서현,26668,27776,54444
10068,20200731,수인분당선,야탑,26104,27399,53503
10069,20200731,수인분당선,모란,19910,20178,40088
10070,20200731,수인분당선,태평,13563,12844,26407
10071,20200731,수인분당선,가천대,6386,7016,13402
10072,20200731,수인분당선,선정릉,7946,8679,16625
10073,20200731,수인분당선,강남구청,9659,11085,20744
10074,20200731,수인분당선,압구정로데오,18144,22493,40637
10075,20200731,수인분당선,서울숲,9549,9589,19138
10076,20200731,수인분당선,수원,8368,5943,14311
10077,20200731,수인분당선,복정,1,0,1
10078,20200731,수인분당선,수서,14922,15885,30807
10079,20200731,수인분당선,대모산입구,3489,3082,6571
10080,20200731,수인분당선,개포동,3806,3967,7773
10081,20200731,수인분당선,구룡,1688,1620,3308
10082,20200731,수인분당선,도곡,6547,6533,13080
10083,20200731,수인분당선,한티,14042,14725,28767
10084,20200731,수인분당선,선릉,13032,20786,33818
10085,20200801,수인분당선,인천,732,1182,1914
10086,20200801,수인분당선,신포,971,1082,2053
10087,20200801,수인분당선,숭의,1982,1740,3722
10088,20200801,수인분당선,인하대,2734,2543,5277
10089,20200801,수인분당선,송도,1465,1421,2886
10090,20200801,수인분당선,연수,2794,2975,5769
10091,20200801,수인분당선,원인재,2670,2664,5334
10092,20200801,수인분당선,남동인더스파크,726,605,1331
10093,20200801,수인분당선,호구포,1768,1648,3416
10094,20200801,수인분당선,인천논현,3424,3500,6924
10095,20200801,수인분당선,소래포구,3356,3438,6794
10096,20200801,수인분당선,월곶,1562,1467,3029
10097,20200801,수인분당선,달월,45,40,85
10098,20200801,수인분당선,매교,1191,1270,2461
10099,20200801,수인분당선,수원시청,7683,9003,16686
10100,20200801,수인분당선,매탄권선,2529,2295,4824
10101,20200801,수인분당선,망포,7250,6451,13701
10102,20200801,수인분당선,영통,5352,5410,10762
10103,20200801,수인분당선,청명,2143,1985,4128
10104,20200801,수인분당선,상갈,3243,3069,6312
10105,20200801,수인분당선,기흥,5894,5470,11364
10106,20200801,수인분당선,신갈,2394,2278,4672
10107,20200801,수인분당선,구성,2734,2717,5451
10108,20200801,수인분당선,죽전,8520,9935,18455
10109,20200801,수인분당선,보정,1368,1190,2558
10110,20200801,수인분당선,이매,3292,3233,6525
10111,20200801,수인분당선,오리,6394,5375,11769
10112,20200801,수인분당선,미금,9483,9665,19148
10113,20200801,수인분당선,정자,9343,9553,18896
10114,20200801,수인분당선,수내,7382,6895,14277
10115,20200801,수인분당선,서현,16363,16472,32835
10116,20200801,수인분당선,야탑,14726,15788,30514
10117,20200801,수인분당선,모란,13314,13738,27052
10118,20200801,수인분당선,태평,9058,8505,17563
10119,20200801,수인분당선,가천대,3588,4063,7651
10120,20200801,수인분당선,선정릉,2905,2966,5871
10121,20200801,수인분당선,강남구청,4237,4911,9148
10122,20200801,수인분당선,압구정로데오,13148,15749,28897
10123,20200801,수인분당선,서울숲,4264,4190,8454
10124,20200801,수인분당선,수원,5700,3822,9522
10125,20200801,수인분당선,수서,8721,9334,18055
10126,20200801,수인분당선,대모산입구,1933,1692,3625
10127,20200801,수인분당선,개포동,2191,2091,4282
10128,20200801,수인분당선,구룡,864,800,1664
10129,20200801,수인분당선,도곡,3325,3036,6361
10130,20200801,수인분당선,한티,9241,9033,18274
10131,20200801,수인분당선,선릉,4459,6911,11370
10132,20200802,수인분당선,수원,3826,2511,6337
10133,20200802,수인분당선,선릉,2108,3262,5370
10134,20200802,수인분당선,한티,6106,6171,12277
10135,20200802,수인분당선,도곡,1980,1957,3937
10136,20200802,수인분당선,구룡,436,493,929
10137,20200802,수인분당선,개포동,1543,1578,3121
10138,20200802,수인분당선,대모산입구,1138,1030,2168
10139,20200802,수인분당선,수서,7333,6769,14102
10140,20200802,수인분당선,서울숲,2753,2818,5571
10141,20200802,수인분당선,압구정로데오,7504,8475,15979
10142,20200802,수인분당선,강남구청,2229,2640,4869
10143,20200802,수인분당선,선정릉,1754,1775,3529
10144,20200802,수인분당선,가천대,2519,3132,5651
10145,20200802,수인분당선,태평,6357,5817,12174
10146,20200802,수인분당선,모란,8530,8833,17363
10147,20200802,수인분당선,야탑,10597,10596,21193
10148,20200802,수인분당선,서현,10646,10940,21586
10149,20200802,수인분당선,수내,4713,4590,9303
10150,20200802,수인분당선,정자,5598,5836,11434
10151,20200802,수인분당선,미금,5711,6267,11978
10152,20200802,수인분당선,오리,4207,3759,7966
10153,20200802,수인분당선,이매,2257,2372,4629
10154,20200802,수인분당선,보정,804,717,1521
10155,20200802,수인분당선,죽전,6093,7034,13127
10156,20200802,수인분당선,구성,1798,1892,3690
10157,20200802,수인분당선,신갈,1521,1542,3063
10158,20200802,수인분당선,기흥,3729,3757,7486
10159,20200802,수인분당선,상갈,2215,2188,4403
10160,20200802,수인분당선,청명,1413,1513,2926
10161,20200802,수인분당선,영통,3496,3614,7110
10162,20200802,수인분당선,망포,4512,4904,9416
10163,20200802,수인분당선,매탄권선,1689,1658,3347
10164,20200802,수인분당선,수원시청,5147,4976,10123
10165,20200802,수인분당선,매교,785,791,1576
10166,20200802,수인분당선,달월,29,27,56
10167,20200802,수인분당선,월곶,1032,1003,2035
10168,20200802,수인분당선,소래포구,2479,2419,4898
10169,20200802,수인분당선,인천논현,2159,2231,4390
10170,20200802,수인분당선,호구포,1315,1380,2695
10171,20200802,수인분당선,남동인더스파크,539,565,1104
10172,20200802,수인분당선,원인재,1891,1988,3879
10173,20200802,수인분당선,연수,2043,2124,4167
10174,20200802,수인분당선,송도,1015,1027,2042
10175,20200802,수인분당선,인하대,1935,1826,3761
10176,20200802,수인분당선,숭의,1335,1295,2630
10177,20200802,수인분당선,신포,741,723,1464
10178,20200802,수인분당선,인천,719,977,1696
10179,20200803,수인분당선,인천논현,4408,4583,8991
10180,20200803,수인분당선,소래포구,3352,3210,6562
10181,20200803,수인분당선,월곶,1815,1700,3515
10182,20200803,수인분당선,달월,64,40,104
10183,20200803,수인분당선,매교,2224,2176,4400
10184,20200803,수인분당선,수원시청,9498,10259,19757
10185,20200803,수인분당선,매탄권선,3682,3612,7294
10186,20200803,수인분당선,망포,11061,10689,21750
10187,20200803,수인분당선,영통,6873,7175,14048
10188,20200803,수인분당선,청명,3732,3473,7205
10189,20200803,수인분당선,상갈,4553,4256,8809
10190,20200803,수인분당선,기흥,8190,7839,16029
10191,20200803,수인분당선,신갈,4057,4056,8113
10192,20200803,수인분당선,구성,4352,4438,8790
10193,20200803,수인분당선,죽전,11367,12651,24018
10194,20200803,수인분당선,보정,2237,1834,4071
10195,20200803,수인분당선,이매,5035,4719,9754
10196,20200803,수인분당선,오리,10361,8796,19157
10197,20200803,수인분당선,미금,14314,15089,29403
10198,20200803,수인분당선,정자,15534,16426,31960
10199,20200803,수인분당선,수내,11439,11502,22941
10200,20200803,수인분당선,서현,22730,23031,45761
10201,20200803,수인분당선,야탑,22497,23783,46280
10202,20200803,수인분당선,모란,16890,16752,33642
10203,20200803,수인분당선,태평,12049,11541,23590
10204,20200803,수인분당선,가천대,4819,5800,10619
10205,20200803,수인분당선,선정릉,7672,8189,15861
10206,20200803,수인분당선,강남구청,8495,9912,18407
10207,20200803,수인분당선,압구정로데오,14867,16717,31584
10208,20200803,수인분당선,서울숲,7733,7793,15526
10209,20200803,수인분당선,수원,6676,4490,11166
10210,20200803,수인분당선,수서,13134,13197,26331
10211,20200803,수인분당선,대모산입구,3030,2714,5744
10212,20200803,수인분당선,개포동,3115,3297,6412
10213,20200803,수인분당선,구룡,1537,1508,3045
10214,20200803,수인분당선,도곡,6100,6210,12310
10215,20200803,수인분당선,한티,12372,13396,25768
10216,20200803,수인분당선,선릉,11990,19052,31042
10217,20200803,수인분당선,호구포,2595,2675,5270
10218,20200803,수인분당선,남동인더스파크,1491,1576,3067
10219,20200803,수인분당선,원인재,3325,3457,6782
10220,20200803,수인분당선,연수,3561,3584,7145
10221,20200803,수인분당선,송도,1909,1749,3658
10222,20200803,수인분당선,인하대,3910,3664,7574
10223,20200803,수인분당선,숭의,2907,2707,5614
10224,20200803,수인분당선,신포,1245,1272,2517
10225,20200803,수인분당선,인천,779,1163,1942
10226,20200804,수인분당선,인천,843,1370,2213
10227,20200804,수인분당선,신포,1438,1496,2934
10228,20200804,수인분당선,숭의,3027,2950,5977
10229,20200804,수인분당선,인하대,4287,4021,8308
10230,20200804,수인분당선,송도,1979,1892,3871
10231,20200804,수인분당선,연수,3827,3874,7701
10232,20200804,수인분당선,원인재,3674,3700,7374
10233,20200804,수인분당선,남동인더스파크,1525,1688,3213
10234,20200804,수인분당선,호구포,2774,2850,5624
10235,20200804,수인분당선,인천논현,4738,4983,9721
10236,20200804,수인분당선,소래포구,3895,3657,7552
10237,20200804,수인분당선,월곶,1900,1776,3676
10238,20200804,수인분당선,달월,64,42,106
10239,20200804,수인분당선,매교,2294,2223,4517
10240,20200804,수인분당선,수원시청,9825,10784,20609
10241,20200804,수인분당선,매탄권선,3947,3769,7716
10242,20200804,수인분당선,망포,11788,11251,23039
10243,20200804,수인분당선,영통,7639,7680,15319
10244,20200804,수인분당선,청명,3950,3759,7709
10245,20200804,수인분당선,상갈,4831,4594,9425
10246,20200804,수인분당선,기흥,8521,8085,16606
10247,20200804,수인분당선,신갈,4423,4268,8691
10248,20200804,수인분당선,구성,4633,4713,9346
10249,20200804,수인분당선,죽전,12318,13624,25942
10250,20200804,수인분당선,보정,2431,2008,4439
10251,20200804,수인분당선,이매,5311,4882,10193
10252,20200804,수인분당선,오리,11115,9648,20763
10253,20200804,수인분당선,미금,15210,16105,31315
10254,20200804,수인분당선,정자,15988,17076,33064
10255,20200804,수인분당선,수내,12040,12057,24097
10256,20200804,수인분당선,서현,23976,24508,48484
10257,20200804,수인분당선,야탑,23737,24807,48544
10258,20200804,수인분당선,모란,21788,22162,43950
10259,20200804,수인분당선,태평,12831,12313,25144
10260,20200804,수인분당선,가천대,5158,6131,11289
10261,20200804,수인분당선,선정릉,7830,8467,16297
10262,20200804,수인분당선,강남구청,9050,10461,19511
10263,20200804,수인분당선,압구정로데오,16377,18773,35150
10264,20200804,수인분당선,서울숲,8422,8572,16994
10265,20200804,수인분당선,수원,7128,5051,12179
10266,20200804,수인분당선,복정,1,0,1
10267,20200804,수인분당선,수서,13161,13142,26303
10268,20200804,수인분당선,대모산입구,3193,2899,6092
10269,20200804,수인분당선,개포동,3220,3376,6596
10270,20200804,수인분당선,구룡,1686,1621,3307
10271,20200804,수인분당선,도곡,6285,6323,12608
10272,20200804,수인분당선,한티,13092,13840,26932
10273,20200804,수인분당선,선릉,12405,19558,31963
10274,20200805,수인분당선,선릉,12662,19981,32643
10275,20200805,수인분당선,한티,13138,14061,27199
10276,20200805,수인분당선,도곡,6255,6324,12579
10277,20200805,수인분당선,구룡,1652,1575,3227
10278,20200805,수인분당선,개포동,3406,3655,7061
10279,20200805,수인분당선,대모산입구,3166,2860,6026
10280,20200805,수인분당선,수서,13030,13298,26328
10281,20200805,수인분당선,수원,7230,5034,12264
10282,20200805,수인분당선,서울숲,8545,8554,17099
10283,20200805,수인분당선,압구정로데오,16269,18446,34715
10284,20200805,수인분당선,강남구청,9234,10535,19769
10285,20200805,수인분당선,선정릉,7709,8269,15978
10286,20200805,수인분당선,가천대,5046,6105,11151
10287,20200805,수인분당선,태평,12638,11960,24598
10288,20200805,수인분당선,모란,17932,17730,35662
10289,20200805,수인분당선,야탑,23732,24912,48644
10290,20200805,수인분당선,서현,23972,24461,48433
10291,20200805,수인분당선,수내,12019,12149,24168
10292,20200805,수인분당선,정자,16491,17502,33993
10293,20200805,수인분당선,미금,14931,15906,30837
10294,20200805,수인분당선,오리,10968,9493,20461
10295,20200805,수인분당선,이매,5198,4812,10010
10296,20200805,수인분당선,보정,2374,1912,4286
10297,20200805,수인분당선,죽전,12134,13506,25640
10298,20200805,수인분당선,구성,4443,4626,9069
10299,20200805,수인분당선,신갈,4412,4289,8701
10300,20200805,수인분당선,기흥,8728,8321,17049
10301,20200805,수인분당선,상갈,4891,4562,9453
10302,20200805,수인분당선,청명,3842,3675,7517
10303,20200805,수인분당선,영통,7496,7623,15119
10304,20200805,수인분당선,망포,11870,11363,23233
10305,20200805,수인분당선,매탄권선,4089,3882,7971
10306,20200805,수인분당선,수원시청,9847,11117,20964
10307,20200805,수인분당선,매교,2263,2261,4524
10308,20200805,수인분당선,달월,67,43,110
10309,20200805,수인분당선,월곶,1908,1834,3742
10310,20200805,수인분당선,소래포구,3940,3637,7577
10311,20200805,수인분당선,인천논현,4829,5053,9882
10312,20200805,수인분당선,호구포,2731,2761,5492
10313,20200805,수인분당선,남동인더스파크,1669,1776,3445
10314,20200805,수인분당선,원인재,3594,3681,7275
10315,20200805,수인분당선,연수,3965,4030,7995
10316,20200805,수인분당선,송도,2083,1964,4047
10317,20200805,수인분당선,인하대,4333,4033,8366
10318,20200805,수인분당선,숭의,3169,2936,6105
10319,20200805,수인분당선,신포,1491,1577,3068
10320,20200805,수인분당선,인천,762,1218,1980
10321,20200806,수인분당선,망포,12098,11397,23495
10322,20200806,수인분당선,매탄권선,4041,3767,7808
10323,20200806,수인분당선,수원시청,9746,10901,20647
10324,20200806,수인분당선,매교,2372,2206,4578
10325,20200806,수인분당선,달월,61,41,102
10326,20200806,수인분당선,월곶,2016,1873,3889
10327,20200806,수인분당선,소래포구,3743,3486,7229
10328,20200806,수인분당선,인천논현,4847,5186,10033
10329,20200806,수인분당선,호구포,3020,3033,6053
10330,20200806,수인분당선,남동인더스파크,1869,2079,3948
10331,20200806,수인분당선,원인재,3689,3806,7495
10332,20200806,수인분당선,연수,3935,3919,7854
10333,20200806,수인분당선,송도,2146,1947,4093
10334,20200806,수인분당선,인하대,4504,4260,8764
10335,20200806,수인분당선,숭의,3094,2980,6074
10336,20200806,수인분당선,신포,1500,1533,3033
10337,20200806,수인분당선,인천,808,1332,2140
10338,20200806,수인분당선,영통,7516,7687,15203
10339,20200806,수인분당선,선릉,13200,21249,34449
10340,20200806,수인분당선,한티,13470,14482,27952
10341,20200806,수인분당선,도곡,6237,6217,12454
10342,20200806,수인분당선,구룡,1708,1564,3272
10343,20200806,수인분당선,개포동,3414,3556,6970
10344,20200806,수인분당선,대모산입구,3147,2804,5951
10345,20200806,수인분당선,수서,13468,13708,27176
10346,20200806,수인분당선,복정,1,0,1
10347,20200806,수인분당선,수원,6950,5017,11967
10348,20200806,수인분당선,서울숲,9209,8960,18169
10349,20200806,수인분당선,압구정로데오,17360,20411,37771
10350,20200806,수인분당선,강남구청,9369,10948,20317
10351,20200806,수인분당선,선정릉,7967,8650,16617
10352,20200806,수인분당선,가천대,5001,6016,11017
10353,20200806,수인분당선,태평,12677,12164,24841
10354,20200806,수인분당선,모란,17847,18011,35858
10355,20200806,수인분당선,야탑,24002,25139,49141
10356,20200806,수인분당선,서현,23534,24199,47733
10357,20200806,수인분당선,수내,12214,12288,24502
10358,20200806,수인분당선,정자,16116,17223,33339
10359,20200806,수인분당선,미금,14680,15606,30286
10360,20200806,수인분당선,오리,10984,9464,20448
10361,20200806,수인분당선,이매,5335,4797,10132
10362,20200806,수인분당선,보정,2304,1984,4288
10363,20200806,수인분당선,죽전,12190,13499,25689
10364,20200806,수인분당선,구성,4435,4525,8960
10365,20200806,수인분당선,신갈,4313,4184,8497
10366,20200806,수인분당선,기흥,8626,7891,16517
10367,20200806,수인분당선,상갈,4931,4442,9373
10368,20200806,수인분당선,청명,3923,3628,7551
10369,20200807,수인분당선,인천,893,1517,2410
10370,20200807,수인분당선,신포,1609,1724,3333
10371,20200807,수인분당선,숭의,3399,3154,6553
10372,20200807,수인분당선,인하대,5107,4662,9769
10373,20200807,수인분당선,송도,2315,2199,4514
10374,20200807,수인분당선,연수,4344,4488,8832
10375,20200807,수인분당선,원인재,4133,4239,8372
10376,20200807,수인분당선,남동인더스파크,1961,2171,4132
10377,20200807,수인분당선,호구포,3293,3320,6613
10378,20200807,수인분당선,인천논현,5555,5751,11306
10379,20200807,수인분당선,소래포구,4395,4091,8486
10380,20200807,수인분당선,월곶,2242,2114,4356
10381,20200807,수인분당선,달월,75,63,138
10382,20200807,수인분당선,매교,2291,2216,4507
10383,20200807,수인분당선,수원시청,10949,13512,24461
10384,20200807,수인분당선,매탄권선,4549,4098,8647
10385,20200807,수인분당선,망포,13670,12384,26054
10386,20200807,수인분당선,영통,8341,8528,16869
10387,20200807,수인분당선,청명,4310,3799,8109
10388,20200807,수인분당선,상갈,5377,4981,10358
10389,20200807,수인분당선,기흥,9412,8801,18213
10390,20200807,수인분당선,신갈,4651,4425,9076
10391,20200807,수인분당선,구성,4892,4916,9808
10392,20200807,수인분당선,죽전,13758,15081,28839
10393,20200807,수인분당선,보정,2505,2091,4596
10394,20200807,수인분당선,이매,5744,5174,10918
10395,20200807,수인분당선,오리,11844,10052,21896
10396,20200807,수인분당선,미금,15606,16470,32076
10397,20200807,수인분당선,정자,17307,18656,35963
10398,20200807,수인분당선,수내,13245,13135,26380
10399,20200807,수인분당선,서현,26266,26988,53254
10400,20200807,수인분당선,야탑,25915,27323,53238
10401,20200807,수인분당선,모란,19612,20312,39924
10402,20200807,수인분당선,태평,13541,12782,26323
10403,20200807,수인분당선,가천대,5451,6032,11483
10404,20200807,수인분당선,선정릉,7962,8672,16634
10405,20200807,수인분당선,강남구청,9911,11336,21247
10406,20200807,수인분당선,압구정로데오,18570,22975,41545
10407,20200807,수인분당선,서울숲,9681,9462,19143
10408,20200807,수인분당선,수원,8009,5740,13749
10409,20200807,수인분당선,복정,1,0,1
10410,20200807,수인분당선,수서,15007,15589,30596
10411,20200807,수인분당선,대모산입구,3410,3054,6464
10412,20200807,수인분당선,개포동,3835,3948,7783
10413,20200807,수인분당선,구룡,1742,1543,3285
10414,20200807,수인분당선,도곡,6391,6250,12641
10415,20200807,수인분당선,한티,14958,15741,30699
10416,20200807,수인분당선,선릉,13068,20815,33883
10417,20200808,수인분당선,선릉,5292,8510,13802
10418,20200808,수인분당선,한티,12110,11335,23445
10419,20200808,수인분당선,도곡,3911,3648,7559
10420,20200808,수인분당선,구룡,1076,1006,2082
10421,20200808,수인분당선,개포동,2350,2328,4678
10422,20200808,수인분당선,대모산입구,2329,2122,4451
10423,20200808,수인분당선,수서,9807,9964,19771
10424,20200808,수인분당선,수원,5789,4053,9842
10425,20200808,수인분당선,서울숲,5600,5476,11076
10426,20200808,수인분당선,압구정로데오,14644,17472,32116
10427,20200808,수인분당선,강남구청,4851,5676,10527
10428,20200808,수인분당선,선정릉,3489,3545,7034
10429,20200808,수인분당선,가천대,4618,5044,9662
10430,20200808,수인분당선,태평,9833,9311,19144
10431,20200808,수인분당선,모란,14735,14865,29600
10432,20200808,수인분당선,야탑,16032,16809,32841
10433,20200808,수인분당선,서현,17859,18234,36093
10434,20200808,수인분당선,수내,8201,7638,15839
10435,20200808,수인분당선,정자,10202,10425,20627
10436,20200808,수인분당선,미금,10321,10841,21162
10437,20200808,수인분당선,오리,7005,5933,12938
10438,20200808,수인분당선,이매,3871,3515,7386
10439,20200808,수인분당선,보정,1437,1282,2719
10440,20200808,수인분당선,죽전,9400,10649,20049
10441,20200808,수인분당선,구성,2902,2998,5900
10442,20200808,수인분당선,신갈,2703,2619,5322
10443,20200808,수인분당선,기흥,6049,5770,11819
10444,20200808,수인분당선,상갈,3388,3410,6798
10445,20200808,수인분당선,청명,2271,2196,4467
10446,20200808,수인분당선,영통,5994,5972,11966
10447,20200808,수인분당선,망포,8040,7245,15285
10448,20200808,수인분당선,매탄권선,2873,2658,5531
10449,20200808,수인분당선,수원시청,8559,9994,18553
10450,20200808,수인분당선,매교,1399,1369,2768
10451,20200808,수인분당선,달월,41,39,80
10452,20200808,수인분당선,월곶,1629,1542,3171
10453,20200808,수인분당선,소래포구,3512,3626,7138
10454,20200808,수인분당선,인천논현,3939,3994,7933
10455,20200808,수인분당선,호구포,2033,1886,3919
10456,20200808,수인분당선,남동인더스파크,915,852,1767
10457,20200808,수인분당선,원인재,2828,2974,5802
10458,20200808,수인분당선,연수,3194,3440,6634
10459,20200808,수인분당선,송도,1706,1668,3374
10460,20200808,수인분당선,인하대,3239,2893,6132
10461,20200808,수인분당선,숭의,2249,2081,4330
10462,20200808,수인분당선,신포,1117,1191,2308
10463,20200808,수인분당선,인천,786,1366,2152
10464,20200809,수인분당선,선릉,2309,3319,5628
10465,20200809,수인분당선,한티,8051,7603,15654
10466,20200809,수인분당선,도곡,1801,1774,3575
10467,20200809,수인분당선,구룡,444,521,965
10468,20200809,수인분당선,개포동,1654,1680,3334
10469,20200809,수인분당선,대모산입구,1294,1192,2486
10470,20200809,수인분당선,수서,7470,6955,14425
10471,20200809,수인분당선,수원,3796,2643,6439
10472,20200809,수인분당선,서울숲,2953,3147,6100
10473,20200809,수인분당선,압구정로데오,7097,7951,15048
10474,20200809,수인분당선,강남구청,2418,2834,5252
10475,20200809,수인분당선,선정릉,1781,1861,3642
10476,20200809,수인분당선,가천대,2470,3123,5593
10477,20200809,수인분당선,태평,6130,5758,11888
10478,20200809,수인분당선,모란,9834,10291,20125
10479,20200809,수인분당선,야탑,10271,10408,20679
10480,20200809,수인분당선,서현,10848,11066,21914
10481,20200809,수인분당선,수내,4849,4792,9641
10482,20200809,수인분당선,정자,6008,6165,12173
10483,20200809,수인분당선,미금,5850,6290,12140
10484,20200809,수인분당선,오리,4281,3733,8014
10485,20200809,수인분당선,이매,2221,2212,4433
10486,20200809,수인분당선,보정,825,740,1565
10487,20200809,수인분당선,죽전,5843,6955,12798
10488,20200809,수인분당선,구성,1794,1791,3585
10489,20200809,수인분당선,신갈,1483,1530,3013
10490,20200809,수인분당선,기흥,3860,3758,7618
10491,20200809,수인분당선,상갈,2088,2121,4209
10492,20200809,수인분당선,청명,1570,1558,3128
10493,20200809,수인분당선,영통,3562,3637,7199
10494,20200809,수인분당선,망포,4697,5032,9729
10495,20200809,수인분당선,매탄권선,1757,1775,3532
10496,20200809,수인분당선,수원시청,5294,5236,10530
10497,20200809,수인분당선,매교,803,789,1592
10498,20200809,수인분당선,달월,27,19,46
10499,20200809,수인분당선,월곶,985,929,1914
10500,20200809,수인분당선,소래포구,1941,1784,3725
10501,20200809,수인분당선,인천논현,1987,2148,4135
10502,20200809,수인분당선,호구포,1139,1213,2352
10503,20200809,수인분당선,남동인더스파크,413,476,889
10504,20200809,수인분당선,원인재,1755,1813,3568
10505,20200809,수인분당선,연수,1852,1925,3777
10506,20200809,수인분당선,송도,937,915,1852
10507,20200809,수인분당선,인하대,1687,1662,3349
10508,20200809,수인분당선,숭의,1153,1118,2271
10509,20200809,수인분당선,신포,533,566,1099
10510,20200809,수인분당선,인천,521,730,1251
10511,20200810,수인분당선,인천,792,1356,2148
10512,20200810,수인분당선,신포,1473,1542,3015
10513,20200810,수인분당선,숭의,3409,3135,6544
10514,20200810,수인분당선,인하대,4699,4401,9100
10515,20200810,수인분당선,송도,2134,1977,4111
10516,20200810,수인분당선,연수,3998,4018,8016
10517,20200810,수인분당선,원인재,3779,3933,7712
10518,20200810,수인분당선,남동인더스파크,2150,2392,4542
10519,20200810,수인분당선,호구포,3255,3321,6576
10520,20200810,수인분당선,인천논현,5078,5328,10406
10521,20200810,수인분당선,소래포구,3899,3661,7560
10522,20200810,수인분당선,월곶,2143,1979,4122
10523,20200810,수인분당선,달월,66,42,108
10524,20200810,수인분당선,매교,2402,2343,4745
10525,20200810,수인분당선,수원시청,10521,11405,21926
10526,20200810,수인분당선,매탄권선,4121,3980,8101
10527,20200810,수인분당선,망포,12548,12091,24639
10528,20200810,수인분당선,영통,7611,8005,15616
10529,20200810,수인분당선,청명,4050,3859,7909
10530,20200810,수인분당선,상갈,5158,4893,10051
10531,20200810,수인분당선,기흥,8922,8638,17560
10532,20200810,수인분당선,신갈,4424,4275,8699
10533,20200810,수인분당선,구성,4851,4892,9743
10534,20200810,수인분당선,죽전,11734,13220,24954
10535,20200810,수인분당선,보정,2427,2016,4443
10536,20200810,수인분당선,이매,5414,5030,10444
10537,20200810,수인분당선,오리,11551,9766,21317
10538,20200810,수인분당선,미금,15314,16578,31892
10539,20200810,수인분당선,정자,16370,17738,34108
10540,20200810,수인분당선,수내,12775,12814,25589
10541,20200810,수인분당선,서현,24226,24446,48672
10542,20200810,수인분당선,야탑,24770,25976,50746
10543,20200810,수인분당선,모란,18743,18792,37535
10544,20200810,수인분당선,태평,12904,12504,25408
10545,20200810,수인분당선,가천대,5916,6987,12903
10546,20200810,수인분당선,선정릉,8280,8732,17012
10547,20200810,수인분당선,강남구청,9336,10627,19963
10548,20200810,수인분당선,압구정로데오,15984,17685,33669
10549,20200810,수인분당선,서울숲,8617,8631,17248
10550,20200810,수인분당선,수원,7221,5217,12438
10551,20200810,수인분당선,수서,13538,13731,27269
10552,20200810,수인분당선,대모산입구,3325,3088,6413
10553,20200810,수인분당선,개포동,3504,3737,7241
10554,20200810,수인분당선,구룡,1618,1595,3213
10555,20200810,수인분당선,도곡,6495,6617,13112
10556,20200810,수인분당선,한티,13808,14681,28489
10557,20200810,수인분당선,선릉,13721,21203,34924
10558,20200811,수인분당선,인천,802,1341,2143
10559,20200811,수인분당선,신포,1509,1540,3049
10560,20200811,수인분당선,숭의,3355,3126,6481
10561,20200811,수인분당선,인하대,4739,4428,9167
10562,20200811,수인분당선,송도,2120,2028,4148
10563,20200811,수인분당선,연수,4036,4099,8135
10564,20200811,수인분당선,원인재,3829,3995,7824
10565,20200811,수인분당선,남동인더스파크,2218,2387,4605
10566,20200811,수인분당선,호구포,3293,3265,6558
10567,20200811,수인분당선,인천논현,5053,5364,10417
10568,20200811,수인분당선,소래포구,3895,3665,7560
10569,20200811,수인분당선,월곶,2073,1935,4008
10570,20200811,수인분당선,달월,70,41,111
10571,20200811,수인분당선,매교,2300,2305,4605
10572,20200811,수인분당선,수원시청,10602,11763,22365
10573,20200811,수인분당선,매탄권선,4246,4028,8274
10574,20200811,수인분당선,망포,12792,12176,24968
10575,20200811,수인분당선,영통,7741,8101,15842
10576,20200811,수인분당선,청명,4103,3868,7971
10577,20200811,수인분당선,상갈,5161,4802,9963
10578,20200811,수인분당선,기흥,9017,8432,17449
10579,20200811,수인분당선,신갈,4549,4382,8931
10580,20200811,수인분당선,구성,4776,4770,9546
10581,20200811,수인분당선,죽전,12832,14170,27002
10582,20200811,수인분당선,보정,2444,2069,4513
10583,20200811,수인분당선,이매,5799,4986,10785
10584,20200811,수인분당선,오리,11502,9903,21405
10585,20200811,수인분당선,미금,15445,16214,31659
10586,20200811,수인분당선,정자,16734,17805,34539
10587,20200811,수인분당선,수내,12744,12768,25512
10588,20200811,수인분당선,서현,24892,25637,50529
10589,20200811,수인분당선,야탑,24716,26079,50795
10590,20200811,수인분당선,모란,18284,18472,36756
10591,20200811,수인분당선,태평,12781,12237,25018
10592,20200811,수인분당선,가천대,5828,6890,12718
10593,20200811,수인분당선,선정릉,7962,8738,16700
10594,20200811,수인분당선,강남구청,9605,10825,20430
10595,20200811,수인분당선,압구정로데오,17032,19682,36714
10596,20200811,수인분당선,서울숲,8934,8947,17881
10597,20200811,수인분당선,수원,7156,5270,12426
10598,20200811,수인분당선,수서,13393,13586,26979
10599,20200811,수인분당선,대모산입구,3323,3015,6338
10600,20200811,수인분당선,개포동,3516,3565,7081
10601,20200811,수인분당선,구룡,1552,1512,3064
10602,20200811,수인분당선,도곡,6455,6404,12859
10603,20200811,수인분당선,한티,13733,14697,28430
10604,20200811,수인분당선,선릉,13403,21333,34736
10605,20200812,수인분당선,인천,926,1621,2547
10606,20200812,수인분당선,신포,1684,1716,3400
10607,20200812,수인분당선,숭의,3668,3393,7061
10608,20200812,수인분당선,인하대,5119,4738,9857
10609,20200812,수인분당선,송도,2401,2201,4602
10610,20200812,수인분당선,연수,4359,4440,8799
10611,20200812,수인분당선,원인재,4051,4075,8126
10612,20200812,수인분당선,남동인더스파크,2250,2410,4660
10613,20200812,수인분당선,호구포,3428,3486,6914
10614,20200812,수인분당선,인천논현,5428,5761,11189
10615,20200812,수인분당선,소래포구,4434,4148,8582
10616,20200812,수인분당선,월곶,2294,2159,4453
10617,20200812,수인분당선,달월,84,70,154
10618,20200812,수인분당선,매교,2474,2410,4884
10619,20200812,수인분당선,수원시청,11129,12167,23296
10620,20200812,수인분당선,매탄권선,4463,4076,8539
10621,20200812,수인분당선,망포,13227,12510,25737
10622,20200812,수인분당선,영통,8111,8437,16548
10623,20200812,수인분당선,청명,4109,3964,8073
10624,20200812,수인분당선,상갈,5400,5102,10502
10625,20200812,수인분당선,기흥,9456,8948,18404
10626,20200812,수인분당선,신갈,4699,4536,9235
10627,20200812,수인분당선,구성,4947,5087,10034
10628,20200812,수인분당선,죽전,13261,14620,27881
10629,20200812,수인분당선,보정,2506,2044,4550
10630,20200812,수인분당선,이매,5726,5305,11031
10631,20200812,수인분당선,오리,12071,10420,22491
10632,20200812,수인분당선,미금,16135,16921,33056
10633,20200812,수인분당선,정자,17092,18570,35662
10634,20200812,수인분당선,수내,13239,13166,26405
10635,20200812,수인분당선,서현,26412,26917,53329
10636,20200812,수인분당선,야탑,26098,27415,53513
10637,20200812,수인분당선,모란,19525,19795,39320
10638,20200812,수인분당선,태평,13521,12937,26458
10639,20200812,수인분당선,가천대,6168,7083,13251
10640,20200812,수인분당선,선정릉,8299,8970,17269
10641,20200812,수인분당선,강남구청,9877,11278,21155
10642,20200812,수인분당선,압구정로데오,17711,20491,38202
10643,20200812,수인분당선,서울숲,9694,9681,19375
10644,20200812,수인분당선,수원,7718,5450,13168
10645,20200812,수인분당선,수서,13845,14198,28043
10646,20200812,수인분당선,대모산입구,3451,3172,6623
10647,20200812,수인분당선,개포동,3638,3833,7471
10648,20200812,수인분당선,구룡,1715,1665,3380
10649,20200812,수인분당선,도곡,6702,6629,13331
10650,20200812,수인분당선,한티,14318,15240,29558
10651,20200812,수인분당선,선릉,13734,21182,34916
10652,20200813,수인분당선,선릉,13824,21035,34859
10653,20200813,수인분당선,한티,14067,14946,29013
10654,20200813,수인분당선,도곡,6556,6510,13066
10655,20200813,수인분당선,구룡,1724,1646,3370
10656,20200813,수인분당선,개포동,3474,3618,7092
10657,20200813,수인분당선,대모산입구,3384,3108,6492
10658,20200813,수인분당선,수서,13724,14600,28324
10659,20200813,수인분당선,복정,1,0,1
10660,20200813,수인분당선,수원,7436,5438,12874
10661,20200813,수인분당선,서울숲,9320,9213,18533
10662,20200813,수인분당선,압구정로데오,17725,20773,38498
10663,20200813,수인분당선,강남구청,9715,11221,20936
10664,20200813,수인분당선,선정릉,8023,8597,16620
10665,20200813,수인분당선,가천대,6156,7028,13184
10666,20200813,수인분당선,태평,13292,12623,25915
10667,20200813,수인분당선,모란,19457,19292,38749
10668,20200813,수인분당선,야탑,25521,26926,52447
10669,20200813,수인분당선,서현,25584,26245,51829
10670,20200813,수인분당선,수내,12844,12859,25703
10671,20200813,수인분당선,정자,17090,18130,35220
10672,20200813,수인분당선,미금,15620,16691,32311
10673,20200813,수인분당선,오리,11618,9894,21512
10674,20200813,수인분당선,이매,5618,5103,10721
10675,20200813,수인분당선,보정,2398,1977,4375
10676,20200813,수인분당선,죽전,12906,14017,26923
10677,20200813,수인분당선,구성,4727,4848,9575
10678,20200813,수인분당선,신갈,4597,4502,9099
10679,20200813,수인분당선,기흥,9287,8786,18073
10680,20200813,수인분당선,상갈,5250,4966,10216
10681,20200813,수인분당선,청명,4101,3845,7946
10682,20200813,수인분당선,영통,8021,8292,16313
10683,20200813,수인분당선,망포,13185,12384,25569
10684,20200813,수인분당선,매탄권선,4379,4197,8576
10685,20200813,수인분당선,수원시청,10972,12121,23093
10686,20200813,수인분당선,매교,2375,2396,4771
10687,20200813,수인분당선,달월,78,50,128
10688,20200813,수인분당선,월곶,2256,2084,4340
10689,20200813,수인분당선,소래포구,4412,4000,8412
10690,20200813,수인분당선,인천논현,5368,5546,10914
10691,20200813,수인분당선,호구포,3353,3402,6755
10692,20200813,수인분당선,남동인더스파크,2085,2378,4463
10693,20200813,수인분당선,원인재,4067,4182,8249
10694,20200813,수인분당선,연수,4253,4359,8612
10695,20200813,수인분당선,송도,2336,2166,4502
10696,20200813,수인분당선,인하대,5040,4698,9738
10697,20200813,수인분당선,숭의,3512,3307,6819
10698,20200813,수인분당선,신포,1573,1653,3226
10699,20200813,수인분당선,인천,926,1583,2509
10700,20200814,수인분당선,선릉,12992,20046,33038
10701,20200814,수인분당선,한티,14539,15288,29827
10702,20200814,수인분당선,도곡,6318,6205,12523
10703,20200814,수인분당선,구룡,1749,1586,3335
10704,20200814,수인분당선,개포동,3646,3787,7433
10705,20200814,수인분당선,대모산입구,3459,3089,6548
10706,20200814,수인분당선,수서,14772,16054,30826
10707,20200814,수인분당선,복정,2,0,2
10708,20200814,수인분당선,수원,8065,6051,14116
10709,20200814,수인분당선,서울숲,9132,8948,18080
10710,20200814,수인분당선,압구정로데오,18048,22030,40078
10711,20200814,수인분당선,강남구청,9591,10921,20512
10712,20200814,수인분당선,선정릉,7729,8477,16206
10713,20200814,수인분당선,가천대,6209,6732,12941
10714,20200814,수인분당선,태평,13841,12834,26675
10715,20200814,수인분당선,모란,23914,24966,48880
10716,20200814,수인분당선,야탑,25876,27587,53463
10717,20200814,수인분당선,서현,26118,27021,53139
10718,20200814,수인분당선,수내,12752,12548,25300
10719,20200814,수인분당선,정자,16938,17987,34925
10720,20200814,수인분당선,미금,15613,16307,31920
10721,20200814,수인분당선,오리,11670,9695,21365
10722,20200814,수인분당선,이매,5784,5257,11041
10723,20200814,수인분당선,보정,2311,1854,4165
10724,20200814,수인분당선,죽전,13284,13968,27252
10725,20200814,수인분당선,구성,4625,4717,9342
10726,20200814,수인분당선,신갈,4525,4366,8891
10727,20200814,수인분당선,기흥,9314,8910,18224
10728,20200814,수인분당선,상갈,5362,4934,10296
10729,20200814,수인분당선,청명,4249,3900,8149
10730,20200814,수인분당선,영통,8627,8846,17473
10731,20200814,수인분당선,망포,13847,12541,26388
10732,20200814,수인분당선,매탄권선,4762,4210,8972
10733,20200814,수인분당선,수원시청,11273,14070,25343
10734,20200814,수인분당선,매교,2456,2460,4916
10735,20200814,수인분당선,달월,67,44,111
10736,20200814,수인분당선,월곶,2267,2080,4347
10737,20200814,수인분당선,소래포구,4240,3960,8200
10738,20200814,수인분당선,인천논현,5249,5645,10894
10739,20200814,수인분당선,호구포,3378,3374,6752
10740,20200814,수인분당선,남동인더스파크,2166,2382,4548
10741,20200814,수인분당선,원인재,4179,4122,8301
10742,20200814,수인분당선,연수,4321,4360,8681
10743,20200814,수인분당선,송도,2313,2104,4417
10744,20200814,수인분당선,인하대,4951,4631,9582
10745,20200814,수인분당선,숭의,3486,3146,6632
10746,20200814,수인분당선,신포,1566,1686,3252
10747,20200814,수인분당선,인천,884,1591,2475
10748,20200815,수인분당선,인천,805,1399,2204
10749,20200815,수인분당선,신포,995,1033,2028
10750,20200815,수인분당선,숭의,1680,1528,3208
10751,20200815,수인분당선,인하대,2629,2521,5150
10752,20200815,수인분당선,송도,1412,1369,2781
10753,20200815,수인분당선,연수,2842,2938,5780
10754,20200815,수인분당선,원인재,2577,2569,5146
10755,20200815,수인분당선,남동인더스파크,757,671,1428
10756,20200815,수인분당선,호구포,1747,1579,3326
10757,20200815,수인분당선,인천논현,3140,3227,6367
10758,20200815,수인분당선,소래포구,3110,3207,6317
10759,20200815,수인분당선,월곶,1531,1472,3003
10760,20200815,수인분당선,달월,35,30,65
10761,20200815,수인분당선,매교,1093,1163,2256
10762,20200815,수인분당선,수원시청,7158,8375,15533
10763,20200815,수인분당선,매탄권선,2334,2155,4489
10764,20200815,수인분당선,망포,6703,5878,12581
10765,20200815,수인분당선,영통,4788,4706,9494
10766,20200815,수인분당선,청명,1985,1803,3788
10767,20200815,수인분당선,상갈,2871,2804,5675
10768,20200815,수인분당선,기흥,4875,4698,9573
10769,20200815,수인분당선,신갈,1988,1952,3940
10770,20200815,수인분당선,구성,2429,2361,4790
10771,20200815,수인분당선,죽전,7170,8148,15318
10772,20200815,수인분당선,보정,1170,998,2168
10773,20200815,수인분당선,이매,2918,2675,5593
10774,20200815,수인분당선,오리,5761,4762,10523
10775,20200815,수인분당선,미금,7748,7910,15658
10776,20200815,수인분당선,정자,8258,8244,16502
10777,20200815,수인분당선,수내,6381,5981,12362
10778,20200815,수인분당선,서현,13595,13852,27447
10779,20200815,수인분당선,야탑,12898,13809,26707
10780,20200815,수인분당선,모란,12001,12124,24125
10781,20200815,수인분당선,태평,8219,7358,15577
10782,20200815,수인분당선,가천대,3550,3920,7470
10783,20200815,수인분당선,압구정로데오,11319,13823,25142
10784,20200815,수인분당선,서울숲,4692,4858,9550
10785,20200815,수인분당선,수원,4972,3470,8442
10786,20200815,수인분당선,복정,4,0,4
10787,20200815,수인분당선,수서,7743,8853,16596
10788,20200815,수인분당선,대모산입구,1694,1437,3131
10789,20200815,수인분당선,개포동,1872,1853,3725
10790,20200815,수인분당선,구룡,1041,931,1972
10791,20200815,수인분당선,도곡,2995,2813,5808
10792,20200815,수인분당선,한티,9916,9071,18987
10793,20200815,수인분당선,선릉,3697,5792,9489
10794,20200815,수인분당선,선정릉,2844,2959,5803
10795,20200815,수인분당선,강남구청,3733,4479,8212
10796,20200816,수인분당선,인천,967,1469,2436
10797,20200816,수인분당선,신포,965,981,1946
10798,20200816,수인분당선,숭의,1614,1522,3136
10799,20200816,수인분당선,인하대,2311,2239,4550
10800,20200816,수인분당선,송도,1355,1274,2629
10801,20200816,수인분당선,연수,2599,2606,5205
10802,20200816,수인분당선,원인재,2261,2275,4536
10803,20200816,수인분당선,남동인더스파크,567,572,1139
10804,20200816,수인분당선,호구포,1625,1668,3293
10805,20200816,수인분당선,인천논현,2598,2688,5286
10806,20200816,수인분당선,소래포구,3472,3548,7020
10807,20200816,수인분당선,월곶,1392,1293,2685
10808,20200816,수인분당선,달월,33,33,66
10809,20200816,수인분당선,매교,939,989,1928
10810,20200816,수인분당선,수원시청,5843,6358,12201
10811,20200816,수인분당선,매탄권선,1966,1878,3844
10812,20200816,수인분당선,망포,5019,4929,9948
10813,20200816,수인분당선,영통,3923,3983,7906
10814,20200816,수인분당선,청명,1592,1545,3137
10815,20200816,수인분당선,상갈,2399,2414,4813
10816,20200816,수인분당선,기흥,4007,3943,7950
10817,20200816,수인분당선,신갈,1643,1631,3274
10818,20200816,수인분당선,구성,1850,1941,3791
10819,20200816,수인분당선,죽전,6484,7291,13775
10820,20200816,수인분당선,보정,847,760,1607
10821,20200816,수인분당선,이매,2565,2484,5049
10822,20200816,수인분당선,오리,4628,3979,8607
10823,20200816,수인분당선,미금,5896,6400,12296
10824,20200816,수인분당선,정자,6062,6503,12565
10825,20200816,수인분당선,수내,5104,4997,10101
10826,20200816,수인분당선,서현,10852,11444,22296
10827,20200816,수인분당선,야탑,10929,11168,22097
10828,20200816,수인분당선,모란,9756,10175,19931
10829,20200816,수인분당선,태평,6941,6408,13349
10830,20200816,수인분당선,가천대,2700,3243,5943
10831,20200816,수인분당선,선정릉,1908,1955,3863
10832,20200816,수인분당선,강남구청,2439,2897,5336
10833,20200816,수인분당선,압구정로데오,7890,9253,17143
10834,20200816,수인분당선,서울숲,4311,4264,8575
10835,20200816,수인분당선,수원,4324,2823,7147
10836,20200816,수인분당선,수서,7530,6941,14471
10837,20200816,수인분당선,대모산입구,1233,1155,2388
10838,20200816,수인분당선,개포동,1715,1735,3450
10839,20200816,수인분당선,구룡,583,545,1128
10840,20200816,수인분당선,도곡,2067,2102,4169
10841,20200816,수인분당선,한티,8089,7591,15680
10842,20200816,수인분당선,선릉,2320,3454,5774
10843,20200817,수인분당선,선릉,4329,6810,11139
10844,20200817,수인분당선,한티,8742,9105,17847
10845,20200817,수인분당선,도곡,3310,3284,6594
10846,20200817,수인분당선,구룡,851,930,1781
10847,20200817,수인분당선,개포동,1914,1924,3838
10848,20200817,수인분당선,대모산입구,1876,1697,3573
10849,20200817,수인분당선,수서,8692,7806,16498
10850,20200817,수인분당선,수원,5174,3575,8749
10851,20200817,수인분당선,서울숲,4792,4861,9653
10852,20200817,수인분당선,압구정로데오,10071,11401,21472
10853,20200817,수인분당선,강남구청,3583,4152,7735
10854,20200817,수인분당선,선정릉,2695,2836,5531
10855,20200817,수인분당선,가천대,3487,4211,7698
10856,20200817,수인분당선,태평,8844,8506,17350
10857,20200817,수인분당선,모란,12586,12916,25502
10858,20200817,수인분당선,야탑,14429,14833,29262
10859,20200817,수인분당선,서현,14251,14631,28882
10860,20200817,수인분당선,수내,6452,6457,12909
10861,20200817,수인분당선,정자,8014,8523,16537
10862,20200817,수인분당선,미금,8758,9485,18243
10863,20200817,수인분당선,오리,5867,5108,10975
10864,20200817,수인분당선,이매,2981,2761,5742
10865,20200817,수인분당선,보정,1115,1054,2169
10866,20200817,수인분당선,죽전,7417,8614,16031
10867,20200817,수인분당선,구성,2460,2629,5089
10868,20200817,수인분당선,신갈,2174,2123,4297
10869,20200817,수인분당선,기흥,5291,5128,10419
10870,20200817,수인분당선,상갈,2958,2956,5914
10871,20200817,수인분당선,청명,2022,1970,3992
10872,20200817,수인분당선,영통,4893,5056,9949
10873,20200817,수인분당선,망포,6551,6802,13353
10874,20200817,수인분당선,매탄권선,2366,2309,4675
10875,20200817,수인분당선,수원시청,7154,7358,14512
10876,20200817,수인분당선,매교,1300,1280,2580
10877,20200817,수인분당선,달월,32,36,68
10878,20200817,수인분당선,월곶,1678,1520,3198
10879,20200817,수인분당선,소래포구,3652,3421,7073
10880,20200817,수인분당선,인천논현,3853,3908,7761
10881,20200817,수인분당선,호구포,2107,2139,4246
10882,20200817,수인분당선,남동인더스파크,1211,1366,2577
10883,20200817,수인분당선,원인재,2685,2870,5555
10884,20200817,수인분당선,연수,3054,3118,6172
10885,20200817,수인분당선,송도,1533,1500,3033
10886,20200817,수인분당선,인하대,3241,3086,6327
10887,20200817,수인분당선,숭의,2107,1930,4037
10888,20200817,수인분당선,신포,1036,1054,2090
10889,20200817,수인분당선,인천,939,1492,2431
10890,20200818,수인분당선,인천,889,1574,2463
10891,20200818,수인분당선,신포,1451,1454,2905
10892,20200818,수인분당선,숭의,3447,3247,6694
10893,20200818,수인분당선,인하대,4640,4401,9041
10894,20200818,수인분당선,송도,2215,2042,4257
10895,20200818,수인분당선,연수,3976,4085,8061
10896,20200818,수인분당선,원인재,3744,3833,7577
10897,20200818,수인분당선,남동인더스파크,2229,2450,4679
10898,20200818,수인분당선,호구포,3216,3274,6490
10899,20200818,수인분당선,인천논현,4979,5237,10216
10900,20200818,수인분당선,소래포구,4033,3783,7816
10901,20200818,수인분당선,월곶,2130,2005,4135
10902,20200818,수인분당선,달월,68,51,119
10903,20200818,수인분당선,매교,1993,1954,3947
10904,20200818,수인분당선,수원시청,10038,10775,20813
10905,20200818,수인분당선,매탄권선,3841,3736,7577
10906,20200818,수인분당선,망포,11647,11280,22927
10907,20200818,수인분당선,영통,7166,7465,14631
10908,20200818,수인분당선,청명,3586,3492,7078
10909,20200818,수인분당선,상갈,4637,4395,9032
10910,20200818,수인분당선,기흥,8236,7909,16145
10911,20200818,수인분당선,신갈,4130,4068,8198
10912,20200818,수인분당선,구성,4221,4379,8600
10913,20200818,수인분당선,죽전,11450,12298,23748
10914,20200818,수인분당선,보정,2072,1680,3752
10915,20200818,수인분당선,이매,4731,4478,9209
10916,20200818,수인분당선,오리,10557,8983,19540
10917,20200818,수인분당선,미금,14319,15302,29621
10918,20200818,수인분당선,정자,14607,15674,30281
10919,20200818,수인분당선,수내,11557,11486,23043
10920,20200818,수인분당선,서현,22556,22775,45331
10921,20200818,수인분당선,야탑,22775,23802,46577
10922,20200818,수인분당선,모란,17999,18009,36008
10923,20200818,수인분당선,태평,12512,12252,24764
10924,20200818,수인분당선,가천대,5647,6757,12404
10925,20200818,수인분당선,선정릉,7611,8155,15766
10926,20200818,수인분당선,강남구청,8786,10060,18846
10927,20200818,수인분당선,압구정로데오,15695,17678,33373
10928,20200818,수인분당선,서울숲,8293,8427,16720
10929,20200818,수인분당선,수원,6886,4941,11827
10930,20200818,수인분당선,복정,1,0,1
10931,20200818,수인분당선,수서,13072,12696,25768
10932,20200818,수인분당선,대모산입구,3223,2922,6145
10933,20200818,수인분당선,개포동,3099,3305,6404
10934,20200818,수인분당선,구룡,1508,1505,3013
10935,20200818,수인분당선,도곡,5907,5977,11884
10936,20200818,수인분당선,한티,12993,14065,27058
10937,20200818,수인분당선,선릉,12700,19887,32587
10938,20200819,수인분당선,인천,860,1462,2322
10939,20200819,수인분당선,신포,1422,1397,2819
10940,20200819,수인분당선,숭의,3279,3120,6399
10941,20200819,수인분당선,인하대,4568,4320,8888
10942,20200819,수인분당선,송도,2151,2026,4177
10943,20200819,수인분당선,연수,3862,3954,7816
10944,20200819,수인분당선,원인재,3653,3721,7374
10945,20200819,수인분당선,남동인더스파크,2212,2429,4641
10946,20200819,수인분당선,호구포,3112,3156,6268
10947,20200819,수인분당선,인천논현,4886,5138,10024
10948,20200819,수인분당선,소래포구,3920,3701,7621
10949,20200819,수인분당선,월곶,2048,1867,3915
10950,20200819,수인분당선,달월,73,49,122
10951,20200819,수인분당선,매교,1911,1939,3850
10952,20200819,수인분당선,수원시청,9545,10511,20056
10953,20200819,수인분당선,매탄권선,3699,3558,7257
10954,20200819,수인분당선,망포,11158,10746,21904
10955,20200819,수인분당선,영통,6853,7139,13992
10956,20200819,수인분당선,청명,3471,3351,6822
10957,20200819,수인분당선,상갈,4431,4185,8616
10958,20200819,수인분당선,기흥,7898,7512,15410
10959,20200819,수인분당선,신갈,3827,3753,7580
10960,20200819,수인분당선,구성,3951,4161,8112
10961,20200819,수인분당선,죽전,10794,11907,22701
10962,20200819,수인분당선,보정,2017,1601,3618
10963,20200819,수인분당선,이매,4439,4155,8594
10964,20200819,수인분당선,오리,10308,8571,18879
10965,20200819,수인분당선,미금,13402,14480,27882
10966,20200819,수인분당선,정자,13721,14702,28423
10967,20200819,수인분당선,수내,11017,11113,22130
10968,20200819,수인분당선,서현,21152,21416,42568
10969,20200819,수인분당선,야탑,21967,23083,45050
10970,20200819,수인분당선,모란,20191,20421,40612
10971,20200819,수인분당선,태평,12264,11878,24142
10972,20200819,수인분당선,가천대,5894,6806,12700
10973,20200819,수인분당선,선정릉,7570,7975,15545
10974,20200819,수인분당선,강남구청,8596,9918,18514
10975,20200819,수인분당선,압구정로데오,15244,17036,32280
10976,20200819,수인분당선,서울숲,8302,8420,16722
10977,20200819,수인분당선,수원,6672,4723,11395
10978,20200819,수인분당선,수서,11917,12254,24171
10979,20200819,수인분당선,대모산입구,3086,2830,5916
10980,20200819,수인분당선,개포동,3088,3247,6335
10981,20200819,수인분당선,구룡,1447,1447,2894
10982,20200819,수인분당선,도곡,5665,5892,11557
10983,20200819,수인분당선,한티,12494,13431,25925
10984,20200819,수인분당선,선릉,12640,18800,31440
10985,20200819,수인분당선,복정,3,0,3
10986,20200820,수인분당선,수원시청,9485,10347,19832
10987,20200820,수인분당선,매탄권선,3581,3458,7039
10988,20200820,수인분당선,망포,10875,10420,21295
10989,20200820,수인분당선,영통,6713,6975,13688
10990,20200820,수인분당선,청명,3384,3219,6603
10991,20200820,수인분당선,인천,841,1415,2256
10992,20200820,수인분당선,신포,1358,1414,2772
10993,20200820,수인분당선,숭의,3249,3044,6293
10994,20200820,수인분당선,인하대,4586,4277,8863
10995,20200820,수인분당선,송도,2038,1867,3905
10996,20200820,수인분당선,연수,3775,3812,7587
10997,20200820,수인분당선,원인재,3595,3660,7255
10998,20200820,수인분당선,남동인더스파크,2178,2380,4558
10999,20200820,수인분당선,호구포,3040,3102,6142
11000,20200820,수인분당선,인천논현,4655,4934,9589
11001,20200820,수인분당선,소래포구,3830,3598,7428
11002,20200820,수인분당선,월곶,2020,1925,3945
11003,20200820,수인분당선,달월,70,52,122
11004,20200820,수인분당선,매교,1842,1879,3721
11005,20200820,수인분당선,상갈,4370,4120,8490
11006,20200820,수인분당선,기흥,7844,7464,15308
11007,20200820,수인분당선,신갈,3819,3690,7509
11008,20200820,수인분당선,구성,3887,3995,7882
11009,20200820,수인분당선,죽전,10544,11561,22105
11010,20200820,수인분당선,보정,1899,1550,3449
11011,20200820,수인분당선,이매,4344,4135,8479
11012,20200820,수인분당선,오리,9748,8189,17937
11013,20200820,수인분당선,미금,13160,13926,27086
11014,20200820,수인분당선,정자,13356,14206,27562
11015,20200820,수인분당선,수내,10743,10880,21623
11016,20200820,수인분당선,서현,20134,20503,40637
11017,20200820,수인분당선,야탑,21180,22265,43445
11018,20200820,수인분당선,모란,16798,16804,33602
11019,20200820,수인분당선,태평,11992,11630,23622
11020,20200820,수인분당선,가천대,5401,6340,11741
11021,20200820,수인분당선,선정릉,7103,7682,14785
11022,20200820,수인분당선,강남구청,8267,9496,17763
11023,20200820,수인분당선,압구정로데오,14747,16763,31510
11024,20200820,수인분당선,서울숲,8034,7965,15999
11025,20200820,수인분당선,수원,6302,4654,10956
11026,20200820,수인분당선,수서,11320,11717,23037
11027,20200820,수인분당선,대모산입구,2980,2689,5669
11028,20200820,수인분당선,개포동,2833,3043,5876
11029,20200820,수인분당선,구룡,1497,1444,2941
11030,20200820,수인분당선,도곡,5650,5671,11321
11031,20200820,수인분당선,한티,12060,12930,24990
11032,20200820,수인분당선,선릉,12102,18364,30466
11033,20200821,수인분당선,달월,73,47,120
11034,20200821,수인분당선,매교,1925,2006,3931
11035,20200821,수인분당선,수원시청,9707,11131,20838
11036,20200821,수인분당선,매탄권선,3796,3467,7263
11037,20200821,수인분당선,망포,11593,10646,22239
11038,20200821,수인분당선,영통,6860,7145,14005
11039,20200821,수인분당선,청명,3485,3300,6785
11040,20200821,수인분당선,상갈,4344,4107,8451
11041,20200821,수인분당선,기흥,7813,7451,15264
11042,20200821,수인분당선,신갈,3746,3669,7415
11043,20200821,수인분당선,구성,3776,4045,7821
11044,20200821,수인분당선,죽전,10934,11667,22601
11045,20200821,수인분당선,보정,1817,1503,3320
11046,20200821,수인분당선,이매,4234,3987,8221
11047,20200821,수인분당선,오리,9656,8097,17753
11048,20200821,수인분당선,미금,12914,13766,26680
11049,20200821,수인분당선,정자,13328,14234,27562
11050,20200821,수인분당선,수내,10765,10843,21608
11051,20200821,수인분당선,서현,20785,21354,42139
11052,20200821,수인분당선,야탑,21089,22423,43512
11053,20200821,수인분당선,모란,16989,17208,34197
11054,20200821,수인분당선,태평,11971,11453,23424
11055,20200821,수인분당선,가천대,5373,6047,11420
11056,20200821,수인분당선,선정릉,7094,7537,14631
11057,20200821,수인분당선,강남구청,8188,9369,17557
11058,20200821,수인분당선,압구정로데오,15087,17687,32774
11059,20200821,수인분당선,서울숲,7419,7351,14770
11060,20200821,수인분당선,수원,6675,4878,11553
11061,20200821,수인분당선,복정,1,0,1
11062,20200821,수인분당선,수서,11787,12964,24751
11063,20200821,수인분당선,대모산입구,2959,2666,5625
11064,20200821,수인분당선,개포동,2860,3036,5896
11065,20200821,수인분당선,구룡,1214,1198,2412
11066,20200821,수인분당선,도곡,5533,5531,11064
11067,20200821,수인분당선,한티,12510,13379,25889
11068,20200821,수인분당선,선릉,11556,17588,29144
11069,20200821,수인분당선,월곶,1975,1935,3910
11070,20200821,수인분당선,소래포구,3660,3530,7190
11071,20200821,수인분당선,인천논현,4432,4720,9152
11072,20200821,수인분당선,호구포,2808,2836,5644
11073,20200821,수인분당선,남동인더스파크,2089,2292,4381
11074,20200821,수인분당선,원인재,3525,3732,7257
11075,20200821,수인분당선,연수,3761,3827,7588
11076,20200821,수인분당선,송도,2042,1897,3939
11077,20200821,수인분당선,인하대,4518,4358,8876
11078,20200821,수인분당선,숭의,3184,2928,6112
11079,20200821,수인분당선,신포,1350,1405,2755
11080,20200821,수인분당선,인천,825,1325,2150
11081,20200822,수인분당선,인천,688,1088,1776
11082,20200822,수인분당선,신포,874,934,1808
11083,20200822,수인분당선,숭의,1840,1731,3571
11084,20200822,수인분당선,인하대,2564,2402,4966
11085,20200822,수인분당선,송도,1319,1272,2591
11086,20200822,수인분당선,연수,2670,2762,5432
11087,20200822,수인분당선,원인재,2361,2434,4795
11088,20200822,수인분당선,남동인더스파크,794,757,1551
11089,20200822,수인분당선,호구포,1616,1469,3085
11090,20200822,수인분당선,인천논현,2934,2960,5894
11091,20200822,수인분당선,소래포구,2772,2815,5587
11092,20200822,수인분당선,월곶,1353,1253,2606
11093,20200822,수인분당선,달월,36,42,78
11094,20200822,수인분당선,매교,1069,1104,2173
11095,20200822,수인분당선,수원시청,5787,6554,12341
11096,20200822,수인분당선,매탄권선,2087,1957,4044
11097,20200822,수인분당선,망포,5350,5035,10385
11098,20200822,수인분당선,영통,4192,4284,8476
11099,20200822,수인분당선,청명,1687,1613,3300
11100,20200822,수인분당선,상갈,2265,2279,4544
11101,20200822,수인분당선,기흥,4236,4166,8402
11102,20200822,수인분당선,신갈,1701,1643,3344
11103,20200822,수인분당선,구성,1950,2006,3956
11104,20200822,수인분당선,죽전,6084,7122,13206
11105,20200822,수인분당선,보정,956,832,1788
11106,20200822,수인분당선,이매,2314,2286,4600
11107,20200822,수인분당선,오리,4913,4109,9022
11108,20200822,수인분당선,미금,7120,7230,14350
11109,20200822,수인분당선,정자,6854,7039,13893
11110,20200822,수인분당선,수내,5819,5420,11239
11111,20200822,수인분당선,서현,11458,11756,23214
11112,20200822,수인분당선,야탑,10511,11282,21793
11113,20200822,수인분당선,모란,10918,11221,22139
11114,20200822,수인분당선,태평,7813,7356,15169
11115,20200822,수인분당선,가천대,3047,3497,6544
11116,20200822,수인분당선,선정릉,2511,2570,5081
11117,20200822,수인분당선,강남구청,3218,3874,7092
11118,20200822,수인분당선,압구정로데오,9764,11211,20975
11119,20200822,수인분당선,서울숲,3436,3475,6911
11120,20200822,수인분당선,수원,3987,2779,6766
11121,20200822,수인분당선,수서,5989,6605,12594
11122,20200822,수인분당선,대모산입구,1705,1537,3242
11123,20200822,수인분당선,개포동,1640,1667,3307
11124,20200822,수인분당선,구룡,679,681,1360
11125,20200822,수인분당선,도곡,2991,2794,5785
11126,20200822,수인분당선,한티,8396,8085,16481
11127,20200822,수인분당선,선릉,3672,5443,9115
11128,20200823,수인분당선,개포동,1089,1066,2155
11129,20200823,수인분당선,대모산입구,936,842,1778
11130,20200823,수인분당선,수서,5336,4779,10115
11131,20200823,수인분당선,수원,3164,1954,5118
11132,20200823,수인분당선,서울숲,2793,2778,5571
11133,20200823,수인분당선,압구정로데오,5626,6459,12085
11134,20200823,수인분당선,강남구청,1872,2222,4094
11135,20200823,수인분당선,선정릉,1509,1609,3118
11136,20200823,수인분당선,가천대,2237,2620,4857
11137,20200823,수인분당선,태평,5624,5205,10829
11138,20200823,수인분당선,모란,7523,7712,15235
11139,20200823,수인분당선,야탑,7472,7658,15130
11140,20200823,수인분당선,서현,8024,8320,16344
11141,20200823,수인분당선,수내,3878,3763,7641
11142,20200823,수인분당선,정자,4415,4628,9043
11143,20200823,수인분당선,미금,4299,4610,8909
11144,20200823,수인분당선,오리,3478,3094,6572
11145,20200823,수인분당선,이매,1541,1669,3210
11146,20200823,수인분당선,보정,573,554,1127
11147,20200823,수인분당선,죽전,4472,5135,9607
11148,20200823,수인분당선,구성,1248,1456,2704
11149,20200823,수인분당선,신갈,1120,1145,2265
11150,20200823,수인분당선,기흥,3026,2928,5954
11151,20200823,수인분당선,상갈,1672,1740,3412
11152,20200823,수인분당선,청명,1196,1149,2345
11153,20200823,수인분당선,영통,2672,2822,5494
11154,20200823,수인분당선,망포,3543,3723,7266
11155,20200823,수인분당선,매탄권선,1379,1332,2711
11156,20200823,수인분당선,수원시청,4140,4178,8318
11157,20200823,수인분당선,매교,696,701,1397
11158,20200823,수인분당선,달월,31,40,71
11159,20200823,수인분당선,월곶,1045,963,2008
11160,20200823,수인분당선,소래포구,2566,2473,5039
11161,20200823,수인분당선,인천논현,1711,1749,3460
11162,20200823,수인분당선,호구포,1021,1083,2104
11163,20200823,수인분당선,남동인더스파크,425,413,838
11164,20200823,수인분당선,원인재,1660,1760,3420
11165,20200823,수인분당선,연수,1932,1919,3851
11166,20200823,수인분당선,송도,889,908,1797
11167,20200823,수인분당선,인하대,1758,1671,3429
11168,20200823,수인분당선,숭의,1156,1164,2320
11169,20200823,수인분당선,신포,600,581,1181
11170,20200823,수인분당선,인천,612,829,1441
11171,20200823,수인분당선,구룡,394,419,813
11172,20200823,수인분당선,한티,5799,5692,11491
11173,20200823,수인분당선,선릉,1908,2746,4654
11174,20200823,수인분당선,도곡,1449,1402,2851
11175,20200824,수인분당선,한티,10458,11353,21811
11176,20200824,수인분당선,선릉,11512,17677,29189
11177,20200824,수인분당선,도곡,5591,5639,11230
11178,20200824,수인분당선,구룡,1231,1232,2463
11179,20200824,수인분당선,개포동,2846,2984,5830
11180,20200824,수인분당선,대모산입구,2971,2755,5726
11181,20200824,수인분당선,수서,10792,10955,21747
11182,20200824,수인분당선,수원,6082,4353,10435
11183,20200824,수인분당선,서울숲,7393,7502,14895
11184,20200824,수인분당선,압구정로데오,12781,14441,27222
11185,20200824,수인분당선,강남구청,7665,8755,16420
11186,20200824,수인분당선,선정릉,6839,7460,14299
11187,20200824,수인분당선,가천대,5170,6094,11264
11188,20200824,수인분당선,태평,11742,11504,23246
11189,20200824,수인분당선,모란,18423,18694,37117
11190,20200824,수인분당선,야탑,20245,21183,41428
11191,20200824,수인분당선,서현,19637,19820,39457
11192,20200824,수인분당선,수내,9681,9718,19399
11193,20200824,수인분당선,정자,12730,13555,26285
11194,20200824,수인분당선,미금,12386,13316,25702
11195,20200824,수인분당선,오리,9474,8007,17481
11196,20200824,수인분당선,이매,4229,3950,8179
11197,20200824,수인분당선,보정,1843,1519,3362
11198,20200824,수인분당선,죽전,10023,11009,21032
11199,20200824,수인분당선,구성,3751,3924,7675
11200,20200824,수인분당선,신갈,3573,3557,7130
11201,20200824,수인분당선,기흥,7318,7016,14334
11202,20200824,수인분당선,상갈,4101,3944,8045
11203,20200824,수인분당선,청명,3194,3083,6277
11204,20200824,수인분당선,영통,6229,6509,12738
11205,20200824,수인분당선,망포,10487,10145,20632
11206,20200824,수인분당선,매탄권선,3502,3297,6799
11207,20200824,수인분당선,수원시청,9127,9737,18864
11208,20200824,수인분당선,매교,1901,1920,3821
11209,20200824,수인분당선,달월,65,46,111
11210,20200824,수인분당선,월곶,1927,1834,3761
11211,20200824,수인분당선,소래포구,3483,3262,6745
11212,20200824,수인분당선,인천논현,4293,4512,8805
11213,20200824,수인분당선,호구포,2812,2932,5744
11214,20200824,수인분당선,남동인더스파크,2120,2314,4434
11215,20200824,수인분당선,원인재,3370,3535,6905
11216,20200824,수인분당선,연수,3625,3570,7195
11217,20200824,수인분당선,송도,1978,1811,3789
11218,20200824,수인분당선,인하대,4289,4159,8448
11219,20200824,수인분당선,숭의,3127,2970,6097
11220,20200824,수인분당선,신포,1281,1288,2569
11221,20200824,수인분당선,인천,767,1294,2061
11222,20200825,수인분당선,선릉,11486,17160,28646
11223,20200825,수인분당선,한티,11659,12598,24257
11224,20200825,수인분당선,도곡,5413,5572,10985
11225,20200825,수인분당선,구룡,1223,1223,2446
11226,20200825,수인분당선,개포동,2777,2946,5723
11227,20200825,수인분당선,대모산입구,2927,2779,5706
11228,20200825,수인분당선,수서,10267,10584,20851
11229,20200825,수인분당선,수원,6109,4330,10439
11230,20200825,수인분당선,서울숲,7507,7536,15043
11231,20200825,수인분당선,압구정로데오,14067,15671,29738
11232,20200825,수인분당선,강남구청,7892,9114,17006
11233,20200825,수인분당선,선정릉,7010,7442,14452
11234,20200825,수인분당선,가천대,5248,6138,11386
11235,20200825,수인분당선,태평,11780,11388,23168
11236,20200825,수인분당선,모란,16348,16390,32738
11237,20200825,수인분당선,야탑,20283,21109,41392
11238,20200825,수인분당선,서현,19070,19505,38575
11239,20200825,수인분당선,수내,10325,10462,20787
11240,20200825,수인분당선,정자,12809,13558,26367
11241,20200825,수인분당선,미금,12140,13229,25369
11242,20200825,수인분당선,오리,9539,7986,17525
11243,20200825,수인분당선,이매,4139,3935,8074
11244,20200825,수인분당선,보정,1854,1523,3377
11245,20200825,수인분당선,죽전,10041,11169,21210
11246,20200825,수인분당선,구성,3707,3875,7582
11247,20200825,수인분당선,신갈,3579,3534,7113
11248,20200825,수인분당선,기흥,7270,7085,14355
11249,20200825,수인분당선,상갈,4125,3867,7992
11250,20200825,수인분당선,청명,3230,3084,6314
11251,20200825,수인분당선,영통,6148,6396,12544
11252,20200825,수인분당선,망포,10471,10132,20603
11253,20200825,수인분당선,매탄권선,3439,3378,6817
11254,20200825,수인분당선,수원시청,9132,9820,18952
11255,20200825,수인분당선,매교,1816,1804,3620
11256,20200825,수인분당선,달월,70,49,119
11257,20200825,수인분당선,월곶,1952,1894,3846
11258,20200825,수인분당선,소래포구,3533,3231,6764
11259,20200825,수인분당선,인천논현,4316,4610,8926
11260,20200825,수인분당선,호구포,2854,2920,5774
11261,20200825,수인분당선,남동인더스파크,2113,2318,4431
11262,20200825,수인분당선,원인재,3451,3535,6986
11263,20200825,수인분당선,연수,3550,3578,7128
11264,20200825,수인분당선,송도,1905,1786,3691
11265,20200825,수인분당선,인하대,4350,4091,8441
11266,20200825,수인분당선,숭의,3071,2958,6029
11267,20200825,수인분당선,신포,1275,1287,2562
11268,20200825,수인분당선,인천,748,1249,1997
11269,20200826,수인분당선,선릉,11396,16939,28335
11270,20200826,수인분당선,한티,11309,12269,23578
11271,20200826,수인분당선,도곡,5177,5418,10595
11272,20200826,수인분당선,구룡,1201,1198,2399
11273,20200826,수인분당선,개포동,2687,2890,5577
11274,20200826,수인분당선,대모산입구,2845,2689,5534
11275,20200826,수인분당선,수서,10013,10337,20350
11276,20200826,수인분당선,수원,5948,4266,10214
11277,20200826,수인분당선,서울숲,7361,7421,14782
11278,20200826,수인분당선,압구정로데오,13090,14631,27721
11279,20200826,수인분당선,강남구청,7799,8813,16612
11280,20200826,수인분당선,선정릉,6937,7324,14261
11281,20200826,수인분당선,가천대,5227,6232,11459
11282,20200826,수인분당선,태평,11313,11146,22459
11283,20200826,수인분당선,모란,15758,15777,31535
11284,20200826,수인분당선,야탑,20013,20845,40858
11285,20200826,수인분당선,서현,18902,19117,38019
11286,20200826,수인분당선,수내,10115,10236,20351
11287,20200826,수인분당선,정자,12469,13189,25658
11288,20200826,수인분당선,미금,11994,12811,24805
11289,20200826,수인분당선,오리,9419,7896,17315
11290,20200826,수인분당선,이매,3938,3748,7686
11291,20200826,수인분당선,보정,1797,1514,3311
11292,20200826,수인분당선,죽전,9908,11057,20965
11293,20200826,수인분당선,구성,3641,3835,7476
11294,20200826,수인분당선,신갈,3407,3390,6797
11295,20200826,수인분당선,기흥,7134,6919,14053
11296,20200826,수인분당선,상갈,4042,3839,7881
11297,20200826,수인분당선,청명,3191,3142,6333
11298,20200826,수인분당선,영통,5996,6245,12241
11299,20200826,수인분당선,망포,10272,9911,20183
11300,20200826,수인분당선,매탄권선,3329,3291,6620
11301,20200826,수인분당선,수원시청,8841,9608,18449
11302,20200826,수인분당선,매교,1854,1808,3662
11303,20200826,수인분당선,달월,68,40,108
11304,20200826,수인분당선,월곶,1880,1796,3676
11305,20200826,수인분당선,소래포구,3354,3149,6503
11306,20200826,수인분당선,인천논현,4096,4424,8520
11307,20200826,수인분당선,호구포,2889,2901,5790
11308,20200826,수인분당선,남동인더스파크,2035,2288,4323
11309,20200826,수인분당선,원인재,3259,3369,6628
11310,20200826,수인분당선,연수,3479,3457,6936
11311,20200826,수인분당선,송도,1825,1695,3520
11312,20200826,수인분당선,인하대,4111,3902,8013
11313,20200826,수인분당선,숭의,2970,2847,5817
11314,20200826,수인분당선,신포,1233,1256,2489
11315,20200826,수인분당선,인천,740,1220,1960
11316,20200827,수인분당선,인천,624,987,1611
11317,20200827,수인분당선,신포,1126,1151,2277
11318,20200827,수인분당선,숭의,2779,2601,5380
11319,20200827,수인분당선,인하대,3779,3714,7493
11320,20200827,수인분당선,송도,1629,1552,3181
11321,20200827,수인분당선,연수,3129,3267,6396
11322,20200827,수인분당선,원인재,3002,3069,6071
11323,20200827,수인분당선,남동인더스파크,1925,2104,4029
11324,20200827,수인분당선,호구포,2730,2758,5488
11325,20200827,수인분당선,인천논현,3828,4038,7866
11326,20200827,수인분당선,소래포구,2863,2704,5567
11327,20200827,수인분당선,월곶,1660,1635,3295
11328,20200827,수인분당선,달월,69,44,113
11329,20200827,수인분당선,매교,1674,1699,3373
11330,20200827,수인분당선,수원시청,8089,8801,16890
11331,20200827,수인분당선,매탄권선,3136,3030,6166
11332,20200827,수인분당선,망포,9632,9287,18919
11333,20200827,수인분당선,영통,5664,5753,11417
11334,20200827,수인분당선,청명,3005,2835,5840
11335,20200827,수인분당선,상갈,3837,3594,7431
11336,20200827,수인분당선,기흥,6581,6334,12915
11337,20200827,수인분당선,신갈,3211,3107,6318
11338,20200827,수인분당선,구성,3407,3574,6981
11339,20200827,수인분당선,죽전,9250,10183,19433
11340,20200827,수인분당선,보정,1632,1348,2980
11341,20200827,수인분당선,이매,3847,3660,7507
11342,20200827,수인분당선,오리,8889,7432,16321
11343,20200827,수인분당선,미금,11254,11949,23203
11344,20200827,수인분당선,정자,11600,12447,24047
11345,20200827,수인분당선,수내,9341,9490,18831
11346,20200827,수인분당선,서현,17435,17674,35109
11347,20200827,수인분당선,야탑,18554,19496,38050
11348,20200827,수인분당선,모란,14682,14948,29630
11349,20200827,수인분당선,태평,10825,10435,21260
11350,20200827,수인분당선,가천대,4926,5865,10791
11351,20200827,수인분당선,선정릉,6352,6885,13237
11352,20200827,수인분당선,강남구청,7147,8277,15424
11353,20200827,수인분당선,압구정로데오,12238,13951,26189
11354,20200827,수인분당선,서울숲,6794,6868,13662
11355,20200827,수인분당선,수원,5628,3920,9548
11356,20200827,수인분당선,수서,9398,9663,19061
11357,20200827,수인분당선,대모산입구,2555,2339,4894
11358,20200827,수인분당선,개포동,2508,2685,5193
11359,20200827,수인분당선,구룡,1025,1045,2070
11360,20200827,수인분당선,도곡,4845,4926,9771
11361,20200827,수인분당선,한티,10665,11608,22273
11362,20200827,수인분당선,선릉,10823,16016,26839
11363,20200828,수인분당선,야탑,20055,21345,41400
11364,20200828,수인분당선,서현,19249,19659,38908
11365,20200828,수인분당선,수내,10365,10442,20807
11366,20200828,수인분당선,정자,12751,13548,26299
11367,20200828,수인분당선,미금,12167,13142,25309
11368,20200828,수인분당선,오리,9493,7988,17481
11369,20200828,수인분당선,이매,4066,3875,7941
11370,20200828,수인분당선,보정,1753,1545,3298
11371,20200828,수인분당선,죽전,10423,11235,21658
11372,20200828,수인분당선,구성,3666,3800,7466
11373,20200828,수인분당선,신갈,3493,3415,6908
11374,20200828,수인분당선,기흥,7331,7006,14337
11375,20200828,수인분당선,상갈,4066,3895,7961
11376,20200828,수인분당선,청명,3261,3000,6261
11377,20200828,수인분당선,영통,6395,6512,12907
11378,20200828,수인분당선,망포,10943,10053,20996
11379,20200828,수인분당선,매탄권선,3623,3366,6989
11380,20200828,수인분당선,수원시청,9003,10344,19347
11381,20200828,수인분당선,매교,1803,1864,3667
11382,20200828,수인분당선,달월,79,61,140
11383,20200828,수인분당선,월곶,1990,1860,3850
11384,20200828,수인분당선,소래포구,3365,3162,6527
11385,20200828,수인분당선,인천논현,4262,4564,8826
11386,20200828,수인분당선,호구포,2916,2937,5853
11387,20200828,수인분당선,남동인더스파크,2060,2219,4279
11388,20200828,수인분당선,원인재,3368,3349,6717
11389,20200828,수인분당선,인천,700,1182,1882
11390,20200828,수인분당선,신포,1247,1290,2537
11391,20200828,수인분당선,숭의,2982,2831,5813
11392,20200828,수인분당선,인하대,4259,4008,8267
11393,20200828,수인분당선,송도,1851,1650,3501
11394,20200828,수인분당선,연수,3443,3531,6974
11395,20200828,수인분당선,선릉,11232,16852,28084
11396,20200828,수인분당선,한티,11519,12418,23937
11397,20200828,수인분당선,도곡,5115,5102,10217
11398,20200828,수인분당선,구룡,1205,1178,2383
11399,20200828,수인분당선,개포동,2759,2972,5731
11400,20200828,수인분당선,대모산입구,2880,2644,5524
11401,20200828,수인분당선,수서,10939,11834,22773
11402,20200828,수인분당선,수원,6292,4559,10851
11403,20200828,수인분당선,서울숲,7257,7374,14631
11404,20200828,수인분당선,압구정로데오,13954,16311,30265
11405,20200828,수인분당선,강남구청,7783,8983,16766
11406,20200828,수인분당선,선정릉,6723,7103,13826
11407,20200828,수인분당선,가천대,5475,6220,11695
11408,20200828,수인분당선,태평,11494,11114,22608
11409,20200828,수인분당선,모란,16235,16293,32528
11410,20200829,수인분당선,선릉,3503,4961,8464
11411,20200829,수인분당선,한티,7418,7312,14730
11412,20200829,수인분당선,도곡,2553,2430,4983
11413,20200829,수인분당선,구룡,631,591,1222
11414,20200829,수인분당선,개포동,1504,1437,2941
11415,20200829,수인분당선,대모산입구,1665,1457,3122
11416,20200829,수인분당선,수서,5337,5796,11133
11417,20200829,수인분당선,수원,3674,2573,6247
11418,20200829,수인분당선,서울숲,3302,3264,6566
11419,20200829,수인분당선,압구정로데오,8950,10153,19103
11420,20200829,수인분당선,강남구청,3060,3600,6660
11421,20200829,수인분당선,선정릉,2197,2358,4555
11422,20200829,수인분당선,가천대,2961,3361,6322
11423,20200829,수인분당선,태평,7524,7036,14560
11424,20200829,수인분당선,모란,11930,12142,24072
11425,20200829,수인분당선,야탑,10085,10565,20650
11426,20200829,수인분당선,서현,10524,10759,21283
11427,20200829,수인분당선,수내,5343,5136,10479
11428,20200829,수인분당선,정자,6471,6665,13136
11429,20200829,수인분당선,미금,6705,6944,13649
11430,20200829,수인분당선,오리,4718,4144,8862
11431,20200829,수인분당선,이매,2404,2266,4670
11432,20200829,수인분당선,보정,889,742,1631
11433,20200829,수인분당선,죽전,5859,6728,12587
11434,20200829,수인분당선,구성,1807,1930,3737
11435,20200829,수인분당선,신갈,1542,1597,3139
11436,20200829,수인분당선,기흥,3901,3853,7754
11437,20200829,수인분당선,상갈,2164,2117,4281
11438,20200829,수인분당선,청명,1410,1372,2782
11439,20200829,수인분당선,영통,3508,3659,7167
11440,20200829,수인분당선,망포,4861,4420,9281
11441,20200829,수인분당선,매탄권선,1808,1652,3460
11442,20200829,수인분당선,수원시청,5283,5706,10989
11443,20200829,수인분당선,매교,982,964,1946
11444,20200829,수인분당선,달월,36,31,67
11445,20200829,수인분당선,월곶,1153,1171,2324
11446,20200829,수인분당선,소래포구,2468,2513,4981
11447,20200829,수인분당선,인천논현,2668,2757,5425
11448,20200829,수인분당선,호구포,1412,1405,2817
11449,20200829,수인분당선,남동인더스파크,732,674,1406
11450,20200829,수인분당선,원인재,2027,2156,4183
11451,20200829,수인분당선,연수,2371,2518,4889
11452,20200829,수인분당선,송도,1193,1124,2317
11453,20200829,수인분당선,인하대,2266,2089,4355
11454,20200829,수인분당선,숭의,1650,1557,3207
11455,20200829,수인분당선,신포,759,849,1608
11456,20200829,수인분당선,인천,579,897,1476
11457,20200830,수인분당선,선릉,1633,2392,4025
11458,20200830,수인분당선,한티,4962,4791,9753
11459,20200830,수인분당선,도곡,1279,1416,2695
11460,20200830,수인분당선,구룡,358,447,805
11461,20200830,수인분당선,개포동,933,903,1836
11462,20200830,수인분당선,대모산입구,1031,938,1969
11463,20200830,수인분당선,수서,4813,4180,8993
11464,20200830,수인분당선,수원,2604,1653,4257
11465,20200830,수인분당선,서울숲,2280,2249,4529
11466,20200830,수인분당선,압구정로데오,4851,5381,10232
11467,20200830,수인분당선,강남구청,1591,1825,3416
11468,20200830,수인분당선,선정릉,1314,1377,2691
11469,20200830,수인분당선,가천대,2068,2539,4607
11470,20200830,수인분당선,태평,4868,4708,9576
11471,20200830,수인분당선,모란,6477,6682,13159
11472,20200830,수인분당선,야탑,6773,7170,13943
11473,20200830,수인분당선,서현,6829,6926,13755
11474,20200830,수인분당선,수내,3401,3371,6772
11475,20200830,수인분당선,정자,4042,4200,8242
11476,20200830,수인분당선,미금,3784,4207,7991
11477,20200830,수인분당선,오리,3149,2800,5949
11478,20200830,수인분당선,이매,1561,1537,3098
11479,20200830,수인분당선,보정,540,513,1053
11480,20200830,수인분당선,죽전,4414,4914,9328
11481,20200830,수인분당선,구성,1187,1300,2487
11482,20200830,수인분당선,신갈,1022,1037,2059
11483,20200830,수인분당선,기흥,2765,2676,5441
11484,20200830,수인분당선,상갈,1509,1597,3106
11485,20200830,수인분당선,청명,1038,1077,2115
11486,20200830,수인분당선,영통,2341,2456,4797
11487,20200830,수인분당선,망포,2930,3311,6241
11488,20200830,수인분당선,매탄권선,1181,1135,2316
11489,20200830,수인분당선,수원시청,3387,3390,6777
11490,20200830,수인분당선,매교,652,660,1312
11491,20200830,수인분당선,달월,30,31,61
11492,20200830,수인분당선,월곶,919,894,1813
11493,20200830,수인분당선,소래포구,2257,2226,4483
11494,20200830,수인분당선,인천논현,1669,1721,3390
11495,20200830,수인분당선,호구포,972,1026,1998
11496,20200830,수인분당선,남동인더스파크,422,443,865
11497,20200830,수인분당선,원인재,1395,1459,2854
11498,20200830,수인분당선,연수,1754,1690,3444
11499,20200830,수인분당선,송도,859,840,1699
11500,20200830,수인분당선,인하대,1581,1548,3129
11501,20200830,수인분당선,숭의,1036,1031,2067
11502,20200830,수인분당선,신포,594,560,1154
11503,20200830,수인분당선,인천,436,618,1054
11504,20200831,수인분당선,선릉,10725,16057,26782
11505,20200831,수인분당선,한티,9381,10101,19482
11506,20200831,수인분당선,도곡,4990,5149,10139
11507,20200831,수인분당선,인천,739,1132,1871
11508,20200831,수인분당선,신포,1143,1167,2310
11509,20200831,수인분당선,숭의,2943,2807,5750
11510,20200831,수인분당선,인하대,3923,3710,7633
11511,20200831,수인분당선,송도,1797,1629,3426
11512,20200831,수인분당선,연수,3252,3150,6402
11513,20200831,수인분당선,원인재,3048,3262,6310
11514,20200831,수인분당선,남동인더스파크,2009,2257,4266
11515,20200831,수인분당선,호구포,2799,2886,5685
11516,20200831,수인분당선,인천논현,3894,4114,8008
11517,20200831,수인분당선,소래포구,3382,3132,6514
11518,20200831,수인분당선,월곶,1831,1748,3579
11519,20200831,수인분당선,달월,67,38,105
11520,20200831,수인분당선,매교,1906,1880,3786
11521,20200831,수인분당선,수원시청,7897,8464,16361
11522,20200831,수인분당선,매탄권선,3236,3060,6296
11523,20200831,수인분당선,망포,9643,9383,19026
11524,20200831,수인분당선,영통,5469,5736,11205
11525,20200831,수인분당선,청명,3126,2920,6046
11526,20200831,수인분당선,상갈,3843,3601,7444
11527,20200831,수인분당선,기흥,6836,6612,13448
11528,20200831,수인분당선,신갈,3313,3216,6529
11529,20200831,수인분당선,구성,3494,3724,7218
11530,20200831,수인분당선,죽전,9450,10294,19744
11531,20200831,수인분당선,보정,1714,1437,3151
11532,20200831,수인분당선,이매,3906,3575,7481
11533,20200831,수인분당선,오리,8788,7516,16304
11534,20200831,수인분당선,미금,11019,12025,23044
11535,20200831,수인분당선,정자,11385,11953,23338
11536,20200831,수인분당선,수내,9401,9535,18936
11537,20200831,수인분당선,서현,17470,17567,35037
11538,20200831,수인분당선,야탑,18619,19557,38176
11539,20200831,수인분당선,모란,15274,15458,30732
11540,20200831,수인분당선,태평,10871,10642,21513
11541,20200831,수인분당선,가천대,4952,5844,10796
11542,20200831,수인분당선,선정릉,6513,6882,13395
11543,20200831,수인분당선,강남구청,6913,8002,14915
11544,20200831,수인분당선,압구정로데오,11560,12642,24202
11545,20200831,수인분당선,서울숲,6923,7042,13965
11546,20200831,수인분당선,수원,5595,3951,9546
11547,20200831,수인분당선,수서,9780,9886,19666
11548,20200831,수인분당선,대모산입구,2821,2580,5401
11549,20200831,수인분당선,개포동,2497,2664,5161
11550,20200831,수인분당선,구룡,1251,1254,2505
11551,20200901,수인분당선,선릉,10414,15388,25802
11552,20200901,수인분당선,한티,9316,10051,19367
11553,20200901,수인분당선,도곡,4884,4941,9825
11554,20200901,수인분당선,구룡,1250,1273,2523
11555,20200901,수인분당선,개포동,2467,2644,5111
11556,20200901,수인분당선,대모산입구,2731,2573,5304
11557,20200901,수인분당선,수서,9235,9494,18729
11558,20200901,수인분당선,수원,5304,3760,9064
11559,20200901,수인분당선,서울숲,6570,6604,13174
11560,20200901,수인분당선,압구정로데오,12405,13386,25791
11561,20200901,수인분당선,강남구청,7004,8171,15175
11562,20200901,수인분당선,선정릉,6371,6713,13084
11563,20200901,수인분당선,가천대,4803,5745,10548
11564,20200901,수인분당선,태평,10641,10366,21007
11565,20200901,수인분당선,모란,15022,15100,30122
11566,20200901,수인분당선,야탑,18311,19119,37430
11567,20200901,수인분당선,서현,16908,17178,34086
11568,20200901,수인분당선,수내,9318,9307,18625
11569,20200901,수인분당선,정자,11186,11861,23047
11570,20200901,수인분당선,미금,10787,11613,22400
11571,20200901,수인분당선,오리,8657,7443,16100
11572,20200901,수인분당선,이매,3862,3587,7449
11573,20200901,수인분당선,보정,1728,1428,3156
11574,20200901,수인분당선,죽전,9175,10053,19228
11575,20200901,수인분당선,구성,3445,3639,7084
11576,20200901,수인분당선,신갈,3146,3105,6251
11577,20200901,수인분당선,기흥,6633,6366,12999
11578,20200901,수인분당선,상갈,3713,3552,7265
11579,20200901,수인분당선,청명,2993,2868,5861
11580,20200901,수인분당선,영통,5314,5474,10788
11581,20200901,수인분당선,망포,9406,9095,18501
11582,20200901,수인분당선,매탄권선,3159,3101,6260
11583,20200901,수인분당선,수원시청,7549,8050,15599
11584,20200901,수인분당선,매교,1817,1862,3679
11585,20200901,수인분당선,달월,77,53,130
11586,20200901,수인분당선,월곶,1750,1736,3486
11587,20200901,수인분당선,소래포구,3422,3287,6709
11588,20200901,수인분당선,인천논현,3827,4031,7858
11589,20200901,수인분당선,호구포,2833,2902,5735
11590,20200901,수인분당선,남동인더스파크,2059,2269,4328
11591,20200901,수인분당선,원인재,3080,3123,6203
11592,20200901,수인분당선,연수,3171,3262,6433
11593,20200901,수인분당선,송도,1841,1688,3529
11594,20200901,수인분당선,인하대,3958,3754,7712
11595,20200901,수인분당선,숭의,3023,2838,5861
11596,20200901,수인분당선,신포,1167,1203,2370
11597,20200901,수인분당선,인천,706,1105,1811
11598,20200902,수인분당선,선릉,10384,15036,25420
11599,20200902,수인분당선,한티,9086,9958,19044
11600,20200902,수인분당선,도곡,4736,4939,9675
11601,20200902,수인분당선,구룡,1156,1142,2298
11602,20200902,수인분당선,개포동,2384,2614,4998
11603,20200902,수인분당선,대모산입구,2562,2452,5014
11604,20200902,수인분당선,수서,8718,9120,17838
11605,20200902,수인분당선,복정,1,0,1
11606,20200902,수인분당선,수원,5085,3619,8704
11607,20200902,수인분당선,서울숲,6509,6545,13054
11608,20200902,수인분당선,압구정로데오,12004,12826,24830
11609,20200902,수인분당선,강남구청,6839,7957,14796
11610,20200902,수인분당선,선정릉,6374,6702,13076
11611,20200902,수인분당선,가천대,4716,5624,10340
11612,20200902,수인분당선,태평,10183,9866,20049
11613,20200902,수인분당선,모란,14111,14185,28296
11614,20200902,수인분당선,야탑,17861,18704,36565
11615,20200902,수인분당선,서현,16127,16456,32583
11616,20200902,수인분당선,수내,9067,9136,18203
11617,20200902,수인분당선,정자,10832,11462,22294
11618,20200902,수인분당선,미금,10422,11366,21788
11619,20200902,수인분당선,오리,8444,7054,15498
11620,20200902,수인분당선,이매,3726,3468,7194
11621,20200902,수인분당선,보정,1638,1358,2996
11622,20200902,수인분당선,죽전,8707,9572,18279
11623,20200902,수인분당선,구성,3265,3498,6763
11624,20200902,수인분당선,신갈,3055,3041,6096
11625,20200902,수인분당선,기흥,6451,6199,12650
11626,20200902,수인분당선,상갈,3579,3467,7046
11627,20200902,수인분당선,청명,2909,2845,5754
11628,20200902,수인분당선,영통,5124,5371,10495
11629,20200902,수인분당선,망포,9052,8804,17856
11630,20200902,수인분당선,매탄권선,3032,2947,5979
11631,20200902,수인분당선,수원시청,7187,7838,15025
11632,20200902,수인분당선,매교,1788,1763,3551
11633,20200902,수인분당선,달월,72,46,118
11634,20200902,수인분당선,월곶,1719,1635,3354
11635,20200902,수인분당선,소래포구,2959,2807,5766
11636,20200902,수인분당선,인천논현,3521,3799,7320
11637,20200902,수인분당선,호구포,2736,2813,5549
11638,20200902,수인분당선,남동인더스파크,1961,2183,4144
11639,20200902,수인분당선,원인재,2897,3089,5986
11640,20200902,수인분당선,연수,3085,3027,6112
11641,20200902,수인분당선,송도,1650,1506,3156
11642,20200902,수인분당선,인하대,3722,3515,7237
11643,20200902,수인분당선,숭의,2819,2621,5440
11644,20200902,수인분당선,신포,1064,1095,2159
11645,20200902,수인분당선,인천,609,980,1589
11646,20200903,수인분당선,인천,604,1074,1678
11647,20200903,수인분당선,신포,1152,1160,2312
11648,20200903,수인분당선,숭의,2758,2610,5368
11649,20200903,수인분당선,인하대,3706,3556,7262
11650,20200903,수인분당선,송도,1638,1536,3174
11651,20200903,수인분당선,연수,3057,3029,6086
11652,20200903,수인분당선,원인재,2930,2979,5909
11653,20200903,수인분당선,남동인더스파크,1913,2149,4062
11654,20200903,수인분당선,호구포,2640,2698,5338
11655,20200903,수인분당선,인천논현,3542,3634,7176
11656,20200903,수인분당선,소래포구,2941,2903,5844
11657,20200903,수인분당선,월곶,1676,1666,3342
11658,20200903,수인분당선,달월,62,43,105
11659,20200903,수인분당선,매교,1758,1774,3532
11660,20200903,수인분당선,수원시청,7242,7689,14931
11661,20200903,수인분당선,매탄권선,3128,3030,6158
11662,20200903,수인분당선,망포,9089,8806,17895
11663,20200903,수인분당선,영통,5115,5220,10335
11664,20200903,수인분당선,청명,2823,2690,5513
11665,20200903,수인분당선,상갈,3562,3398,6960
11666,20200903,수인분당선,기흥,6397,6065,12462
11667,20200903,수인분당선,신갈,2998,2930,5928
11668,20200903,수인분당선,구성,3302,3528,6830
11669,20200903,수인분당선,죽전,8918,9594,18512
11670,20200903,수인분당선,보정,1622,1350,2972
11671,20200903,수인분당선,이매,3645,3263,6908
11672,20200903,수인분당선,오리,8405,7280,15685
11673,20200903,수인분당선,미금,10331,11068,21399
11674,20200903,수인분당선,정자,10868,11335,22203
11675,20200903,수인분당선,수내,8841,8969,17810
11676,20200903,수인분당선,서현,16185,16401,32586
11677,20200903,수인분당선,야탑,17501,18471,35972
11678,20200903,수인분당선,모란,14214,14363,28577
11679,20200903,수인분당선,태평,10413,10009,20422
11680,20200903,수인분당선,가천대,4638,5621,10259
11681,20200903,수인분당선,선정릉,6023,6504,12527
11682,20200903,수인분당선,강남구청,6657,7681,14338
11683,20200903,수인분당선,압구정로데오,11891,13026,24917
11684,20200903,수인분당선,서울숲,6745,6836,13581
11685,20200903,수인분당선,수원,5058,3656,8714
11686,20200903,수인분당선,수서,8798,9234,18032
11687,20200903,수인분당선,대모산입구,2523,2278,4801
11688,20200903,수인분당선,개포동,2265,2388,4653
11689,20200903,수인분당선,구룡,1109,1106,2215
11690,20200903,수인분당선,도곡,4689,4703,9392
11691,20200903,수인분당선,한티,9122,9714,18836
11692,20200903,수인분당선,선릉,10038,15094,25132
11693,20200904,수인분당선,선릉,10390,15690,26080
11694,20200904,수인분당선,한티,10264,10965,21229
11695,20200904,수인분당선,도곡,4990,5018,10008
11696,20200904,수인분당선,구룡,1374,1307,2681
11697,20200904,수인분당선,개포동,2651,2817,5468
11698,20200904,수인분당선,대모산입구,2801,2581,5382
11699,20200904,수인분당선,수서,10687,11825,22512
11700,20200904,수인분당선,수원,5864,4338,10202
11701,20200904,수인분당선,서울숲,7695,7572,15267
11702,20200904,수인분당선,압구정로데오,13873,14966,28839
11703,20200904,수인분당선,강남구청,7149,8282,15431
11704,20200904,수인분당선,선정릉,6484,6825,13309
11705,20200904,수인분당선,가천대,5444,6135,11579
11706,20200904,수인분당선,태평,11242,11025,22267
11707,20200904,수인분당선,모란,19009,19194,38203
11708,20200904,수인분당선,야탑,19603,20490,40093
11709,20200904,수인분당선,서현,18460,18956,37416
11710,20200904,수인분당선,수내,10000,10040,20040
11711,20200904,수인분당선,정자,12005,12682,24687
11712,20200904,수인분당선,미금,11722,12506,24228
11713,20200904,수인분당선,오리,9286,7808,17094
11714,20200904,수인분당선,이매,4027,3855,7882
11715,20200904,수인분당선,보정,1789,1506,3295
11716,20200904,수인분당선,죽전,10417,11110,21527
11717,20200904,수인분당선,구성,3733,3968,7701
11718,20200904,수인분당선,신갈,3439,3409,6848
11719,20200904,수인분당선,기흥,7141,6966,14107
11720,20200904,수인분당선,상갈,3977,3860,7837
11721,20200904,수인분당선,청명,3264,2990,6254
11722,20200904,수인분당선,영통,5980,6135,12115
11723,20200904,수인분당선,망포,10485,9793,20278
11724,20200904,수인분당선,매탄권선,3549,3279,6828
11725,20200904,수인분당선,수원시청,8234,9138,17372
11726,20200904,수인분당선,매교,2014,1968,3982
11727,20200904,수인분당선,달월,74,55,129
11728,20200904,수인분당선,월곶,1845,1818,3663
11729,20200904,수인분당선,소래포구,3750,3564,7314
11730,20200904,수인분당선,인천논현,4030,4296,8326
11731,20200904,수인분당선,호구포,3022,2988,6010
11732,20200904,수인분당선,남동인더스파크,1997,2188,4185
11733,20200904,수인분당선,원인재,3264,3422,6686
11734,20200904,수인분당선,연수,3397,3405,6802
11735,20200904,수인분당선,송도,1968,1813,3781
11736,20200904,수인분당선,인하대,4262,4030,8292
11737,20200904,수인분당선,숭의,3189,2898,6087
11738,20200904,수인분당선,신포,1284,1381,2665
11739,20200904,수인분당선,인천,777,1320,2097
11740,20200905,수인분당선,남동인더스파크,712,707,1419
11741,20200905,수인분당선,선릉,3055,4610,7665
11742,20200905,수인분당선,한티,6144,6188,12332
11743,20200905,수인분당선,도곡,2623,2429,5052
11744,20200905,수인분당선,구룡,698,677,1375
11745,20200905,수인분당선,개포동,1553,1536,3089
11746,20200905,수인분당선,대모산입구,1760,1618,3378
11747,20200905,수인분당선,수서,5458,5747,11205
11748,20200905,수인분당선,복정,1,0,1
11749,20200905,수인분당선,수원,3770,2714,6484
11750,20200905,수인분당선,서울숲,4696,4753,9449
11751,20200905,수인분당선,압구정로데오,9437,10480,19917
11752,20200905,수인분당선,강남구청,3009,3609,6618
11753,20200905,수인분당선,선정릉,2187,2301,4488
11754,20200905,수인분당선,가천대,2991,3594,6585
11755,20200905,수인분당선,태평,7571,7144,14715
11756,20200905,수인분당선,모란,10802,10639,21441
11757,20200905,수인분당선,야탑,10319,11093,21412
11758,20200905,수인분당선,서현,10794,11039,21833
11759,20200905,수인분당선,수내,5167,4963,10130
11760,20200905,수인분당선,정자,6535,6698,13233
11761,20200905,수인분당선,미금,6720,7097,13817
11762,20200905,수인분당선,오리,4935,4115,9050
11763,20200905,수인분당선,이매,2197,2146,4343
11764,20200905,수인분당선,보정,979,871,1850
11765,20200905,수인분당선,죽전,6332,7197,13529
11766,20200905,수인분당선,구성,2065,2136,4201
11767,20200905,수인분당선,신갈,1675,1691,3366
11768,20200905,수인분당선,기흥,4201,4063,8264
11769,20200905,수인분당선,상갈,2285,2268,4553
11770,20200905,수인분당선,청명,1571,1486,3057
11771,20200905,수인분당선,영통,3650,3628,7278
11772,20200905,수인분당선,망포,5078,4755,9833
11773,20200905,수인분당선,매탄권선,1928,1809,3737
11774,20200905,수인분당선,수원시청,5320,5807,11127
11775,20200905,수인분당선,매교,1101,1161,2262
11776,20200905,수인분당선,달월,53,45,98
11777,20200905,수인분당선,월곶,1391,1386,2777
11778,20200905,수인분당선,소래포구,3379,3477,6856
11779,20200905,수인분당선,인천논현,2831,2902,5733
11780,20200905,수인분당선,호구포,1626,1561,3187
11781,20200905,수인분당선,원인재,2283,2416,4699
11782,20200905,수인분당선,연수,2444,2560,5004
11783,20200905,수인분당선,송도,1343,1314,2657
11784,20200905,수인분당선,인하대,2614,2437,5051
11785,20200905,수인분당선,숭의,1829,1703,3532
11786,20200905,수인분당선,신포,804,914,1718
11787,20200905,수인분당선,인천,689,1054,1743
11788,20200906,수인분당선,선릉,1438,2227,3665
11789,20200906,수인분당선,한티,3890,4075,7965
11790,20200906,수인분당선,도곡,1404,1496,2900
11791,20200906,수인분당선,구룡,395,443,838
11792,20200906,수인분당선,개포동,916,889,1805
11793,20200906,수인분당선,대모산입구,829,833,1662
11794,20200906,수인분당선,수서,4928,4264,9192
11795,20200906,수인분당선,수원,2786,1732,4518
11796,20200906,수인분당선,서울숲,2838,2810,5648
11797,20200906,수인분당선,압구정로데오,5285,5538,10823
11798,20200906,수인분당선,강남구청,1619,2008,3627
11799,20200906,수인분당선,선정릉,1252,1342,2594
11800,20200906,수인분당선,가천대,2061,2507,4568
11801,20200906,수인분당선,태평,5085,4837,9922
11802,20200906,수인분당선,모란,6766,6991,13757
11803,20200906,수인분당선,야탑,7093,7307,14400
11804,20200906,수인분당선,서현,7088,7074,14162
11805,20200906,수인분당선,수내,3350,3378,6728
11806,20200906,수인분당선,정자,3992,3993,7985
11807,20200906,수인분당선,미금,3924,4264,8188
11808,20200906,수인분당선,오리,3338,2923,6261
11809,20200906,수인분당선,이매,1453,1559,3012
11810,20200906,수인분당선,보정,513,509,1022
11811,20200906,수인분당선,죽전,4473,5054,9527
11812,20200906,수인분당선,구성,1223,1405,2628
11813,20200906,수인분당선,신갈,1086,1092,2178
11814,20200906,수인분당선,기흥,2771,2764,5535
11815,20200906,수인분당선,상갈,1555,1598,3153
11816,20200906,수인분당선,청명,1017,1048,2065
11817,20200906,수인분당선,영통,2417,2475,4892
11818,20200906,수인분당선,망포,3173,3284,6457
11819,20200906,수인분당선,매탄권선,1279,1277,2556
11820,20200906,수인분당선,수원시청,3487,3515,7002
11821,20200906,수인분당선,매교,708,640,1348
11822,20200906,수인분당선,달월,32,31,63
11823,20200906,수인분당선,월곶,1014,927,1941
11824,20200906,수인분당선,소래포구,2731,2653,5384
11825,20200906,수인분당선,인천논현,1722,1743,3465
11826,20200906,수인분당선,호구포,1041,1059,2100
11827,20200906,수인분당선,남동인더스파크,366,412,778
11828,20200906,수인분당선,원인재,1523,1598,3121
11829,20200906,수인분당선,연수,1802,1789,3591
11830,20200906,수인분당선,송도,904,886,1790
11831,20200906,수인분당선,인하대,1740,1638,3378
11832,20200906,수인분당선,숭의,1172,1096,2268
11833,20200906,수인분당선,신포,576,594,1170
11834,20200906,수인분당선,인천,510,729,1239
11835,20200907,수인분당선,청명,2911,2794,5705
11836,20200907,수인분당선,상갈,3575,3415,6990
11837,20200907,수인분당선,기흥,6524,6174,12698
11838,20200907,수인분당선,신갈,3045,2976,6021
11839,20200907,수인분당선,구성,3403,3497,6900
11840,20200907,수인분당선,죽전,8591,9508,18099
11841,20200907,수인분당선,보정,1623,1374,2997
11842,20200907,수인분당선,이매,3664,3480,7144
11843,20200907,수인분당선,오리,8360,7060,15420
11844,20200907,수인분당선,미금,10403,11172,21575
11845,20200907,수인분당선,정자,10945,11358,22303
11846,20200907,수인분당선,수내,8967,9080,18047
11847,20200907,수인분당선,서현,16533,16478,33011
11848,20200907,수인분당선,야탑,17720,18486,36206
11849,20200907,수인분당선,모란,14006,13998,28004
11850,20200907,수인분당선,태평,10231,10033,20264
11851,20200907,수인분당선,가천대,4655,5691,10346
11852,20200907,수인분당선,선정릉,6395,6774,13169
11853,20200907,수인분당선,강남구청,6768,7760,14528
11854,20200907,수인분당선,압구정로데오,11425,12210,23635
11855,20200907,수인분당선,서울숲,6526,6531,13057
11856,20200907,수인분당선,수원,4977,3672,8649
11857,20200907,수인분당선,수서,9231,9449,18680
11858,20200907,수인분당선,대모산입구,2531,2349,4880
11859,20200907,수인분당선,개포동,2326,2497,4823
11860,20200907,수인분당선,구룡,1096,1136,2232
11861,20200907,수인분당선,도곡,4974,5150,10124
11862,20200907,수인분당선,한티,9264,10120,19384
11863,20200907,수인분당선,선릉,10774,16086,26860
11864,20200907,수인분당선,인천,498,906,1404
11865,20200907,수인분당선,신포,965,918,1883
11866,20200907,수인분당선,숭의,2498,2374,4872
11867,20200907,수인분당선,인하대,3412,3189,6601
11868,20200907,수인분당선,송도,1423,1327,2750
11869,20200907,수인분당선,연수,2674,2687,5361
11870,20200907,수인분당선,원인재,2662,2741,5403
11871,20200907,수인분당선,남동인더스파크,1811,2094,3905
11872,20200907,수인분당선,호구포,2607,2740,5347
11873,20200907,수인분당선,인천논현,3290,3432,6722
11874,20200907,수인분당선,월곶,1550,1432,2982
11875,20200907,수인분당선,달월,69,41,110
11876,20200907,수인분당선,매교,1724,1756,3480
11877,20200907,수인분당선,수원시청,7143,7610,14753
11878,20200907,수인분당선,매탄권선,3028,2987,6015
11879,20200907,수인분당선,망포,9230,9049,18279
11880,20200907,수인분당선,영통,5130,5181,10311
11881,20200907,수인분당선,소래포구,2425,2345,4770
11882,20200908,수인분당선,호구포,2981,3070,6051
11883,20200908,수인분당선,인천논현,4090,4271,8361
11884,20200908,수인분당선,소래포구,3664,3501,7165
11885,20200908,수인분당선,월곶,1985,1834,3819
11886,20200908,수인분당선,달월,78,58,136
11887,20200908,수인분당선,매교,1874,1894,3768
11888,20200908,수인분당선,수원시청,8148,8563,16711
11889,20200908,수인분당선,매탄권선,3390,3305,6695
11890,20200908,수인분당선,망포,9950,9665,19615
11891,20200908,수인분당선,영통,5578,5692,11270
11892,20200908,수인분당선,청명,3198,2978,6176
11893,20200908,수인분당선,상갈,4033,3848,7881
11894,20200908,수인분당선,기흥,6997,6804,13801
11895,20200908,수인분당선,신갈,3457,3403,6860
11896,20200908,수인분당선,구성,3684,3963,7647
11897,20200908,수인분당선,죽전,9930,10845,20775
11898,20200908,수인분당선,보정,1849,1522,3371
11899,20200908,수인분당선,이매,4077,3833,7910
11900,20200908,수인분당선,오리,9406,7964,17370
11901,20200908,수인분당선,미금,11765,12558,24323
11902,20200908,수인분당선,정자,12024,12725,24749
11903,20200908,수인분당선,수내,9946,10074,20020
11904,20200908,수인분당선,서현,18256,18471,36727
11905,20200908,수인분당선,야탑,19548,20495,40043
11906,20200908,수인분당선,모란,16062,16043,32105
11907,20200908,수인분당선,태평,11145,10901,22046
11908,20200908,수인분당선,구룡,1326,1317,2643
11909,20200908,수인분당선,가천대,5187,6053,11240
11910,20200908,수인분당선,선정릉,6649,7118,13767
11911,20200908,수인분당선,강남구청,7454,8541,15995
11912,20200908,수인분당선,압구정로데오,13282,14460,27742
11913,20200908,수인분당선,서울숲,7608,7681,15289
11914,20200908,수인분당선,수원,5670,4040,9710
11915,20200908,수인분당선,수서,9973,10334,20307
11916,20200908,수인분당선,대모산입구,2933,2699,5632
11917,20200908,수인분당선,개포동,2609,2769,5378
11918,20200908,수인분당선,도곡,5224,5388,10612
11919,20200908,수인분당선,한티,10104,10776,20880
11920,20200908,수인분당선,선릉,11110,16685,27795
11921,20200908,수인분당선,인천,768,1260,2028
11922,20200908,수인분당선,신포,1334,1352,2686
11923,20200908,수인분당선,숭의,3209,3018,6227
11924,20200908,수인분당선,인하대,4156,3967,8123
11925,20200908,수인분당선,송도,2046,1813,3859
11926,20200908,수인분당선,연수,3401,3429,6830
11927,20200908,수인분당선,원인재,3386,3480,6866
11928,20200908,수인분당선,남동인더스파크,2022,2249,4271
11929,20200909,수인분당선,인천,728,1233,1961
11930,20200909,수인분당선,신포,1188,1204,2392
11931,20200909,수인분당선,숭의,3074,2928,6002
11932,20200909,수인분당선,인하대,4126,3926,8052
11933,20200909,수인분당선,송도,1937,1815,3752
11934,20200909,수인분당선,연수,3406,3392,6798
11935,20200909,수인분당선,원인재,3280,3432,6712
11936,20200909,수인분당선,남동인더스파크,1976,2238,4214
11937,20200909,수인분당선,호구포,2990,3029,6019
11938,20200909,수인분당선,인천논현,4059,4254,8313
11939,20200909,수인분당선,소래포구,3624,3470,7094
11940,20200909,수인분당선,월곶,1848,1731,3579
11941,20200909,수인분당선,달월,82,54,136
11942,20200909,수인분당선,매교,1848,1873,3721
11943,20200909,수인분당선,수원시청,7906,8405,16311
11944,20200909,수인분당선,매탄권선,3319,3161,6480
11945,20200909,수인분당선,망포,9786,9465,19251
11946,20200909,수인분당선,영통,5435,5699,11134
11947,20200909,수인분당선,청명,3127,2950,6077
11948,20200909,수인분당선,상갈,3880,3764,7644
11949,20200909,수인분당선,기흥,6932,6598,13530
11950,20200909,수인분당선,신갈,3202,3236,6438
11951,20200909,수인분당선,구성,3663,3926,7589
11952,20200909,수인분당선,죽전,9660,10526,20186
11953,20200909,수인분당선,보정,1837,1556,3393
11954,20200909,수인분당선,이매,3938,3795,7733
11955,20200909,수인분당선,오리,9234,7831,17065
11956,20200909,수인분당선,미금,11625,12513,24138
11957,20200909,수인분당선,정자,11915,12707,24622
11958,20200909,수인분당선,수내,9873,9914,19787
11959,20200909,수인분당선,서현,17960,18168,36128
11960,20200909,수인분당선,야탑,19536,20632,40168
11961,20200909,수인분당선,모란,18221,18527,36748
11962,20200909,수인분당선,태평,11192,10820,22012
11963,20200909,수인분당선,가천대,5212,6154,11366
11964,20200909,수인분당선,선정릉,6682,7175,13857
11965,20200909,수인분당선,강남구청,7442,8572,16014
11966,20200909,수인분당선,압구정로데오,12791,13927,26718
11967,20200909,수인분당선,서울숲,7200,7222,14422
11968,20200909,수인분당선,수원,5441,3952,9393
11969,20200909,수인분당선,복정,1,0,1
11970,20200909,수인분당선,수서,10094,10531,20625
11971,20200909,수인분당선,대모산입구,2859,2638,5497
11972,20200909,수인분당선,개포동,2593,2718,5311
11973,20200909,수인분당선,구룡,1301,1305,2606
11974,20200909,수인분당선,도곡,5123,5185,10308
11975,20200909,수인분당선,한티,10059,10853,20912
11976,20200909,수인분당선,선릉,11138,16328,27466
11977,20200910,수인분당선,복정,1,0,1
11978,20200910,수인분당선,선릉,11201,16444,27645
11979,20200910,수인분당선,한티,10145,10858,21003
11980,20200910,수인분당선,도곡,5295,5279,10574
11981,20200910,수인분당선,구룡,1318,1279,2597
11982,20200910,수인분당선,개포동,2629,2702,5331
11983,20200910,수인분당선,대모산입구,2872,2652,5524
11984,20200910,수인분당선,수서,10384,10779,21163
11985,20200910,수인분당선,수원,5743,4185,9928
11986,20200910,수인분당선,서울숲,7634,7755,15389
11987,20200910,수인분당선,압구정로데오,13440,14844,28284
11988,20200910,수인분당선,강남구청,7396,8505,15901
11989,20200910,수인분당선,선정릉,6617,7133,13750
11990,20200910,수인분당선,가천대,5310,6168,11478
11991,20200910,수인분당선,태평,11151,10795,21946
11992,20200910,수인분당선,모란,16126,15961,32087
11993,20200910,수인분당선,야탑,19555,20661,40216
11994,20200910,수인분당선,서현,17878,18280,36158
11995,20200910,수인분당선,수내,9921,9959,19880
11996,20200910,수인분당선,정자,12174,12670,24844
11997,20200910,수인분당선,미금,11674,12685,24359
11998,20200910,수인분당선,오리,9382,8091,17473
11999,20200910,수인분당선,이매,4016,3730,7746
12000,20200910,수인분당선,보정,1838,1574,3412
12001,20200910,수인분당선,죽전,10115,10965,21080
12002,20200910,수인분당선,구성,3716,3818,7534
12003,20200910,수인분당선,신갈,3392,3343,6735
12004,20200910,수인분당선,기흥,7185,6963,14148
12005,20200910,수인분당선,상갈,3990,3835,7825
12006,20200910,수인분당선,청명,3211,3081,6292
12007,20200910,수인분당선,영통,5657,5882,11539
12008,20200910,수인분당선,망포,10086,9719,19805
12009,20200910,수인분당선,매탄권선,3232,3227,6459
12010,20200910,수인분당선,수원시청,8281,8848,17129
12011,20200910,수인분당선,매교,1897,1935,3832
12012,20200910,수인분당선,달월,80,53,133
12013,20200910,수인분당선,월곶,1884,1834,3718
12014,20200910,수인분당선,소래포구,3901,3735,7636
12015,20200910,수인분당선,인천논현,4041,4289,8330
12016,20200910,수인분당선,호구포,2919,3042,5961
12017,20200910,수인분당선,남동인더스파크,1940,2257,4197
12018,20200910,수인분당선,원인재,3370,3523,6893
12019,20200910,수인분당선,연수,3387,3320,6707
12020,20200910,수인분당선,송도,2001,1869,3870
12021,20200910,수인분당선,인하대,4245,4040,8285
12022,20200910,수인분당선,숭의,3210,3048,6258
12023,20200910,수인분당선,신포,1324,1324,2648
12024,20200910,수인분당선,인천,832,1217,2049
12025,20200911,수인분당선,인천,781,1235,2016
12026,20200911,수인분당선,신포,1317,1385,2702
12027,20200911,수인분당선,숭의,3157,2893,6050
12028,20200911,수인분당선,인하대,4324,4043,8367
12029,20200911,수인분당선,송도,2054,1927,3981
12030,20200911,수인분당선,연수,3403,3403,6806
12031,20200911,수인분당선,원인재,3446,3590,7036
12032,20200911,수인분당선,남동인더스파크,2030,2229,4259
12033,20200911,수인분당선,호구포,2985,3036,6021
12034,20200911,수인분당선,인천논현,4238,4511,8749
12035,20200911,수인분당선,소래포구,3979,3868,7847
12036,20200911,수인분당선,월곶,1929,1869,3798
12037,20200911,수인분당선,달월,68,54,122
12038,20200911,수인분당선,매교,1954,2055,4009
12039,20200911,수인분당선,수원시청,8778,9626,18404
12040,20200911,수인분당선,매탄권선,3696,3419,7115
12041,20200911,수인분당선,망포,11069,10293,21362
12042,20200911,수인분당선,영통,6182,6537,12719
12043,20200911,수인분당선,청명,3393,3137,6530
12044,20200911,수인분당선,상갈,4177,3997,8174
12045,20200911,수인분당선,기흥,7457,7224,14681
12046,20200911,수인분당선,신갈,3471,3507,6978
12047,20200911,수인분당선,구성,3878,4036,7914
12048,20200911,수인분당선,죽전,10860,11682,22542
12049,20200911,수인분당선,보정,1782,1581,3363
12050,20200911,수인분당선,이매,4087,3899,7986
12051,20200911,수인분당선,오리,9777,8299,18076
12052,20200911,수인분당선,미금,12415,13204,25619
12053,20200911,수인분당선,정자,12721,13426,26147
12054,20200911,수인분당선,수내,10476,10489,20965
12055,20200911,수인분당선,서현,19369,19782,39151
12056,20200911,수인분당선,야탑,20497,21624,42121
12057,20200911,수인분당선,모란,16564,16518,33082
12058,20200911,수인분당선,태평,11559,11192,22751
12059,20200911,수인분당선,가천대,5562,6287,11849
12060,20200911,수인분당선,선정릉,6949,7224,14173
12061,20200911,수인분당선,강남구청,7791,8872,16663
12062,20200911,수인분당선,압구정로데오,14962,16034,30996
12063,20200911,수인분당선,서울숲,7744,7765,15509
12064,20200911,수인분당선,수원,6107,4463,10570
12065,20200911,수인분당선,수서,11461,12777,24238
12066,20200911,수인분당선,대모산입구,2892,2744,5636
12067,20200911,수인분당선,개포동,2724,2931,5655
12068,20200911,수인분당선,구룡,1435,1368,2803
12069,20200911,수인분당선,도곡,5410,5295,10705
12070,20200911,수인분당선,한티,10929,11595,22524
12071,20200911,수인분당선,선릉,11081,16340,27421
12072,20200912,수인분당선,인천,1218,1945,3163
12073,20200912,수인분당선,신포,1054,1095,2149
12074,20200912,수인분당선,숭의,2028,1911,3939
12075,20200912,수인분당선,인하대,2792,2611,5403
12076,20200912,수인분당선,송도,1573,1499,3072
12077,20200912,수인분당선,연수,2766,2788,5554
12078,20200912,수인분당선,원인재,2508,2707,5215
12079,20200912,수인분당선,남동인더스파크,853,800,1653
12080,20200912,수인분당선,호구포,1778,1716,3494
12081,20200912,수인분당선,인천논현,3025,3194,6219
12082,20200912,수인분당선,소래포구,5600,5651,11251
12083,20200912,수인분당선,월곶,1713,1622,3335
12084,20200912,수인분당선,달월,61,52,113
12085,20200912,수인분당선,사리,2985,3011,5996
12086,20200912,수인분당선,야목,448,444,892
12087,20200912,수인분당선,어천,592,612,1204
12088,20200912,수인분당선,오목천,1751,1697,3448
12089,20200912,수인분당선,고색,1809,1946,3755
12090,20200912,수인분당선,매교,1241,1370,2611
12091,20200912,수인분당선,수원시청,6164,6833,12997
12092,20200912,수인분당선,매탄권선,2216,2094,4310
12093,20200912,수인분당선,망포,5815,5458,11273
12094,20200912,수인분당선,영통,4012,4171,8183
12095,20200912,수인분당선,청명,1716,1587,3303
12096,20200912,수인분당선,상갈,2474,2421,4895
12097,20200912,수인분당선,기흥,4494,4322,8816
12098,20200912,수인분당선,신갈,1915,1856,3771
12099,20200912,수인분당선,구성,2081,2127,4208
12100,20200912,수인분당선,죽전,6822,7719,14541
12101,20200912,수인분당선,보정,1034,889,1923
12102,20200912,수인분당선,이매,2272,2195,4467
12103,20200912,수인분당선,오리,5097,4318,9415
12104,20200912,수인분당선,미금,7345,7517,14862
12105,20200912,수인분당선,정자,7055,7040,14095
12106,20200912,수인분당선,수내,5589,5428,11017
12107,20200912,수인분당선,서현,11829,11953,23782
12108,20200912,수인분당선,야탑,11054,11840,22894
12109,20200912,수인분당선,모란,11186,11163,22349
12110,20200912,수인분당선,태평,7750,7506,15256
12111,20200912,수인분당선,가천대,3429,3891,7320
12112,20200912,수인분당선,선정릉,2576,2600,5176
12113,20200912,수인분당선,강남구청,3268,3934,7202
12114,20200912,수인분당선,압구정로데오,10763,11574,22337
12115,20200912,수인분당선,서울숲,4138,4210,8348
12116,20200912,수인분당선,수원,5467,4379,9846
12117,20200912,수인분당선,복정,1,0,1
12118,20200912,수인분당선,수서,6032,6584,12616
12119,20200912,수인분당선,대모산입구,2022,1874,3896
12120,20200912,수인분당선,개포동,1667,1673,3340
12121,20200912,수인분당선,구룡,1410,1348,2758
12122,20200912,수인분당선,도곡,2907,2651,5558
12123,20200912,수인분당선,한티,6521,6557,13078
12124,20200912,수인분당선,선릉,3481,4978,8459
12125,20200913,수인분당선,가천대,2470,3072,5542
12126,20200913,수인분당선,강남구청,1898,2232,4130
12127,20200913,수인분당선,개포동,1067,1101,2168
12128,20200913,수인분당선,고색,1382,1397,2779
12129,20200913,수인분당선,구룡,414,479,893
12130,20200913,수인분당선,구성,1521,1674,3195
12131,20200913,수인분당선,기흥,3335,3315,6650
12132,20200913,수인분당선,남동인더스파크,445,455,900
12133,20200913,수인분당선,달월,62,62,124
12134,20200913,수인분당선,대모산입구,1177,1086,2263
12135,20200913,수인분당선,도곡,1628,1574,3202
12136,20200913,수인분당선,망포,3949,4163,8112
12137,20200913,수인분당선,매교,973,995,1968
12138,20200913,수인분당선,매탄권선,1604,1595,3199
12139,20200913,수인분당선,모란,7837,8104,15941
12140,20200913,수인분당선,미금,4516,4950,9466
12141,20200913,수인분당선,보정,684,670,1354
12142,20200913,수인분당선,사리,2480,2265,4745
12143,20200913,수인분당선,상갈,1837,1891,3728
12144,20200913,수인분당선,서울숲,4382,4475,8857
12145,20200913,수인분당선,서현,8599,8566,17165
12146,20200913,수인분당선,선릉,1711,2557,4268
12147,20200913,수인분당선,선정릉,1601,1666,3267
12148,20200913,수인분당선,소래포구,5834,5848,11682
12149,20200913,수인분당선,송도,1294,1222,2516
12150,20200913,수인분당선,수내,4009,3903,7912
12151,20200913,수인분당선,수서,5833,5007,10840
12152,20200913,수인분당선,수원,4732,3450,8182
12153,20200913,수인분당선,수원시청,4511,4623,9134
12154,20200913,수인분당선,숭의,1466,1403,2869
12155,20200913,수인분당선,신갈,1292,1260,2552
12156,20200913,수인분당선,신포,934,887,1821
12157,20200913,수인분당선,압구정로데오,6117,6785,12902
12158,20200913,수인분당선,야목,306,305,611
12159,20200913,수인분당선,야탑,8214,8477,16691
12160,20200913,수인분당선,어천,510,529,1039
12161,20200913,수인분당선,연수,2190,2192,4382
12162,20200913,수인분당선,영통,2946,3001,5947
12163,20200913,수인분당선,오리,3673,3343,7016
12164,20200913,수인분당선,오목천,1558,1462,3020
12165,20200913,수인분당선,원인재,2034,2096,4130
12166,20200913,수인분당선,월곶,1533,1293,2826
12167,20200913,수인분당선,이매,1783,1846,3629
12168,20200913,수인분당선,인천,1114,1765,2879
12169,20200913,수인분당선,인천논현,2028,2146,4174
12170,20200913,수인분당선,인하대,2294,2206,4500
12171,20200913,수인분당선,정자,4696,4998,9694
12172,20200913,수인분당선,죽전,5203,5887,11090
12173,20200913,수인분당선,청명,1304,1320,2624
12174,20200913,수인분당선,태평,5748,5343,11091
12175,20200913,수인분당선,한티,4290,4493,8783
12176,20200913,수인분당선,호구포,1342,1359,2701
12177,20200914,수인분당선,인천,987,1644,2631
12178,20200914,수인분당선,신포,1508,1506,3014
12179,20200914,수인분당선,숭의,3304,3140,6444
12180,20200914,수인분당선,인하대,4824,4517,9341
12181,20200914,수인분당선,송도,2184,1982,4166
12182,20200914,수인분당선,연수,3817,3805,7622
12183,20200914,수인분당선,원인재,3754,3969,7723
12184,20200914,수인분당선,남동인더스파크,2181,2389,4570
12185,20200914,수인분당선,호구포,3169,3317,6486
12186,20200914,수인분당선,인천논현,4685,4990,9675
12187,20200914,수인분당선,소래포구,5039,4894,9933
12188,20200914,수인분당선,월곶,2234,2103,4337
12189,20200914,수인분당선,달월,87,62,149
12190,20200914,수인분당선,사리,2496,2720,5216
12191,20200914,수인분당선,야목,239,218,457
12192,20200914,수인분당선,어천,372,352,724
12193,20200914,수인분당선,오목천,1561,1578,3139
12194,20200914,수인분당선,고색,1758,1876,3634
12195,20200914,수인분당선,매교,2305,2274,4579
12196,20200914,수인분당선,수원시청,9854,10676,20530
12197,20200914,수인분당선,매탄권선,3763,3551,7314
12198,20200914,수인분당선,망포,11295,10871,22166
12199,20200914,수인분당선,영통,6482,6715,13197
12200,20200914,수인분당선,청명,3507,3322,6829
12201,20200914,수인분당선,상갈,4450,4224,8674
12202,20200914,수인분당선,기흥,7779,7615,15394
12203,20200914,수인분당선,신갈,3834,3758,7592
12204,20200914,수인분당선,구성,4230,4242,8472
12205,20200914,수인분당선,죽전,10853,12003,22856
12206,20200914,수인분당선,보정,2068,1684,3752
12207,20200914,수인분당선,이매,4591,4284,8875
12208,20200914,수인분당선,오리,10414,8826,19240
12209,20200914,수인분당선,미금,13254,14255,27509
12210,20200914,수인분당선,정자,13171,14265,27436
12211,20200914,수인분당선,수내,10921,11026,21947
12212,20200914,수인분당선,서현,20033,20404,40437
12213,20200914,수인분당선,야탑,21433,22495,43928
12214,20200914,수인분당선,모란,20539,20850,41389
12215,20200914,수인분당선,태평,12073,11640,23713
12216,20200914,수인분당선,가천대,5967,6888,12855
12217,20200914,수인분당선,선정릉,7173,7776,14949
12218,20200914,수인분당선,강남구청,8115,9324,17439
12219,20200914,수인분당선,압구정로데오,13034,14642,27676
12220,20200914,수인분당선,서울숲,7741,7849,15590
12221,20200914,수인분당선,수원,7021,5393,12414
12222,20200914,수인분당선,수서,11241,11359,22600
12223,20200914,수인분당선,대모산입구,3233,2949,6182
12224,20200914,수인분당선,개포동,2889,2954,5843
12225,20200914,수인분당선,구룡,1406,1403,2809
12226,20200914,수인분당선,도곡,5677,5741,11418
12227,20200914,수인분당선,한티,11069,12012,23081
12228,20200914,수인분당선,선릉,11933,18293,30226
12229,20200915,수인분당선,연수,3924,3992,7916
12230,20200915,수인분당선,선릉,12354,18294,30648
12231,20200915,수인분당선,한티,11632,12357,23989
12232,20200915,수인분당선,도곡,5816,5840,11656
12233,20200915,수인분당선,구룡,1417,1404,2821
12234,20200915,수인분당선,개포동,2957,3015,5972
12235,20200915,수인분당선,대모산입구,3107,2855,5962
12236,20200915,수인분당선,수서,11214,11262,22476
12237,20200915,수인분당선,수원,7170,5463,12633
12238,20200915,수인분당선,서울숲,8159,8189,16348
12239,20200915,수인분당선,압구정로데오,14313,16186,30499
12240,20200915,수인분당선,강남구청,8408,9691,18099
12241,20200915,수인분당선,선정릉,7356,7882,15238
12242,20200915,수인분당선,가천대,5989,6899,12888
12243,20200915,수인분당선,태평,12185,11794,23979
12244,20200915,수인분당선,모란,17640,17700,35340
12245,20200915,수인분당선,야탑,22185,23156,45341
12246,20200915,수인분당선,서현,20262,20688,40950
12247,20200915,수인분당선,수내,11234,11304,22538
12248,20200915,수인분당선,정자,13446,14584,28030
12249,20200915,수인분당선,미금,13454,14747,28201
12250,20200915,수인분당선,오리,10493,8933,19426
12251,20200915,수인분당선,이매,4674,4314,8988
12252,20200915,수인분당선,보정,2030,1731,3761
12253,20200915,수인분당선,죽전,11289,12337,23626
12254,20200915,수인분당선,구성,4296,4431,8727
12255,20200915,수인분당선,신갈,3795,3769,7564
12256,20200915,수인분당선,기흥,8164,7776,15940
12257,20200915,수인분당선,상갈,4646,4362,9008
12258,20200915,수인분당선,청명,3584,3486,7070
12259,20200915,수인분당선,영통,6608,6948,13556
12260,20200915,수인분당선,망포,11741,11184,22925
12261,20200915,수인분당선,매탄권선,3969,3758,7727
12262,20200915,수인분당선,수원시청,10157,10872,21029
12263,20200915,수인분당선,매교,2280,2401,4681
12264,20200915,수인분당선,고색,1924,1998,3922
12265,20200915,수인분당선,오목천,1682,1685,3367
12266,20200915,수인분당선,어천,410,379,789
12267,20200915,수인분당선,야목,185,188,373
12268,20200915,수인분당선,사리,2587,2640,5227
12269,20200915,수인분당선,달월,81,61,142
12270,20200915,수인분당선,월곶,2322,2094,4416
12271,20200915,수인분당선,소래포구,5550,5385,10935
12272,20200915,수인분당선,인천논현,4735,4932,9667
12273,20200915,수인분당선,호구포,3112,3268,6380
12274,20200915,수인분당선,남동인더스파크,2278,2487,4765
12275,20200915,수인분당선,원인재,3809,4075,7884
12276,20200915,수인분당선,송도,2233,1960,4193
12277,20200915,수인분당선,인하대,4853,4649,9502
12278,20200915,수인분당선,숭의,3449,3204,6653
12279,20200915,수인분당선,신포,1533,1570,3103
12280,20200915,수인분당선,인천,990,1629,2619
12281,20200916,수인분당선,선릉,12131,18261,30392
12282,20200916,수인분당선,한티,11727,12483,24210
12283,20200916,수인분당선,도곡,5722,5804,11526
12284,20200916,수인분당선,구룡,1407,1367,2774
12285,20200916,수인분당선,개포동,2904,3142,6046
12286,20200916,수인분당선,대모산입구,3090,2821,5911
12287,20200916,수인분당선,수서,11067,11336,22403
12288,20200916,수인분당선,수원,6889,5404,12293
12289,20200916,수인분당선,서울숲,7820,7957,15777
12290,20200916,수인분당선,압구정로데오,14225,16176,30401
12291,20200916,수인분당선,강남구청,8410,9732,18142
12292,20200916,수인분당선,선정릉,7357,7873,15230
12293,20200916,수인분당선,가천대,6010,6826,12836
12294,20200916,수인분당선,태평,11984,11446,23430
12295,20200916,수인분당선,모란,17302,17391,34693
12296,20200916,수인분당선,야탑,21993,23160,45153
12297,20200916,수인분당선,서현,20428,20816,41244
12298,20200916,수인분당선,수내,11179,11264,22443
12299,20200916,수인분당선,정자,13699,13658,27357
12300,20200916,수인분당선,미금,13413,14287,27700
12301,20200916,수인분당선,오리,10403,8857,19260
12302,20200916,수인분당선,이매,5151,4461,9612
12303,20200916,수인분당선,보정,2078,1748,3826
12304,20200916,수인분당선,죽전,11156,12219,23375
12305,20200916,수인분당선,구성,4154,4374,8528
12306,20200916,수인분당선,신갈,3809,3711,7520
12307,20200916,수인분당선,기흥,8047,7695,15742
12308,20200916,수인분당선,상갈,4448,4274,8722
12309,20200916,수인분당선,청명,3651,3434,7085
12310,20200916,수인분당선,영통,6646,6806,13452
12311,20200916,수인분당선,망포,11546,11153,22699
12312,20200916,수인분당선,매탄권선,3965,3778,7743
12313,20200916,수인분당선,수원시청,10162,10965,21127
12314,20200916,수인분당선,매교,2245,2378,4623
12315,20200916,수인분당선,고색,2009,1994,4003
12316,20200916,수인분당선,오목천,1500,1443,2943
12317,20200916,수인분당선,어천,382,330,712
12318,20200916,수인분당선,야목,174,163,337
12319,20200916,수인분당선,사리,2514,2570,5084
12320,20200916,수인분당선,달월,84,55,139
12321,20200916,수인분당선,월곶,2125,1957,4082
12322,20200916,수인분당선,소래포구,5080,4982,10062
12323,20200916,수인분당선,인천논현,4710,4893,9603
12324,20200916,수인분당선,호구포,3157,3301,6458
12325,20200916,수인분당선,남동인더스파크,2246,2485,4731
12326,20200916,수인분당선,원인재,3853,4004,7857
12327,20200916,수인분당선,연수,3852,3888,7740
12328,20200916,수인분당선,송도,2183,2044,4227
12329,20200916,수인분당선,인하대,4735,4330,9065
12330,20200916,수인분당선,숭의,3436,3138,6574
12331,20200916,수인분당선,신포,1475,1523,2998
12332,20200916,수인분당선,인천,842,1440,2282
12333,20200917,수인분당선,인천,953,1591,2544
12334,20200917,수인분당선,신포,1574,1529,3103
12335,20200917,수인분당선,숭의,3528,3332,6860
12336,20200917,수인분당선,인하대,4908,4555,9463
12337,20200917,수인분당선,송도,2222,2015,4237
12338,20200917,수인분당선,연수,3910,3898,7808
12339,20200917,수인분당선,원인재,3999,4089,8088
12340,20200917,수인분당선,남동인더스파크,2222,2451,4673
12341,20200917,수인분당선,호구포,3217,3285,6502
12342,20200917,수인분당선,인천논현,4788,5013,9801
12343,20200917,수인분당선,소래포구,5639,5414,11053
12344,20200917,수인분당선,월곶,2197,2092,4289
12345,20200917,수인분당선,달월,97,60,157
12346,20200917,수인분당선,사리,2616,2670,5286
12347,20200917,수인분당선,야목,183,185,368
12348,20200917,수인분당선,어천,382,381,763
12349,20200917,수인분당선,오목천,1589,1535,3124
12350,20200917,수인분당선,고색,2033,1993,4026
12351,20200917,수인분당선,매교,2298,2414,4712
12352,20200917,수인분당선,수원시청,10164,11127,21291
12353,20200917,수인분당선,매탄권선,3989,3865,7854
12354,20200917,수인분당선,망포,11884,11213,23097
12355,20200917,수인분당선,영통,6656,6929,13585
12356,20200917,수인분당선,청명,3642,3486,7128
12357,20200917,수인분당선,상갈,4665,4403,9068
12358,20200917,수인분당선,기흥,7998,7724,15722
12359,20200917,수인분당선,신갈,3910,3861,7771
12360,20200917,수인분당선,구성,4336,4358,8694
12361,20200917,수인분당선,죽전,11195,12307,23502
12362,20200917,수인분당선,보정,2049,1761,3810
12363,20200917,수인분당선,이매,4678,4398,9076
12364,20200917,수인분당선,오리,10508,8800,19308
12365,20200917,수인분당선,미금,13501,14467,27968
12366,20200917,수인분당선,정자,13914,13594,27508
12367,20200917,수인분당선,수내,11190,11333,22523
12368,20200917,수인분당선,서현,20641,20934,41575
12369,20200917,수인분당선,야탑,21830,23003,44833
12370,20200917,수인분당선,모란,17487,17730,35217
12371,20200917,수인분당선,태평,12012,11594,23606
12372,20200917,수인분당선,가천대,6222,7110,13332
12373,20200917,수인분당선,선정릉,7243,7758,15001
12374,20200917,수인분당선,강남구청,8372,9859,18231
12375,20200917,수인분당선,압구정로데오,14693,16983,31676
12376,20200917,수인분당선,서울숲,8249,8342,16591
12377,20200917,수인분당선,수원,6985,5453,12438
12378,20200917,수인분당선,수서,11571,11781,23352
12379,20200917,수인분당선,대모산입구,3079,2871,5950
12380,20200917,수인분당선,개포동,2908,3007,5915
12381,20200917,수인분당선,구룡,1489,1477,2966
12382,20200917,수인분당선,도곡,5824,5809,11633
12383,20200917,수인분당선,한티,11799,12858,24657
12384,20200917,수인분당선,선릉,12231,18553,30784
12385,20200918,수인분당선,인천,1038,1694,2732
12386,20200918,수인분당선,신포,1609,1629,3238
12387,20200918,수인분당선,숭의,3653,3364,7017
12388,20200918,수인분당선,인하대,5210,4809,10019
12389,20200918,수인분당선,송도,2489,2191,4680
12390,20200918,수인분당선,연수,4178,4266,8444
12391,20200918,수인분당선,원인재,4179,4281,8460
12392,20200918,수인분당선,남동인더스파크,2406,2584,4990
12393,20200918,수인분당선,호구포,3290,3274,6564
12394,20200918,수인분당선,인천논현,5082,5503,10585
12395,20200918,수인분당선,소래포구,5789,5890,11679
12396,20200918,수인분당선,월곶,2328,2251,4579
12397,20200918,수인분당선,달월,113,78,191
12398,20200918,수인분당선,사리,2799,2789,5588
12399,20200918,수인분당선,야목,191,208,399
12400,20200918,수인분당선,어천,477,403,880
12401,20200918,수인분당선,오목천,1862,1730,3592
12402,20200918,수인분당선,고색,2312,2245,4557
12403,20200918,수인분당선,매교,2447,2553,5000
12404,20200918,수인분당선,수원시청,11177,13143,24320
12405,20200918,수인분당선,매탄권선,4401,4044,8445
12406,20200918,수인분당선,망포,13213,12033,25246
12407,20200918,수인분당선,영통,7685,7876,15561
12408,20200918,수인분당선,청명,3946,3570,7516
12409,20200918,수인분당선,상갈,4933,4584,9517
12410,20200918,수인분당선,기흥,8769,8287,17056
12411,20200918,수인분당선,신갈,4028,3937,7965
12412,20200918,수인분당선,구성,4450,4591,9041
12413,20200918,수인분당선,죽전,12570,13462,26032
12414,20200918,수인분당선,보정,2161,1822,3983
12415,20200918,수인분당선,이매,5020,4642,9662
12416,20200918,수인분당선,오리,11136,9369,20505
12417,20200918,수인분당선,미금,14281,15239,29520
12418,20200918,수인분당선,정자,14830,14456,29286
12419,20200918,수인분당선,수내,12032,12091,24123
12420,20200918,수인분당선,서현,22266,22906,45172
12421,20200918,수인분당선,야탑,23416,24905,48321
12422,20200918,수인분당선,모란,18633,18741,37374
12423,20200918,수인분당선,태평,12646,12082,24728
12424,20200918,수인분당선,가천대,6531,6899,13430
12425,20200918,수인분당선,선정릉,7603,8036,15639
12426,20200918,수인분당선,강남구청,8874,10248,19122
12427,20200918,수인분당선,압구정로데오,16233,19371,35604
12428,20200918,수인분당선,서울숲,8854,8992,17846
12429,20200918,수인분당선,수원,7916,6398,14314
12430,20200918,수인분당선,수서,12864,13731,26595
12431,20200918,수인분당선,대모산입구,3230,2975,6205
12432,20200918,수인분당선,개포동,3173,3339,6512
12433,20200918,수인분당선,구룡,1664,1517,3181
12434,20200918,수인분당선,도곡,5974,5990,11964
12435,20200918,수인분당선,한티,12830,13823,26653
12436,20200918,수인분당선,선릉,12437,18622,31059
12437,20200919,수인분당선,매교,1610,1652,3262
12438,20200919,수인분당선,고색,1556,1595,3151
12439,20200919,수인분당선,오목천,1548,1401,2949
12440,20200919,수인분당선,인천,1213,1876,3089
12441,20200919,수인분당선,신포,1186,1251,2437
12442,20200919,수인분당선,숭의,2362,2243,4605
12443,20200919,수인분당선,인하대,3733,3365,7098
12444,20200919,수인분당선,송도,1883,1783,3666
12445,20200919,수인분당선,연수,3349,3310,6659
12446,20200919,수인분당선,어천,458,414,872
12447,20200919,수인분당선,야목,210,205,415
12448,20200919,수인분당선,사리,2595,2387,4982
12449,20200919,수인분당선,달월,55,58,113
12450,20200919,수인분당선,월곶,1881,1878,3759
12451,20200919,수인분당선,소래포구,6339,6756,13095
12452,20200919,수인분당선,인천논현,3960,3964,7924
12453,20200919,수인분당선,호구포,1997,1945,3942
12454,20200919,수인분당선,남동인더스파크,1031,951,1982
12455,20200919,수인분당선,원인재,3138,3164,6302
12456,20200919,수인분당선,선릉,4277,6638,10915
12457,20200919,수인분당선,한티,9910,9461,19371
12458,20200919,수인분당선,도곡,3522,3173,6695
12459,20200919,수인분당선,구룡,1001,947,1948
12460,20200919,수인분당선,개포동,2143,2001,4144
12461,20200919,수인분당선,대모산입구,2402,2272,4674
12462,20200919,수인분당선,수서,7796,8342,16138
12463,20200919,수인분당선,수원,6591,5238,11829
12464,20200919,수인분당선,서울숲,6647,6882,13529
12465,20200919,수인분당선,압구정로데오,12849,15118,27967
12466,20200919,수인분당선,강남구청,4114,5100,9214
12467,20200919,수인분당선,선정릉,3122,3165,6287
12468,20200919,수인분당선,가천대,4159,4516,8675
12469,20200919,수인분당선,태평,9480,8868,18348
12470,20200919,수인분당선,모란,17936,18511,36447
12471,20200919,수인분당선,야탑,14215,14918,29133
12472,20200919,수인분당선,서현,14773,15096,29869
12473,20200919,수인분당선,수내,7669,7160,14829
12474,20200919,수인분당선,정자,9244,8442,17686
12475,20200919,수인분당선,미금,9228,9601,18829
12476,20200919,수인분당선,오리,6618,5527,12145
12477,20200919,수인분당선,이매,3131,3015,6146
12478,20200919,수인분당선,보정,1342,1185,2527
12479,20200919,수인분당선,죽전,8689,9730,18419
12480,20200919,수인분당선,구성,2755,2773,5528
12481,20200919,수인분당선,신갈,2429,2343,4772
12482,20200919,수인분당선,기흥,5405,5266,10671
12483,20200919,수인분당선,상갈,3168,3073,6241
12484,20200919,수인분당선,청명,2318,2199,4517
12485,20200919,수인분당선,영통,5272,5286,10558
12486,20200919,수인분당선,망포,7447,6710,14157
12487,20200919,수인분당선,매탄권선,2935,2649,5584
12488,20200919,수인분당선,수원시청,8208,9444,17652
12489,20200920,수인분당선,선릉,2451,3488,5939
12490,20200920,수인분당선,한티,6601,6391,12992
12491,20200920,수인분당선,도곡,1952,1938,3890
12492,20200920,수인분당선,구룡,592,641,1233
12493,20200920,수인분당선,개포동,1250,1280,2530
12494,20200920,수인분당선,대모산입구,1288,1202,2490
12495,20200920,수인분당선,수서,6641,5991,12632
12496,20200920,수인분당선,수원,4927,3651,8578
12497,20200920,수인분당선,서울숲,4744,4948,9692
12498,20200920,수인분당선,압구정로데오,7040,8073,15113
12499,20200920,수인분당선,강남구청,2191,2658,4849
12500,20200920,수인분당선,선정릉,1837,1930,3767
12501,20200920,수인분당선,가천대,2814,3454,6268
12502,20200920,수인분당선,태평,6330,6074,12404
12503,20200920,수인분당선,모란,9270,9405,18675
12504,20200920,수인분당선,야탑,9960,10557,20517
12505,20200920,수인분당선,서현,10107,10173,20280
12506,20200920,수인분당선,수내,4833,4727,9560
12507,20200920,수인분당선,정자,5885,5769,11654
12508,20200920,수인분당선,미금,5399,5987,11386
12509,20200920,수인분당선,오리,4524,3943,8467
12510,20200920,수인분당선,이매,2152,2218,4370
12511,20200920,수인분당선,보정,804,737,1541
12512,20200920,수인분당선,죽전,6284,7146,13430
12513,20200920,수인분당선,구성,1810,1915,3725
12514,20200920,수인분당선,신갈,1557,1564,3121
12515,20200920,수인분당선,기흥,3882,3761,7643
12516,20200920,수인분당선,상갈,2270,2371,4641
12517,20200920,수인분당선,청명,1480,1526,3006
12518,20200920,수인분당선,영통,3764,3734,7498
12519,20200920,수인분당선,망포,4796,4941,9737
12520,20200920,수인분당선,매탄권선,1891,1862,3753
12521,20200920,수인분당선,수원시청,5575,5480,11055
12522,20200920,수인분당선,매교,1133,1160,2293
12523,20200920,수인분당선,고색,1170,1255,2425
12524,20200920,수인분당선,오목천,1136,1129,2265
12525,20200920,수인분당선,어천,384,407,791
12526,20200920,수인분당선,야목,180,192,372
12527,20200920,수인분당선,사리,2093,1876,3969
12528,20200920,수인분당선,달월,53,71,124
12529,20200920,수인분당선,월곶,1523,1393,2916
12530,20200920,수인분당선,소래포구,5748,5799,11547
12531,20200920,수인분당선,인천논현,2355,2441,4796
12532,20200920,수인분당선,호구포,1428,1426,2854
12533,20200920,수인분당선,남동인더스파크,605,593,1198
12534,20200920,수인분당선,원인재,2142,2220,4362
12535,20200920,수인분당선,연수,2405,2286,4691
12536,20200920,수인분당선,송도,1290,1255,2545
12537,20200920,수인분당선,인하대,2544,2356,4900
12538,20200920,수인분당선,숭의,1641,1443,3084
12539,20200920,수인분당선,신포,917,908,1825
12540,20200920,수인분당선,인천,979,1496,2475
12541,20200921,수인분당선,선릉,12551,19203,31754
12542,20200921,수인분당선,한티,12108,13099,25207
12543,20200921,수인분당선,도곡,6142,6221,12363
12544,20200921,수인분당선,구룡,1707,1735,3442
12545,20200921,수인분당선,개포동,3011,3094,6105
12546,20200921,수인분당선,대모산입구,3283,3029,6312
12547,20200921,수인분당선,수서,11815,12120,23935
12548,20200921,수인분당선,수원,7375,5753,13128
12549,20200921,수인분당선,서울숲,8229,8223,16452
12550,20200921,수인분당선,압구정로데오,14252,15951,30203
12551,20200921,수인분당선,강남구청,8410,9660,18070
12552,20200921,수인분당선,선정릉,7619,8111,15730
12553,20200921,수인분당선,가천대,6293,7317,13610
12554,20200921,수인분당선,태평,12445,11920,24365
12555,20200921,수인분당선,모란,18229,18257,36486
12556,20200921,수인분당선,야탑,22945,23960,46905
12557,20200921,수인분당선,서현,21632,21930,43562
12558,20200921,수인분당선,수내,11574,11681,23255
12559,20200921,수인분당선,정자,14407,15397,29804
12560,20200921,수인분당선,미금,14267,15282,29549
12561,20200921,수인분당선,오리,10755,9157,19912
12562,20200921,수인분당선,이매,5008,4677,9685
12563,20200921,수인분당선,보정,2290,1983,4273
12564,20200921,수인분당선,죽전,11687,12791,24478
12565,20200921,수인분당선,구성,4547,4648,9195
12566,20200921,수인분당선,신갈,4099,4062,8161
12567,20200921,수인분당선,기흥,8322,8007,16329
12568,20200921,수인분당선,상갈,4784,4448,9232
12569,20200921,수인분당선,청명,3903,3684,7587
12570,20200921,수인분당선,영통,6873,7332,14205
12571,20200921,수인분당선,망포,12239,11566,23805
12572,20200921,수인분당선,매탄권선,4189,3979,8168
12573,20200921,수인분당선,수원시청,10544,11309,21853
12574,20200921,수인분당선,매교,2581,2618,5199
12575,20200921,수인분당선,고색,2141,2106,4247
12576,20200921,수인분당선,오목천,1763,1788,3551
12577,20200921,수인분당선,어천,355,362,717
12578,20200921,수인분당선,야목,184,171,355
12579,20200921,수인분당선,사리,2754,2685,5439
12580,20200921,수인분당선,달월,69,42,111
12581,20200921,수인분당선,월곶,2381,2130,4511
12582,20200921,수인분당선,소래포구,5382,5136,10518
12583,20200921,수인분당선,인천논현,4947,5197,10144
12584,20200921,수인분당선,호구포,3274,3383,6657
12585,20200921,수인분당선,남동인더스파크,2193,2452,4645
12586,20200921,수인분당선,원인재,4077,4082,8159
12587,20200921,수인분당선,연수,4076,4008,8084
12588,20200921,수인분당선,송도,2412,2194,4606
12589,20200921,수인분당선,인하대,5057,4796,9853
12590,20200921,수인분당선,숭의,3556,3333,6889
12591,20200921,수인분당선,신포,1605,1554,3159
12592,20200921,수인분당선,인천,959,1547,2506
12593,20200922,수인분당선,인천,950,1639,2589
12594,20200922,수인분당선,신포,1661,1708,3369
12595,20200922,수인분당선,숭의,3707,3540,7247
12596,20200922,수인분당선,인하대,5201,4768,9969
12597,20200922,수인분당선,송도,2451,2182,4633
12598,20200922,수인분당선,연수,4051,4093,8144
12599,20200922,수인분당선,원인재,4103,4279,8382
12600,20200922,수인분당선,남동인더스파크,2288,2457,4745
12601,20200922,수인분당선,호구포,3360,3421,6781
12602,20200922,수인분당선,인천논현,5078,5389,10467
12603,20200922,수인분당선,소래포구,5589,5474,11063
12604,20200922,수인분당선,월곶,2425,2291,4716
12605,20200922,수인분당선,달월,69,55,124
12606,20200922,수인분당선,사리,2781,2786,5567
12607,20200922,수인분당선,야목,187,177,364
12608,20200922,수인분당선,어천,410,372,782
12609,20200922,수인분당선,오목천,1865,1842,3707
12610,20200922,수인분당선,고색,2254,2211,4465
12611,20200922,수인분당선,매교,2582,2585,5167
12612,20200922,수인분당선,수원시청,10760,11612,22372
12613,20200922,수인분당선,매탄권선,4236,4074,8310
12614,20200922,수인분당선,망포,12171,11607,23778
12615,20200922,수인분당선,영통,6963,7312,14275
12616,20200922,수인분당선,청명,3898,3703,7601
12617,20200922,수인분당선,상갈,4933,4640,9573
12618,20200922,수인분당선,기흥,8651,8111,16762
12619,20200922,수인분당선,신갈,4193,4112,8305
12620,20200922,수인분당선,구성,4517,4701,9218
12621,20200922,수인분당선,죽전,12125,13336,25461
12622,20200922,수인분당선,보정,2314,2014,4328
12623,20200922,수인분당선,이매,5175,4760,9935
12624,20200922,수인분당선,오리,11006,9257,20263
12625,20200922,수인분당선,미금,14155,15472,29627
12626,20200922,수인분당선,정자,14868,15854,30722
12627,20200922,수인분당선,수내,11614,11844,23458
12628,20200922,수인분당선,서현,21616,22066,43682
12629,20200922,수인분당선,야탑,23286,24292,47578
12630,20200922,수인분당선,모란,18221,18202,36423
12631,20200922,수인분당선,태평,12460,12131,24591
12632,20200922,수인분당선,가천대,6509,7364,13873
12633,20200922,수인분당선,선정릉,7738,8318,16056
12634,20200922,수인분당선,강남구청,8887,10279,19166
12635,20200922,수인분당선,압구정로데오,15678,17820,33498
12636,20200922,수인분당선,서울숲,8774,8919,17693
12637,20200922,수인분당선,수원,7346,5628,12974
12638,20200922,수인분당선,수서,11777,12026,23803
12639,20200922,수인분당선,대모산입구,3337,3040,6377
12640,20200922,수인분당선,개포동,3057,3221,6278
12641,20200922,수인분당선,구룡,1786,1764,3550
12642,20200922,수인분당선,도곡,6142,6243,12385
12643,20200922,수인분당선,한티,12568,13609,26177
12644,20200922,수인분당선,선릉,12704,19196,31900
12645,20200923,수인분당선,선릉,12767,19312,32079
12646,20200923,수인분당선,한티,12885,13854,26739
12647,20200923,수인분당선,도곡,6116,6294,12410
12648,20200923,수인분당선,구룡,1761,1740,3501
12649,20200923,수인분당선,개포동,3183,3352,6535
12650,20200923,수인분당선,대모산입구,3241,3034,6275
12651,20200923,수인분당선,수서,12048,12251,24299
12652,20200923,수인분당선,수원,7521,5719,13240
12653,20200923,수인분당선,서울숲,8966,9087,18053
12654,20200923,수인분당선,압구정로데오,15868,18050,33918
12655,20200923,수인분당선,강남구청,9206,10681,19887
12656,20200923,수인분당선,선정릉,7798,8277,16075
12657,20200923,수인분당선,가천대,6713,7615,14328
12658,20200923,수인분당선,태평,12688,12356,25044
12659,20200923,수인분당선,모란,18236,18347,36583
12660,20200923,수인분당선,야탑,23465,24677,48142
12661,20200923,수인분당선,서현,21955,22502,44457
12662,20200923,수인분당선,수내,11981,12087,24068
12663,20200923,수인분당선,정자,14869,16041,30910
12664,20200923,수인분당선,미금,14473,15510,29983
12665,20200923,수인분당선,오리,11020,9361,20381
12666,20200923,수인분당선,이매,5117,4695,9812
12667,20200923,수인분당선,보정,2327,2005,4332
12668,20200923,수인분당선,죽전,12162,13366,25528
12669,20200923,수인분당선,구성,4594,4654,9248
12670,20200923,수인분당선,신갈,4095,4048,8143
12671,20200923,수인분당선,기흥,8670,8169,16839
12672,20200923,수인분당선,상갈,5022,4669,9691
12673,20200923,수인분당선,청명,3969,3774,7743
12674,20200923,수인분당선,영통,7211,7502,14713
12675,20200923,수인분당선,망포,12381,11801,24182
12676,20200923,수인분당선,매탄권선,4259,3999,8258
12677,20200923,수인분당선,수원시청,10827,11933,22760
12678,20200923,수인분당선,매교,2570,2695,5265
12679,20200923,수인분당선,고색,2255,2222,4477
12680,20200923,수인분당선,오목천,1996,1850,3846
12681,20200923,수인분당선,어천,452,429,881
12682,20200923,수인분당선,야목,181,178,359
12683,20200923,수인분당선,사리,2921,2781,5702
12684,20200923,수인분당선,달월,68,49,117
12685,20200923,수인분당선,월곶,2330,2165,4495
12686,20200923,수인분당선,소래포구,5383,5158,10541
12687,20200923,수인분당선,인천논현,5065,5408,10473
12688,20200923,수인분당선,호구포,3362,3440,6802
12689,20200923,수인분당선,남동인더스파크,2200,2457,4657
12690,20200923,수인분당선,원인재,4083,4267,8350
12691,20200923,수인분당선,연수,4359,4181,8540
12692,20200923,수인분당선,송도,2461,2250,4711
12693,20200923,수인분당선,인하대,5126,4858,9984
12694,20200923,수인분당선,숭의,3594,3384,6978
12695,20200923,수인분당선,신포,1639,1644,3283
12696,20200923,수인분당선,인천,963,1609,2572
12697,20200924,수인분당선,선릉,12730,19363,32093
12698,20200924,수인분당선,한티,12692,13748,26440
12699,20200924,수인분당선,도곡,6178,6261,12439
12700,20200924,수인분당선,구룡,1761,1775,3536
12701,20200924,수인분당선,개포동,3090,3253,6343
12702,20200924,수인분당선,대모산입구,3357,3145,6502
12703,20200924,수인분당선,수서,12682,12964,25646
12704,20200924,수인분당선,수원,7371,5724,13095
12705,20200924,수인분당선,서울숲,8817,8896,17713
12706,20200924,수인분당선,압구정로데오,15829,18113,33942
12707,20200924,수인분당선,강남구청,9020,10444,19464
12708,20200924,수인분당선,선정릉,7860,8366,16226
12709,20200924,수인분당선,가천대,6827,7526,14353
12710,20200924,수인분당선,태평,12972,12410,25382
12711,20200924,수인분당선,모란,24044,24853,48897
12712,20200924,수인분당선,야탑,23862,24945,48807
12713,20200924,수인분당선,서현,22038,22453,44491
12714,20200924,수인분당선,수내,11859,12140,23999
12715,20200924,수인분당선,정자,14953,16156,31109
12716,20200924,수인분당선,미금,14641,15718,30359
12717,20200924,수인분당선,오리,11257,9565,20822
12718,20200924,수인분당선,이매,5184,4856,10040
12719,20200924,수인분당선,보정,2396,2057,4453
12720,20200924,수인분당선,죽전,12366,13652,26018
12721,20200924,수인분당선,구성,4740,4750,9490
12722,20200924,수인분당선,신갈,4166,4079,8245
12723,20200924,수인분당선,기흥,8843,8252,17095
12724,20200924,수인분당선,상갈,5097,4747,9844
12725,20200924,수인분당선,청명,4067,3813,7880
12726,20200924,수인분당선,영통,7279,7409,14688
12727,20200924,수인분당선,망포,12587,11919,24506
12728,20200924,수인분당선,매탄권선,4233,4088,8321
12729,20200924,수인분당선,수원시청,10731,11693,22424
12730,20200924,수인분당선,매교,2570,2631,5201
12731,20200924,수인분당선,고색,2186,2154,4340
12732,20200924,수인분당선,오목천,1948,1847,3795
12733,20200924,수인분당선,어천,444,434,878
12734,20200924,수인분당선,야목,184,169,353
12735,20200924,수인분당선,사리,2906,2711,5617
12736,20200924,수인분당선,달월,61,57,118
12737,20200924,수인분당선,월곶,2437,2204,4641
12738,20200924,수인분당선,소래포구,5301,5064,10365
12739,20200924,수인분당선,인천논현,4967,5362,10329
12740,20200924,수인분당선,호구포,3349,3467,6816
12741,20200924,수인분당선,남동인더스파크,2220,2497,4717
12742,20200924,수인분당선,원인재,4037,4169,8206
12743,20200924,수인분당선,연수,4116,3992,8108
12744,20200924,수인분당선,송도,2405,2250,4655
12745,20200924,수인분당선,인하대,5259,4781,10040
12746,20200924,수인분당선,숭의,3572,3397,6969
12747,20200924,수인분당선,신포,1620,1730,3350
12748,20200924,수인분당선,인천,941,1568,2509
12749,20200925,수인분당선,인천,969,1668,2637
12750,20200925,수인분당선,신포,1694,1799,3493
12751,20200925,수인분당선,숭의,3706,3429,7135
12752,20200925,수인분당선,인하대,5497,5138,10635
12753,20200925,수인분당선,송도,2474,2184,4658
12754,20200925,수인분당선,연수,4352,4365,8717
12755,20200925,수인분당선,원인재,4348,4298,8646
12756,20200925,수인분당선,남동인더스파크,2216,2528,4744
12757,20200925,수인분당선,호구포,3435,3470,6905
12758,20200925,수인분당선,인천논현,5326,5704,11030
12759,20200925,수인분당선,소래포구,5382,5441,10823
12760,20200925,수인분당선,월곶,2513,2298,4811
12761,20200925,수인분당선,달월,73,68,141
12762,20200925,수인분당선,사리,3179,3021,6200
12763,20200925,수인분당선,야목,193,192,385
12764,20200925,수인분당선,어천,496,419,915
12765,20200925,수인분당선,오목천,2182,1887,4069
12766,20200925,수인분당선,고색,2420,2386,4806
12767,20200925,수인분당선,매교,2815,2797,5612
12768,20200925,수인분당선,수원시청,11698,14094,25792
12769,20200925,수인분당선,매탄권선,4726,4366,9092
12770,20200925,수인분당선,망포,13851,12525,26376
12771,20200925,수인분당선,영통,8088,8399,16487
12772,20200925,수인분당선,청명,4350,3925,8275
12773,20200925,수인분당선,상갈,5251,4885,10136
12774,20200925,수인분당선,기흥,9265,8628,17893
12775,20200925,수인분당선,신갈,4315,4148,8463
12776,20200925,수인분당선,구성,4911,4845,9756
12777,20200925,수인분당선,죽전,13362,14188,27550
12778,20200925,수인분당선,보정,2365,2050,4415
12779,20200925,수인분당선,이매,5403,4999,10402
12780,20200925,수인분당선,오리,11609,9939,21548
12781,20200925,수인분당선,미금,15129,16115,31244
12782,20200925,수인분당선,정자,16005,17325,33330
12783,20200925,수인분당선,수내,12605,12597,25202
12784,20200925,수인분당선,서현,23673,24474,48147
12785,20200925,수인분당선,야탑,24904,25912,50816
12786,20200925,수인분당선,모란,19394,19521,38915
12787,20200925,수인분당선,태평,13273,12768,26041
12788,20200925,수인분당선,가천대,7086,7540,14626
12789,20200925,수인분당선,선정릉,8002,8610,16612
12790,20200925,수인분당선,강남구청,9419,10953,20372
12791,20200925,수인분당선,압구정로데오,17258,20816,38074
12792,20200925,수인분당선,서울숲,9353,9323,18676
12793,20200925,수인분당선,수원,8046,6402,14448
12794,20200925,수인분당선,복정,1,0,1
12795,20200925,수인분당선,수서,13584,14504,28088
12796,20200925,수인분당선,대모산입구,3373,3163,6536
12797,20200925,수인분당선,개포동,3463,3523,6986
12798,20200925,수인분당선,구룡,1832,1662,3494
12799,20200925,수인분당선,도곡,6494,6334,12828
12800,20200925,수인분당선,한티,13692,14700,28392
12801,20200925,수인분당선,선릉,12928,19922,32850
12802,20200926,수인분당선,선릉,4597,6735,11332
12803,20200926,수인분당선,한티,10950,10627,21577
12804,20200926,수인분당선,도곡,3871,3696,7567
12805,20200926,수인분당선,구룡,1183,1127,2310
12806,20200926,수인분당선,개포동,2185,2063,4248
12807,20200926,수인분당선,대모산입구,2277,2048,4325
12808,20200926,수인분당선,수서,8019,8818,16837
12809,20200926,수인분당선,수원,6776,5216,11992
12810,20200926,수인분당선,서울숲,6944,7479,14423
12811,20200926,수인분당선,압구정로데오,13872,16728,30600
12812,20200926,수인분당선,강남구청,4153,5040,9193
12813,20200926,수인분당선,선정릉,3220,3308,6528
12814,20200926,수인분당선,가천대,4311,4732,9043
12815,20200926,수인분당선,태평,9473,9044,18517
12816,20200926,수인분당선,모란,14388,14250,28638
12817,20200926,수인분당선,야탑,14886,15966,30852
12818,20200926,수인분당선,서현,15818,16185,32003
12819,20200926,수인분당선,수내,7868,7297,15165
12820,20200926,수인분당선,정자,9578,9734,19312
12821,20200926,수인분당선,미금,9646,10138,19784
12822,20200926,수인분당선,오리,6955,5836,12791
12823,20200926,수인분당선,이매,3257,3114,6371
12824,20200926,수인분당선,보정,1410,1269,2679
12825,20200926,수인분당선,죽전,8963,10139,19102
12826,20200926,수인분당선,구성,2812,2844,5656
12827,20200926,수인분당선,신갈,2432,2348,4780
12828,20200926,수인분당선,기흥,5822,5451,11273
12829,20200926,수인분당선,상갈,3268,3250,6518
12830,20200926,수인분당선,청명,2475,2300,4775
12831,20200926,수인분당선,영통,5464,5439,10903
12832,20200926,수인분당선,망포,7825,7036,14861
12833,20200926,수인분당선,매탄권선,2828,2613,5441
12834,20200926,수인분당선,수원시청,8506,9964,18470
12835,20200926,수인분당선,매교,1676,1814,3490
12836,20200926,수인분당선,고색,1597,1608,3205
12837,20200926,수인분당선,오목천,1546,1261,2807
12838,20200926,수인분당선,어천,373,384,757
12839,20200926,수인분당선,야목,202,196,398
12840,20200926,수인분당선,사리,2597,2313,4910
12841,20200926,수인분당선,달월,63,55,118
12842,20200926,수인분당선,월곶,2019,1917,3936
12843,20200926,수인분당선,소래포구,5859,6442,12301
12844,20200926,수인분당선,인천논현,3944,4042,7986
12845,20200926,수인분당선,호구포,2163,2034,4197
12846,20200926,수인분당선,남동인더스파크,1064,985,2049
12847,20200926,수인분당선,원인재,3235,3166,6401
12848,20200926,수인분당선,연수,3378,3348,6726
12849,20200926,수인분당선,송도,1879,1783,3662
12850,20200926,수인분당선,인하대,3718,3408,7126
12851,20200926,수인분당선,숭의,2484,2257,4741
12852,20200926,수인분당선,신포,1323,1379,2702
12853,20200926,수인분당선,인천,1147,1795,2942
12854,20200927,수인분당선,인천,888,1431,2319
12855,20200927,수인분당선,신포,900,934,1834
12856,20200927,수인분당선,숭의,1686,1501,3187
12857,20200927,수인분당선,인하대,2462,2389,4851
12858,20200927,수인분당선,송도,1411,1393,2804
12859,20200927,수인분당선,연수,2488,2466,4954
12860,20200927,수인분당선,원인재,2434,2483,4917
12861,20200927,수인분당선,남동인더스파크,590,591,1181
12862,20200927,수인분당선,호구포,1527,1511,3038
12863,20200927,수인분당선,인천논현,2520,2530,5050
12864,20200927,수인분당선,소래포구,5343,5304,10647
12865,20200927,수인분당선,월곶,1588,1499,3087
12866,20200927,수인분당선,달월,74,64,138
12867,20200927,수인분당선,사리,2050,1871,3921
12868,20200927,수인분당선,야목,151,164,315
12869,20200927,수인분당선,어천,344,319,663
12870,20200927,수인분당선,오목천,1181,1138,2319
12871,20200927,수인분당선,고색,1162,1197,2359
12872,20200927,수인분당선,매교,1104,1127,2231
12873,20200927,수인분당선,수원시청,5822,5573,11395
12874,20200927,수인분당선,매탄권선,1991,1917,3908
12875,20200927,수인분당선,망포,5069,5084,10153
12876,20200927,수인분당선,영통,3670,3561,7231
12877,20200927,수인분당선,청명,1474,1540,3014
12878,20200927,수인분당선,상갈,2276,2318,4594
12879,20200927,수인분당선,기흥,4037,3926,7963
12880,20200927,수인분당선,신갈,1529,1613,3142
12881,20200927,수인분당선,구성,1919,2042,3961
12882,20200927,수인분당선,죽전,6743,7516,14259
12883,20200927,수인분당선,보정,907,831,1738
12884,20200927,수인분당선,이매,2219,2258,4477
12885,20200927,수인분당선,오리,4920,4322,9242
12886,20200927,수인분당선,미금,5995,6360,12355
12887,20200927,수인분당선,정자,6364,6505,12869
12888,20200927,수인분당선,수내,5325,5040,10365
12889,20200927,수인분당선,서현,10854,11051,21905
12890,20200927,수인분당선,야탑,10398,11001,21399
12891,20200927,수인분당선,모란,9543,9929,19472
12892,20200927,수인분당선,태평,6889,6321,13210
12893,20200927,수인분당선,가천대,2959,3509,6468
12894,20200927,수인분당선,선정릉,1824,2036,3860
12895,20200927,수인분당선,강남구청,2365,2704,5069
12896,20200927,수인분당선,압구정로데오,7399,8664,16063
12897,20200927,수인분당선,서울숲,5257,5528,10785
12898,20200927,수인분당선,수원,4920,3997,8917
12899,20200927,수인분당선,복정,1,0,1
12900,20200927,수인분당선,수서,6024,6335,12359
12901,20200927,수인분당선,대모산입구,1470,1374,2844
12902,20200927,수인분당선,개포동,1551,1538,3089
12903,20200927,수인분당선,구룡,509,497,1006
12904,20200927,수인분당선,도곡,1973,1958,3931
12905,20200927,수인분당선,한티,6885,6601,13486
12906,20200927,수인분당선,선릉,2493,3382,5875
12907,20200928,수인분당선,선릉,12511,19122,31633
12908,20200928,수인분당선,한티,12655,13696,26351
12909,20200928,수인분당선,도곡,6391,6502,12893
12910,20200928,수인분당선,구룡,1383,1329,2712
12911,20200928,수인분당선,개포동,3173,3267,6440
12912,20200928,수인분당선,대모산입구,3374,3102,6476
12913,20200928,수인분당선,수서,11813,14004,25817
12914,20200928,수인분당선,수원,7378,5877,13255
12915,20200928,수인분당선,서울숲,8439,8488,16927
12916,20200928,수인분당선,압구정로데오,15491,17530,33021
12917,20200928,수인분당선,강남구청,8799,10135,18934
12918,20200928,수인분당선,선정릉,7412,8111,15523
12919,20200928,수인분당선,가천대,6582,7313,13895
12920,20200928,수인분당선,태평,13009,12601,25610
12921,20200928,수인분당선,모란,19053,19018,38071
12922,20200928,수인분당선,야탑,23825,24901,48726
12923,20200928,수인분당선,서현,23074,23292,46366
12924,20200928,수인분당선,수내,11914,12058,23972
12925,20200928,수인분당선,정자,15016,16022,31038
12926,20200928,수인분당선,미금,14955,15845,30800
12927,20200928,수인분당선,오리,11112,9507,20619
12928,20200928,수인분당선,이매,5094,4777,9871
12929,20200928,수인분당선,보정,2291,1948,4239
12930,20200928,수인분당선,죽전,12393,13296,25689
12931,20200928,수인분당선,구성,4564,4566,9130
12932,20200928,수인분당선,신갈,4167,4068,8235
12933,20200928,수인분당선,기흥,8636,8242,16878
12934,20200928,수인분당선,상갈,4911,4725,9636
12935,20200928,수인분당선,청명,4020,3797,7817
12936,20200928,수인분당선,영통,7570,7641,15211
12937,20200928,수인분당선,망포,12522,11814,24336
12938,20200928,수인분당선,매탄권선,4307,4050,8357
12939,20200928,수인분당선,수원시청,11176,11960,23136
12940,20200928,수인분당선,매교,2658,2617,5275
12941,20200928,수인분당선,고색,2198,2187,4385
12942,20200928,수인분당선,오목천,1946,1768,3714
12943,20200928,수인분당선,어천,449,438,887
12944,20200928,수인분당선,야목,204,174,378
12945,20200928,수인분당선,사리,2819,2669,5488
12946,20200928,수인분당선,달월,60,50,110
12947,20200928,수인분당선,월곶,2413,2125,4538
12948,20200928,수인분당선,소래포구,4999,4747,9746
12949,20200928,수인분당선,인천논현,5109,5576,10685
12950,20200928,수인분당선,호구포,3321,3441,6762
12951,20200928,수인분당선,남동인더스파크,2056,2401,4457
12952,20200928,수인분당선,원인재,4070,4154,8224
12953,20200928,수인분당선,연수,4174,4016,8190
12954,20200928,수인분당선,송도,2416,2184,4600
12955,20200928,수인분당선,인하대,5137,4770,9907
12956,20200928,수인분당선,숭의,3628,3356,6984
12957,20200928,수인분당선,신포,1590,1675,3265
12958,20200928,수인분당선,인천,917,1552,2469
12959,20200929,수인분당선,인천,883,1518,2401
12960,20200929,수인분당선,신포,1643,1734,3377
12961,20200929,수인분당선,숭의,3562,3317,6879
12962,20200929,수인분당선,인하대,5156,4663,9819
12963,20200929,수인분당선,송도,2331,2154,4485
12964,20200929,수인분당선,연수,4182,4219,8401
12965,20200929,수인분당선,원인재,4129,4243,8372
12966,20200929,수인분당선,남동인더스파크,1948,2113,4061
12967,20200929,수인분당선,호구포,3134,3131,6265
12968,20200929,수인분당선,인천논현,5141,5569,10710
12969,20200929,수인분당선,소래포구,5000,5062,10062
12970,20200929,수인분당선,월곶,2304,2172,4476
12971,20200929,수인분당선,달월,68,50,118
12972,20200929,수인분당선,사리,2888,2819,5707
12973,20200929,수인분당선,야목,199,180,379
12974,20200929,수인분당선,어천,558,432,990
12975,20200929,수인분당선,오목천,2216,1893,4109
12976,20200929,수인분당선,고색,2246,2260,4506
12977,20200929,수인분당선,매교,2570,2609,5179
12978,20200929,수인분당선,수원시청,11099,12669,23768
12979,20200929,수인분당선,매탄권선,4610,4005,8615
12980,20200929,수인분당선,망포,13223,11641,24864
12981,20200929,수인분당선,영통,7740,7806,15546
12982,20200929,수인분당선,청명,4018,3650,7668
12983,20200929,수인분당선,상갈,4949,4715,9664
12984,20200929,수인분당선,기흥,8601,8187,16788
12985,20200929,수인분당선,신갈,4090,4026,8116
12986,20200929,수인분당선,구성,4402,4520,8922
12987,20200929,수인분당선,죽전,13101,13934,27035
12988,20200929,수인분당선,보정,2312,1979,4291
12989,20200929,수인분당선,이매,5271,4805,10076
12990,20200929,수인분당선,오리,10671,9078,19749
12991,20200929,수인분당선,미금,14840,15571,30411
12992,20200929,수인분당선,정자,14525,15585,30110
12993,20200929,수인분당선,수내,11457,11515,22972
12994,20200929,수인분당선,서현,23092,24082,47174
12995,20200929,수인분당선,야탑,23836,25713,49549
12996,20200929,수인분당선,모란,23693,24476,48169
12997,20200929,수인분당선,태평,13366,12775,26141
12998,20200929,수인분당선,가천대,6663,6885,13548
12999,20200929,수인분당선,선정릉,6880,7390,14270
13000,20200929,수인분당선,강남구청,8261,9659,17920
13001,20200929,수인분당선,압구정로데오,16182,18794,34976
13002,20200929,수인분당선,서울숲,8512,8401,16913
13003,20200929,수인분당선,수원,7994,6649,14643
13004,20200929,수인분당선,수서,11111,12612,23723
13005,20200929,수인분당선,대모산입구,3203,2951,6154
13006,20200929,수인분당선,개포동,3218,3276,6494
13007,20200929,수인분당선,구룡,1378,1301,2679
13008,20200929,수인분당선,도곡,5998,6037,12035
13009,20200929,수인분당선,한티,12722,13745,26467
13010,20200929,수인분당선,선릉,11270,16946,28216
13011,20200930,수인분당선,인천,877,1380,2257
13012,20200930,수인분당선,신포,809,931,1740
13013,20200930,수인분당선,숭의,1541,1429,2970
13014,20200930,수인분당선,인하대,2300,2050,4350
13015,20200930,수인분당선,송도,1161,1245,2406
13016,20200930,수인분당선,연수,2466,2307,4773
13017,20200930,수인분당선,원인재,2159,2298,4457
13018,20200930,수인분당선,남동인더스파크,597,478,1075
13019,20200930,수인분당선,호구포,1481,1411,2892
13020,20200930,수인분당선,인천논현,2440,2540,4980
13021,20200930,수인분당선,소래포구,4378,4505,8883
13022,20200930,수인분당선,월곶,1359,1309,2668
13023,20200930,수인분당선,달월,49,56,105
13024,20200930,수인분당선,사리,1672,1573,3245
13025,20200930,수인분당선,야목,106,149,255
13026,20200930,수인분당선,어천,293,320,613
13027,20200930,수인분당선,오목천,1087,959,2046
13028,20200930,수인분당선,고색,1007,1094,2101
13029,20200930,수인분당선,매교,975,1015,1990
13030,20200930,수인분당선,수원시청,4622,4683,9305
13031,20200930,수인분당선,매탄권선,1741,1544,3285
13032,20200930,수인분당선,망포,4740,4011,8751
13033,20200930,수인분당선,영통,3541,3065,6606
13034,20200930,수인분당선,청명,1333,1300,2633
13035,20200930,수인분당선,상갈,2191,2243,4434
13036,20200930,수인분당선,기흥,3583,3480,7063
13037,20200930,수인분당선,신갈,1410,1524,2934
13038,20200930,수인분당선,구성,1727,2014,3741
13039,20200930,수인분당선,죽전,5151,5683,10834
13040,20200930,수인분당선,보정,808,731,1539
13041,20200930,수인분당선,이매,2080,2138,4218
13042,20200930,수인분당선,오리,4418,3681,8099
13043,20200930,수인분당선,미금,5826,5773,11599
13044,20200930,수인분당선,정자,5766,5412,11178
13045,20200930,수인분당선,수내,4647,4236,8883
13046,20200930,수인분당선,서현,9593,9896,19489
13047,20200930,수인분당선,야탑,9160,10482,19642
13048,20200930,수인분당선,모란,8756,8767,17523
13049,20200930,수인분당선,태평,6668,6200,12868
13050,20200930,수인분당선,가천대,2792,2531,5323
13051,20200930,수인분당선,선정릉,1406,1239,2645
13052,20200930,수인분당선,강남구청,1908,2042,3950
13053,20200930,수인분당선,압구정로데오,6144,7232,13376
13054,20200930,수인분당선,서울숲,3520,3488,7008
13055,20200930,수인분당선,수원,4568,3752,8320
13056,20200930,수인분당선,수서,4249,6036,10285
13057,20200930,수인분당선,대모산입구,1074,932,2006
13058,20200930,수인분당선,개포동,1133,1077,2210
13059,20200930,수인분당선,구룡,477,394,871
13060,20200930,수인분당선,도곡,1933,1912,3845
13061,20200930,수인분당선,한티,5841,5441,11282
13062,20200930,수인분당선,선릉,2117,2779,4896
13063,20201001,수인분당선,선릉,1034,1510,2544
13064,20201001,수인분당선,한티,3659,3588,7247
13065,20201001,수인분당선,도곡,994,929,1923
13066,20201001,수인분당선,구룡,278,268,546
13067,20201001,수인분당선,개포동,710,716,1426
13068,20201001,수인분당선,대모산입구,820,747,1567
13069,20201001,수인분당선,수서,3776,3944,7720
13070,20201001,수인분당선,수원,3779,2707,6486
13071,20201001,수인분당선,서울숲,2230,2245,4475
13072,20201001,수인분당선,압구정로데오,1811,2328,4139
13073,20201001,수인분당선,강남구청,916,1082,1998
13074,20201001,수인분당선,선정릉,794,826,1620
13075,20201001,수인분당선,가천대,1997,2231,4228
13076,20201001,수인분당선,태평,4894,4547,9441
13077,20201001,수인분당선,모란,5826,6044,11870
13078,20201001,수인분당선,야탑,6109,6261,12370
13079,20201001,수인분당선,서현,4885,5185,10070
13080,20201001,수인분당선,수내,2161,2041,4202
13081,20201001,수인분당선,정자,3315,3365,6680
13082,20201001,수인분당선,미금,3494,3585,7079
13083,20201001,수인분당선,오리,2632,2219,4851
13084,20201001,수인분당선,이매,1333,1432,2765
13085,20201001,수인분당선,보정,535,496,1031
13086,20201001,수인분당선,죽전,3178,3668,6846
13087,20201001,수인분당선,구성,1313,1285,2598
13088,20201001,수인분당선,신갈,1070,1073,2143
13089,20201001,수인분당선,기흥,2753,2550,5303
13090,20201001,수인분당선,상갈,1595,1636,3231
13091,20201001,수인분당선,청명,971,946,1917
13092,20201001,수인분당선,영통,2215,2194,4409
13093,20201001,수인분당선,망포,2975,2754,5729
13094,20201001,수인분당선,매탄권선,1303,1204,2507
13095,20201001,수인분당선,수원시청,2899,3718,6617
13096,20201001,수인분당선,매교,773,799,1572
13097,20201001,수인분당선,고색,941,948,1889
13098,20201001,수인분당선,오목천,1045,855,1900
13099,20201001,수인분당선,어천,312,291,603
13100,20201001,수인분당선,야목,158,127,285
13101,20201001,수인분당선,사리,1589,1344,2933
13102,20201001,수인분당선,달월,34,41,75
13103,20201001,수인분당선,월곶,1136,1059,2195
13104,20201001,수인분당선,소래포구,4092,4203,8295
13105,20201001,수인분당선,인천논현,1737,1834,3571
13106,20201001,수인분당선,호구포,1116,1129,2245
13107,20201001,수인분당선,남동인더스파크,384,363,747
13108,20201001,수인분당선,원인재,1765,1826,3591
13109,20201001,수인분당선,연수,1925,1967,3892
13110,20201001,수인분당선,송도,993,1007,2000
13111,20201001,수인분당선,인하대,1763,1688,3451
13112,20201001,수인분당선,숭의,1301,1148,2449
13113,20201001,수인분당선,신포,611,618,1229
13114,20201001,수인분당선,인천,1053,1593,2646
13115,20201002,수인분당선,인천,1194,1977,3171
13116,20201002,수인분당선,신포,964,908,1872
13117,20201002,수인분당선,숭의,1547,1403,2950
13118,20201002,수인분당선,인하대,2215,2086,4301
13119,20201002,수인분당선,송도,1352,1187,2539
13120,20201002,수인분당선,연수,2391,2375,4766
13121,20201002,수인분당선,원인재,2243,2304,4547
13122,20201002,수인분당선,남동인더스파크,462,444,906
13123,20201002,수인분당선,호구포,1347,1384,2731
13124,20201002,수인분당선,인천논현,2381,2536,4917
13125,20201002,수인분당선,소래포구,6238,6415,12653
13126,20201002,수인분당선,월곶,1636,1423,3059
13127,20201002,수인분당선,달월,66,71,137
13128,20201002,수인분당선,사리,2162,1824,3986
13129,20201002,수인분당선,야목,180,166,346
13130,20201002,수인분당선,어천,368,353,721
13131,20201002,수인분당선,오목천,1304,1123,2427
13132,20201002,수인분당선,고색,1247,1213,2460
13133,20201002,수인분당선,매교,1080,1051,2131
13134,20201002,수인분당선,수원시청,4498,6120,10618
13135,20201002,수인분당선,매탄권선,1852,1641,3493
13136,20201002,수인분당선,망포,4532,4164,8696
13137,20201002,수인분당선,영통,3241,3559,6800
13138,20201002,수인분당선,청명,1503,1344,2847
13139,20201002,수인분당선,상갈,2402,2274,4676
13140,20201002,수인분당선,기흥,3893,3584,7477
13141,20201002,수인분당선,신갈,1398,1383,2781
13142,20201002,수인분당선,구성,1811,1751,3562
13143,20201002,수인분당선,죽전,5943,6678,12621
13144,20201002,수인분당선,보정,771,662,1433
13145,20201002,수인분당선,이매,2015,2081,4096
13146,20201002,수인분당선,오리,3852,3272,7124
13147,20201002,수인분당선,미금,5264,5426,10690
13148,20201002,수인분당선,정자,5169,5471,10640
13149,20201002,수인분당선,수내,3272,3211,6483
13150,20201002,수인분당선,서현,8385,8951,17336
13151,20201002,수인분당선,야탑,9394,9620,19014
13152,20201002,수인분당선,모란,8487,8881,17368
13153,20201002,수인분당선,태평,5905,5251,11156
13154,20201002,수인분당선,가천대,2329,2842,5171
13155,20201002,수인분당선,선정릉,1135,1262,2397
13156,20201002,수인분당선,강남구청,1525,1933,3458
13157,20201002,수인분당선,압구정로데오,4224,5939,10163
13158,20201002,수인분당선,서울숲,3274,3418,6692
13159,20201002,수인분당선,수원,5574,4199,9773
13160,20201002,수인분당선,수서,5139,4221,9360
13161,20201002,수인분당선,대모산입구,999,937,1936
13162,20201002,수인분당선,개포동,1077,1031,2108
13163,20201002,수인분당선,구룡,433,393,826
13164,20201002,수인분당선,도곡,1777,1669,3446
13165,20201002,수인분당선,한티,5654,5619,11273
13166,20201002,수인분당선,선릉,1611,2631,4242
13167,20201003,수인분당선,인천,1387,2199,3586
13168,20201003,수인분당선,신포,1121,1140,2261
13169,20201003,수인분당선,숭의,1846,1663,3509
13170,20201003,수인분당선,인하대,2812,2735,5547
13171,20201003,수인분당선,송도,1675,1540,3215
13172,20201003,수인분당선,연수,2847,2914,5761
13173,20201003,수인분당선,원인재,2728,2738,5466
13174,20201003,수인분당선,남동인더스파크,549,551,1100
13175,20201003,수인분당선,호구포,1567,1571,3138
13176,20201003,수인분당선,인천논현,2961,3151,6112
13177,20201003,수인분당선,소래포구,7462,7775,15237
13178,20201003,수인분당선,월곶,1984,1715,3699
13179,20201003,수인분당선,달월,56,67,123
13180,20201003,수인분당선,사리,2477,2070,4547
13181,20201003,수인분당선,야목,206,193,399
13182,20201003,수인분당선,어천,409,383,792
13183,20201003,수인분당선,오목천,1539,1310,2849
13184,20201003,수인분당선,고색,1420,1418,2838
13185,20201003,수인분당선,매교,1191,1284,2475
13186,20201003,수인분당선,수원시청,5785,7029,12814
13187,20201003,수인분당선,매탄권선,2158,1950,4108
13188,20201003,수인분당선,망포,5403,5291,10694
13189,20201003,수인분당선,영통,4006,4263,8269
13190,20201003,수인분당선,청명,1790,1699,3489
13191,20201003,수인분당선,상갈,2645,2603,5248
13192,20201003,수인분당선,기흥,4471,4273,8744
13193,20201003,수인분당선,신갈,1766,1726,3492
13194,20201003,수인분당선,구성,2148,2117,4265
13195,20201003,수인분당선,죽전,6802,7894,14696
13196,20201003,수인분당선,보정,1016,907,1923
13197,20201003,수인분당선,이매,2427,2477,4904
13198,20201003,수인분당선,오리,4677,3969,8646
13199,20201003,수인분당선,미금,6569,6954,13523
13200,20201003,수인분당선,정자,6404,6882,13286
13201,20201003,수인분당선,수내,5354,5090,10444
13202,20201003,수인분당선,서현,11747,12247,23994
13203,20201003,수인분당선,야탑,11547,11493,23040
13204,20201003,수인분당선,모란,10006,10665,20671
13205,20201003,수인분당선,태평,7001,6482,13483
13206,20201003,수인분당선,가천대,2763,3248,6011
13207,20201003,수인분당선,선정릉,1615,1716,3331
13208,20201003,수인분당선,강남구청,2019,2538,4557
13209,20201003,수인분당선,압구정로데오,7443,9686,17129
13210,20201003,수인분당선,서울숲,4756,5170,9926
13211,20201003,수인분당선,수원,6210,4792,11002
13212,20201003,수인분당선,수서,6106,4759,10865
13213,20201003,수인분당선,대모산입구,1202,1103,2305
13214,20201003,수인분당선,개포동,1351,1323,2674
13215,20201003,수인분당선,구룡,565,553,1118
13216,20201003,수인분당선,도곡,2250,2016,4266
13217,20201003,수인분당선,한티,7094,6817,13911
13218,20201003,수인분당선,선릉,2232,3454,5686
13219,20201004,수인분당선,인천,1026,1641,2667
13220,20201004,수인분당선,신포,979,1014,1993
13221,20201004,수인분당선,숭의,1620,1461,3081
13222,20201004,수인분당선,인하대,2466,2446,4912
13223,20201004,수인분당선,송도,1430,1366,2796
13224,20201004,수인분당선,연수,2423,2308,4731
13225,20201004,수인분당선,원인재,2239,2299,4538
13226,20201004,수인분당선,남동인더스파크,419,471,890
13227,20201004,수인분당선,호구포,1430,1533,2963
13228,20201004,수인분당선,인천논현,2456,2540,4996
13229,20201004,수인분당선,소래포구,5464,5342,10806
13230,20201004,수인분당선,월곶,1528,1364,2892
13231,20201004,수인분당선,달월,50,48,98
13232,20201004,수인분당선,사리,2174,1812,3986
13233,20201004,수인분당선,야목,160,171,331
13234,20201004,수인분당선,어천,327,358,685
13235,20201004,수인분당선,오목천,1191,1153,2344
13236,20201004,수인분당선,고색,1108,1207,2315
13237,20201004,수인분당선,매교,1079,1112,2191
13238,20201004,수인분당선,수원시청,5246,5210,10456
13239,20201004,수인분당선,매탄권선,1854,1820,3674
13240,20201004,수인분당선,망포,4661,5108,9769
13241,20201004,수인분당선,영통,3599,3914,7513
13242,20201004,수인분당선,청명,1516,1543,3059
13243,20201004,수인분당선,상갈,2321,2335,4656
13244,20201004,수인분당선,기흥,3975,3795,7770
13245,20201004,수인분당선,신갈,1500,1527,3027
13246,20201004,수인분당선,구성,1812,1908,3720
13247,20201004,수인분당선,죽전,6195,7276,13471
13248,20201004,수인분당선,보정,820,752,1572
13249,20201004,수인분당선,이매,2186,2338,4524
13250,20201004,수인분당선,오리,4272,3666,7938
13251,20201004,수인분당선,미금,5554,6028,11582
13252,20201004,수인분당선,정자,5589,5874,11463
13253,20201004,수인분당선,수내,4965,4825,9790
13254,20201004,수인분당선,서현,10463,10481,20944
13255,20201004,수인분당선,야탑,10856,10554,21410
13256,20201004,수인분당선,모란,12351,12905,25256
13257,20201004,수인분당선,태평,6589,6319,12908
13258,20201004,수인분당선,가천대,2666,3523,6189
13259,20201004,수인분당선,선정릉,1535,1665,3200
13260,20201004,수인분당선,강남구청,1966,2381,4347
13261,20201004,수인분당선,압구정로데오,6468,7499,13967
13262,20201004,수인분당선,서울숲,4256,4407,8663
13263,20201004,수인분당선,수원,5111,3935,9046
13264,20201004,수인분당선,수서,6533,5264,11797
13265,20201004,수인분당선,대모산입구,1104,1121,2225
13266,20201004,수인분당선,개포동,1297,1301,2598
13267,20201004,수인분당선,구룡,481,602,1083
13268,20201004,수인분당선,도곡,1905,1866,3771
13269,20201004,수인분당선,한티,6334,6209,12543
13270,20201004,수인분당선,선릉,2005,2823,4828
13271,20201005,수인분당선,인천,902,1504,2406
13272,20201005,수인분당선,신포,1561,1529,3090
13273,20201005,수인분당선,숭의,3621,3415,7036
13274,20201005,수인분당선,인하대,5021,4763,9784
13275,20201005,수인분당선,송도,2443,2207,4650
13276,20201005,수인분당선,연수,4147,4108,8255
13277,20201005,수인분당선,원인재,4149,4202,8351
13278,20201005,수인분당선,남동인더스파크,2194,2450,4644
13279,20201005,수인분당선,호구포,3351,3311,6662
13280,20201005,수인분당선,인천논현,5052,5452,10504
13281,20201005,수인분당선,소래포구,5284,4943,10227
13282,20201005,수인분당선,월곶,2325,2159,4484
13283,20201005,수인분당선,달월,82,61,143
13284,20201005,수인분당선,사리,2860,2699,5559
13285,20201005,수인분당선,야목,184,179,363
13286,20201005,수인분당선,어천,458,412,870
13287,20201005,수인분당선,오목천,2007,1921,3928
13288,20201005,수인분당선,고색,2304,2228,4532
13289,20201005,수인분당선,매교,2642,2588,5230
13290,20201005,수인분당선,수원시청,11067,11894,22961
13291,20201005,수인분당선,매탄권선,4228,4019,8247
13292,20201005,수인분당선,망포,12508,12085,24593
13293,20201005,수인분당선,영통,7366,7753,15119
13294,20201005,수인분당선,청명,3909,3726,7635
13295,20201005,수인분당선,상갈,4920,4653,9573
13296,20201005,수인분당선,기흥,8715,8292,17007
13297,20201005,수인분당선,신갈,4212,4104,8316
13298,20201005,수인분당선,구성,4618,4634,9252
13299,20201005,수인분당선,죽전,11875,13370,25245
13300,20201005,수인분당선,보정,2275,1983,4258
13301,20201005,수인분당선,이매,5123,4763,9886
13302,20201005,수인분당선,오리,10787,9365,20152
13303,20201005,수인분당선,미금,14987,16010,30997
13304,20201005,수인분당선,정자,14649,15762,30411
13305,20201005,수인분당선,수내,11816,11965,23781
13306,20201005,수인분당선,서현,22212,22753,44965
13307,20201005,수인분당선,야탑,23995,24988,48983
13308,20201005,수인분당선,모란,18324,18600,36924
13309,20201005,수인분당선,태평,12778,12528,25306
13310,20201005,수인분당선,가천대,7499,8415,15914
13311,20201005,수인분당선,선정릉,7785,8412,16197
13312,20201005,수인분당선,강남구청,8679,9899,18578
13313,20201005,수인분당선,압구정로데오,14854,16398,31252
13314,20201005,수인분당선,서울숲,8365,8419,16784
13315,20201005,수인분당선,수원,7394,5892,13286
13316,20201005,수인분당선,수서,12963,11732,24695
13317,20201005,수인분당선,대모산입구,3362,3079,6441
13318,20201005,수인분당선,개포동,3125,3264,6389
13319,20201005,수인분당선,구룡,1689,1716,3405
13320,20201005,수인분당선,도곡,6264,6340,12604
13321,20201005,수인분당선,한티,12252,13360,25612
13322,20201005,수인분당선,선릉,12967,19753,32720
13323,20201006,수인분당선,선릉,13299,20177,33476
13324,20201006,수인분당선,한티,12721,13822,26543
13325,20201006,수인분당선,도곡,6312,6382,12694
13326,20201006,수인분당선,구룡,1674,1670,3344
13327,20201006,수인분당선,개포동,3369,3396,6765
13328,20201006,수인분당선,대모산입구,3419,3117,6536
13329,20201006,수인분당선,수서,11998,12227,24225
13330,20201006,수인분당선,수원,7510,5904,13414
13331,20201006,수인분당선,서울숲,8886,8834,17720
13332,20201006,수인분당선,압구정로데오,16190,18247,34437
13333,20201006,수인분당선,강남구청,9393,10846,20239
13334,20201006,수인분당선,선정릉,8065,8679,16744
13335,20201006,수인분당선,가천대,7693,8516,16209
13336,20201006,수인분당선,태평,12775,12388,25163
13337,20201006,수인분당선,모란,18944,18798,37742
13338,20201006,수인분당선,야탑,24283,25472,49755
13339,20201006,수인분당선,서현,22874,23421,46295
13340,20201006,수인분당선,수내,12253,12314,24567
13341,20201006,수인분당선,정자,15597,16788,32385
13342,20201006,수인분당선,미금,15025,16237,31262
13343,20201006,수인분당선,오리,11174,9470,20644
13344,20201006,수인분당선,이매,5265,4850,10115
13345,20201006,수인분당선,보정,2293,1984,4277
13346,20201006,수인분당선,죽전,12552,13695,26247
13347,20201006,수인분당선,구성,4690,4963,9653
13348,20201006,수인분당선,신갈,4336,4227,8563
13349,20201006,수인분당선,기흥,8860,8395,17255
13350,20201006,수인분당선,상갈,5004,4801,9805
13351,20201006,수인분당선,청명,4002,3865,7867
13352,20201006,수인분당선,영통,7507,7853,15360
13353,20201006,수인분당선,망포,12826,12189,25015
13354,20201006,수인분당선,매탄권선,4316,4187,8503
13355,20201006,수인분당선,수원시청,11076,12135,23211
13356,20201006,수인분당선,매교,2687,2722,5409
13357,20201006,수인분당선,고색,2436,2346,4782
13358,20201006,수인분당선,오목천,2071,1891,3962
13359,20201006,수인분당선,어천,445,415,860
13360,20201006,수인분당선,야목,167,179,346
13361,20201006,수인분당선,사리,2882,2806,5688
13362,20201006,수인분당선,달월,86,61,147
13363,20201006,수인분당선,월곶,2406,2231,4637
13364,20201006,수인분당선,소래포구,5650,5421,11071
13365,20201006,수인분당선,인천논현,5145,5452,10597
13366,20201006,수인분당선,호구포,3445,3506,6951
13367,20201006,수인분당선,남동인더스파크,2315,2528,4843
13368,20201006,수인분당선,원인재,4249,4354,8603
13369,20201006,수인분당선,연수,4204,4274,8478
13370,20201006,수인분당선,송도,2542,2275,4817
13371,20201006,수인분당선,인하대,5164,4884,10048
13372,20201006,수인분당선,숭의,3777,3563,7340
13373,20201006,수인분당선,신포,1723,1734,3457
13374,20201006,수인분당선,인천,930,1559,2489
13375,20201007,수인분당선,사리,2947,2890,5837
13376,20201007,수인분당선,달월,96,76,172
13377,20201007,수인분당선,월곶,2427,2306,4733
13378,20201007,수인분당선,소래포구,5853,5650,11503
13379,20201007,수인분당선,인천논현,5263,5541,10804
13380,20201007,수인분당선,호구포,3541,3506,7047
13381,20201007,수인분당선,남동인더스파크,2303,2566,4869
13382,20201007,수인분당선,원인재,4246,4372,8618
13383,20201007,수인분당선,연수,4372,4345,8717
13384,20201007,수인분당선,송도,2529,2319,4848
13385,20201007,수인분당선,인하대,5231,4889,10120
13386,20201007,수인분당선,숭의,3803,3558,7361
13387,20201007,수인분당선,신포,1661,1685,3346
13388,20201007,수인분당선,인천,970,1626,2596
13389,20201007,수인분당선,선릉,13209,20194,33403
13390,20201007,수인분당선,한티,13081,14168,27249
13391,20201007,수인분당선,도곡,6313,6495,12808
13392,20201007,수인분당선,구룡,1758,1736,3494
13393,20201007,수인분당선,개포동,3467,3583,7050
13394,20201007,수인분당선,대모산입구,3376,3165,6541
13395,20201007,수인분당선,수서,12392,12508,24900
13396,20201007,수인분당선,복정,1,0,1
13397,20201007,수인분당선,수원,7641,6045,13686
13398,20201007,수인분당선,서울숲,8957,9180,18137
13399,20201007,수인분당선,압구정로데오,16110,18306,34416
13400,20201007,수인분당선,강남구청,9481,10933,20414
13401,20201007,수인분당선,선정릉,7886,8577,16463
13402,20201007,수인분당선,가천대,7854,8796,16650
13403,20201007,수인분당선,태평,12835,12390,25225
13404,20201007,수인분당선,모란,18761,18869,37630
13405,20201007,수인분당선,야탑,24830,26034,50864
13406,20201007,수인분당선,서현,23032,23839,46871
13407,20201007,수인분당선,수내,12367,12484,24851
13408,20201007,수인분당선,정자,15626,16654,32280
13409,20201007,수인분당선,미금,15117,16128,31245
13410,20201007,수인분당선,오리,11327,9602,20929
13411,20201007,수인분당선,이매,5298,4936,10234
13412,20201007,수인분당선,보정,2409,2083,4492
13413,20201007,수인분당선,죽전,12703,13978,26681
13414,20201007,수인분당선,구성,4691,4774,9465
13415,20201007,수인분당선,신갈,4329,4192,8521
13416,20201007,수인분당선,기흥,9147,8634,17781
13417,20201007,수인분당선,상갈,5121,4897,10018
13418,20201007,수인분당선,청명,4075,3853,7928
13419,20201007,수인분당선,영통,7671,7976,15647
13420,20201007,수인분당선,망포,12992,12195,25187
13421,20201007,수인분당선,매탄권선,4390,4241,8631
13422,20201007,수인분당선,수원시청,11281,12321,23602
13423,20201007,수인분당선,매교,2697,2707,5404
13424,20201007,수인분당선,고색,2496,2458,4954
13425,20201007,수인분당선,오목천,2201,1959,4160
13426,20201007,수인분당선,어천,444,402,846
13427,20201007,수인분당선,야목,181,175,356
13428,20201008,수인분당선,인천,1050,1800,2850
13429,20201008,수인분당선,신포,1729,1775,3504
13430,20201008,수인분당선,숭의,3885,3539,7424
13431,20201008,수인분당선,인하대,5477,5088,10565
13432,20201008,수인분당선,송도,2666,2373,5039
13433,20201008,수인분당선,연수,4430,4308,8738
13434,20201008,수인분당선,원인재,4358,4570,8928
13435,20201008,수인분당선,남동인더스파크,2309,2534,4843
13436,20201008,수인분당선,호구포,3623,3484,7107
13437,20201008,수인분당선,인천논현,5379,5785,11164
13438,20201008,수인분당선,소래포구,6204,6136,12340
13439,20201008,수인분당선,월곶,2484,2298,4782
13440,20201008,수인분당선,달월,91,73,164
13441,20201008,수인분당선,사리,3200,3023,6223
13442,20201008,수인분당선,야목,197,184,381
13443,20201008,수인분당선,어천,499,447,946
13444,20201008,수인분당선,오목천,2311,2005,4316
13445,20201008,수인분당선,고색,2686,2560,5246
13446,20201008,수인분당선,매교,2696,2682,5378
13447,20201008,수인분당선,수원시청,11657,13764,25421
13448,20201008,수인분당선,매탄권선,4705,4343,9048
13449,20201008,수인분당선,망포,14082,12943,27025
13450,20201008,수인분당선,영통,8224,8548,16772
13451,20201008,수인분당선,청명,4406,3871,8277
13452,20201008,수인분당선,상갈,5273,5008,10281
13453,20201008,수인분당선,기흥,9444,8946,18390
13454,20201008,수인분당선,신갈,4415,4319,8734
13455,20201008,수인분당선,구성,5024,4995,10019
13456,20201008,수인분당선,죽전,13807,14607,28414
13457,20201008,수인분당선,보정,2503,2133,4636
13458,20201008,수인분당선,이매,5409,5020,10429
13459,20201008,수인분당선,오리,11816,9898,21714
13460,20201008,수인분당선,미금,15618,16665,32283
13461,20201008,수인분당선,정자,16262,17715,33977
13462,20201008,수인분당선,수내,12497,12587,25084
13463,20201008,수인분당선,서현,24216,24911,49127
13464,20201008,수인분당선,야탑,25722,27044,52766
13465,20201008,수인분당선,모란,19756,19762,39518
13466,20201008,수인분당선,태평,13300,12570,25870
13467,20201008,수인분당선,가천대,8059,8755,16814
13468,20201008,수인분당선,선정릉,8032,8646,16678
13469,20201008,수인분당선,강남구청,9912,11390,21302
13470,20201008,수인분당선,압구정로데오,17246,20655,37901
13471,20201008,수인분당선,서울숲,9323,9405,18728
13472,20201008,수인분당선,수원,8185,6617,14802
13473,20201008,수인분당선,복정,2,0,2
13474,20201008,수인분당선,수서,13688,14495,28183
13475,20201008,수인분당선,대모산입구,3478,3169,6647
13476,20201008,수인분당선,개포동,3487,3509,6996
13477,20201008,수인분당선,구룡,1877,1750,3627
13478,20201008,수인분당선,도곡,6563,6447,13010
13479,20201008,수인분당선,한티,13499,14641,28140
13480,20201008,수인분당선,선릉,13539,20724,34263
13481,20201009,수인분당선,선릉,4025,6236,10261
13482,20201009,수인분당선,한티,8135,8336,16471
13483,20201009,수인분당선,도곡,3684,3208,6892
13484,20201009,수인분당선,구룡,1054,1004,2058
13485,20201009,수인분당선,개포동,2104,1919,4023
13486,20201009,수인분당선,대모산입구,2008,1872,3880
13487,20201009,수인분당선,수서,8029,9014,17043
13488,20201009,수인분당선,수원,6800,5322,12122
13489,20201009,수인분당선,서울숲,7254,7721,14975
13490,20201009,수인분당선,압구정로데오,12511,15310,27821
13491,20201009,수인분당선,강남구청,3984,4899,8883
13492,20201009,수인분당선,선정릉,2786,2808,5594
13493,20201009,수인분당선,가천대,4640,4921,9561
13494,20201009,수인분당선,태평,9102,8330,17432
13495,20201009,수인분당선,모란,19191,19883,39074
13496,20201009,수인분당선,야탑,14628,15205,29833
13497,20201009,수인분당선,서현,14507,14742,29249
13498,20201009,수인분당선,수내,6999,6700,13699
13499,20201009,수인분당선,정자,9079,9457,18536
13500,20201009,수인분당선,미금,8983,9351,18334
13501,20201009,수인분당선,오리,6339,5167,11506
13502,20201009,수인분당선,이매,3273,3084,6357
13503,20201009,수인분당선,보정,1295,1088,2383
13504,20201009,수인분당선,죽전,9055,10066,19121
13505,20201009,수인분당선,구성,2827,2804,5631
13506,20201009,수인분당선,신갈,2226,2315,4541
13507,20201009,수인분당선,기흥,5697,5404,11101
13508,20201009,수인분당선,상갈,3456,3405,6861
13509,20201009,수인분당선,청명,2290,2167,4457
13510,20201009,수인분당선,영통,5390,5340,10730
13511,20201009,수인분당선,망포,7648,6799,14447
13512,20201009,수인분당선,매탄권선,2877,2566,5443
13513,20201009,수인분당선,수원시청,7885,9315,17200
13514,20201009,수인분당선,매교,1592,1677,3269
13515,20201009,수인분당선,고색,1605,1683,3288
13516,20201009,수인분당선,오목천,1627,1480,3107
13517,20201009,수인분당선,어천,415,420,835
13518,20201009,수인분당선,야목,177,191,368
13519,20201009,수인분당선,사리,2692,2273,4965
13520,20201009,수인분당선,달월,59,67,126
13521,20201009,수인분당선,월곶,2041,1849,3890
13522,20201009,수인분당선,소래포구,7754,8045,15799
13523,20201009,수인분당선,인천논현,3505,3751,7256
13524,20201009,수인분당선,호구포,2063,1990,4053
13525,20201009,수인분당선,남동인더스파크,928,923,1851
13526,20201009,수인분당선,원인재,2996,3088,6084
13527,20201009,수인분당선,연수,3142,3106,6248
13528,20201009,수인분당선,송도,1977,1793,3770
13529,20201009,수인분당선,인하대,3632,3278,6910
13530,20201009,수인분당선,숭의,2260,2066,4326
13531,20201009,수인분당선,신포,1282,1320,2602
13532,20201009,수인분당선,인천,1388,2388,3776
13533,20201010,수인분당선,선릉,4368,6624,10992
13534,20201010,수인분당선,한티,10153,9859,20012
13535,20201010,수인분당선,도곡,3532,3325,6857
13536,20201010,수인분당선,구룡,942,895,1837
13537,20201010,수인분당선,개포동,2117,2103,4220
13538,20201010,수인분당선,대모산입구,2416,2218,4634
13539,20201010,수인분당선,수서,8231,8158,16389
13540,20201010,수인분당선,수원,6798,5356,12154
13541,20201010,수인분당선,서울숲,6968,7210,14178
13542,20201010,수인분당선,압구정로데오,13116,15984,29100
13543,20201010,수인분당선,강남구청,4228,5233,9461
13544,20201010,수인분당선,선정릉,2971,3090,6061
13545,20201010,수인분당선,가천대,4591,4757,9348
13546,20201010,수인분당선,태평,9242,8737,17979
13547,20201010,수인분당선,모란,13590,13908,27498
13548,20201010,수인분당선,야탑,15147,15707,30854
13549,20201010,수인분당선,서현,15492,16198,31690
13550,20201010,수인분당선,수내,7601,7271,14872
13551,20201010,수인분당선,정자,9460,9661,19121
13552,20201010,수인분당선,미금,9901,10187,20088
13553,20201010,수인분당선,오리,6586,5545,12131
13554,20201010,수인분당선,이매,3225,3197,6422
13555,20201010,수인분당선,보정,1415,1250,2665
13556,20201010,수인분당선,죽전,9002,10141,19143
13557,20201010,수인분당선,구성,2885,2953,5838
13558,20201010,수인분당선,신갈,2476,2437,4913
13559,20201010,수인분당선,기흥,5979,5509,11488
13560,20201010,수인분당선,상갈,3400,3414,6814
13561,20201010,수인분당선,청명,2301,2160,4461
13562,20201010,수인분당선,영통,5771,5751,11522
13563,20201010,수인분당선,망포,7432,6910,14342
13564,20201010,수인분당선,매탄권선,2845,2581,5426
13565,20201010,수인분당선,수원시청,8728,9829,18557
13566,20201010,수인분당선,매교,1641,1724,3365
13567,20201010,수인분당선,고색,1572,1652,3224
13568,20201010,수인분당선,오목천,1541,1337,2878
13569,20201010,수인분당선,어천,482,440,922
13570,20201010,수인분당선,야목,200,182,382
13571,20201010,수인분당선,사리,2643,2375,5018
13572,20201010,수인분당선,달월,50,57,107
13573,20201010,수인분당선,월곶,2130,1876,4006
13574,20201010,수인분당선,소래포구,7025,7374,14399
13575,20201010,수인분당선,인천논현,3804,3960,7764
13576,20201010,수인분당선,호구포,2030,2006,4036
13577,20201010,수인분당선,남동인더스파크,918,853,1771
13578,20201010,수인분당선,원인재,3198,3227,6425
13579,20201010,수인분당선,연수,3427,3436,6863
13580,20201010,수인분당선,송도,1907,1794,3701
13581,20201010,수인분당선,인하대,3680,3322,7002
13582,20201010,수인분당선,숭의,2421,2200,4621
13583,20201010,수인분당선,신포,1332,1355,2687
13584,20201010,수인분당선,인천,1219,2058,3277
13585,20201011,수인분당선,인천,978,1519,2497
13586,20201011,수인분당선,신포,1081,1019,2100
13587,20201011,수인분당선,숭의,1697,1595,3292
13588,20201011,수인분당선,인하대,2604,2594,5198
13589,20201011,수인분당선,송도,1471,1409,2880
13590,20201011,수인분당선,연수,2656,2567,5223
13591,20201011,수인분당선,원인재,2487,2475,4962
13592,20201011,수인분당선,남동인더스파크,632,619,1251
13593,20201011,수인분당선,호구포,1502,1500,3002
13594,20201011,수인분당선,인천논현,2580,2589,5169
13595,20201011,수인분당선,소래포구,6042,5980,12022
13596,20201011,수인분당선,월곶,1556,1497,3053
13597,20201011,수인분당선,달월,60,69,129
13598,20201011,수인분당선,사리,1943,1771,3714
13599,20201011,수인분당선,야목,155,151,306
13600,20201011,수인분당선,어천,335,364,699
13601,20201011,수인분당선,오목천,1123,1103,2226
13602,20201011,수인분당선,고색,1125,1189,2314
13603,20201011,수인분당선,매교,1148,1168,2316
13604,20201011,수인분당선,수원시청,5829,5963,11792
13605,20201011,수인분당선,매탄권선,2008,1941,3949
13606,20201011,수인분당선,망포,5146,5297,10443
13607,20201011,수인분당선,영통,3800,3831,7631
13608,20201011,수인분당선,청명,1529,1601,3130
13609,20201011,수인분당선,상갈,2438,2421,4859
13610,20201011,수인분당선,기흥,4129,3975,8104
13611,20201011,수인분당선,신갈,1575,1684,3259
13612,20201011,수인분당선,구성,1888,2075,3963
13613,20201011,수인분당선,죽전,6621,7327,13948
13614,20201011,수인분당선,보정,841,815,1656
13615,20201011,수인분당선,이매,2367,2394,4761
13616,20201011,수인분당선,오리,4753,4166,8919
13617,20201011,수인분당선,미금,6098,6582,12680
13618,20201011,수인분당선,정자,6195,6439,12634
13619,20201011,수인분당선,수내,5216,5053,10269
13620,20201011,수인분당선,서현,10914,10885,21799
13621,20201011,수인분당선,야탑,11006,11429,22435
13622,20201011,수인분당선,모란,9618,9905,19523
13623,20201011,수인분당선,태평,6809,6405,13214
13624,20201011,수인분당선,가천대,3198,3841,7039
13625,20201011,수인분당선,선정릉,1845,1888,3733
13626,20201011,수인분당선,강남구청,2522,2912,5434
13627,20201011,수인분당선,압구정로데오,7274,8348,15622
13628,20201011,수인분당선,서울숲,4830,4971,9801
13629,20201011,수인분당선,수원,5174,4148,9322
13630,20201011,수인분당선,수서,7289,7014,14303
13631,20201011,수인분당선,대모산입구,1645,1621,3266
13632,20201011,수인분당선,개포동,1400,1430,2830
13633,20201011,수인분당선,구룡,614,646,1260
13634,20201011,수인분당선,도곡,1990,2002,3992
13635,20201011,수인분당선,한티,6849,6738,13587
13636,20201011,수인분당선,선릉,2477,3510,5987
13637,20201012,수인분당선,연수,4344,4225,8569
13638,20201012,수인분당선,원인재,4156,4325,8481
13639,20201012,수인분당선,남동인더스파크,2242,2544,4786
13640,20201012,수인분당선,호구포,3558,3544,7102
13641,20201012,수인분당선,인천논현,5275,5620,10895
13642,20201012,수인분당선,소래포구,5808,5623,11431
13643,20201012,수인분당선,월곶,2449,2255,4704
13644,20201012,수인분당선,달월,82,55,137
13645,20201012,수인분당선,사리,3020,2805,5825
13646,20201012,수인분당선,선릉,13641,20793,34434
13647,20201012,수인분당선,한티,12907,13924,26831
13648,20201012,수인분당선,도곡,6451,6547,12998
13649,20201012,수인분당선,구룡,1753,1767,3520
13650,20201012,수인분당선,개포동,3397,3473,6870
13651,20201012,수인분당선,대모산입구,3459,3123,6582
13652,20201012,수인분당선,수서,12802,13139,25941
13653,20201012,수인분당선,복정,1,0,1
13654,20201012,수인분당선,수원,7792,6309,14101
13655,20201012,수인분당선,서울숲,8804,8891,17695
13656,20201012,수인분당선,압구정로데오,14693,16449,31142
13657,20201012,수인분당선,강남구청,9289,10734,20023
13658,20201012,수인분당선,선정릉,7908,8476,16384
13659,20201012,수인분당선,가천대,7979,9089,17068
13660,20201012,수인분당선,태평,13118,12669,25787
13661,20201012,수인분당선,모란,19118,19282,38400
13662,20201012,수인분당선,야탑,24837,26186,51023
13663,20201012,수인분당선,서현,23477,23819,47296
13664,20201012,수인분당선,수내,12325,12347,24672
13665,20201012,수인분당선,정자,15516,16812,32328
13666,20201012,수인분당선,미금,15372,16351,31723
13667,20201012,수인분당선,오리,11518,9865,21383
13668,20201012,수인분당선,이매,5259,4969,10228
13669,20201012,수인분당선,보정,2526,2104,4630
13670,20201012,수인분당선,죽전,12739,13990,26729
13671,20201012,수인분당선,구성,4842,4985,9827
13672,20201012,수인분당선,신갈,4458,4368,8826
13673,20201012,수인분당선,기흥,9171,8676,17847
13674,20201012,수인분당선,상갈,5221,4956,10177
13675,20201012,수인분당선,청명,4102,3892,7994
13676,20201012,수인분당선,영통,7684,8062,15746
13677,20201012,수인분당선,망포,12961,12597,25558
13678,20201012,수인분당선,매탄권선,4481,4265,8746
13679,20201012,수인분당선,수원시청,11403,12127,23530
13680,20201012,수인분당선,매교,2678,2674,5352
13681,20201012,수인분당선,고색,2521,2415,4936
13682,20201012,수인분당선,오목천,2204,1996,4200
13683,20201012,수인분당선,어천,464,420,884
13684,20201012,수인분당선,야목,182,182,364
13685,20201012,수인분당선,송도,2543,2288,4831
13686,20201012,수인분당선,인하대,5345,5037,10382
13687,20201012,수인분당선,숭의,3849,3590,7439
13688,20201012,수인분당선,신포,1727,1646,3373
13689,20201012,수인분당선,인천,975,1629,2604
13690,20201013,수인분당선,인천,958,1612,2570
13691,20201013,수인분당선,신포,1834,1833,3667
13692,20201013,수인분당선,숭의,3893,3641,7534
13693,20201013,수인분당선,인하대,5395,5131,10526
13694,20201013,수인분당선,송도,2561,2268,4829
13695,20201013,수인분당선,연수,4391,4428,8819
13696,20201013,수인분당선,원인재,4411,4471,8882
13697,20201013,수인분당선,남동인더스파크,2303,2557,4860
13698,20201013,수인분당선,호구포,3588,3609,7197
13699,20201013,수인분당선,인천논현,5278,5685,10963
13700,20201013,수인분당선,소래포구,6546,6336,12882
13701,20201013,수인분당선,월곶,2490,2301,4791
13702,20201013,수인분당선,달월,85,67,152
13703,20201013,수인분당선,사리,3154,2956,6110
13704,20201013,수인분당선,야목,197,185,382
13705,20201013,수인분당선,어천,509,457,966
13706,20201013,수인분당선,오목천,2237,2076,4313
13707,20201013,수인분당선,고색,2584,2486,5070
13708,20201013,수인분당선,매교,2751,2837,5588
13709,20201013,수인분당선,수원시청,11559,12526,24085
13710,20201013,수인분당선,매탄권선,4488,4325,8813
13711,20201013,수인분당선,망포,13538,12773,26311
13712,20201013,수인분당선,영통,7812,8240,16052
13713,20201013,수인분당선,청명,4219,4072,8291
13714,20201013,수인분당선,상갈,5300,4982,10282
13715,20201013,수인분당선,기흥,9351,8881,18232
13716,20201013,수인분당선,신갈,4500,4464,8964
13717,20201013,수인분당선,구성,4956,5062,10018
13718,20201013,수인분당선,죽전,13199,14311,27510
13719,20201013,수인분당선,보정,2538,2236,4774
13720,20201013,수인분당선,이매,5576,5204,10780
13721,20201013,수인분당선,오리,11679,9949,21628
13722,20201013,수인분당선,미금,15482,16593,32075
13723,20201013,수인분당선,정자,16081,17311,33392
13724,20201013,수인분당선,수내,12705,12783,25488
13725,20201013,수인분당선,서현,23778,24172,47950
13726,20201013,수인분당선,야탑,25425,26550,51975
13727,20201013,수인분당선,모란,19527,19626,39153
13728,20201013,수인분당선,태평,13268,12838,26106
13729,20201013,수인분당선,가천대,8269,9424,17693
13730,20201013,수인분당선,선정릉,8188,8810,16998
13731,20201013,수인분당선,강남구청,9535,10957,20492
13732,20201013,수인분당선,압구정로데오,16349,18668,35017
13733,20201013,수인분당선,서울숲,9213,9150,18363
13734,20201013,수인분당선,수원,7968,6293,14261
13735,20201013,수인분당선,수서,12821,13182,26003
13736,20201013,수인분당선,대모산입구,3486,3267,6753
13737,20201013,수인분당선,개포동,3489,3606,7095
13738,20201013,수인분당선,구룡,1797,1786,3583
13739,20201013,수인분당선,도곡,6414,6565,12979
13740,20201013,수인분당선,한티,13185,14172,27357
13741,20201013,수인분당선,선릉,13796,20934,34730
13742,20201014,수인분당선,신갈,4555,4540,9095
13743,20201014,수인분당선,기흥,9282,8880,18162
13744,20201014,수인분당선,상갈,5403,5164,10567
13745,20201014,수인분당선,청명,4392,4090,8482
13746,20201014,수인분당선,영통,8004,7000,15004
13747,20201014,수인분당선,망포,13615,13069,26684
13748,20201014,수인분당선,매탄권선,4550,4415,8965
13749,20201014,수인분당선,수원시청,11908,12928,24836
13750,20201014,수인분당선,매교,2907,2900,5807
13751,20201014,수인분당선,고색,2713,2574,5287
13752,20201014,수인분당선,오목천,2334,2087,4421
13753,20201014,수인분당선,어천,507,495,1002
13754,20201014,수인분당선,야목,192,165,357
13755,20201014,수인분당선,사리,3179,2935,6114
13756,20201014,수인분당선,달월,92,62,154
13757,20201014,수인분당선,월곶,2457,2329,4786
13758,20201014,수인분당선,소래포구,6651,6284,12935
13759,20201014,수인분당선,인천논현,5418,5801,11219
13760,20201014,수인분당선,호구포,3613,3643,7256
13761,20201014,수인분당선,남동인더스파크,2385,2665,5050
13762,20201014,수인분당선,원인재,4262,4402,8664
13763,20201014,수인분당선,연수,4422,4407,8829
13764,20201014,수인분당선,송도,2565,2311,4876
13765,20201014,수인분당선,인하대,5507,5090,10597
13766,20201014,수인분당선,숭의,3888,3547,7435
13767,20201014,수인분당선,신포,1782,1780,3562
13768,20201014,수인분당선,인천,953,1699,2652
13769,20201014,수인분당선,선릉,13887,20963,34850
13770,20201014,수인분당선,한티,13316,14299,27615
13771,20201014,수인분당선,도곡,6548,6704,13252
13772,20201014,수인분당선,구룡,1854,1846,3700
13773,20201014,수인분당선,개포동,3619,3712,7331
13774,20201014,수인분당선,대모산입구,3676,3399,7075
13775,20201014,수인분당선,수서,13409,13689,27098
13776,20201014,수인분당선,수원,7983,6303,14286
13777,20201014,수인분당선,서울숲,9040,9106,18146
13778,20201014,수인분당선,압구정로데오,16304,18644,34948
13779,20201014,수인분당선,강남구청,9707,11104,20811
13780,20201014,수인분당선,선정릉,8277,8836,17113
13781,20201014,수인분당선,가천대,8469,9538,18007
13782,20201014,수인분당선,태평,13514,13107,26621
13783,20201014,수인분당선,모란,25193,25626,50819
13784,20201014,수인분당선,야탑,25934,27283,53217
13785,20201014,수인분당선,서현,23897,24665,48562
13786,20201014,수인분당선,수내,12807,12845,25652
13787,20201014,수인분당선,정자,16421,17632,34053
13788,20201014,수인분당선,미금,15889,17060,32949
13789,20201014,수인분당선,오리,11999,10058,22057
13790,20201014,수인분당선,이매,5679,5219,10898
13791,20201014,수인분당선,보정,2526,2159,4685
13792,20201014,수인분당선,죽전,13228,14484,27712
13793,20201014,수인분당선,구성,4945,5133,10078
13794,20201015,수인분당선,선릉,13535,20830,34365
13795,20201015,수인분당선,한티,13267,14240,27507
13796,20201015,수인분당선,도곡,6572,6596,13168
13797,20201015,수인분당선,구룡,1846,1763,3609
13798,20201015,수인분당선,개포동,3551,3628,7179
13799,20201015,수인분당선,대모산입구,3477,3269,6746
13800,20201015,수인분당선,수서,13425,13859,27284
13801,20201015,수인분당선,수원,7869,6415,14284
13802,20201015,수인분당선,서울숲,9109,9104,18213
13803,20201015,수인분당선,압구정로데오,16460,18818,35278
13804,20201015,수인분당선,강남구청,9510,11061,20571
13805,20201015,수인분당선,선정릉,8252,8909,17161
13806,20201015,수인분당선,가천대,8251,9180,17431
13807,20201015,수인분당선,태평,13288,12808,26096
13808,20201015,수인분당선,모란,19498,19486,38984
13809,20201015,수인분당선,야탑,25513,26551,52064
13810,20201015,수인분당선,서현,23788,24302,48090
13811,20201015,수인분당선,수내,12691,12889,25580
13812,20201015,수인분당선,정자,16210,17405,33615
13813,20201015,수인분당선,미금,14517,15517,30034
13814,20201015,수인분당선,오리,11802,10121,21923
13815,20201015,수인분당선,이매,5603,5308,10911
13816,20201015,수인분당선,보정,2505,2133,4638
13817,20201015,수인분당선,죽전,13377,14585,27962
13818,20201015,수인분당선,구성,5000,5155,10155
13819,20201015,수인분당선,신갈,4564,4432,8996
13820,20201015,수인분당선,기흥,9414,8870,18284
13821,20201015,수인분당선,상갈,5354,5047,10401
13822,20201015,수인분당선,청명,4243,4023,8266
13823,20201015,수인분당선,영통,7800,5717,13517
13824,20201015,수인분당선,망포,13695,12899,26594
13825,20201015,수인분당선,매탄권선,4640,4406,9046
13826,20201015,수인분당선,수원시청,11539,12656,24195
13827,20201015,수인분당선,매교,2772,2784,5556
13828,20201015,수인분당선,고색,2725,2579,5304
13829,20201015,수인분당선,오목천,2262,2100,4362
13830,20201015,수인분당선,어천,534,500,1034
13831,20201015,수인분당선,야목,200,173,373
13832,20201015,수인분당선,사리,3200,2897,6097
13833,20201015,수인분당선,달월,90,58,148
13834,20201015,수인분당선,월곶,2469,2274,4743
13835,20201015,수인분당선,소래포구,7094,6786,13880
13836,20201015,수인분당선,인천논현,5284,5608,10892
13837,20201015,수인분당선,호구포,3543,3561,7104
13838,20201015,수인분당선,남동인더스파크,2300,2607,4907
13839,20201015,수인분당선,원인재,4311,4515,8826
13840,20201015,수인분당선,연수,4413,4336,8749
13841,20201015,수인분당선,송도,2549,2331,4880
13842,20201015,수인분당선,인하대,5495,5226,10721
13843,20201015,수인분당선,숭의,3845,3631,7476
13844,20201015,수인분당선,신포,1845,1816,3661
13845,20201015,수인분당선,인천,1021,1702,2723
13846,20201016,수인분당선,복정,1,0,1
13847,20201016,수인분당선,인천,1057,1689,2746
13848,20201016,수인분당선,신포,1780,1914,3694
13849,20201016,수인분당선,숭의,3906,3616,7522
13850,20201016,수인분당선,인하대,5703,5311,11014
13851,20201016,수인분당선,송도,2727,2422,5149
13852,20201016,수인분당선,연수,4649,4707,9356
13853,20201016,수인분당선,원인재,4522,4734,9256
13854,20201016,수인분당선,남동인더스파크,2358,2570,4928
13855,20201016,수인분당선,호구포,3707,3617,7324
13856,20201016,수인분당선,인천논현,5507,5983,11490
13857,20201016,수인분당선,소래포구,7198,7160,14358
13858,20201016,수인분당선,월곶,2620,2368,4988
13859,20201016,수인분당선,달월,77,58,135
13860,20201016,수인분당선,사리,3308,3060,6368
13861,20201016,수인분당선,야목,211,178,389
13862,20201016,수인분당선,어천,583,519,1102
13863,20201016,수인분당선,오목천,2401,2020,4421
13864,20201016,수인분당선,고색,2732,2677,5409
13865,20201016,수인분당선,매교,2896,2865,5761
13866,20201016,수인분당선,수원시청,12378,15076,27454
13867,20201016,수인분당선,매탄권선,4953,4571,9524
13868,20201016,수인분당선,망포,15024,13585,28609
13869,20201016,수인분당선,영통,8645,8735,17380
13870,20201016,수인분당선,청명,4428,4061,8489
13871,20201016,수인분당선,상갈,5583,5365,10948
13872,20201016,수인분당선,기흥,9657,9305,18962
13873,20201016,수인분당선,신갈,4667,4401,9068
13874,20201016,수인분당선,구성,5059,5275,10334
13875,20201016,수인분당선,죽전,14104,15022,29126
13876,20201016,수인분당선,보정,2583,2176,4759
13877,20201016,수인분당선,이매,5763,5345,11108
13878,20201016,수인분당선,오리,12190,10238,22428
13879,20201016,수인분당선,미금,15975,16791,32766
13880,20201016,수인분당선,정자,16902,18288,35190
13881,20201016,수인분당선,수내,13210,13412,26622
13882,20201016,수인분당선,서현,25139,26013,51152
13883,20201016,수인분당선,야탑,26221,27670,53891
13884,20201016,수인분당선,모란,20433,20530,40963
13885,20201016,수인분당선,태평,13390,12974,26364
13886,20201016,수인분당선,가천대,8045,8589,16634
13887,20201016,수인분당선,선정릉,8200,8848,17048
13888,20201016,수인분당선,강남구청,9807,11317,21124
13889,20201016,수인분당선,압구정로데오,17895,21638,39533
13890,20201016,수인분당선,서울숲,9313,9296,18609
13891,20201016,수인분당선,수원,8710,7314,16024
13892,20201016,수인분당선,수서,14778,15250,30028
13893,20201016,수인분당선,대모산입구,3527,3204,6731
13894,20201016,수인분당선,개포동,3715,3754,7469
13895,20201016,수인분당선,구룡,1653,1598,3251
13896,20201016,수인분당선,도곡,6521,6548,13069
13897,20201016,수인분당선,한티,13830,14810,28640
13898,20201016,수인분당선,선릉,13666,20892,34558
13899,20201017,수인분당선,인천,1177,1947,3124
13900,20201017,수인분당선,선릉,5390,8125,13515
13901,20201017,수인분당선,한티,11569,11183,22752
13902,20201017,수인분당선,도곡,4339,3990,8329
13903,20201017,수인분당선,구룡,1716,1537,3253
13904,20201017,수인분당선,개포동,2513,2450,4963
13905,20201017,수인분당선,대모산입구,2566,2311,4877
13906,20201017,수인분당선,수서,9807,9985,19792
13907,20201017,수인분당선,수원,7616,6373,13989
13908,20201017,수인분당선,서울숲,7560,7908,15468
13909,20201017,수인분당선,압구정로데오,14993,18406,33399
13910,20201017,수인분당선,강남구청,5087,6212,11299
13911,20201017,수인분당선,선정릉,3736,3737,7473
13912,20201017,수인분당선,가천대,5550,5788,11338
13913,20201017,수인분당선,태평,10368,9758,20126
13914,20201017,수인분당선,모란,15553,15745,31298
13915,20201017,수인분당선,야탑,17458,18492,35950
13916,20201017,수인분당선,서현,16724,17061,33785
13917,20201017,수인분당선,수내,8690,8311,17001
13918,20201017,수인분당선,정자,10775,10629,21404
13919,20201017,수인분당선,미금,10540,10933,21473
13920,20201017,수인분당선,오리,7751,6216,13967
13921,20201017,수인분당선,이매,3940,3734,7674
13922,20201017,수인분당선,보정,1516,1408,2924
13923,20201017,수인분당선,죽전,10057,11171,21228
13924,20201017,수인분당선,구성,3192,3217,6409
13925,20201017,수인분당선,신갈,2891,2847,5738
13926,20201017,수인분당선,기흥,6496,6026,12522
13927,20201017,수인분당선,상갈,3669,3659,7328
13928,20201017,수인분당선,청명,2661,2453,5114
13929,20201017,수인분당선,영통,6120,6271,12391
13930,20201017,수인분당선,망포,8950,8002,16952
13931,20201017,수인분당선,매탄권선,3429,3144,6573
13932,20201017,수인분당선,수원시청,10338,12091,22429
13933,20201017,수인분당선,매교,1892,1946,3838
13934,20201017,수인분당선,고색,1993,1937,3930
13935,20201017,수인분당선,오목천,1923,1606,3529
13936,20201017,수인분당선,어천,447,437,884
13937,20201017,수인분당선,야목,214,190,404
13938,20201017,수인분당선,사리,2903,2533,5436
13939,20201017,수인분당선,달월,66,64,130
13940,20201017,수인분당선,월곶,2201,2001,4202
13941,20201017,수인분당선,소래포구,7765,8165,15930
13942,20201017,수인분당선,인천논현,4257,4436,8693
13943,20201017,수인분당선,호구포,2373,2240,4613
13944,20201017,수인분당선,남동인더스파크,1027,948,1975
13945,20201017,수인분당선,원인재,3547,3680,7227
13946,20201017,수인분당선,연수,3716,3668,7384
13947,20201017,수인분당선,송도,2263,2042,4305
13948,20201017,수인분당선,인하대,4570,4081,8651
13949,20201017,수인분당선,숭의,2626,2438,5064
13950,20201017,수인분당선,신포,1386,1429,2815
13951,20201018,수인분당선,인하대,3148,3010,6158
13952,20201018,수인분당선,숭의,1833,1752,3585
13953,20201018,수인분당선,신포,1088,1063,2151
13954,20201018,수인분당선,인천,1007,1589,2596
13955,20201018,수인분당선,선릉,2800,4015,6815
13956,20201018,수인분당선,한티,7536,7268,14804
13957,20201018,수인분당선,도곡,2340,2305,4645
13958,20201018,수인분당선,구룡,645,692,1337
13959,20201018,수인분당선,개포동,1858,1909,3767
13960,20201018,수인분당선,대모산입구,1480,1439,2919
13961,20201018,수인분당선,수서,7721,7660,15381
13962,20201018,수인분당선,수원,5712,4766,10478
13963,20201018,수인분당선,서울숲,5386,5566,10952
13964,20201018,수인분당선,압구정로데오,8148,9320,17468
13965,20201018,수인분당선,강남구청,2769,3525,6294
13966,20201018,수인분당선,선정릉,2196,2276,4472
13967,20201018,수인분당선,가천대,3571,4380,7951
13968,20201018,수인분당선,태평,7753,7133,14886
13969,20201018,수인분당선,모란,10783,10777,21560
13970,20201018,수인분당선,야탑,12287,12756,25043
13971,20201018,수인분당선,서현,11653,11708,23361
13972,20201018,수인분당선,수내,5499,5321,10820
13973,20201018,수인분당선,정자,6857,7108,13965
13974,20201018,수인분당선,미금,6605,7168,13773
13975,20201018,수인분당선,오리,5156,4597,9753
13976,20201018,수인분당선,이매,2766,2771,5537
13977,20201018,수인분당선,보정,933,873,1806
13978,20201018,수인분당선,죽전,7684,8484,16168
13979,20201018,수인분당선,구성,2144,2321,4465
13980,20201018,수인분당선,신갈,1876,1867,3743
13981,20201018,수인분당선,기흥,4536,4413,8949
13982,20201018,수인분당선,상갈,2761,2810,5571
13983,20201018,수인분당선,청명,1810,1833,3643
13984,20201018,수인분당선,영통,4485,4516,9001
13985,20201018,수인분당선,망포,5893,6029,11922
13986,20201018,수인분당선,매탄권선,2276,2179,4455
13987,20201018,수인분당선,수원시청,7065,6857,13922
13988,20201018,수인분당선,매교,1380,1407,2787
13989,20201018,수인분당선,고색,1271,1345,2616
13990,20201018,수인분당선,오목천,1343,1300,2643
13991,20201018,수인분당선,어천,408,434,842
13992,20201018,수인분당선,야목,214,204,418
13993,20201018,수인분당선,사리,2078,1910,3988
13994,20201018,수인분당선,달월,37,54,91
13995,20201018,수인분당선,월곶,1682,1565,3247
13996,20201018,수인분당선,소래포구,6636,6501,13137
13997,20201018,수인분당선,인천논현,2817,2850,5667
13998,20201018,수인분당선,호구포,1743,1781,3524
13999,20201018,수인분당선,남동인더스파크,644,662,1306
14000,20201018,수인분당선,원인재,2591,2656,5247
14001,20201018,수인분당선,연수,2795,2745,5540
14002,20201018,수인분당선,송도,1538,1488,3026
14003,20201019,수인분당선,연수,4465,4363,8828
14004,20201019,수인분당선,인천,980,1693,2673
14005,20201019,수인분당선,신포,1800,1756,3556
14006,20201019,수인분당선,숭의,3824,3587,7411
14007,20201019,수인분당선,인하대,5902,5526,11428
14008,20201019,수인분당선,송도,2661,2354,5015
14009,20201019,수인분당선,원인재,4372,4433,8805
14010,20201019,수인분당선,남동인더스파크,2394,2679,5073
14011,20201019,수인분당선,호구포,3655,3642,7297
14012,20201019,수인분당선,인천논현,5479,5759,11238
14013,20201019,수인분당선,소래포구,6243,5908,12151
14014,20201019,수인분당선,월곶,2419,2287,4706
14015,20201019,수인분당선,달월,92,72,164
14016,20201019,수인분당선,사리,3182,2866,6048
14017,20201019,수인분당선,야목,161,154,315
14018,20201019,수인분당선,어천,522,503,1025
14019,20201019,수인분당선,오목천,2522,2327,4849
14020,20201019,수인분당선,고색,2725,2613,5338
14021,20201019,수인분당선,매교,2906,2945,5851
14022,20201019,수인분당선,수원시청,11811,12645,24456
14023,20201019,수인분당선,매탄권선,4731,4437,9168
14024,20201019,수인분당선,망포,13600,13182,26782
14025,20201019,수인분당선,영통,7889,8345,16234
14026,20201019,수인분당선,청명,4354,4084,8438
14027,20201019,수인분당선,상갈,5408,5123,10531
14028,20201019,수인분당선,기흥,9571,8997,18568
14029,20201019,수인분당선,신갈,4641,4564,9205
14030,20201019,수인분당선,구성,5046,5233,10279
14031,20201019,수인분당선,죽전,13291,14647,27938
14032,20201019,수인분당선,보정,2564,2257,4821
14033,20201019,수인분당선,이매,5791,5383,11174
14034,20201019,수인분당선,오리,11915,10056,21971
14035,20201019,수인분당선,미금,15831,16986,32817
14036,20201019,수인분당선,정자,16156,17368,33524
14037,20201019,수인분당선,수내,12625,12655,25280
14038,20201019,수인분당선,서현,24174,24611,48785
14039,20201019,수인분당선,야탑,25605,26706,52311
14040,20201019,수인분당선,모란,24303,25083,49386
14041,20201019,수인분당선,태평,13551,13120,26671
14042,20201019,수인분당선,가천대,10670,11864,22534
14043,20201019,수인분당선,선정릉,8095,8730,16825
14044,20201019,수인분당선,강남구청,9441,10767,20208
14045,20201019,수인분당선,압구정로데오,15214,17035,32249
14046,20201019,수인분당선,서울숲,8801,8901,17702
14047,20201019,수인분당선,수원,7812,6244,14056
14048,20201019,수인분당선,수서,13580,13737,27317
14049,20201019,수인분당선,대모산입구,3603,3384,6987
14050,20201019,수인분당선,개포동,3524,3599,7123
14051,20201019,수인분당선,구룡,1965,1951,3916
14052,20201019,수인분당선,도곡,6795,6787,13582
14053,20201019,수인분당선,한티,13143,14194,27337
14054,20201019,수인분당선,선릉,13630,21001,34631
14055,20201020,수인분당선,인천,999,1755,2754
14056,20201020,수인분당선,신포,1824,1834,3658
14057,20201020,수인분당선,숭의,3890,3684,7574
14058,20201020,수인분당선,인하대,5994,5645,11639
14059,20201020,수인분당선,송도,2622,2336,4958
14060,20201020,수인분당선,연수,4460,4445,8905
14061,20201020,수인분당선,원인재,4479,4597,9076
14062,20201020,수인분당선,남동인더스파크,2447,2705,5152
14063,20201020,수인분당선,호구포,3578,3658,7236
14064,20201020,수인분당선,인천논현,5502,5871,11373
14065,20201020,수인분당선,소래포구,7051,6861,13912
14066,20201020,수인분당선,월곶,2550,2376,4926
14067,20201020,수인분당선,달월,94,66,160
14068,20201020,수인분당선,사리,3339,3171,6510
14069,20201020,수인분당선,야목,196,184,380
14070,20201020,수인분당선,어천,523,496,1019
14071,20201020,수인분당선,오목천,2747,2476,5223
14072,20201020,수인분당선,고색,2830,2713,5543
14073,20201020,수인분당선,매교,2920,2919,5839
14074,20201020,수인분당선,수원시청,11663,12824,24487
14075,20201020,수인분당선,매탄권선,4646,4490,9136
14076,20201020,수인분당선,망포,13906,13145,27051
14077,20201020,수인분당선,영통,7708,8135,15843
14078,20201020,수인분당선,청명,4396,4121,8517
14079,20201020,수인분당선,상갈,5565,5314,10879
14080,20201020,수인분당선,기흥,9826,9191,19017
14081,20201020,수인분당선,신갈,4775,4709,9484
14082,20201020,수인분당선,구성,5118,5263,10381
14083,20201020,수인분당선,죽전,13717,10918,24635
14084,20201020,수인분당선,보정,2663,2246,4909
14085,20201020,수인분당선,이매,5850,5432,11282
14086,20201020,수인분당선,오리,12061,10126,22187
14087,20201020,수인분당선,미금,16075,17183,33258
14088,20201020,수인분당선,정자,16746,18066,34812
14089,20201020,수인분당선,수내,13116,13238,26354
14090,20201020,수인분당선,서현,24022,24741,48763
14091,20201020,수인분당선,야탑,26000,27305,53305
14092,20201020,수인분당선,모란,19905,20078,39983
14093,20201020,수인분당선,태평,13657,13163,26820
14094,20201020,수인분당선,가천대,10696,11670,22366
14095,20201020,수인분당선,선정릉,8212,9021,17233
14096,20201020,수인분당선,강남구청,9773,11266,21039
14097,20201020,수인분당선,압구정로데오,16564,18808,35372
14098,20201020,수인분당선,서울숲,9119,9265,18384
14099,20201020,수인분당선,수원,8007,6473,14480
14100,20201020,수인분당선,복정,1,0,1
14101,20201020,수인분당선,수서,13396,13764,27160
14102,20201020,수인분당선,대모산입구,3569,3368,6937
14103,20201020,수인분당선,개포동,3720,3677,7397
14104,20201020,수인분당선,구룡,1988,2019,4007
14105,20201020,수인분당선,도곡,6681,6806,13487
14106,20201020,수인분당선,한티,13304,14371,27675
14107,20201020,수인분당선,선릉,13956,21320,35276
14108,20201021,수인분당선,선릉,13914,21244,35158
14109,20201021,수인분당선,한티,13566,14663,28229
14110,20201021,수인분당선,도곡,6577,6771,13348
14111,20201021,수인분당선,구룡,2052,1963,4015
14112,20201021,수인분당선,개포동,3833,3936,7769
14113,20201021,수인분당선,대모산입구,3590,3307,6897
14114,20201021,수인분당선,수서,13445,13717,27162
14115,20201021,수인분당선,수원,8228,6622,14850
14116,20201021,수인분당선,서울숲,9185,9167,18352
14117,20201021,수인분당선,압구정로데오,16468,18901,35369
14118,20201021,수인분당선,강남구청,9619,11151,20770
14119,20201021,수인분당선,선정릉,8324,8942,17266
14120,20201021,수인분당선,가천대,10214,11297,21511
14121,20201021,수인분당선,태평,13302,12836,26138
14122,20201021,수인분당선,모란,19897,19766,39663
14123,20201021,수인분당선,야탑,26176,27547,53723
14124,20201021,수인분당선,서현,24261,24828,49089
14125,20201021,수인분당선,수내,13001,13090,26091
14126,20201021,수인분당선,정자,16864,18199,35063
14127,20201021,수인분당선,미금,16095,17153,33248
14128,20201021,수인분당선,오리,11838,10149,21987
14129,20201021,수인분당선,이매,5777,5341,11118
14130,20201021,수인분당선,보정,2706,2265,4971
14131,20201021,수인분당선,죽전,13690,14654,28344
14132,20201021,수인분당선,구성,5026,5275,10301
14133,20201021,수인분당선,신갈,4777,4629,9406
14134,20201021,수인분당선,기흥,9692,9164,18856
14135,20201021,수인분당선,상갈,5528,5322,10850
14136,20201021,수인분당선,청명,4432,4307,8739
14137,20201021,수인분당선,영통,8068,8516,16584
14138,20201021,수인분당선,망포,14342,13685,28027
14139,20201021,수인분당선,매탄권선,4783,4555,9338
14140,20201021,수인분당선,수원시청,11850,12917,24767
14141,20201021,수인분당선,매교,2969,2934,5903
14142,20201021,수인분당선,고색,2790,2745,5535
14143,20201021,수인분당선,오목천,2679,2387,5066
14144,20201021,수인분당선,어천,550,519,1069
14145,20201021,수인분당선,야목,184,165,349
14146,20201021,수인분당선,사리,3306,3093,6399
14147,20201021,수인분당선,달월,88,63,151
14148,20201021,수인분당선,월곶,2536,2345,4881
14149,20201021,수인분당선,소래포구,6301,6093,12394
14150,20201021,수인분당선,인천논현,5539,5920,11459
14151,20201021,수인분당선,호구포,3683,3717,7400
14152,20201021,수인분당선,남동인더스파크,2421,2692,5113
14153,20201021,수인분당선,원인재,4449,4563,9012
14154,20201021,수인분당선,연수,4475,4553,9028
14155,20201021,수인분당선,송도,2767,2408,5175
14156,20201021,수인분당선,인하대,6109,5708,11817
14157,20201021,수인분당선,숭의,3950,3758,7708
14158,20201021,수인분당선,신포,1838,1848,3686
14159,20201021,수인분당선,인천,1013,1699,2712
14160,20201022,수인분당선,선릉,14076,21275,35351
14161,20201022,수인분당선,한티,13434,14679,28113
14162,20201022,수인분당선,도곡,6590,6685,13275
14163,20201022,수인분당선,구룡,2001,1961,3962
14164,20201022,수인분당선,개포동,3544,3737,7281
14165,20201022,수인분당선,대모산입구,3557,3283,6840
14166,20201022,수인분당선,수서,13812,14125,27937
14167,20201022,수인분당선,수원,8323,6705,15028
14168,20201022,수인분당선,서울숲,9135,9372,18507
14169,20201022,수인분당선,압구정로데오,16736,19242,35978
14170,20201022,수인분당선,강남구청,9628,11176,20804
14171,20201022,수인분당선,선정릉,8244,9016,17260
14172,20201022,수인분당선,가천대,10462,11429,21891
14173,20201022,수인분당선,태평,13395,13008,26403
14174,20201022,수인분당선,모란,19648,19751,39399
14175,20201022,수인분당선,야탑,25811,26970,52781
14176,20201022,수인분당선,서현,24461,25195,49656
14177,20201022,수인분당선,수내,12672,13098,25770
14178,20201022,수인분당선,정자,16870,18406,35276
14179,20201022,수인분당선,미금,15976,17072,33048
14180,20201022,수인분당선,오리,12021,10264,22285
14181,20201022,수인분당선,이매,5898,5513,11411
14182,20201022,수인분당선,보정,2698,2260,4958
14183,20201022,수인분당선,죽전,13650,15039,28689
14184,20201022,수인분당선,구성,5230,5294,10524
14185,20201022,수인분당선,신갈,4725,4643,9368
14186,20201022,수인분당선,기흥,9804,9082,18886
14187,20201022,수인분당선,상갈,5477,5319,10796
14188,20201022,수인분당선,청명,4392,4176,8568
14189,20201022,수인분당선,영통,8045,8311,16356
14190,20201022,수인분당선,망포,14336,13245,27581
14191,20201022,수인분당선,매탄권선,4737,4646,9383
14192,20201022,수인분당선,수원시청,11871,13135,25006
14193,20201022,수인분당선,매교,2892,2842,5734
14194,20201022,수인분당선,고색,2831,2726,5557
14195,20201022,수인분당선,오목천,2733,2341,5074
14196,20201022,수인분당선,어천,536,513,1049
14197,20201022,수인분당선,야목,185,150,335
14198,20201022,수인분당선,사리,3215,2993,6208
14199,20201022,수인분당선,달월,87,69,156
14200,20201022,수인분당선,월곶,2481,2325,4806
14201,20201022,수인분당선,소래포구,6146,5903,12049
14202,20201022,수인분당선,인천논현,5483,5850,11333
14203,20201022,수인분당선,호구포,3561,3606,7167
14204,20201022,수인분당선,남동인더스파크,2413,2686,5099
14205,20201022,수인분당선,원인재,4400,4529,8929
14206,20201022,수인분당선,연수,4542,4452,8994
14207,20201022,수인분당선,송도,2661,2387,5048
14208,20201022,수인분당선,인하대,5808,5587,11395
14209,20201022,수인분당선,숭의,3789,3586,7375
14210,20201022,수인분당선,신포,1792,1818,3610
14211,20201022,수인분당선,인천,996,1743,2739
14212,20201023,수인분당선,인천,1102,1880,2982
14213,20201023,수인분당선,연수,4672,4767,9439
14214,20201023,수인분당선,원인재,4581,4744,9325
14215,20201023,수인분당선,남동인더스파크,2428,2681,5109
14216,20201023,수인분당선,호구포,3664,3616,7280
14217,20201023,수인분당선,인천논현,5801,6191,11992
14218,20201023,수인분당선,소래포구,6245,6077,12322
14219,20201023,수인분당선,월곶,2509,2350,4859
14220,20201023,수인분당선,달월,81,58,139
14221,20201023,수인분당선,사리,3603,3207,6810
14222,20201023,수인분당선,야목,190,155,345
14223,20201023,수인분당선,어천,648,557,1205
14224,20201023,수인분당선,오목천,2644,2259,4903
14225,20201023,수인분당선,고색,2964,2797,5761
14226,20201023,수인분당선,매교,3055,3023,6078
14227,20201023,수인분당선,수원시청,12766,15610,28376
14228,20201023,수인분당선,매탄권선,5193,4711,9904
14229,20201023,수인분당선,망포,15620,14194,29814
14230,20201023,수인분당선,영통,8893,9216,18109
14231,20201023,수인분당선,청명,4821,4358,9179
14232,20201023,수인분당선,상갈,5800,5505,11305
14233,20201023,수인분당선,기흥,10151,9706,19857
14234,20201023,수인분당선,신갈,4803,4733,9536
14235,20201023,수인분당선,구성,5244,5395,10639
14236,20201023,수인분당선,죽전,14774,15769,30543
14237,20201023,수인분당선,보정,2708,2269,4977
14238,20201023,수인분당선,이매,5887,5362,11249
14239,20201023,수인분당선,오리,12187,10505,22692
14240,20201023,수인분당선,미금,16489,17371,33860
14241,20201023,수인분당선,정자,17748,19011,36759
14242,20201023,수인분당선,수내,13566,13637,27203
14243,20201023,수인분당선,서현,25870,26993,52863
14244,20201023,수인분당선,야탑,27170,28616,55786
14245,20201023,수인분당선,모란,20945,21198,42143
14246,20201023,수인분당선,태평,14013,13306,27319
14247,20201023,수인분당선,가천대,10206,10680,20886
14248,20201023,수인분당선,선정릉,8519,8976,17495
14249,20201023,수인분당선,강남구청,10147,11649,21796
14250,20201023,수인분당선,압구정로데오,18356,22186,40542
14251,20201023,수인분당선,서울숲,9357,9518,18875
14252,20201023,수인분당선,수원,9113,7424,16537
14253,20201023,수인분당선,수서,14901,15739,30640
14254,20201023,수인분당선,대모산입구,3598,3321,6919
14255,20201023,수인분당선,개포동,3837,4019,7856
14256,20201023,수인분당선,구룡,2008,1835,3843
14257,20201023,수인분당선,도곡,6848,6728,13576
14258,20201023,수인분당선,한티,14689,15546,30235
14259,20201023,수인분당선,선릉,13911,21122,35033
14260,20201023,수인분당선,신포,1923,2013,3936
14261,20201023,수인분당선,숭의,3903,3611,7514
14262,20201023,수인분당선,인하대,6237,5805,12042
14263,20201023,수인분당선,송도,2748,2490,5238
14264,20201024,수인분당선,선릉,5584,8277,13861
14265,20201024,수인분당선,한티,11713,11207,22920
14266,20201024,수인분당선,야목,186,189,375
14267,20201024,수인분당선,청명,2859,2689,5548
14268,20201024,수인분당선,영통,6505,6546,13051
14269,20201024,수인분당선,망포,9128,8245,17373
14270,20201024,수인분당선,매탄권선,3427,3170,6597
14271,20201024,수인분당선,수원시청,10741,12680,23421
14272,20201024,수인분당선,매교,2027,2025,4052
14273,20201024,수인분당선,고색,1767,1768,3535
14274,20201024,수인분당선,오목천,1844,1581,3425
14275,20201024,수인분당선,어천,560,475,1035
14276,20201024,수인분당선,인천,1234,2176,3410
14277,20201024,수인분당선,신포,1367,1373,2740
14278,20201024,수인분당선,숭의,2732,2508,5240
14279,20201024,수인분당선,인하대,4065,3843,7908
14280,20201024,수인분당선,송도,2058,1978,4036
14281,20201024,수인분당선,연수,3818,3797,7615
14282,20201024,수인분당선,원인재,3681,3847,7528
14283,20201024,수인분당선,남동인더스파크,1006,964,1970
14284,20201024,수인분당선,호구포,2305,2201,4506
14285,20201024,수인분당선,인천논현,4343,4451,8794
14286,20201024,수인분당선,소래포구,6579,6942,13521
14287,20201024,수인분당선,월곶,2191,1968,4159
14288,20201024,수인분당선,달월,53,62,115
14289,20201024,수인분당선,사리,2713,2383,5096
14290,20201024,수인분당선,구성,3501,3505,7006
14291,20201024,수인분당선,도곡,4313,3904,8217
14292,20201024,수인분당선,구룡,1522,1474,2996
14293,20201024,수인분당선,개포동,2558,2524,5082
14294,20201024,수인분당선,대모산입구,2752,2486,5238
14295,20201024,수인분당선,수서,10655,10809,21464
14296,20201024,수인분당선,수원,8066,6378,14444
14297,20201024,수인분당선,서울숲,7291,7792,15083
14298,20201024,수인분당선,압구정로데오,15189,18401,33590
14299,20201024,수인분당선,강남구청,5014,6110,11124
14300,20201024,수인분당선,선정릉,3744,3887,7631
14301,20201024,수인분당선,가천대,6510,6546,13056
14302,20201024,수인분당선,태평,10668,9991,20659
14303,20201024,수인분당선,모란,22032,22693,44725
14304,20201024,수인분당선,야탑,17440,18344,35784
14305,20201024,수인분당선,서현,18244,18556,36800
14306,20201024,수인분당선,수내,8597,8186,16783
14307,20201024,수인분당선,정자,10713,10754,21467
14308,20201024,수인분당선,미금,11066,11626,22692
14309,20201024,수인분당선,오리,7870,6485,14355
14310,20201024,수인분당선,이매,4133,3911,8044
14311,20201024,수인분당선,보정,1669,1465,3134
14312,20201024,수인분당선,죽전,10368,11590,21958
14313,20201024,수인분당선,신갈,2840,2831,5671
14314,20201024,수인분당선,기흥,6780,6298,13078
14315,20201024,수인분당선,상갈,3975,3936,7911
14316,20201025,수인분당선,선릉,2907,4161,7068
14317,20201025,수인분당선,한티,7727,7654,15381
14318,20201025,수인분당선,도곡,2420,2369,4789
14319,20201025,수인분당선,구룡,707,766,1473
14320,20201025,수인분당선,개포동,1863,1868,3731
14321,20201025,수인분당선,대모산입구,1585,1457,3042
14322,20201025,수인분당선,수서,7758,7825,15583
14323,20201025,수인분당선,수원,5867,4667,10534
14324,20201025,수인분당선,서울숲,5686,5869,11555
14325,20201025,수인분당선,압구정로데오,8701,9581,18282
14326,20201025,수인분당선,강남구청,2947,3587,6534
14327,20201025,수인분당선,선정릉,2258,2437,4695
14328,20201025,수인분당선,가천대,3558,4292,7850
14329,20201025,수인분당선,태평,7549,7126,14675
14330,20201025,수인분당선,모란,10954,11089,22043
14331,20201025,수인분당선,야탑,12595,13096,25691
14332,20201025,수인분당선,서현,12116,12172,24288
14333,20201025,수인분당선,수내,5860,5648,11508
14334,20201025,수인분당선,정자,6875,7121,13996
14335,20201025,수인분당선,미금,6727,7381,14108
14336,20201025,수인분당선,오리,5356,4734,10090
14337,20201025,수인분당선,이매,2854,2892,5746
14338,20201025,수인분당선,보정,1069,966,2035
14339,20201025,수인분당선,죽전,7503,8296,15799
14340,20201025,수인분당선,구성,2269,2364,4633
14341,20201025,수인분당선,신갈,1920,2031,3951
14342,20201025,수인분당선,기흥,4842,4559,9401
14343,20201025,수인분당선,상갈,2924,3024,5948
14344,20201025,수인분당선,청명,1854,1916,3770
14345,20201025,수인분당선,영통,4222,4197,8419
14346,20201025,수인분당선,망포,5821,6073,11894
14347,20201025,수인분당선,매탄권선,2394,2301,4695
14348,20201025,수인분당선,수원시청,7107,6874,13981
14349,20201025,수인분당선,매교,1328,1410,2738
14350,20201025,수인분당선,고색,1246,1371,2617
14351,20201025,수인분당선,오목천,1326,1231,2557
14352,20201025,수인분당선,어천,397,434,831
14353,20201025,수인분당선,야목,171,138,309
14354,20201025,수인분당선,사리,2181,2029,4210
14355,20201025,수인분당선,달월,57,61,118
14356,20201025,수인분당선,월곶,1676,1555,3231
14357,20201025,수인분당선,소래포구,6037,5858,11895
14358,20201025,수인분당선,인천논현,2861,2944,5805
14359,20201025,수인분당선,호구포,1749,1788,3537
14360,20201025,수인분당선,남동인더스파크,711,719,1430
14361,20201025,수인분당선,원인재,2838,2834,5672
14362,20201025,수인분당선,연수,2940,2943,5883
14363,20201025,수인분당선,송도,1673,1553,3226
14364,20201025,수인분당선,인하대,2989,2798,5787
14365,20201025,수인분당선,숭의,1913,1802,3715
14366,20201025,수인분당선,신포,1099,1060,2159
14367,20201025,수인분당선,인천,1101,1729,2830
14368,20201026,수인분당선,도곡,6823,6901,13724
14369,20201026,수인분당선,구룡,1916,1944,3860
14370,20201026,수인분당선,개포동,3536,3645,7181
14371,20201026,수인분당선,대모산입구,3610,3293,6903
14372,20201026,수인분당선,수서,13719,13898,27617
14373,20201026,수인분당선,수원,7912,6464,14376
14374,20201026,수인분당선,서울숲,8812,8877,17689
14375,20201026,수인분당선,압구정로데오,15585,17402,32987
14376,20201026,수인분당선,강남구청,9618,10770,20388
14377,20201026,수인분당선,선정릉,8052,8702,16754
14378,20201026,수인분당선,가천대,8737,9895,18632
14379,20201026,수인분당선,태평,13383,12960,26343
14380,20201026,수인분당선,모란,19707,19827,39534
14381,20201026,수인분당선,야탑,25731,26857,52588
14382,20201026,수인분당선,서현,23800,24511,48311
14383,20201026,수인분당선,수내,12586,12678,25264
14384,20201026,수인분당선,정자,16306,17447,33753
14385,20201026,수인분당선,미금,15703,16748,32451
14386,20201026,수인분당선,오리,11734,10043,21777
14387,20201026,수인분당선,이매,5534,5280,10814
14388,20201026,수인분당선,보정,2642,2232,4874
14389,20201026,수인분당선,죽전,13448,15009,28457
14390,20201026,수인분당선,구성,5189,5241,10430
14391,20201026,수인분당선,신갈,4680,4600,9280
14392,20201026,수인분당선,기흥,9645,9185,18830
14393,20201026,수인분당선,상갈,5468,5126,10594
14394,20201026,수인분당선,청명,4444,4183,8627
14395,20201026,수인분당선,영통,7975,8352,16327
14396,20201026,수인분당선,망포,13941,13335,27276
14397,20201026,수인분당선,매탄권선,4691,4610,9301
14398,20201026,수인분당선,수원시청,11921,12810,24731
14399,20201026,수인분당선,매교,2928,2891,5819
14400,20201026,수인분당선,고색,2813,2650,5463
14401,20201026,수인분당선,오목천,2557,2315,4872
14402,20201026,수인분당선,어천,520,507,1027
14403,20201026,수인분당선,야목,187,177,364
14404,20201026,수인분당선,사리,3226,2951,6177
14405,20201026,수인분당선,달월,80,60,140
14406,20201026,수인분당선,월곶,2447,2269,4716
14407,20201026,수인분당선,소래포구,5915,5549,11464
14408,20201026,수인분당선,인천논현,5456,5875,11331
14409,20201026,수인분당선,호구포,3522,3672,7194
14410,20201026,수인분당선,남동인더스파크,2463,2668,5131
14411,20201026,수인분당선,원인재,4376,4551,8927
14412,20201026,수인분당선,연수,4508,4368,8876
14413,20201026,수인분당선,송도,2641,2438,5079
14414,20201026,수인분당선,인하대,6233,5950,12183
14415,20201026,수인분당선,숭의,3914,3644,7558
14416,20201026,수인분당선,신포,1741,1741,3482
14417,20201026,수인분당선,인천,1025,1605,2630
14418,20201026,수인분당선,선릉,13837,21023,34860
14419,20201026,수인분당선,한티,13245,14296,27541
14420,20201027,수인분당선,인천,1019,1796,2815
14421,20201027,수인분당선,신포,1804,1892,3696
14422,20201027,수인분당선,숭의,3993,3723,7716
14423,20201027,수인분당선,인하대,6503,6161,12664
14424,20201027,수인분당선,송도,2719,2356,5075
14425,20201027,수인분당선,연수,4458,4501,8959
14426,20201027,수인분당선,원인재,4459,4575,9034
14427,20201027,수인분당선,남동인더스파크,2305,2585,4890
14428,20201027,수인분당선,호구포,3561,3636,7197
14429,20201027,수인분당선,인천논현,5518,5819,11337
14430,20201027,수인분당선,소래포구,6537,6231,12768
14431,20201027,수인분당선,월곶,2563,2377,4940
14432,20201027,수인분당선,달월,94,61,155
14433,20201027,수인분당선,사리,3348,3200,6548
14434,20201027,수인분당선,야목,190,169,359
14435,20201027,수인분당선,어천,567,538,1105
14436,20201027,수인분당선,오목천,2605,2341,4946
14437,20201027,수인분당선,고색,2863,2836,5699
14438,20201027,수인분당선,매교,2836,2878,5714
14439,20201027,수인분당선,수원시청,11980,12836,24816
14440,20201027,수인분당선,매탄권선,4698,4525,9223
14441,20201027,수인분당선,망포,14292,13464,27756
14442,20201027,수인분당선,영통,8149,8550,16699
14443,20201027,수인분당선,청명,4461,4192,8653
14444,20201027,수인분당선,상갈,5636,5297,10933
14445,20201027,수인분당선,기흥,9858,9314,19172
14446,20201027,수인분당선,신갈,4791,4759,9550
14447,20201027,수인분당선,구성,5180,5355,10535
14448,20201027,수인분당선,죽전,13815,15354,29169
14449,20201027,수인분당선,보정,2635,2278,4913
14450,20201027,수인분당선,이매,5718,5403,11121
14451,20201027,수인분당선,오리,11989,10193,22182
14452,20201027,수인분당선,미금,15809,17034,32843
14453,20201027,수인분당선,정자,16838,18165,35003
14454,20201027,수인분당선,수내,12901,13029,25930
14455,20201027,수인분당선,서현,24502,25086,49588
14456,20201027,수인분당선,야탑,25929,27047,52976
14457,20201027,수인분당선,모란,20034,20203,40237
14458,20201027,수인분당선,태평,13571,13104,26675
14459,20201027,수인분당선,가천대,8923,10112,19035
14460,20201027,수인분당선,선정릉,8436,8970,17406
14461,20201027,수인분당선,강남구청,9832,11389,21221
14462,20201027,수인분당선,압구정로데오,16546,18963,35509
14463,20201027,수인분당선,서울숲,9302,9180,18482
14464,20201027,수인분당선,수원,8226,6693,14919
14465,20201027,수인분당선,수서,13732,13877,27609
14466,20201027,수인분당선,대모산입구,3623,3391,7014
14467,20201027,수인분당선,개포동,3666,3711,7377
14468,20201027,수인분당선,구룡,1917,1859,3776
14469,20201027,수인분당선,도곡,6742,6846,13588
14470,20201027,수인분당선,한티,13585,14491,28076
14471,20201027,수인분당선,선릉,14194,21573,35767
14472,20201028,수인분당선,선릉,14269,21454,35723
14473,20201028,수인분당선,한티,13511,14578,28089
14474,20201028,수인분당선,도곡,6733,6780,13513
14475,20201028,수인분당선,구룡,2005,1915,3920
14476,20201028,수인분당선,개포동,3827,3902,7729
14477,20201028,수인분당선,대모산입구,3731,3436,7167
14478,20201028,수인분당선,수서,13986,14250,28236
14479,20201028,수인분당선,수원,8553,6695,15248
14480,20201028,수인분당선,서울숲,9363,9537,18900
14481,20201028,수인분당선,압구정로데오,16881,19100,35981
14482,20201028,수인분당선,강남구청,9858,11592,21450
14483,20201028,수인분당선,선정릉,8172,8862,17034
14484,20201028,수인분당선,가천대,8960,10122,19082
14485,20201028,수인분당선,태평,13463,13048,26511
14486,20201028,수인분당선,모란,19949,19786,39735
14487,20201028,수인분당선,야탑,26415,27665,54080
14488,20201028,수인분당선,서현,24327,25154,49481
14489,20201028,수인분당선,수내,13190,13163,26353
14490,20201028,수인분당선,정자,17040,18259,35299
14491,20201028,수인분당선,미금,15942,17206,33148
14492,20201028,수인분당선,오리,12224,10274,22498
14493,20201028,수인분당선,이매,5923,5489,11412
14494,20201028,수인분당선,보정,2650,2191,4841
14495,20201028,수인분당선,죽전,14125,15351,29476
14496,20201028,수인분당선,구성,5065,5369,10434
14497,20201028,수인분당선,신갈,4748,4634,9382
14498,20201028,수인분당선,기흥,9811,9382,19193
14499,20201028,수인분당선,상갈,5636,5407,11043
14500,20201028,수인분당선,청명,4497,4266,8763
14501,20201028,수인분당선,영통,8495,8592,17087
14502,20201028,수인분당선,망포,14383,13661,28044
14503,20201028,수인분당선,매탄권선,4850,4665,9515
14504,20201028,수인분당선,수원시청,12098,13416,25514
14505,20201028,수인분당선,매교,2937,3037,5974
14506,20201028,수인분당선,고색,2998,2806,5804
14507,20201028,수인분당선,오목천,2638,2359,4997
14508,20201028,수인분당선,어천,589,548,1137
14509,20201028,수인분당선,야목,164,157,321
14510,20201028,수인분당선,사리,3332,3127,6459
14511,20201028,수인분당선,달월,76,59,135
14512,20201028,수인분당선,월곶,2635,2455,5090
14513,20201028,수인분당선,소래포구,6865,6592,13457
14514,20201028,수인분당선,인천논현,5638,5976,11614
14515,20201028,수인분당선,호구포,3649,3678,7327
14516,20201028,수인분당선,남동인더스파크,2462,2719,5181
14517,20201028,수인분당선,원인재,4550,4632,9182
14518,20201028,수인분당선,연수,4655,4593,9248
14519,20201028,수인분당선,송도,2692,2504,5196
14520,20201028,수인분당선,인하대,6641,6262,12903
14521,20201028,수인분당선,숭의,3925,3721,7646
14522,20201028,수인분당선,신포,1897,1964,3861
14523,20201028,수인분당선,인천,1094,1759,2853
14524,20201029,수인분당선,달월,69,53,122
14525,20201029,수인분당선,사리,3273,3153,6426
14526,20201029,수인분당선,야목,188,173,361
14527,20201029,수인분당선,어천,587,540,1127
14528,20201029,수인분당선,오목천,2669,2380,5049
14529,20201029,수인분당선,고색,3001,2904,5905
14530,20201029,수인분당선,매교,3056,3056,6112
14531,20201029,수인분당선,수원시청,12044,13225,25269
14532,20201029,수인분당선,매탄권선,4854,4604,9458
14533,20201029,수인분당선,망포,14368,13488,27856
14534,20201029,수인분당선,영통,8329,8689,17018
14535,20201029,수인분당선,청명,4456,4241,8697
14536,20201029,수인분당선,상갈,5557,5252,10809
14537,20201029,수인분당선,기흥,9751,9236,18987
14538,20201029,수인분당선,신갈,4617,4531,9148
14539,20201029,수인분당선,구성,5237,5296,10533
14540,20201029,수인분당선,죽전,13996,15244,29240
14541,20201029,수인분당선,보정,2651,2287,4938
14542,20201029,수인분당선,이매,6025,5572,11597
14543,20201029,수인분당선,오리,12136,10336,22472
14544,20201029,수인분당선,미금,16018,17157,33175
14545,20201029,수인분당선,정자,17236,18196,35432
14546,20201029,수인분당선,수내,13055,13263,26318
14547,20201029,수인분당선,서현,24597,25112,49709
14548,20201029,수인분당선,야탑,26372,27223,53595
14549,20201029,수인분당선,모란,26550,27319,53869
14550,20201029,수인분당선,태평,13683,13238,26921
14551,20201029,수인분당선,가천대,9178,10075,19253
14552,20201029,수인분당선,선정릉,8249,9029,17278
14553,20201029,수인분당선,강남구청,9918,11429,21347
14554,20201029,수인분당선,압구정로데오,17142,19847,36989
14555,20201029,수인분당선,서울숲,9500,9566,19066
14556,20201029,수인분당선,수원,8514,6852,15366
14557,20201029,수인분당선,수서,14283,14693,28976
14558,20201029,수인분당선,대모산입구,3691,3444,7135
14559,20201029,수인분당선,개포동,3767,3835,7602
14560,20201029,수인분당선,구룡,2162,1991,4153
14561,20201029,수인분당선,도곡,6723,6662,13385
14562,20201029,수인분당선,한티,13459,14502,27961
14563,20201029,수인분당선,선릉,13942,21363,35305
14564,20201029,수인분당선,월곶,2511,2331,4842
14565,20201029,수인분당선,소래포구,7129,6856,13985
14566,20201029,수인분당선,인천논현,5420,5857,11277
14567,20201029,수인분당선,호구포,3592,3609,7201
14568,20201029,수인분당선,남동인더스파크,2329,2640,4969
14569,20201029,수인분당선,원인재,4492,4573,9065
14570,20201029,수인분당선,연수,4471,4496,8967
14571,20201029,수인분당선,송도,2635,2437,5072
14572,20201029,수인분당선,인하대,6577,6186,12763
14573,20201029,수인분당선,숭의,3878,3593,7471
14574,20201029,수인분당선,신포,1802,1831,3633
14575,20201029,수인분당선,인천,1030,1659,2689
14576,20201030,수인분당선,한티,14344,15187,29531
14577,20201030,수인분당선,선릉,13754,21150,34904
14578,20201030,수인분당선,도곡,6780,6694,13474
14579,20201030,수인분당선,구룡,1975,1853,3828
14580,20201030,수인분당선,개포동,3868,3995,7863
14581,20201030,수인분당선,대모산입구,3717,3351,7068
14582,20201030,수인분당선,수서,15118,16174,31292
14583,20201030,수인분당선,수원,9544,7699,17243
14584,20201030,수인분당선,서울숲,9970,10193,20163
14585,20201030,수인분당선,압구정로데오,18319,22564,40883
14586,20201030,수인분당선,강남구청,10060,11903,21963
14587,20201030,수인분당선,선정릉,8350,8890,17240
14588,20201030,수인분당선,가천대,9100,9561,18661
14589,20201030,수인분당선,태평,13984,13182,27166
14590,20201030,수인분당선,모란,20688,21208,41896
14591,20201030,수인분당선,야탑,27608,29048,56656
14592,20201030,수인분당선,서현,26159,26965,53124
14593,20201030,수인분당선,수내,13745,13823,27568
14594,20201030,수인분당선,미금,16159,17233,33392
14595,20201030,수인분당선,오리,12443,10516,22959
14596,20201030,수인분당선,이매,6132,5549,11681
14597,20201030,수인분당선,보정,2729,2262,4991
14598,20201030,수인분당선,죽전,15223,16266,31489
14599,20201030,수인분당선,구성,5312,5389,10701
14600,20201030,수인분당선,신갈,4744,4700,9444
14601,20201030,수인분당선,기흥,10234,9759,19993
14602,20201030,수인분당선,상갈,6034,5655,11689
14603,20201030,수인분당선,청명,4745,4324,9069
14604,20201030,수인분당선,영통,9268,9534,18802
14605,20201030,수인분당선,망포,15896,14385,30281
14606,20201030,수인분당선,매탄권선,5295,4858,10153
14607,20201030,수인분당선,수원시청,13161,16408,29569
14608,20201030,수인분당선,매교,3121,3065,6186
14609,20201030,수인분당선,고색,3161,3009,6170
14610,20201030,수인분당선,오목천,2862,2413,5275
14611,20201030,수인분당선,어천,645,548,1193
14612,20201030,수인분당선,야목,196,174,370
14613,20201030,수인분당선,사리,3626,3126,6752
14614,20201030,수인분당선,달월,74,53,127
14615,20201030,수인분당선,월곶,2629,2401,5030
14616,20201030,수인분당선,소래포구,7476,7138,14614
14617,20201030,수인분당선,인천논현,5769,6002,11771
14618,20201030,수인분당선,호구포,3595,3542,7137
14619,20201030,수인분당선,남동인더스파크,2276,2518,4794
14620,20201030,수인분당선,원인재,4896,5150,10046
14621,20201030,수인분당선,연수,4752,4846,9598
14622,20201030,수인분당선,송도,2823,2607,5430
14623,20201030,수인분당선,인하대,6725,6074,12799
14624,20201030,수인분당선,숭의,3914,4128,8042
14625,20201030,수인분당선,신포,1859,2075,3934
14626,20201030,수인분당선,인천,1062,1880,2942
14627,20201030,수인분당선,정자,17432,18815,36247
14628,20201031,수인분당선,영통,6738,6825,13563
14629,20201031,수인분당선,청명,2885,2579,5464
14630,20201031,수인분당선,상갈,4225,4195,8420
14631,20201031,수인분당선,기흥,7052,6523,13575
14632,20201031,수인분당선,신갈,2983,2874,5857
14633,20201031,수인분당선,구성,3522,3460,6982
14634,20201031,수인분당선,죽전,11485,12836,24321
14635,20201031,수인분당선,보정,1755,1506,3261
14636,20201031,수인분당선,이매,4049,3903,7952
14637,20201031,수인분당선,오리,7814,6616,14430
14638,20201031,수인분당선,미금,10914,11250,22164
14639,20201031,수인분당선,정자,10916,10917,21833
14640,20201031,수인분당선,수내,8594,8264,16858
14641,20201031,수인분당선,서현,18261,18597,36858
14642,20201031,수인분당선,야탑,18165,19218,37383
14643,20201031,수인분당선,모란,16070,16193,32263
14644,20201031,수인분당선,태평,10746,9973,20719
14645,20201031,수인분당선,가천대,5619,5649,11268
14646,20201031,수인분당선,선정릉,3899,4051,7950
14647,20201031,수인분당선,강남구청,5249,6474,11723
14648,20201031,수인분당선,압구정로데오,15412,19187,34599
14649,20201031,수인분당선,서울숲,8470,9135,17605
14650,20201031,수인분당선,수원,8123,6477,14600
14651,20201031,수인분당선,수서,10689,10931,21620
14652,20201031,수인분당선,대모산입구,2860,2558,5418
14653,20201031,수인분당선,개포동,2664,2537,5201
14654,20201031,수인분당선,구룡,1395,1366,2761
14655,20201031,수인분당선,도곡,4702,4241,8943
14656,20201031,수인분당선,한티,11526,10991,22517
14657,20201031,수인분당선,선릉,5821,8779,14600
14658,20201031,수인분당선,인천,1363,2442,3805
14659,20201031,수인분당선,신포,1455,1506,2961
14660,20201031,수인분당선,숭의,2687,2601,5288
14661,20201031,수인분당선,인하대,4329,3993,8322
14662,20201031,수인분당선,송도,2206,2062,4268
14663,20201031,수인분당선,연수,3885,3868,7753
14664,20201031,수인분당선,원인재,3775,3854,7629
14665,20201031,수인분당선,남동인더스파크,973,893,1866
14666,20201031,수인분당선,호구포,2389,2287,4676
14667,20201031,수인분당선,인천논현,4459,4421,8880
14668,20201031,수인분당선,소래포구,7927,8171,16098
14669,20201031,수인분당선,월곶,2259,2147,4406
14670,20201031,수인분당선,달월,57,51,108
14671,20201031,수인분당선,사리,2949,2558,5507
14672,20201031,수인분당선,야목,192,183,375
14673,20201031,수인분당선,어천,495,475,970
14674,20201031,수인분당선,오목천,1911,1605,3516
14675,20201031,수인분당선,고색,2063,2039,4102
14676,20201031,수인분당선,매교,1991,2121,4112
14677,20201031,수인분당선,수원시청,11320,13273,24593
14678,20201031,수인분당선,매탄권선,3435,3227,6662
14679,20201031,수인분당선,망포,9618,8578,18196
14680,20201101,수인분당선,인천,840,1209,2049
14681,20201101,수인분당선,신포,911,890,1801
14682,20201101,수인분당선,숭의,1679,1529,3208
14683,20201101,수인분당선,인하대,2502,2506,5008
14684,20201101,수인분당선,송도,1228,1203,2431
14685,20201101,수인분당선,연수,2580,2543,5123
14686,20201101,수인분당선,원인재,2308,2418,4726
14687,20201101,수인분당선,남동인더스파크,767,731,1498
14688,20201101,수인분당선,호구포,1495,1545,3040
14689,20201101,수인분당선,인천논현,2626,2708,5334
14690,20201101,수인분당선,소래포구,4582,4456,9038
14691,20201101,수인분당선,월곶,1317,1321,2638
14692,20201101,수인분당선,달월,31,29,60
14693,20201101,수인분당선,사리,1985,1715,3700
14694,20201101,수인분당선,야목,125,111,236
14695,20201101,수인분당선,어천,339,383,722
14696,20201101,수인분당선,오목천,1097,1107,2204
14697,20201101,수인분당선,고색,1204,1280,2484
14698,20201101,수인분당선,매교,1186,1268,2454
14699,20201101,수인분당선,수원시청,7138,6911,14049
14700,20201101,수인분당선,매탄권선,2163,2113,4276
14701,20201101,수인분당선,망포,5575,5885,11460
14702,20201101,수인분당선,영통,4336,4370,8706
14703,20201101,수인분당선,청명,1740,1826,3566
14704,20201101,수인분당선,상갈,2633,2594,5227
14705,20201101,수인분당선,기흥,4408,4398,8806
14706,20201101,수인분당선,신갈,1769,1757,3526
14707,20201101,수인분당선,구성,2128,2233,4361
14708,20201101,수인분당선,죽전,7409,8544,15953
14709,20201101,수인분당선,보정,968,936,1904
14710,20201101,수인분당선,이매,2795,2783,5578
14711,20201101,수인분당선,오리,4816,4305,9121
14712,20201101,수인분당선,미금,6381,6856,13237
14713,20201101,수인분당선,정자,6674,6838,13512
14714,20201101,수인분당선,수내,5381,5298,10679
14715,20201101,수인분당선,서현,11840,12132,23972
14716,20201101,수인분당선,야탑,11951,12504,24455
14717,20201101,수인분당선,모란,10092,10361,20453
14718,20201101,수인분당선,태평,7134,6753,13887
14719,20201101,수인분당선,가천대,3583,4292,7875
14720,20201101,수인분당선,선정릉,2028,2112,4140
14721,20201101,수인분당선,강남구청,2773,3232,6005
14722,20201101,수인분당선,압구정로데오,7747,8574,16321
14723,20201101,수인분당선,서울숲,3816,4018,7834
14724,20201101,수인분당선,수원,5576,4407,9983
14725,20201101,수인분당선,복정,1,0,1
14726,20201101,수인분당선,수서,7978,7593,15571
14727,20201101,수인분당선,대모산입구,1315,1302,2617
14728,20201101,수인분당선,개포동,1659,1688,3347
14729,20201101,수인분당선,구룡,852,921,1773
14730,20201101,수인분당선,도곡,2296,2218,4514
14731,20201101,수인분당선,한티,7746,7354,15100
14732,20201101,수인분당선,선릉,2657,3845,6502
14733,20201102,수인분당선,복정,1,0,1
14734,20201102,수인분당선,선릉,13960,21111,35071
14735,20201102,수인분당선,한티,13163,14120,27283
14736,20201102,수인분당선,도곡,6684,6792,13476
14737,20201102,수인분당선,구룡,1918,1958,3876
14738,20201102,수인분당선,개포동,3722,3801,7523
14739,20201102,수인분당선,대모산입구,3610,3346,6956
14740,20201102,수인분당선,수서,13708,13790,27498
14741,20201102,수인분당선,수원,8218,6685,14903
14742,20201102,수인분당선,서울숲,9096,9182,18278
14743,20201102,수인분당선,압구정로데오,15240,17226,32466
14744,20201102,수인분당선,강남구청,9506,10982,20488
14745,20201102,수인분당선,선정릉,8149,8758,16907
14746,20201102,수인분당선,가천대,8620,9914,18534
14747,20201102,수인분당선,태평,13317,12864,26181
14748,20201102,수인분당선,모란,19734,19721,39455
14749,20201102,수인분당선,야탑,25907,27282,53189
14750,20201102,수인분당선,서현,24264,24619,48883
14751,20201102,수인분당선,수내,13052,12876,25928
14752,20201102,수인분당선,정자,16333,17655,33988
14753,20201102,수인분당선,미금,15811,16813,32624
14754,20201102,수인분당선,오리,12031,10244,22275
14755,20201102,수인분당선,이매,5732,5369,11101
14756,20201102,수인분당선,보정,2584,2270,4854
14757,20201102,수인분당선,죽전,13607,15074,28681
14758,20201102,수인분당선,구성,5130,5206,10336
14759,20201102,수인분당선,신갈,4630,4554,9184
14760,20201102,수인분당선,기흥,9638,9157,18795
14761,20201102,수인분당선,상갈,5433,5247,10680
14762,20201102,수인분당선,청명,4409,4216,8625
14763,20201102,수인분당선,영통,8151,8521,16672
14764,20201102,수인분당선,망포,14041,13385,27426
14765,20201102,수인분당선,매탄권선,4732,4539,9271
14766,20201102,수인분당선,수원시청,12027,12870,24897
14767,20201102,수인분당선,매교,3036,2976,6012
14768,20201102,수인분당선,고색,2940,2792,5732
14769,20201102,수인분당선,오목천,2502,2285,4787
14770,20201102,수인분당선,어천,592,573,1165
14771,20201102,수인분당선,야목,199,163,362
14772,20201102,수인분당선,사리,3416,3154,6570
14773,20201102,수인분당선,달월,84,59,143
14774,20201102,수인분당선,월곶,2474,2282,4756
14775,20201102,수인분당선,소래포구,6595,6224,12819
14776,20201102,수인분당선,인천논현,5559,5881,11440
14777,20201102,수인분당선,호구포,3539,3687,7226
14778,20201102,수인분당선,남동인더스파크,2256,2634,4890
14779,20201102,수인분당선,원인재,4412,4583,8995
14780,20201102,수인분당선,연수,4496,4374,8870
14781,20201102,수인분당선,송도,2634,2448,5082
14782,20201102,수인분당선,인하대,6024,5777,11801
14783,20201102,수인분당선,숭의,3951,3605,7556
14784,20201102,수인분당선,신포,1820,1791,3611
14785,20201102,수인분당선,인천,1007,1656,2663
14786,20201103,수인분당선,선릉,14116,21381,35497
14787,20201103,수인분당선,한티,13368,14388,27756
14788,20201103,수인분당선,도곡,6623,6709,13332
14789,20201103,수인분당선,구룡,2081,2033,4114
14790,20201103,수인분당선,개포동,3720,3886,7606
14791,20201103,수인분당선,대모산입구,3619,3386,7005
14792,20201103,수인분당선,수서,13466,13833,27299
14793,20201103,수인분당선,수원,8178,6639,14817
14794,20201103,수인분당선,서울숲,9168,9352,18520
14795,20201103,수인분당선,압구정로데오,16694,18791,35485
14796,20201103,수인분당선,강남구청,9970,11426,21396
14797,20201103,수인분당선,선정릉,8505,9015,17520
14798,20201103,수인분당선,가천대,8799,9898,18697
14799,20201103,수인분당선,태평,13411,12967,26378
14800,20201103,수인분당선,모란,19873,19827,39700
14801,20201103,수인분당선,야탑,26331,27429,53760
14802,20201103,수인분당선,서현,24976,25628,50604
14803,20201103,수인분당선,수내,13375,13536,26911
14804,20201103,수인분당선,정자,17264,18363,35627
14805,20201103,수인분당선,미금,16196,17263,33459
14806,20201103,수인분당선,오리,11954,10271,22225
14807,20201103,수인분당선,이매,5914,5445,11359
14808,20201103,수인분당선,보정,2639,2239,4878
14809,20201103,수인분당선,죽전,13459,14927,28386
14810,20201103,수인분당선,구성,5178,5236,10414
14811,20201103,수인분당선,신갈,4667,4560,9227
14812,20201103,수인분당선,기흥,9989,9339,19328
14813,20201103,수인분당선,상갈,5493,5347,10840
14814,20201103,수인분당선,청명,4473,3334,7807
14815,20201103,수인분당선,영통,8108,8498,16606
14816,20201103,수인분당선,망포,14096,13415,27511
14817,20201103,수인분당선,매탄권선,4694,4654,9348
14818,20201103,수인분당선,수원시청,11888,12741,24629
14819,20201103,수인분당선,매교,2912,2906,5818
14820,20201103,수인분당선,고색,2930,2789,5719
14821,20201103,수인분당선,오목천,2575,2201,4776
14822,20201103,수인분당선,어천,511,530,1041
14823,20201103,수인분당선,야목,188,173,361
14824,20201103,수인분당선,사리,3365,3202,6567
14825,20201103,수인분당선,달월,79,54,133
14826,20201103,수인분당선,월곶,2529,2337,4866
14827,20201103,수인분당선,소래포구,6334,6044,12378
14828,20201103,수인분당선,인천논현,5310,5783,11093
14829,20201103,수인분당선,호구포,3545,3623,7168
14830,20201103,수인분당선,남동인더스파크,2368,2679,5047
14831,20201103,수인분당선,원인재,4352,4489,8841
14832,20201103,수인분당선,연수,4395,4393,8788
14833,20201103,수인분당선,송도,2681,2311,4992
14834,20201103,수인분당선,인하대,6100,5764,11864
14835,20201103,수인분당선,숭의,3861,3636,7497
14836,20201103,수인분당선,신포,1738,1832,3570
14837,20201103,수인분당선,인천,1024,1705,2729
14838,20201104,수인분당선,선릉,14109,21322,35431
14839,20201104,수인분당선,한티,13645,14576,28221
14840,20201104,수인분당선,도곡,6737,6812,13549
14841,20201104,수인분당선,구룡,2099,2011,4110
14842,20201104,수인분당선,개포동,3779,3823,7602
14843,20201104,수인분당선,대모산입구,3638,3434,7072
14844,20201104,수인분당선,수서,13812,14018,27830
14845,20201104,수인분당선,복정,3,0,3
14846,20201104,수인분당선,수원,8155,6541,14696
14847,20201104,수인분당선,서울숲,9337,9441,18778
14848,20201104,수인분당선,압구정로데오,16701,19028,35729
14849,20201104,수인분당선,강남구청,9716,11110,20826
14850,20201104,수인분당선,선정릉,8353,8920,17273
14851,20201104,수인분당선,가천대,8718,9950,18668
14852,20201104,수인분당선,태평,13595,13085,26680
14853,20201104,수인분당선,모란,25679,26316,51995
14854,20201104,수인분당선,야탑,26761,27884,54645
14855,20201104,수인분당선,서현,24730,25124,49854
14856,20201104,수인분당선,수내,13407,13467,26874
14857,20201104,수인분당선,정자,17109,18356,35465
14858,20201104,수인분당선,미금,16504,17431,33935
14859,20201104,수인분당선,오리,12093,10340,22433
14860,20201104,수인분당선,이매,5828,5546,11374
14861,20201104,수인분당선,보정,2581,2218,4799
14862,20201104,수인분당선,죽전,13892,15099,28991
14863,20201104,수인분당선,구성,5048,5269,10317
14864,20201104,수인분당선,신갈,4733,4655,9388
14865,20201104,수인분당선,기흥,9738,9100,18838
14866,20201104,수인분당선,상갈,5488,5342,10830
14867,20201104,수인분당선,청명,4274,4097,8371
14868,20201104,수인분당선,영통,8229,8676,16905
14869,20201104,수인분당선,망포,14314,13482,27796
14870,20201104,수인분당선,매탄권선,4862,4697,9559
14871,20201104,수인분당선,수원시청,12205,13240,25445
14872,20201104,수인분당선,매교,2965,2930,5895
14873,20201104,수인분당선,고색,3003,2856,5859
14874,20201104,수인분당선,오목천,2550,2277,4827
14875,20201104,수인분당선,어천,578,559,1137
14876,20201104,수인분당선,야목,180,170,350
14877,20201104,수인분당선,사리,3334,3110,6444
14878,20201104,수인분당선,달월,71,51,122
14879,20201104,수인분당선,월곶,2617,2387,5004
14880,20201104,수인분당선,소래포구,5769,5557,11326
14881,20201104,수인분당선,인천논현,5531,5925,11456
14882,20201104,수인분당선,호구포,3646,3641,7287
14883,20201104,수인분당선,남동인더스파크,2307,2571,4878
14884,20201104,수인분당선,원인재,4493,4516,9009
14885,20201104,수인분당선,연수,4570,4547,9117
14886,20201104,수인분당선,송도,2532,2398,4930
14887,20201104,수인분당선,인하대,6080,5610,11690
14888,20201104,수인분당선,숭의,3845,3538,7383
14889,20201104,수인분당선,신포,1747,1790,3537
14890,20201104,수인분당선,인천,1009,1581,2590
14891,20201105,수인분당선,소래포구,6230,5918,12148
14892,20201105,수인분당선,인천논현,5506,5847,11353
14893,20201105,수인분당선,호구포,3626,3726,7352
14894,20201105,수인분당선,남동인더스파크,2287,2597,4884
14895,20201105,수인분당선,원인재,4472,4627,9099
14896,20201105,수인분당선,연수,4510,4469,8979
14897,20201105,수인분당선,송도,2679,2464,5143
14898,20201105,수인분당선,인하대,6133,5819,11952
14899,20201105,수인분당선,숭의,3842,3602,7444
14900,20201105,수인분당선,신포,1765,1829,3594
14901,20201105,수인분당선,인천,1029,1655,2684
14902,20201105,수인분당선,선릉,14106,21255,35361
14903,20201105,수인분당선,한티,13664,14696,28360
14904,20201105,수인분당선,도곡,6762,6754,13516
14905,20201105,수인분당선,구룡,2106,1999,4105
14906,20201105,수인분당선,개포동,3815,3796,7611
14907,20201105,수인분당선,대모산입구,3557,3265,6822
14908,20201105,수인분당선,수서,14077,14332,28409
14909,20201105,수인분당선,수원,8410,6669,15079
14910,20201105,수인분당선,서울숲,9580,9615,19195
14911,20201105,수인분당선,압구정로데오,16897,19432,36329
14912,20201105,수인분당선,강남구청,9609,11331,20940
14913,20201105,수인분당선,선정릉,8360,9007,17367
14914,20201105,수인분당선,가천대,8733,9679,18412
14915,20201105,수인분당선,태평,13351,13016,26367
14916,20201105,수인분당선,모란,20029,20216,40245
14917,20201105,수인분당선,야탑,26299,27515,53814
14918,20201105,수인분당선,서현,24668,25152,49820
14919,20201105,수인분당선,수내,13244,13331,26575
14920,20201105,수인분당선,정자,17231,18471,35702
14921,20201105,수인분당선,미금,15993,17116,33109
14922,20201105,수인분당선,오리,12160,10364,22524
14923,20201105,수인분당선,이매,5725,5360,11085
14924,20201105,수인분당선,보정,2665,2278,4943
14925,20201105,수인분당선,죽전,14184,15515,29699
14926,20201105,수인분당선,구성,5261,5305,10566
14927,20201105,수인분당선,신갈,4675,4643,9318
14928,20201105,수인분당선,기흥,9904,9498,19402
14929,20201105,수인분당선,상갈,5623,5371,10994
14930,20201105,수인분당선,청명,4467,4187,8654
14931,20201105,수인분당선,영통,8334,8553,16887
14932,20201105,수인분당선,망포,14435,13515,27950
14933,20201105,수인분당선,매탄권선,4894,4733,9627
14934,20201105,수인분당선,수원시청,12246,13204,25450
14935,20201105,수인분당선,매교,2942,2933,5875
14936,20201105,수인분당선,고색,2920,2799,5719
14937,20201105,수인분당선,오목천,2593,2189,4782
14938,20201105,수인분당선,어천,574,516,1090
14939,20201105,수인분당선,야목,220,196,416
14940,20201105,수인분당선,사리,3427,3264,6691
14941,20201105,수인분당선,달월,96,71,167
14942,20201105,수인분당선,월곶,2581,2312,4893
14943,20201106,수인분당선,인천,1030,1695,2725
14944,20201106,수인분당선,신포,1779,1929,3708
14945,20201106,수인분당선,숭의,3958,3629,7587
14946,20201106,수인분당선,인하대,6390,5857,12247
14947,20201106,수인분당선,송도,2695,2507,5202
14948,20201106,수인분당선,연수,4771,4879,9650
14949,20201106,수인분당선,원인재,4633,4742,9375
14950,20201106,수인분당선,남동인더스파크,2362,2564,4926
14951,20201106,수인분당선,호구포,3812,3702,7514
14952,20201106,수인분당선,인천논현,5643,6141,11784
14953,20201106,수인분당선,소래포구,5899,5860,11759
14954,20201106,수인분당선,월곶,2518,2399,4917
14955,20201106,수인분당선,달월,92,64,156
14956,20201106,수인분당선,사리,3619,3366,6985
14957,20201106,수인분당선,야목,209,175,384
14958,20201106,수인분당선,어천,632,537,1169
14959,20201106,수인분당선,오목천,2698,2232,4930
14960,20201106,수인분당선,고색,3161,2933,6094
14961,20201106,수인분당선,매교,3067,3059,6126
14962,20201106,수인분당선,수원시청,12885,15702,28587
14963,20201106,수인분당선,매탄권선,5252,4796,10048
14964,20201106,수인분당선,망포,15764,14209,29973
14965,20201106,수인분당선,영통,9131,9465,18596
14966,20201106,수인분당선,청명,4652,4267,8919
14967,20201106,수인분당선,상갈,5919,5371,11290
14968,20201106,수인분당선,기흥,10174,9626,19800
14969,20201106,수인분당선,신갈,4850,4772,9622
14970,20201106,수인분당선,구성,5241,5272,10513
14971,20201106,수인분당선,죽전,15189,16005,31194
14972,20201106,수인분당선,보정,2701,2273,4974
14973,20201106,수인분당선,이매,5939,5422,11361
14974,20201106,수인분당선,오리,12573,10570,23143
14975,20201106,수인분당선,미금,16617,17434,34051
14976,20201106,수인분당선,정자,17751,19093,36844
14977,20201106,수인분당선,수내,14067,13444,27511
14978,20201106,수인분당선,서현,26125,27236,53361
14979,20201106,수인분당선,야탑,27619,29002,56621
14980,20201106,수인분당선,모란,20628,21006,41634
14981,20201106,수인분당선,태평,13779,13018,26797
14982,20201106,수인분당선,가천대,8639,9127,17766
14983,20201106,수인분당선,선정릉,8401,8990,17391
14984,20201106,수인분당선,강남구청,9915,11564,21479
14985,20201106,수인분당선,압구정로데오,18045,22118,40163
14986,20201106,수인분당선,서울숲,9665,9582,19247
14987,20201106,수인분당선,수원,8984,6504,15488
14988,20201106,수인분당선,수서,15191,16160,31351
14989,20201106,수인분당선,대모산입구,3526,3266,6792
14990,20201106,수인분당선,개포동,3854,3896,7750
14991,20201106,수인분당선,구룡,2136,1977,4113
14992,20201106,수인분당선,도곡,6906,6737,13643
14993,20201106,수인분당선,한티,14340,15316,29656
14994,20201106,수인분당선,선릉,13897,21327,35224
14995,20201107,수인분당선,선릉,5604,8661,14265
14996,20201107,수인분당선,한티,11864,11450,23314
14997,20201107,수인분당선,도곡,4902,4292,9194
14998,20201107,수인분당선,구룡,1417,1377,2794
14999,20201107,수인분당선,개포동,2510,2480,4990
15000,20201107,수인분당선,대모산입구,2573,2308,4881
15001,20201107,수인분당선,수서,10410,10648,21058
15002,20201107,수인분당선,수원,8043,6379,14422
15003,20201107,수인분당선,서울숲,8172,8760,16932
15004,20201107,수인분당선,압구정로데오,15842,19292,35134
15005,20201107,수인분당선,강남구청,5546,6657,12203
15006,20201107,수인분당선,선정릉,3897,4079,7976
15007,20201107,수인분당선,가천대,5198,5514,10712
15008,20201107,수인분당선,태평,10666,9977,20643
15009,20201107,수인분당선,모란,15720,15987,31707
15010,20201107,수인분당선,야탑,17594,18911,36505
15011,20201107,수인분당선,서현,18446,18623,37069
15012,20201107,수인분당선,수내,8990,8326,17316
15013,20201107,수인분당선,정자,10944,11037,21981
15014,20201107,수인분당선,미금,10806,11335,22141
15015,20201107,수인분당선,오리,7818,6446,14264
15016,20201107,수인분당선,이매,4086,3863,7949
15017,20201107,수인분당선,보정,1673,1459,3132
15018,20201107,수인분당선,죽전,10775,11926,22701
15019,20201107,수인분당선,구성,3434,3405,6839
15020,20201107,수인분당선,신갈,2904,2835,5739
15021,20201107,수인분당선,기흥,6896,6438,13334
15022,20201107,수인분당선,상갈,4022,3976,7998
15023,20201107,수인분당선,청명,2934,2731,5665
15024,20201107,수인분당선,영통,6732,6531,13263
15025,20201107,수인분당선,망포,9212,8088,17300
15026,20201107,수인분당선,매탄권선,3396,3100,6496
15027,20201107,수인분당선,수원시청,11150,13240,24390
15028,20201107,수인분당선,매교,1850,1948,3798
15029,20201107,수인분당선,고색,1928,1943,3871
15030,20201107,수인분당선,오목천,1837,1575,3412
15031,20201107,수인분당선,어천,564,468,1032
15032,20201107,수인분당선,야목,189,186,375
15033,20201107,수인분당선,사리,3035,2580,5615
15034,20201107,수인분당선,달월,59,72,131
15035,20201107,수인분당선,월곶,2227,2042,4269
15036,20201107,수인분당선,소래포구,6813,6885,13698
15037,20201107,수인분당선,인천논현,4341,4502,8843
15038,20201107,수인분당선,호구포,2357,2244,4601
15039,20201107,수인분당선,남동인더스파크,922,891,1813
15040,20201107,수인분당선,원인재,3687,3770,7457
15041,20201107,수인분당선,연수,3985,3831,7816
15042,20201107,수인분당선,송도,2162,2072,4234
15043,20201107,수인분당선,인하대,4463,4015,8478
15044,20201107,수인분당선,숭의,2764,2583,5347
15045,20201107,수인분당선,신포,1369,1449,2818
15046,20201107,수인분당선,인천,1285,2255,3540
15047,20201108,수인분당선,선릉,2872,4274,7146
15048,20201108,수인분당선,한티,8462,8248,16710
15049,20201108,수인분당선,도곡,2433,2339,4772
15050,20201108,수인분당선,구룡,676,742,1418
15051,20201108,수인분당선,개포동,1921,1940,3861
15052,20201108,수인분당선,대모산입구,1605,1555,3160
15053,20201108,수인분당선,수서,8357,8253,16610
15054,20201108,수인분당선,수원,6003,4703,10706
15055,20201108,수인분당선,서울숲,6096,6483,12579
15056,20201108,수인분당선,압구정로데오,9001,9969,18970
15057,20201108,수인분당선,강남구청,3152,3810,6962
15058,20201108,수인분당선,선정릉,2238,2300,4538
15059,20201108,수인분당선,가천대,3546,4333,7879
15060,20201108,수인분당선,태평,7835,7404,15239
15061,20201108,수인분당선,모란,11080,11308,22388
15062,20201108,수인분당선,야탑,13195,13789,26984
15063,20201108,수인분당선,서현,13301,13433,26734
15064,20201108,수인분당선,수내,6048,5860,11908
15065,20201108,수인분당선,정자,7276,7480,14756
15066,20201108,수인분당선,미금,7341,7879,15220
15067,20201108,수인분당선,오리,5319,4696,10015
15068,20201108,수인분당선,이매,2955,3017,5972
15069,20201108,수인분당선,보정,1046,943,1989
15070,20201108,수인분당선,죽전,8109,8806,16915
15071,20201108,수인분당선,구성,2362,2473,4835
15072,20201108,수인분당선,신갈,1960,2116,4076
15073,20201108,수인분당선,기흥,4958,4841,9799
15074,20201108,수인분당선,상갈,2868,2889,5757
15075,20201108,수인분당선,청명,1912,2002,3914
15076,20201108,수인분당선,영통,4690,4621,9311
15077,20201108,수인분당선,망포,6041,6277,12318
15078,20201108,수인분당선,매탄권선,2308,2383,4691
15079,20201108,수인분당선,수원시청,7385,7329,14714
15080,20201108,수인분당선,매교,1358,1425,2783
15081,20201108,수인분당선,고색,1291,1429,2720
15082,20201108,수인분당선,오목천,1303,1165,2468
15083,20201108,수인분당선,어천,391,458,849
15084,20201108,수인분당선,야목,166,157,323
15085,20201108,수인분당선,사리,2221,1966,4187
15086,20201108,수인분당선,달월,44,47,91
15087,20201108,수인분당선,월곶,1722,1600,3322
15088,20201108,수인분당선,소래포구,5526,5403,10929
15089,20201108,수인분당선,인천논현,2917,3005,5922
15090,20201108,수인분당선,호구포,1768,1792,3560
15091,20201108,수인분당선,남동인더스파크,779,748,1527
15092,20201108,수인분당선,원인재,2778,2826,5604
15093,20201108,수인분당선,연수,2872,2832,5704
15094,20201108,수인분당선,송도,1588,1501,3089
15095,20201108,수인분당선,인하대,2845,2859,5704
15096,20201108,수인분당선,숭의,1881,1808,3689
15097,20201108,수인분당선,신포,1117,1042,2159
15098,20201108,수인분당선,인천,1088,1722,2810
15099,20201109,수인분당선,야목,190,155,345
15100,20201109,수인분당선,달월,69,53,122
15101,20201109,수인분당선,월곶,2526,2270,4796
15102,20201109,수인분당선,소래포구,5383,5078,10461
15103,20201109,수인분당선,인천논현,5434,5776,11210
15104,20201109,수인분당선,호구포,3556,3742,7298
15105,20201109,수인분당선,남동인더스파크,2354,2643,4997
15106,20201109,수인분당선,원인재,4350,4449,8799
15107,20201109,수인분당선,연수,4434,4273,8707
15108,20201109,수인분당선,송도,2573,2283,4856
15109,20201109,수인분당선,인하대,6069,5807,11876
15110,20201109,수인분당선,숭의,3860,3586,7446
15111,20201109,수인분당선,신포,1771,1756,3527
15112,20201109,수인분당선,인천,942,1630,2572
15113,20201109,수인분당선,복정,2,0,2
15114,20201109,수인분당선,선릉,13865,21215,35080
15115,20201109,수인분당선,한티,12432,13434,25866
15116,20201109,수인분당선,도곡,6864,6893,13757
15117,20201109,수인분당선,구룡,1997,1978,3975
15118,20201109,수인분당선,개포동,3654,3799,7453
15119,20201109,수인분당선,대모산입구,3687,3520,7207
15120,20201109,수인분당선,수서,13982,14133,28115
15121,20201109,수인분당선,수원,8125,6225,14350
15122,20201109,수인분당선,서울숲,8577,8667,17244
15123,20201109,수인분당선,압구정로데오,15104,17020,32124
15124,20201109,수인분당선,강남구청,9584,10863,20447
15125,20201109,수인분당선,선정릉,8222,8805,17027
15126,20201109,수인분당선,가천대,8620,9832,18452
15127,20201109,수인분당선,태평,13493,13139,26632
15128,20201109,수인분당선,모란,25226,25792,51018
15129,20201109,수인분당선,야탑,25855,27072,52927
15130,20201109,수인분당선,서현,24654,24955,49609
15131,20201109,수인분당선,수내,12375,12371,24746
15132,20201109,수인분당선,정자,16509,17730,34239
15133,20201109,수인분당선,미금,15870,16819,32689
15134,20201109,수인분당선,오리,12102,10235,22337
15135,20201109,수인분당선,이매,5674,5374,11048
15136,20201109,수인분당선,보정,2579,2273,4852
15137,20201109,수인분당선,죽전,13842,15313,29155
15138,20201109,수인분당선,구성,5007,5119,10126
15139,20201109,수인분당선,신갈,4672,4611,9283
15140,20201109,수인분당선,기흥,9735,9124,18859
15141,20201109,수인분당선,상갈,5552,5363,10915
15142,20201109,수인분당선,청명,4307,4170,8477
15143,20201109,수인분당선,영통,8021,8360,16381
15144,20201109,수인분당선,망포,13901,13315,27216
15145,20201109,수인분당선,매탄권선,4743,4579,9322
15146,20201109,수인분당선,수원시청,11900,12746,24646
15147,20201109,수인분당선,매교,2841,2904,5745
15148,20201109,수인분당선,고색,2888,2812,5700
15149,20201109,수인분당선,오목천,2570,2333,4903
15150,20201109,수인분당선,어천,571,518,1089
15151,20201109,수인분당선,사리,3338,3161,6499
15152,20201110,수인분당선,송도,2603,2259,4862
15153,20201110,수인분당선,인하대,6118,5835,11953
15154,20201110,수인분당선,숭의,3919,3711,7630
15155,20201110,수인분당선,망포,14453,13739,28192
15156,20201110,수인분당선,매탄권선,4808,4664,9472
15157,20201110,수인분당선,영통,8264,8512,16776
15158,20201110,수인분당선,청명,4441,4151,8592
15159,20201110,수인분당선,상갈,5583,5361,10944
15160,20201110,수인분당선,기흥,10000,9605,19605
15161,20201110,수인분당선,신갈,4806,4634,9440
15162,20201110,수인분당선,구성,5158,5300,10458
15163,20201110,수인분당선,죽전,14169,15613,29782
15164,20201110,수인분당선,보정,2694,2291,4985
15165,20201110,수인분당선,이매,5797,5370,11167
15166,20201110,수인분당선,오리,12225,10368,22593
15167,20201110,수인분당선,미금,16249,17202,33451
15168,20201110,수인분당선,정자,17048,18269,35317
15169,20201110,수인분당선,수내,13303,13494,26797
15170,20201110,수인분당선,서현,24655,25344,49999
15171,20201110,수인분당선,야탑,26252,27494,53746
15172,20201110,수인분당선,모란,19997,20100,40097
15173,20201110,수인분당선,태평,13495,12986,26481
15174,20201110,수인분당선,가천대,8896,10071,18967
15175,20201110,수인분당선,선정릉,8291,8940,17231
15176,20201110,수인분당선,강남구청,9806,11290,21096
15177,20201110,수인분당선,압구정로데오,17012,19486,36498
15178,20201110,수인분당선,서울숲,9444,9445,18889
15179,20201110,수인분당선,수원,8457,7131,15588
15180,20201110,수인분당선,복정,1,0,1
15181,20201110,수인분당선,수서,13681,14053,27734
15182,20201110,수인분당선,대모산입구,3659,3481,7140
15183,20201110,수인분당선,개포동,3807,3868,7675
15184,20201110,수인분당선,구룡,1967,1938,3905
15185,20201110,수인분당선,도곡,6819,6947,13766
15186,20201110,수인분당선,한티,13954,14851,28805
15187,20201110,수인분당선,선릉,14276,21554,35830
15188,20201110,수인분당선,오목천,2636,2302,4938
15189,20201110,수인분당선,신포,1797,1876,3673
15190,20201110,수인분당선,인천,1001,1728,2729
15191,20201110,수인분당선,어천,615,541,1156
15192,20201110,수인분당선,야목,209,172,381
15193,20201110,수인분당선,사리,3422,3273,6695
15194,20201110,수인분당선,달월,91,61,152
15195,20201110,수인분당선,월곶,2585,2371,4956
15196,20201110,수인분당선,소래포구,5767,5396,11163
15197,20201110,수인분당선,인천논현,5561,5936,11497
15198,20201110,수인분당선,호구포,3615,3728,7343
15199,20201110,수인분당선,남동인더스파크,2466,2673,5139
15200,20201110,수인분당선,원인재,4496,4626,9122
15201,20201110,수인분당선,연수,4573,4472,9045
15202,20201110,수인분당선,고색,2981,2924,5905
15203,20201110,수인분당선,매교,2966,2867,5833
15204,20201110,수인분당선,수원시청,12056,13146,25202
15205,20201111,수인분당선,복정,1,0,1
15206,20201111,수인분당선,선릉,14385,21856,36241
15207,20201111,수인분당선,한티,14079,15101,29180
15208,20201111,수인분당선,도곡,6893,6954,13847
15209,20201111,수인분당선,구룡,2005,1965,3970
15210,20201111,수인분당선,개포동,3957,4044,8001
15211,20201111,수인분당선,대모산입구,3671,3443,7114
15212,20201111,수인분당선,수서,13873,14028,27901
15213,20201111,수인분당선,수원,8452,6694,15146
15214,20201111,수인분당선,서울숲,9787,9932,19719
15215,20201111,수인분당선,압구정로데오,17282,19710,36992
15216,20201111,수인분당선,강남구청,9944,11669,21613
15217,20201111,수인분당선,선정릉,8292,8845,17137
15218,20201111,수인분당선,가천대,9022,10060,19082
15219,20201111,수인분당선,태평,13743,13235,26978
15220,20201111,수인분당선,모란,20268,20229,40497
15221,20201111,수인분당선,야탑,27096,28368,55464
15222,20201111,수인분당선,서현,25278,25766,51044
15223,20201111,수인분당선,수내,13667,13780,27447
15224,20201111,수인분당선,정자,17390,18861,36251
15225,20201111,수인분당선,미금,16179,17206,33385
15226,20201111,수인분당선,오리,12479,10703,23182
15227,20201111,수인분당선,이매,5806,5433,11239
15228,20201111,수인분당선,보정,2754,2335,5089
15229,20201111,수인분당선,죽전,14729,16029,30758
15230,20201111,수인분당선,구성,5227,5398,10625
15231,20201111,수인분당선,신갈,4811,4742,9553
15232,20201111,수인분당선,기흥,10081,9611,19692
15233,20201111,수인분당선,상갈,5784,5452,11236
15234,20201111,수인분당선,청명,4501,4260,8761
15235,20201111,수인분당선,영통,8526,8803,17329
15236,20201111,수인분당선,망포,14587,13678,28265
15237,20201111,수인분당선,매탄권선,4891,4651,9542
15238,20201111,수인분당선,수원시청,12211,13474,25685
15239,20201111,수인분당선,매교,3012,3013,6025
15240,20201111,수인분당선,고색,3110,2949,6059
15241,20201111,수인분당선,오목천,2757,2333,5090
15242,20201111,수인분당선,어천,611,564,1175
15243,20201111,수인분당선,야목,201,169,370
15244,20201111,수인분당선,사리,3474,3226,6700
15245,20201111,수인분당선,달월,86,62,148
15246,20201111,수인분당선,월곶,2623,2415,5038
15247,20201111,수인분당선,소래포구,6078,5793,11871
15248,20201111,수인분당선,인천논현,5762,6131,11893
15249,20201111,수인분당선,호구포,3688,3764,7452
15250,20201111,수인분당선,남동인더스파크,2485,2768,5253
15251,20201111,수인분당선,원인재,4512,4653,9165
15252,20201111,수인분당선,연수,4700,4565,9265
15253,20201111,수인분당선,송도,2793,2543,5336
15254,20201111,수인분당선,인하대,6321,5975,12296
15255,20201111,수인분당선,숭의,4059,3731,7790
15256,20201111,수인분당선,신포,1861,1847,3708
15257,20201111,수인분당선,인천,1070,1850,2920
15258,20201112,수인분당선,선릉,14202,21537,35739
15259,20201112,수인분당선,한티,13903,14958,28861
15260,20201112,수인분당선,도곡,6896,6756,13652
15261,20201112,수인분당선,구룡,2013,1958,3971
15262,20201112,수인분당선,개포동,3820,3825,7645
15263,20201112,수인분당선,대모산입구,3641,3354,6995
15264,20201112,수인분당선,수서,14241,14623,28864
15265,20201112,수인분당선,수원,8451,6224,14675
15266,20201112,수인분당선,서울숲,9632,9690,19322
15267,20201112,수인분당선,압구정로데오,17390,19924,37314
15268,20201112,수인분당선,강남구청,9754,11355,21109
15269,20201112,수인분당선,선정릉,8218,8833,17051
15270,20201112,수인분당선,가천대,8726,9754,18480
15271,20201112,수인분당선,태평,13499,12950,26449
15272,20201112,수인분당선,모란,20003,20051,40054
15273,20201112,수인분당선,야탑,26521,27798,54319
15274,20201112,수인분당선,서현,24699,25326,50025
15275,20201112,수인분당선,수내,13251,13385,26636
15276,20201112,수인분당선,정자,17294,18661,35955
15277,20201112,수인분당선,미금,16099,17122,33221
15278,20201112,수인분당선,오리,12372,10585,22957
15279,20201112,수인분당선,이매,5758,5433,11191
15280,20201112,수인분당선,보정,2607,2283,4890
15281,20201112,수인분당선,죽전,14602,15853,30455
15282,20201112,수인분당선,구성,5233,5341,10574
15283,20201112,수인분당선,신갈,4741,4533,9274
15284,20201112,수인분당선,기흥,9716,9282,18998
15285,20201112,수인분당선,상갈,5593,5265,10858
15286,20201112,수인분당선,청명,4483,4250,8733
15287,20201112,수인분당선,영통,8734,8967,17701
15288,20201112,수인분당선,망포,14610,13652,28262
15289,20201112,수인분당선,매탄권선,4900,4735,9635
15290,20201112,수인분당선,수원시청,12189,13501,25690
15291,20201112,수인분당선,매교,2927,2967,5894
15292,20201112,수인분당선,고색,2964,2922,5886
15293,20201112,수인분당선,오목천,2715,2414,5129
15294,20201112,수인분당선,어천,627,592,1219
15295,20201112,수인분당선,야목,203,188,391
15296,20201112,수인분당선,사리,3548,3282,6830
15297,20201112,수인분당선,달월,83,64,147
15298,20201112,수인분당선,월곶,2596,2278,4874
15299,20201112,수인분당선,소래포구,6405,6196,12601
15300,20201112,수인분당선,인천논현,5566,5986,11552
15301,20201112,수인분당선,호구포,3535,3670,7205
15302,20201112,수인분당선,남동인더스파크,2266,2681,4947
15303,20201112,수인분당선,원인재,4586,4755,9341
15304,20201112,수인분당선,연수,4559,4450,9009
15305,20201112,수인분당선,송도,2690,2405,5095
15306,20201112,수인분당선,인하대,6136,5762,11898
15307,20201112,수인분당선,숭의,3853,3734,7587
15308,20201112,수인분당선,신포,1862,1866,3728
15309,20201112,수인분당선,인천,1014,1753,2767
15310,20201113,수인분당선,선릉,14148,21451,35599
15311,20201113,수인분당선,한티,14732,15589,30321
15312,20201113,수인분당선,도곡,6831,6806,13637
15313,20201113,수인분당선,구룡,2070,1961,4031
15314,20201113,수인분당선,개포동,3978,4049,8027
15315,20201113,수인분당선,대모산입구,3752,3418,7170
15316,20201113,수인분당선,수서,15333,16305,31638
15317,20201113,수인분당선,수원,9246,7611,16857
15318,20201113,수인분당선,서울숲,10020,10101,20121
15319,20201113,수인분당선,압구정로데오,18477,22717,41194
15320,20201113,수인분당선,강남구청,10166,11605,21771
15321,20201113,수인분당선,선정릉,8174,8851,17025
15322,20201113,수인분당선,가천대,8302,8841,17143
15323,20201113,수인분당선,태평,13990,13301,27291
15324,20201113,수인분당선,모란,20675,20904,41579
15325,20201113,수인분당선,야탑,27594,29069,56663
15326,20201113,수인분당선,서현,26206,26993,53199
15327,20201113,수인분당선,수내,13879,13661,27540
15328,20201113,수인분당선,정자,17619,19149,36768
15329,20201113,수인분당선,미금,16210,17360,33570
15330,20201113,수인분당선,오리,12562,10584,23146
15331,20201113,수인분당선,이매,6036,5739,11775
15332,20201113,수인분당선,보정,2689,2277,4966
15333,20201113,수인분당선,죽전,15499,16439,31938
15334,20201113,수인분당선,구성,5172,5376,10548
15335,20201113,수인분당선,신갈,4799,4579,9378
15336,20201113,수인분당선,기흥,10207,9717,19924
15337,20201113,수인분당선,상갈,5847,5426,11273
15338,20201113,수인분당선,청명,4667,4266,8933
15339,20201113,수인분당선,영통,9458,9607,19065
15340,20201113,수인분당선,망포,15780,14317,30097
15341,20201113,수인분당선,매탄권선,5251,4791,10042
15342,20201113,수인분당선,수원시청,13138,15866,29004
15343,20201113,수인분당선,매교,3004,3047,6051
15344,20201113,수인분당선,고색,3178,3060,6238
15345,20201113,수인분당선,오목천,2905,2387,5292
15346,20201113,수인분당선,어천,681,550,1231
15347,20201113,수인분당선,야목,214,177,391
15348,20201113,수인분당선,사리,3671,3428,7099
15349,20201113,수인분당선,달월,87,61,148
15350,20201113,수인분당선,월곶,2661,2470,5131
15351,20201113,수인분당선,소래포구,6085,5976,12061
15352,20201113,수인분당선,인천논현,5794,6201,11995
15353,20201113,수인분당선,호구포,3691,3664,7355
15354,20201113,수인분당선,남동인더스파크,2350,2524,4874
15355,20201113,수인분당선,원인재,4702,4838,9540
15356,20201113,수인분당선,연수,4765,4850,9615
15357,20201113,수인분당선,송도,2770,2436,5206
15358,20201113,수인분당선,인하대,6353,5916,12269
15359,20201113,수인분당선,숭의,3920,3646,7566
15360,20201113,수인분당선,신포,1872,1954,3826
15361,20201113,수인분당선,인천,1037,1721,2758
15362,20201114,수인분당선,선릉,5728,8857,14585
15363,20201114,수인분당선,한티,11758,11364,23122
15364,20201114,수인분당선,도곡,4357,3892,8249
15365,20201114,수인분당선,구룡,1185,1096,2281
15366,20201114,수인분당선,개포동,2718,2602,5320
15367,20201114,수인분당선,대모산입구,2443,2314,4757
15368,20201114,수인분당선,수서,10761,11010,21771
15369,20201114,수인분당선,수원,7933,6630,14563
15370,20201114,수인분당선,서울숲,8193,8678,16871
15371,20201114,수인분당선,압구정로데오,15883,19234,35117
15372,20201114,수인분당선,강남구청,5187,6438,11625
15373,20201114,수인분당선,선정릉,3791,3772,7563
15374,20201114,수인분당선,가천대,5810,6033,11843
15375,20201114,수인분당선,태평,10584,10080,20664
15376,20201114,수인분당선,모란,21549,22281,43830
15377,20201114,수인분당선,야탑,18088,18989,37077
15378,20201114,수인분당선,서현,18461,18727,37188
15379,20201114,수인분당선,수내,8891,8384,17275
15380,20201114,수인분당선,정자,11041,11185,22226
15381,20201114,수인분당선,미금,10870,11211,22081
15382,20201114,수인분당선,오리,7879,6517,14396
15383,20201114,수인분당선,이매,4322,4083,8405
15384,20201114,수인분당선,보정,1650,1459,3109
15385,20201114,수인분당선,죽전,10774,11660,22434
15386,20201114,수인분당선,구성,3355,3325,6680
15387,20201114,수인분당선,신갈,3100,3024,6124
15388,20201114,수인분당선,기흥,6888,6477,13365
15389,20201114,수인분당선,상갈,3878,3881,7759
15390,20201114,수인분당선,청명,2794,2678,5472
15391,20201114,수인분당선,영통,6880,6691,13571
15392,20201114,수인분당선,망포,9466,8222,17688
15393,20201114,수인분당선,매탄권선,3436,3030,6466
15394,20201114,수인분당선,수원시청,10701,12597,23298
15395,20201114,수인분당선,매교,1899,1954,3853
15396,20201114,수인분당선,고색,1924,1909,3833
15397,20201114,수인분당선,오목천,1813,1601,3414
15398,20201114,수인분당선,어천,476,472,948
15399,20201114,수인분당선,야목,189,170,359
15400,20201114,수인분당선,사리,2890,2488,5378
15401,20201114,수인분당선,달월,48,57,105
15402,20201114,수인분당선,월곶,2097,2026,4123
15403,20201114,수인분당선,소래포구,6458,6551,13009
15404,20201114,수인분당선,인천논현,4408,4498,8906
15405,20201114,수인분당선,호구포,2348,2179,4527
15406,20201114,수인분당선,남동인더스파크,1003,921,1924
15407,20201114,수인분당선,원인재,3705,3729,7434
15408,20201114,수인분당선,연수,3966,4027,7993
15409,20201114,수인분당선,송도,2131,2033,4164
15410,20201114,수인분당선,인하대,4148,3785,7933
15411,20201114,수인분당선,숭의,2630,2421,5051
15412,20201114,수인분당선,신포,1472,1487,2959
15413,20201114,수인분당선,인천,1252,2351,3603
15414,20201115,수인분당선,서울숲,5376,5737,11113
15415,20201115,수인분당선,인천,1108,1846,2954
15416,20201115,수인분당선,신포,1165,1141,2306
15417,20201115,수인분당선,숭의,2012,1793,3805
15418,20201115,수인분당선,인하대,3069,3009,6078
15419,20201115,수인분당선,송도,1523,1464,2987
15420,20201115,수인분당선,연수,3054,2976,6030
15421,20201115,수인분당선,원인재,2639,2788,5427
15422,20201115,수인분당선,남동인더스파크,718,708,1426
15423,20201115,수인분당선,호구포,1812,1815,3627
15424,20201115,수인분당선,인천논현,3164,3206,6370
15425,20201115,수인분당선,소래포구,5068,4942,10010
15426,20201115,수인분당선,월곶,1645,1522,3167
15427,20201115,수인분당선,달월,42,43,85
15428,20201115,수인분당선,사리,2127,1900,4027
15429,20201115,수인분당선,야목,151,125,276
15430,20201115,수인분당선,어천,348,381,729
15431,20201115,수인분당선,오목천,1238,1143,2381
15432,20201115,수인분당선,고색,1247,1343,2590
15433,20201115,수인분당선,매교,1455,1496,2951
15434,20201115,수인분당선,수원시청,7127,7059,14186
15435,20201115,수인분당선,매탄권선,2383,2275,4658
15436,20201115,수인분당선,망포,5893,6371,12264
15437,20201115,수인분당선,영통,4639,4763,9402
15438,20201115,수인분당선,청명,1850,1900,3750
15439,20201115,수인분당선,상갈,2954,2966,5920
15440,20201115,수인분당선,기흥,4751,4799,9550
15441,20201115,수인분당선,신갈,1940,2016,3956
15442,20201115,수인분당선,구성,2342,2398,4740
15443,20201115,수인분당선,죽전,8037,9045,17082
15444,20201115,수인분당선,보정,1038,1002,2040
15445,20201115,수인분당선,이매,3015,3059,6074
15446,20201115,수인분당선,오리,5453,4872,10325
15447,20201115,수인분당선,미금,6687,7273,13960
15448,20201115,수인분당선,정자,7001,7264,14265
15449,20201115,수인분당선,수내,5929,5739,11668
15450,20201115,수인분당선,서현,12613,12876,25489
15451,20201115,수인분당선,야탑,13066,13282,26348
15452,20201115,수인분당선,모란,10714,11105,21819
15453,20201115,수인분당선,태평,7785,7234,15019
15454,20201115,수인분당선,가천대,4095,4769,8864
15455,20201115,수인분당선,선정릉,2282,2423,4705
15456,20201115,수인분당선,강남구청,2967,3630,6597
15457,20201115,수인분당선,압구정로데오,8789,9745,18534
15458,20201115,수인분당선,수원,6013,4944,10957
15459,20201115,수인분당선,복정,2,0,2
15460,20201115,수인분당선,수서,8350,8073,16423
15461,20201115,수인분당선,대모산입구,1342,1350,2692
15462,20201115,수인분당선,개포동,1993,1966,3959
15463,20201115,수인분당선,구룡,640,768,1408
15464,20201115,수인분당선,도곡,2486,2371,4857
15465,20201115,수인분당선,한티,8163,7931,16094
15466,20201115,수인분당선,선릉,3033,4435,7468
15467,20201116,수인분당선,인천,984,1617,2601
15468,20201116,수인분당선,신포,1737,1724,3461
15469,20201116,수인분당선,숭의,3932,3666,7598
15470,20201116,수인분당선,인하대,5888,5721,11609
15471,20201116,수인분당선,송도,2602,2406,5008
15472,20201116,수인분당선,연수,4444,4292,8736
15473,20201116,수인분당선,원인재,4404,4525,8929
15474,20201116,수인분당선,남동인더스파크,2312,2640,4952
15475,20201116,수인분당선,호구포,3621,3737,7358
15476,20201116,수인분당선,인천논현,5507,5778,11285
15477,20201116,수인분당선,소래포구,5789,5483,11272
15478,20201116,수인분당선,월곶,2479,2305,4784
15479,20201116,수인분당선,달월,76,55,131
15480,20201116,수인분당선,사리,3421,3243,6664
15481,20201116,수인분당선,야목,207,160,367
15482,20201116,수인분당선,어천,556,529,1085
15483,20201116,수인분당선,오목천,2690,2342,5032
15484,20201116,수인분당선,고색,3005,2946,5951
15485,20201116,수인분당선,매교,2870,2895,5765
15486,20201116,수인분당선,수원시청,12086,12750,24836
15487,20201116,수인분당선,매탄권선,4781,4539,9320
15488,20201116,수인분당선,망포,14081,13441,27522
15489,20201116,수인분당선,영통,8261,8744,17005
15490,20201116,수인분당선,청명,4255,3991,8246
15491,20201116,수인분당선,상갈,5452,5153,10605
15492,20201116,수인분당선,기흥,9623,9083,18706
15493,20201116,수인분당선,신갈,4586,4459,9045
15494,20201116,수인분당선,구성,4994,5169,10163
15495,20201116,수인분당선,죽전,12806,14052,26858
15496,20201116,수인분당선,보정,2575,2264,4839
15497,20201116,수인분당선,이매,5523,5124,10647
15498,20201116,수인분당선,오리,11904,10328,22232
15499,20201116,수인분당선,미금,15412,16424,31836
15500,20201116,수인분당선,정자,16356,17715,34071
15501,20201116,수인분당선,수내,12828,12945,25773
15502,20201116,수인분당선,서현,23682,24206,47888
15503,20201116,수인분당선,야탑,25574,26962,52536
15504,20201116,수인분당선,모란,19478,19400,38878
15505,20201116,수인분당선,태평,13217,12677,25894
15506,20201116,수인분당선,가천대,8555,9905,18460
15507,20201116,수인분당선,선정릉,7982,8591,16573
15508,20201116,수인분당선,강남구청,9402,10585,19987
15509,20201116,수인분당선,압구정로데오,15432,17406,32838
15510,20201116,수인분당선,서울숲,9196,9299,18495
15511,20201116,수인분당선,수원,8054,6769,14823
15512,20201116,수인분당선,복정,1,0,1
15513,20201116,수인분당선,수서,13794,13949,27743
15514,20201116,수인분당선,대모산입구,3617,3425,7042
15515,20201116,수인분당선,개포동,3710,3818,7528
15516,20201116,수인분당선,구룡,2047,2061,4108
15517,20201116,수인분당선,도곡,6813,6893,13706
15518,20201116,수인분당선,한티,13180,14351,27531
15519,20201116,수인분당선,선릉,13867,21516,35383
15520,20201117,수인분당선,인천,879,1613,2492
15521,20201117,수인분당선,신포,1771,1832,3603
15522,20201117,수인분당선,숭의,3957,3654,7611
15523,20201117,수인분당선,인하대,5974,5720,11694
15524,20201117,수인분당선,송도,2563,2330,4893
15525,20201117,수인분당선,연수,4322,4368,8690
15526,20201117,수인분당선,원인재,4281,4519,8800
15527,20201117,수인분당선,남동인더스파크,2360,2603,4963
15528,20201117,수인분당선,호구포,3591,3663,7254
15529,20201117,수인분당선,인천논현,5414,5747,11161
15530,20201117,수인분당선,소래포구,5582,5304,10886
15531,20201117,수인분당선,월곶,2508,2325,4833
15532,20201117,수인분당선,달월,88,70,158
15533,20201117,수인분당선,사리,3357,3231,6588
15534,20201117,수인분당선,야목,189,159,348
15535,20201117,수인분당선,어천,565,517,1082
15536,20201117,수인분당선,오목천,2698,2343,5041
15537,20201117,수인분당선,고색,2985,2852,5837
15538,20201117,수인분당선,매교,2888,2909,5797
15539,20201117,수인분당선,수원시청,12153,13352,25505
15540,20201117,수인분당선,매탄권선,4705,4584,9289
15541,20201117,수인분당선,망포,14110,13508,27618
15542,20201117,수인분당선,영통,8268,8582,16850
15543,20201117,수인분당선,청명,4366,4142,8508
15544,20201117,수인분당선,상갈,5524,5229,10753
15545,20201117,수인분당선,기흥,9549,9230,18779
15546,20201117,수인분당선,신갈,4678,4524,9202
15547,20201117,수인분당선,구성,5104,5279,10383
15548,20201117,수인분당선,죽전,13702,15064,28766
15549,20201117,수인분당선,보정,2659,2215,4874
15550,20201117,수인분당선,이매,5639,5140,10779
15551,20201117,수인분당선,오리,11926,10217,22143
15552,20201117,수인분당선,미금,15613,16759,32372
15553,20201117,수인분당선,정자,16813,17978,34791
15554,20201117,수인분당선,수내,12855,13173,26028
15555,20201117,수인분당선,서현,23758,24305,48063
15556,20201117,수인분당선,야탑,25722,26814,52536
15557,20201117,수인분당선,모란,19581,19649,39230
15558,20201117,수인분당선,태평,13337,12909,26246
15559,20201117,수인분당선,가천대,8954,10143,19097
15560,20201117,수인분당선,선정릉,8131,8747,16878
15561,20201117,수인분당선,강남구청,9774,11304,21078
15562,20201117,수인분당선,압구정로데오,16836,19235,36071
15563,20201117,수인분당선,서울숲,9094,9135,18229
15564,20201117,수인분당선,수원,8167,6621,14788
15565,20201117,수인분당선,수서,13605,13946,27551
15566,20201117,수인분당선,대모산입구,3656,3409,7065
15567,20201117,수인분당선,개포동,3774,3904,7678
15568,20201117,수인분당선,구룡,1949,1980,3929
15569,20201117,수인분당선,도곡,6763,6823,13586
15570,20201117,수인분당선,한티,13676,14746,28422
15571,20201117,수인분당선,선릉,14197,21361,35558
15572,20201118,수인분당선,야탑,25355,26668,52023
15573,20201118,수인분당선,서현,23608,24297,47905
15574,20201118,수인분당선,수내,13086,13159,26245
15575,20201118,수인분당선,정자,16566,17919,34485
15576,20201118,수인분당선,미금,15474,16486,31960
15577,20201118,수인분당선,오리,11934,9959,21893
15578,20201118,수인분당선,이매,5570,5218,10788
15579,20201118,수인분당선,보정,2614,2193,4807
15580,20201118,수인분당선,죽전,13251,14651,27902
15581,20201118,수인분당선,구성,4974,5123,10097
15582,20201118,수인분당선,신갈,4513,4437,8950
15583,20201118,수인분당선,기흥,9465,9103,18568
15584,20201118,수인분당선,상갈,5523,5162,10685
15585,20201118,수인분당선,청명,4310,4133,8443
15586,20201118,수인분당선,영통,8097,8413,16510
15587,20201118,수인분당선,망포,14112,13216,27328
15588,20201118,수인분당선,매탄권선,4735,4538,9273
15589,20201118,수인분당선,월곶,2440,2323,4763
15590,20201118,수인분당선,달월,75,43,118
15591,20201118,수인분당선,사리,3245,3118,6363
15592,20201118,수인분당선,야목,213,169,382
15593,20201118,수인분당선,어천,552,517,1069
15594,20201118,수인분당선,오목천,2597,2263,4860
15595,20201118,수인분당선,고색,2981,2823,5804
15596,20201118,수인분당선,매교,2911,2902,5813
15597,20201118,수인분당선,수원시청,11864,12919,24783
15598,20201118,수인분당선,소래포구,4971,4720,9691
15599,20201118,수인분당선,인천논현,5352,5640,10992
15600,20201118,수인분당선,호구포,3590,3632,7222
15601,20201118,수인분당선,남동인더스파크,2409,2646,5055
15602,20201118,수인분당선,원인재,4301,4387,8688
15603,20201118,수인분당선,연수,4429,4423,8852
15604,20201118,수인분당선,송도,2491,2277,4768
15605,20201118,수인분당선,인하대,5959,5619,11578
15606,20201118,수인분당선,숭의,3730,3637,7367
15607,20201118,수인분당선,신포,1704,1688,3392
15608,20201118,수인분당선,인천,983,1621,2604
15609,20201118,수인분당선,선릉,13987,21239,35226
15610,20201118,수인분당선,한티,13599,14666,28265
15611,20201118,수인분당선,도곡,6578,6704,13282
15612,20201118,수인분당선,구룡,1925,1882,3807
15613,20201118,수인분당선,개포동,3864,4028,7892
15614,20201118,수인분당선,대모산입구,3523,3308,6831
15615,20201118,수인분당선,수서,13264,13702,26966
15616,20201118,수인분당선,수원,8011,6482,14493
15617,20201118,수인분당선,서울숲,8680,8796,17476
15618,20201118,수인분당선,압구정로데오,16618,18952,35570
15619,20201118,수인분당선,강남구청,10032,11370,21402
15620,20201118,수인분당선,선정릉,8212,8780,16992
15621,20201118,수인분당선,가천대,8979,10084,19063
15622,20201118,수인분당선,태평,13225,12792,26017
15623,20201118,수인분당선,모란,19395,19278,38673
15624,20201119,수인분당선,망포,13257,12554,25811
15625,20201119,수인분당선,선릉,13316,21052,34368
15626,20201119,수인분당선,한티,13173,14273,27446
15627,20201119,수인분당선,도곡,6512,6405,12917
15628,20201119,수인분당선,구룡,1880,1848,3728
15629,20201119,수인분당선,개포동,3699,3704,7403
15630,20201119,수인분당선,대모산입구,3549,3005,6554
15631,20201119,수인분당선,수서,13627,13746,27373
15632,20201119,수인분당선,수원,7593,6127,13720
15633,20201119,수인분당선,서울숲,8350,8483,16833
15634,20201119,수인분당선,압구정로데오,15883,18825,34708
15635,20201119,수인분당선,강남구청,9391,11022,20413
15636,20201119,수인분당선,선정릉,8088,8787,16875
15637,20201119,수인분당선,가천대,8369,9429,17798
15638,20201119,수인분당선,태평,12676,12112,24788
15639,20201119,수인분당선,모란,20173,20442,40615
15640,20201119,수인분당선,야탑,24285,25644,49929
15641,20201119,수인분당선,서현,22552,23053,45605
15642,20201119,수인분당선,수내,12293,12314,24607
15643,20201119,수인분당선,정자,15972,16982,32954
15644,20201119,수인분당선,미금,14487,15421,29908
15645,20201119,수인분당선,오리,11055,9521,20576
15646,20201119,수인분당선,이매,5387,4890,10277
15647,20201119,수인분당선,보정,2529,2063,4592
15648,20201119,수인분당선,죽전,12615,13884,26499
15649,20201119,수인분당선,구성,4659,4747,9406
15650,20201119,수인분당선,신갈,4290,4131,8421
15651,20201119,수인분당선,기흥,9028,8534,17562
15652,20201119,수인분당선,상갈,5127,4775,9902
15653,20201119,수인분당선,청명,4197,3837,8034
15654,20201119,수인분당선,영통,7469,7881,15350
15655,20201119,수인분당선,매탄권선,4435,4338,8773
15656,20201119,수인분당선,수원시청,11113,12112,23225
15657,20201119,수인분당선,매교,2662,2701,5363
15658,20201119,수인분당선,고색,2808,2702,5510
15659,20201119,수인분당선,오목천,2306,2033,4339
15660,20201119,수인분당선,어천,490,460,950
15661,20201119,수인분당선,야목,168,143,311
15662,20201119,수인분당선,사리,2951,2771,5722
15663,20201119,수인분당선,달월,79,43,122
15664,20201119,수인분당선,월곶,2315,2146,4461
15665,20201119,수인분당선,소래포구,4077,3866,7943
15666,20201119,수인분당선,인천논현,4962,5303,10265
15667,20201119,수인분당선,호구포,3278,3481,6759
15668,20201119,수인분당선,남동인더스파크,2229,2515,4744
15669,20201119,수인분당선,원인재,4052,4041,8093
15670,20201119,수인분당선,연수,4080,4031,8111
15671,20201119,수인분당선,송도,2209,2016,4225
15672,20201119,수인분당선,인하대,5467,5271,10738
15673,20201119,수인분당선,숭의,3408,3216,6624
15674,20201119,수인분당선,신포,1558,1586,3144
15675,20201119,수인분당선,인천,817,1339,2156
15676,20201120,수인분당선,선릉,13429,20819,34248
15677,20201120,수인분당선,한티,14104,15177,29281
15678,20201120,수인분당선,도곡,6632,6536,13168
15679,20201120,수인분당선,구룡,2130,1985,4115
15680,20201120,수인분당선,개포동,3839,3928,7767
15681,20201120,수인분당선,대모산입구,3568,3264,6832
15682,20201120,수인분당선,수서,14740,15821,30561
15683,20201120,수인분당선,복정,1,0,1
15684,20201120,수인분당선,수원,8637,7417,16054
15685,20201120,수인분당선,서울숲,9042,9130,18172
15686,20201120,수인분당선,압구정로데오,18469,22107,40576
15687,20201120,수인분당선,강남구청,9873,11398,21271
15688,20201120,수인분당선,선정릉,8413,8700,17113
15689,20201120,수인분당선,가천대,8464,8911,17375
15690,20201120,수인분당선,태평,13624,13137,26761
15691,20201120,수인분당선,모란,19895,20455,40350
15692,20201120,수인분당선,야탑,26541,27806,54347
15693,20201120,수인분당선,서현,25152,26029,51181
15694,20201120,수인분당선,수내,13212,13501,26713
15695,20201120,수인분당선,정자,16819,18330,35149
15696,20201120,수인분당선,미금,15654,16740,32394
15697,20201120,수인분당선,오리,12028,10195,22223
15698,20201120,수인분당선,이매,5648,5315,10963
15699,20201120,수인분당선,보정,2599,2199,4798
15700,20201120,수인분당선,죽전,14066,15113,29179
15701,20201120,수인분당선,구성,4865,5124,9989
15702,20201120,수인분당선,신갈,4520,4439,8959
15703,20201120,수인분당선,기흥,9856,9381,19237
15704,20201120,수인분당선,상갈,5677,5206,10883
15705,20201120,수인분당선,청명,4519,4165,8684
15706,20201120,수인분당선,영통,8686,9042,17728
15707,20201120,수인분당선,망포,15089,13645,28734
15708,20201120,수인분당선,매탄권선,5111,4631,9742
15709,20201120,수인분당선,수원시청,12708,15335,28043
15710,20201120,수인분당선,매교,2942,2985,5927
15711,20201120,수인분당선,고색,3233,2988,6221
15712,20201120,수인분당선,오목천,2605,2194,4799
15713,20201120,수인분당선,어천,636,592,1228
15714,20201120,수인분당선,야목,188,157,345
15715,20201120,수인분당선,사리,3544,3208,6752
15716,20201120,수인분당선,달월,90,69,159
15717,20201120,수인분당선,월곶,2416,2317,4733
15718,20201120,수인분당선,소래포구,4726,4709,9435
15719,20201120,수인분당선,인천논현,5438,5888,11326
15720,20201120,수인분당선,호구포,3594,3669,7263
15721,20201120,수인분당선,남동인더스파크,2385,2585,4970
15722,20201120,수인분당선,원인재,4449,4643,9092
15723,20201120,수인분당선,연수,4494,4560,9054
15724,20201120,수인분당선,송도,2501,2272,4773
15725,20201120,수인분당선,인하대,6158,5595,11753
15726,20201120,수인분당선,숭의,3769,3503,7272
15727,20201120,수인분당선,신포,1715,1793,3508
15728,20201120,수인분당선,인천,935,1538,2473
15729,20201121,수인분당선,인천,977,1693,2670
15730,20201121,수인분당선,신포,1200,1270,2470
15731,20201121,수인분당선,숭의,2455,2328,4783
15732,20201121,수인분당선,인하대,3857,3601,7458
15733,20201121,수인분당선,송도,1787,1712,3499
15734,20201121,수인분당선,연수,3488,3590,7078
15735,20201121,수인분당선,원인재,3190,3318,6508
15736,20201121,수인분당선,남동인더스파크,949,895,1844
15737,20201121,수인분당선,호구포,2254,2061,4315
15738,20201121,수인분당선,인천논현,4065,4189,8254
15739,20201121,수인분당선,소래포구,4562,4661,9223
15740,20201121,수인분당선,월곶,1871,1837,3708
15741,20201121,수인분당선,달월,62,56,118
15742,20201121,수인분당선,사리,2561,2212,4773
15743,20201121,수인분당선,야목,157,145,302
15744,20201121,수인분당선,어천,458,402,860
15745,20201121,수인분당선,오목천,1531,1306,2837
15746,20201121,수인분당선,고색,1732,1761,3493
15747,20201121,수인분당선,매교,1779,1880,3659
15748,20201121,수인분당선,수원시청,10100,11554,21654
15749,20201121,수인분당선,매탄권선,3353,2971,6324
15750,20201121,수인분당선,망포,8441,7420,15861
15751,20201121,수인분당선,영통,6092,6034,12126
15752,20201121,수인분당선,청명,2535,2339,4874
15753,20201121,수인분당선,상갈,3433,3390,6823
15754,20201121,수인분당선,기흥,6061,5748,11809
15755,20201121,수인분당선,신갈,2533,2498,5031
15756,20201121,수인분당선,구성,2832,2982,5814
15757,20201121,수인분당선,죽전,9379,10499,19878
15758,20201121,수인분당선,보정,1438,1265,2703
15759,20201121,수인분당선,이매,3596,3362,6958
15760,20201121,수인분당선,오리,7250,6067,13317
15761,20201121,수인분당선,미금,9999,10348,20347
15762,20201121,수인분당선,정자,10013,10038,20051
15763,20201121,수인분당선,수내,8199,7548,15747
15764,20201121,수인분당선,서현,16539,16740,33279
15765,20201121,수인분당선,야탑,15822,16998,32820
15766,20201121,수인분당선,모란,14460,14474,28934
15767,20201121,수인분당선,태평,9679,9180,18859
15768,20201121,수인분당선,가천대,4706,5007,9713
15769,20201121,수인분당선,선정릉,3551,3717,7268
15770,20201121,수인분당선,강남구청,4950,6048,10998
15771,20201121,수인분당선,압구정로데오,14771,17862,32633
15772,20201121,수인분당선,서울숲,6051,6187,12238
15773,20201121,수인분당선,수원,7008,5617,12625
15774,20201121,수인분당선,수서,9374,9644,19018
15775,20201121,수인분당선,대모산입구,2442,2255,4697
15776,20201121,수인분당선,개포동,2384,2290,4674
15777,20201121,수인분당선,구룡,1445,1359,2804
15778,20201121,수인분당선,도곡,4233,3888,8121
15779,20201121,수인분당선,한티,10681,10188,20869
15780,20201121,수인분당선,선릉,4934,7808,12742
15781,20201122,수인분당선,원인재,2312,2257,4569
15782,20201122,수인분당선,연수,2442,2404,4846
15783,20201122,수인분당선,송도,1188,1115,2303
15784,20201122,수인분당선,인하대,2422,2441,4863
15785,20201122,수인분당선,숭의,1555,1466,3021
15786,20201122,수인분당선,신포,884,900,1784
15787,20201122,수인분당선,인천,817,1166,1983
15788,20201122,수인분당선,남동인더스파크,730,684,1414
15789,20201122,수인분당선,호구포,1573,1583,3156
15790,20201122,수인분당선,인천논현,2463,2596,5059
15791,20201122,수인분당선,소래포구,3282,3207,6489
15792,20201122,수인분당선,월곶,1359,1259,2618
15793,20201122,수인분당선,달월,44,46,90
15794,20201122,수인분당선,사리,1758,1570,3328
15795,20201122,수인분당선,야목,104,98,202
15796,20201122,수인분당선,어천,299,369,668
15797,20201122,수인분당선,오목천,964,941,1905
15798,20201122,수인분당선,고색,1130,1169,2299
15799,20201122,수인분당선,매교,1143,1116,2259
15800,20201122,수인분당선,수원시청,6373,6054,12427
15801,20201122,수인분당선,매탄권선,2100,2102,4202
15802,20201122,수인분당선,망포,5117,5425,10542
15803,20201122,수인분당선,영통,3893,4079,7972
15804,20201122,수인분당선,청명,1628,1656,3284
15805,20201122,수인분당선,상갈,2443,2471,4914
15806,20201122,수인분당선,기흥,4261,4152,8413
15807,20201122,수인분당선,신갈,1553,1610,3163
15808,20201122,수인분당선,구성,1881,2018,3899
15809,20201122,수인분당선,죽전,6434,7255,13689
15810,20201122,수인분당선,보정,834,787,1621
15811,20201122,수인분당선,이매,2476,2520,4996
15812,20201122,수인분당선,오리,4839,4247,9086
15813,20201122,수인분당선,미금,6271,6638,12909
15814,20201122,수인분당선,정자,6352,6599,12951
15815,20201122,수인분당선,수내,5376,5272,10648
15816,20201122,수인분당선,서현,11303,11515,22818
15817,20201122,수인분당선,야탑,11050,11438,22488
15818,20201122,수인분당선,모란,9539,9763,19302
15819,20201122,수인분당선,태평,6847,6521,13368
15820,20201122,수인분당선,가천대,3150,3876,7026
15821,20201122,수인분당선,선정릉,2276,2396,4672
15822,20201122,수인분당선,강남구청,2723,3322,6045
15823,20201122,수인분당선,압구정로데오,8367,9237,17604
15824,20201122,수인분당선,서울숲,3658,3778,7436
15825,20201122,수인분당선,수원,4914,4059,8973
15826,20201122,수인분당선,수서,7336,6995,14331
15827,20201122,수인분당선,대모산입구,1415,1344,2759
15828,20201122,수인분당선,개포동,1728,1704,3432
15829,20201122,수인분당선,구룡,579,635,1214
15830,20201122,수인분당선,도곡,2086,2040,4126
15831,20201122,수인분당선,한티,7049,7055,14104
15832,20201122,수인분당선,선릉,2488,3832,6320
15833,20201123,수인분당선,사리,3184,2966,6150
15834,20201123,수인분당선,야목,158,142,300
15835,20201123,수인분당선,오리,11283,9613,20896
15836,20201123,수인분당선,어천,542,558,1100
15837,20201123,수인분당선,오목천,2444,2113,4557
15838,20201123,수인분당선,고색,2965,2788,5753
15839,20201123,수인분당선,매교,2704,2765,5469
15840,20201123,수인분당선,수원시청,11536,12422,23958
15841,20201123,수인분당선,매탄권선,4484,4270,8754
15842,20201123,수인분당선,망포,13378,12755,26133
15843,20201123,수인분당선,영통,7602,7924,15526
15844,20201123,수인분당선,청명,4015,3867,7882
15845,20201123,수인분당선,상갈,5186,4846,10032
15846,20201123,수인분당선,기흥,8941,8466,17407
15847,20201123,수인분당선,신갈,4277,4167,8444
15848,20201123,수인분당선,구성,4694,4901,9595
15849,20201123,수인분당선,죽전,12538,13856,26394
15850,20201123,수인분당선,보정,2322,2073,4395
15851,20201123,수인분당선,이매,5079,4810,9889
15852,20201123,수인분당선,미금,14631,15529,30160
15853,20201123,수인분당선,정자,15417,16646,32063
15854,20201123,수인분당선,수내,11857,11921,23778
15855,20201123,수인분당선,서현,22640,22994,45634
15856,20201123,수인분당선,야탑,24303,25513,49816
15857,20201123,수인분당선,모란,18726,18644,37370
15858,20201123,수인분당선,태평,12935,12671,25606
15859,20201123,수인분당선,가천대,7924,9097,17021
15860,20201123,수인분당선,선정릉,8034,8457,16491
15861,20201123,수인분당선,강남구청,9177,10553,19730
15862,20201123,수인분당선,압구정로데오,15389,17215,32604
15863,20201123,수인분당선,서울숲,8064,8187,16251
15864,20201123,수인분당선,수원,7479,6170,13649
15865,20201123,수인분당선,수서,12986,13169,26155
15866,20201123,수인분당선,대모산입구,3432,3262,6694
15867,20201123,수인분당선,개포동,3624,3617,7241
15868,20201123,수인분당선,구룡,1923,1917,3840
15869,20201123,수인분당선,도곡,6279,6402,12681
15870,20201123,수인분당선,한티,12646,13736,26382
15871,20201123,수인분당선,선릉,13327,20411,33738
15872,20201123,수인분당선,인천,848,1447,2295
15873,20201123,수인분당선,신포,1637,1678,3315
15874,20201123,수인분당선,숭의,3736,3424,7160
15875,20201123,수인분당선,인하대,5569,5281,10850
15876,20201123,수인분당선,송도,2411,2245,4656
15877,20201123,수인분당선,연수,4259,4130,8389
15878,20201123,수인분당선,원인재,4194,4263,8457
15879,20201123,수인분당선,남동인더스파크,2286,2584,4870
15880,20201123,수인분당선,호구포,3549,3680,7229
15881,20201123,수인분당선,인천논현,5236,5475,10711
15882,20201123,수인분당선,소래포구,4416,4120,8536
15883,20201123,수인분당선,월곶,2356,2154,4510
15884,20201123,수인분당선,달월,75,48,123
15885,20201124,수인분당선,선릉,13446,19605,33051
15886,20201124,수인분당선,한티,12648,13623,26271
15887,20201124,수인분당선,도곡,6159,6240,12399
15888,20201124,수인분당선,구룡,1840,1816,3656
15889,20201124,수인분당선,개포동,3381,3477,6858
15890,20201124,수인분당선,대모산입구,3475,3297,6772
15891,20201124,수인분당선,수서,12323,12854,25177
15892,20201124,수인분당선,복정,3,0,3
15893,20201124,수인분당선,수원,7231,5903,13134
15894,20201124,수인분당선,서울숲,8163,8212,16375
15895,20201124,수인분당선,압구정로데오,16021,17346,33367
15896,20201124,수인분당선,강남구청,9082,10440,19522
15897,20201124,수인분당선,선정릉,8004,8606,16610
15898,20201124,수인분당선,가천대,7238,8373,15611
15899,20201124,수인분당선,태평,12848,12561,25409
15900,20201124,수인분당선,모란,22103,22626,44729
15901,20201124,수인분당선,야탑,23903,24987,48890
15902,20201124,수인분당선,서현,21686,22105,43791
15903,20201124,수인분당선,수내,11970,12088,24058
15904,20201124,수인분당선,정자,15207,16003,31210
15905,20201124,수인분당선,미금,14270,15325,29595
15906,20201124,수인분당선,오리,11128,9420,20548
15907,20201124,수인분당선,이매,4881,4723,9604
15908,20201124,수인분당선,보정,2364,2022,4386
15909,20201124,수인분당선,죽전,12230,13414,25644
15910,20201124,수인분당선,구성,4581,4822,9403
15911,20201124,수인분당선,신갈,4233,4213,8446
15912,20201124,수인분당선,기흥,8624,8252,16876
15913,20201124,수인분당선,상갈,4894,4718,9612
15914,20201124,수인분당선,청명,3915,3788,7703
15915,20201124,수인분당선,영통,7453,7811,15264
15916,20201124,수인분당선,망포,12862,12346,25208
15917,20201124,수인분당선,매탄권선,4384,4253,8637
15918,20201124,수인분당선,수원시청,11096,11694,22790
15919,20201124,수인분당선,매교,2713,2829,5542
15920,20201124,수인분당선,고색,2923,2781,5704
15921,20201124,수인분당선,오목천,2320,2060,4380
15922,20201124,수인분당선,어천,503,479,982
15923,20201124,수인분당선,야목,173,148,321
15924,20201124,수인분당선,사리,3114,2957,6071
15925,20201124,수인분당선,달월,72,48,120
15926,20201124,수인분당선,월곶,2345,2188,4533
15927,20201124,수인분당선,소래포구,4306,4106,8412
15928,20201124,수인분당선,인천논현,4904,5317,10221
15929,20201124,수인분당선,호구포,3344,3452,6796
15930,20201124,수인분당선,남동인더스파크,2344,2573,4917
15931,20201124,수인분당선,원인재,4037,4083,8120
15932,20201124,수인분당선,연수,3994,3937,7931
15933,20201124,수인분당선,송도,2302,2108,4410
15934,20201124,수인분당선,인하대,5280,5075,10355
15935,20201124,수인분당선,숭의,3637,3462,7099
15936,20201124,수인분당선,신포,1698,1675,3373
15937,20201124,수인분당선,인천,856,1451,2307
15938,20201125,수인분당선,선릉,13111,19359,32470
15939,20201125,수인분당선,한티,12527,13633,26160
15940,20201125,수인분당선,도곡,6007,6149,12156
15941,20201125,수인분당선,구룡,1852,1824,3676
15942,20201125,수인분당선,개포동,3609,3673,7282
15943,20201125,수인분당선,대모산입구,3430,3192,6622
15944,20201125,수인분당선,수서,12107,12668,24775
15945,20201125,수인분당선,수원,7512,5996,13508
15946,20201125,수인분당선,서울숲,8220,8414,16634
15947,20201125,수인분당선,압구정로데오,15918,17201,33119
15948,20201125,수인분당선,강남구청,9102,10422,19524
15949,20201125,수인분당선,선정릉,7945,8468,16413
15950,20201125,수인분당선,가천대,7344,8386,15730
15951,20201125,수인분당선,태평,12661,12421,25082
15952,20201125,수인분당선,모란,18313,18105,36418
15953,20201125,수인분당선,야탑,23652,25048,48700
15954,20201125,수인분당선,서현,21735,22219,43954
15955,20201125,수인분당선,수내,12163,12211,24374
15956,20201125,수인분당선,정자,14999,15765,30764
15957,20201125,수인분당선,미금,14305,15240,29545
15958,20201125,수인분당선,오리,11144,9380,20524
15959,20201125,수인분당선,이매,4886,4658,9544
15960,20201125,수인분당선,보정,2278,1926,4204
15961,20201125,수인분당선,죽전,12318,13488,25806
15962,20201125,수인분당선,구성,4579,4809,9388
15963,20201125,수인분당선,신갈,4052,4044,8096
15964,20201125,수인분당선,기흥,8637,8408,17045
15965,20201125,수인분당선,상갈,4912,4807,9719
15966,20201125,수인분당선,청명,3966,3772,7738
15967,20201125,수인분당선,영통,7401,7687,15088
15968,20201125,수인분당선,망포,13021,12396,25417
15969,20201125,수인분당선,매탄권선,4367,4267,8634
15970,20201125,수인분당선,수원시청,11086,11941,23027
15971,20201125,수인분당선,매교,2737,2840,5577
15972,20201125,수인분당선,고색,2937,2752,5689
15973,20201125,수인분당선,오목천,2299,2083,4382
15974,20201125,수인분당선,어천,524,519,1043
15975,20201125,수인분당선,야목,195,162,357
15976,20201125,수인분당선,사리,3168,3011,6179
15977,20201125,수인분당선,달월,97,68,165
15978,20201125,수인분당선,월곶,2210,2189,4399
15979,20201125,수인분당선,소래포구,4483,4212,8695
15980,20201125,수인분당선,인천논현,5072,5377,10449
15981,20201125,수인분당선,호구포,3481,3571,7052
15982,20201125,수인분당선,남동인더스파크,2297,2542,4839
15983,20201125,수인분당선,원인재,4044,4080,8124
15984,20201125,수인분당선,연수,4013,4004,8017
15985,20201125,수인분당선,송도,2322,2119,4441
15986,20201125,수인분당선,인하대,5378,5114,10492
15987,20201125,수인분당선,숭의,3658,3435,7093
15988,20201125,수인분당선,신포,1661,1666,3327
15989,20201125,수인분당선,인천,800,1425,2225
15990,20201126,수인분당선,인천,839,1403,2242
15991,20201126,수인분당선,신포,1518,1544,3062
15992,20201126,수인분당선,숭의,3638,3347,6985
15993,20201126,수인분당선,인하대,5133,4820,9953
15994,20201126,수인분당선,송도,2243,2092,4335
15995,20201126,수인분당선,연수,3871,3840,7711
15996,20201126,수인분당선,원인재,3996,3926,7922
15997,20201126,수인분당선,남동인더스파크,2286,2599,4885
15998,20201126,수인분당선,호구포,3399,3486,6885
15999,20201126,수인분당선,인천논현,4818,5132,9950
16000,20201126,수인분당선,소래포구,4369,4190,8559
16001,20201126,수인분당선,월곶,2245,2067,4312
16002,20201126,수인분당선,달월,84,62,146
16003,20201126,수인분당선,사리,3041,2826,5867
16004,20201126,수인분당선,야목,175,125,300
16005,20201126,수인분당선,어천,512,510,1022
16006,20201126,수인분당선,오목천,2042,1985,4027
16007,20201126,수인분당선,고색,2842,2720,5562
16008,20201126,수인분당선,매교,2363,2490,4853
16009,20201126,수인분당선,수원시청,10669,11370,22039
16010,20201126,수인분당선,매탄권선,4125,4007,8132
16011,20201126,수인분당선,망포,12441,12021,24462
16012,20201126,수인분당선,영통,7127,7372,14499
16013,20201126,수인분당선,청명,3811,3599,7410
16014,20201126,수인분당선,상갈,4835,4732,9567
16015,20201126,수인분당선,기흥,8425,8108,16533
16016,20201126,수인분당선,신갈,3871,3982,7853
16017,20201126,수인분당선,구성,4392,4612,9004
16018,20201126,수인분당선,죽전,11947,13040,24987
16019,20201126,수인분당선,보정,2176,1828,4004
16020,20201126,수인분당선,이매,4712,4537,9249
16021,20201126,수인분당선,오리,10755,9194,19949
16022,20201126,수인분당선,미금,13623,14548,28171
16023,20201126,수인분당선,정자,14406,15331,29737
16024,20201126,수인분당선,수내,11347,11393,22740
16025,20201126,수인분당선,서현,20903,21201,42104
16026,20201126,수인분당선,야탑,22974,24132,47106
16027,20201126,수인분당선,모란,17874,17830,35704
16028,20201126,수인분당선,태평,12291,12009,24300
16029,20201126,수인분당선,가천대,6898,7783,14681
16030,20201126,수인분당선,선정릉,7560,8157,15717
16031,20201126,수인분당선,강남구청,8775,10020,18795
16032,20201126,수인분당선,압구정로데오,15754,16982,32736
16033,20201126,수인분당선,서울숲,7940,7922,15862
16034,20201126,수인분당선,수원,7111,5759,12870
16035,20201126,수인분당선,수서,12235,12822,25057
16036,20201126,수인분당선,대모산입구,3256,3083,6339
16037,20201126,수인분당선,개포동,3272,3332,6604
16038,20201126,수인분당선,구룡,1639,1623,3262
16039,20201126,수인분당선,도곡,5891,5909,11800
16040,20201126,수인분당선,한티,12017,13046,25063
16041,20201126,수인분당선,선릉,12926,18958,31884
16042,20201127,수인분당선,복정,1,0,1
16043,20201127,수인분당선,인천,884,1373,2257
16044,20201127,수인분당선,신포,1482,1532,3014
16045,20201127,수인분당선,숭의,3519,3294,6813
16046,20201127,수인분당선,인하대,5150,4826,9976
16047,20201127,수인분당선,송도,2223,2058,4281
16048,20201127,수인분당선,연수,3770,3756,7526
16049,20201127,수인분당선,원인재,3881,4049,7930
16050,20201127,수인분당선,남동인더스파크,2264,2511,4775
16051,20201127,수인분당선,호구포,3381,3402,6783
16052,20201127,수인분당선,인천논현,4882,5285,10167
16053,20201127,수인분당선,소래포구,4066,3992,8058
16054,20201127,수인분당선,월곶,2253,2182,4435
16055,20201127,수인분당선,달월,82,53,135
16056,20201127,수인분당선,사리,2952,2851,5803
16057,20201127,수인분당선,야목,182,162,344
16058,20201127,수인분당선,어천,546,489,1035
16059,20201127,수인분당선,오목천,2026,1830,3856
16060,20201127,수인분당선,고색,2982,2733,5715
16061,20201127,수인분당선,매교,2365,2447,4812
16062,20201127,수인분당선,수원시청,10925,11922,22847
16063,20201127,수인분당선,매탄권선,4280,4019,8299
16064,20201127,수인분당선,망포,13189,12225,25414
16065,20201127,수인분당선,영통,7452,7595,15047
16066,20201127,수인분당선,청명,3888,3598,7486
16067,20201127,수인분당선,상갈,4833,4704,9537
16068,20201127,수인분당선,기흥,8524,8305,16829
16069,20201127,수인분당선,신갈,3978,3950,7928
16070,20201127,수인분당선,구성,4283,4498,8781
16071,20201127,수인분당선,죽전,12278,13100,25378
16072,20201127,수인분당선,보정,2115,1767,3882
16073,20201127,수인분당선,이매,4577,4504,9081
16074,20201127,수인분당선,오리,10907,9184,20091
16075,20201127,수인분당선,미금,13716,14564,28280
16076,20201127,수인분당선,정자,14554,15388,29942
16077,20201127,수인분당선,수내,11613,11756,23369
16078,20201127,수인분당선,서현,21617,22248,43865
16079,20201127,수인분당선,야탑,23167,24574,47741
16080,20201127,수인분당선,모란,18003,18041,36044
16081,20201127,수인분당선,태평,12415,12189,24604
16082,20201127,수인분당선,가천대,6822,7538,14360
16083,20201127,수인분당선,선정릉,7720,8150,15870
16084,20201127,수인분당선,강남구청,8831,9988,18819
16085,20201127,수인분당선,압구정로데오,16614,18002,34616
16086,20201127,수인분당선,서울숲,7946,7854,15800
16087,20201127,수인분당선,수원,7321,6212,13533
16088,20201127,수인분당선,수서,12560,14064,26624
16089,20201127,수인분당선,대모산입구,3300,3022,6322
16090,20201127,수인분당선,개포동,3360,3550,6910
16091,20201127,수인분당선,구룡,1586,1559,3145
16092,20201127,수인분당선,도곡,5859,5852,11711
16093,20201127,수인분당선,한티,12479,13256,25735
16094,20201127,수인분당선,선릉,12564,18125,30689
16095,20201128,수인분당선,수원시청,7805,8338,16143
16096,20201128,수인분당선,매교,1479,1591,3070
16097,20201128,수인분당선,고색,1555,1573,3128
16098,20201128,수인분당선,오목천,1225,1122,2347
16099,20201128,수인분당선,어천,355,318,673
16100,20201128,수인분당선,야목,117,109,226
16101,20201128,수인분당선,사리,2004,1821,3825
16102,20201128,수인분당선,달월,38,39,77
16103,20201128,수인분당선,월곶,1604,1558,3162
16104,20201128,수인분당선,소래포구,3337,3482,6819
16105,20201128,수인분당선,인천논현,3266,3392,6658
16106,20201128,수인분당선,호구포,1998,1965,3963
16107,20201128,수인분당선,남동인더스파크,948,922,1870
16108,20201128,수인분당선,원인재,2628,2657,5285
16109,20201128,수인분당선,연수,2766,2714,5480
16110,20201128,수인분당선,송도,1505,1472,2977
16111,20201128,수인분당선,인하대,3127,2857,5984
16112,20201128,수인분당선,숭의,2031,1922,3953
16113,20201128,수인분당선,신포,990,1061,2051
16114,20201128,수인분당선,인천,710,1182,1892
16115,20201128,수인분당선,매탄권선,2412,2316,4728
16116,20201128,수인분당선,망포,6643,6022,12665
16117,20201128,수인분당선,영통,4994,4895,9889
16118,20201128,수인분당선,청명,1955,1892,3847
16119,20201128,수인분당선,상갈,2755,2861,5616
16120,20201128,수인분당선,기흥,4936,4869,9805
16121,20201128,수인분당선,신갈,1961,1975,3936
16122,20201128,수인분당선,구성,2242,2497,4739
16123,20201128,수인분당선,죽전,7412,8340,15752
16124,20201128,수인분당선,보정,1103,989,2092
16125,20201128,수인분당선,이매,2877,2762,5639
16126,20201128,수인분당선,오리,6107,5277,11384
16127,20201128,수인분당선,미금,8343,8561,16904
16128,20201128,수인분당선,정자,7979,8052,16031
16129,20201128,수인분당선,수내,6889,6477,13366
16130,20201128,수인분당선,서현,13208,13340,26548
16131,20201128,수인분당선,야탑,13066,13758,26824
16132,20201128,수인분당선,모란,12335,12237,24572
16133,20201128,수인분당선,태평,8478,8328,16806
16134,20201128,수인분당선,가천대,4006,4541,8547
16135,20201128,수인분당선,선정릉,3123,3152,6275
16136,20201128,수인분당선,강남구청,3991,4770,8761
16137,20201128,수인분당선,압구정로데오,11994,13075,25069
16138,20201128,수인분당선,서울숲,4184,4167,8351
16139,20201128,수인분당선,수원,5460,4382,9842
16140,20201128,수인분당선,복정,1,0,1
16141,20201128,수인분당선,수서,6871,7520,14391
16142,20201128,수인분당선,대모산입구,2022,1910,3932
16143,20201128,수인분당선,개포동,1937,1897,3834
16144,20201128,수인분당선,구룡,953,904,1857
16145,20201128,수인분당선,도곡,3259,3057,6316
16146,20201128,수인분당선,한티,8106,8071,16177
16147,20201128,수인분당선,선릉,4273,6558,10831
16148,20201129,수인분당선,인천,682,982,1664
16149,20201129,수인분당선,신포,756,793,1549
16150,20201129,수인분당선,숭의,1409,1361,2770
16151,20201129,수인분당선,인하대,2180,2154,4334
16152,20201129,수인분당선,송도,1085,1035,2120
16153,20201129,수인분당선,연수,2244,2134,4378
16154,20201129,수인분당선,원인재,1955,2070,4025
16155,20201129,수인분당선,남동인더스파크,544,523,1067
16156,20201129,수인분당선,호구포,1446,1482,2928
16157,20201129,수인분당선,인천논현,2180,2218,4398
16158,20201129,수인분당선,소래포구,2785,2698,5483
16159,20201129,수인분당선,월곶,1148,1073,2221
16160,20201129,수인분당선,달월,30,39,69
16161,20201129,수인분당선,사리,1497,1376,2873
16162,20201129,수인분당선,야목,88,96,184
16163,20201129,수인분당선,어천,244,333,577
16164,20201129,수인분당선,오목천,887,847,1734
16165,20201129,수인분당선,고색,1147,1142,2289
16166,20201129,수인분당선,매교,1007,1068,2075
16167,20201129,수인분당선,수원시청,5151,4962,10113
16168,20201129,수인분당선,매탄권선,1718,1687,3405
16169,20201129,수인분당선,망포,4188,4512,8700
16170,20201129,수인분당선,영통,3329,3368,6697
16171,20201129,수인분당선,청명,1343,1367,2710
16172,20201129,수인분당선,상갈,2001,2087,4088
16173,20201129,수인분당선,기흥,3427,3480,6907
16174,20201129,수인분당선,신갈,1343,1365,2708
16175,20201129,수인분당선,구성,1546,1687,3233
16176,20201129,수인분당선,죽전,5641,6424,12065
16177,20201129,수인분당선,보정,712,647,1359
16178,20201129,수인분당선,이매,2121,2192,4313
16179,20201129,수인분당선,오리,4176,3713,7889
16180,20201129,수인분당선,미금,5212,5695,10907
16181,20201129,수인분당선,정자,5051,5290,10341
16182,20201129,수인분당선,수내,4517,4411,8928
16183,20201129,수인분당선,서현,9056,9029,18085
16184,20201129,수인분당선,야탑,9595,9977,19572
16185,20201129,수인분당선,모란,10850,11191,22041
16186,20201129,수인분당선,태평,6204,5900,12104
16187,20201129,수인분당선,가천대,2810,3474,6284
16188,20201129,수인분당선,선정릉,1763,1870,3633
16189,20201129,수인분당선,강남구청,2324,2800,5124
16190,20201129,수인분당선,압구정로데오,6479,6846,13325
16191,20201129,수인분당선,서울숲,2667,2703,5370
16192,20201129,수인분당선,수원,4203,3236,7439
16193,20201129,수인분당선,수서,6504,5669,12173
16194,20201129,수인분당선,대모산입구,1377,1314,2691
16195,20201129,수인분당선,개포동,1292,1275,2567
16196,20201129,수인분당선,구룡,543,592,1135
16197,20201129,수인분당선,도곡,1895,1870,3765
16198,20201129,수인분당선,한티,5453,5596,11049
16199,20201129,수인분당선,선릉,2212,3376,5588
16200,20201130,수인분당선,선릉,12570,18714,31284
16201,20201130,수인분당선,한티,11519,12460,23979
16202,20201130,수인분당선,도곡,5873,5901,11774
16203,20201130,수인분당선,구룡,1546,1507,3053
16204,20201130,수인분당선,개포동,3261,3496,6757
16205,20201130,수인분당선,대모산입구,3221,2998,6219
16206,20201130,수인분당선,수서,11663,11752,23415
16207,20201130,수인분당선,수원,6839,5606,12445
16208,20201130,수인분당선,서울숲,7184,7201,14385
16209,20201130,수인분당선,압구정로데오,13906,15006,28912
16210,20201130,수인분당선,강남구청,8459,9742,18201
16211,20201130,수인분당선,선정릉,7325,7880,15205
16212,20201130,수인분당선,가천대,6692,7774,14466
16213,20201130,수인분당선,태평,11939,11926,23865
16214,20201130,수인분당선,모란,17273,17253,34526
16215,20201130,수인분당선,야탑,22033,23132,45165
16216,20201130,수인분당선,서현,20445,20514,40959
16217,20201130,수인분당선,수내,11146,11191,22337
16218,20201130,수인분당선,정자,13525,14440,27965
16219,20201130,수인분당선,미금,13233,13927,27160
16220,20201130,수인분당선,오리,10404,8952,19356
16221,20201130,수인분당선,이매,4425,4210,8635
16222,20201130,수인분당선,보정,2034,1743,3777
16223,20201130,수인분당선,죽전,11294,12513,23807
16224,20201130,수인분당선,구성,4181,4372,8553
16225,20201130,수인분당선,신갈,3862,3853,7715
16226,20201130,수인분당선,기흥,7996,7767,15763
16227,20201130,수인분당선,상갈,4588,4422,9010
16228,20201130,수인분당선,청명,3604,3456,7060
16229,20201130,수인분당선,영통,6724,6963,13687
16230,20201130,수인분당선,망포,12164,11584,23748
16231,20201130,수인분당선,매탄권선,3986,3803,7789
16232,20201130,수인분당선,수원시청,10425,10912,21337
16233,20201130,수인분당선,매교,2371,2361,4732
16234,20201130,수인분당선,고색,2769,2678,5447
16235,20201130,수인분당선,오목천,1796,1821,3617
16236,20201130,수인분당선,어천,493,451,944
16237,20201130,수인분당선,야목,148,128,276
16238,20201130,수인분당선,사리,2858,2706,5564
16239,20201130,수인분당선,달월,79,46,125
16240,20201130,수인분당선,월곶,2040,2017,4057
16241,20201130,수인분당선,소래포구,4139,3790,7929
16242,20201130,수인분당선,인천논현,4722,5001,9723
16243,20201130,수인분당선,호구포,3295,3396,6691
16244,20201130,수인분당선,남동인더스파크,2226,2535,4761
16245,20201130,수인분당선,원인재,3787,3878,7665
16246,20201130,수인분당선,연수,3769,3652,7421
16247,20201130,수인분당선,송도,2143,1952,4095
16248,20201130,수인분당선,인하대,4788,4655,9443
16249,20201130,수인분당선,숭의,3474,3203,6677
16250,20201130,수인분당선,신포,1383,1337,2720
16251,20201130,수인분당선,인천,807,1322,2129
16252,20201201,수인분당선,인천,798,1309,2107
16253,20201201,수인분당선,신포,1425,1364,2789
16254,20201201,수인분당선,숭의,3456,3265,6721
16255,20201201,수인분당선,인하대,4884,4608,9492
16256,20201201,수인분당선,송도,2120,1936,4056
16257,20201201,수인분당선,연수,3834,3779,7613
16258,20201201,수인분당선,원인재,3731,3882,7613
16259,20201201,수인분당선,남동인더스파크,2249,2512,4761
16260,20201201,수인분당선,호구포,3188,3384,6572
16261,20201201,수인분당선,인천논현,4663,4983,9646
16262,20201201,수인분당선,소래포구,4117,3867,7984
16263,20201201,수인분당선,월곶,2137,1991,4128
16264,20201201,수인분당선,달월,86,61,147
16265,20201201,수인분당선,사리,2910,2752,5662
16266,20201201,수인분당선,야목,147,132,279
16267,20201201,수인분당선,어천,445,468,913
16268,20201201,수인분당선,오목천,1935,1844,3779
16269,20201201,수인분당선,고색,2799,2615,5414
16270,20201201,수인분당선,매교,2350,2374,4724
16271,20201201,수인분당선,수원시청,10363,10970,21333
16272,20201201,수인분당선,매탄권선,3849,3802,7651
16273,20201201,수인분당선,망포,12120,11672,23792
16274,20201201,수인분당선,영통,6765,6964,13729
16275,20201201,수인분당선,청명,3616,3485,7101
16276,20201201,수인분당선,상갈,4534,4382,8916
16277,20201201,수인분당선,기흥,7943,7790,15733
16278,20201201,수인분당선,신갈,3886,3850,7736
16279,20201201,수인분당선,구성,4265,4365,8630
16280,20201201,수인분당선,죽전,11332,12380,23712
16281,20201201,수인분당선,보정,2042,1718,3760
16282,20201201,수인분당선,이매,4356,4179,8535
16283,20201201,수인분당선,오리,10515,8935,19450
16284,20201201,수인분당선,미금,13390,14154,27544
16285,20201201,수인분당선,정자,13803,14653,28456
16286,20201201,수인분당선,수내,11394,11496,22890
16287,20201201,수인분당선,서현,20475,20726,41201
16288,20201201,수인분당선,야탑,22365,23404,45769
16289,20201201,수인분당선,모란,17322,17246,34568
16290,20201201,수인분당선,태평,12008,11771,23779
16291,20201201,수인분당선,가천대,6602,7646,14248
16292,20201201,수인분당선,선정릉,7502,7951,15453
16293,20201201,수인분당선,강남구청,8658,9909,18567
16294,20201201,수인분당선,압구정로데오,14889,16053,30942
16295,20201201,수인분당선,서울숲,7279,7276,14555
16296,20201201,수인분당선,수원,6817,5656,12473
16297,20201201,수인분당선,수서,10671,11002,21673
16298,20201201,수인분당선,대모산입구,3191,2996,6187
16299,20201201,수인분당선,개포동,3197,3260,6457
16300,20201201,수인분당선,구룡,1528,1517,3045
16301,20201201,수인분당선,도곡,5703,5772,11475
16302,20201201,수인분당선,한티,11509,12438,23947
16303,20201201,수인분당선,선릉,12500,18327,30827
16304,20201202,수인분당선,복정,1,0,1
16305,20201202,수인분당선,인천,820,1358,2178
16306,20201202,수인분당선,신포,1459,1473,2932
16307,20201202,수인분당선,숭의,3529,3380,6909
16308,20201202,수인분당선,인하대,4998,4672,9670
16309,20201202,수인분당선,송도,2181,2006,4187
16310,20201202,수인분당선,연수,3873,3891,7764
16311,20201202,수인분당선,원인재,3785,3997,7782
16312,20201202,수인분당선,남동인더스파크,2223,2490,4713
16313,20201202,수인분당선,호구포,3393,3457,6850
16314,20201202,수인분당선,사리,2972,2872,5844
16315,20201202,수인분당선,야목,170,126,296
16316,20201202,수인분당선,어천,487,503,990
16317,20201202,수인분당선,오목천,1910,1865,3775
16318,20201202,수인분당선,고색,2858,2733,5591
16319,20201202,수인분당선,매교,2509,2576,5085
16320,20201202,수인분당선,수원시청,10473,11055,21528
16321,20201202,수인분당선,매탄권선,4236,4034,8270
16322,20201202,수인분당선,망포,12139,11594,23733
16323,20201202,수인분당선,영통,6979,7123,14102
16324,20201202,수인분당선,청명,3724,3542,7266
16325,20201202,수인분당선,상갈,4639,4570,9209
16326,20201202,수인분당선,기흥,8219,7927,16146
16327,20201202,수인분당선,신갈,3998,4026,8024
16328,20201202,수인분당선,구성,4194,4472,8666
16329,20201202,수인분당선,죽전,11558,12560,24118
16330,20201202,수인분당선,보정,2081,1809,3890
16331,20201202,수인분당선,이매,4566,4428,8994
16332,20201202,수인분당선,오리,10575,8928,19503
16333,20201202,수인분당선,미금,13683,14482,28165
16334,20201202,수인분당선,정자,13975,14941,28916
16335,20201202,수인분당선,수내,11449,11552,23001
16336,20201202,수인분당선,서현,20860,21188,42048
16337,20201202,수인분당선,야탑,22819,24147,46966
16338,20201202,수인분당선,모란,17560,17515,35075
16339,20201202,수인분당선,태평,11986,11861,23847
16340,20201202,수인분당선,가천대,6659,7608,14267
16341,20201202,수인분당선,선정릉,7840,8182,16022
16342,20201202,수인분당선,강남구청,8858,10200,19058
16343,20201202,수인분당선,압구정로데오,14823,16085,30908
16344,20201202,수인분당선,서울숲,7370,7400,14770
16345,20201202,수인분당선,수원,6855,5632,12487
16346,20201202,수인분당선,수서,11021,11361,22382
16347,20201202,수인분당선,대모산입구,3289,3045,6334
16348,20201202,수인분당선,개포동,3230,3342,6572
16349,20201202,수인분당선,구룡,1539,1522,3061
16350,20201202,수인분당선,도곡,5756,5988,11744
16351,20201202,수인분당선,한티,11750,12460,24210
16352,20201202,수인분당선,선릉,12362,18246,30608
16353,20201202,수인분당선,인천논현,4852,5069,9921
16354,20201202,수인분당선,소래포구,4220,3871,8091
16355,20201202,수인분당선,월곶,2166,2000,4166
16356,20201202,수인분당선,달월,79,55,134
16357,20201203,수인분당선,선릉,12427,18260,30687
16358,20201203,수인분당선,한티,11726,12652,24378
16359,20201203,수인분당선,도곡,5964,5836,11800
16360,20201203,수인분당선,구룡,1639,1541,3180
16361,20201203,수인분당선,개포동,3131,3218,6349
16362,20201203,수인분당선,대모산입구,3244,3013,6257
16363,20201203,수인분당선,수서,11012,11581,22593
16364,20201203,수인분당선,복정,1,0,1
16365,20201203,수인분당선,수원,6838,5600,12438
16366,20201203,수인분당선,서울숲,7366,7408,14774
16367,20201203,수인분당선,압구정로데오,15357,16527,31884
16368,20201203,수인분당선,강남구청,8757,10150,18907
16369,20201203,수인분당선,선정릉,7177,7742,14919
16370,20201203,수인분당선,가천대,6520,7461,13981
16371,20201203,수인분당선,태평,11836,11633,23469
16372,20201203,수인분당선,모란,17262,17365,34627
16373,20201203,수인분당선,야탑,22274,23274,45548
16374,20201203,수인분당선,서현,20615,20831,41446
16375,20201203,수인분당선,수내,11525,11645,23170
16376,20201203,수인분당선,정자,13842,14544,28386
16377,20201203,수인분당선,미금,13472,14389,27861
16378,20201203,수인분당선,오리,10608,8946,19554
16379,20201203,수인분당선,이매,4452,4209,8661
16380,20201203,수인분당선,보정,2083,1779,3862
16381,20201203,수인분당선,죽전,11310,12496,23806
16382,20201203,수인분당선,구성,4243,4468,8711
16383,20201203,수인분당선,신갈,3942,3856,7798
16384,20201203,수인분당선,기흥,8155,7946,16101
16385,20201203,수인분당선,상갈,4556,4515,9071
16386,20201203,수인분당선,청명,3775,3497,7272
16387,20201203,수인분당선,영통,6837,7064,13901
16388,20201203,수인분당선,망포,12115,11703,23818
16389,20201203,수인분당선,매탄권선,4205,4078,8283
16390,20201203,수인분당선,수원시청,10368,10989,21357
16391,20201203,수인분당선,매교,2422,2414,4836
16392,20201203,수인분당선,고색,2862,2739,5601
16393,20201203,수인분당선,오목천,1827,1792,3619
16394,20201203,수인분당선,어천,510,513,1023
16395,20201203,수인분당선,야목,159,136,295
16396,20201203,수인분당선,사리,2925,2840,5765
16397,20201203,수인분당선,달월,74,55,129
16398,20201203,수인분당선,월곶,2009,1918,3927
16399,20201203,수인분당선,소래포구,4074,3831,7905
16400,20201203,수인분당선,인천논현,4870,5011,9881
16401,20201203,수인분당선,호구포,3200,3300,6500
16402,20201203,수인분당선,남동인더스파크,2238,2464,4702
16403,20201203,수인분당선,원인재,3830,3872,7702
16404,20201203,수인분당선,연수,3797,3764,7561
16405,20201203,수인분당선,송도,2170,2078,4248
16406,20201203,수인분당선,인하대,4793,4604,9397
16407,20201203,수인분당선,숭의,3344,3150,6494
16408,20201203,수인분당선,신포,1400,1352,2752
16409,20201203,수인분당선,인천,849,1340,2189
16410,20201204,수인분당선,한티,13198,13942,27140
16411,20201204,수인분당선,선릉,12563,18272,30835
16412,20201204,수인분당선,대모산입구,3190,3041,6231
16413,20201204,수인분당선,개포동,3233,3315,6548
16414,20201204,수인분당선,구룡,1469,1397,2866
16415,20201204,수인분당선,도곡,5665,5690,11355
16416,20201204,수인분당선,인천,791,1297,2088
16417,20201204,수인분당선,신포,1417,1390,2807
16418,20201204,수인분당선,숭의,3519,3326,6845
16419,20201204,수인분당선,인하대,4988,4648,9636
16420,20201204,수인분당선,송도,2212,2066,4278
16421,20201204,수인분당선,연수,3812,3843,7655
16422,20201204,수인분당선,원인재,3814,3977,7791
16423,20201204,수인분당선,남동인더스파크,2148,2436,4584
16424,20201204,수인분당선,호구포,3299,3435,6734
16425,20201204,수인분당선,인천논현,4764,5063,9827
16426,20201204,수인분당선,소래포구,3968,3852,7820
16427,20201204,수인분당선,월곶,2161,2013,4174
16428,20201204,수인분당선,달월,76,54,130
16429,20201204,수인분당선,사리,3114,2951,6065
16430,20201204,수인분당선,야목,158,148,306
16431,20201204,수인분당선,어천,538,500,1038
16432,20201204,수인분당선,오목천,1958,1804,3762
16433,20201204,수인분당선,고색,2887,2720,5607
16434,20201204,수인분당선,매교,2362,2521,4883
16435,20201204,수인분당선,수원시청,10918,12038,22956
16436,20201204,수인분당선,매탄권선,4288,3971,8259
16437,20201204,수인분당선,망포,12942,11946,24888
16438,20201204,수인분당선,영통,7400,7423,14823
16439,20201204,수인분당선,청명,3688,3531,7219
16440,20201204,수인분당선,상갈,4680,4540,9220
16441,20201204,수인분당선,기흥,8308,8249,16557
16442,20201204,수인분당선,신갈,3978,3968,7946
16443,20201204,수인분당선,구성,4296,4495,8791
16444,20201204,수인분당선,죽전,12132,13031,25163
16445,20201204,수인분당선,보정,2067,1781,3848
16446,20201204,수인분당선,이매,4648,4425,9073
16447,20201204,수인분당선,오리,10842,9280,20122
16448,20201204,수인분당선,미금,13703,14706,28409
16449,20201204,수인분당선,정자,14459,15341,29800
16450,20201204,수인분당선,수내,11865,11909,23774
16451,20201204,수인분당선,서현,21678,22163,43841
16452,20201204,수인분당선,야탑,22998,24350,47348
16453,20201204,수인분당선,모란,20568,20724,41292
16454,20201204,수인분당선,태평,12483,12244,24727
16455,20201204,수인분당선,가천대,6644,7352,13996
16456,20201204,수인분당선,선정릉,7171,7601,14772
16457,20201204,수인분당선,강남구청,8720,9801,18521
16458,20201204,수인분당선,압구정로데오,16276,17414,33690
16459,20201204,수인분당선,서울숲,7572,7508,15080
16460,20201204,수인분당선,수원,7320,6100,13420
16461,20201204,수인분당선,수서,12245,13481,25726
16462,20201205,수인분당선,어천,364,357,721
16463,20201205,수인분당선,오목천,1264,1100,2364
16464,20201205,수인분당선,고색,1528,1501,3029
16465,20201205,수인분당선,매교,1477,1523,3000
16466,20201205,수인분당선,수원시청,8067,8525,16592
16467,20201205,수인분당선,매탄권선,2548,2393,4941
16468,20201205,수인분당선,망포,6791,6286,13077
16469,20201205,수인분당선,영통,5275,5191,10466
16470,20201205,수인분당선,청명,2022,1967,3989
16471,20201205,수인분당선,상갈,2931,2890,5821
16472,20201205,수인분당선,기흥,5038,4913,9951
16473,20201205,수인분당선,신갈,1946,2045,3991
16474,20201205,수인분당선,구성,2402,2524,4926
16475,20201205,수인분당선,죽전,8260,9042,17302
16476,20201205,수인분당선,보정,1165,1015,2180
16477,20201205,수인분당선,이매,2809,2783,5592
16478,20201205,수인분당선,오리,6246,5270,11516
16479,20201205,수인분당선,미금,8497,8781,17278
16480,20201205,수인분당선,정자,8215,8441,16656
16481,20201205,수인분당선,수내,7148,6646,13794
16482,20201205,수인분당선,서현,13614,13688,27302
16483,20201205,수인분당선,야탑,13447,14175,27622
16484,20201205,수인분당선,모란,12727,12472,25199
16485,20201205,수인분당선,선릉,4562,6543,11105
16486,20201205,수인분당선,한티,8658,8810,17468
16487,20201205,수인분당선,도곡,3325,3102,6427
16488,20201205,수인분당선,구룡,895,861,1756
16489,20201205,수인분당선,개포동,1958,1963,3921
16490,20201205,수인분당선,대모산입구,2280,2089,4369
16491,20201205,수인분당선,수서,7257,7761,15018
16492,20201205,수인분당선,수원,5522,4484,10006
16493,20201205,수인분당선,서울숲,4017,3995,8012
16494,20201205,수인분당선,압구정로데오,12396,13292,25688
16495,20201205,수인분당선,강남구청,4048,4938,8986
16496,20201205,수인분당선,선정릉,2787,2815,5602
16497,20201205,수인분당선,가천대,3889,4501,8390
16498,20201205,수인분당선,태평,8582,8325,16907
16499,20201205,수인분당선,인천,705,1235,1940
16500,20201205,수인분당선,신포,1038,1072,2110
16501,20201205,수인분당선,숭의,2115,2070,4185
16502,20201205,수인분당선,인하대,3278,3072,6350
16503,20201205,수인분당선,송도,1525,1540,3065
16504,20201205,수인분당선,연수,2817,2839,5656
16505,20201205,수인분당선,원인재,2845,2927,5772
16506,20201205,수인분당선,남동인더스파크,837,780,1617
16507,20201205,수인분당선,호구포,2000,1863,3863
16508,20201205,수인분당선,인천논현,3396,3573,6969
16509,20201205,수인분당선,소래포구,3446,3510,6956
16510,20201205,수인분당선,월곶,1497,1518,3015
16511,20201205,수인분당선,달월,46,45,91
16512,20201205,수인분당선,사리,2081,1899,3980
16513,20201205,수인분당선,야목,146,129,275
16514,20201206,수인분당선,복정,3,0,3
16515,20201206,수인분당선,인천,709,988,1697
16516,20201206,수인분당선,신포,848,794,1642
16517,20201206,수인분당선,숭의,1583,1411,2994
16518,20201206,수인분당선,인하대,2339,2256,4595
16519,20201206,수인분당선,송도,1164,1130,2294
16520,20201206,수인분당선,연수,2184,2129,4313
16521,20201206,수인분당선,원인재,2110,2129,4239
16522,20201206,수인분당선,남동인더스파크,532,512,1044
16523,20201206,수인분당선,호구포,1436,1544,2980
16524,20201206,수인분당선,인천논현,2209,2313,4522
16525,20201206,수인분당선,소래포구,2976,2877,5853
16526,20201206,수인분당선,월곶,1140,1123,2263
16527,20201206,수인분당선,달월,34,39,73
16528,20201206,수인분당선,사리,1605,1411,3016
16529,20201206,수인분당선,야목,110,100,210
16530,20201206,수인분당선,어천,293,343,636
16531,20201206,수인분당선,오목천,851,905,1756
16532,20201206,수인분당선,고색,1070,1087,2157
16533,20201206,수인분당선,매교,1045,1078,2123
16534,20201206,수인분당선,수원시청,5132,5054,10186
16535,20201206,수인분당선,매탄권선,1688,1662,3350
16536,20201206,수인분당선,망포,4314,4613,8927
16537,20201206,수인분당선,영통,3586,3429,7015
16538,20201206,수인분당선,청명,1390,1506,2896
16539,20201206,수인분당선,상갈,2069,2109,4178
16540,20201206,수인분당선,기흥,3526,3528,7054
16541,20201206,수인분당선,신갈,1317,1358,2675
16542,20201206,수인분당선,구성,1593,1830,3423
16543,20201206,수인분당선,죽전,6364,6732,13096
16544,20201206,수인분당선,보정,714,679,1393
16545,20201206,수인분당선,이매,2031,2193,4224
16546,20201206,수인분당선,오리,4236,3743,7979
16547,20201206,수인분당선,미금,5254,5531,10785
16548,20201206,수인분당선,정자,5149,5410,10559
16549,20201206,수인분당선,수내,4760,4508,9268
16550,20201206,수인분당선,서현,9082,9247,18329
16551,20201206,수인분당선,야탑,9274,9628,18902
16552,20201206,수인분당선,모란,8312,8431,16743
16553,20201206,수인분당선,태평,6095,5795,11890
16554,20201206,수인분당선,가천대,2626,3323,5949
16555,20201206,수인분당선,선정릉,1721,1805,3526
16556,20201206,수인분당선,강남구청,2249,2733,4982
16557,20201206,수인분당선,압구정로데오,6280,6747,13027
16558,20201206,수인분당선,서울숲,2741,2760,5501
16559,20201206,수인분당선,수원,4119,3309,7428
16560,20201206,수인분당선,수서,6093,5598,11691
16561,20201206,수인분당선,대모산입구,1099,1097,2196
16562,20201206,수인분당선,개포동,1354,1376,2730
16563,20201206,수인분당선,구룡,487,579,1066
16564,20201206,수인분당선,도곡,1925,1900,3825
16565,20201206,수인분당선,한티,5726,5844,11570
16566,20201206,수인분당선,선릉,2358,3435,5793
16567,20201207,수인분당선,인천,810,1282,2092
16568,20201207,수인분당선,신포,1394,1410,2804
16569,20201207,수인분당선,숭의,3395,3186,6581
16570,20201207,수인분당선,인하대,5075,4835,9910
16571,20201207,수인분당선,송도,2269,2028,4297
16572,20201207,수인분당선,연수,3899,3754,7653
16573,20201207,수인분당선,원인재,3772,3937,7709
16574,20201207,수인분당선,남동인더스파크,2225,2520,4745
16575,20201207,수인분당선,호구포,3333,3460,6793
16576,20201207,수인분당선,인천논현,4807,4991,9798
16577,20201207,수인분당선,소래포구,3881,3602,7483
16578,20201207,수인분당선,월곶,2170,1984,4154
16579,20201207,수인분당선,달월,67,39,106
16580,20201207,수인분당선,사리,2945,2833,5778
16581,20201207,수인분당선,야목,171,137,308
16582,20201207,수인분당선,어천,485,495,980
16583,20201207,수인분당선,오목천,2199,2125,4324
16584,20201207,수인분당선,고색,2757,2733,5490
16585,20201207,수인분당선,매교,2482,2558,5040
16586,20201207,수인분당선,수원시청,10270,10802,21072
16587,20201207,수인분당선,매탄권선,3937,3890,7827
16588,20201207,수인분당선,망포,11841,11578,23419
16589,20201207,수인분당선,영통,6638,6882,13520
16590,20201207,수인분당선,청명,3728,3526,7254
16591,20201207,수인분당선,상갈,4551,4472,9023
16592,20201207,수인분당선,기흥,7933,7625,15558
16593,20201207,수인분당선,신갈,4011,3999,8010
16594,20201207,수인분당선,구성,4191,4468,8659
16595,20201207,수인분당선,죽전,11140,12062,23202
16596,20201207,수인분당선,보정,2099,1816,3915
16597,20201207,수인분당선,이매,4738,4448,9186
16598,20201207,수인분당선,오리,10403,8878,19281
16599,20201207,수인분당선,미금,13327,14124,27451
16600,20201207,수인분당선,정자,13588,14472,28060
16601,20201207,수인분당선,수내,11207,11221,22428
16602,20201207,수인분당선,서현,20323,20730,41053
16603,20201207,수인분당선,야탑,22175,23092,45267
16604,20201207,수인분당선,모란,17243,17309,34552
16605,20201207,수인분당선,태평,11850,11685,23535
16606,20201207,수인분당선,가천대,8072,9102,17174
16607,20201207,수인분당선,선정릉,7252,7677,14929
16608,20201207,수인분당선,강남구청,8218,9319,17537
16609,20201207,수인분당선,압구정로데오,13739,14817,28556
16610,20201207,수인분당선,서울숲,7072,7047,14119
16611,20201207,수인분당선,수원,6804,5483,12287
16612,20201207,수인분당선,수서,11248,11529,22777
16613,20201207,수인분당선,대모산입구,3194,2991,6185
16614,20201207,수인분당선,개포동,3141,3214,6355
16615,20201207,수인분당선,구룡,1725,1673,3398
16616,20201207,수인분당선,도곡,5816,6021,11837
16617,20201207,수인분당선,한티,12303,13337,25640
16618,20201207,수인분당선,선릉,12839,18799,31638
16619,20201208,수인분당선,선릉,12246,17785,30031
16620,20201208,수인분당선,한티,11443,12348,23791
16621,20201208,수인분당선,도곡,5595,5546,11141
16622,20201208,수인분당선,구룡,1404,1360,2764
16623,20201208,수인분당선,개포동,3000,3075,6075
16624,20201208,수인분당선,대모산입구,3089,2921,6010
16625,20201208,수인분당선,수서,10381,10803,21184
16626,20201208,수인분당선,수원,6315,5083,11398
16627,20201208,수인분당선,서울숲,7052,7022,14074
16628,20201208,수인분당선,압구정로데오,13956,15084,29040
16629,20201208,수인분당선,강남구청,8074,9223,17297
16630,20201208,수인분당선,선정릉,7140,7503,14643
16631,20201208,수인분당선,가천대,7649,8414,16063
16632,20201208,수인분당선,태평,11411,11095,22506
16633,20201208,수인분당선,모란,16553,16575,33128
16634,20201208,수인분당선,야탑,21123,21988,43111
16635,20201208,수인분당선,서현,19101,19286,38387
16636,20201208,수인분당선,수내,10498,10572,21070
16637,20201208,수인분당선,정자,13196,14012,27208
16638,20201208,수인분당선,미금,12782,13283,26065
16639,20201208,수인분당선,오리,9937,8457,18394
16640,20201208,수인분당선,이매,4470,4227,8697
16641,20201208,수인분당선,고색,2655,2617,5272
16642,20201208,수인분당선,오목천,1972,1860,3832
16643,20201208,수인분당선,어천,408,434,842
16644,20201208,수인분당선,야목,150,113,263
16645,20201208,수인분당선,보정,1956,1755,3711
16646,20201208,수인분당선,죽전,10633,11638,22271
16647,20201208,수인분당선,구성,4050,4248,8298
16648,20201208,수인분당선,신갈,3770,3721,7491
16649,20201208,수인분당선,기흥,7606,7368,14974
16650,20201208,수인분당선,상갈,4295,4306,8601
16651,20201208,수인분당선,청명,3516,3404,6920
16652,20201208,수인분당선,영통,6227,6427,12654
16653,20201208,수인분당선,망포,11699,11156,22855
16654,20201208,수인분당선,매탄권선,3790,3768,7558
16655,20201208,수인분당선,수원시청,9642,10148,19790
16656,20201208,수인분당선,매교,2285,2424,4709
16657,20201208,수인분당선,인천,749,1245,1994
16658,20201208,수인분당선,신포,1403,1401,2804
16659,20201208,수인분당선,숭의,3371,3203,6574
16660,20201208,수인분당선,인하대,4921,4541,9462
16661,20201208,수인분당선,송도,2122,1936,4058
16662,20201208,수인분당선,연수,3596,3580,7176
16663,20201208,수인분당선,원인재,3612,3753,7365
16664,20201208,수인분당선,남동인더스파크,2179,2471,4650
16665,20201208,수인분당선,호구포,3165,3260,6425
16666,20201208,수인분당선,인천논현,4534,4751,9285
16667,20201208,수인분당선,소래포구,3616,3487,7103
16668,20201208,수인분당선,월곶,2047,1925,3972
16669,20201208,수인분당선,달월,83,53,136
16670,20201208,수인분당선,사리,2850,2698,5548
16671,20201209,수인분당선,수원시청,9603,10230,19833
16672,20201209,수인분당선,매탄권선,3877,3655,7532
16673,20201209,수인분당선,망포,11420,10970,22390
16674,20201209,수인분당선,영통,6207,6385,12592
16675,20201209,수인분당선,청명,3412,3256,6668
16676,20201209,수인분당선,상갈,4432,4238,8670
16677,20201209,수인분당선,기흥,7587,7431,15018
16678,20201209,수인분당선,신갈,3750,3719,7469
16679,20201209,수인분당선,구성,3970,4277,8247
16680,20201209,수인분당선,죽전,10721,11696,22417
16681,20201209,수인분당선,보정,2015,1728,3743
16682,20201209,수인분당선,이매,4427,4210,8637
16683,20201209,수인분당선,오리,9876,8370,18246
16684,20201209,수인분당선,미금,12892,13571,26463
16685,20201209,수인분당선,정자,12987,13667,26654
16686,20201209,수인분당선,수내,10529,10588,21117
16687,20201209,수인분당선,서현,19219,19567,38786
16688,20201209,수인분당선,야탑,21431,22369,43800
16689,20201209,수인분당선,모란,19654,20038,39692
16690,20201209,수인분당선,태평,11542,11341,22883
16691,20201209,수인분당선,가천대,7452,8320,15772
16692,20201209,수인분당선,선정릉,7151,7455,14606
16693,20201209,수인분당선,강남구청,8019,9091,17110
16694,20201209,수인분당선,압구정로데오,13864,14813,28677
16695,20201209,수인분당선,서울숲,6939,6939,13878
16696,20201209,수인분당선,선릉,11991,17446,29437
16697,20201209,수인분당선,한티,11390,12243,23633
16698,20201209,수인분당선,도곡,5398,5450,10848
16699,20201209,수인분당선,구룡,1395,1365,2760
16700,20201209,수인분당선,개포동,2960,3028,5988
16701,20201209,수인분당선,대모산입구,3080,2919,5999
16702,20201209,수인분당선,수서,10188,10784,20972
16703,20201209,수인분당선,수원,6194,4967,11161
16704,20201209,수인분당선,매교,2342,2439,4781
16705,20201209,수인분당선,고색,2707,2619,5326
16706,20201209,수인분당선,오목천,1933,1841,3774
16707,20201209,수인분당선,어천,414,441,855
16708,20201209,수인분당선,야목,142,121,263
16709,20201209,수인분당선,사리,2817,2706,5523
16710,20201209,수인분당선,달월,67,42,109
16711,20201209,수인분당선,월곶,2021,1939,3960
16712,20201209,수인분당선,소래포구,3752,3571,7323
16713,20201209,수인분당선,인천논현,4546,4785,9331
16714,20201209,수인분당선,호구포,3296,3367,6663
16715,20201209,수인분당선,남동인더스파크,2259,2499,4758
16716,20201209,수인분당선,원인재,3663,3781,7444
16717,20201209,수인분당선,연수,3665,3684,7349
16718,20201209,수인분당선,송도,2050,1949,3999
16719,20201209,수인분당선,인하대,4849,4595,9444
16720,20201209,수인분당선,숭의,3400,3199,6599
16721,20201209,수인분당선,신포,1462,1452,2914
16722,20201209,수인분당선,인천,792,1265,2057
16723,20201210,수인분당선,복정,1,0,1
16724,20201210,수인분당선,인천,804,1316,2120
16725,20201210,수인분당선,신포,1452,1479,2931
16726,20201210,수인분당선,숭의,3381,3273,6654
16727,20201210,수인분당선,인하대,4850,4548,9398
16728,20201210,수인분당선,송도,2054,1858,3912
16729,20201210,수인분당선,연수,3616,3556,7172
16730,20201210,수인분당선,원인재,3642,3769,7411
16731,20201210,수인분당선,남동인더스파크,2148,2384,4532
16732,20201210,수인분당선,호구포,3255,3342,6597
16733,20201210,수인분당선,인천논현,4582,4825,9407
16734,20201210,수인분당선,소래포구,3807,3679,7486
16735,20201210,수인분당선,월곶,1982,1917,3899
16736,20201210,수인분당선,달월,80,57,137
16737,20201210,수인분당선,사리,2853,2643,5496
16738,20201210,수인분당선,야목,158,152,310
16739,20201210,수인분당선,어천,436,424,860
16740,20201210,수인분당선,오목천,1983,1888,3871
16741,20201210,수인분당선,고색,2733,2677,5410
16742,20201210,수인분당선,매교,2341,2479,4820
16743,20201210,수인분당선,수원시청,9754,10203,19957
16744,20201210,수인분당선,매탄권선,3792,3796,7588
16745,20201210,수인분당선,망포,11418,10893,22311
16746,20201210,수인분당선,영통,6137,6506,12643
16747,20201210,수인분당선,청명,3486,3264,6750
16748,20201210,수인분당선,상갈,4310,4166,8476
16749,20201210,수인분당선,기흥,7619,7303,14922
16750,20201210,수인분당선,신갈,3714,3705,7419
16751,20201210,수인분당선,구성,4042,4199,8241
16752,20201210,수인분당선,죽전,10670,11644,22314
16753,20201210,수인분당선,보정,1952,1661,3613
16754,20201210,수인분당선,이매,4319,4071,8390
16755,20201210,수인분당선,오리,9890,8497,18387
16756,20201210,수인분당선,미금,12429,13208,25637
16757,20201210,수인분당선,정자,12983,13716,26699
16758,20201210,수인분당선,수내,10466,10496,20962
16759,20201210,수인분당선,서현,19074,19390,38464
16760,20201210,수인분당선,야탑,20904,21907,42811
16761,20201210,수인분당선,모란,16765,17082,33847
16762,20201210,수인분당선,태평,11399,11044,22443
16763,20201210,수인분당선,가천대,7163,7948,15111
16764,20201210,수인분당선,선정릉,6891,7401,14292
16765,20201210,수인분당선,강남구청,8006,9063,17069
16766,20201210,수인분당선,압구정로데오,13884,15145,29029
16767,20201210,수인분당선,서울숲,6958,7037,13995
16768,20201210,수인분당선,수원,6268,4924,11192
16769,20201210,수인분당선,수서,10342,10794,21136
16770,20201210,수인분당선,대모산입구,3148,2993,6141
16771,20201210,수인분당선,개포동,2873,2988,5861
16772,20201210,수인분당선,구룡,1385,1379,2764
16773,20201210,수인분당선,도곡,5548,5396,10944
16774,20201210,수인분당선,한티,11342,12133,23475
16775,20201210,수인분당선,선릉,11900,17541,29441
16776,20201211,수인분당선,인천,794,1331,2125
16777,20201211,수인분당선,신포,1510,1546,3056
16778,20201211,수인분당선,숭의,3510,3216,6726
16779,20201211,수인분당선,인하대,4850,4660,9510
16780,20201211,수인분당선,송도,2137,2032,4169
16781,20201211,수인분당선,연수,3865,3811,7676
16782,20201211,수인분당선,원인재,3776,3923,7699
16783,20201211,수인분당선,남동인더스파크,2165,2380,4545
16784,20201211,수인분당선,호구포,3394,3457,6851
16785,20201211,수인분당선,인천논현,4620,4992,9612
16786,20201211,수인분당선,소래포구,4153,3924,8077
16787,20201211,수인분당선,월곶,2133,1989,4122
16788,20201211,수인분당선,달월,73,48,121
16789,20201211,수인분당선,사리,2988,2830,5818
16790,20201211,수인분당선,야목,170,137,307
16791,20201211,수인분당선,어천,526,495,1021
16792,20201211,수인분당선,오목천,1984,1863,3847
16793,20201211,수인분당선,고색,2883,2691,5574
16794,20201211,수인분당선,매교,2379,2485,4864
16795,20201211,수인분당선,수원시청,10082,11080,21162
16796,20201211,수인분당선,매탄권선,4122,3940,8062
16797,20201211,수인분당선,망포,12332,11542,23874
16798,20201211,수인분당선,영통,6823,7015,13838
16799,20201211,수인분당선,청명,3652,3327,6979
16800,20201211,수인분당선,상갈,4533,4456,8989
16801,20201211,수인분당선,기흥,7836,7711,15547
16802,20201211,수인분당선,신갈,3694,3750,7444
16803,20201211,수인분당선,구성,4044,4221,8265
16804,20201211,수인분당선,죽전,11555,12164,23719
16805,20201211,수인분당선,보정,1973,1687,3660
16806,20201211,수인분당선,이매,4514,4246,8760
16807,20201211,수인분당선,오리,9989,8495,18484
16808,20201211,수인분당선,미금,13030,13283,26313
16809,20201211,수인분당선,정자,13290,14098,27388
16810,20201211,수인분당선,수내,10907,11063,21970
16811,20201211,수인분당선,서현,20221,20798,41019
16812,20201211,수인분당선,야탑,21440,22694,44134
16813,20201211,수인분당선,모란,17528,17647,35175
16814,20201211,수인분당선,태평,11791,11555,23346
16815,20201211,수인분당선,가천대,7319,7933,15252
16816,20201211,수인분당선,선정릉,6835,7170,14005
16817,20201211,수인분당선,강남구청,8059,9248,17307
16818,20201211,수인분당선,압구정로데오,15239,16411,31650
16819,20201211,수인분당선,서울숲,7211,7079,14290
16820,20201211,수인분당선,수원,6783,5580,12363
16821,20201211,수인분당선,수서,10814,12011,22825
16822,20201211,수인분당선,대모산입구,3120,2846,5966
16823,20201211,수인분당선,개포동,2988,3099,6087
16824,20201211,수인분당선,구룡,1363,1325,2688
16825,20201211,수인분당선,도곡,5453,5350,10803
16826,20201211,수인분당선,한티,11703,12397,24100
16827,20201211,수인분당선,선릉,11735,17364,29099
16828,20201212,수인분당선,원인재,2551,2663,5214
16829,20201212,수인분당선,남동인더스파크,821,828,1649
16830,20201212,수인분당선,호구포,1854,1783,3637
16831,20201212,수인분당선,인천논현,3044,3093,6137
16832,20201212,수인분당선,소래포구,3252,3453,6705
16833,20201212,수인분당선,월곶,1534,1503,3037
16834,20201212,수인분당선,달월,59,36,95
16835,20201212,수인분당선,사리,1875,1626,3501
16836,20201212,수인분당선,야목,128,113,241
16837,20201212,수인분당선,어천,362,333,695
16838,20201212,수인분당선,오목천,1154,1060,2214
16839,20201212,수인분당선,고색,1421,1452,2873
16840,20201212,수인분당선,매교,1473,1488,2961
16841,20201212,수인분당선,수원시청,6588,7122,13710
16842,20201212,수인분당선,매탄권선,2131,2004,4135
16843,20201212,수인분당선,망포,5858,5447,11305
16844,20201212,수인분당선,영통,4211,4180,8391
16845,20201212,수인분당선,청명,1725,1683,3408
16846,20201212,수인분당선,상갈,2500,2576,5076
16847,20201212,수인분당선,기흥,4540,4437,8977
16848,20201212,수인분당선,신갈,1913,1921,3834
16849,20201212,수인분당선,구성,2189,2242,4431
16850,20201212,수인분당선,죽전,6871,7510,14381
16851,20201212,수인분당선,보정,1059,959,2018
16852,20201212,수인분당선,이매,2372,2462,4834
16853,20201212,수인분당선,오리,5622,4672,10294
16854,20201212,수인분당선,미금,7676,7971,15647
16855,20201212,수인분당선,정자,6997,7160,14157
16856,20201212,수인분당선,수내,5995,5709,11704
16857,20201212,수인분당선,서현,11994,11918,23912
16858,20201212,수인분당선,야탑,11718,12446,24164
16859,20201212,수인분당선,모란,11736,11866,23602
16860,20201212,수인분당선,태평,7900,7934,15834
16861,20201212,수인분당선,가천대,3687,4089,7776
16862,20201212,수인분당선,선정릉,2573,2657,5230
16863,20201212,수인분당선,강남구청,3330,4014,7344
16864,20201212,수인분당선,압구정로데오,10913,11908,22821
16865,20201212,수인분당선,서울숲,3421,3335,6756
16866,20201212,수인분당선,수원,4704,3734,8438
16867,20201212,수인분당선,수서,5997,6539,12536
16868,20201212,수인분당선,대모산입구,1886,1757,3643
16869,20201212,수인분당선,개포동,1592,1565,3157
16870,20201212,수인분당선,구룡,818,727,1545
16871,20201212,수인분당선,도곡,2880,2641,5521
16872,20201212,수인분당선,한티,6857,7014,13871
16873,20201212,수인분당선,선릉,3805,5495,9300
16874,20201212,수인분당선,연수,2739,2743,5482
16875,20201212,수인분당선,송도,1566,1474,3040
16876,20201212,수인분당선,인하대,3048,2784,5832
16877,20201212,수인분당선,숭의,1983,1881,3864
16878,20201212,수인분당선,신포,983,1044,2027
16879,20201212,수인분당선,인천,714,1064,1778
16880,20201213,수인분당선,선릉,1894,2761,4655
16881,20201213,수인분당선,한티,4238,4471,8709
16882,20201213,수인분당선,도곡,1435,1505,2940
16883,20201213,수인분당선,구룡,384,368,752
16884,20201213,수인분당선,개포동,981,1066,2047
16885,20201213,수인분당선,대모산입구,1187,1079,2266
16886,20201213,수인분당선,수서,5490,5470,10960
16887,20201213,수인분당선,수원,3354,2685,6039
16888,20201213,수인분당선,서울숲,2114,2118,4232
16889,20201213,수인분당선,압구정로데오,5742,6290,12032
16890,20201213,수인분당선,강남구청,1890,2367,4257
16891,20201213,수인분당선,선정릉,1512,1472,2984
16892,20201213,수인분당선,가천대,15463,13872,29335
16893,20201213,수인분당선,태평,6923,5839,12762
16894,20201213,수인분당선,모란,7976,8221,16197
16895,20201213,수인분당선,야탑,8265,8690,16955
16896,20201213,수인분당선,서현,8013,8134,16147
16897,20201213,수인분당선,수내,3880,3960,7840
16898,20201213,수인분당선,정자,4415,4481,8896
16899,20201213,수인분당선,미금,4442,4705,9147
16900,20201213,수인분당선,오리,3489,3173,6662
16901,20201213,수인분당선,이매,1656,1782,3438
16902,20201213,수인분당선,보정,646,565,1211
16903,20201213,수인분당선,죽전,4585,5252,9837
16904,20201213,수인분당선,구성,1362,1435,2797
16905,20201213,수인분당선,신갈,1178,1166,2344
16906,20201213,수인분당선,기흥,3072,2982,6054
16907,20201213,수인분당선,상갈,1763,1687,3450
16908,20201213,수인분당선,청명,1152,1201,2353
16909,20201213,수인분당선,영통,2468,2512,4980
16910,20201213,수인분당선,망포,3555,3877,7432
16911,20201213,수인분당선,매탄권선,1419,1409,2828
16912,20201213,수인분당선,수원시청,4153,4095,8248
16913,20201213,수인분당선,매교,793,807,1600
16914,20201213,수인분당선,고색,983,953,1936
16915,20201213,수인분당선,오목천,763,765,1528
16916,20201213,수인분당선,어천,216,298,514
16917,20201213,수인분당선,야목,78,78,156
16918,20201213,수인분당선,사리,1285,1085,2370
16919,20201213,수인분당선,달월,42,45,87
16920,20201213,수인분당선,월곶,927,944,1871
16921,20201213,수인분당선,소래포구,2229,2241,4470
16922,20201213,수인분당선,인천논현,1775,1832,3607
16923,20201213,수인분당선,호구포,1339,1370,2709
16924,20201213,수인분당선,남동인더스파크,485,492,977
16925,20201213,수인분당선,원인재,1679,1716,3395
16926,20201213,수인분당선,연수,1883,1798,3681
16927,20201213,수인분당선,송도,952,892,1844
16928,20201213,수인분당선,인하대,1751,1750,3501
16929,20201213,수인분당선,숭의,1189,1110,2299
16930,20201213,수인분당선,신포,632,625,1257
16931,20201213,수인분당선,인천,525,730,1255
16932,20201214,수인분당선,선릉,11354,16919,28273
16933,20201214,수인분당선,한티,10106,10999,21105
16934,20201214,수인분당선,도곡,5044,5179,10223
16935,20201214,수인분당선,구룡,1223,1196,2419
16936,20201214,수인분당선,개포동,2623,2760,5383
16937,20201214,수인분당선,대모산입구,2831,2638,5469
16938,20201214,수인분당선,수서,9732,10092,19824
16939,20201214,수인분당선,수원,5682,4573,10255
16940,20201214,수인분당선,서울숲,6168,6160,12328
16941,20201214,수인분당선,압구정로데오,12090,13069,25159
16942,20201214,수인분당선,강남구청,7406,8327,15733
16943,20201214,수인분당선,선정릉,6716,7042,13758
16944,20201214,수인분당선,가천대,5718,6726,12444
16945,20201214,수인분당선,태평,10793,10683,21476
16946,20201214,수인분당선,모란,16396,16656,33052
16947,20201214,수인분당선,야탑,19803,20661,40464
16948,20201214,수인분당선,서현,17956,18121,36077
16949,20201214,수인분당선,수내,9906,9796,19702
16950,20201214,수인분당선,정자,11914,12724,24638
16951,20201214,수인분당선,미금,11695,12481,24176
16952,20201214,수인분당선,오리,9101,7719,16820
16953,20201214,수인분당선,이매,4030,3761,7791
16954,20201214,수인분당선,보정,1713,1535,3248
16955,20201214,수인분당선,죽전,9560,10370,19930
16956,20201214,수인분당선,구성,3640,3790,7430
16957,20201214,수인분당선,신갈,3403,3409,6812
16958,20201214,수인분당선,기흥,7078,6839,13917
16959,20201214,수인분당선,상갈,3893,3848,7741
16960,20201214,수인분당선,청명,3177,3098,6275
16961,20201214,수인분당선,영통,5686,5894,11580
16962,20201214,수인분당선,망포,10702,10254,20956
16963,20201214,수인분당선,매탄권선,3573,3372,6945
16964,20201214,수인분당선,수원시청,8939,9321,18260
16965,20201214,수인분당선,매교,2167,2247,4414
16966,20201214,수인분당선,고색,2519,2543,5062
16967,20201214,수인분당선,오목천,1610,1594,3204
16968,20201214,수인분당선,어천,394,421,815
16969,20201214,수인분당선,야목,127,99,226
16970,20201214,수인분당선,사리,2632,2507,5139
16971,20201214,수인분당선,달월,72,38,110
16972,20201214,수인분당선,월곶,1862,1714,3576
16973,20201214,수인분당선,소래포구,3185,3020,6205
16974,20201214,수인분당선,인천논현,4132,4307,8439
16975,20201214,수인분당선,호구포,2995,3189,6184
16976,20201214,수인분당선,남동인더스파크,2059,2334,4393
16977,20201214,수인분당선,원인재,3264,3366,6630
16978,20201214,수인분당선,연수,3326,3226,6552
16979,20201214,수인분당선,송도,1889,1707,3596
16980,20201214,수인분당선,인하대,4164,3948,8112
16981,20201214,수인분당선,숭의,3114,2866,5980
16982,20201214,수인분당선,신포,1280,1235,2515
16983,20201214,수인분당선,인천,719,1169,1888
16984,20201214,수인분당선,복정,1,0,1
16985,20201215,수인분당선,선릉,11148,16229,27377
16986,20201215,수인분당선,한티,10280,10982,21262
16987,20201215,수인분당선,도곡,4914,4948,9862
16988,20201215,수인분당선,구룡,1211,1184,2395
16989,20201215,수인분당선,개포동,2617,2742,5359
16990,20201215,수인분당선,대모산입구,2749,2545,5294
16991,20201215,수인분당선,수서,9211,9671,18882
16992,20201215,수인분당선,수원,5468,4425,9893
16993,20201215,수인분당선,서울숲,6244,6270,12514
16994,20201215,수인분당선,압구정로데오,13228,14344,27572
16995,20201215,수인분당선,강남구청,7370,8452,15822
16996,20201215,수인분당선,선정릉,6442,6849,13291
16997,20201215,수인분당선,가천대,5522,6369,11891
16998,20201215,수인분당선,태평,10627,10459,21086
16999,20201215,수인분당선,모란,15340,15293,30633
17000,20201215,수인분당선,야탑,19164,19985,39149
17001,20201215,수인분당선,서현,17419,17650,35069
17002,20201215,수인분당선,수내,9655,9709,19364
17003,20201215,수인분당선,정자,11766,12300,24066
17004,20201215,수인분당선,미금,11557,12124,23681
17005,20201215,수인분당선,오리,8951,7591,16542
17006,20201215,수인분당선,이매,3786,3521,7307
17007,20201215,수인분당선,보정,1654,1416,3070
17008,20201215,수인분당선,죽전,9401,10449,19850
17009,20201215,수인분당선,구성,3561,3750,7311
17010,20201215,수인분당선,신갈,3281,3228,6509
17011,20201215,수인분당선,기흥,6964,6737,13701
17012,20201215,수인분당선,상갈,3870,3849,7719
17013,20201215,수인분당선,청명,3120,3012,6132
17014,20201215,수인분당선,영통,5523,5721,11244
17015,20201215,수인분당선,망포,10242,9973,20215
17016,20201215,수인분당선,매탄권선,3378,3513,6891
17017,20201215,수인분당선,수원시청,8707,9159,17866
17018,20201215,수인분당선,매교,1954,2046,4000
17019,20201215,수인분당선,고색,2473,2436,4909
17020,20201215,수인분당선,오목천,1546,1559,3105
17021,20201215,수인분당선,어천,405,370,775
17022,20201215,수인분당선,야목,139,95,234
17023,20201215,수인분당선,사리,2435,2294,4729
17024,20201215,수인분당선,달월,74,47,121
17025,20201215,수인분당선,월곶,1780,1724,3504
17026,20201215,수인분당선,소래포구,3108,2925,6033
17027,20201215,수인분당선,인천논현,3958,4187,8145
17028,20201215,수인분당선,호구포,2906,3058,5964
17029,20201215,수인분당선,남동인더스파크,2129,2396,4525
17030,20201215,수인분당선,원인재,3331,3354,6685
17031,20201215,수인분당선,연수,3134,3137,6271
17032,20201215,수인분당선,송도,1810,1628,3438
17033,20201215,수인분당선,인하대,4071,3910,7981
17034,20201215,수인분당선,숭의,3003,2801,5804
17035,20201215,수인분당선,신포,1220,1233,2453
17036,20201215,수인분당선,인천,713,1222,1935
17037,20201216,수인분당선,연수,3263,3280,6543
17038,20201216,수인분당선,송도,1819,1644,3463
17039,20201216,수인분당선,인하대,4052,3855,7907
17040,20201216,수인분당선,숭의,3000,2880,5880
17041,20201216,수인분당선,신포,1188,1156,2344
17042,20201216,수인분당선,인천,722,1155,1877
17043,20201216,수인분당선,원인재,3250,3307,6557
17044,20201216,수인분당선,남동인더스파크,2120,2340,4460
17045,20201216,수인분당선,호구포,3006,3094,6100
17046,20201216,수인분당선,인천논현,4031,4183,8214
17047,20201216,수인분당선,소래포구,3008,2858,5866
17048,20201216,수인분당선,월곶,1853,1652,3505
17049,20201216,수인분당선,달월,70,35,105
17050,20201216,수인분당선,사리,2464,2299,4763
17051,20201216,수인분당선,야목,129,97,226
17052,20201216,수인분당선,어천,390,365,755
17053,20201216,수인분당선,오목천,1607,1614,3221
17054,20201216,수인분당선,고색,2491,2416,4907
17055,20201216,수인분당선,매교,2000,2055,4055
17056,20201216,수인분당선,수원시청,8679,9064,17743
17057,20201216,수인분당선,매탄권선,3393,3262,6655
17058,20201216,수인분당선,망포,10259,9864,20123
17059,20201216,수인분당선,영통,5444,5639,11083
17060,20201216,수인분당선,청명,3068,3009,6077
17061,20201216,수인분당선,상갈,3895,3737,7632
17062,20201216,수인분당선,기흥,6794,6630,13424
17063,20201216,수인분당선,신갈,3296,3241,6537
17064,20201216,수인분당선,구성,3475,3678,7153
17065,20201216,수인분당선,죽전,9348,10303,19651
17066,20201216,수인분당선,보정,1651,1414,3065
17067,20201216,수인분당선,이매,3883,3675,7558
17068,20201216,수인분당선,오리,8878,7498,16376
17069,20201216,수인분당선,미금,11592,12199,23791
17070,20201216,수인분당선,정자,11666,12297,23963
17071,20201216,수인분당선,수내,9648,9705,19353
17072,20201216,수인분당선,서현,17379,17629,35008
17073,20201216,수인분당선,야탑,19444,20314,39758
17074,20201216,수인분당선,모란,15066,15109,30175
17075,20201216,수인분당선,태평,10442,10317,20759
17076,20201216,수인분당선,가천대,5427,6252,11679
17077,20201216,수인분당선,선정릉,6563,6903,13466
17078,20201216,수인분당선,강남구청,7329,8382,15711
17079,20201216,수인분당선,압구정로데오,13074,13976,27050
17080,20201216,수인분당선,서울숲,6211,6269,12480
17081,20201216,수인분당선,수원,5572,4721,10293
17082,20201216,수인분당선,수서,9215,9727,18942
17083,20201216,수인분당선,대모산입구,2747,2609,5356
17084,20201216,수인분당선,개포동,2632,2749,5381
17085,20201216,수인분당선,구룡,1148,1143,2291
17086,20201216,수인분당선,도곡,4949,5003,9952
17087,20201216,수인분당선,한티,10092,10768,20860
17088,20201216,수인분당선,선릉,11131,16117,27248
17089,20201217,수인분당선,인천,710,1187,1897
17090,20201217,수인분당선,신포,1257,1236,2493
17091,20201217,수인분당선,숭의,3124,2943,6067
17092,20201217,수인분당선,인하대,4154,4027,8181
17093,20201217,수인분당선,송도,1834,1738,3572
17094,20201217,수인분당선,연수,3256,3219,6475
17095,20201217,수인분당선,원인재,3305,3378,6683
17096,20201217,수인분당선,남동인더스파크,2085,2327,4412
17097,20201217,수인분당선,호구포,3025,3156,6181
17098,20201217,수인분당선,인천논현,4004,4235,8239
17099,20201217,수인분당선,고색,2594,2533,5127
17100,20201217,수인분당선,매교,2357,2348,4705
17101,20201217,수인분당선,수원시청,8712,9262,17974
17102,20201217,수인분당선,매탄권선,3420,3391,6811
17103,20201217,수인분당선,망포,10541,10078,20619
17104,20201217,수인분당선,영통,5700,5851,11551
17105,20201217,수인분당선,청명,3177,3104,6281
17106,20201217,수인분당선,상갈,3926,3808,7734
17107,20201217,수인분당선,기흥,6866,6767,13633
17108,20201217,수인분당선,신갈,3273,3332,6605
17109,20201217,수인분당선,구성,3602,3863,7465
17110,20201217,수인분당선,죽전,9706,10546,20252
17111,20201217,수인분당선,보정,1821,1549,3370
17112,20201217,수인분당선,이매,3879,3717,7596
17113,20201217,수인분당선,오리,9259,7787,17046
17114,20201217,수인분당선,미금,11518,12179,23697
17115,20201217,수인분당선,정자,12086,12555,24641
17116,20201217,수인분당선,수내,9732,9830,19562
17117,20201217,수인분당선,서현,17677,17981,35658
17118,20201217,수인분당선,야탑,19429,20211,39640
17119,20201217,수인분당선,모란,15411,15491,30902
17120,20201217,수인분당선,태평,10717,10544,21261
17121,20201217,수인분당선,가천대,5446,6201,11647
17122,20201217,수인분당선,선정릉,6503,7020,13523
17123,20201217,수인분당선,강남구청,7104,8272,15376
17124,20201217,수인분당선,압구정로데오,13428,14443,27871
17125,20201217,수인분당선,서울숲,6161,6292,12453
17126,20201217,수인분당선,수원,5615,4486,10101
17127,20201217,수인분당선,수서,9413,9881,19294
17128,20201217,수인분당선,대모산입구,2784,2615,5399
17129,20201217,수인분당선,개포동,2671,2801,5472
17130,20201217,수인분당선,구룡,1200,1205,2405
17131,20201217,수인분당선,도곡,5028,5039,10067
17132,20201217,수인분당선,한티,10070,10873,20943
17133,20201217,수인분당선,선릉,10965,15926,26891
17134,20201217,수인분당선,오목천,1613,1536,3149
17135,20201217,수인분당선,어천,401,409,810
17136,20201217,수인분당선,야목,130,108,238
17137,20201217,수인분당선,사리,2440,2342,4782
17138,20201217,수인분당선,달월,74,51,125
17139,20201217,수인분당선,월곶,1839,1728,3567
17140,20201217,수인분당선,소래포구,3231,3034,6265
17141,20201218,수인분당선,선릉,10943,16073,27016
17142,20201218,수인분당선,한티,10865,11412,22277
17143,20201218,수인분당선,도곡,5143,5194,10337
17144,20201218,수인분당선,구룡,1362,1269,2631
17145,20201218,수인분당선,개포동,2933,2987,5920
17146,20201218,수인분당선,대모산입구,2921,2731,5652
17147,20201218,수인분당선,수서,10090,10870,20960
17148,20201218,수인분당선,수원,6445,5202,11647
17149,20201218,수인분당선,서울숲,6493,6497,12990
17150,20201218,수인분당선,압구정로데오,14818,15976,30794
17151,20201218,수인분당선,강남구청,7612,8737,16349
17152,20201218,수인분당선,선정릉,6506,6739,13245
17153,20201218,수인분당선,가천대,6112,6782,12894
17154,20201218,수인분당선,태평,11262,11133,22395
17155,20201218,수인분당선,모란,16446,16340,32786
17156,20201218,수인분당선,야탑,20652,21847,42499
17157,20201218,수인분당선,서현,19491,19961,39452
17158,20201218,수인분당선,수내,10599,10616,21215
17159,20201218,수인분당선,정자,12603,13323,25926
17160,20201218,수인분당선,미금,12399,12783,25182
17161,20201218,수인분당선,오리,9733,8212,17945
17162,20201218,수인분당선,이매,4184,3941,8125
17163,20201218,수인분당선,보정,1998,1676,3674
17164,20201218,수인분당선,죽전,10768,11590,22358
17165,20201218,수인분당선,구성,3904,4039,7943
17166,20201218,수인분당선,신갈,3556,3520,7076
17167,20201218,수인분당선,기흥,7560,7243,14803
17168,20201218,수인분당선,상갈,4355,4200,8555
17169,20201218,수인분당선,청명,3549,3260,6809
17170,20201218,수인분당선,영통,6538,6492,13030
17171,20201218,수인분당선,망포,11755,11141,22896
17172,20201218,수인분당선,매탄권선,3865,3704,7569
17173,20201218,수인분당선,수원시청,9720,10605,20325
17174,20201218,수인분당선,매교,2429,2532,4961
17175,20201218,수인분당선,고색,2783,2603,5386
17176,20201218,수인분당선,오목천,1782,1675,3457
17177,20201218,수인분당선,어천,464,443,907
17178,20201218,수인분당선,야목,158,121,279
17179,20201218,수인분당선,사리,2773,2567,5340
17180,20201218,수인분당선,달월,77,48,125
17181,20201218,수인분당선,월곶,1949,1861,3810
17182,20201218,수인분당선,소래포구,3566,3510,7076
17183,20201218,수인분당선,인천논현,4439,4623,9062
17184,20201218,수인분당선,호구포,3273,3387,6660
17185,20201218,수인분당선,남동인더스파크,2158,2451,4609
17186,20201218,수인분당선,원인재,3629,3705,7334
17187,20201218,수인분당선,연수,3502,3454,6956
17188,20201218,수인분당선,송도,1998,1842,3840
17189,20201218,수인분당선,인하대,4658,4377,9035
17190,20201218,수인분당선,숭의,3324,3119,6443
17191,20201218,수인분당선,신포,1349,1417,2766
17192,20201218,수인분당선,인천,779,1301,2080
17193,20201219,수인분당선,선릉,3416,5092,8508
17194,20201219,수인분당선,한티,6355,6405,12760
17195,20201219,수인분당선,도곡,2697,2597,5294
17196,20201219,수인분당선,구룡,797,757,1554
17197,20201219,수인분당선,개포동,1589,1580,3169
17198,20201219,수인분당선,대모산입구,1653,1529,3182
17199,20201219,수인분당선,수서,5562,6018,11580
17200,20201219,수인분당선,수원,4484,3516,8000
17201,20201219,수인분당선,서울숲,2893,2918,5811
17202,20201219,수인분당선,압구정로데오,10343,11086,21429
17203,20201219,수인분당선,강남구청,3313,3852,7165
17204,20201219,수인분당선,선정릉,2315,2328,4643
17205,20201219,수인분당선,가천대,3508,3849,7357
17206,20201219,수인분당선,태평,7463,7311,14774
17207,20201219,수인분당선,모란,12701,12721,25422
17208,20201219,수인분당선,야탑,10658,11543,22201
17209,20201219,수인분당선,서현,11665,11645,23310
17210,20201219,수인분당선,수내,5535,5399,10934
17211,20201219,수인분당선,정자,6543,6612,13155
17212,20201219,수인분당선,미금,7219,7127,14346
17213,20201219,수인분당선,오리,5046,4212,9258
17214,20201219,수인분당선,이매,2161,2182,4343
17215,20201219,수인분당선,보정,888,823,1711
17216,20201219,수인분당선,죽전,6448,7108,13556
17217,20201219,수인분당선,구성,1845,2035,3880
17218,20201219,수인분당선,신갈,1625,1681,3306
17219,20201219,수인분당선,기흥,4137,3996,8133
17220,20201219,수인분당선,상갈,2261,2352,4613
17221,20201219,수인분당선,청명,1593,1553,3146
17222,20201219,수인분당선,영통,3809,3846,7655
17223,20201219,수인분당선,망포,5592,5268,10860
17224,20201219,수인분당선,매탄권선,1997,1942,3939
17225,20201219,수인분당선,수원시청,6078,6551,12629
17226,20201219,수인분당선,매교,1283,1317,2600
17227,20201219,수인분당선,고색,1311,1275,2586
17228,20201219,수인분당선,오목천,977,872,1849
17229,20201219,수인분당선,어천,307,270,577
17230,20201219,수인분당선,야목,94,94,188
17231,20201219,수인분당선,사리,1596,1493,3089
17232,20201219,수인분당선,달월,52,50,102
17233,20201219,수인분당선,월곶,1252,1345,2597
17234,20201219,수인분당선,소래포구,2702,2807,5509
17235,20201219,수인분당선,인천논현,2850,2996,5846
17236,20201219,수인분당선,호구포,1796,1747,3543
17237,20201219,수인분당선,남동인더스파크,768,748,1516
17238,20201219,수인분당선,원인재,2376,2456,4832
17239,20201219,수인분당선,연수,2398,2386,4784
17240,20201219,수인분당선,송도,1257,1244,2501
17241,20201219,수인분당선,인하대,4417,3373,7790
17242,20201219,수인분당선,숭의,1851,1746,3597
17243,20201219,수인분당선,신포,882,881,1763
17244,20201219,수인분당선,인천,599,998,1597
17245,20201220,수인분당선,구룡,371,376,747
17246,20201220,수인분당선,도곡,1555,1476,3031
17247,20201220,수인분당선,한티,3941,4159,8100
17248,20201220,수인분당선,선릉,1798,2487,4285
17249,20201220,수인분당선,오목천,681,667,1348
17250,20201220,수인분당선,어천,199,270,469
17251,20201220,수인분당선,야목,70,67,137
17252,20201220,수인분당선,사리,1173,1054,2227
17253,20201220,수인분당선,달월,40,40,80
17254,20201220,수인분당선,월곶,978,954,1932
17255,20201220,수인분당선,인천,510,796,1306
17256,20201220,수인분당선,신포,687,727,1414
17257,20201220,수인분당선,숭의,1211,1168,2379
17258,20201220,수인분당선,인하대,4444,3212,7656
17259,20201220,수인분당선,송도,975,1010,1985
17260,20201220,수인분당선,연수,1872,1818,3690
17261,20201220,수인분당선,원인재,1750,1810,3560
17262,20201220,수인분당선,남동인더스파크,468,470,938
17263,20201220,수인분당선,호구포,1213,1249,2462
17264,20201220,수인분당선,인천논현,1866,1933,3799
17265,20201220,수인분당선,소래포구,2302,2229,4531
17266,20201220,수인분당선,고색,926,986,1912
17267,20201220,수인분당선,매교,828,805,1633
17268,20201220,수인분당선,수원시청,3990,3893,7883
17269,20201220,수인분당선,매탄권선,1438,1460,2898
17270,20201220,수인분당선,망포,3585,3754,7339
17271,20201220,수인분당선,영통,2682,2652,5334
17272,20201220,수인분당선,청명,1078,1128,2206
17273,20201220,수인분당선,상갈,1686,1696,3382
17274,20201220,수인분당선,기흥,2914,2913,5827
17275,20201220,수인분당선,신갈,1037,1071,2108
17276,20201220,수인분당선,구성,1263,1396,2659
17277,20201220,수인분당선,죽전,4956,5437,10393
17278,20201220,수인분당선,보정,558,538,1096
17279,20201220,수인분당선,이매,1599,1647,3246
17280,20201220,수인분당선,오리,3358,2928,6286
17281,20201220,수인분당선,미금,4223,4438,8661
17282,20201220,수인분당선,정자,4033,4101,8134
17283,20201220,수인분당선,수내,3821,3695,7516
17284,20201220,수인분당선,서현,7751,7644,15395
17285,20201220,수인분당선,야탑,7311,7653,14964
17286,20201220,수인분당선,모란,6858,7090,13948
17287,20201220,수인분당선,태평,5230,4937,10167
17288,20201220,수인분당선,가천대,2168,2656,4824
17289,20201220,수인분당선,선정릉,1345,1426,2771
17290,20201220,수인분당선,강남구청,1776,2149,3925
17291,20201220,수인분당선,압구정로데오,5586,5968,11554
17292,20201220,수인분당선,서울숲,2019,2018,4037
17293,20201220,수인분당선,수원,3280,2717,5997
17294,20201220,수인분당선,수서,4162,4217,8379
17295,20201220,수인분당선,대모산입구,1042,1021,2063
17296,20201220,수인분당선,개포동,912,952,1864
17297,20201221,수인분당선,인천,766,1183,1949
17298,20201221,수인분당선,신포,1293,1303,2596
17299,20201221,수인분당선,숭의,3164,2935,6099
17300,20201221,수인분당선,인하대,4395,4146,8541
17301,20201221,수인분당선,송도,1980,1796,3776
17302,20201221,수인분당선,연수,3451,3311,6762
17303,20201221,수인분당선,원인재,3548,3492,7040
17304,20201221,수인분당선,남동인더스파크,2142,2441,4583
17305,20201221,수인분당선,호구포,3020,3198,6218
17306,20201221,수인분당선,인천논현,4254,4408,8662
17307,20201221,수인분당선,소래포구,3399,3208,6607
17308,20201221,수인분당선,월곶,1964,1837,3801
17309,20201221,수인분당선,달월,83,46,129
17310,20201221,수인분당선,사리,2737,2583,5320
17311,20201221,수인분당선,야목,161,122,283
17312,20201221,수인분당선,어천,444,472,916
17313,20201221,수인분당선,오목천,1647,1565,3212
17314,20201221,수인분당선,고색,2623,2553,5176
17315,20201221,수인분당선,매교,2384,2379,4763
17316,20201221,수인분당선,수원시청,9286,9807,19093
17317,20201221,수인분당선,매탄권선,3692,3544,7236
17318,20201221,수인분당선,망포,10892,10520,21412
17319,20201221,수인분당선,영통,6110,6121,12231
17320,20201221,수인분당선,청명,3217,3100,6317
17321,20201221,수인분당선,상갈,4063,3966,8029
17322,20201221,수인분당선,기흥,7123,6876,13999
17323,20201221,수인분당선,신갈,3502,3524,7026
17324,20201221,수인분당선,구성,3711,3937,7648
17325,20201221,수인분당선,죽전,9977,10787,20764
17326,20201221,수인분당선,보정,1916,1637,3553
17327,20201221,수인분당선,이매,3900,3681,7581
17328,20201221,수인분당선,오리,9482,7924,17406
17329,20201221,수인분당선,미금,12040,12922,24962
17330,20201221,수인분당선,정자,12092,12841,24933
17331,20201221,수인분당선,수내,9942,9962,19904
17332,20201221,수인분당선,서현,18624,18727,37351
17333,20201221,수인분당선,야탑,20074,21019,41093
17334,20201221,수인분당선,모란,15935,15889,31824
17335,20201221,수인분당선,태평,11041,10796,21837
17336,20201221,수인분당선,가천대,5145,6104,11249
17337,20201221,수인분당선,선정릉,6639,7020,13659
17338,20201221,수인분당선,강남구청,7445,8593,16038
17339,20201221,수인분당선,압구정로데오,13045,13955,27000
17340,20201221,수인분당선,서울숲,6327,6355,12682
17341,20201221,수인분당선,수원,5883,4693,10576
17342,20201221,수인분당선,수서,9777,10064,19841
17343,20201221,수인분당선,대모산입구,2870,2705,5575
17344,20201221,수인분당선,개포동,2956,3003,5959
17345,20201221,수인분당선,구룡,1301,1273,2574
17346,20201221,수인분당선,도곡,5371,5471,10842
17347,20201221,수인분당선,한티,10462,11161,21623
17348,20201221,수인분당선,선릉,11275,16587,27862
17349,20201222,수인분당선,인천,771,1256,2027
17350,20201222,수인분당선,신포,1301,1290,2591
17351,20201222,수인분당선,숭의,3296,3046,6342
17352,20201222,수인분당선,인하대,4352,4201,8553
17353,20201222,수인분당선,송도,1993,1822,3815
17354,20201222,수인분당선,연수,3385,3402,6787
17355,20201222,수인분당선,원인재,3590,3673,7263
17356,20201222,수인분당선,남동인더스파크,2185,2460,4645
17357,20201222,수인분당선,호구포,3125,3258,6383
17358,20201222,수인분당선,인천논현,4278,4429,8707
17359,20201222,수인분당선,소래포구,3657,3438,7095
17360,20201222,수인분당선,월곶,1988,1872,3860
17361,20201222,수인분당선,달월,79,49,128
17362,20201222,수인분당선,사리,2905,2709,5614
17363,20201222,수인분당선,야목,169,125,294
17364,20201222,수인분당선,어천,436,399,835
17365,20201222,수인분당선,오목천,1617,1585,3202
17366,20201222,수인분당선,고색,2745,2683,5428
17367,20201222,수인분당선,매교,2424,2503,4927
17368,20201222,수인분당선,수원시청,9338,9816,19154
17369,20201222,수인분당선,매탄권선,3674,3555,7229
17370,20201222,수인분당선,망포,11256,10664,21920
17371,20201222,수인분당선,영통,6010,6300,12310
17372,20201222,수인분당선,청명,3333,3155,6488
17373,20201222,수인분당선,상갈,4106,3997,8103
17374,20201222,수인분당선,기흥,7134,6939,14073
17375,20201222,수인분당선,신갈,3527,3612,7139
17376,20201222,수인분당선,구성,3765,3979,7744
17377,20201222,수인분당선,죽전,10213,11148,21361
17378,20201222,수인분당선,보정,1956,1670,3626
17379,20201222,수인분당선,이매,3885,3666,7551
17380,20201222,수인분당선,오리,9476,8008,17484
17381,20201222,수인분당선,미금,12262,12963,25225
17382,20201222,수인분당선,정자,12332,12981,25313
17383,20201222,수인분당선,수내,10162,10270,20432
17384,20201222,수인분당선,서현,18842,18836,37678
17385,20201222,수인분당선,야탑,20179,21317,41496
17386,20201222,수인분당선,모란,15981,16056,32037
17387,20201222,수인분당선,태평,11091,10837,21928
17388,20201222,수인분당선,가천대,5130,5946,11076
17389,20201222,수인분당선,선정릉,6559,7108,13667
17390,20201222,수인분당선,강남구청,7606,8873,16479
17391,20201222,수인분당선,압구정로데오,14152,15221,29373
17392,20201222,수인분당선,서울숲,6549,6562,13111
17393,20201222,수인분당선,수원,5899,4644,10543
17394,20201222,수인분당선,수서,9682,10055,19737
17395,20201222,수인분당선,대모산입구,2906,2715,5621
17396,20201222,수인분당선,개포동,2877,2984,5861
17397,20201222,수인분당선,구룡,1289,1285,2574
17398,20201222,수인분당선,도곡,5244,5256,10500
17399,20201222,수인분당선,한티,10374,11118,21492
17400,20201222,수인분당선,선릉,11263,16448,27711
17401,20201223,수인분당선,인천,761,1219,1980
17402,20201223,수인분당선,신포,1258,1280,2538
17403,20201223,수인분당선,숭의,3266,2970,6236
17404,20201223,수인분당선,인하대,4394,4146,8540
17405,20201223,수인분당선,송도,1953,1804,3757
17406,20201223,수인분당선,연수,3303,3223,6526
17407,20201223,수인분당선,원인재,3523,3579,7102
17408,20201223,수인분당선,남동인더스파크,2137,2361,4498
17409,20201223,수인분당선,호구포,3062,3225,6287
17410,20201223,수인분당선,인천논현,4178,4406,8584
17411,20201223,수인분당선,소래포구,3610,3355,6965
17412,20201223,수인분당선,월곶,1932,1866,3798
17413,20201223,수인분당선,달월,77,52,129
17414,20201223,수인분당선,사리,2795,2624,5419
17415,20201223,수인분당선,야목,157,130,287
17416,20201223,수인분당선,어천,428,458,886
17417,20201223,수인분당선,오목천,1579,1550,3129
17418,20201223,수인분당선,고색,2742,2611,5353
17419,20201223,수인분당선,매교,2331,2398,4729
17420,20201223,수인분당선,수원시청,9374,10059,19433
17421,20201223,수인분당선,매탄권선,3636,3500,7136
17422,20201223,수인분당선,망포,10988,10512,21500
17423,20201223,수인분당선,영통,6083,6199,12282
17424,20201223,수인분당선,청명,3273,3092,6365
17425,20201223,수인분당선,상갈,4088,3937,8025
17426,20201223,수인분당선,기흥,7218,6909,14127
17427,20201223,수인분당선,신갈,3456,3485,6941
17428,20201223,수인분당선,구성,3746,3918,7664
17429,20201223,수인분당선,죽전,10179,11166,21345
17430,20201223,수인분당선,보정,1864,1575,3439
17431,20201223,수인분당선,이매,3998,3732,7730
17432,20201223,수인분당선,오리,9400,7978,17378
17433,20201223,수인분당선,미금,12202,13002,25204
17434,20201223,수인분당선,정자,12060,12728,24788
17435,20201223,수인분당선,수내,10307,10287,20594
17436,20201223,수인분당선,서현,18728,19021,37749
17437,20201223,수인분당선,야탑,20225,21143,41368
17438,20201223,수인분당선,모란,16008,15973,31981
17439,20201223,수인분당선,태평,10999,10774,21773
17440,20201223,수인분당선,가천대,5022,5796,10818
17441,20201223,수인분당선,선정릉,6536,6953,13489
17442,20201223,수인분당선,강남구청,7818,8851,16669
17443,20201223,수인분당선,압구정로데오,14243,15256,29499
17444,20201223,수인분당선,서울숲,6773,6737,13510
17445,20201223,수인분당선,수원,5985,4893,10878
17446,20201223,수인분당선,수서,9727,10209,19936
17447,20201223,수인분당선,대모산입구,2911,2709,5620
17448,20201223,수인분당선,개포동,2868,2988,5856
17449,20201223,수인분당선,구룡,1269,1331,2600
17450,20201223,수인분당선,도곡,5451,5464,10915
17451,20201223,수인분당선,한티,10341,11064,21405
17452,20201223,수인분당선,선릉,11315,16427,27742
17453,20201224,수인분당선,인천,846,1353,2199
17454,20201224,수인분당선,신포,1288,1380,2668
17455,20201224,수인분당선,숭의,3231,3010,6241
17456,20201224,수인분당선,인하대,4401,4169,8570
17457,20201224,수인분당선,송도,1973,1754,3727
17458,20201224,수인분당선,연수,3339,3327,6666
17459,20201224,수인분당선,원인재,3525,3595,7120
17460,20201224,수인분당선,남동인더스파크,2051,2242,4293
17461,20201224,수인분당선,호구포,3156,3235,6391
17462,20201224,수인분당선,인천논현,4233,4520,8753
17463,20201224,수인분당선,소래포구,3592,3584,7176
17464,20201224,수인분당선,월곶,2053,1949,4002
17465,20201224,수인분당선,달월,79,48,127
17466,20201224,수인분당선,사리,2740,2590,5330
17467,20201224,수인분당선,야목,157,137,294
17468,20201224,수인분당선,어천,505,426,931
17469,20201224,수인분당선,오목천,1639,1531,3170
17470,20201224,수인분당선,고색,2776,2565,5341
17471,20201224,수인분당선,매교,2250,2259,4509
17472,20201224,수인분당선,수원시청,9647,10858,20505
17473,20201224,수인분당선,매탄권선,3874,3621,7495
17474,20201224,수인분당선,망포,11772,10861,22633
17475,20201224,수인분당선,영통,6191,6510,12701
17476,20201224,수인분당선,청명,3141,3001,6142
17477,20201224,수인분당선,상갈,4054,3916,7970
17478,20201224,수인분당선,기흥,7300,7171,14471
17479,20201224,수인분당선,신갈,3344,3405,6749
17480,20201224,수인분당선,구성,3639,3946,7585
17481,20201224,수인분당선,죽전,10927,11719,22646
17482,20201224,수인분당선,보정,1745,1499,3244
17483,20201224,수인분당선,이매,3747,3612,7359
17484,20201224,수인분당선,오리,9411,7861,17272
17485,20201224,수인분당선,미금,12028,12913,24941
17486,20201224,수인분당선,정자,11930,12589,24519
17487,20201224,수인분당선,수내,10092,10093,20185
17488,20201224,수인분당선,서현,19327,19640,38967
17489,20201224,수인분당선,야탑,19999,21168,41167
17490,20201224,수인분당선,모란,17850,17941,35791
17491,20201224,수인분당선,태평,11162,11004,22166
17492,20201224,수인분당선,가천대,5022,5592,10614
17493,20201224,수인분당선,선정릉,6200,6685,12885
17494,20201224,수인분당선,강남구청,7365,8361,15726
17495,20201224,수인분당선,압구정로데오,15161,15932,31093
17496,20201224,수인분당선,서울숲,6664,6523,13187
17497,20201224,수인분당선,수원,6304,5365,11669
17498,20201224,수인분당선,수서,9427,10337,19764
17499,20201224,수인분당선,대모산입구,2842,2623,5465
17500,20201224,수인분당선,개포동,2876,3014,5890
17501,20201224,수인분당선,구룡,1305,1215,2520
17502,20201224,수인분당선,도곡,5257,5219,10476
17503,20201224,수인분당선,한티,10292,10734,21026
17504,20201224,수인분당선,선릉,10433,14839,25272
17505,20201225,수인분당선,사리,1455,1297,2752
17506,20201225,수인분당선,야목,92,89,181
17507,20201225,수인분당선,어천,274,243,517
17508,20201225,수인분당선,오목천,908,776,1684
17509,20201225,수인분당선,고색,1025,963,1988
17510,20201225,수인분당선,매교,972,969,1941
17511,20201225,수인분당선,수원시청,4889,5348,10237
17512,20201225,수인분당선,매탄권선,1609,1570,3179
17513,20201225,수인분당선,망포,4518,4136,8654
17514,20201225,수인분당선,영통,3307,3128,6435
17515,20201225,수인분당선,청명,1163,1170,2333
17516,20201225,수인분당선,상갈,1990,2016,4006
17517,20201225,수인분당선,기흥,3480,3397,6877
17518,20201225,수인분당선,신갈,1183,1226,2409
17519,20201225,수인분당선,구성,1478,1594,3072
17520,20201225,수인분당선,죽전,5491,6084,11575
17521,20201225,수인분당선,보정,679,596,1275
17522,20201225,수인분당선,이매,1552,1585,3137
17523,20201225,수인분당선,오리,3720,3154,6874
17524,20201225,수인분당선,미금,5108,5161,10269
17525,20201225,수인분당선,정자,4765,4853,9618
17526,20201225,수인분당선,수내,4249,3950,8199
17527,20201225,수인분당선,서현,9672,9485,19157
17528,20201225,수인분당선,야탑,7964,8630,16594
17529,20201225,수인분당선,모란,8560,8532,17092
17530,20201225,수인분당선,태평,5855,5731,11586
17531,20201225,수인분당선,가천대,2373,2634,5007
17532,20201225,수인분당선,선정릉,1404,1331,2735
17533,20201225,수인분당선,강남구청,1823,2122,3945
17534,20201225,수인분당선,압구정로데오,6699,7430,14129
17535,20201225,수인분당선,서울숲,2509,2441,4950
17536,20201225,수인분당선,수원,4211,3328,7539
17537,20201225,수인분당선,수서,3619,4587,8206
17538,20201225,수인분당선,대모산입구,1235,1125,2360
17539,20201225,수인분당선,개포동,985,1003,1988
17540,20201225,수인분당선,구룡,542,514,1056
17541,20201225,수인분당선,도곡,1638,1586,3224
17542,20201225,수인분당선,한티,4218,4177,8395
17543,20201225,수인분당선,선릉,2007,2713,4720
17544,20201225,수인분당선,인천,826,1270,2096
17545,20201225,수인분당선,신포,809,826,1635
17546,20201225,수인분당선,숭의,1505,1384,2889
17547,20201225,수인분당선,인하대,2277,2251,4528
17548,20201225,수인분당선,송도,1123,1103,2226
17549,20201225,수인분당선,연수,2020,2019,4039
17550,20201225,수인분당선,원인재,1923,2061,3984
17551,20201225,수인분당선,남동인더스파크,577,519,1096
17552,20201225,수인분당선,호구포,1390,1398,2788
17553,20201225,수인분당선,인천논현,2214,2299,4513
17554,20201225,수인분당선,소래포구,2999,3125,6124
17555,20201225,수인분당선,월곶,1240,1202,2442
17556,20201225,수인분당선,달월,36,38,74
17557,20201226,수인분당선,선릉,2807,3939,6746
17558,20201226,수인분당선,한티,5613,5705,11318
17559,20201226,수인분당선,도곡,2347,2196,4543
17560,20201226,수인분당선,구룡,662,638,1300
17561,20201226,수인분당선,개포동,1467,1455,2922
17562,20201226,수인분당선,대모산입구,1557,1445,3002
17563,20201226,수인분당선,수서,4663,4871,9534
17564,20201226,수인분당선,수원,4020,3332,7352
17565,20201226,수인분당선,서울숲,2900,2734,5634
17566,20201226,수인분당선,압구정로데오,8859,9504,18363
17567,20201226,수인분당선,강남구청,2660,3142,5802
17568,20201226,수인분당선,선정릉,1956,1897,3853
17569,20201226,수인분당선,가천대,2669,3124,5793
17570,20201226,수인분당선,태평,6913,6745,13658
17571,20201226,수인분당선,모란,9841,10046,19887
17572,20201226,수인분당선,야탑,9477,10083,19560
17573,20201226,수인분당선,서현,10517,10246,20763
17574,20201226,수인분당선,수내,5031,4937,9968
17575,20201226,수인분당선,정자,5805,5948,11753
17576,20201226,수인분당선,미금,6564,6803,13367
17577,20201226,수인분당선,오리,4636,3905,8541
17578,20201226,수인분당선,이매,1935,1921,3856
17579,20201226,수인분당선,보정,834,740,1574
17580,20201226,수인분당선,죽전,6998,7397,14395
17581,20201226,수인분당선,구성,1780,1849,3629
17582,20201226,수인분당선,신갈,1498,1512,3010
17583,20201226,수인분당선,기흥,3721,3623,7344
17584,20201226,수인분당선,사리,1561,1450,3011
17585,20201226,수인분당선,야목,94,74,168
17586,20201226,수인분당선,어천,279,259,538
17587,20201226,수인분당선,오목천,896,882,1778
17588,20201226,수인분당선,고색,1114,1174,2288
17589,20201226,수인분당선,매교,1129,1180,2309
17590,20201226,수인분당선,수원시청,5826,5537,11363
17591,20201226,수인분당선,매탄권선,1819,1758,3577
17592,20201226,수인분당선,망포,4711,4506,9217
17593,20201226,수인분당선,영통,3321,3354,6675
17594,20201226,수인분당선,청명,1379,1432,2811
17595,20201226,수인분당선,상갈,2164,2151,4315
17596,20201226,수인분당선,인천,711,1048,1759
17597,20201226,수인분당선,신포,880,880,1760
17598,20201226,수인분당선,숭의,1711,1548,3259
17599,20201226,수인분당선,인하대,2472,2311,4783
17600,20201226,수인분당선,송도,1241,1148,2389
17601,20201226,수인분당선,연수,2306,2289,4595
17602,20201226,수인분당선,원인재,2177,2285,4462
17603,20201226,수인분당선,남동인더스파크,621,616,1237
17604,20201226,수인분당선,호구포,1596,1471,3067
17605,20201226,수인분당선,인천논현,2617,2758,5375
17606,20201226,수인분당선,소래포구,3191,3180,6371
17607,20201226,수인분당선,월곶,1318,1238,2556
17608,20201226,수인분당선,달월,48,54,102
17609,20201227,수인분당선,인천,495,727,1222
17610,20201227,수인분당선,신포,615,614,1229
17611,20201227,수인분당선,숭의,1175,1052,2227
17612,20201227,수인분당선,인하대,1821,1768,3589
17613,20201227,수인분당선,송도,949,914,1863
17614,20201227,수인분당선,연수,1785,1687,3472
17615,20201227,수인분당선,원인재,1698,1668,3366
17616,20201227,수인분당선,남동인더스파크,373,396,769
17617,20201227,수인분당선,호구포,1150,1196,2346
17618,20201227,수인분당선,인천논현,1750,1792,3542
17619,20201227,수인분당선,소래포구,2661,2571,5232
17620,20201227,수인분당선,월곶,1030,956,1986
17621,20201227,수인분당선,달월,25,31,56
17622,20201227,수인분당선,사리,1246,1076,2322
17623,20201227,수인분당선,야목,83,84,167
17624,20201227,수인분당선,어천,228,301,529
17625,20201227,수인분당선,오목천,684,684,1368
17626,20201227,수인분당선,고색,806,896,1702
17627,20201227,수인분당선,매교,780,776,1556
17628,20201227,수인분당선,수원시청,3686,3550,7236
17629,20201227,수인분당선,매탄권선,1310,1260,2570
17630,20201227,수인분당선,망포,3306,3575,6881
17631,20201227,수인분당선,영통,2301,2366,4667
17632,20201227,수인분당선,청명,1039,1048,2087
17633,20201227,수인분당선,상갈,1588,1610,3198
17634,20201227,수인분당선,기흥,2730,2680,5410
17635,20201227,수인분당선,신갈,1065,1017,2082
17636,20201227,수인분당선,구성,1197,1295,2492
17637,20201227,수인분당선,죽전,5106,5151,10257
17638,20201227,수인분당선,보정,506,490,996
17639,20201227,수인분당선,이매,1372,1405,2777
17640,20201227,수인분당선,오리,3241,2917,6158
17641,20201227,수인분당선,미금,4038,4278,8316
17642,20201227,수인분당선,정자,3964,4129,8093
17643,20201227,수인분당선,수내,3548,3582,7130
17644,20201227,수인분당선,서현,7269,7180,14449
17645,20201227,수인분당선,야탑,7056,7341,14397
17646,20201227,수인분당선,모란,6705,6836,13541
17647,20201227,수인분당선,태평,4822,4612,9434
17648,20201227,수인분당선,가천대,2020,2483,4503
17649,20201227,수인분당선,선정릉,1120,1285,2405
17650,20201227,수인분당선,강남구청,1596,1925,3521
17651,20201227,수인분당선,압구정로데오,5167,5546,10713
17652,20201227,수인분당선,서울숲,2202,2113,4315
17653,20201227,수인분당선,수원,3201,2419,5620
17654,20201227,수인분당선,수서,4351,4120,8471
17655,20201227,수인분당선,대모산입구,945,862,1807
17656,20201227,수인분당선,개포동,921,946,1867
17657,20201227,수인분당선,구룡,334,388,722
17658,20201227,수인분당선,도곡,1314,1356,2670
17659,20201227,수인분당선,한티,3778,3933,7711
17660,20201227,수인분당선,선릉,1612,2267,3879
17661,20201228,수인분당선,선릉,10964,15976,26940
17662,20201228,수인분당선,한티,10053,10791,20844
17663,20201228,수인분당선,도곡,5057,5077,10134
17664,20201228,수인분당선,구룡,1193,1196,2389
17665,20201228,수인분당선,개포동,2805,2838,5643
17666,20201228,수인분당선,대모산입구,2806,2657,5463
17667,20201228,수인분당선,수서,9518,9869,19387
17668,20201228,수인분당선,수원,5806,4625,10431
17669,20201228,수인분당선,서울숲,6289,6316,12605
17670,20201228,수인분당선,압구정로데오,12550,13492,26042
17671,20201228,수인분당선,강남구청,7249,8259,15508
17672,20201228,수인분당선,선정릉,6212,6665,12877
17673,20201228,수인분당선,가천대,4965,5824,10789
17674,20201228,수인분당선,태평,10802,10595,21397
17675,20201228,수인분당선,모란,16020,16172,32192
17676,20201228,수인분당선,야탑,19335,20217,39552
17677,20201228,수인분당선,서현,18425,18474,36899
17678,20201228,수인분당선,수내,9965,9785,19750
17679,20201228,수인분당선,정자,11729,12381,24110
17680,20201228,수인분당선,미금,11894,12738,24632
17681,20201228,수인분당선,오리,9263,7954,17217
17682,20201228,수인분당선,이매,3814,3588,7402
17683,20201228,수인분당선,보정,1764,1553,3317
17684,20201228,수인분당선,죽전,9892,10884,20776
17685,20201228,수인분당선,구성,3663,3769,7432
17686,20201228,수인분당선,신갈,3510,3430,6940
17687,20201228,수인분당선,기흥,6930,6689,13619
17688,20201228,수인분당선,상갈,3861,3740,7601
17689,20201228,수인분당선,청명,3067,2984,6051
17690,20201228,수인분당선,영통,5773,5932,11705
17691,20201228,수인분당선,망포,10269,9937,20206
17692,20201228,수인분당선,매탄권선,3354,3253,6607
17693,20201228,수인분당선,수원시청,9096,9600,18696
17694,20201228,수인분당선,매교,2157,2130,4287
17695,20201228,수인분당선,고색,2619,2589,5208
17696,20201228,수인분당선,오목천,1633,1601,3234
17697,20201228,수인분당선,어천,412,427,839
17698,20201228,수인분당선,야목,158,132,290
17699,20201228,수인분당선,사리,2569,2481,5050
17700,20201228,수인분당선,달월,85,46,131
17701,20201228,수인분당선,월곶,1996,1870,3866
17702,20201228,수인분당선,소래포구,3670,3524,7194
17703,20201228,수인분당선,인천논현,4332,4504,8836
17704,20201228,수인분당선,호구포,3018,3219,6237
17705,20201228,수인분당선,남동인더스파크,1940,2248,4188
17706,20201228,수인분당선,원인재,3526,3456,6982
17707,20201228,수인분당선,연수,3467,3349,6816
17708,20201228,수인분당선,송도,2073,1870,3943
17709,20201228,수인분당선,인하대,4262,3984,8246
17710,20201228,수인분당선,숭의,3233,3053,6286
17711,20201228,수인분당선,신포,1378,1321,2699
17712,20201228,수인분당선,인천,780,1260,2040
17713,20201228,수인분당선,복정,1,0,1
17714,20201229,수인분당선,인천,685,1163,1848
17715,20201229,수인분당선,신포,1285,1259,2544
17716,20201229,수인분당선,숭의,3203,2999,6202
17717,20201229,수인분당선,인하대,4079,3909,7988
17718,20201229,수인분당선,송도,1948,1756,3704
17719,20201229,수인분당선,연수,3302,3250,6552
17720,20201229,수인분당선,원인재,3375,3471,6846
17721,20201229,수인분당선,남동인더스파크,2028,2273,4301
17722,20201229,수인분당선,호구포,3010,3163,6173
17723,20201229,수인분당선,인천논현,4218,4407,8625
17724,20201229,수인분당선,소래포구,3538,3350,6888
17725,20201229,수인분당선,월곶,1902,1846,3748
17726,20201229,수인분당선,달월,95,57,152
17727,20201229,수인분당선,사리,2553,2466,5019
17728,20201229,수인분당선,야목,159,132,291
17729,20201229,수인분당선,어천,426,398,824
17730,20201229,수인분당선,오목천,1566,1546,3112
17731,20201229,수인분당선,고색,2626,2543,5169
17732,20201229,수인분당선,매교,2113,2235,4348
17733,20201229,수인분당선,수원시청,9063,9488,18551
17734,20201229,수인분당선,매탄권선,3356,3263,6619
17735,20201229,수인분당선,망포,10403,10029,20432
17736,20201229,수인분당선,영통,5675,5782,11457
17737,20201229,수인분당선,청명,3075,2989,6064
17738,20201229,수인분당선,상갈,3994,3890,7884
17739,20201229,수인분당선,기흥,6894,6620,13514
17740,20201229,수인분당선,신갈,3474,3384,6858
17741,20201229,수인분당선,구성,3586,3830,7416
17742,20201229,수인분당선,죽전,10050,10884,20934
17743,20201229,수인분당선,보정,1717,1511,3228
17744,20201229,수인분당선,이매,3856,3725,7581
17745,20201229,수인분당선,오리,9349,7862,17211
17746,20201229,수인분당선,미금,12019,12728,24747
17747,20201229,수인분당선,정자,11954,12630,24584
17748,20201229,수인분당선,수내,10039,9973,20012
17749,20201229,수인분당선,서현,18482,18756,37238
17750,20201229,수인분당선,야탑,19651,20477,40128
17751,20201229,수인분당선,모란,17415,17821,35236
17752,20201229,수인분당선,태평,10895,10743,21638
17753,20201229,수인분당선,가천대,9689,9989,19678
17754,20201229,수인분당선,선정릉,6441,6867,13308
17755,20201229,수인분당선,강남구청,7409,8510,15919
17756,20201229,수인분당선,압구정로데오,13893,14820,28713
17757,20201229,수인분당선,서울숲,6407,6455,12862
17758,20201229,수인분당선,수원,5755,4646,10401
17759,20201229,수인분당선,수서,9469,10040,19509
17760,20201229,수인분당선,대모산입구,2900,2731,5631
17761,20201229,수인분당선,개포동,2839,2894,5733
17762,20201229,수인분당선,구룡,1234,1257,2491
17763,20201229,수인분당선,도곡,4999,4890,9889
17764,20201229,수인분당선,한티,10309,10995,21304
17765,20201229,수인분당선,선릉,11037,15911,26948
17766,20201230,수인분당선,인천,695,1118,1813
17767,20201230,수인분당선,신포,1159,1130,2289
17768,20201230,수인분당선,숭의,2847,2759,5606
17769,20201230,수인분당선,인하대,3907,3655,7562
17770,20201230,수인분당선,송도,1786,1559,3345
17771,20201230,수인분당선,연수,3082,3063,6145
17772,20201230,수인분당선,원인재,3169,3208,6377
17773,20201230,수인분당선,남동인더스파크,1811,2033,3844
17774,20201230,수인분당선,호구포,2889,3022,5911
17775,20201230,수인분당선,인천논현,3903,4119,8022
17776,20201230,수인분당선,소래포구,2898,2841,5739
17777,20201230,수인분당선,월곶,1713,1600,3313
17778,20201230,수인분당선,달월,65,45,110
17779,20201230,수인분당선,사리,2382,2241,4623
17780,20201230,수인분당선,야목,125,99,224
17781,20201230,수인분당선,수원시청,8786,9268,18054
17782,20201230,수인분당선,매탄권선,3310,3140,6450
17783,20201230,수인분당선,망포,9888,9530,19418
17784,20201230,수인분당선,영통,5536,5666,11202
17785,20201230,수인분당선,청명,3002,2785,5787
17786,20201230,수인분당선,상갈,3694,3602,7296
17787,20201230,수인분당선,기흥,6739,6452,13191
17788,20201230,수인분당선,신갈,3143,3184,6327
17789,20201230,수인분당선,구성,3314,3462,6776
17790,20201230,수인분당선,죽전,9484,10331,19815
17791,20201230,수인분당선,보정,1630,1348,2978
17792,20201230,수인분당선,이매,3741,3528,7269
17793,20201230,수인분당선,오리,8743,7443,16186
17794,20201230,수인분당선,미금,11255,12056,23311
17795,20201230,수인분당선,정자,11342,11963,23305
17796,20201230,수인분당선,수내,9528,9658,19186
17797,20201230,수인분당선,서현,18036,18052,36088
17798,20201230,수인분당선,야탑,18579,19282,37861
17799,20201230,수인분당선,모란,14917,14729,29646
17800,20201230,수인분당선,태평,10232,10100,20332
17801,20201230,수인분당선,가천대,4906,5613,10519
17802,20201230,수인분당선,선정릉,6178,6514,12692
17803,20201230,수인분당선,강남구청,7084,8073,15157
17804,20201230,수인분당선,압구정로데오,13553,14221,27774
17805,20201230,수인분당선,서울숲,6004,6052,12056
17806,20201230,수인분당선,수원,5586,4581,10167
17807,20201230,수인분당선,수서,9083,9689,18772
17808,20201230,수인분당선,대모산입구,2617,2490,5107
17809,20201230,수인분당선,개포동,2658,2810,5468
17810,20201230,수인분당선,구룡,1392,1370,2762
17811,20201230,수인분당선,도곡,4625,4635,9260
17812,20201230,수인분당선,한티,10186,10762,20948
17813,20201230,수인분당선,선릉,10383,15055,25438
17814,20201230,수인분당선,어천,400,352,752
17815,20201230,수인분당선,오목천,1487,1462,2949
17816,20201230,수인분당선,고색,2451,2424,4875
17817,20201230,수인분당선,매교,1856,1907,3763
17818,20201231,수인분당선,인천,718,1197,1915
17819,20201231,수인분당선,신포,1243,1309,2552
17820,20201231,수인분당선,숭의,2841,2721,5562
17821,20201231,수인분당선,인하대,3789,3591,7380
17822,20201231,수인분당선,송도,1644,1605,3249
17823,20201231,수인분당선,연수,3051,3145,6196
17824,20201231,수인분당선,원인재,3311,3332,6643
17825,20201231,수인분당선,남동인더스파크,1558,1794,3352
17826,20201231,수인분당선,호구포,2884,2861,5745
17827,20201231,수인분당선,인천논현,3882,4132,8014
17828,20201231,수인분당선,소래포구,3095,3289,6384
17829,20201231,수인분당선,월곶,1782,1703,3485
17830,20201231,수인분당선,달월,84,59,143
17831,20201231,수인분당선,사리,2447,2184,4631
17832,20201231,수인분당선,야목,125,106,231
17833,20201231,수인분당선,어천,494,380,874
17834,20201231,수인분당선,오목천,1486,1314,2800
17835,20201231,수인분당선,고색,2226,2093,4319
17836,20201231,수인분당선,매교,1842,1840,3682
17837,20201231,수인분당선,수원시청,8691,9397,18088
17838,20201231,수인분당선,매탄권선,3379,3090,6469
17839,20201231,수인분당선,망포,9713,8813,18526
17840,20201231,수인분당선,영통,5624,5599,11223
17841,20201231,수인분당선,청명,2790,2594,5384
17842,20201231,수인분당선,상갈,3516,3364,6880
17843,20201231,수인분당선,기흥,6322,6016,12338
17844,20201231,수인분당선,신갈,2990,2985,5975
17845,20201231,수인분당선,구성,3073,3284,6357
17846,20201231,수인분당선,죽전,9370,10106,19476
17847,20201231,수인분당선,보정,1468,1278,2746
17848,20201231,수인분당선,이매,3538,3434,6972
17849,20201231,수인분당선,오리,7987,6725,14712
17850,20201231,수인분당선,미금,10753,11335,22088
17851,20201231,수인분당선,정자,10359,10798,21157
17852,20201231,수인분당선,수내,8836,8753,17589
17853,20201231,수인분당선,서현,17501,17709,35210
17854,20201231,수인분당선,야탑,17417,18826,36243
17855,20201231,수인분당선,모란,14683,14626,29309
17856,20201231,수인분당선,태평,10533,10483,21016
17857,20201231,수인분당선,가천대,4716,5102,9818
17858,20201231,수인분당선,선정릉,4996,5164,10160
17859,20201231,수인분당선,강남구청,6213,6908,13121
17860,20201231,수인분당선,압구정로데오,12774,13350,26124
17861,20201231,수인분당선,서울숲,5318,5369,10687
17862,20201231,수인분당선,수원,5947,4982,10929
17863,20201231,수인분당선,수서,8235,9266,17501
17864,20201231,수인분당선,대모산입구,2444,2241,4685
17865,20201231,수인분당선,개포동,2552,2617,5169
17866,20201231,수인분당선,구룡,1396,1277,2673
17867,20201231,수인분당선,도곡,4368,4330,8698
17868,20201231,수인분당선,한티,9500,9977,19477
17869,20201231,수인분당선,선릉,8891,12702,21593
