사용월,호선명,지하철역,승차총승객수,하차총승객수,승하차총승객수
202201,3호선,가락시장,2769,2734,5503
202201,3호선,경복궁,7916,8217,16133
202201,3호선,경찰병원,2071,2017,4088
202201,3호선,고속터미널,21392,21318,42710
202201,3호선,교대,2419,1533,3952
202201,3호선,구파발,8761,9006,17767
202201,3호선,금호,2920,2819,5739
202201,3호선,남부터미널,8813,8988,17801
202201,3호선,녹번,5319,4904,10223
202201,3호선,대청,3224,2903,6127
202201,3호선,대치,4906,5067,9973
202201,3호선,도곡,1330,1263,2593
202201,3호선,독립문,3120,3377,6497
202201,3호선,동대입구,3319,3865,7184
202201,3호선,매봉,2829,2774,5603
202201,3호선,무악재,1416,1550,2966
202201,3호선,불광,7261,8298,15559
202201,3호선,수서,7370,7076,14446
202201,3호선,신사,9269,9133,18402
202201,3호선,안국,6901,7218,14119
202201,3호선,압구정,7726,7982,15708
202201,3호선,약수,4669,4528,9197
202201,3호선,양재,8646,9105,17751
202201,3호선,연신내,16671,15993,32664
202201,3호선,오금,1789,1782,3571
202201,3호선,옥수,3543,3641,7184
202201,3호선,을지로3가,2345,2163,4508
202201,3호선,일원,3321,2803,6124
202201,3호선,잠원,1488,1587,3075
202201,3호선,종로3가,3034,4181,7215
202201,3호선,지축,1580,1532,3112
202201,3호선,학여울,461,473,934
202201,3호선,홍제,7002,6640,13642
202201,3호선,가락시장,3140,3412,6552
202201,3호선,경복궁,8101,8467,16568
202201,3호선,경찰병원,2186,2420,4606
202201,3호선,고속터미널,39814,30429,70243
202201,3호선,교대,3241,2139,5380
202201,3호선,구파발,9439,9582,19021
202201,3호선,금호,3556,3472,7028
202201,3호선,남부터미널,12278,11483,23761
202201,3호선,녹번,6065,5509,11574
202201,3호선,대청,3550,3577,7127
202201,3호선,대치,5248,4598,9846
202201,3호선,도곡,1612,1769,3381
202201,3호선,독립문,3143,3493,6636
202201,3호선,동대입구,4375,4970,9345
202201,3호선,매봉,3436,3470,6906
202201,3호선,무악재,1462,1663,3125
202201,3호선,불광,8004,9452,17456
202201,3호선,수서,9629,8463,18092
202201,3호선,신사,11108,10958,22066
202201,3호선,안국,7682,8406,16088
202201,3호선,압구정,11469,12084,23553
202201,3호선,약수,5491,5522,11013
202201,3호선,양재,10604,12674,23278
202201,3호선,연신내,18040,17330,35370
202201,3호선,오금,2220,2222,4442
202201,3호선,옥수,3919,4299,8218
202201,3호선,을지로3가,2519,2382,4901
202201,3호선,일원,2936,3181,6117
202201,3호선,잠원,1948,2075,4023
202201,3호선,종로3가,3043,3936,6979
202201,3호선,지축,1728,1656,3384
202201,3호선,충무로,1,0,1
202201,3호선,학여울,657,704,1361
202201,3호선,홍제,7597,7319,14916
202201,3호선,가락시장,5686,5406,11092
202201,3호선,경복궁,13627,14089,27716
202201,3호선,경찰병원,3702,3694,7396
202201,3호선,고속터미널,43388,43336,86724
202201,3호선,교대,6247,3750,9997
202201,3호선,구파발,13854,13754,27608
202201,3호선,금호,5400,4991,10391
202201,3호선,남부터미널,18153,18159,36312
202201,3호선,녹번,9803,8544,18347
202201,3호선,대청,5745,5252,10997
202201,3호선,대치,9216,8229,17445
202201,3호선,도곡,3297,3180,6477
202201,3호선,독립문,5083,5383,10466
202201,3호선,동대입구,6877,7366,14243
202201,3호선,매봉,5589,5321,10910
202201,3호선,무악재,2492,2575,5067
202201,3호선,불광,11957,13323,25280
202201,3호선,수서,12241,12373,24614
202201,3호선,신사,26065,26724,52789
202201,3호선,안국,13133,14633,27766
202201,3호선,압구정,24711,25484,50195
202201,3호선,약수,8464,7981,16445
202201,3호선,양재,19763,20996,40759
202201,3호선,연신내,26820,25471,52291
202201,3호선,오금,3515,3305,6820
202201,3호선,옥수,6218,6444,12662
202201,3호선,을지로3가,4731,4880,9611
202201,3호선,일원,5492,5496,10988
202201,3호선,잠원,3009,2862,5871
202201,3호선,종로3가,5607,7684,13291
202201,3호선,지축,2929,2840,5769
202201,3호선,충무로,1,0,1
202201,3호선,학여울,1064,994,2058
202201,3호선,홍제,12055,11444,23499
202201,3호선,가락시장,3194,3465,6659
202201,3호선,경복궁,9803,9922,19725
202201,3호선,경찰병원,2427,2608,5035
202201,3호선,고속터미널,34914,32930,67844
202201,3호선,교대,3810,2497,6307
202201,3호선,구파발,9760,9964,19724
202201,3호선,금호,3828,3653,7481
202201,3호선,남부터미널,12426,12988,25414
202201,3호선,녹번,6603,5989,12592
202201,3호선,대청,3760,3656,7416
202201,3호선,대치,5616,4901,10517
202201,3호선,도곡,1773,1860,3633
202201,3호선,독립문,3490,3788,7278
202201,3호선,동대입구,5017,5428,10445
202201,3호선,매봉,3678,3711,7389
202201,3호선,무악재,1687,1770,3457
202201,3호선,불광,8789,9915,18704
202201,3호선,수서,9360,9102,18462
202201,3호선,신사,13825,13662,27487
202201,3호선,안국,9019,9571,18590
202201,3호선,압구정,12761,13013,25774
202201,3호선,약수,6121,5787,11908
202201,3호선,양재,12417,14163,26580
202201,3호선,연신내,19331,18628,37959
202201,3호선,오금,2389,2432,4821
202201,3호선,옥수,4279,4395,8674
202201,3호선,을지로3가,3085,2812,5897
202201,3호선,일원,3067,3179,6246
202201,3호선,잠원,1877,1929,3806
202201,3호선,종로3가,3612,4578,8190
202201,3호선,지축,1892,1802,3694
202201,3호선,학여울,850,890,1740
202201,3호선,홍제,8143,7969,16112
202201,3호선,가락시장,5913,5567,11480
202201,3호선,경복궁,13608,14005,27613
202201,3호선,경찰병원,3741,3674,7415
202201,3호선,고속터미널,44642,44580,89222
202201,3호선,교대,6413,3843,10256
202201,3호선,구파발,13360,13487,26847
202201,3호선,금호,5611,5167,10778
202201,3호선,남부터미널,19606,19365,38971
202201,3호선,녹번,9627,8563,18190
202201,3호선,대청,5718,5306,11024
202201,3호선,대치,9057,8089,17146
202201,3호선,도곡,3167,3110,6277
202201,3호선,독립문,5022,5244,10266
202201,3호선,동대입구,5877,6470,12347
202201,3호선,매봉,5918,5708,11626
202201,3호선,무악재,2519,2596,5115
202201,3호선,불광,11890,13216,25106
202201,3호선,수서,12457,12341,24798
202201,3호선,신사,26405,26857,53262
202201,3호선,안국,13542,15067,28609
202201,3호선,압구정,24607,25694,50301
202201,3호선,약수,8420,7913,16333
202201,3호선,양재,20857,22192,43049
202201,3호선,연신내,27329,26090,53419
202201,3호선,오금,3514,3217,6731
202201,3호선,옥수,6230,6417,12647
202201,3호선,을지로3가,4766,5130,9896
202201,3호선,일원,5260,5159,10419
202201,3호선,잠원,3171,3023,6194
202201,3호선,종로3가,5727,7692,13419
202201,3호선,지축,2770,2693,5463
202201,3호선,충무로,1,0,1
202201,3호선,학여울,2724,2230,4954
202201,3호선,홍제,12108,11426,23534
202201,3호선,가락시장,3489,3707,7196
202201,3호선,경복궁,10255,10288,20543
202201,3호선,경찰병원,2464,2644,5108
202201,3호선,고속터미널,36869,35095,71964
202201,3호선,교대,3981,2437,6418
202201,3호선,구파발,10103,10215,20318
202201,3호선,금호,3948,3764,7712
202201,3호선,남부터미널,12275,13044,25319
202201,3호선,녹번,6804,6089,12893
202201,3호선,대청,3834,3889,7723
202201,3호선,대치,5751,5144,10895
202201,3호선,도곡,1806,1915,3721
202201,3호선,독립문,3586,4000,7586
202201,3호선,동대입구,4133,4483,8616
202201,3호선,매봉,3805,3844,7649
202201,3호선,무악재,1657,1852,3509
202201,3호선,불광,8956,10245,19201
202201,3호선,수서,9819,9719,19538
202201,3호선,신사,14404,14289,28693
202201,3호선,안국,10047,10583,20630
202201,3호선,압구정,13200,13575,26775
202201,3호선,약수,6182,5949,12131
202201,3호선,양재,13819,15634,29453
202201,3호선,연신내,19348,18417,37765
202201,3호선,오금,2498,2439,4937
202201,3호선,옥수,4285,4732,9017
202201,3호선,을지로3가,3085,2919,6004
202201,3호선,일원,2979,3070,6049
202201,3호선,잠원,1919,1969,3888
202201,3호선,종로3가,3643,4792,8435
202201,3호선,지축,1962,1876,3838
202201,3호선,학여울,1796,1882,3678
202201,3호선,홍제,8379,8093,16472
202201,3호선,가락시장,6198,6036,12234
202201,3호선,경복궁,14239,14525,28764
202201,3호선,경찰병원,3813,3768,7581
202201,3호선,고속터미널,45305,44716,90021
202201,3호선,교대,6662,4097,10759
202201,3호선,구파발,14234,14081,28315
202201,3호선,금호,5641,5177,10818
202201,3호선,남부터미널,19006,18898,37904
202201,3호선,녹번,9935,8739,18674
202201,3호선,대청,5946,5503,11449
202201,3호선,대치,9186,8182,17368
202201,3호선,도곡,3175,3129,6304
202201,3호선,독립문,5229,5505,10734
202201,3호선,동대입구,5025,5846,10871
202201,3호선,매봉,6043,5836,11879
202201,3호선,무악재,2605,2742,5347
202201,3호선,불광,12123,13521,25644
202201,3호선,수서,12795,12885,25680
202201,3호선,신사,26640,27191,53831
202201,3호선,안국,14062,15719,29781
202201,3호선,압구정,25367,26391,51758
202201,3호선,약수,8733,8256,16989
202201,3호선,양재,20969,22200,43169
202201,3호선,연신내,28532,26881,55413
202201,3호선,오금,3643,3387,7030
202201,3호선,옥수,6369,6608,12977
202201,3호선,을지로3가,4954,5258,10212
202201,3호선,일원,4658,4646,9304
202201,3호선,잠원,3380,3224,6604
202201,3호선,종로3가,5836,7936,13772
202201,3호선,지축,2797,2738,5535
202201,3호선,충무로,1,0,1
202201,3호선,학여울,990,1017,2007
202201,3호선,홍제,12473,11799,24272
202201,3호선,가락시장,3486,3784,7270
202201,3호선,경복궁,10498,10934,21432
202201,3호선,경찰병원,2581,2625,5206
202201,3호선,고속터미널,35272,33988,69260
202201,3호선,교대,3884,2440,6324
202201,3호선,구파발,10154,10398,20552
202201,3호선,금호,3877,3774,7651
202201,3호선,남부터미널,12985,13839,26824
202201,3호선,녹번,6857,6212,13069
202201,3호선,대청,3779,3804,7583
202201,3호선,대치,5816,5196,11012
202201,3호선,도곡,1805,1941,3746
202201,3호선,독립문,3872,4224,8096
202201,3호선,동대입구,4240,4734,8974
202201,3호선,매봉,3836,3802,7638
202201,3호선,무악재,1733,1842,3575
202201,3호선,불광,9134,10491,19625
202201,3호선,수서,9714,9555,19269
202201,3호선,신사,14532,14174,28706
202201,3호선,안국,10196,10985,21181
202201,3호선,압구정,13214,13846,27060
202201,3호선,약수,6292,5955,12247
202201,3호선,양재,12886,14805,27691
202201,3호선,연신내,19954,19091,39045
202201,3호선,오금,2463,2419,4882
202201,3호선,옥수,4392,4714,9106
202201,3호선,을지로3가,3116,2743,5859
202201,3호선,일원,2922,3181,6103
202201,3호선,잠원,1975,2027,4002
202201,3호선,종로3가,3698,4843,8541
202201,3호선,지축,1908,1897,3805
202201,3호선,충무로,1,0,1
202201,3호선,학여울,890,886,1776
202201,3호선,홍제,8685,8281,16966
202201,3호선,가락시장,5398,5256,10654
202201,3호선,경복궁,11309,11290,22599
202201,3호선,경찰병원,3295,2970,6265
202201,3호선,고속터미널,35794,56093,91887
202201,3호선,교대,4990,2924,7914
202201,3호선,구파발,12453,12285,24738
202201,3호선,금호,4943,4429,9372
202201,3호선,남부터미널,15713,19877,35590
202201,3호선,녹번,8635,7400,16035
202201,3호선,대청,4907,4473,9380
202201,3호선,대치,8329,7482,15811
202201,3호선,도곡,2467,2447,4914
202201,3호선,독립문,4501,4655,9156
202201,3호선,동대입구,5361,5733,11094
202201,3호선,매봉,4755,4466,9221
202201,3호선,무악재,2202,2187,4389
202201,3호선,불광,11100,12101,23201
202201,3호선,수서,8542,9570,18112
202201,3호선,신사,19733,20281,40014
202201,3호선,안국,10345,11421,21766
202201,3호선,압구정,21122,22140,43262
202201,3호선,약수,7452,6776,14228
202201,3호선,양재,15150,15569,30719
202201,3호선,연신내,25391,23455,48846
202201,3호선,오금,2959,2657,5616
202201,3호선,옥수,5440,5597,11037
202201,3호선,을지로3가,3583,3596,7179
202201,3호선,일원,3823,3726,7549
202201,3호선,잠원,2476,2428,4904
202201,3호선,종로3가,4459,5985,10444
202201,3호선,지축,2371,2322,4693
202201,3호선,충무로,1,0,1
202201,3호선,학여울,855,830,1685
202201,3호선,홍제,11148,10185,21333
202201,3호선,가락시장,3662,3360,7022
202201,3호선,경복궁,8624,8860,17484
202201,3호선,경찰병원,2204,2112,4316
202201,3호선,고속터미널,26728,42041,68769
202201,3호선,교대,2823,1622,4445
202201,3호선,구파발,9092,8868,17960
202201,3호선,금호,3557,3237,6794
202201,3호선,남부터미널,9973,13520,23493
202201,3호선,녹번,6083,5307,11390
202201,3호선,대청,3511,3209,6720
202201,3호선,대치,5352,4554,9906
202201,3호선,도곡,1538,1532,3070
202201,3호선,독립문,3442,3606,7048
202201,3호선,동대입구,3437,3613,7050
202201,3호선,매봉,3105,2926,6031
202201,3호선,무악재,1602,1625,3227
202201,3호선,불광,8116,8847,16963
202201,3호선,수서,6363,7379,13742
202201,3호선,신사,10893,10966,21859
202201,3호선,안국,7915,8658,16573
202201,3호선,압구정,12216,12534,24750
202201,3호선,약수,5502,4986,10488
202201,3호선,양재,9659,10219,19878
202201,3호선,연신내,18496,17208,35704
202201,3호선,오금,2147,2033,4180
202201,3호선,옥수,3803,3873,7676
202201,3호선,을지로3가,2393,2206,4599
202201,3호선,일원,2674,2695,5369
202201,3호선,잠원,1684,1736,3420
202201,3호선,종로3가,2858,3793,6651
202201,3호선,지축,1708,1691,3399
202201,3호선,학여울,679,653,1332
202201,3호선,홍제,7799,7303,15102
202202,3호선,가락시장,4853,4616,9469
202202,3호선,경복궁,11914,11997,23911
202202,3호선,경찰병원,3317,3242,6559
202202,3호선,고속터미널,38852,36716,75568
202202,3호선,교대,5623,3359,8982
202202,3호선,구파발,12209,12248,24457
202202,3호선,금호,4833,4552,9385
202202,3호선,남부터미널,16814,16489,33303
202202,3호선,녹번,8618,7598,16216
202202,3호선,대청,4907,4599,9506
202202,3호선,대치,8419,7676,16095
202202,3호선,도곡,2582,2552,5134
202202,3호선,독립문,4334,4543,8877
202202,3호선,동대입구,5237,5651,10888
202202,3호선,매봉,5073,4930,10003
202202,3호선,무악재,2166,2310,4476
202202,3호선,불광,10617,11859,22476
202202,3호선,수서,10895,10547,21442
202202,3호선,신사,22001,22330,44331
202202,3호선,안국,11199,12179,23378
202202,3호선,압구정,22962,23596,46558
202202,3호선,약수,7711,7247,14958
202202,3호선,양재,17288,18618,35906
202202,3호선,연신내,24102,23158,47260
202202,3호선,오금,2930,2871,5801
202202,3호선,옥수,5450,5758,11208
202202,3호선,을지로3가,4150,4255,8405
202202,3호선,일원,3957,4039,7996
202202,3호선,잠원,2611,2574,5185
202202,3호선,종로3가,5114,6407,11521
202202,3호선,지축,2386,2336,4722
202202,3호선,충무로,1,0,1
202202,3호선,학여울,1181,1222,2403
202202,3호선,홍제,10749,10324,21073
202202,3호선,가락시장,2952,3227,6179
202202,3호선,경복궁,8619,8675,17294
202202,3호선,경찰병원,2223,2295,4518
202202,3호선,고속터미널,29931,28013,57944
202202,3호선,교대,3451,2310,5761
202202,3호선,구파발,8962,9265,18227
202202,3호선,금호,3554,3504,7058
202202,3호선,남부터미널,10646,10967,21613
202202,3호선,녹번,5974,5511,11485
202202,3호선,대청,3514,3450,6964
202202,3호선,대치,5255,4618,9873
202202,3호선,도곡,1614,1698,3312
202202,3호선,독립문,3650,3905,7555
202202,3호선,동대입구,4085,4480,8565
202202,3호선,매봉,3471,3401,6872
202202,3호선,무악재,1443,1588,3031
202202,3호선,불광,7987,9005,16992
202202,3호선,수서,8564,8063,16627
202202,3호선,신사,11460,11624,23084
202202,3호선,안국,7774,8265,16039
202202,3호선,압구정,11938,12180,24118
202202,3호선,약수,5497,5241,10738
202202,3호선,양재,10879,12526,23405
202202,3호선,연신내,17576,16692,34268
202202,3호선,오금,2133,2128,4261
202202,3호선,옥수,3778,4125,7903
202202,3호선,을지로3가,2518,2393,4911
202202,3호선,일원,2841,3048,5889
202202,3호선,잠원,1672,1804,3476
202202,3호선,종로3가,3117,3857,6974
202202,3호선,지축,1667,1613,3280
202202,3호선,학여울,733,758,1491
202202,3호선,홍제,7545,7247,14792
202202,3호선,가락시장,5443,5058,10501
202202,3호선,경복궁,13616,14071,27687
202202,3호선,경찰병원,3535,3494,7029
202202,3호선,고속터미널,40908,40316,81224
202202,3호선,교대,6204,3711,9915
202202,3호선,구파발,13293,13198,26491
202202,3호선,금호,5287,4890,10177
202202,3호선,남부터미널,18481,18182,36663
202202,3호선,녹번,9234,8110,17344
202202,3호선,대청,5482,5076,10558
202202,3호선,대치,8659,7809,16468
202202,3호선,도곡,3106,3107,6213
202202,3호선,독립문,5048,5362,10410
202202,3호선,동대입구,6308,6810,13118
202202,3호선,매봉,5807,5588,11395
202202,3호선,무악재,2384,2538,4922
202202,3호선,불광,11681,13247,24928
202202,3호선,수서,11683,12053,23736
202202,3호선,신사,24743,25282,50025
202202,3호선,안국,12941,14302,27243
202202,3호선,압구정,23662,24654,48316
202202,3호선,약수,8358,7712,16070
202202,3호선,양재,19240,20522,39762
202202,3호선,연신내,26618,25342,51960
202202,3호선,오금,3432,3318,6750
202202,3호선,옥수,6115,6188,12303
202202,3호선,을지로3가,4457,4626,9083
202202,3호선,일원,5639,5393,11032
202202,3호선,잠원,2903,2800,5703
202202,3호선,종로3가,5192,6884,12076
202202,3호선,지축,2778,2615,5393
202202,3호선,학여울,2705,2924,5629
202202,3호선,홍제,11977,11399,23376
202202,3호선,가락시장,3210,3309,6519
202202,3호선,경복궁,10114,10206,20320
202202,3호선,경찰병원,2376,2471,4847
202202,3호선,고속터미널,32390,30857,63247
202202,3호선,교대,3650,2168,5818
202202,3호선,구파발,9472,9634,19106
202202,3호선,금호,3801,3721,7522
202202,3호선,남부터미널,12287,13054,25341
202202,3호선,녹번,6327,5749,12076
202202,3호선,대청,3660,3619,7279
202202,3호선,대치,5473,4773,10246
202202,3호선,도곡,1634,1776,3410
202202,3호선,독립문,3807,4119,7926
202202,3호선,동대입구,4096,4562,8658
202202,3호선,매봉,3631,3609,7240
202202,3호선,무악재,1549,1800,3349
202202,3호선,불광,8406,9844,18250
202202,3호선,수서,9144,8920,18064
202202,3호선,신사,13128,13070,26198
202202,3호선,안국,9199,9883,19082
202202,3호선,압구정,12690,12963,25653
202202,3호선,약수,6006,5753,11759
202202,3호선,양재,12212,13787,25999
202202,3호선,연신내,19125,18043,37168
202202,3호선,오금,2381,2393,4774
202202,3호선,옥수,4262,4547,8809
202202,3호선,을지로3가,2687,2458,5145
202202,3호선,일원,2914,3058,5972
202202,3호선,잠원,1875,1904,3779
202202,3호선,종로3가,3462,4464,7926
202202,3호선,지축,1943,1825,3768
202202,3호선,충무로,3,0,3
202202,3호선,학여울,2321,2446,4767
202202,3호선,홍제,8273,7887,16160
202202,3호선,가락시장,5398,5007,10405
202202,3호선,경복궁,13505,13793,27298
202202,3호선,경찰병원,3546,3471,7017
202202,3호선,고속터미널,39193,39028,78221
202202,3호선,교대,5959,3597,9556
202202,3호선,구파발,12706,12664,25370
202202,3호선,금호,5084,4779,9863
202202,3호선,남부터미널,18024,17946,35970
202202,3호선,녹번,9165,8105,17270
202202,3호선,대청,5424,4995,10419
202202,3호선,대치,8708,7933,16641
202202,3호선,도곡,2859,3222,6081
202202,3호선,독립문,4979,5181,10160
202202,3호선,동대입구,4815,5348,10163
202202,3호선,매봉,5708,5491,11199
202202,3호선,무악재,2319,2583,4902
202202,3호선,불광,11594,12854,24448
202202,3호선,수서,11740,11896,23636
202202,3호선,신사,23233,23686,46919
202202,3호선,안국,12525,13274,25799
202202,3호선,압구정,23232,24035,47267
202202,3호선,약수,8014,7616,15630
202202,3호선,양재,19316,20422,39738
202202,3호선,연신내,25761,24287,50048
202202,3호선,오금,3472,3329,6801
202202,3호선,옥수,5741,6124,11865
202202,3호선,을지로3가,4402,4588,8990
202202,3호선,일원,4704,4664,9368
202202,3호선,잠원,3132,3012,6144
202202,3호선,종로3가,5341,6895,12236
202202,3호선,지축,2655,2571,5226
202202,3호선,충무로,2,0,2
202202,3호선,학여울,2046,2028,4074
202202,3호선,홍제,11975,11497,23472
202202,3호선,가락시장,3143,3299,6442
202202,3호선,경복궁,9251,9222,18473
202202,3호선,경찰병원,2238,2378,4616
202202,3호선,고속터미널,31301,29308,60609
202202,3호선,교대,3615,2273,5888
202202,3호선,구파발,9050,9333,18383
202202,3호선,금호,3501,3425,6926
202202,3호선,남부터미널,11625,12172,23797
202202,3호선,녹번,6109,5544,11653
202202,3호선,대청,3579,3506,7085
202202,3호선,대치,5295,4671,9966
202202,3호선,도곡,1664,1813,3477
202202,3호선,독립문,3455,3616,7071
202202,3호선,동대입구,3939,4188,8127
202202,3호선,매봉,3488,3518,7006
202202,3호선,무악재,1521,1708,3229
202202,3호선,불광,8162,9232,17394
202202,3호선,수서,9076,8879,17955
202202,3호선,신사,12537,12504,25041
202202,3호선,안국,8295,8757,17052
202202,3호선,압구정,12680,13024,25704
202202,3호선,약수,5661,5446,11107
202202,3호선,양재,12260,13958,26218
202202,3호선,연신내,17649,16914,34563
202202,3호선,오금,2196,2169,4365
202202,3호선,옥수,3940,4161,8101
202202,3호선,을지로3가,2814,2553,5367
202202,3호선,일원,2844,2971,5815
202202,3호선,잠원,1729,1805,3534
202202,3호선,종로3가,3194,3904,7098
202202,3호선,지축,1778,1665,3443
202202,3호선,학여울,1442,1652,3094
202202,3호선,홍제,7645,7469,15114
202202,3호선,가락시장,5107,4870,9977
202202,3호선,경복궁,11944,12207,24151
202202,3호선,경찰병원,3549,3414,6963
202202,3호선,고속터미널,37745,38612,76357
202202,3호선,교대,5917,3639,9556
202202,3호선,구파발,12097,12104,24201
202202,3호선,금호,5059,4639,9698
202202,3호선,남부터미널,17810,18139,35949
202202,3호선,녹번,8785,7871,16656
202202,3호선,대청,5250,4780,10030
202202,3호선,대치,8356,7572,15928
202202,3호선,도곡,2948,2969,5917
202202,3호선,독립문,4902,5018,9920
202202,3호선,동대입구,5804,6238,12042
202202,3호선,매봉,5322,5104,10426
202202,3호선,무악재,2222,2376,4598
202202,3호선,불광,10823,12187,23010
202202,3호선,수서,11261,11696,22957
202202,3호선,신사,22714,23084,45798
202202,3호선,안국,11321,12057,23378
202202,3호선,압구정,21643,22667,44310
202202,3호선,약수,7893,7334,15227
202202,3호선,양재,18028,19152,37180
202202,3호선,연신내,24862,23406,48268
202202,3호선,오금,3252,2985,6237
202202,3호선,옥수,5475,5716,11191
202202,3호선,을지로3가,4202,4325,8527
202202,3호선,일원,4212,4161,8373
202202,3호선,잠원,3058,2967,6025
202202,3호선,종로3가,4917,6588,11505
202202,3호선,지축,2582,2382,4964
202202,3호선,학여울,1579,1562,3141
202202,3호선,홍제,11187,10777,21964
202202,3호선,가락시장,3133,3309,6442
202202,3호선,경복궁,11135,11175,22310
202202,3호선,경찰병원,2271,2382,4653
202202,3호선,고속터미널,31987,30119,62106
202202,3호선,교대,3798,2411,6209
202202,3호선,구파발,9719,9805,19524
202202,3호선,금호,3589,3528,7117
202202,3호선,남부터미널,12153,12530,24683
202202,3호선,녹번,6251,5783,12034
202202,3호선,대청,3767,3668,7435
202202,3호선,대치,5454,4741,10195
202202,3호선,도곡,1573,1691,3264
202202,3호선,독립문,4169,4554,8723
202202,3호선,동대입구,5438,5854,11292
202202,3호선,매봉,3509,3381,6890
202202,3호선,무악재,1535,1813,3348
202202,3호선,불광,8652,10016,18668
202202,3호선,수서,8857,8647,17504
202202,3호선,신사,12982,12915,25897
202202,3호선,안국,9305,10078,19383
202202,3호선,압구정,12376,12869,25245
202202,3호선,약수,5631,5467,11098
202202,3호선,양재,11763,13172,24935
202202,3호선,연신내,19190,17748,36938
202202,3호선,오금,2416,2298,4714
202202,3호선,옥수,4511,4433,8944
202202,3호선,을지로3가,2858,2673,5531
202202,3호선,일원,2823,2995,5818
202202,3호선,잠원,1861,1888,3749
202202,3호선,종로3가,3563,4413,7976
202202,3호선,지축,1955,1830,3785
202202,3호선,학여울,1406,1535,2941
202202,3호선,홍제,8189,7995,16184
202203,3호선,가락시장,5047,4727,9774
202203,3호선,경복궁,13389,13854,27243
202203,3호선,경찰병원,3447,3433,6880
202203,3호선,고속터미널,37456,36942,74398
202203,3호선,교대,5873,3623,9496
202203,3호선,구파발,13234,13345,26579
202203,3호선,금호,4889,4609,9498
202203,3호선,남부터미널,17017,17000,34017
202203,3호선,녹번,8952,7865,16817
202203,3호선,대청,5114,4760,9874
202203,3호선,대치,8320,7563,15883
202203,3호선,도곡,2857,2876,5733
202203,3호선,독립문,5169,5560,10729
202203,3호선,동대입구,4780,5415,10195
202203,3호선,매봉,5096,4945,10041
202203,3호선,무악재,2422,2504,4926
202203,3호선,불광,11269,12748,24017
202203,3호선,수서,10891,11139,22030
202203,3호선,신사,22898,23606,46504
202203,3호선,안국,12650,13622,26272
202203,3호선,압구정,21519,22578,44097
202203,3호선,약수,7870,7367,15237
202203,3호선,양재,17719,19040,36759
202203,3호선,연신내,25685,24267,49952
202203,3호선,오금,3236,3132,6368
202203,3호선,옥수,5694,5872,11566
202203,3호선,을지로3가,4229,4466,8695
202203,3호선,일원,4427,4327,8754
202203,3호선,잠원,2832,2785,5617
202203,3호선,종로3가,5137,6655,11792
202203,3호선,지축,2609,2397,5006
202203,3호선,학여울,2835,3131,5966
202203,3호선,홍제,11134,10680,21814
202203,3호선,가락시장,3048,3232,6280
202203,3호선,경복궁,9258,9459,18717
202203,3호선,경찰병원,2268,2343,4611
202203,3호선,고속터미널,30602,29341,59943
202203,3호선,교대,3566,2343,5909
202203,3호선,구파발,9426,9834,19260
202203,3호선,금호,3463,3386,6849
202203,3호선,남부터미널,11590,12581,24171
202203,3호선,녹번,6237,5523,11760
202203,3호선,대청,3556,3445,7001
202203,3호선,대치,5240,4602,9842
202203,3호선,도곡,1598,1736,3334
202203,3호선,독립문,3793,4205,7998
202203,3호선,동대입구,3775,4185,7960
202203,3호선,매봉,3405,3342,6747
202203,3호선,무악재,1385,1672,3057
202203,3호선,불광,8111,9171,17282
202203,3호선,수서,8610,8292,16902
202203,3호선,신사,11926,11799,23725
202203,3호선,안국,8422,8979,17401
202203,3호선,압구정,11240,11607,22847
202203,3호선,약수,5588,5450,11038
202203,3호선,양재,11006,12793,23799
202203,3호선,연신내,18222,17106,35328
202203,3호선,오금,2174,2210,4384
202203,3호선,옥수,3886,4149,8035
202203,3호선,을지로3가,2520,2248,4768
202203,3호선,일원,2832,2917,5749
202203,3호선,잠원,1788,1879,3667
202203,3호선,종로3가,3198,3922,7120
202203,3호선,지축,1862,1778,3640
202203,3호선,충무로,2,0,2
202203,3호선,학여울,2080,2252,4332
202203,3호선,홍제,7735,7526,15261
202203,3호선,가락시장,5228,5049,10277
202203,3호선,경복궁,13677,14347,28024
202203,3호선,경찰병원,3433,3215,6648
202203,3호선,고속터미널,39037,38442,77479
202203,3호선,교대,6038,3747,9785
202203,3호선,구파발,12976,13365,26341
202203,3호선,금호,5024,4630,9654
202203,3호선,남부터미널,17751,17737,35488
202203,3호선,녹번,9062,7949,17011
202203,3호선,대청,5150,4733,9883
202203,3호선,대치,8445,7784,16229
202203,3호선,도곡,2860,2953,5813
202203,3호선,독립문,5337,5863,11200
202203,3호선,동대입구,5230,5639,10869
202203,3호선,매봉,5077,4889,9966
202203,3호선,무악재,2250,2446,4696
202203,3호선,불광,11379,12987,24366
202203,3호선,수서,10966,11092,22058
202203,3호선,신사,23296,24126,47422
202203,3호선,안국,12323,14073,26396
202203,3호선,압구정,21277,22630,43907
202203,3호선,약수,7888,7635,15523
202203,3호선,양재,17581,19082,36663
202203,3호선,연신내,26005,24611,50616
202203,3호선,오금,3153,2998,6151
202203,3호선,옥수,5859,6024,11883
202203,3호선,을지로3가,4303,4541,8844
202203,3호선,일원,4307,4243,8550
202203,3호선,잠원,3202,2991,6193
202203,3호선,종로3가,5061,6969,12030
202203,3호선,지축,2850,2757,5607
202203,3호선,학여울,928,918,1846
202203,3호선,홍제,11571,10998,22569
202203,3호선,가락시장,2601,2926,5527
202203,3호선,경복궁,7022,7230,14252
202203,3호선,경찰병원,2048,2103,4151
202203,3호선,고속터미널,30023,29525,59548
202203,3호선,교대,3446,2236,5682
202203,3호선,구파발,8093,7975,16068
202203,3호선,금호,3071,3021,6092
202203,3호선,남부터미널,11086,12178,23264
202203,3호선,녹번,5621,5025,10646
202203,3호선,대청,3261,3171,6432
202203,3호선,대치,5188,4438,9626
202203,3호선,도곡,1399,1431,2830
202203,3호선,독립문,3148,3280,6428
202203,3호선,동대입구,3520,3673,7193
202203,3호선,매봉,3136,3073,6209
202203,3호선,무악재,1304,1340,2644
202203,3호선,불광,6776,7560,14336
202203,3호선,수서,8312,8067,16379
202203,3호선,신사,11008,10902,21910
202203,3호선,안국,6938,7557,14495
202203,3호선,압구정,10539,10971,21510
202203,3호선,약수,4966,4836,9802
202203,3호선,양재,10167,11891,22058
202203,3호선,연신내,15638,15194,30832
202203,3호선,오금,1928,1922,3850
202203,3호선,옥수,3513,3685,7198
202203,3호선,을지로3가,2426,2134,4560
202203,3호선,일원,2651,2760,5411
202203,3호선,잠원,1617,1571,3188
202203,3호선,종로3가,2870,3668,6538
202203,3호선,지축,1604,1557,3161
202203,3호선,학여울,670,664,1334
202203,3호선,홍제,6923,6593,13516
202203,3호선,가락시장,4649,4361,9010
202203,3호선,경복궁,10418,10500,20918
202203,3호선,경찰병원,3273,3140,6413
202203,3호선,고속터미널,37079,36866,73945
202203,3호선,교대,5677,3519,9196
202203,3호선,구파발,11133,11041,22174
202203,3호선,금호,4547,4227,8774
202203,3호선,남부터미널,16157,15799,31956
202203,3호선,녹번,8148,7260,15408
202203,3호선,대청,4759,4393,9152
202203,3호선,대치,8082,7153,15235
202203,3호선,도곡,2540,2634,5174
202203,3호선,독립문,4064,4270,8334
202203,3호선,동대입구,4989,5298,10287
202203,3호선,매봉,4882,4744,9626
202203,3호선,무악재,2073,2075,4148
202203,3호선,불광,9619,10477,20096
202203,3호선,수서,10650,10518,21168
202203,3호선,신사,21862,22911,44773
202203,3호선,안국,10481,11869,22350
202203,3호선,압구정,20339,21456,41795
202203,3호선,약수,7062,6789,13851
202203,3호선,양재,16388,17790,34178
202203,3호선,연신내,22787,22118,44905
202203,3호선,오금,2932,2824,5756
202203,3호선,옥수,5239,5332,10571
202203,3호선,을지로3가,4009,4223,8232
202203,3호선,일원,3781,3731,7512
202203,3호선,잠원,2749,2644,5393
202203,3호선,종로3가,4812,6390,11202
202203,3호선,지축,2427,2262,4689
202203,3호선,학여울,2600,2869,5469
202203,3호선,홍제,10163,9498,19661
202203,3호선,가락시장,3145,3310,6455
202203,3호선,경복궁,10168,10407,20575
202203,3호선,경찰병원,2231,2343,4574
202203,3호선,고속터미널,32572,31444,64016
202203,3호선,교대,3732,2249,5981
202203,3호선,구파발,9662,9900,19562
202203,3호선,금호,3495,3399,6894
202203,3호선,남부터미널,11592,12473,24065
202203,3호선,녹번,5957,5527,11484
202203,3호선,대청,3536,3465,7001
202203,3호선,대치,5386,4691,10077
202203,3호선,도곡,1722,1904,3626
202203,3호선,독립문,3610,4061,7671
202203,3호선,동대입구,4560,4949,9509
202203,3호선,매봉,3596,3531,7127
202203,3호선,무악재,1552,1677,3229
202203,3호선,불광,8456,9914,18370
202203,3호선,수서,9075,8900,17975
202203,3호선,신사,13113,13217,26330
202203,3호선,안국,10060,10574,20634
202203,3호선,압구정,11875,12364,24239
202203,3호선,약수,5608,5524,11132
202203,3호선,양재,11533,13433,24966
202203,3호선,연신내,18319,17351,35670
202203,3호선,오금,2232,2236,4468
202203,3호선,옥수,4161,4394,8555
202203,3호선,을지로3가,2738,2600,5338
202203,3호선,일원,2881,3015,5896
202203,3호선,잠원,1825,1837,3662
202203,3호선,종로3가,3430,4292,7722
202203,3호선,지축,1919,1851,3770
202203,3호선,학여울,2513,2837,5350
202203,3호선,홍제,7885,7576,15461
202203,3호선,가락시장,5196,4805,10001
202203,3호선,경복궁,12662,13191,25853
202203,3호선,경찰병원,3274,3144,6418
202203,3호선,고속터미널,39104,38984,78088
202203,3호선,교대,5935,3634,9569
202203,3호선,구파발,12154,12127,24281
202203,3호선,금호,4857,4623,9480
202203,3호선,남부터미널,17541,17499,35040
202203,3호선,녹번,8763,7732,16495
202203,3호선,대청,5056,4574,9630
202203,3호선,대치,8352,7620,15972
202203,3호선,도곡,2811,2905,5716
202203,3호선,독립문,4630,4937,9567
202203,3호선,동대입구,5374,5713,11087
202203,3호선,매봉,4990,4952,9942
202203,3호선,무악재,2209,2197,4406
202203,3호선,불광,10252,11445,21697
202203,3호선,수서,11024,11055,22079
202203,3호선,신사,23548,24538,48086
202203,3호선,안국,12238,13999,26237
202203,3호선,압구정,21327,22421,43748
202203,3호선,약수,7675,7324,14999
202203,3호선,양재,17080,18879,35959
202203,3호선,연신내,24512,23255,47767
202203,3호선,오금,3112,2912,6024
202203,3호선,옥수,5656,5829,11485
202203,3호선,을지로3가,4405,4617,9022
202203,3호선,일원,3934,3864,7798
202203,3호선,잠원,2774,2637,5411
202203,3호선,종로3가,5077,6740,11817
202203,3호선,지축,2671,2459,5130
202203,3호선,충무로,4,0,4
202203,3호선,학여울,3069,3588,6657
202203,3호선,홍제,10584,9922,20506
202203,3호선,가락시장,3228,3425,6653
202203,3호선,경복궁,12414,13040,25454
202203,3호선,경찰병원,2374,2536,4910
202203,3호선,고속터미널,34862,33662,68524
202203,3호선,교대,3957,2541,6498
202203,3호선,구파발,10212,10436,20648
202203,3호선,금호,3759,3723,7482
202203,3호선,남부터미널,13097,14145,27242
202203,3호선,녹번,6581,6021,12602
202203,3호선,대청,3811,3772,7583
202203,3호선,대치,5497,4800,10297
202203,3호선,도곡,1672,1938,3610
202203,3호선,독립문,4066,4444,8510
202203,3호선,동대입구,4643,5207,9850
202203,3호선,매봉,3695,3617,7312
202203,3호선,무악재,1656,1910,3566
202203,3호선,불광,9103,10382,19485
202203,3호선,수서,9152,9091,18243
202203,3호선,신사,13921,13844,27765
202203,3호선,안국,11385,12312,23697
202203,3호선,압구정,12521,12782,25303
202203,3호선,약수,5886,5889,11775
202203,3호선,양재,11835,13553,25388
202203,3호선,연신내,19566,18608,38174
202203,3호선,오금,2267,2216,4483
202203,3호선,옥수,4526,4714,9240
202203,3호선,을지로3가,2942,2681,5623
202203,3호선,일원,2966,3137,6103
202203,3호선,잠원,1988,2062,4050
202203,3호선,종로3가,3642,4306,7948
202203,3호선,지축,2151,1950,4101
202203,3호선,충무로,1,0,1
202203,3호선,학여울,2455,2838,5293
202203,3호선,홍제,8391,8159,16550
202204,3호선,가락시장,5652,5337,10989
202204,3호선,경복궁,19427,20459,39886
202204,3호선,경찰병원,3697,3587,7284
202204,3호선,고속터미널,45336,45686,91022
202204,3호선,교대,6362,3886,10248
202204,3호선,구파발,14356,14853,29209
202204,3호선,금호,5488,5063,10551
202204,3호선,남부터미널,18777,19025,37802
202204,3호선,녹번,9801,8689,18490
202204,3호선,대청,5572,5163,10735
202204,3호선,대치,8898,8001,16899
202204,3호선,도곡,3217,3204,6421
202204,3호선,독립문,5651,6505,12156
202204,3호선,동대입구,6450,7187,13637
202204,3호선,매봉,5945,5641,11586
202204,3호선,무악재,2676,2830,5506
202204,3호선,불광,12352,13485,25837
202204,3호선,수서,12160,12346,24506
202204,3호선,신사,24762,25365,50127
202204,3호선,안국,18173,20394,38567
202204,3호선,압구정,22279,23528,45807
202204,3호선,약수,8769,8362,17131
202204,3호선,양재,18935,20889,39824
202204,3호선,연신내,28355,26882,55237
202204,3호선,오금,3736,3639,7375
202204,3호선,옥수,7175,7155,14330
202204,3호선,을지로3가,4878,5320,10198
202204,3호선,일원,4847,4739,9586
202204,3호선,잠원,3299,3115,6414
202204,3호선,종로3가,6041,8160,14201
202204,3호선,지축,3207,2893,6100
202204,3호선,충무로,2,0,2
202204,3호선,학여울,1085,970,2055
202204,3호선,홍제,12421,11773,24194
202204,3호선,가락시장,3439,3765,7204
202204,3호선,경복궁,14802,15020,29822
202204,3호선,경찰병원,2438,2485,4923
202204,3호선,고속터미널,38338,36068,74406
202204,3호선,교대,4090,2490,6580
202204,3호선,구파발,10455,10997,21452
202204,3호선,금호,4052,3839,7891
202204,3호선,남부터미널,13241,13836,27077
202204,3호선,녹번,6829,6334,13163
202204,3호선,대청,3932,3837,7769
202204,3호선,대치,5645,5009,10654
202204,3호선,도곡,1889,2073,3962
202204,3호선,독립문,4368,5265,9633
202204,3호선,동대입구,5279,5789,11068
202204,3호선,매봉,3893,3895,7788
202204,3호선,무악재,1763,1951,3714
202204,3호선,불광,9157,10345,19502
202204,3호선,수서,9878,9787,19665
202204,3호선,신사,13653,13604,27257
202204,3호선,안국,13524,15149,28673
202204,3호선,압구정,12539,12846,25385
202204,3호선,약수,6226,6218,12444
202204,3호선,양재,12853,14614,27467
202204,3호선,연신내,20111,19078,39189
202204,3호선,오금,2529,2482,5011
202204,3호선,옥수,5017,5139,10156
202204,3호선,을지로3가,2978,2837,5815
202204,3호선,일원,3297,3528,6825
202204,3호선,잠원,2246,2187,4433
202204,3호선,종로3가,3972,4890,8862
202204,3호선,지축,2275,2126,4401
202204,3호선,충무로,2,0,2
202204,3호선,학여울,876,869,1745
202204,3호선,홍제,8967,8634,17601
202204,3호선,가락시장,6236,5890,12126
202204,3호선,경복궁,20127,21733,41860
202204,3호선,경찰병원,4036,3853,7889
202204,3호선,고속터미널,49165,48018,97183
202204,3호선,교대,7128,4275,11403
202204,3호선,구파발,15089,14831,29920
202204,3호선,금호,5946,5316,11262
202204,3호선,남부터미널,20887,20315,41202
202204,3호선,녹번,10162,8685,18847
202204,3호선,대청,6094,5650,11744
202204,3호선,대치,9115,8240,17355
202204,3호선,도곡,3966,4880,8846
202204,3호선,독립문,6346,7323,13669
202204,3호선,동대입구,8078,9277,17355
202204,3호선,매봉,7953,7465,15418
202204,3호선,무악재,2723,2900,5623
202204,3호선,불광,12563,14050,26613
202204,3호선,수서,13994,13896,27890
202204,3호선,신사,24423,26450,50873
202204,3호선,안국,19703,22924,42627
202204,3호선,압구정,23373,24934,48307
202204,3호선,약수,9012,8516,17528
202204,3호선,양재,21294,22880,44174
202204,3호선,연신내,29523,27923,57446
202204,3호선,오금,4119,3938,8057
202204,3호선,옥수,7465,7387,14852
202204,3호선,을지로3가,5184,5606,10790
202204,3호선,일원,4901,4749,9650
202204,3호선,잠원,3904,3676,7580
202204,3호선,종로3가,5930,8018,13948
202204,3호선,지축,3528,3193,6721
202204,3호선,충무로,2,0,2
202204,3호선,학여울,3080,3411,6491
202204,3호선,홍제,13457,12541,25998
202204,3호선,가락시장,3730,3838,7568
202204,3호선,경복궁,15855,16914,32769
202204,3호선,경찰병원,2744,2845,5589
202204,3호선,고속터미널,41890,39321,81211
202204,3호선,교대,4292,2732,7024
202204,3호선,구파발,11646,11648,23294
202204,3호선,금호,4250,4135,8385
202204,3호선,남부터미널,14901,15793,30694
202204,3호선,녹번,7251,6515,13766
202204,3호선,대청,4401,4282,8683
202204,3호선,대치,5907,5275,11182
202204,3호선,도곡,2523,3288,5811
202204,3호선,독립문,4805,5800,10605
202204,3호선,동대입구,7008,7813,14821
202204,3호선,매봉,5622,5570,11192
202204,3호선,무악재,1998,2180,4178
202204,3호선,불광,9686,11045,20731
202204,3호선,수서,10898,10743,21641
202204,3호선,신사,13223,13494,26717
202204,3호선,안국,14267,16226,30493
202204,3호선,압구정,13165,14037,27202
202204,3호선,약수,6674,6513,13187
202204,3호선,양재,14400,16189,30589
202204,3호선,연신내,22312,21108,43420
202204,3호선,오금,2732,2751,5483
202204,3호선,옥수,5303,5460,10763
202204,3호선,을지로3가,3511,3060,6571
202204,3호선,일원,3635,3936,7571
202204,3호선,잠원,2666,2634,5300
202204,3호선,종로3가,4075,4923,8998
202204,3호선,지축,2568,2290,4858
202204,3호선,충무로,1,0,1
202204,3호선,학여울,2449,2716,5165
202204,3호선,홍제,9897,9467,19364
202204,3호선,가락시장,6255,6033,12288
202204,3호선,경복궁,19059,20339,39398
202204,3호선,경찰병원,3982,3919,7901
202204,3호선,고속터미널,49558,49422,98980
202204,3호선,교대,7041,4122,11163
202204,3호선,구파발,15514,15736,31250
202204,3호선,금호,5996,5283,11279
202204,3호선,남부터미널,19779,19561,39340
202204,3호선,녹번,10491,8876,19367
202204,3호선,대청,5940,5442,11382
202204,3호선,대치,8252,7742,15994
202204,3호선,도곡,3420,3419,6839
202204,3호선,독립문,6441,7385,13826
202204,3호선,동대입구,7658,8748,16406
202204,3호선,매봉,6448,6176,12624
202204,3호선,무악재,2751,2946,5697
202204,3호선,불광,13257,14795,28052
202204,3호선,수서,13398,13449,26847
202204,3호선,신사,25137,26887,52024
202204,3호선,안국,17445,20007,37452
202204,3호선,압구정,24456,25917,50373
202204,3호선,약수,9356,8996,18352
202204,3호선,양재,20918,22619,43537
202204,3호선,연신내,29852,28003,57855
202204,3호선,오금,3725,3554,7279
202204,3호선,옥수,7059,7233,14292
202204,3호선,을지로3가,5379,5821,11200
202204,3호선,일원,4743,4703,9446
202204,3호선,잠원,3811,3679,7490
202204,3호선,종로3가,6165,8282,14447
202204,3호선,지축,3576,3192,6768
202204,3호선,충무로,2,0,2
202204,3호선,학여울,1960,2086,4046
202204,3호선,홍제,13584,12624,26208
202204,3호선,가락시장,3825,4002,7827
202204,3호선,경복궁,13794,14516,28310
202204,3호선,경찰병원,2891,2905,5796
202204,3호선,고속터미널,41041,37809,78850
202204,3호선,교대,4379,2667,7046
202204,3호선,구파발,11256,11690,22946
202204,3호선,금호,4229,4113,8342
202204,3호선,남부터미널,13731,14476,28207
202204,3호선,녹번,7223,6590,13813
202204,3호선,대청,4174,4064,8238
202204,3호선,대치,5010,4591,9601
202204,3호선,도곡,2124,2244,4368
202204,3호선,독립문,4643,5379,10022
202204,3호선,동대입구,5631,6462,12093
202204,3호선,매봉,4215,4245,8460
202204,3호선,무악재,1943,2118,4061
202204,3호선,불광,9886,11248,21134
202204,3호선,수서,10319,10252,20571
202204,3호선,신사,13252,13476,26728
202204,3호선,안국,12152,13660,25812
202204,3호선,압구정,13419,14233,27652
202204,3호선,약수,6889,6611,13500
202204,3호선,양재,13943,15967,29910
202204,3호선,연신내,21482,20259,41741
202204,3호선,오금,2781,2747,5528
202204,3호선,옥수,5055,5206,10261
202204,3호선,을지로3가,3669,3329,6998
202204,3호선,일원,3373,3620,6993
202204,3호선,잠원,2372,2336,4708
202204,3호선,종로3가,3891,5092,8983
202204,3호선,지축,2568,2367,4935
202204,3호선,학여울,877,866,1743
202204,3호선,홍제,9584,9247,18831
202204,3호선,가락시장,6113,5983,12096
202204,3호선,경복궁,18800,20283,39083
202204,3호선,경찰병원,4072,3834,7906
202204,3호선,고속터미널,50781,50391,101172
202204,3호선,교대,7094,4163,11257
202204,3호선,구파발,15465,15608,31073
202204,3호선,금호,6062,5372,11434
202204,3호선,남부터미널,21281,21479,42760
202204,3호선,녹번,10626,8943,19569
202204,3호선,대청,6128,5592,11720
202204,3호선,대치,8049,7488,15537
202204,3호선,도곡,3372,3441,6813
202204,3호선,독립문,6361,7312,13673
202204,3호선,동대입구,7120,7943,15063
202204,3호선,매봉,6574,6253,12827
202204,3호선,무악재,2883,2911,5794
202204,3호선,불광,13518,15055,28573
202204,3호선,수서,13590,13596,27186
202204,3호선,신사,25661,27586,53247
202204,3호선,안국,17784,20854,38638
202204,3호선,압구정,25041,26796,51837
202204,3호선,약수,9463,8960,18423
202204,3호선,양재,21199,23286,44485
202204,3호선,연신내,30127,28149,58276
202204,3호선,오금,3771,3573,7344
202204,3호선,옥수,7349,7260,14609
202204,3호선,을지로3가,5693,6446,12139
202204,3호선,일원,5273,4993,10266
202204,3호선,잠원,3563,3396,6959
202204,3호선,종로3가,5921,8900,14821
202204,3호선,지축,3547,3256,6803
202204,3호선,충무로,1,0,1
202204,3호선,학여울,1219,1238,2457
202204,3호선,홍제,13773,12726,26499
202204,3호선,가락시장,3668,3874,7542
202204,3호선,경복궁,13278,13876,27154
202204,3호선,경찰병원,2710,2790,5500
202204,3호선,고속터미널,41725,38752,80477
202204,3호선,교대,4304,2786,7090
202204,3호선,구파발,11623,11884,23507
202204,3호선,금호,4412,4151,8563
202204,3호선,남부터미널,14900,15642,30542
202204,3호선,녹번,7437,6672,14109
202204,3호선,대청,4224,4059,8283
202204,3호선,대치,4931,4533,9464
202204,3호선,도곡,2128,2309,4437
202204,3호선,독립문,4396,5007,9403
202204,3호선,동대입구,5156,5556,10712
202204,3호선,매봉,4527,4427,8954
202204,3호선,무악재,1777,1997,3774
202204,3호선,불광,9846,11083,20929
202204,3호선,수서,10464,10153,20617
202204,3호선,신사,13309,13338,26647
202204,3호선,안국,12049,13274,25323
202204,3호선,압구정,13381,14210,27591
202204,3호선,약수,6843,6564,13407
202204,3호선,양재,13361,15786,29147
202204,3호선,연신내,21868,20484,42352
202204,3호선,오금,2899,2977,5876
202204,3호선,옥수,5147,5355,10502
202204,3호선,을지로3가,3486,3426,6912
202204,3호선,일원,3589,3873,7462
202204,3호선,잠원,2329,2291,4620
202204,3호선,종로3가,3957,5147,9104
202204,3호선,지축,2506,2265,4771
202204,3호선,충무로,1,0,1
202204,3호선,학여울,938,927,1865
202204,3호선,홍제,9462,8885,18347
202204,3호선,가락시장,6427,6085,12512
202204,3호선,경복궁,24771,24009,48780
202204,3호선,경찰병원,4208,4128,8336
202204,3호선,고속터미널,57031,57063,114094
202204,3호선,교대,7891,4889,12780
202204,3호선,구파발,16735,17174,33909
202204,3호선,금호,6294,5727,12021
202204,3호선,남부터미널,22953,22642,45595
202204,3호선,녹번,11390,10095,21485
202204,3호선,대청,6366,5748,12114
202204,3호선,대치,8217,7590,15807
202204,3호선,도곡,3764,3839,7603
202204,3호선,독립문,7233,7868,15101
202204,3호선,동대입구,9797,14336,24133
202204,3호선,매봉,6841,6578,13419
202204,3호선,무악재,3043,3322,6365
202204,3호선,불광,13759,15681,29440
202204,3호선,수서,15173,14585,29758
202204,3호선,신사,28904,30687,59591
202204,3호선,안국,25024,24453,49477
202204,3호선,압구정,26215,28438,54653
202204,3호선,약수,10287,9669,19956
202204,3호선,양재,22673,25467,48140
202204,3호선,연신내,30667,29252,59919
202204,3호선,오금,4022,3789,7811
202204,3호선,옥수,7717,7814,15531
202204,3호선,을지로3가,7138,7480,14618
202204,3호선,일원,5203,5149,10352
202204,3호선,잠원,3817,3626,7443
202204,3호선,종로3가,7306,11056,18362
202204,3호선,지축,3805,3465,7270
202204,3호선,학여울,2995,3095,6090
202204,3호선,홍제,14491,14070,28561
202205,3호선,가락시장,3999,4214,8213
202205,3호선,경복궁,20437,18453,38890
202205,3호선,경찰병원,2820,2818,5638
202205,3호선,고속터미널,47617,44736,92353
202205,3호선,교대,4768,2924,7692
202205,3호선,구파발,12738,13222,25960
202205,3호선,금호,4479,4416,8895
202205,3호선,남부터미널,15448,16573,32021
202205,3호선,녹번,7901,7461,15362
202205,3호선,대청,4333,4342,8675
202205,3호선,대치,5049,4747,9796
202205,3호선,도곡,2136,2240,4376
202205,3호선,독립문,5123,5830,10953
202205,3호선,동대입구,5524,6136,11660
202205,3호선,매봉,4346,4303,8649
202205,3호선,무악재,2170,2397,4567
202205,3호선,불광,10896,12777,23673
202205,3호선,수서,11219,11239,22458
202205,3호선,신사,16157,15508,31665
202205,3호선,안국,18204,18370,36574
202205,3호선,압구정,14505,15139,29644
202205,3호선,약수,7383,7336,14719
202205,3호선,양재,14818,17187,32005
202205,3호선,연신내,23088,22117,45205
202205,3호선,오금,2800,2851,5651
202205,3호선,옥수,5509,5794,11303
202205,3호선,을지로3가,4440,3908,8348
202205,3호선,일원,3556,3880,7436
202205,3호선,잠원,2535,2506,5041
202205,3호선,종로3가,5137,6200,11337
202205,3호선,지축,2740,2499,5239
202205,3호선,학여울,2449,2760,5209
202205,3호선,홍제,10596,10123,20719
202205,3호선,가락시장,5794,5566,11360
202205,3호선,경복궁,20163,19714,39877
202205,3호선,경찰병원,3797,3705,7502
202205,3호선,고속터미널,55663,58892,114555
202205,3호선,교대,7016,4281,11297
202205,3호선,구파발,16036,16292,32328
202205,3호선,금호,5961,5303,11264
202205,3호선,남부터미널,20771,21840,42611
202205,3호선,녹번,10509,9063,19572
202205,3호선,대청,5819,5178,10997
202205,3호선,대치,9268,8434,17702
202205,3호선,도곡,3240,3279,6519
202205,3호선,독립문,6244,6702,12946
202205,3호선,동대입구,6272,7135,13407
202205,3호선,매봉,6186,6043,12229
202205,3호선,무악재,2693,2779,5472
202205,3호선,불광,12715,14312,27027
202205,3호선,수서,13435,13522,26957
202205,3호선,신사,24718,26107,50825
202205,3호선,안국,18655,19956,38611
202205,3호선,압구정,23482,25017,48499
202205,3호선,약수,9090,8398,17488
202205,3호선,양재,19869,21929,41798
202205,3호선,연신내,29514,27789,57303
202205,3호선,오금,3720,3580,7300
202205,3호선,옥수,6986,7131,14117
202205,3호선,을지로3가,5388,5785,11173
202205,3호선,일원,5061,4913,9974
202205,3호선,잠원,3491,3144,6635
202205,3호선,종로3가,5894,8632,14526
202205,3호선,지축,3424,3118,6542
202205,3호선,충무로,3,0,3
202205,3호선,학여울,2671,2852,5523
202205,3호선,홍제,13517,12571,26088
202205,3호선,가락시장,3532,3891,7423
202205,3호선,경복궁,12774,12763,25537
202205,3호선,경찰병원,2745,2951,5696
202205,3호선,고속터미널,53797,43248,97045
202205,3호선,교대,4067,2638,6705
202205,3호선,구파발,13513,13924,27437
202205,3호선,금호,4263,4255,8518
202205,3호선,남부터미널,16815,16267,33082
202205,3호선,녹번,7521,7040,14561
202205,3호선,대청,4102,4197,8299
202205,3호선,대치,6112,5530,11642
202205,3호선,도곡,1806,1945,3751
202205,3호선,독립문,4614,5108,9722
202205,3호선,동대입구,4853,5413,10266
202205,3호선,매봉,4146,4125,8271
202205,3호선,무악재,2055,2379,4434
202205,3호선,불광,9963,11413,21376
202205,3호선,수서,11529,10553,22082
202205,3호선,신사,12482,12592,25074
202205,3호선,안국,13735,14988,28723
202205,3호선,압구정,13050,13705,26755
202205,3호선,약수,6862,6833,13695
202205,3호선,양재,13475,16295,29770
202205,3호선,연신내,22421,21279,43700
202205,3호선,오금,2717,2769,5486
202205,3호선,옥수,5288,5561,10849
202205,3호선,을지로3가,3105,2895,6000
202205,3호선,일원,3574,3856,7430
202205,3호선,잠원,2244,2262,4506
202205,3호선,종로3가,4056,4887,8943
202205,3호선,지축,2552,2307,4859
202205,3호선,학여울,1972,2114,4086
202205,3호선,홍제,9916,9806,19722
202205,3호선,가락시장,7090,6634,13724
202205,3호선,경복궁,28687,32765,61452
202205,3호선,경찰병원,4716,4481,9197
202205,3호선,고속터미널,61703,60529,122232
202205,3호선,교대,8814,5468,14282
202205,3호선,구파발,17861,18324,36185
202205,3호선,금호,6596,5992,12588
202205,3호선,남부터미널,25517,25141,50658
202205,3호선,녹번,11898,10043,21941
202205,3호선,대청,6998,6458,13456
202205,3호선,대치,11410,10006,21416
202205,3호선,도곡,3934,4109,8043
202205,3호선,독립문,7611,8718,16329
202205,3호선,동대입구,8310,9715,18025
202205,3호선,매봉,7241,6955,14196
202205,3호선,무악재,3057,3296,6353
202205,3호선,불광,14440,16400,30840
202205,3호선,수서,15991,15557,31548
202205,3호선,신사,30055,31392,61447
202205,3호선,안국,23162,24871,48033
202205,3호선,압구정,26998,29220,56218
202205,3호선,약수,10464,9914,20378
202205,3호선,양재,25464,27872,53336
202205,3호선,연신내,33052,31023,64075
202205,3호선,오금,4784,4601,9385
202205,3호선,옥수,8453,8223,16676
202205,3호선,을지로3가,6509,7452,13961
202205,3호선,일원,5905,5887,11792
202205,3호선,잠원,4155,3913,8068
202205,3호선,종로3가,7083,10519,17602
202205,3호선,지축,4116,3679,7795
202205,3호선,충무로,1,0,1
202205,3호선,학여울,11793,12435,24228
202205,3호선,홍제,15460,14238,29698
202205,3호선,가락시장,4315,4610,8925
202205,3호선,경복궁,22635,26016,48651
202205,3호선,경찰병원,3095,3226,6321
202205,3호선,고속터미널,51747,48046,99793
202205,3호선,교대,5455,3375,8830
202205,3호선,구파발,13759,13852,27611
202205,3호선,금호,4742,4401,9143
202205,3호선,남부터미널,18051,19184,37235
202205,3호선,녹번,8532,7552,16084
202205,3호선,대청,4720,4628,9348
202205,3호선,대치,7573,6710,14283
202205,3호선,도곡,2443,2732,5175
202205,3호선,독립문,5676,6649,12325
202205,3호선,동대입구,7079,7847,14926
202205,3호선,매봉,5232,5183,10415
202205,3호선,무악재,2193,2409,4602
202205,3호선,불광,10990,12576,23566
202205,3호선,수서,12127,12240,24367
202205,3호선,신사,16800,16606,33406
202205,3호선,안국,16666,17331,33997
202205,3호선,압구정,15557,16348,31905
202205,3호선,약수,7845,7557,15402
202205,3호선,양재,16230,19184,35414
202205,3호선,연신내,23982,22858,46840
202205,3호선,오금,3166,3221,6387
202205,3호선,옥수,5971,6179,12150
202205,3호선,을지로3가,4536,4141,8677
202205,3호선,일원,4087,4220,8307
202205,3호선,잠원,2814,2741,5555
202205,3호선,종로3가,4980,6321,11301
202205,3호선,지축,2926,2767,5693
202205,3호선,충무로,1,0,1
202205,3호선,학여울,10449,11021,21470
202205,3호선,홍제,10975,10450,21425
202205,3호선,가락시장,6809,6451,13260
202205,3호선,경복궁,29562,34134,63696
202205,3호선,경찰병원,4415,4209,8624
202205,3호선,고속터미널,60824,59526,120350
202205,3호선,교대,8616,5357,13973
202205,3호선,구파발,18062,18445,36507
202205,3호선,금호,6504,5804,12308
202205,3호선,남부터미널,24323,23890,48213
202205,3호선,녹번,11810,10009,21819
202205,3호선,대청,6822,6136,12958
202205,3호선,대치,10675,9594,20269
202205,3호선,도곡,3886,4173,8059
202205,3호선,독립문,7191,7954,15145
202205,3호선,동대입구,7728,9096,16824
202205,3호선,매봉,7192,7069,14261
202205,3호선,무악재,3066,3269,6335
202205,3호선,불광,14565,16373,30938
202205,3호선,수서,15823,15340,31163
202205,3호선,신사,28520,30670,59190
202205,3호선,안국,23503,25613,49116
202205,3호선,압구정,27311,29447,56758
202205,3호선,약수,10478,10011,20489
202205,3호선,양재,24968,27665,52633
202205,3호선,연신내,32352,30313,62665
202205,3호선,오금,4218,3916,8134
202205,3호선,옥수,8219,8068,16287
202205,3호선,을지로3가,6822,7448,14270
202205,3호선,일원,5723,5570,11293
202205,3호선,잠원,4242,3965,8207
202205,3호선,종로3가,7378,10902,18280
202205,3호선,지축,4188,3652,7840
202205,3호선,충무로,3,0,3
202205,3호선,학여울,1549,1471,3020
202205,3호선,홍제,15126,14204,29330
202205,3호선,가락시장,4262,4421,8683
202205,3호선,경복궁,19162,21074,40236
202205,3호선,경찰병원,2977,3058,6035
202205,3호선,고속터미널,49821,46475,96296
202205,3호선,교대,5157,3196,8353
202205,3호선,구파발,13020,13284,26304
202205,3호선,금호,4689,4383,9072
202205,3호선,남부터미널,16756,17988,34744
202205,3호선,녹번,8234,7377,15611
202205,3호선,대청,4777,4642,9419
202205,3호선,대치,6889,5996,12885
202205,3호선,도곡,2382,2543,4925
202205,3호선,독립문,4966,5698,10664
202205,3호선,동대입구,5944,6629,12573
202205,3호선,매봉,4821,4843,9664
202205,3호선,무악재,2107,2287,4394
202205,3호선,불광,10759,12248,23007
202205,3호선,수서,11139,11449,22588
202205,3호선,신사,15982,16055,32037
202205,3호선,안국,14815,15982,30797
202205,3호선,압구정,15486,16413,31899
202205,3호선,약수,7780,7538,15318
202205,3호선,양재,15516,18051,33567
202205,3호선,연신내,23119,21908,45027
202205,3호선,오금,3012,2937,5949
202205,3호선,옥수,5617,5739,11356
202205,3호선,을지로3가,4160,3832,7992
202205,3호선,일원,3844,4020,7864
202205,3호선,잠원,2617,2497,5114
202205,3호선,종로3가,5020,6400,11420
202205,3호선,지축,2792,2605,5397
202205,3호선,충무로,1,0,1
202205,3호선,학여울,1068,1058,2126
202205,3호선,홍제,10776,10440,21216
202205,3호선,가락시장,6812,6564,13376
202205,3호선,경복궁,30164,32186,62350
202205,3호선,경찰병원,4343,4124,8467
202205,3호선,고속터미널,57998,57665,115663
202205,3호선,교대,8503,5060,13563
202205,3호선,구파발,17684,18198,35882
202205,3호선,금호,6484,5786,12270
202205,3호선,남부터미널,23637,23177,46814
202205,3호선,녹번,11927,10388,22315
202205,3호선,대청,6623,6060,12683
202205,3호선,대치,10690,9522,20212
202205,3호선,도곡,4232,4423,8655
202205,3호선,독립문,7339,7948,15287
202205,3호선,동대입구,7793,9143,16936
202205,3호선,매봉,7259,7199,14458
202205,3호선,무악재,3211,3493,6704
202205,3호선,불광,14305,16046,30351
202205,3호선,수서,15035,14685,29720
202205,3호선,신사,25605,27888,53493
202205,3호선,안국,23872,24625,48497
202205,3호선,압구정,26891,28958,55849
202205,3호선,약수,10123,9525,19648
202205,3호선,양재,23202,25206,48408
202205,3호선,연신내,33148,30722,63870
202205,3호선,오금,4297,3940,8237
202205,3호선,옥수,8189,8293,16482
202205,3호선,을지로3가,6468,7248,13716
202205,3호선,일원,5327,5313,10640
202205,3호선,잠원,4257,4096,8353
202205,3호선,종로3가,6953,10311,17264
202205,3호선,지축,4171,3731,7902
202205,3호선,충무로,1,0,1
202205,3호선,학여울,2049,2096,4145
202205,3호선,홍제,15069,14191,29260
202205,3호선,가락시장,4163,4280,8443
202205,3호선,경복궁,20182,22880,43062
202205,3호선,경찰병원,3143,3243,6386
202205,3호선,고속터미널,45792,43881,89673
202205,3호선,교대,4928,3133,8061
202205,3호선,구파발,12650,13136,25786
202205,3호선,금호,4523,4323,8846
202205,3호선,남부터미널,16090,17132,33222
202205,3호선,녹번,8035,7150,15185
202205,3호선,대청,4591,4435,9026
202205,3호선,대치,6784,5964,12748
202205,3호선,도곡,2434,2661,5095
202205,3호선,독립문,4750,5070,9820
202205,3호선,동대입구,5241,5880,11121
202205,3호선,매봉,4607,4710,9317
202205,3호선,무악재,2122,2297,4419
202205,3호선,불광,10568,12133,22701
202205,3호선,수서,11446,11583,23029
202205,3호선,신사,13984,14106,28090
202205,3호선,안국,14837,15452,30289
202205,3호선,압구정,15243,15997,31240
202205,3호선,약수,7221,6962,14183
202205,3호선,양재,15447,17398,32845
202205,3호선,연신내,22716,21317,44033
202205,3호선,오금,3025,2963,5988
202205,3호선,옥수,5538,5800,11338
202205,3호선,을지로3가,4046,3741,7787
202205,3호선,일원,3826,3961,7787
202205,3호선,잠원,2501,2516,5017
202205,3호선,종로3가,4463,5677,10140
202205,3호선,지축,2826,2589,5415
202205,3호선,학여울,1443,1499,2942
202205,3호선,홍제,10232,9728,19960
202206,3호선,가락시장,6375,6023,12398
202206,3호선,경복궁,24674,28149,52823
202206,3호선,경찰병원,4101,3908,8009
202206,3호선,고속터미널,55319,62061,117380
202206,3호선,교대,7112,4543,11655
202206,3호선,구파발,16048,16249,32297
202206,3호선,금호,6130,5404,11534
202206,3호선,남부터미널,22926,24080,47006
202206,3호선,녹번,10990,9083,20073
202206,3호선,대청,6337,5554,11891
202206,3호선,대치,10232,9289,19521
202206,3호선,도곡,3334,3269,6603
202206,3호선,독립문,6610,7130,13740
202206,3호선,동대입구,8801,10180,18981
202206,3호선,매봉,6453,6280,12733
202206,3호선,무악재,2858,3007,5865
202206,3호선,불광,13586,14903,28489
202206,3호선,수서,14039,14092,28131
202206,3호선,신사,23728,25617,49345
202206,3호선,안국,21967,23261,45228
202206,3호선,압구정,24719,26477,51196
202206,3호선,약수,9516,8835,18351
202206,3호선,양재,20555,22131,42686
202206,3호선,연신내,29698,27821,57519
202206,3호선,오금,3990,3530,7520
202206,3호선,옥수,7482,7177,14659
202206,3호선,을지로3가,6041,6546,12587
202206,3호선,일원,5096,4814,9910
202206,3호선,잠원,3623,3344,6967
202206,3호선,종로3가,6398,9785,16183
202206,3호선,지축,3774,3392,7166
202206,3호선,충무로,1,0,1
202206,3호선,학여울,1343,1363,2706
202206,3호선,홍제,14094,12784,26878
202206,3호선,가락시장,3979,4201,8180
202206,3호선,경복궁,21381,24628,46009
202206,3호선,경찰병원,2892,2912,5804
202206,3호선,고속터미널,41690,40691,82381
202206,3호선,교대,4603,2653,7256
202206,3호선,구파발,12579,13027,25606
202206,3호선,금호,4367,3995,8362
202206,3호선,남부터미널,14467,14395,28862
202206,3호선,녹번,7830,6739,14569
202206,3호선,대청,4421,4067,8488
202206,3호선,대치,6508,5662,12170
202206,3호선,도곡,2001,2015,4016
202206,3호선,독립문,5623,5966,11589
202206,3호선,동대입구,7154,8164,15318
202206,3호선,매봉,4556,4509,9065
202206,3호선,무악재,2023,2107,4130
202206,3호선,불광,10422,11731,22153
202206,3호선,수서,10979,11162,22141
202206,3호선,신사,13453,14293,27746
202206,3호선,안국,17527,18559,36086
202206,3호선,압구정,14550,15572,30122
202206,3호선,약수,7140,6848,13988
202206,3호선,양재,13841,15037,28878
202206,3호선,연신내,22405,21227,43632
202206,3호선,오금,2780,2639,5419
202206,3호선,옥수,5223,5293,10516
202206,3호선,을지로3가,4439,4296,8735
202206,3호선,일원,3580,3616,7196
202206,3호선,잠원,2300,2244,4544
202206,3호선,종로3가,4551,6774,11325
202206,3호선,지축,2700,2435,5135
202206,3호선,충무로,1,0,1
202206,3호선,학여울,1201,1171,2372
202206,3호선,홍제,10044,9328,19372
202206,3호선,가락시장,7018,6517,13535
202206,3호선,경복궁,23779,27254,51033
202206,3호선,경찰병원,4455,4171,8626
202206,3호선,고속터미널,54181,53853,108034
202206,3호선,교대,8118,4916,13034
202206,3호선,구파발,17209,17272,34481
202206,3호선,금호,6308,5727,12035
202206,3호선,남부터미널,22910,22363,45273
202206,3호선,녹번,11481,9750,21231
202206,3호선,대청,6606,5992,12598
202206,3호선,대치,9901,8930,18831
202206,3호선,도곡,3905,4022,7927
202206,3호선,독립문,6801,7452,14253
202206,3호선,동대입구,8359,9630,17989
202206,3호선,매봉,7081,6833,13914
202206,3호선,무악재,2872,3044,5916
202206,3호선,불광,14302,15948,30250
202206,3호선,수서,15300,14985,30285
202206,3호선,신사,25507,27060,52567
202206,3호선,안국,19015,21089,40104
202206,3호선,압구정,26736,28391,55127
202206,3호선,약수,10023,9559,19582
202206,3호선,양재,23129,25245,48374
202206,3호선,연신내,31709,29478,61187
202206,3호선,오금,4174,3876,8050
202206,3호선,옥수,7932,7876,15808
202206,3호선,을지로3가,5987,6637,12624
202206,3호선,일원,5709,5431,11140
202206,3호선,잠원,3960,3721,7681
202206,3호선,종로3가,6683,10173,16856
202206,3호선,지축,4048,3633,7681
202206,3호선,충무로,1,0,1
202206,3호선,학여울,1986,2070,4056
202206,3호선,홍제,14661,13344,28005
202206,3호선,가락시장,3952,4216,8168
202206,3호선,경복궁,19823,22958,42781
202206,3호선,경찰병원,2887,2915,5802
202206,3호선,고속터미널,43597,41773,85370
202206,3호선,교대,4720,2891,7611
202206,3호선,구파발,12342,13067,25409
202206,3호선,금호,4505,4276,8781
202206,3호선,남부터미널,15740,16820,32560
202206,3호선,녹번,8075,7226,15301
202206,3호선,대청,4460,4484,8944
202206,3호선,대치,6439,5750,12189
202206,3호선,도곡,2096,2313,4409
202206,3호선,독립문,4880,5471,10351
202206,3호선,동대입구,5492,6203,11695
202206,3호선,매봉,4635,4630,9265
202206,3호선,무악재,2020,2154,4174
202206,3호선,불광,10488,11952,22440
202206,3호선,수서,11152,11291,22443
202206,3호선,신사,14351,14421,28772
202206,3호선,안국,13583,13113,26696
202206,3호선,압구정,15186,15590,30776
202206,3호선,약수,7388,7035,14423
202206,3호선,양재,14972,16872,31844
202206,3호선,연신내,22566,21431,43997
202206,3호선,오금,2948,2846,5794
202206,3호선,옥수,5435,5654,11089
202206,3호선,을지로3가,3746,3523,7269
202206,3호선,일원,3830,4035,7865
202206,3호선,잠원,2377,2353,4730
202206,3호선,종로3가,4395,5844,10239
202206,3호선,지축,2627,2495,5122
202206,3호선,충무로,2,0,2
202206,3호선,학여울,1666,1722,3388
202206,3호선,홍제,10161,9573,19734
202206,3호선,가락시장,6839,6536,13375
202206,3호선,경복궁,23101,27129,50230
202206,3호선,경찰병원,4388,4221,8609
202206,3호선,고속터미널,54974,55454,110428
202206,3호선,교대,8228,5009,13237
202206,3호선,구파발,17494,17669,35163
202206,3호선,금호,6442,5634,12076
202206,3호선,남부터미널,23449,22689,46138
202206,3호선,녹번,11633,9790,21423
202206,3호선,대청,6714,6048,12762
202206,3호선,대치,9610,8679,18289
202206,3호선,도곡,4198,4266,8464
202206,3호선,독립문,6389,6839,13228
202206,3호선,동대입구,8897,10651,19548
202206,3호선,매봉,7091,6831,13922
202206,3호선,무악재,2963,2965,5928
202206,3호선,불광,13727,15594,29321
202206,3호선,수서,15038,14920,29958
202206,3호선,신사,25401,27221,52622
202206,3호선,안국,19516,20868,40384
202206,3호선,압구정,26474,28214,54688
202206,3호선,약수,9898,9400,19298
202206,3호선,양재,23085,25038,48123
202206,3호선,연신내,31108,28917,60025
202206,3호선,오금,4412,4075,8487
202206,3호선,옥수,8172,8264,16436
202206,3호선,을지로3가,6020,6490,12510
202206,3호선,일원,5945,5544,11489
202206,3호선,잠원,3883,3680,7563
202206,3호선,종로3가,6848,10350,17198
202206,3호선,지축,4209,3827,8036
202206,3호선,충무로,2,0,2
202206,3호선,학여울,2438,2695,5133
202206,3호선,홍제,14828,13646,28474
202206,3호선,가락시장,3881,4108,7989
202206,3호선,경복궁,17595,20892,38487
202206,3호선,경찰병원,3034,3023,6057
202206,3호선,고속터미널,44622,42439,87061
202206,3호선,교대,4838,3073,7911
202206,3호선,구파발,12339,12989,25328
202206,3호선,금호,4418,4238,8656
202206,3호선,남부터미널,15604,16605,32209
202206,3호선,녹번,7873,7113,14986
202206,3호선,대청,4509,4485,8994
202206,3호선,대치,5984,5410,11394
202206,3호선,도곡,2103,2216,4319
202206,3호선,독립문,4597,4997,9594
202206,3호선,동대입구,5196,5833,11029
202206,3호선,매봉,4504,4564,9068
202206,3호선,무악재,2058,2188,4246
202206,3호선,불광,10327,11571,21898
202206,3호선,수서,11397,11023,22420
202206,3호선,신사,14132,14262,28394
202206,3호선,안국,13214,13085,26299
202206,3호선,압구정,15024,15725,30749
202206,3호선,약수,7055,6890,13945
202206,3호선,양재,14333,16333,30666
202206,3호선,연신내,22135,20877,43012
202206,3호선,오금,3081,3017,6098
202206,3호선,옥수,5504,5704,11208
202206,3호선,을지로3가,4003,3572,7575
202206,3호선,일원,3864,4049,7913
202206,3호선,잠원,2523,2442,4965
202206,3호선,종로3가,4386,5681,10067
202206,3호선,지축,2733,2580,5313
202206,3호선,충무로,2,0,2
202206,3호선,학여울,1558,1635,3193
202206,3호선,홍제,10348,9870,20218
202206,3호선,가락시장,6760,6506,13266
202206,3호선,경복궁,23407,26206,49613
202206,3호선,경찰병원,4359,4115,8474
202206,3호선,고속터미널,57225,57111,114336
202206,3호선,교대,8145,4911,13056
202206,3호선,구파발,17830,17581,35411
202206,3호선,금호,6414,5588,12002
202206,3호선,남부터미널,22559,22105,44664
202206,3호선,녹번,11438,9548,20986
202206,3호선,대청,6645,6116,12761
202206,3호선,대치,9207,8395,17602
202206,3호선,도곡,3885,3720,7605
202206,3호선,독립문,6632,7182,13814
202206,3호선,동대입구,7474,8549,16023
202206,3호선,매봉,6869,6661,13530
202206,3호선,무악재,3105,3122,6227
202206,3호선,불광,13862,15711,29573
202206,3호선,수서,14932,14767,29699
202206,3호선,신사,24968,26934,51902
202206,3호선,안국,20145,21167,41312
202206,3호선,압구정,26598,28759,55357
202206,3호선,약수,10017,9569,19586
202206,3호선,양재,22360,24142,46502
202206,3호선,연신내,31575,29110,60685
202206,3호선,오금,3906,3691,7597
202206,3호선,옥수,7629,7474,15103
202206,3호선,을지로3가,6102,6724,12826
202206,3호선,일원,5640,5376,11016
202206,3호선,잠원,3634,3369,7003
202206,3호선,종로3가,6739,9872,16611
202206,3호선,지축,4001,3564,7565
202206,3호선,학여울,2604,2713,5317
202206,3호선,홍제,14695,13491,28186
202206,3호선,가락시장,3802,3896,7698
202206,3호선,경복궁,15721,17704,33425
202206,3호선,경찰병원,2858,2841,5699
202206,3호선,고속터미널,46038,43530,89568
202206,3호선,교대,4699,2782,7481
202206,3호선,구파발,11792,12126,23918
202206,3호선,금호,4416,4199,8615
202206,3호선,남부터미널,15504,16357,31861
202206,3호선,녹번,7620,6875,14495
202206,3호선,대청,4363,4304,8667
202206,3호선,대치,5359,4944,10303
202206,3호선,도곡,1956,2128,4084
202206,3호선,독립문,4290,4534,8824
202206,3호선,동대입구,5069,5485,10554
202206,3호선,매봉,4537,4589,9126
202206,3호선,무악재,1954,1999,3953
202206,3호선,불광,9651,10772,20423
202206,3호선,수서,11075,11221,22296
202206,3호선,신사,13513,13546,27059
202206,3호선,안국,12188,12456,24644
202206,3호선,압구정,15312,15664,30976
202206,3호선,약수,7065,6777,13842
202206,3호선,양재,14585,16580,31165
202206,3호선,연신내,21443,20491,41934
202206,3호선,오금,2859,2858,5717
202206,3호선,옥수,4977,5175,10152
202206,3호선,을지로3가,3562,3469,7031
202206,3호선,일원,3879,3999,7878
202206,3호선,잠원,2428,2330,4758
202206,3호선,종로3가,4096,5351,9447
202206,3호선,지축,2558,2434,4992
202206,3호선,충무로,1,0,1
202206,3호선,학여울,1962,2076,4038
202206,3호선,홍제,9484,9073,18557
202207,3호선,가락시장,6548,6081,12629
202207,3호선,경복궁,23243,25024,48267
202207,3호선,경찰병원,4105,3847,7952
202207,3호선,고속터미널,56960,57248,114208
202207,3호선,교대,7584,4613,12197
202207,3호선,구파발,17433,17577,35010
202207,3호선,금호,6230,5573,11803
202207,3호선,남부터미널,23309,22944,46253
202207,3호선,녹번,11379,9817,21196
202207,3호선,대청,6181,5732,11913
202207,3호선,대치,8484,7908,16392
202207,3호선,도곡,3342,3369,6711
202207,3호선,독립문,6633,6536,13169
202207,3호선,동대입구,7035,7843,14878
202207,3호선,매봉,6712,6539,13251
202207,3호선,무악재,3129,3002,6131
202207,3호선,불광,13595,15517,29112
202207,3호선,수서,14490,14363,28853
202207,3호선,신사,25355,27062,52417
202207,3호선,안국,20045,21025,41070
202207,3호선,압구정,26357,28204,54561
202207,3호선,약수,10016,9362,19378
202207,3호선,양재,21293,23501,44794
202207,3호선,연신내,30844,28894,59738
202207,3호선,오금,4033,3661,7694
202207,3호선,옥수,7353,7365,14718
202207,3호선,을지로3가,6698,6776,13474
202207,3호선,일원,5464,5309,10773
202207,3호선,잠원,3569,3440,7009
202207,3호선,종로3가,6834,10154,16988
202207,3호선,지축,3691,3407,7098
202207,3호선,충무로,1,0,1
202207,3호선,학여울,1996,2075,4071
202207,3호선,홍제,14128,13420,27548
202207,3호선,가락시장,3973,4150,8123
202207,3호선,경복궁,15107,16676,31783
202207,3호선,경찰병원,2832,2924,5756
202207,3호선,고속터미널,46380,43634,90014
202207,3호선,교대,4706,2862,7568
202207,3호선,구파발,12753,13288,26041
202207,3호선,금호,4325,4184,8509
202207,3호선,남부터미널,15931,16316,32247
202207,3호선,녹번,7657,6810,14467
202207,3호선,대청,4215,4168,8383
202207,3호선,대치,5419,4983,10402
202207,3호선,도곡,1929,2014,3943
202207,3호선,독립문,4423,4587,9010
202207,3호선,동대입구,7525,8115,15640
202207,3호선,매봉,4439,4497,8936
202207,3호선,무악재,1923,2037,3960
202207,3호선,불광,10018,11592,21610
202207,3호선,수서,11027,10687,21714
202207,3호선,신사,13717,14053,27770
202207,3호선,안국,12360,12063,24423
202207,3호선,압구정,15016,15293,30309
202207,3호선,약수,7031,6814,13845
202207,3호선,양재,13463,15444,28907
202207,3호선,연신내,21977,20703,42680
202207,3호선,오금,2813,2821,5634
202207,3호선,옥수,4994,5279,10273
202207,3호선,을지로3가,3965,3590,7555
202207,3호선,일원,3849,4065,7914
202207,3호선,잠원,2474,2431,4905
202207,3호선,종로3가,4248,5440,9688
202207,3호선,지축,2613,2396,5009
202207,3호선,학여울,1380,1465,2845
202207,3호선,홍제,9676,9166,18842
202207,3호선,가락시장,6479,6012,12491
202207,3호선,경복궁,18270,20546,38816
202207,3호선,경찰병원,4315,4133,8448
202207,3호선,고속터미널,56574,56214,112788
202207,3호선,교대,7500,4649,12149
202207,3호선,구파발,17343,17489,34832
202207,3호선,금호,5963,5275,11238
202207,3호선,남부터미널,22342,21880,44222
202207,3호선,녹번,11323,9439,20762
202207,3호선,대청,6173,5620,11793
202207,3호선,대치,9965,8987,18952
202207,3호선,도곡,3410,3366,6776
202207,3호선,독립문,5881,6029,11910
202207,3호선,동대입구,6183,6986,13169
202207,3호선,매봉,6639,6385,13024
202207,3호선,무악재,2843,2840,5683
202207,3호선,불광,13581,15065,28646
202207,3호선,수서,14417,14120,28537
202207,3호선,신사,24746,26687,51433
202207,3호선,안국,16790,18199,34989
202207,3호선,압구정,26271,27897,54168
202207,3호선,약수,9489,8807,18296
202207,3호선,양재,20827,22872,43699
202207,3호선,연신내,30910,28611,59521
202207,3호선,오금,4117,3667,7784
202207,3호선,옥수,7442,7389,14831
202207,3호선,을지로3가,5479,5834,11313
202207,3호선,일원,5290,5252,10542
202207,3호선,잠원,3660,3461,7121
202207,3호선,종로3가,6371,9173,15544
202207,3호선,지축,3853,3607,7460
202207,3호선,학여울,2776,2831,5607
202207,3호선,홍제,13892,12590,26482
202207,3호선,가락시장,3752,4010,7762
202207,3호선,경복궁,14680,15816,30496
202207,3호선,경찰병원,2960,2976,5936
202207,3호선,고속터미널,47291,43582,90873
202207,3호선,교대,4788,2929,7717
202207,3호선,구파발,12896,13248,26144
202207,3호선,금호,4295,4177,8472
202207,3호선,남부터미널,15818,16647,32465
202207,3호선,녹번,7547,6799,14346
202207,3호선,대청,4290,4136,8426
202207,3호선,대치,6143,5432,11575
202207,3호선,도곡,1948,2010,3958
202207,3호선,독립문,4127,4369,8496
202207,3호선,동대입구,5237,5671,10908
202207,3호선,매봉,4503,4547,9050
202207,3호선,무악재,1872,1993,3865
202207,3호선,불광,9886,11473,21359
202207,3호선,수서,10684,10777,21461
202207,3호선,신사,13923,14083,28006
202207,3호선,안국,11627,11765,23392
202207,3호선,압구정,14896,15525,30421
202207,3호선,약수,6696,6503,13199
202207,3호선,양재,13700,15780,29480
202207,3호선,연신내,22357,21045,43402
202207,3호선,오금,2793,2685,5478
202207,3호선,옥수,5020,5290,10310
202207,3호선,을지로3가,3645,3351,6996
202207,3호선,일원,3661,3724,7385
202207,3호선,잠원,2173,2245,4418
202207,3호선,종로3가,4430,5612,10042
202207,3호선,지축,2744,2541,5285
202207,3호선,학여울,2132,2241,4373
202207,3호선,홍제,9603,9145,18748
202207,3호선,가락시장,6161,5817,11978
202207,3호선,경복궁,20201,21761,41962
202207,3호선,경찰병원,4058,3915,7973
202207,3호선,고속터미널,54662,54504,109166
202207,3호선,교대,7839,4782,12621
202207,3호선,구파발,16712,17227,33939
202207,3호선,금호,6113,5460,11573
202207,3호선,남부터미널,22900,22627,45527
202207,3호선,녹번,11077,9377,20454
202207,3호선,대청,6149,5655,11804
202207,3호선,대치,11851,10462,22313
202207,3호선,도곡,3375,3364,6739
202207,3호선,독립문,5865,5826,11691
202207,3호선,동대입구,6286,6870,13156
202207,3호선,매봉,6743,6475,13218
202207,3호선,무악재,2686,2711,5397
202207,3호선,불광,13067,14699,27766
202207,3호선,수서,13904,13919,27823
202207,3호선,신사,24145,26063,50208
202207,3호선,안국,19097,19099,38196
202207,3호선,압구정,26286,27768,54054
202207,3호선,약수,9452,9091,18543
202207,3호선,양재,20292,22657,42949
202207,3호선,연신내,29893,27607,57500
202207,3호선,오금,3701,3518,7219
202207,3호선,옥수,6932,7006,13938
202207,3호선,을지로3가,5778,6146,11924
202207,3호선,일원,5011,4878,9889
202207,3호선,잠원,3747,3546,7293
202207,3호선,종로3가,6735,9600,16335
202207,3호선,지축,3875,3591,7466
202207,3호선,학여울,2745,2856,5601
202207,3호선,홍제,13442,12646,26088
202207,3호선,가락시장,3876,4077,7953
202207,3호선,경복궁,14913,16386,31299
202207,3호선,경찰병원,2813,2855,5668
202207,3호선,고속터미널,45305,42587,87892
202207,3호선,교대,4842,2982,7824
202207,3호선,구파발,12397,12980,25377
202207,3호선,금호,4477,4145,8622
202207,3호선,남부터미널,14692,15354,30046
202207,3호선,녹번,7611,6753,14364
202207,3호선,대청,4238,4229,8467
202207,3호선,대치,7838,6588,14426
202207,3호선,도곡,1916,2080,3996
202207,3호선,독립문,4053,4275,8328
202207,3호선,동대입구,6470,7068,13538
202207,3호선,매봉,4167,4259,8426
202207,3호선,무악재,1880,1958,3838
202207,3호선,불광,9698,11169,20867
202207,3호선,수서,10874,10922,21796
202207,3호선,신사,13849,13928,27777
202207,3호선,안국,12540,12535,25075
202207,3호선,압구정,14897,15541,30438
202207,3호선,약수,6934,6715,13649
202207,3호선,양재,13584,15681,29265
202207,3호선,연신내,21548,20330,41878
202207,3호선,오금,2704,2756,5460
202207,3호선,옥수,5208,5326,10534
202207,3호선,을지로3가,3729,3505,7234
202207,3호선,일원,3589,3741,7330
202207,3호선,잠원,2181,2170,4351
202207,3호선,종로3가,4044,5477,9521
202207,3호선,지축,2661,2447,5108
202207,3호선,학여울,2038,2211,4249
202207,3호선,홍제,9365,9007,18372
202207,3호선,가락시장,5938,5663,11601
202207,3호선,경복궁,17497,19019,36516
202207,3호선,경찰병원,4020,3889,7909
202207,3호선,고속터미널,50934,51894,102828
202207,3호선,교대,7284,4642,11926
202207,3호선,구파발,15953,16227,32180
202207,3호선,금호,5795,5198,10993
202207,3호선,남부터미널,21214,20993,42207
202207,3호선,녹번,10248,8968,19216
202207,3호선,대청,5818,5357,11175
202207,3호선,대치,11196,9843,21039
202207,3호선,도곡,3191,3203,6394
202207,3호선,독립문,5902,5806,11708
202207,3호선,동대입구,6130,6842,12972
202207,3호선,매봉,6111,5990,12101
202207,3호선,무악재,2711,2778,5489
202207,3호선,불광,12729,14158,26887
202207,3호선,수서,13528,13719,27247
202207,3호선,신사,23296,24588,47884
202207,3호선,안국,17252,17738,34990
202207,3호선,압구정,25627,27401,53028
202207,3호선,약수,8883,8331,17214
202207,3호선,양재,18836,20439,39275
202207,3호선,연신내,29251,27228,56479
202207,3호선,오금,3769,3560,7329
202207,3호선,옥수,6720,6774,13494
202207,3호선,을지로3가,5315,5403,10718
202207,3호선,일원,5365,5226,10591
202207,3호선,잠원,3583,3523,7106
202207,3호선,종로3가,6402,8746,15148
202207,3호선,지축,3635,3246,6881
202207,3호선,충무로,5,0,5
202207,3호선,학여울,1394,1369,2763
202207,3호선,홍제,13009,12234,25243
202207,3호선,가락시장,3444,3674,7118
202207,3호선,경복궁,12673,14257,26930
202207,3호선,경찰병원,2747,2735,5482
202207,3호선,고속터미널,42236,40382,82618
202207,3호선,교대,4503,2682,7185
202207,3호선,구파발,11923,12225,24148
202207,3호선,금호,4229,3931,8160
202207,3호선,남부터미널,15196,15633,30829
202207,3호선,녹번,7160,6355,13515
202207,3호선,대청,3996,3938,7934
202207,3호선,대치,7463,6286,13749
202207,3호선,도곡,1934,2049,3983
202207,3호선,독립문,4058,4127,8185
202207,3호선,동대입구,4655,5096,9751
202207,3호선,매봉,4165,4175,8340
202207,3호선,무악재,1813,1901,3714
202207,3호선,불광,9416,10562,19978
202207,3호선,수서,10486,10599,21085
202207,3호선,신사,12266,12418,24684
202207,3호선,안국,12105,12323,24428
202207,3호선,압구정,14455,15174,29629
202207,3호선,약수,6600,6448,13048
202207,3호선,양재,12316,14281,26597
202207,3호선,연신내,20858,19765,40623
202207,3호선,오금,2633,2765,5398
202207,3호선,옥수,4740,4986,9726
202207,3호선,을지로3가,3529,3325,6854
202207,3호선,일원,3567,3778,7345
202207,3호선,잠원,2296,2216,4512
202207,3호선,종로3가,4021,5330,9351
202207,3호선,지축,2569,2292,4861
202207,3호선,학여울,1057,1056,2113
202207,3호선,홍제,8996,8587,17583
202207,3호선,가락시장,5475,5027,10502
202207,3호선,경복궁,15002,15999,31001
202207,3호선,경찰병원,3684,3594,7278
202207,3호선,고속터미널,50633,52156,102789
202207,3호선,교대,6320,4076,10396
202207,3호선,구파발,15162,15433,30595
202207,3호선,금호,5153,4606,9759
202207,3호선,남부터미널,19898,19737,39635
202207,3호선,녹번,9587,8088,17675
202207,3호선,대청,5293,4901,10194
202207,3호선,대치,10108,8929,19037
202207,3호선,도곡,2671,2657,5328
202207,3호선,독립문,5182,5070,10252
202207,3호선,동대입구,5983,6712,12695
202207,3호선,매봉,5520,5368,10888
202207,3호선,무악재,2507,2519,5026
202207,3호선,불광,11739,13177,24916
202207,3호선,수서,12482,12703,25185
202207,3호선,신사,21108,22070,43178
202207,3호선,안국,14979,16073,31052
202207,3호선,압구정,22646,24410,47056
202207,3호선,약수,8416,7807,16223
202207,3호선,양재,16441,18010,34451
202207,3호선,연신내,27231,25064,52295
202207,3호선,오금,3354,3241,6595
202207,3호선,옥수,6391,6007,12398
202207,3호선,을지로3가,5011,5055,10066
202207,3호선,일원,4607,4245,8852
202207,3호선,잠원,3002,2835,5837
202207,3호선,종로3가,5670,8063,13733
202207,3호선,지축,3215,3012,6227
202207,3호선,학여울,2544,2584,5128
202207,3호선,홍제,12303,10885,23188
202207,3호선,가락시장,3192,3431,6623
202207,3호선,경복궁,11347,12249,23596
202207,3호선,경찰병원,2512,2645,5157
202207,3호선,고속터미널,43773,39029,82802
202207,3호선,교대,4064,2616,6680
202207,3호선,구파발,10764,11241,22005
202207,3호선,금호,3632,3558,7190
202207,3호선,남부터미널,14414,14081,28495
202207,3호선,녹번,6430,5784,12214
202207,3호선,대청,3727,3758,7485
202207,3호선,대치,7135,6108,13243
202207,3호선,도곡,1680,1690,3370
202207,3호선,독립문,3794,3893,7687
202207,3호선,동대입구,4951,5235,10186
202207,3호선,매봉,3685,3674,7359
202207,3호선,무악재,1653,1786,3439
202207,3호선,불광,8427,9228,17655
202207,3호선,수서,9856,10111,19967
202207,3호선,신사,11632,11672,23304
202207,3호선,안국,11466,11006,22472
202207,3호선,압구정,13354,14185,27539
202207,3호선,약수,6146,5980,12126
202207,3호선,양재,10858,13041,23899
202207,3호선,연신내,18571,17794,36365
202207,3호선,오금,2402,2474,4876
202207,3호선,옥수,4244,4521,8765
202207,3호선,을지로3가,3494,3073,6567
202207,3호선,일원,3214,3292,6506
202207,3호선,잠원,1789,1935,3724
202207,3호선,종로3가,3804,5035,8839
202207,3호선,지축,2244,2046,4290
202207,3호선,충무로,1,0,1
202207,3호선,학여울,1661,1738,3399
202207,3호선,홍제,8012,7886,15898
202208,3호선,가락시장,5081,4926,10007
202208,3호선,경복궁,15332,16695,32027
202208,3호선,경찰병원,3802,3664,7466
202208,3호선,고속터미널,46662,47100,93762
202208,3호선,교대,6478,4000,10478
202208,3호선,구파발,14868,15259,30127
202208,3호선,금호,5184,4664,9848
202208,3호선,남부터미널,18752,18580,37332
202208,3호선,녹번,9776,8271,18047
202208,3호선,대청,5374,5008,10382
202208,3호선,대치,11024,9590,20614
202208,3호선,도곡,2802,2664,5466
202208,3호선,독립문,5219,5187,10406
202208,3호선,동대입구,6048,6796,12844
202208,3호선,매봉,5448,5422,10870
202208,3호선,무악재,2520,2504,5024
202208,3호선,불광,11700,13352,25052
202208,3호선,수서,12766,12676,25442
202208,3호선,신사,20504,21701,42205
202208,3호선,안국,14083,15284,29367
202208,3호선,압구정,22344,24051,46395
202208,3호선,약수,8581,8104,16685
202208,3호선,양재,16640,18044,34684
202208,3호선,연신내,27213,25277,52490
202208,3호선,오금,3463,3222,6685
202208,3호선,옥수,6191,6269,12460
202208,3호선,을지로3가,4764,4748,9512
202208,3호선,일원,4864,4704,9568
202208,3호선,잠원,2938,2810,5748
202208,3호선,종로3가,5711,7944,13655
202208,3호선,지축,3410,3129,6539
202208,3호선,충무로,3,0,3
202208,3호선,학여울,1374,1438,2812
202208,3호선,홍제,11956,11101,23057
202208,3호선,가락시장,3400,3562,6962
202208,3호선,경복궁,11358,13080,24438
202208,3호선,경찰병원,2616,2692,5308
202208,3호선,고속터미널,40409,37537,77946
202208,3호선,교대,3954,2535,6489
202208,3호선,구파발,11109,11493,22602
202208,3호선,금호,3971,3704,7675
202208,3호선,남부터미널,13971,14147,28118
202208,3호선,녹번,6680,6113,12793
202208,3호선,대청,3941,3897,7838
202208,3호선,대치,7187,6123,13310
202208,3호선,도곡,1671,1771,3442
202208,3호선,독립문,3740,3888,7628
202208,3호선,동대입구,4670,5154,9824
202208,3호선,매봉,3731,3814,7545
202208,3호선,무악재,1733,1800,3533
202208,3호선,불광,8836,10041,18877
202208,3호선,수서,9997,10259,20256
202208,3호선,신사,11905,12188,24093
202208,3호선,안국,10634,10868,21502
202208,3호선,압구정,12818,13453,26271
202208,3호선,약수,6410,6255,12665
202208,3호선,양재,11685,13594,25279
202208,3호선,연신내,19773,18790,38563
202208,3호선,오금,2613,2560,5173
202208,3호선,옥수,4530,4853,9383
202208,3호선,을지로3가,3408,2955,6363
202208,3호선,일원,3573,3724,7297
202208,3호선,잠원,2010,2040,4050
202208,3호선,종로3가,3844,5063,8907
202208,3호선,지축,2428,2353,4781
202208,3호선,학여울,959,973,1932
202208,3호선,홍제,8352,8007,16359
202208,3호선,가락시장,5501,5050,10551
202208,3호선,경복궁,13159,14018,27177
202208,3호선,경찰병원,3749,3524,7273
202208,3호선,고속터미널,45824,52480,98304
202208,3호선,교대,6222,3886,10108
202208,3호선,구파발,14153,14474,28627
202208,3호선,금호,5238,4714,9952
202208,3호선,남부터미널,19924,20677,40601
202208,3호선,녹번,9316,7873,17189
202208,3호선,대청,5425,4824,10249
202208,3호선,대치,10234,8843,19077
202208,3호선,도곡,2770,2670,5440
202208,3호선,독립문,5305,5175,10480
202208,3호선,동대입구,8395,9262,17657
202208,3호선,매봉,5402,5207,10609
202208,3호선,무악재,2549,2451,5000
202208,3호선,불광,11110,12017,23127
202208,3호선,수서,12760,12885,25645
202208,3호선,신사,20000,21340,41340
202208,3호선,안국,12678,14380,27058
202208,3호선,압구정,22820,24096,46916
202208,3호선,약수,8425,7753,16178
202208,3호선,양재,16226,17676,33902
202208,3호선,연신내,26309,24250,50559
202208,3호선,오금,3248,3078,6326
202208,3호선,옥수,5905,5783,11688
202208,3호선,을지로3가,4467,4679,9146
202208,3호선,일원,4586,4373,8959
202208,3호선,잠원,3126,2918,6044
202208,3호선,종로3가,5554,7819,13373
202208,3호선,지축,3289,2940,6229
202208,3호선,충무로,1,0,1
202208,3호선,학여울,1070,1010,2080
202208,3호선,홍제,11536,10731,22267
202208,3호선,가락시장,3377,3539,6916
202208,3호선,경복궁,13976,16171,30147
202208,3호선,경찰병원,2656,2619,5275
202208,3호선,고속터미널,37298,36876,74174
202208,3호선,교대,4271,2560,6831
202208,3호선,구파발,11566,12132,23698
202208,3호선,금호,4106,3734,7840
202208,3호선,남부터미널,14225,14133,28358
202208,3호선,녹번,7186,6330,13516
202208,3호선,대청,3864,3729,7593
202208,3호선,대치,6883,5887,12770
202208,3호선,도곡,1726,1734,3460
202208,3호선,독립문,5246,5374,10620
202208,3호선,동대입구,7039,7643,14682
202208,3호선,매봉,3921,3895,7816
202208,3호선,무악재,1790,1773,3563
202208,3호선,불광,9275,10415,19690
202208,3호선,수서,10180,10120,20300
202208,3호선,신사,11791,12574,24365
202208,3호선,안국,13200,13273,26473
202208,3호선,압구정,14133,14982,29115
202208,3호선,약수,6523,6347,12870
202208,3호선,양재,11558,12820,24378
202208,3호선,연신내,20941,20041,40982
202208,3호선,오금,2453,2570,5023
202208,3호선,옥수,4632,4786,9418
202208,3호선,을지로3가,3559,3618,7177
202208,3호선,일원,3377,3333,6710
202208,3호선,잠원,2049,1978,4027
202208,3호선,종로3가,4212,6218,10430
202208,3호선,지축,2561,2355,4916
202208,3호선,학여울,809,840,1649
202208,3호선,홍제,8899,8439,17338
202208,3호선,가락시장,6254,5884,12138
202208,3호선,경복궁,16792,18595,35387
202208,3호선,경찰병원,4115,3937,8052
202208,3호선,고속터미널,50219,50578,100797
202208,3호선,교대,7318,4465,11783
202208,3호선,구파발,16248,16528,32776
202208,3호선,금호,5889,5075,10964
202208,3호선,남부터미널,21417,20569,41986
202208,3호선,녹번,10465,8703,19168
202208,3호선,대청,5927,5573,11500
202208,3호선,대치,11220,9738,20958
202208,3호선,도곡,3026,3090,6116
202208,3호선,독립문,5865,6043,11908
202208,3호선,동대입구,7682,8595,16277
202208,3호선,매봉,6029,5833,11862
202208,3호선,무악재,2838,2725,5563
202208,3호선,불광,12447,13799,26246
202208,3호선,수서,13499,13205,26704
202208,3호선,신사,23538,25538,49076
202208,3호선,안국,16641,18566,35207
202208,3호선,압구정,25014,26762,51776
202208,3호선,약수,9136,8559,17695
202208,3호선,양재,19701,21715,41416
202208,3호선,연신내,29669,26957,56626
202208,3호선,오금,3639,3363,7002
202208,3호선,옥수,6651,6731,13382
202208,3호선,을지로3가,5212,5633,10845
202208,3호선,일원,5097,4828,9925
202208,3호선,잠원,3374,3255,6629
202208,3호선,종로3가,6288,8981,15269
202208,3호선,지축,3712,3466,7178
202208,3호선,충무로,1,0,1
202208,3호선,학여울,4506,4864,9370
202208,3호선,홍제,12923,12204,25127
202208,3호선,가락시장,3849,3901,7750
202208,3호선,경복궁,13114,14994,28108
202208,3호선,경찰병원,2918,3023,5941
202208,3호선,고속터미널,41237,39777,81014
202208,3호선,교대,4484,2718,7202
202208,3호선,구파발,12094,12710,24804
202208,3호선,금호,4119,3864,7983
202208,3호선,남부터미널,14043,14659,28702
202208,3호선,녹번,7108,6527,13635
202208,3호선,대청,4135,4165,8300
202208,3호선,대치,7452,6264,13716
202208,3호선,도곡,1923,2009,3932
202208,3호선,독립문,4150,4381,8531
202208,3호선,동대입구,5502,5960,11462
202208,3호선,매봉,4033,3975,8008
202208,3호선,무악재,1868,1915,3783
202208,3호선,불광,9734,10980,20714
202208,3호선,수서,10690,10741,21431
202208,3호선,신사,13636,13723,27359
202208,3호선,안국,11992,12299,24291
202208,3호선,압구정,14859,15382,30241
202208,3호선,약수,6912,6579,13491
202208,3호선,양재,13614,15666,29280
202208,3호선,연신내,21499,20356,41855
202208,3호선,오금,2925,2851,5776
202208,3호선,옥수,4817,4994,9811
202208,3호선,을지로3가,3628,3371,6999
202208,3호선,일원,3585,3724,7309
202208,3호선,잠원,2227,2233,4460
202208,3호선,종로3가,4160,5358,9518
202208,3호선,지축,2737,2532,5269
202208,3호선,학여울,3281,3596,6877
202208,3호선,홍제,9129,8646,17775
202208,3호선,가락시장,6946,6706,13652
202208,3호선,경복궁,19009,21848,40857
202208,3호선,경찰병원,4132,3960,8092
202208,3호선,고속터미널,70736,61116,131852
202208,3호선,교대,8226,5139,13365
202208,3호선,구파발,16729,17179,33908
202208,3호선,금호,6245,5621,11866
202208,3호선,남부터미널,23346,23031,46377
202208,3호선,녹번,11256,9500,20756
202208,3호선,대청,6398,5811,12209
202208,3호선,대치,11809,10424,22233
202208,3호선,도곡,3996,4293,8289
202208,3호선,독립문,6332,6729,13061
202208,3호선,동대입구,9343,10878,20221
202208,3호선,매봉,6604,6283,12887
202208,3호선,무악재,2974,2969,5943
202208,3호선,불광,13510,15281,28791
202208,3호선,수서,14697,14688,29385
202208,3호선,신사,25055,27196,52251
202208,3호선,안국,19386,21461,40847
202208,3호선,압구정,26743,28827,55570
202208,3호선,약수,9672,9224,18896
202208,3호선,양재,21823,24008,45831
202208,3호선,연신내,30759,28377,59136
202208,3호선,오금,3881,3589,7470
202208,3호선,옥수,7707,7574,15281
202208,3호선,을지로3가,5821,6282,12103
202208,3호선,일원,5990,5765,11755
202208,3호선,잠원,4127,3696,7823
202208,3호선,종로3가,6448,9584,16032
202208,3호선,지축,3984,3604,7588
202208,3호선,충무로,1,0,1
202208,3호선,학여울,4729,5239,9968
202208,3호선,홍제,14054,13244,27298
202208,3호선,가락시장,4109,4221,8330
202208,3호선,경복궁,15570,17795,33365
202208,3호선,경찰병원,2854,2960,5814
202208,3호선,고속터미널,49017,44899,93916
202208,3호선,교대,5019,3047,8066
202208,3호선,구파발,12546,13389,25935
202208,3호선,금호,4457,4267,8724
202208,3호선,남부터미널,16708,17290,33998
202208,3호선,녹번,7782,7095,14877
202208,3호선,대청,4367,4322,8689
202208,3호선,대치,7777,6494,14271
202208,3호선,도곡,2034,2195,4229
202208,3호선,독립문,4780,5087,9867
202208,3호선,동대입구,9033,9856,18889
202208,3호선,매봉,4235,4145,8380
202208,3호선,무악재,1978,2113,4091
202208,3호선,불광,10300,11442,21742
202208,3호선,수서,11148,11280,22428
202208,3호선,신사,14531,14574,29105
202208,3호선,안국,14213,14530,28743
202208,3호선,압구정,15644,16437,32081
202208,3호선,약수,7288,6973,14261
202208,3호선,양재,14198,16417,30615
202208,3호선,연신내,22432,21296,43728
202208,3호선,오금,2962,2935,5897
202208,3호선,옥수,5568,5798,11366
202208,3호선,을지로3가,4020,3607,7627
202208,3호선,일원,3976,4077,8053
202208,3호선,잠원,2698,2706,5404
202208,3호선,종로3가,4297,5676,9973
202208,3호선,지축,2904,2743,5647
202208,3호선,충무로,2,0,2
202208,3호선,학여울,3346,3784,7130
202208,3호선,홍제,10109,9747,19856
202209,3호선,가락시장,7228,6815,14043
202209,3호선,경복궁,21033,24316,45349
202209,3호선,경찰병원,4323,4109,8432
202209,3호선,고속터미널,58051,55470,113521
202209,3호선,교대,8062,4919,12981
202209,3호선,구파발,17384,18031,35415
202209,3호선,금호,6171,5560,11731
202209,3호선,남부터미널,22834,21606,44440
202209,3호선,녹번,11367,9539,20906
202209,3호선,대청,6575,6070,12645
202209,3호선,대치,11854,10501,22355
202209,3호선,도곡,3370,3592,6962
202209,3호선,독립문,6701,7131,13832
202209,3호선,동대입구,10128,11783,21911
202209,3호선,매봉,6638,6316,12954
202209,3호선,무악재,2878,2970,5848
202209,3호선,불광,13852,15373,29225
202209,3호선,수서,15266,14911,30177
202209,3호선,신사,25803,27834,53637
202209,3호선,안국,19210,21632,40842
202209,3호선,압구정,27832,29589,57421
202209,3호선,약수,9709,9265,18974
202209,3호선,양재,22553,24651,47204
202209,3호선,연신내,31586,29299,60885
202209,3호선,오금,4148,3970,8118
202209,3호선,옥수,7919,7765,15684
202209,3호선,을지로3가,5854,6224,12078
202209,3호선,일원,6001,5842,11843
202209,3호선,잠원,4082,4005,8087
202209,3호선,종로3가,6707,10096,16803
202209,3호선,지축,4245,3838,8083
202209,3호선,충무로,3,0,3
202209,3호선,학여울,1973,2106,4079
202209,3호선,홍제,14417,13338,27755
202209,3호선,가락시장,4129,4337,8466
202209,3호선,경복궁,10706,11351,22057
202209,3호선,경찰병원,2778,2883,5661
202209,3호선,고속터미널,41627,41510,83137
202209,3호선,교대,4531,2828,7359
202209,3호선,구파발,10392,10462,20854
202209,3호선,금호,3944,3770,7714
202209,3호선,남부터미널,13460,15027,28487
202209,3호선,녹번,6896,6204,13100
202209,3호선,대청,4011,3992,8003
202209,3호선,대치,7515,6207,13722
202209,3호선,도곡,1726,1999,3725
202209,3호선,독립문,3813,3962,7775
202209,3호선,동대입구,7368,7653,15021
202209,3호선,매봉,3935,4090,8025
202209,3호선,무악재,1808,1829,3637
202209,3호선,불광,8493,9436,17929
202209,3호선,수서,10692,10963,21655
202209,3호선,신사,12895,12527,25422
202209,3호선,안국,10141,10386,20527
202209,3호선,압구정,14111,14723,28834
202209,3호선,약수,6511,6391,12902
202209,3호선,양재,13531,15585,29116
202209,3호선,연신내,19385,18366,37751
202209,3호선,오금,2780,2727,5507
202209,3호선,옥수,4519,4806,9325
202209,3호선,을지로3가,3422,3087,6509
202209,3호선,일원,3718,3715,7433
202209,3호선,잠원,1928,1981,3909
202209,3호선,종로3가,4009,4818,8827
202209,3호선,지축,2466,2244,4710
202209,3호선,충무로,1,0,1
202209,3호선,학여울,1544,1679,3223
202209,3호선,홍제,8682,8295,16977
202209,3호선,가락시장,2337,2213,4550
202209,3호선,경복궁,19034,23252,42286
202209,3호선,경찰병원,1986,1944,3930
202209,3호선,고속터미널,24912,25395,50307
202209,3호선,교대,1960,1280,3240
202209,3호선,구파발,8981,9117,18098
202209,3호선,금호,3284,3035,6319
202209,3호선,남부터미널,9793,9429,19222
202209,3호선,녹번,5544,4950,10494
202209,3호선,대청,2748,2761,5509
202209,3호선,대치,5197,4595,9792
202209,3호선,도곡,957,1131,2088
202209,3호선,독립문,3150,3064,6214
202209,3호선,동대입구,3974,4503,8477
202209,3호선,매봉,2407,2397,4804
202209,3호선,무악재,1415,1524,2939
202209,3호선,불광,6367,7006,13373
202209,3호선,수서,8073,7937,16010
202209,3호선,신사,5915,6491,12406
202209,3호선,안국,12959,12773,25732
202209,3호선,압구정,5333,5776,11109
202209,3호선,약수,4580,4438,9018
202209,3호선,양재,6279,7421,13700
202209,3호선,연신내,15505,14864,30369
202209,3호선,오금,1778,1763,3541
202209,3호선,옥수,3772,3732,7504
202209,3호선,을지로3가,2309,2033,4342
202209,3호선,일원,2271,2175,4446
202209,3호선,잠원,1478,1455,2933
202209,3호선,종로3가,2965,4509,7474
202209,3호선,지축,1891,1746,3637
202209,3호선,학여울,426,426,852
202209,3호선,홍제,7314,6816,14130
202209,3호선,가락시장,3063,3114,6177
202209,3호선,경복궁,20828,26233,47061
202209,3호선,경찰병원,2281,2507,4788
202209,3호선,고속터미널,51587,32144,83731
202209,3호선,교대,3362,2237,5599
202209,3호선,구파발,11323,12073,23396
202209,3호선,금호,3902,3817,7719
202209,3호선,남부터미널,14208,10380,24588
202209,3호선,녹번,6665,6144,12809
202209,3호선,대청,3616,3640,7256
202209,3호선,대치,6592,5544,12136
202209,3호선,도곡,1434,1635,3069
202209,3호선,독립문,4299,4930,9229
202209,3호선,동대입구,4478,5599,10077
202209,3호선,매봉,3446,3489,6935
202209,3호선,무악재,1742,1874,3616
202209,3호선,불광,8865,10753,19618
202209,3호선,수서,10228,7873,18101
202209,3호선,신사,8724,10300,19024
202209,3호선,안국,16240,15920,32160
202209,3호선,압구정,9491,10450,19941
202209,3호선,약수,5726,5866,11592
202209,3호선,양재,9023,10794,19817
202209,3호선,연신내,19310,18832,38142
202209,3호선,오금,2179,2370,4549
202209,3호선,옥수,4706,4903,9609
202209,3호선,을지로3가,3531,3423,6954
202209,3호선,일원,2983,3034,6017
202209,3호선,잠원,2082,2059,4141
202209,3호선,종로3가,4067,6322,10389
202209,3호선,지축,2439,2202,4641
202209,3호선,충무로,1,0,1
202209,3호선,학여울,710,644,1354
202209,3호선,홍제,8482,8196,16678
202209,3호선,가락시장,6765,6484,13249
202209,3호선,경복궁,22045,25074,47119
202209,3호선,경찰병원,4497,4270,8767
202209,3호선,고속터미널,63239,57227,120466
202209,3호선,교대,8338,5134,13472
202209,3호선,구파발,17309,17700,35009
202209,3호선,금호,6335,5800,12135
202209,3호선,남부터미널,24174,22992,47166
202209,3호선,녹번,11623,9775,21398
202209,3호선,대청,6706,6130,12836
202209,3호선,대치,12303,10513,22816
202209,3호선,도곡,3699,4023,7722
202209,3호선,독립문,6580,7307,13887
202209,3호선,동대입구,8706,10063,18769
202209,3호선,매봉,6935,6483,13418
202209,3호선,무악재,3167,3216,6383
202209,3호선,불광,13724,15440,29164
202209,3호선,수서,15429,15225,30654
202209,3호선,신사,26679,28901,55580
202209,3호선,안국,20582,22863,43445
202209,3호선,압구정,28314,30492,58806
202209,3호선,약수,9877,9557,19434
202209,3호선,양재,23273,25408,48681
202209,3호선,연신내,30912,28740,59652
202209,3호선,오금,4164,4132,8296
202209,3호선,옥수,7864,7854,15718
202209,3호선,을지로3가,6087,6589,12676
202209,3호선,일원,6137,6072,12209
202209,3호선,잠원,3865,3681,7546
202209,3호선,종로3가,6883,10176,17059
202209,3호선,지축,4199,3869,8068
202209,3호선,충무로,3,0,3
202209,3호선,학여울,3418,3506,6924
202209,3호선,홍제,14502,13334,27836
202209,3호선,가락시장,4259,4491,8750
202209,3호선,경복궁,17270,19656,36926
202209,3호선,경찰병원,2953,3034,5987
202209,3호선,고속터미널,48699,46043,94742
202209,3호선,교대,5082,3070,8152
202209,3호선,구파발,13086,13694,26780
202209,3호선,금호,4477,4212,8689
202209,3호선,남부터미널,14728,16418,31146
202209,3호선,녹번,8116,7265,15381
202209,3호선,대청,4501,4351,8852
202209,3호선,대치,8027,6841,14868
202209,3호선,도곡,2107,2289,4396
202209,3호선,독립문,5029,5548,10577
202209,3호선,동대입구,5899,6573,12472
202209,3호선,매봉,4515,4432,8947
202209,3호선,무악재,2261,2506,4767
202209,3호선,불광,10484,12011,22495
202209,3호선,수서,11656,11968,23624
202209,3호선,신사,15139,15059,30198
202209,3호선,안국,15328,15382,30710
202209,3호선,압구정,15880,16667,32547
202209,3호선,약수,7200,6892,14092
202209,3호선,양재,14964,17059,32023
202209,3호선,연신내,22986,21210,44196
202209,3호선,오금,3010,3088,6098
202209,3호선,옥수,5576,5689,11265
202209,3호선,을지로3가,4146,3781,7927
202209,3호선,일원,4040,4083,8123
202209,3호선,잠원,2377,2339,4716
202209,3호선,종로3가,4600,5857,10457
202209,3호선,지축,2971,2759,5730
202209,3호선,학여울,2531,2750,5281
202209,3호선,홍제,10389,9582,19971
202209,3호선,가락시장,7315,7162,14477
202209,3호선,경복궁,29406,31402,60808
202209,3호선,경찰병원,4647,4417,9064
202209,3호선,고속터미널,64949,60751,125700
202209,3호선,교대,8960,5291,14251
202209,3호선,구파발,18240,19167,37407
202209,3호선,금호,6664,5992,12656
202209,3호선,남부터미널,24906,24127,49033
202209,3호선,녹번,12116,10662,22778
202209,3호선,대청,6884,6367,13251
202209,3호선,대치,11915,10311,22226
202209,3호선,도곡,3854,4114,7968
202209,3호선,독립문,7949,8732,16681
202209,3호선,동대입구,9718,10689,20407
202209,3호선,매봉,6814,6519,13333
202209,3호선,무악재,3159,3277,6436
202209,3호선,불광,15131,17200,32331
202209,3호선,수서,16249,16001,32250
202209,3호선,신사,26872,28982,55854
202209,3호선,안국,25639,27255,52894
202209,3호선,압구정,27984,30577,58561
202209,3호선,약수,10444,10011,20455
202209,3호선,양재,25943,28177,54120
202209,3호선,연신내,32615,30418,63033
202209,3호선,오금,4355,4040,8395
202209,3호선,옥수,8664,8466,17130
202209,3호선,을지로3가,6895,7106,14001
202209,3호선,일원,6474,6279,12753
202209,3호선,잠원,4615,4386,9001
202209,3호선,종로3가,7487,11053,18540
202209,3호선,지축,4504,4015,8519
202209,3호선,충무로,1,0,1
202209,3호선,학여울,2102,2164,4266
202209,3호선,홍제,15235,14472,29707
202209,3호선,가락시장,4272,4510,8782
202209,3호선,경복궁,19138,21514,40652
202209,3호선,경찰병원,3146,3166,6312
202209,3호선,고속터미널,51498,47890,99388
202209,3호선,교대,5242,3243,8485
202209,3호선,구파발,13237,13817,27054
202209,3호선,금호,4777,4394,9171
202209,3호선,남부터미널,17021,18470,35491
202209,3호선,녹번,8421,7506,15927
202209,3호선,대청,4683,4544,9227
202209,3호선,대치,7936,6509,14445
202209,3호선,도곡,2356,2578,4934
202209,3호선,독립문,5271,5878,11149
202209,3호선,동대입구,9035,9861,18896
202209,3호선,매봉,4479,4495,8974
202209,3호선,무악재,2138,2262,4400
202209,3호선,불광,10989,12405,23394
202209,3호선,수서,11711,12042,23753
202209,3호선,신사,15540,15750,31290
202209,3호선,안국,17140,17590,34730
202209,3호선,압구정,16567,17228,33795
202209,3호선,약수,7583,7264,14847
202209,3호선,양재,15755,18114,33869
202209,3호선,연신내,23468,21743,45211
202209,3호선,오금,3134,3117,6251
202209,3호선,옥수,5971,6214,12185
202209,3호선,을지로3가,4568,4123,8691
202209,3호선,일원,4062,4240,8302
202209,3호선,잠원,2616,2518,5134
202209,3호선,종로3가,4910,6146,11056
202209,3호선,지축,3118,2925,6043
202209,3호선,학여울,1512,1481,2993
202209,3호선,홍제,10833,10247,21080
202210,3호선,가락시장,6913,6566,13479
202210,3호선,경복궁,26206,29755,55961
202210,3호선,경찰병원,4490,4231,8721
202210,3호선,고속터미널,59124,62989,122113
202210,3호선,교대,8040,4875,12915
202210,3호선,구파발,16798,17567,34365
202210,3호선,금호,6414,5757,12171
202210,3호선,남부터미널,24407,25126,49533
202210,3호선,녹번,11584,9654,21238
202210,3호선,대청,6517,5926,12443
202210,3호선,대치,11023,9836,20859
202210,3호선,도곡,3779,3919,7698
202210,3호선,독립문,7039,7752,14791
202210,3호선,동대입구,7663,8813,16476
202210,3호선,매봉,6439,6144,12583
202210,3호선,무악재,2957,2975,5932
202210,3호선,불광,13975,15435,29410
202210,3호선,수서,15481,15390,30871
202210,3호선,신사,25879,27387,53266
202210,3호선,안국,23610,26445,50055
202210,3호선,압구정,27041,29260,56301
202210,3호선,약수,9834,9327,19161
202210,3호선,양재,22401,24633,47034
202210,3호선,연신내,31642,29080,60722
202210,3호선,오금,4155,3923,8078
202210,3호선,옥수,8008,7724,15732
202210,3호선,을지로3가,6308,6860,13168
202210,3호선,일원,6231,6025,12256
202210,3호선,잠원,4079,3725,7804
202210,3호선,종로3가,7118,10147,17265
202210,3호선,지축,4391,4075,8466
202210,3호선,충무로,2,0,2
202210,3호선,학여울,3355,3401,6756
202210,3호선,홍제,14516,13169,27685
202210,3호선,가락시장,4363,4658,9021
202210,3호선,경복궁,22035,23465,45500
202210,3호선,경찰병원,3032,3025,6057
202210,3호선,고속터미널,45878,44425,90303
202210,3호선,교대,4764,2929,7693
202210,3호선,구파발,12579,12882,25461
202210,3호선,금호,4700,4500,9200
202210,3호선,남부터미널,15328,15558,30886
202210,3호선,녹번,7996,6953,14949
202210,3호선,대청,4595,4331,8926
202210,3호선,대치,7452,6314,13766
202210,3호선,도곡,2049,2099,4148
202210,3호선,독립문,5509,5900,11409
202210,3호선,동대입구,6060,6951,13011
202210,3호선,매봉,4305,4233,8538
202210,3호선,무악재,2091,2189,4280
202210,3호선,불광,10317,11654,21971
202210,3호선,수서,11839,12322,24161
202210,3호선,신사,15025,15730,30755
202210,3호선,안국,21354,20800,42154
202210,3호선,압구정,16112,17178,33290
202210,3호선,약수,7288,7191,14479
202210,3호선,양재,14909,16252,31161
202210,3호선,연신내,22710,21413,44123
202210,3호선,오금,2874,2907,5781
202210,3호선,옥수,5341,5364,10705
202210,3호선,을지로3가,4935,4594,9529
202210,3호선,일원,3932,3968,7900
202210,3호선,잠원,2173,2209,4382
202210,3호선,종로3가,5234,7305,12539
202210,3호선,지축,3138,2792,5930
202210,3호선,학여울,2640,2712,5352
202210,3호선,홍제,10287,9719,20006
202210,3호선,가락시장,7196,6755,13951
202210,3호선,경복궁,29796,34035,63831
202210,3호선,경찰병원,4649,4424,9073
202210,3호선,고속터미널,63442,66498,129940
202210,3호선,교대,8560,4913,13473
202210,3호선,구파발,17806,17977,35783
202210,3호선,금호,7075,6396,13471
202210,3호선,남부터미널,25837,25738,51575
202210,3호선,녹번,12168,10187,22355
202210,3호선,대청,8279,7677,15956
202210,3호선,대치,11680,10086,21766
202210,3호선,도곡,3884,3917,7801
202210,3호선,독립문,7559,8429,15988
202210,3호선,동대입구,10295,12356,22651
202210,3호선,매봉,6908,6459,13367
202210,3호선,무악재,3117,3189,6306
202210,3호선,불광,14811,16282,31093
202210,3호선,수서,16181,16145,32326
202210,3호선,신사,27330,29102,56432
202210,3호선,안국,29484,32056,61540
202210,3호선,압구정,28293,30025,58318
202210,3호선,약수,10583,9894,20477
202210,3호선,양재,24142,25937,50079
202210,3호선,연신내,32850,30334,63184
202210,3호선,오금,4357,4151,8508
202210,3호선,옥수,8886,8803,17689
202210,3호선,을지로3가,6706,7015,13721
202210,3호선,일원,6055,5719,11774
202210,3호선,잠원,4198,3878,8076
202210,3호선,종로3가,7667,10941,18608
202210,3호선,지축,4725,4135,8860
202210,3호선,충무로,4,0,4
202210,3호선,학여울,3233,3334,6567
202210,3호선,홍제,15601,14320,29921
202210,3호선,가락시장,3995,4290,8285
202210,3호선,경복궁,18379,19142,37521
202210,3호선,경찰병원,2905,2998,5903
202210,3호선,고속터미널,47948,46516,94464
202210,3호선,교대,4616,2781,7397
202210,3호선,구파발,10756,11005,21761
202210,3호선,금호,4556,4445,9001
202210,3호선,남부터미널,15241,15733,30974
202210,3호선,녹번,7700,6747,14447
202210,3호선,대청,4232,3996,8228
202210,3호선,대치,7005,5897,12902
202210,3호선,도곡,1721,1651,3372
202210,3호선,독립문,5075,5184,10259
202210,3호선,동대입구,6756,7370,14126
202210,3호선,매봉,4016,4185,8201
202210,3호선,무악재,1964,1946,3910
202210,3호선,불광,9209,10361,19570
202210,3호선,수서,11658,11772,23430
202210,3호선,신사,14389,15268,29657
202210,3호선,안국,18410,18041,36451
202210,3호선,압구정,14833,16031,30864
202210,3호선,약수,7258,6903,14161
202210,3호선,양재,14649,15706,30355
202210,3호선,연신내,20824,19816,40640
202210,3호선,오금,2826,2717,5543
202210,3호선,옥수,4950,5026,9976
202210,3호선,을지로3가,4888,4647,9535
202210,3호선,일원,3549,3544,7093
202210,3호선,잠원,2038,2015,4053
202210,3호선,종로3가,4684,6520,11204
202210,3호선,지축,2741,2588,5329
202210,3호선,학여울,2893,2888,5781
202210,3호선,홍제,9802,9117,18919
202210,3호선,가락시장,7096,6920,14016
202210,3호선,경복궁,27249,30531,57780
202210,3호선,경찰병원,4690,4602,9292
202210,3호선,고속터미널,56313,56897,113210
202210,3호선,교대,8996,5421,14417
202210,3호선,구파발,17954,18378,36332
202210,3호선,금호,7078,6500,13578
202210,3호선,남부터미널,25485,25470,50955
202210,3호선,녹번,12176,10356,22532
202210,3호선,대청,6988,6424,13412
202210,3호선,대치,11704,10282,21986
202210,3호선,도곡,4128,4251,8379
202210,3호선,독립문,7335,8305,15640
202210,3호선,동대입구,11521,13351,24872
202210,3호선,매봉,7189,6810,13999
202210,3호선,무악재,3108,3236,6344
202210,3호선,불광,14554,16330,30884
202210,3호선,수서,16626,16458,33084
202210,3호선,신사,26662,28359,55021
202210,3호선,안국,26748,30154,56902
202210,3호선,압구정,28272,30365,58637
202210,3호선,약수,10725,10168,20893
202210,3호선,양재,25143,27640,52783
202210,3호선,연신내,32081,29911,61992
202210,3호선,오금,4719,4534,9253
202210,3호선,옥수,8374,8289,16663
202210,3호선,을지로3가,6819,6882,13701
202210,3호선,일원,7062,6763,13825
202210,3호선,잠원,4337,3958,8295
202210,3호선,종로3가,7447,10488,17935
202210,3호선,지축,4634,4309,8943
202210,3호선,학여울,1856,1925,3781
202210,3호선,홍제,15207,14291,29498
202210,3호선,가락시장,4335,4560,8895
202210,3호선,경복궁,19244,22134,41378
202210,3호선,경찰병원,3233,3274,6507
202210,3호선,고속터미널,47638,44253,91891
202210,3호선,교대,5788,3498,9286
202210,3호선,구파발,12907,13516,26423
202210,3호선,금호,5083,4829,9912
202210,3호선,남부터미널,16938,17900,34838
202210,3호선,녹번,8025,7198,15223
202210,3호선,대청,4748,4527,9275
202210,3호선,대치,7614,6570,14184
202210,3호선,도곡,2246,2443,4689
202210,3호선,독립문,5088,5684,10772
202210,3호선,동대입구,8812,9759,18571
202210,3호선,매봉,4554,4458,9012
202210,3호선,무악재,2174,2314,4488
202210,3호선,불광,10540,12110,22650
202210,3호선,수서,12177,12266,24443
202210,3호선,신사,15335,15739,31074
202210,3호선,안국,17758,18968,36726
202210,3호선,압구정,16557,17197,33754
202210,3호선,약수,7872,7503,15375
202210,3호선,양재,16016,18148,34164
202210,3호선,연신내,23086,21622,44708
202210,3호선,오금,3217,3181,6398
202210,3호선,옥수,5474,5722,11196
202210,3호선,을지로3가,4436,3912,8348
202210,3호선,일원,4326,4497,8823
202210,3호선,잠원,2418,2443,4861
202210,3호선,종로3가,4561,6009,10570
202210,3호선,지축,3150,2916,6066
202210,3호선,충무로,1,0,1
202210,3호선,학여울,1412,1433,2845
202210,3호선,홍제,10358,10016,20374
202210,3호선,가락시장,6988,6885,13873
202210,3호선,경복궁,32723,36063,68786
202210,3호선,경찰병원,4610,4345,8955
202210,3호선,고속터미널,58580,58170,116750
202210,3호선,교대,8545,5233,13778
202210,3호선,구파발,19227,19947,39174
202210,3호선,금호,7061,6374,13435
202210,3호선,남부터미널,24658,24291,48949
202210,3호선,녹번,12291,10711,23002
202210,3호선,대청,6937,6438,13375
202210,3호선,대치,11740,10440,22180
202210,3호선,도곡,3781,3994,7775
202210,3호선,독립문,7896,8645,16541
202210,3호선,동대입구,12494,14638,27132
202210,3호선,매봉,6687,6479,13166
202210,3호선,무악재,3261,3466,6727
202210,3호선,불광,14792,16969,31761
202210,3호선,수서,16304,16163,32467
202210,3호선,신사,26617,28939,55556
202210,3호선,안국,30930,34450,65380
202210,3호선,압구정,28271,30543,58814
202210,3호선,약수,11004,10348,21352
202210,3호선,양재,25459,27712,53171
202210,3호선,연신내,33306,31362,64668
202210,3호선,오금,4330,4119,8449
202210,3호선,옥수,8282,8183,16465
202210,3호선,을지로3가,8004,7837,15841
202210,3호선,일원,6142,5998,12140
202210,3호선,잠원,4276,3986,8262
202210,3호선,종로3가,7755,10829,18584
202210,3호선,지축,4980,4468,9448
202210,3호선,충무로,4,0,4
202210,3호선,학여울,2924,3033,5957
202210,3호선,홍제,15840,15158,30998
202210,3호선,가락시장,4206,4377,8583
202210,3호선,경복궁,22621,24529,47150
202210,3호선,경찰병원,3004,3161,6165
202210,3호선,고속터미널,49547,45914,95461
202210,3호선,교대,5411,3269,8680
202210,3호선,구파발,13852,14437,28289
202210,3호선,금호,5170,5046,10216
202210,3호선,남부터미널,17455,18413,35868
202210,3호선,녹번,8342,7458,15800
202210,3호선,대청,4644,4527,9171
202210,3호선,대치,7833,6574,14407
202210,3호선,도곡,2127,2367,4494
202210,3호선,독립문,5211,5943,11154
202210,3호선,동대입구,9241,10585,19826
202210,3호선,매봉,4562,4558,9120
202210,3호선,무악재,2151,2335,4486
202210,3호선,불광,10739,12600,23339
202210,3호선,수서,12006,12137,24143
202210,3호선,신사,15308,15652,30960
202210,3호선,안국,21706,22648,44354
202210,3호선,압구정,16725,17603,34328
202210,3호선,약수,7962,7733,15695
202210,3호선,양재,16117,18289,34406
202210,3호선,연신내,23606,22029,45635
202210,3호선,오금,2990,3104,6094
202210,3호선,옥수,5776,5925,11701
202210,3호선,을지로3가,4685,4199,8884
202210,3호선,일원,4224,4353,8577
202210,3호선,잠원,2749,2876,5625
202210,3호선,종로3가,4993,6107,11100
202210,3호선,지축,3287,3114,6401
202210,3호선,충무로,2,0,2
202210,3호선,학여울,2321,2528,4849
202210,3호선,홍제,10547,10165,20712
202210,3호선,가락시장,7438,7079,14517
202210,3호선,경복궁,37723,39786,77509
202210,3호선,경찰병원,4959,4714,9673
202210,3호선,고속터미널,59658,59574,119232
202210,3호선,교대,9204,5319,14523
202210,3호선,구파발,19307,19795,39102
202210,3호선,금호,7349,6768,14117
202210,3호선,남부터미널,25983,25670,51653
202210,3호선,녹번,12402,11011,23413
202210,3호선,대청,7287,6684,13971
202210,3호선,대치,11847,10458,22305
202210,3호선,도곡,4054,4443,8497
202210,3호선,독립문,8176,8906,17082
202210,3호선,동대입구,11625,13924,25549
202210,3호선,매봉,7161,6773,13934
202210,3호선,무악재,3630,3547,7177
202210,3호선,불광,14731,16931,31662
202210,3호선,수서,16918,16662,33580
202210,3호선,신사,26843,29757,56600
202210,3호선,안국,34497,37112,71609
202210,3호선,압구정,28049,30498,58547
202210,3호선,약수,11534,12174,23708
202210,3호선,양재,24859,27316,52175
202210,3호선,연신내,34264,31737,66001
202210,3호선,오금,4735,4422,9157
202210,3호선,옥수,8638,8387,17025
202210,3호선,을지로3가,8213,8311,16524
202210,3호선,일원,6629,6211,12840
202210,3호선,잠원,4484,4193,8677
202210,3호선,종로3가,7763,11354,19117
202210,3호선,지축,4990,4498,9488
202210,3호선,충무로,1,0,1
202210,3호선,학여울,3289,3436,6725
202210,3호선,홍제,15981,14801,30782
202210,3호선,가락시장,4302,4453,8755
202210,3호선,경복궁,22864,26549,49413
202210,3호선,경찰병원,3067,3207,6274
202210,3호선,고속터미널,48668,46693,95361
202210,3호선,교대,5319,3156,8475
202210,3호선,구파발,13808,14550,28358
202210,3호선,금호,5223,5031,10254
202210,3호선,남부터미널,17271,18813,36084
202210,3호선,녹번,8195,7456,15651
202210,3호선,대청,4504,4574,9078
202210,3호선,대치,7749,6538,14287
202210,3호선,도곡,2312,2569,4881
202210,3호선,독립문,5025,5780,10805
202210,3호선,동대입구,6886,8128,15014
202210,3호선,매봉,4371,4254,8625
202210,3호선,무악재,2228,2442,4670
202210,3호선,불광,11476,13167,24643
202210,3호선,수서,11843,12252,24095
202210,3호선,신사,15728,15492,31220
202210,3호선,안국,21384,22695,44079
202210,3호선,압구정,16346,16753,33099
202210,3호선,약수,7889,7422,15311
202210,3호선,양재,16087,17971,34058
202210,3호선,연신내,23210,21742,44952
202210,3호선,오금,3007,3073,6080
202210,3호선,옥수,5762,5912,11674
202210,3호선,을지로3가,4661,4226,8887
202210,3호선,일원,4018,4329,8347
202210,3호선,잠원,2710,2613,5323
202210,3호선,종로3가,4856,6235,11091
202210,3호선,지축,3385,3047,6432
202210,3호선,학여울,2473,2600,5073
202210,3호선,홍제,10806,10436,21242
202211,3호선,가락시장,6972,6706,13678
202211,3호선,경복궁,29740,33642,63382
202211,3호선,경찰병원,4832,4548,9380
202211,3호선,고속터미널,56560,58118,114678
202211,3호선,교대,8473,5034,13507
202211,3호선,구파발,17758,18087,35845
202211,3호선,금호,6429,5734,12163
202211,3호선,남부터미널,24223,23791,48014
202211,3호선,녹번,11598,10017,21615
202211,3호선,대청,6482,6077,12559
202211,3호선,대치,11033,9823,20856
202211,3호선,도곡,3681,3893,7574
202211,3호선,독립문,6697,7530,14227
202211,3호선,동대입구,9107,10953,20060
202211,3호선,매봉,6907,6652,13559
202211,3호선,무악재,3085,3123,6208
202211,3호선,불광,14487,16230,30717
202211,3호선,수서,15483,15249,30732
202211,3호선,신사,26143,27807,53950
202211,3호선,안국,29678,33701,63379
202211,3호선,압구정,26639,28832,55471
202211,3호선,약수,10114,9547,19661
202211,3호선,양재,23425,25457,48882
202211,3호선,연신내,31525,29648,61173
202211,3호선,오금,4572,4449,9021
202211,3호선,옥수,7945,7904,15849
202211,3호선,을지로3가,6532,6765,13297
202211,3호선,일원,5753,5638,11391
202211,3호선,잠원,3958,3718,7676
202211,3호선,종로3가,7555,10261,17816
202211,3호선,지축,4462,4302,8764
202211,3호선,충무로,3,0,3
202211,3호선,학여울,2124,2296,4420
202211,3호선,홍제,15300,14038,29338
202211,3호선,가락시장,4399,4677,9076
202211,3호선,경복궁,23152,26508,49660
202211,3호선,경찰병원,3232,3300,6532
202211,3호선,고속터미널,49738,46007,95745
202211,3호선,교대,5320,3180,8500
202211,3호선,구파발,13090,13535,26625
202211,3호선,금호,4885,4519,9404
202211,3호선,남부터미널,17487,18265,35752
202211,3호선,녹번,8313,7364,15677
202211,3호선,대청,4715,4682,9397
202211,3호선,대치,7862,6794,14656
202211,3호선,도곡,2376,2616,4992
202211,3호선,독립문,4933,5615,10548
202211,3호선,동대입구,8365,9652,18017
202211,3호선,매봉,4634,4515,9149
202211,3호선,무악재,2231,2299,4530
202211,3호선,불광,10405,11902,22307
202211,3호선,수서,12089,12220,24309
202211,3호선,신사,14960,15254,30214
202211,3호선,안국,21644,22884,44528
202211,3호선,압구정,15675,16426,32101
202211,3호선,약수,7664,7423,15087
202211,3호선,양재,16316,18790,35106
202211,3호선,연신내,22767,21149,43916
202211,3호선,오금,3167,3079,6246
202211,3호선,옥수,5464,5644,11108
202211,3호선,을지로3가,4706,4362,9068
202211,3호선,일원,4127,4308,8435
202211,3호선,잠원,2534,2406,4940
202211,3호선,종로3가,4764,6086,10850
202211,3호선,지축,3181,2939,6120
202211,3호선,충무로,4,0,4
202211,3호선,학여울,1024,1039,2063
202211,3호선,홍제,11106,10490,21596
202211,3호선,가락시장,6913,6669,13582
202211,3호선,경복궁,26429,25943,52372
202211,3호선,경찰병원,4566,4550,9116
202211,3호선,고속터미널,56868,57846,114714
202211,3호선,교대,8548,4993,13541
202211,3호선,구파발,16282,16796,33078
202211,3호선,금호,6253,5640,11893
202211,3호선,남부터미널,24287,24587,48874
202211,3호선,녹번,11554,10271,21825
202211,3호선,대청,6409,5959,12368
202211,3호선,대치,9298,8618,17916
202211,3호선,도곡,3733,3638,7371
202211,3호선,독립문,7048,7210,14258
202211,3호선,동대입구,9211,10277,19488
202211,3호선,매봉,6779,6568,13347
202211,3호선,무악재,3463,3440,6903
202211,3호선,불광,13505,14992,28497
202211,3호선,수서,15955,15671,31626
202211,3호선,신사,24780,26387,51167
202211,3호선,안국,29217,29485,58702
202211,3호선,압구정,27679,29576,57255
202211,3호선,약수,10064,9583,19647
202211,3호선,양재,23814,25569,49383
202211,3호선,연신내,29886,28389,58275
202211,3호선,오금,4044,3836,7880
202211,3호선,옥수,7256,7443,14699
202211,3호선,을지로3가,7551,7572,15123
202211,3호선,일원,5835,5732,11567
202211,3호선,잠원,3855,3689,7544
202211,3호선,종로3가,7176,9748,16924
202211,3호선,지축,4192,3902,8094
202211,3호선,학여울,3113,3173,6286
202211,3호선,홍제,14560,14293,28853
202211,3호선,가락시장,4218,4386,8604
202211,3호선,경복궁,16779,18793,35572
202211,3호선,경찰병원,2934,3055,5989
202211,3호선,고속터미널,48711,44825,93536
202211,3호선,교대,5042,3073,8115
202211,3호선,구파발,11835,12186,24021
202211,3호선,금호,4527,4293,8820
202211,3호선,남부터미널,17630,18506,36136
202211,3호선,녹번,7769,6953,14722
202211,3호선,대청,4377,4278,8655
202211,3호선,대치,5953,5368,11321
202211,3호선,도곡,2071,2130,4201
202211,3호선,독립문,4497,4828,9325
202211,3호선,동대입구,5770,6679,12449
202211,3호선,매봉,4188,4170,8358
202211,3호선,무악재,2147,2218,4365
202211,3호선,불광,9854,10926,20780
202211,3호선,수서,11419,11584,23003
202211,3호선,신사,15232,15249,30481
202211,3호선,안국,18232,19135,37367
202211,3호선,압구정,15876,16667,32543
202211,3호선,약수,7106,6906,14012
202211,3호선,양재,15311,17396,32707
202211,3호선,연신내,21591,20579,42170
202211,3호선,오금,3116,3025,6141
202211,3호선,옥수,5156,5355,10511
202211,3호선,을지로3가,4279,4011,8290
202211,3호선,일원,3760,3798,7558
202211,3호선,잠원,2512,2375,4887
202211,3호선,종로3가,4535,5661,10196
202211,3호선,지축,3041,2853,5894
202211,3호선,학여울,2251,2353,4604
202211,3호선,홍제,9903,9491,19394
202211,3호선,가락시장,7347,7000,14347
202211,3호선,경복궁,25869,27141,53010
202211,3호선,경찰병원,4735,4557,9292
202211,3호선,고속터미널,58131,58076,116207
202211,3호선,교대,8492,5170,13662
202211,3호선,구파발,16961,17435,34396
202211,3호선,금호,6403,5653,12056
202211,3호선,남부터미널,25246,25250,50496
202211,3호선,녹번,11949,10359,22308
202211,3호선,대청,6825,6307,13132
202211,3호선,대치,9852,9482,19334
202211,3호선,도곡,3822,3855,7677
202211,3호선,독립문,7163,7620,14783
202211,3호선,동대입구,10126,12019,22145
202211,3호선,매봉,6895,6662,13557
202211,3호선,무악재,3414,3421,6835
202211,3호선,불광,13850,15569,29419
202211,3호선,수서,16280,16203,32483
202211,3호선,신사,26116,27970,54086
202211,3호선,안국,26976,30279,57255
202211,3호선,압구정,28811,31005,59816
202211,3호선,약수,10165,9628,19793
202211,3호선,양재,23316,25457,48773
202211,3호선,연신내,31016,29258,60274
202211,3호선,오금,4385,4250,8635
202211,3호선,옥수,7830,7705,15535
202211,3호선,을지로3가,6757,7242,13999
202211,3호선,일원,5984,5759,11743
202211,3호선,잠원,4017,3786,7803
202211,3호선,종로3가,6980,10329,17309
202211,3호선,지축,4631,4195,8826
202211,3호선,충무로,1,0,1
202211,3호선,학여울,1411,1398,2809
202211,3호선,홍제,14917,14123,29040
202211,3호선,가락시장,4423,4622,9045
202211,3호선,경복궁,17933,20623,38556
202211,3호선,경찰병원,3131,3262,6393
202211,3호선,고속터미널,50145,46328,96473
202211,3호선,교대,5030,3072,8102
202211,3호선,구파발,12690,13528,26218
202211,3호선,금호,4838,4502,9340
202211,3호선,남부터미널,17795,18663,36458
202211,3호선,녹번,8400,7575,15975
202211,3호선,대청,4754,4766,9520
202211,3호선,대치,6164,5874,12038
202211,3호선,도곡,2434,2409,4843
202211,3호선,독립문,4931,5554,10485
202211,3호선,동대입구,13506,13628,27134
202211,3호선,매봉,4627,4641,9268
202211,3호선,무악재,2384,2478,4862
202211,3호선,불광,10425,11903,22328
202211,3호선,수서,12356,12968,25324
202211,3호선,신사,14939,15449,30388
202211,3호선,안국,19240,20286,39526
202211,3호선,압구정,16925,17683,34608
202211,3호선,약수,7841,7547,15388
202211,3호선,양재,15944,18041,33985
202211,3호선,연신내,22332,21032,43364
202211,3호선,오금,3199,3085,6284
202211,3호선,옥수,5642,5869,11511
202211,3호선,을지로3가,4639,4192,8831
202211,3호선,일원,4085,4132,8217
202211,3호선,잠원,2570,2461,5031
202211,3호선,종로3가,4610,5814,10424
202211,3호선,지축,3204,2970,6174
202211,3호선,충무로,2,0,2
202211,3호선,학여울,1084,1109,2193
202211,3호선,홍제,10572,9957,20529
202211,3호선,가락시장,7172,6965,14137
202211,3호선,경복궁,25219,25693,50912
202211,3호선,경찰병원,4620,4435,9055
202211,3호선,고속터미널,59108,59698,118806
202211,3호선,교대,8848,5504,14352
202211,3호선,구파발,16872,17143,34015
202211,3호선,금호,6330,5787,12117
202211,3호선,남부터미널,23993,24342,48335
202211,3호선,녹번,12070,10340,22410
202211,3호선,대청,6842,6206,13048
202211,3호선,대치,9655,8911,18566
202211,3호선,도곡,4121,4408,8529
202211,3호선,독립문,6977,7490,14467
202211,3호선,동대입구,10356,11976,22332
202211,3호선,매봉,7092,6917,14009
202211,3호선,무악재,3327,3384,6711
202211,3호선,불광,14043,15445,29488
202211,3호선,수서,16312,16005,32317
202211,3호선,신사,26806,28414,55220
202211,3호선,안국,26532,28372,54904
202211,3호선,압구정,28936,30925,59861
202211,3호선,약수,10359,9991,20350
202211,3호선,양재,23151,25717,48868
202211,3호선,연신내,30875,29413,60288
202211,3호선,오금,4076,3913,7989
202211,3호선,옥수,7768,7669,15437
202211,3호선,을지로3가,6896,6913,13809
202211,3호선,일원,6079,5956,12035
202211,3호선,잠원,3962,3734,7696
202211,3호선,종로3가,7076,10186,17262
202211,3호선,지축,4588,4340,8928
202211,3호선,학여울,1711,1670,3381
202211,3호선,홍제,14743,13976,28719
202211,3호선,가락시장,4361,4461,8822
202211,3호선,경복궁,16153,17762,33915
202211,3호선,경찰병원,2964,3039,6003
202211,3호선,고속터미널,49712,46632,96344
202211,3호선,교대,5104,3152,8256
202211,3호선,구파발,12045,12468,24513
202211,3호선,금호,4515,4218,8733
202211,3호선,남부터미널,17000,18255,35255
202211,3호선,녹번,7945,7102,15047
202211,3호선,대청,4474,4441,8915
202211,3호선,대치,5554,5190,10744
202211,3호선,도곡,2218,2460,4678
202211,3호선,독립문,4566,5190,9756
202211,3호선,동대입구,6377,7648,14025
202211,3호선,매봉,4409,4267,8676
202211,3호선,무악재,2209,2336,4545
202211,3호선,불광,10117,11163,21280
202211,3호선,수서,11778,12004,23782
202211,3호선,신사,14849,14756,29605
202211,3호선,안국,16683,18045,34728
202211,3호선,압구정,16379,17122,33501
202211,3호선,약수,7283,7037,14320
202211,3호선,양재,15210,17091,32301
202211,3호선,연신내,21812,20419,42231
202211,3호선,오금,2944,2899,5843
202211,3호선,옥수,5173,5217,10390
202211,3호선,을지로3가,4304,3726,8030
202211,3호선,일원,3928,4109,8037
202211,3호선,잠원,2365,2277,4642
202211,3호선,종로3가,4631,5877,10508
202211,3호선,지축,3131,2883,6014
202211,3호선,충무로,1,0,1
202211,3호선,학여울,1286,1248,2534
202211,3호선,홍제,10102,9655,19757
202212,3호선,가락시장,7238,6982,14220
202212,3호선,경복궁,19148,20008,39156
202212,3호선,경찰병원,4485,4390,8875
202212,3호선,고속터미널,58489,57572,116061
202212,3호선,교대,8568,5122,13690
202212,3호선,구파발,15574,15756,31330
202212,3호선,금호,6125,5330,11455
202212,3호선,남부터미널,23859,23470,47329
202212,3호선,녹번,11465,9914,21379
202212,3호선,대청,6479,6124,12603
202212,3호선,대치,8953,8354,17307
202212,3호선,도곡,3685,4015,7700
202212,3호선,독립문,5980,6218,12198
202212,3호선,동대입구,9005,10161,19166
202212,3호선,매봉,6511,6293,12804
202212,3호선,무악재,3198,3141,6339
202212,3호선,불광,13534,15110,28644
202212,3호선,수서,16216,15857,32073
202212,3호선,신사,24948,26438,51386
202212,3호선,안국,21128,23604,44732
202212,3호선,압구정,27607,30017,57624
202212,3호선,약수,9793,9233,19026
202212,3호선,양재,23252,25551,48803
202212,3호선,연신내,29309,27701,57010
202212,3호선,오금,3987,3750,7737
202212,3호선,옥수,7119,7283,14402
202212,3호선,을지로3가,6319,6463,12782
202212,3호선,일원,5664,5526,11190
202212,3호선,잠원,3624,3486,7110
202212,3호선,종로3가,6449,9767,16216
202212,3호선,지축,4360,4100,8460
202212,3호선,충무로,3,0,3
202212,3호선,학여울,4553,4916,9469
202212,3호선,홍제,14245,13360,27605
202212,3호선,가락시장,4117,4316,8433
202212,3호선,경복궁,13389,14071,27460
202212,3호선,경찰병원,3035,3090,6125
202212,3호선,고속터미널,48488,46063,94551
202212,3호선,교대,4671,2884,7555
202212,3호선,구파발,11723,12306,24029
202212,3호선,금호,4292,4041,8333
202212,3호선,남부터미널,16047,17349,33396
202212,3호선,녹번,7671,6891,14562
202212,3호선,대청,4460,4498,8958
202212,3호선,대치,5511,5100,10611
202212,3호선,도곡,2223,2458,4681
202212,3호선,독립문,4145,4409,8554
202212,3호선,동대입구,5401,6011,11412
202212,3호선,매봉,4323,4330,8653
202212,3호선,무악재,2081,2101,4182
202212,3호선,불광,9713,10945,20658
202212,3호선,수서,11377,11947,23324
202212,3호선,신사,14191,14239,28430
202212,3호선,안국,14920,15375,30295
202212,3호선,압구정,16524,16907,33431
202212,3호선,약수,7182,6943,14125
202212,3호선,양재,15160,17103,32263
202212,3호선,연신내,20820,19638,40458
202212,3호선,오금,2971,2963,5934
202212,3호선,옥수,4838,5030,9868
202212,3호선,을지로3가,4217,3746,7963
202212,3호선,일원,4026,4131,8157
202212,3호선,잠원,2258,2151,4409
202212,3호선,종로3가,4298,5711,10009
202212,3호선,지축,2970,2743,5713
202212,3호선,충무로,1,0,1
202212,3호선,학여울,3221,3413,6634
202212,3호선,홍제,9680,9274,18954
202212,3호선,가락시장,7637,7489,15126
202212,3호선,경복궁,20943,22621,43564
202212,3호선,경찰병원,4626,4716,9342
202212,3호선,고속터미널,60342,59009,119351
202212,3호선,교대,9174,5555,14729
202212,3호선,구파발,16786,17002,33788
202212,3호선,금호,6644,5945,12589
202212,3호선,남부터미널,25733,25330,51063
202212,3호선,녹번,12008,10303,22311
202212,3호선,대청,6782,6112,12894
202212,3호선,대치,8758,8052,16810
202212,3호선,도곡,3892,3964,7856
202212,3호선,독립문,6600,6905,13505
202212,3호선,동대입구,10581,12165,22746
202212,3호선,매봉,7070,6733,13803
202212,3호선,무악재,3266,3304,6570
202212,3호선,불광,14776,16303,31079
202212,3호선,수서,16616,16182,32798
202212,3호선,신사,26477,28283,54760
202212,3호선,안국,22482,24841,47323
202212,3호선,압구정,28597,30995,59592
202212,3호선,약수,10869,10280,21149
202212,3호선,양재,24655,26347,51002
202212,3호선,연신내,31796,29810,61606
202212,3호선,오금,4313,4042,8355
202212,3호선,옥수,7555,7471,15026
202212,3호선,을지로3가,7020,7102,14122
202212,3호선,일원,5915,5608,11523
202212,3호선,잠원,3466,3286,6752
202212,3호선,종로3가,7095,10394,17489
202212,3호선,지축,4623,4416,9039
202212,3호선,충무로,2,0,2
202212,3호선,학여울,2806,2936,5742
202212,3호선,홍제,15531,14347,29878
202212,3호선,가락시장,4414,4579,8993
202212,3호선,경복궁,15192,16159,31351
202212,3호선,경찰병원,3051,3228,6279
202212,3호선,고속터미널,48758,45841,94599
202212,3호선,교대,4968,2952,7920
202212,3호선,구파발,11956,12349,24305
202212,3호선,금호,4585,4486,9071
202212,3호선,남부터미널,16920,18495,35415
202212,3호선,녹번,8127,7267,15394
202212,3호선,대청,4494,4509,9003
202212,3호선,대치,5221,4963,10184
202212,3호선,도곡,2197,2221,4418
202212,3호선,독립문,4637,5090,9727
202212,3호선,동대입구,7549,8342,15891
202212,3호선,매봉,4532,4440,8972
202212,3호선,무악재,2218,2289,4507
202212,3호선,불광,10332,11601,21933
202212,3호선,수서,11979,12268,24247
202212,3호선,신사,14887,15086,29973
202212,3호선,안국,16644,17529,34173
202212,3호선,압구정,16556,17020,33576
202212,3호선,약수,7524,7155,14679
202212,3호선,양재,15725,17775,33500
202212,3호선,연신내,22270,20976,43246
202212,3호선,오금,3018,2950,5968
202212,3호선,옥수,5254,5451,10705
202212,3호선,을지로3가,4461,4079,8540
202212,3호선,일원,4034,4130,8164
202212,3호선,잠원,2146,2187,4333
202212,3호선,종로3가,4613,5987,10600
202212,3호선,지축,3244,2992,6236
202212,3호선,학여울,2097,2235,4332
202212,3호선,홍제,10336,9901,20237
202212,3호선,가락시장,7656,7356,15012
202212,3호선,경복궁,20524,21188,41712
202212,3호선,경찰병원,4830,4698,9528
202212,3호선,고속터미널,63306,62062,125368
202212,3호선,교대,8862,5457,14319
202212,3호선,구파발,16870,17206,34076
202212,3호선,금호,6509,5787,12296
202212,3호선,남부터미널,27171,26295,53466
202212,3호선,녹번,11653,10252,21905
202212,3호선,대청,6677,6089,12766
202212,3호선,대치,9220,8784,18004
202212,3호선,도곡,3780,3943,7723
202212,3호선,독립문,6291,6454,12745
202212,3호선,동대입구,9746,10662,20408
202212,3호선,매봉,7354,7144,14498
202212,3호선,무악재,3267,3275,6542
202212,3호선,불광,13721,15187,28908
202212,3호선,수서,16612,16664,33276
202212,3호선,신사,28055,30495,58550
202212,3호선,안국,23675,24997,48672
202212,3호선,압구정,29221,31693,60914
202212,3호선,약수,10562,10061,20623
202212,3호선,양재,24803,26802,51605
202212,3호선,연신내,30978,29600,60578
202212,3호선,오금,4285,4009,8294
202212,3호선,옥수,7581,7552,15133
202212,3호선,을지로3가,7167,7207,14374
202212,3호선,일원,6152,5668,11820
202212,3호선,잠원,3646,3485,7131
202212,3호선,종로3가,7195,10805,18000
202212,3호선,지축,4456,4220,8676
202212,3호선,충무로,2,0,2
202212,3호선,학여울,3465,3507,6972
202212,3호선,홍제,14881,14091,28972
202212,3호선,가락시장,4363,4466,8829
202212,3호선,경복궁,12911,12917,25828
202212,3호선,경찰병원,2968,3059,6027
202212,3호선,고속터미널,50549,47113,97662
202212,3호선,교대,5154,3185,8339
202212,3호선,구파발,11238,11802,23040
202212,3호선,금호,4203,4053,8256
202212,3호선,남부터미널,16807,18125,34932
202212,3호선,녹번,7657,6893,14550
202212,3호선,대청,4284,4330,8614
202212,3호선,대치,4906,4744,9650
202212,3호선,도곡,2183,2321,4504
202212,3호선,독립문,3805,3979,7784
202212,3호선,동대입구,6472,6790,13262
202212,3호선,매봉,4461,4445,8906
202212,3호선,무악재,2032,2121,4153
202212,3호선,불광,9467,10388,19855
202212,3호선,수서,11944,11781,23725
202212,3호선,신사,15393,15247,30640
202212,3호선,안국,14421,14628,29049
202212,3호선,압구정,15831,16642,32473
202212,3호선,약수,7289,6912,14201
202212,3호선,양재,15520,17123,32643
202212,3호선,연신내,20230,19198,39428
202212,3호선,오금,2856,2806,5662
202212,3호선,옥수,4883,5075,9958
202212,3호선,을지로3가,4481,3873,8354
202212,3호선,일원,3851,3980,7831
202212,3호선,잠원,2026,2097,4123
202212,3호선,종로3가,4270,5548,9818
202212,3호선,지축,2789,2661,5450
202212,3호선,충무로,1,0,1
202212,3호선,학여울,1222,1281,2503
202212,3호선,홍제,9723,9438,19161
202212,3호선,가락시장,6026,5612,11638
202212,3호선,경복궁,17028,17638,34666
202212,3호선,경찰병원,3910,3766,7676
202212,3호선,고속터미널,54145,53084,107229
202212,3호선,교대,6425,3937,10362
202212,3호선,구파발,15223,15330,30553
202212,3호선,금호,5475,4933,10408
202212,3호선,남부터미널,21932,21006,42938
202212,3호선,녹번,10288,8924,19212
202212,3호선,대청,5659,5245,10904
202212,3호선,대치,8494,7730,16224
202212,3호선,도곡,2885,3017,5902
202212,3호선,독립문,5016,5047,10063
202212,3호선,동대입구,7236,8151,15387
202212,3호선,매봉,5796,5686,11482
202212,3호선,무악재,2780,2781,5561
202212,3호선,불광,12348,13593,25941
202212,3호선,수서,13738,13767,27505
202212,3호선,신사,23706,25411,49117
202212,3호선,안국,19290,21017,40307
202212,3호선,압구정,25673,27765,53438
202212,3호선,약수,9130,8678,17808
202212,3호선,양재,18012,19623,37635
202212,3호선,연신내,27655,26588,54243
202212,3호선,오금,3403,3185,6588
202212,3호선,옥수,6158,6292,12450
202212,3호선,을지로3가,6378,6246,12624
202212,3호선,일원,4724,4481,9205
202212,3호선,잠원,3104,2999,6103
202212,3호선,종로3가,6251,9387,15638
202212,3호선,지축,3908,3655,7563
202212,3호선,충무로,2,0,2
202212,3호선,학여울,1047,1033,2080
202212,3호선,홍제,13184,12248,25432
202212,3호선,가락시장,3694,3858,7552
202212,3호선,경복궁,14267,15305,29572
202212,3호선,경찰병원,2818,2799,5617
202212,3호선,고속터미널,45197,42730,87927
202212,3호선,교대,4161,2503,6664
202212,3호선,구파발,11902,12499,24401
202212,3호선,금호,4251,4027,8278
202212,3호선,남부터미널,15381,16293,31674
202212,3호선,녹번,7859,6892,14751
202212,3호선,대청,4097,4129,8226
202212,3호선,대치,5198,4685,9883
202212,3호선,도곡,1702,1730,3432
202212,3호선,독립문,3865,3980,7845
202212,3호선,동대입구,6070,7130,13200
202212,3호선,매봉,4188,4107,8295
202212,3호선,무악재,2062,2217,4279
202212,3호선,불광,9903,10969,20872
202212,3호선,수서,10672,10861,21533
202212,3호선,신사,14321,14627,28948
202212,3호선,안국,16316,17291,33607
202212,3호선,압구정,16194,17307,33501
202212,3호선,약수,7080,6795,13875
202212,3호선,양재,12053,13910,25963
202212,3호선,연신내,21812,21094,42906
202212,3호선,오금,2617,2536,5153
202212,3호선,옥수,4571,4952,9523
202212,3호선,을지로3가,5397,4953,10350
202212,3호선,일원,3754,3780,7534
202212,3호선,잠원,2107,2137,4244
202212,3호선,종로3가,4858,7229,12087
202212,3호선,지축,2949,2826,5775
202212,3호선,학여울,781,756,1537
202212,3호선,홍제,9660,9035,18695
202212,3호선,가락시장,5615,5245,10860
202212,3호선,경복궁,16604,17535,34139
202212,3호선,경찰병원,3758,3579,7337
202212,3호선,고속터미널,44757,48206,92963
202212,3호선,교대,5834,3492,9326
202212,3호선,구파발,14213,14124,28337
202212,3호선,금호,5498,4787,10285
202212,3호선,남부터미널,17956,18329,36285
202212,3호선,녹번,9516,8224,17740
202212,3호선,대청,5502,5180,10682
202212,3호선,대치,9526,8512,18038
202212,3호선,도곡,2447,2468,4915
202212,3호선,독립문,5355,5319,10674
202212,3호선,동대입구,7409,8377,15786
202212,3호선,매봉,5290,4978,10268
202212,3호선,무악재,2690,2679,5369
202212,3호선,불광,12017,13254,25271
202212,3호선,수서,11202,11536,22738
202212,3호선,신사,19890,21447,41337
202212,3호선,안국,18115,19446,37561
202212,3호선,압구정,23146,24727,47873
202212,3호선,약수,8645,7816,16461
202212,3호선,양재,15541,17027,32568
202212,3호선,연신내,26830,25745,52575
202212,3호선,오금,3305,3120,6425
202212,3호선,옥수,5843,5853,11696
202212,3호선,을지로3가,5267,5202,10469
202212,3호선,일원,4498,4344,8842
202212,3호선,잠원,3085,2969,6054
202212,3호선,종로3가,5711,8289,14000
202212,3호선,지축,3667,3470,7137
202212,3호선,학여울,898,866,1764
202212,3호선,홍제,12424,11620,24044
