사용월,호선명,지하철역,승차총승객수,하차총승객수,승하차총승객수
202201,5호선,강동,6644,6329,12973
202201,5호선,강일,1527,1558,3085
202201,5호선,개롱,2085,2304,4389
202201,5호선,개화산,2253,2366,4619
202201,5호선,거여,3095,3109,6204
202201,5호선,고덕,3515,3454,6969
202201,5호선,공덕,3249,3303,6552
202201,5호선,광나루,5727,5762,11489
202201,5호선,광화문,8245,7887,16132
202201,5호선,군자,4671,5286,9957
202201,5호선,굽은다리,4329,4090,8419
202201,5호선,길동,3397,3534,6931
202201,5호선,김포공항,5736,5212,10948
202201,5호선,까치산,12401,12296,24697
202201,5호선,답십리,5872,5566,11438
202201,5호선,동대문역사문화공원,672,778,1450
202201,5호선,둔촌동,3208,3233,6441
202201,5호선,마곡,2606,2607,5213
202201,5호선,마장,2302,2166,4468
202201,5호선,마천,2732,2942,5674
202201,5호선,마포,3732,3718,7450
202201,5호선,명일,3191,3429,6620
202201,5호선,목동,5641,5864,11505
202201,5호선,미사,6848,6830,13678
202201,5호선,발산,7230,7644,14874
202201,5호선,방이,2789,2757,5546
202201,5호선,방화,2873,2870,5743
202201,5호선,상일동,4982,4848,9830
202201,5호선,서대문,3995,3793,7788
202201,5호선,송정,3160,2982,6142
202201,5호선,신금호,2302,2414,4716
202201,5호선,신길,1375,1483,2858
202201,5호선,신정,4971,4549,9520
202201,5호선,아차산,9533,9281,18814
202201,5호선,애오개,1995,1911,3906
202201,5호선,양평,1828,1869,3697
202201,5호선,여의나루,3296,3376,6672
202201,5호선,여의도,4712,5120,9832
202201,5호선,영등포구청,986,907,1893
202201,5호선,영등포시장,3730,3872,7602
202201,5호선,오금,1080,1041,2121
202201,5호선,오목교,7333,7737,15070
202201,5호선,올림픽공원,2184,2150,4334
202201,5호선,왕십리,2005,2381,4386
202201,5호선,우장산,4987,5287,10274
202201,5호선,을지로4가,1163,1289,2452
202201,5호선,장한평,5610,5604,11214
202201,5호선,종로3가,7197,6625,13822
202201,5호선,천호,9009,8308,17317
202201,5호선,청구,1437,1325,2762
202201,5호선,충정로,1029,980,2009
202201,5호선,하남검단산,3509,3422,6931
202201,5호선,하남시청,3074,2964,6038
202201,5호선,하남풍산,1684,1772,3456
202201,5호선,행당,2816,2563,5379
202201,5호선,화곡,11204,10584,21788
202201,5호선,강동,7051,7495,14546
202201,5호선,강일,1711,1693,3404
202201,5호선,개롱,2464,2753,5217
202201,5호선,개화산,2333,2414,4747
202201,5호선,거여,3498,3420,6918
202201,5호선,고덕,3760,3853,7613
202201,5호선,공덕,3612,3701,7313
202201,5호선,광나루,6287,6123,12410
202201,5호선,광화문,8709,8581,17290
202201,5호선,군자,5014,5587,10601
202201,5호선,굽은다리,4832,4654,9486
202201,5호선,길동,3642,3824,7466
202201,5호선,김포공항,7284,6233,13517
202201,5호선,까치산,13229,13561,26790
202201,5호선,답십리,6445,6300,12745
202201,5호선,동대문역사문화공원,667,781,1448
202201,5호선,둔촌동,3975,4068,8043
202201,5호선,마곡,3030,3254,6284
202201,5호선,마장,2334,2271,4605
202201,5호선,마천,2957,3137,6094
202201,5호선,마포,3830,4046,7876
202201,5호선,명일,4168,4373,8541
202201,5호선,목동,6407,6795,13202
202201,5호선,미사,7374,7698,15072
202201,5호선,발산,7448,8020,15468
202201,5호선,방이,3319,3278,6597
202201,5호선,방화,3244,3285,6529
202201,5호선,상일동,5747,5574,11321
202201,5호선,서대문,4268,4308,8576
202201,5호선,송정,3175,3281,6456
202201,5호선,신금호,2577,2888,5465
202201,5호선,신길,1439,1871,3310
202201,5호선,신정,5395,5120,10515
202201,5호선,아차산,8733,8893,17626
202201,5호선,애오개,2221,2318,4539
202201,5호선,양평,2168,2434,4602
202201,5호선,여의나루,4297,5071,9368
202201,5호선,여의도,6590,6657,13247
202201,5호선,영등포구청,1142,1214,2356
202201,5호선,영등포시장,3770,4313,8083
202201,5호선,오금,1233,1225,2458
202201,5호선,오목교,10065,10408,20473
202201,5호선,올림픽공원,2184,1984,4168
202201,5호선,왕십리,2279,2650,4929
202201,5호선,우장산,5974,6091,12065
202201,5호선,을지로4가,1127,1201,2328
202201,5호선,장한평,6526,7026,13552
202201,5호선,종로3가,6867,6228,13095
202201,5호선,천호,11082,10250,21332
202201,5호선,청구,1558,1378,2936
202201,5호선,충정로,1170,1231,2401
202201,5호선,하남검단산,3779,3697,7476
202201,5호선,하남시청,3379,3183,6562
202201,5호선,하남풍산,1777,1910,3687
202201,5호선,행당,3243,3039,6282
202201,5호선,화곡,12405,11732,24137
202201,5호선,강동,12086,11628,23714
202201,5호선,강일,2499,2412,4911
202201,5호선,개롱,3875,4160,8035
202201,5호선,개화산,3386,3254,6640
202201,5호선,거여,5526,5265,10791
202201,5호선,고덕,6308,6126,12434
202201,5호선,공덕,6318,6680,12998
202201,5호선,광나루,9346,9205,18551
202201,5호선,광화문,13721,14252,27973
202201,5호선,군자,8114,9154,17268
202201,5호선,굽은다리,6859,6411,13270
202201,5호선,길동,5611,6019,11630
202201,5호선,김포공항,6857,6946,13803
202201,5호선,까치산,19791,19477,39268
202201,5호선,답십리,9637,8925,18562
202201,5호선,동대문역사문화공원,1001,1297,2298
202201,5호선,둔촌동,5873,5888,11761
202201,5호선,마곡,5318,5199,10517
202201,5호선,마장,3802,3592,7394
202201,5호선,마천,4365,4621,8986
202201,5호선,마포,6959,6949,13908
202201,5호선,명일,5767,5785,11552
202201,5호선,목동,10684,10793,21477
202201,5호선,미사,11180,11293,22473
202201,5호선,발산,12596,13223,25819
202201,5호선,방이,4813,4744,9557
202201,5호선,방화,4485,4231,8716
202201,5호선,상일동,8829,8282,17111
202201,5호선,서대문,6236,6164,12400
202201,5호선,송정,4711,4519,9230
202201,5호선,신금호,3844,3990,7834
202201,5호선,신길,2409,2519,4928
202201,5호선,신정,8253,7301,15554
202201,5호선,아차산,12221,11468,23689
202201,5호선,애오개,3392,3386,6778
202201,5호선,양평,3627,3489,7116
202201,5호선,여의나루,5302,6306,11608
202201,5호선,여의도,10058,10444,20502
202201,5호선,영등포구청,1891,1844,3735
202201,5호선,영등포시장,7514,7956,15470
202201,5호선,오금,2051,1979,4030
202201,5호선,오목교,15270,15663,30933
202201,5호선,올림픽공원,2671,2438,5109
202201,5호선,왕십리,3318,3991,7309
202201,5호선,우장산,8919,9259,18178
202201,5호선,을지로4가,3165,3638,6803
202201,5호선,장한평,10450,10525,20975
202201,5호선,종로3가,11199,11421,22620
202201,5호선,천호,16234,15305,31539
202201,5호선,청구,2454,2203,4657
202201,5호선,충정로,1752,1739,3491
202201,5호선,하남검단산,5047,4971,10018
202201,5호선,하남시청,4822,4740,9562
202201,5호선,하남풍산,2526,2567,5093
202201,5호선,행당,5030,4499,9529
202201,5호선,화곡,18979,17720,36699
202201,5호선,강동,7830,7808,15638
202201,5호선,강일,1894,1785,3679
202201,5호선,개롱,2657,2910,5567
202201,5호선,개화산,2420,2572,4992
202201,5호선,거여,3913,3734,7647
202201,5호선,고덕,3729,3711,7440
202201,5호선,공덕,4051,4090,8141
202201,5호선,광나루,6602,6466,13068
202201,5호선,광화문,9917,9657,19574
202201,5호선,군자,5618,6221,11839
202201,5호선,굽은다리,4813,4516,9329
202201,5호선,길동,3746,3958,7704
202201,5호선,김포공항,6585,6259,12844
202201,5호선,까치산,14325,14099,28424
202201,5호선,답십리,6671,6410,13081
202201,5호선,동대문역사문화공원,690,792,1482
202201,5호선,둔촌동,4277,4357,8634
202201,5호선,마곡,3361,3504,6865
202201,5호선,마장,2596,2579,5175
202201,5호선,마천,3234,3439,6673
202201,5호선,마포,4233,4395,8628
202201,5호선,명일,4296,4343,8639
202201,5호선,목동,6953,7258,14211
202201,5호선,미사,8087,8043,16130
202201,5호선,발산,8318,8707,17025
202201,5호선,방이,3491,3455,6946
202201,5호선,방화,3108,3211,6319
202201,5호선,상일동,6064,6119,12183
202201,5호선,서대문,4525,4486,9011
202201,5호선,송정,3458,3417,6875
202201,5호선,신금호,2653,2925,5578
202201,5호선,신길,1714,1914,3628
202201,5호선,신정,5826,5340,11166
202201,5호선,아차산,9015,8923,17938
202201,5호선,애오개,2320,2381,4701
202201,5호선,양평,2399,2520,4919
202201,5호선,여의나루,5011,5759,10770
202201,5호선,여의도,7206,7274,14480
202201,5호선,영등포구청,1160,1189,2349
202201,5호선,영등포시장,4962,5281,10243
202201,5호선,오금,1324,1298,2622
202201,5호선,오목교,10515,10808,21323
202201,5호선,올림픽공원,1873,1701,3574
202201,5호선,왕십리,2144,2604,4748
202201,5호선,우장산,6265,6465,12730
202201,5호선,을지로4가,1322,1446,2768
202201,5호선,장한평,7045,7074,14119
202201,5호선,종로3가,8050,7081,15131
202201,5호선,천호,11517,10757,22274
202201,5호선,청구,1572,1480,3052
202201,5호선,충정로,1315,1261,2576
202201,5호선,하남검단산,4117,4053,8170
202201,5호선,하남시청,3622,3488,7110
202201,5호선,하남풍산,1959,2025,3984
202201,5호선,행당,3513,3212,6725
202201,5호선,화곡,13086,12397,25483
202201,5호선,강동,12005,11405,23410
202201,5호선,강일,2578,2422,5000
202201,5호선,개롱,3982,4154,8136
202201,5호선,개화산,3525,3413,6938
202201,5호선,거여,5534,5451,10985
202201,5호선,고덕,5899,5914,11813
202201,5호선,공덕,6821,6909,13730
202201,5호선,광나루,8798,8477,17275
202201,5호선,광화문,14464,14676,29140
202201,5호선,군자,8228,8855,17083
202201,5호선,굽은다리,6631,6238,12869
202201,5호선,길동,5650,5864,11514
202201,5호선,김포공항,6974,7080,14054
202201,5호선,까치산,20055,19480,39535
202201,5호선,답십리,9754,9096,18850
202201,5호선,동대문역사문화공원,1043,1339,2382
202201,5호선,둔촌동,5862,5811,11673
202201,5호선,마곡,5248,5196,10444
202201,5호선,마장,3905,3925,7830
202201,5호선,마천,4453,4713,9166
202201,5호선,마포,7177,7244,14421
202201,5호선,명일,5713,5757,11470
202201,5호선,목동,10786,11013,21799
202201,5호선,미사,11240,11101,22341
202201,5호선,발산,12598,13276,25874
202201,5호선,방이,5087,4948,10035
202201,5호선,방화,4416,4271,8687
202201,5호선,상일동,9090,8503,17593
202201,5호선,서대문,6933,6534,13467
202201,5호선,송정,4655,4492,9147
202201,5호선,신금호,3839,4025,7864
202201,5호선,신길,2486,2595,5081
202201,5호선,신정,8407,7382,15789
202201,5호선,아차산,11650,11268,22918
202201,5호선,애오개,3600,3432,7032
202201,5호선,양평,3587,3437,7024
202201,5호선,여의나루,5593,6952,12545
202201,5호선,여의도,12796,14159,26955
202201,5호선,영등포구청,2149,1858,4007
202201,5호선,영등포시장,7519,7848,15367
202201,5호선,오금,1888,1820,3708
202201,5호선,오목교,15162,15700,30862
202201,5호선,올림픽공원,2528,2123,4651
202201,5호선,왕십리,3392,4170,7562
202201,5호선,우장산,9270,9180,18450
202201,5호선,을지로4가,3298,3592,6890
202201,5호선,장한평,10506,10428,20934
202201,5호선,종로3가,11742,11558,23300
202201,5호선,천호,16042,15062,31104
202201,5호선,청구,2453,2300,4753
202201,5호선,충정로,1954,1749,3703
202201,5호선,하남검단산,4788,4636,9424
202201,5호선,하남시청,4773,4762,9535
202201,5호선,하남풍산,2514,2610,5124
202201,5호선,행당,5010,4357,9367
202201,5호선,화곡,19079,17754,36833
202201,5호선,강동,8482,8309,16791
202201,5호선,강일,1897,1812,3709
202201,5호선,개롱,2585,2938,5523
202201,5호선,개화산,2455,2511,4966
202201,5호선,거여,3957,3838,7795
202201,5호선,고덕,4051,4053,8104
202201,5호선,공덕,4331,4261,8592
202201,5호선,광나루,6613,6384,12997
202201,5호선,광화문,10988,10702,21690
202201,5호선,군자,5862,6634,12496
202201,5호선,굽은다리,4976,4812,9788
202201,5호선,길동,3865,4047,7912
202201,5호선,김포공항,6538,6761,13299
202201,5호선,까치산,14345,14238,28583
202201,5호선,답십리,6849,6517,13366
202201,5호선,동대문역사문화공원,727,803,1530
202201,5호선,둔촌동,4245,4355,8600
202201,5호선,마곡,3355,3534,6889
202201,5호선,마장,2777,2708,5485
202201,5호선,마천,3309,3570,6879
202201,5호선,마포,4463,4565,9028
202201,5호선,명일,4485,4630,9115
202201,5호선,목동,7011,7299,14310
202201,5호선,미사,8053,8084,16137
202201,5호선,발산,8308,8423,16731
202201,5호선,방이,3651,3572,7223
202201,5호선,방화,3180,3289,6469
202201,5호선,상일동,6249,6205,12454
202201,5호선,서대문,4724,4582,9306
202201,5호선,송정,3333,3208,6541
202201,5호선,신금호,2731,2978,5709
202201,5호선,신길,1651,1983,3634
202201,5호선,신정,5773,5380,11153
202201,5호선,아차산,9672,9560,19232
202201,5호선,애오개,2438,2600,5038
202201,5호선,양평,2520,2670,5190
202201,5호선,여의나루,4673,5888,10561
202201,5호선,여의도,7886,7585,15471
202201,5호선,영등포구청,1288,1277,2565
202201,5호선,영등포시장,4984,5240,10224
202201,5호선,오금,1408,1447,2855
202201,5호선,오목교,10616,10803,21419
202201,5호선,올림픽공원,1873,1568,3441
202201,5호선,왕십리,2382,2815,5197
202201,5호선,우장산,6361,6611,12972
202201,5호선,을지로4가,1406,1600,3006
202201,5호선,장한평,7171,7227,14398
202201,5호선,종로3가,8717,7461,16178
202201,5호선,천호,12196,11463,23659
202201,5호선,청구,1724,1624,3348
202201,5호선,충정로,1316,1373,2689
202201,5호선,하남검단산,4084,4033,8117
202201,5호선,하남시청,3636,3504,7140
202201,5호선,하남풍산,1971,2059,4030
202201,5호선,행당,3494,3271,6765
202201,5호선,화곡,13290,12720,26010
202201,5호선,강동,12429,11759,24188
202201,5호선,강일,2646,2548,5194
202201,5호선,개롱,3986,4293,8279
202201,5호선,개화산,3462,3339,6801
202201,5호선,거여,5779,5517,11296
202201,5호선,고덕,6052,6027,12079
202201,5호선,공덕,6925,7075,14000
202201,5호선,광나루,9018,8599,17617
202201,5호선,광화문,13909,13941,27850
202201,5호선,군자,8329,9157,17486
202201,5호선,굽은다리,6924,6562,13486
202201,5호선,길동,5801,6106,11907
202201,5호선,김포공항,7052,7146,14198
202201,5호선,까치산,20608,19914,40522
202201,5호선,답십리,9944,9143,19087
202201,5호선,동대문역사문화공원,1065,1392,2457
202201,5호선,둔촌동,6108,6094,12202
202201,5호선,마곡,5425,5380,10805
202201,5호선,마장,4202,4165,8367
202201,5호선,마천,4500,4667,9167
202201,5호선,마포,7365,7361,14726
202201,5호선,명일,6000,6051,12051
202201,5호선,목동,10996,11214,22210
202201,5호선,미사,11400,11377,22777
202201,5호선,발산,12951,13443,26394
202201,5호선,방이,5053,5024,10077
202201,5호선,방화,4371,4279,8650
202201,5호선,상일동,9082,8401,17483
202201,5호선,서대문,6958,6806,13764
202201,5호선,송정,4825,4642,9467
202201,5호선,신금호,4011,4134,8145
202201,5호선,신길,2452,2716,5168
202201,5호선,신정,8868,7613,16481
202201,5호선,아차산,12580,12014,24594
202201,5호선,애오개,3532,3460,6992
202201,5호선,양평,3667,3621,7288
202201,5호선,여의나루,6439,7618,14057
202201,5호선,여의도,11224,11544,22768
202201,5호선,영등포구청,2025,1938,3963
202201,5호선,영등포시장,7715,8162,15877
202201,5호선,오금,2166,2049,4215
202201,5호선,오목교,15684,16097,31781
202201,5호선,올림픽공원,2764,2473,5237
202201,5호선,왕십리,3405,4074,7479
202201,5호선,우장산,9554,9553,19107
202201,5호선,을지로4가,3426,3815,7241
202201,5호선,장한평,10934,10754,21688
202201,5호선,종로3가,11955,12108,24063
202201,5호선,천호,16292,15534,31826
202201,5호선,청구,2530,2286,4816
202201,5호선,충정로,1848,1779,3627
202201,5호선,하남검단산,4728,4687,9415
202201,5호선,하남시청,4971,4898,9869
202201,5호선,하남풍산,2578,2678,5256
202201,5호선,행당,5300,4661,9961
202201,5호선,화곡,19480,18178,37658
202201,5호선,강동,8398,8293,16691
202201,5호선,강일,1952,1871,3823
202201,5호선,개롱,2667,3058,5725
202201,5호선,개화산,2521,2564,5085
202201,5호선,거여,4015,3929,7944
202201,5호선,고덕,3993,3874,7867
202201,5호선,공덕,4217,4343,8560
202201,5호선,광나루,7271,7097,14368
202201,5호선,광화문,9853,9814,19667
202201,5호선,군자,5907,6412,12319
202201,5호선,굽은다리,5015,4606,9621
202201,5호선,길동,4034,4201,8235
202201,5호선,김포공항,6367,6348,12715
202201,5호선,까치산,14801,14439,29240
202201,5호선,답십리,7058,6596,13654
202201,5호선,동대문역사문화공원,695,828,1523
202201,5호선,둔촌동,4317,4412,8729
202201,5호선,마곡,3708,3763,7471
202201,5호선,마장,2933,2960,5893
202201,5호선,마천,3406,3641,7047
202201,5호선,마포,4567,4782,9349
202201,5호선,명일,4446,4593,9039
202201,5호선,목동,7069,7371,14440
202201,5호선,미사,8362,8277,16639
202201,5호선,발산,8763,8943,17706
202201,5호선,방이,3787,3722,7509
202201,5호선,방화,3209,3353,6562
202201,5호선,상일동,6409,6286,12695
202201,5호선,서대문,4801,4760,9561
202201,5호선,송정,3521,3433,6954
202201,5호선,신금호,2863,3035,5898
202201,5호선,신길,1733,2002,3735
202201,5호선,신정,6028,5514,11542
202201,5호선,아차산,10111,10018,20129
202201,5호선,애오개,2468,2563,5031
202201,5호선,양평,2534,2628,5162
202201,5호선,여의나루,5762,6613,12375
202201,5호선,여의도,7591,7692,15283
202201,5호선,영등포구청,1333,1201,2534
202201,5호선,영등포시장,5059,5167,10226
202201,5호선,오금,1437,1427,2864
202201,5호선,오목교,10643,10967,21610
202201,5호선,올림픽공원,1987,1815,3802
202201,5호선,왕십리,2311,2696,5007
202201,5호선,우장산,6331,6579,12910
202201,5호선,을지로4가,1519,1609,3128
202201,5호선,장한평,7302,7342,14644
202201,5호선,종로3가,8736,7680,16416
202201,5호선,천호,11805,11064,22869
202201,5호선,청구,1757,1519,3276
202201,5호선,충정로,1336,1372,2708
202201,5호선,하남검단산,4182,4193,8375
202201,5호선,하남시청,3623,3475,7098
202201,5호선,하남풍산,1970,2111,4081
202201,5호선,행당,3576,3429,7005
202201,5호선,화곡,13380,12625,26005
202201,5호선,강동,9719,8979,18698
202201,5호선,강일,2286,2193,4479
202201,5호선,개롱,3430,3661,7091
202201,5호선,개화산,3123,3043,6166
202201,5호선,거여,4862,4636,9498
202201,5호선,고덕,5180,5015,10195
202201,5호선,공덕,5290,5367,10657
202201,5호선,광나루,7683,7377,15060
202201,5호선,광화문,10700,10856,21556
202201,5호선,군자,6698,6961,13659
202201,5호선,굽은다리,5910,5507,11417
202201,5호선,길동,5225,5392,10617
202201,5호선,김포공항,6407,7577,13984
202201,5호선,까치산,17926,16561,34487
202201,5호선,답십리,8276,7451,15727
202201,5호선,동대문역사문화공원,780,1023,1803
202201,5호선,둔촌동,4982,4909,9891
202201,5호선,마곡,4469,4455,8924
202201,5호선,마장,4039,3898,7937
202201,5호선,마천,4065,4303,8368
202201,5호선,마포,5656,5676,11332
202201,5호선,명일,5115,5152,10267
202201,5호선,목동,9018,9063,18081
202201,5호선,미사,9811,9351,19162
202201,5호선,발산,9932,10233,20165
202201,5호선,방이,4149,4188,8337
202201,5호선,방화,3821,3668,7489
202201,5호선,상일동,7650,7117,14767
202201,5호선,서대문,5326,4891,10217
202201,5호선,송정,4232,4056,8288
202201,5호선,신금호,3447,3472,6919
202201,5호선,신길,1968,1861,3829
202201,5호선,신정,7348,6282,13630
202201,5호선,아차산,9845,9164,19009
202201,5호선,애오개,2943,2705,5648
202201,5호선,양평,3001,2607,5608
202201,5호선,여의나루,4129,5227,9356
202201,5호선,여의도,8238,8467,16705
202201,5호선,영등포구청,1624,1518,3142
202201,5호선,영등포시장,5998,5870,11868
202201,5호선,오금,1631,1623,3254
202201,5호선,오목교,12902,13288,26190
202201,5호선,올림픽공원,2315,2115,4430
202201,5호선,왕십리,2838,3258,6096
202201,5호선,우장산,8409,8325,16734
202201,5호선,을지로4가,2374,2672,5046
202201,5호선,장한평,9010,8624,17634
202201,5호선,종로3가,9268,9004,18272
202201,5호선,천호,13966,12949,26915
202201,5호선,청구,2100,1960,4060
202201,5호선,충정로,1419,1275,2694
202201,5호선,하남검단산,4483,4502,8985
202201,5호선,하남시청,4946,4884,9830
202201,5호선,하남풍산,2306,2469,4775
202201,5호선,행당,4381,3808,8189
202201,5호선,화곡,16770,15023,31793
202201,5호선,강동,6686,6326,13012
202201,5호선,강일,1638,1621,3259
202201,5호선,개롱,2440,2597,5037
202201,5호선,개화산,2315,2337,4652
202201,5호선,거여,3522,3229,6751
202201,5호선,고덕,3464,3358,6822
202201,5호선,공덕,3612,3478,7090
202201,5호선,광나루,5486,5367,10853
202201,5호선,광화문,8764,8495,17259
202201,5호선,군자,4653,4625,9278
202201,5호선,굽은다리,4319,3940,8259
202201,5호선,길동,3637,3752,7389
202201,5호선,김포공항,5773,6612,12385
202201,5호선,까치산,13174,12176,25350
202201,5호선,답십리,5978,5368,11346
202201,5호선,동대문역사문화공원,607,740,1347
202201,5호선,둔촌동,3830,3685,7515
202201,5호선,마곡,2952,2859,5811
202201,5호선,마장,2801,2787,5588
202201,5호선,마천,3007,3213,6220
202201,5호선,마포,3878,3774,7652
202201,5호선,명일,3739,3808,7547
202201,5호선,목동,6097,6118,12215
202201,5호선,미사,7080,6865,13945
202201,5호선,발산,6786,6837,13623
202201,5호선,방이,3003,2919,5922
202201,5호선,방화,3043,2868,5911
202201,5호선,상일동,5469,5089,10558
202201,5호선,서대문,3880,3790,7670
202201,5호선,송정,3110,2998,6108
202201,5호선,신금호,2440,2498,4938
202201,5호선,신길,1291,1228,2519
202201,5호선,신정,5293,4595,9888
202201,5호선,아차산,7584,7346,14930
202201,5호선,애오개,2063,2035,4098
202201,5호선,양평,2045,1879,3924
202201,5호선,여의나루,4128,5013,9141
202201,5호선,여의도,6077,5945,12022
202201,5호선,영등포구청,1053,971,2024
202201,5호선,영등포시장,3968,3860,7828
202201,5호선,오금,1182,1137,2319
202201,5호선,오목교,9126,9369,18495
202201,5호선,올림픽공원,1631,1521,3152
202201,5호선,왕십리,1933,2324,4257
202201,5호선,우장산,5963,5990,11953
202201,5호선,을지로4가,1292,1404,2696
202201,5호선,장한평,6128,5870,11998
202201,5호선,종로3가,6473,6262,12735
202201,5호선,천호,10244,9690,19934
202201,5호선,청구,1490,1347,2837
202201,5호선,충정로,1055,1000,2055
202201,5호선,하남검단산,3668,3812,7480
202201,5호선,하남시청,3389,3248,6637
202201,5호선,하남풍산,1726,1850,3576
202201,5호선,행당,3262,2780,6042
202201,5호선,화곡,11712,10492,22204
202202,5호선,강동,10814,10409,21223
202202,5호선,강일,2295,2166,4461
202202,5호선,개롱,3462,3716,7178
202202,5호선,개화산,3268,3206,6474
202202,5호선,거여,4910,4788,9698
202202,5호선,고덕,5237,5174,10411
202202,5호선,공덕,5743,6116,11859
202202,5호선,광나루,8347,7786,16133
202202,5호선,광화문,11626,11752,23378
202202,5호선,군자,7143,7870,15013
202202,5호선,굽은다리,5799,5579,11378
202202,5호선,길동,5119,5315,10434
202202,5호선,김포공항,6424,6068,12492
202202,5호선,까치산,17786,17616,35402
202202,5호선,답십리,8616,8181,16797
202202,5호선,동대문역사문화공원,855,1136,1991
202202,5호선,둔촌동,4984,5073,10057
202202,5호선,마곡,4770,4855,9625
202202,5호선,마장,3146,3047,6193
202202,5호선,마천,3947,4010,7957
202202,5호선,마포,6174,6221,12395
202202,5호선,명일,5497,5487,10984
202202,5호선,목동,9422,9610,19032
202202,5호선,미사,9922,9819,19741
202202,5호선,발산,10790,11103,21893
202202,5호선,방이,4548,4331,8879
202202,5호선,방화,3757,3665,7422
202202,5호선,상일동,7701,7445,15146
202202,5호선,서대문,5795,5399,11194
202202,5호선,송정,4197,4168,8365
202202,5호선,신금호,3465,3660,7125
202202,5호선,신길,2195,2378,4573
202202,5호선,신정,7517,6534,14051
202202,5호선,아차산,9850,9502,19352
202202,5호선,애오개,3045,3102,6147
202202,5호선,양평,3095,3080,6175
202202,5호선,여의나루,4086,5471,9557
202202,5호선,여의도,9882,10017,19899
202202,5호선,영등포구청,1627,1552,3179
202202,5호선,영등포시장,6220,6550,12770
202202,5호선,오금,1768,1701,3469
202202,5호선,오목교,13197,13347,26544
202202,5호선,올림픽공원,2284,2003,4287
202202,5호선,왕십리,3133,3641,6774
202202,5호선,우장산,8179,8214,16393
202202,5호선,을지로4가,2649,2843,5492
202202,5호선,장한평,9604,9928,19532
202202,5호선,종로3가,9830,9524,19354
202202,5호선,천호,14128,13356,27484
202202,5호선,청구,2176,1980,4156
202202,5호선,충정로,1544,1531,3075
202202,5호선,하남검단산,4040,4154,8194
202202,5호선,하남시청,4302,4225,8527
202202,5호선,하남풍산,2322,2368,4690
202202,5호선,행당,4418,3836,8254
202202,5호선,화곡,16893,15811,32704
202202,5호선,강동,7474,7414,14888
202202,5호선,강일,1685,1562,3247
202202,5호선,개롱,2456,2685,5141
202202,5호선,개화산,2240,2250,4490
202202,5호선,거여,3592,3488,7080
202202,5호선,고덕,3465,3528,6993
202202,5호선,공덕,3652,3695,7347
202202,5호선,광나루,6489,6311,12800
202202,5호선,광화문,8435,8065,16500
202202,5호선,군자,5028,5683,10711
202202,5호선,굽은다리,4382,4143,8525
202202,5호선,길동,3574,3663,7237
202202,5호선,김포공항,6228,5752,11980
202202,5호선,까치산,12933,12676,25609
202202,5호선,답십리,6128,5907,12035
202202,5호선,동대문역사문화공원,631,690,1321
202202,5호선,둔촌동,3816,3919,7735
202202,5호선,마곡,3165,3314,6479
202202,5호선,마장,2368,2286,4654
202202,5호선,마천,2944,3228,6172
202202,5호선,마포,3920,4101,8021
202202,5호선,명일,3938,4052,7990
202202,5호선,목동,6356,6645,13001
202202,5호선,미사,7152,7089,14241
202202,5호선,발산,7515,7517,15032
202202,5호선,방이,3276,3221,6497
202202,5호선,방화,3008,3120,6128
202202,5호선,상일동,5245,5273,10518
202202,5호선,서대문,4169,4031,8200
202202,5호선,송정,2993,3010,6003
202202,5호선,신금호,2462,2757,5219
202202,5호선,신길,1590,1749,3339
202202,5호선,신정,5326,4824,10150
202202,5호선,아차산,8004,7806,15810
202202,5호선,애오개,2134,2247,4381
202202,5호선,양평,2190,2358,4548
202202,5호선,여의나루,4124,5005,9129
202202,5호선,여의도,6681,6605,13286
202202,5호선,영등포구청,1159,1129,2288
202202,5호선,영등포시장,4029,4307,8336
202202,5호선,오금,1228,1224,2452
202202,5호선,오목교,9388,9663,19051
202202,5호선,올림픽공원,1737,1565,3302
202202,5호선,왕십리,2062,2363,4425
202202,5호선,우장산,5687,5913,11600
202202,5호선,을지로4가,1250,1280,2530
202202,5호선,장한평,6709,6765,13474
202202,5호선,종로3가,6399,5845,12244
202202,5호선,천호,10425,9697,20122
202202,5호선,청구,1467,1394,2861
202202,5호선,충정로,1202,1235,2437
202202,5호선,하남검단산,3546,3593,7139
202202,5호선,하남시청,3190,3192,6382
202202,5호선,하남풍산,1741,1840,3581
202202,5호선,행당,3297,3107,6404
202202,5호선,화곡,11766,11366,23132
202202,5호선,강동,11929,11304,23233
202202,5호선,강일,2644,2467,5111
202202,5호선,개롱,3935,3995,7930
202202,5호선,개화산,3461,3417,6878
202202,5호선,거여,5515,5274,10789
202202,5호선,고덕,5613,5593,11206
202202,5호선,공덕,6351,6432,12783
202202,5호선,광나루,9322,8894,18216
202202,5호선,광화문,12032,12203,24235
202202,5호선,군자,7772,8380,16152
202202,5호선,굽은다리,6421,6041,12462
202202,5호선,길동,5601,5753,11354
202202,5호선,김포공항,6778,6765,13543
202202,5호선,까치산,19458,18861,38319
202202,5호선,답십리,9366,8645,18011
202202,5호선,동대문역사문화공원,920,1181,2101
202202,5호선,둔촌동,5591,5649,11240
202202,5호선,마곡,5141,5128,10269
202202,5호선,마장,3547,3319,6866
202202,5호선,마천,4440,4595,9035
202202,5호선,마포,6755,6909,13664
202202,5호선,명일,5469,5579,11048
202202,5호선,목동,10713,10936,21649
202202,5호선,미사,10637,10607,21244
202202,5호선,발산,12309,13024,25333
202202,5호선,방이,4845,4839,9684
202202,5호선,방화,4434,4203,8637
202202,5호선,상일동,8352,7820,16172
202202,5호선,서대문,6618,6424,13042
202202,5호선,송정,4451,4474,8925
202202,5호선,신금호,3923,4031,7954
202202,5호선,신길,2351,2439,4790
202202,5호선,신정,8166,7140,15306
202202,5호선,아차산,10960,10716,21676
202202,5호선,애오개,3305,3240,6545
202202,5호선,양평,3433,3361,6794
202202,5호선,여의나루,6533,7726,14259
202202,5호선,여의도,10132,10700,20832
202202,5호선,영등포구청,1856,1818,3674
202202,5호선,영등포시장,7503,7752,15255
202202,5호선,오금,1959,1853,3812
202202,5호선,오목교,15039,15423,30462
202202,5호선,올림픽공원,2677,2367,5044
202202,5호선,왕십리,3293,3819,7112
202202,5호선,우장산,8903,8852,17755
202202,5호선,을지로4가,3004,3480,6484
202202,5호선,장한평,10321,10387,20708
202202,5호선,종로3가,10364,10321,20685
202202,5호선,천호,15428,14490,29918
202202,5호선,청구,2393,2234,4627
202202,5호선,충정로,1705,1626,3331
202202,5호선,하남검단산,4778,4679,9457
202202,5호선,하남시청,4716,4557,9273
202202,5호선,하남풍산,2392,2469,4861
202202,5호선,행당,4829,4188,9017
202202,5호선,화곡,18454,17208,35662
202202,5호선,강동,7796,7816,15612
202202,5호선,강일,1823,1799,3622
202202,5호선,개롱,2558,2855,5413
202202,5호선,개화산,2330,2446,4776
202202,5호선,거여,3796,3748,7544
202202,5호선,고덕,3898,3772,7670
202202,5호선,공덕,4046,3973,8019
202202,5호선,광나루,6579,6550,13129
202202,5호선,광화문,9060,8911,17971
202202,5호선,군자,5611,6023,11634
202202,5호선,굽은다리,4628,4412,9040
202202,5호선,길동,3720,3989,7709
202202,5호선,김포공항,5973,5883,11856
202202,5호선,까치산,13926,13743,27669
202202,5호선,답십리,6721,6271,12992
202202,5호선,동대문역사문화공원,687,761,1448
202202,5호선,둔촌동,4004,4115,8119
202202,5호선,마곡,3258,3348,6606
202202,5호선,마장,2439,2441,4880
202202,5호선,마천,3304,3544,6848
202202,5호선,마포,4215,4283,8498
202202,5호선,명일,4249,4244,8493
202202,5호선,목동,6756,6868,13624
202202,5호선,미사,7675,7737,15412
202202,5호선,발산,7873,8206,16079
202202,5호선,방이,3445,3415,6860
202202,5호선,방화,3149,3130,6279
202202,5호선,상일동,5702,5638,11340
202202,5호선,서대문,4569,4553,9122
202202,5호선,송정,3180,3201,6381
202202,5호선,신금호,2481,2821,5302
202202,5호선,신길,1611,1880,3491
202202,5호선,신정,5646,5109,10755
202202,5호선,아차산,8887,8833,17720
202202,5호선,애오개,2316,2348,4664
202202,5호선,양평,2354,2417,4771
202202,5호선,여의나루,6381,6972,13353
202202,5호선,여의도,7258,7525,14783
202202,5호선,영등포구청,1280,1186,2466
202202,5호선,영등포시장,4760,5004,9764
202202,5호선,오금,1409,1357,2766
202202,5호선,오목교,10143,10473,20616
202202,5호선,올림픽공원,1885,1743,3628
202202,5호선,왕십리,2227,2696,4923
202202,5호선,우장산,6207,6233,12440
202202,5호선,을지로4가,1374,1315,2689
202202,5호선,장한평,6820,7005,13825
202202,5호선,종로3가,7625,6937,14562
202202,5호선,천호,11133,10418,21551
202202,5호선,청구,1641,1460,3101
202202,5호선,충정로,1244,1243,2487
202202,5호선,하남검단산,3990,4113,8103
202202,5호선,하남시청,3311,3225,6536
202202,5호선,하남풍산,1939,1891,3830
202202,5호선,행당,3452,3228,6680
202202,5호선,화곡,12522,11934,24456
202202,5호선,강동,11917,11403,23320
202202,5호선,강일,2447,2310,4757
202202,5호선,개롱,3697,3921,7618
202202,5호선,개화산,3334,3336,6670
202202,5호선,거여,5453,5306,10759
202202,5호선,고덕,5492,5408,10900
202202,5호선,공덕,6143,6396,12539
202202,5호선,광나루,8696,8261,16957
202202,5호선,광화문,14230,14556,28786
202202,5호선,군자,7634,8345,15979
202202,5호선,굽은다리,6346,5965,12311
202202,5호선,길동,5461,5696,11157
202202,5호선,김포공항,6922,6835,13757
202202,5호선,까치산,19196,18696,37892
202202,5호선,답십리,9074,8489,17563
202202,5호선,동대문역사문화공원,948,1227,2175
202202,5호선,둔촌동,5706,5727,11433
202202,5호선,마곡,5363,5363,10726
202202,5호선,마장,3484,3397,6881
202202,5호선,마천,4303,4552,8855
202202,5호선,마포,6666,6710,13376
202202,5호선,명일,5472,5540,11012
202202,5호선,목동,10044,10232,20276
202202,5호선,미사,10516,10438,20954
202202,5호선,발산,12567,12952,25519
202202,5호선,방이,4987,4978,9965
202202,5호선,방화,4228,4078,8306
202202,5호선,상일동,8224,7889,16113
202202,5호선,서대문,6480,6196,12676
202202,5호선,송정,4537,4513,9050
202202,5호선,신금호,3812,3972,7784
202202,5호선,신길,2280,2539,4819
202202,5호선,신정,8073,7144,15217
202202,5호선,아차산,11366,10984,22350
202202,5호선,애오개,3213,3297,6510
202202,5호선,양평,3270,3220,6490
202202,5호선,여의나루,5302,6672,11974
202202,5호선,여의도,10177,9877,20054
202202,5호선,영등포구청,1757,1640,3397
202202,5호선,영등포시장,7366,7690,15056
202202,5호선,오금,1951,1868,3819
202202,5호선,오목교,15317,15316,30633
202202,5호선,올림픽공원,2698,2438,5136
202202,5호선,왕십리,3162,3753,6915
202202,5호선,우장산,8692,8706,17398
202202,5호선,을지로4가,2871,3398,6269
202202,5호선,장한평,9957,9993,19950
202202,5호선,종로3가,10223,10410,20633
202202,5호선,천호,14976,14000,28976
202202,5호선,청구,2323,2116,4439
202202,5호선,충정로,1682,1630,3312
202202,5호선,하남검단산,4633,4797,9430
202202,5호선,하남시청,4948,4833,9781
202202,5호선,하남풍산,2316,2390,4706
202202,5호선,행당,4785,4263,9048
202202,5호선,화곡,18050,16938,34988
202202,5호선,강동,8173,8004,16177
202202,5호선,강일,1725,1618,3343
202202,5호선,개롱,2410,2678,5088
202202,5호선,개화산,2289,2330,4619
202202,5호선,거여,3825,3644,7469
202202,5호선,고덕,3700,3730,7430
202202,5호선,공덕,3806,3906,7712
202202,5호선,광나루,6269,6311,12580
202202,5호선,광화문,8791,8762,17553
202202,5호선,군자,5142,5697,10839
202202,5호선,굽은다리,4674,4380,9054
202202,5호선,길동,3546,3696,7242
202202,5호선,김포공항,6376,6098,12474
202202,5호선,까치산,13212,13134,26346
202202,5호선,답십리,6254,5827,12081
202202,5호선,동대문역사문화공원,671,734,1405
202202,5호선,둔촌동,3745,3969,7714
202202,5호선,마곡,3165,3287,6452
202202,5호선,마장,2413,2257,4670
202202,5호선,마천,3036,3345,6381
202202,5호선,마포,4170,4284,8454
202202,5호선,명일,3865,3931,7796
202202,5호선,목동,6457,6748,13205
202202,5호선,미사,7253,7159,14412
202202,5호선,발산,7755,7935,15690
202202,5호선,방이,3226,3228,6454
202202,5호선,방화,2894,3076,5970
202202,5호선,상일동,5441,5464,10905
202202,5호선,서대문,4339,4245,8584
202202,5호선,송정,3029,3083,6112
202202,5호선,신금호,2584,2814,5398
202202,5호선,신길,1565,1827,3392
202202,5호선,신정,5431,4907,10338
202202,5호선,아차산,8876,8559,17435
202202,5호선,애오개,2238,2368,4606
202202,5호선,양평,2222,2285,4507
202202,5호선,여의나루,4174,5410,9584
202202,5호선,여의도,6854,6966,13820
202202,5호선,영등포구청,1110,1078,2188
202202,5호선,영등포시장,4783,5020,9803
202202,5호선,오금,1259,1263,2522
202202,5호선,오목교,10195,10281,20476
202202,5호선,올림픽공원,1851,1719,3570
202202,5호선,왕십리,2229,2555,4784
202202,5호선,우장산,5643,5785,11428
202202,5호선,을지로4가,1220,1309,2529
202202,5호선,장한평,6570,6672,13242
202202,5호선,종로3가,6672,6027,12699
202202,5호선,천호,10831,9978,20809
202202,5호선,청구,1598,1386,2984
202202,5호선,충정로,1202,1256,2458
202202,5호선,하남검단산,3613,3566,7179
202202,5호선,하남시청,3232,3197,6429
202202,5호선,하남풍산,1729,1801,3530
202202,5호선,행당,3350,3013,6363
202202,5호선,화곡,11856,11389,23245
202202,5호선,강동,11294,10761,22055
202202,5호선,강일,2328,2170,4498
202202,5호선,개롱,3782,3924,7706
202202,5호선,개화산,3258,3195,6453
202202,5호선,거여,5311,5069,10380
202202,5호선,고덕,5400,5314,10714
202202,5호선,공덕,5928,6199,12127
202202,5호선,광나루,8798,8450,17248
202202,5호선,광화문,11844,11990,23834
202202,5호선,군자,7210,7871,15081
202202,5호선,굽은다리,6042,5694,11736
202202,5호선,길동,5233,5400,10633
202202,5호선,김포공항,6634,6958,13592
202202,5호선,까치산,18414,17919,36333
202202,5호선,답십리,8785,8248,17033
202202,5호선,동대문역사문화공원,907,1148,2055
202202,5호선,둔촌동,5602,5533,11135
202202,5호선,마곡,4828,4734,9562
202202,5호선,마장,3330,3120,6450
202202,5호선,마천,4173,4329,8502
202202,5호선,마포,6479,6587,13066
202202,5호선,명일,5235,5205,10440
202202,5호선,목동,9856,9928,19784
202202,5호선,미사,9890,9694,19584
202202,5호선,발산,11949,12455,24404
202202,5호선,방이,4353,4386,8739
202202,5호선,방화,3972,3926,7898
202202,5호선,상일동,7818,7377,15195
202202,5호선,서대문,5977,5853,11830
202202,5호선,송정,4351,4342,8693
202202,5호선,신금호,3636,3769,7405
202202,5호선,신길,2313,2490,4803
202202,5호선,신정,8012,6926,14938
202202,5호선,아차산,10591,10385,20976
202202,5호선,애오개,3138,3108,6246
202202,5호선,양평,3213,3010,6223
202202,5호선,여의나루,5318,7407,12725
202202,5호선,여의도,10877,10681,21558
202202,5호선,영등포구청,1625,1670,3295
202202,5호선,영등포시장,7299,7523,14822
202202,5호선,오금,1871,1806,3677
202202,5호선,오목교,14767,15115,29882
202202,5호선,올림픽공원,2406,2037,4443
202202,5호선,왕십리,3089,3650,6739
202202,5호선,우장산,8534,8451,16985
202202,5호선,을지로4가,2749,3075,5824
202202,5호선,장한평,9738,9579,19317
202202,5호선,종로3가,9638,9712,19350
202202,5호선,천호,14737,13763,28500
202202,5호선,청구,2293,2027,4320
202202,5호선,충정로,1670,1545,3215
202202,5호선,하남검단산,4278,4353,8631
202202,5호선,하남시청,4583,4401,8984
202202,5호선,하남풍산,2366,2370,4736
202202,5호선,행당,4586,4082,8668
202202,5호선,화곡,17339,16241,33580
202202,5호선,강동,7945,7782,15727
202202,5호선,강일,1829,1769,3598
202202,5호선,개롱,2576,2832,5408
202202,5호선,개화산,2379,2511,4890
202202,5호선,거여,3930,3819,7749
202202,5호선,고덕,3724,3695,7419
202202,5호선,공덕,3998,3967,7965
202202,5호선,광나루,6737,6690,13427
202202,5호선,광화문,10206,9939,20145
202202,5호선,군자,5351,5776,11127
202202,5호선,굽은다리,4495,4187,8682
202202,5호선,길동,3699,3938,7637
202202,5호선,김포공항,6211,5869,12080
202202,5호선,까치산,13686,13498,27184
202202,5호선,답십리,6564,6178,12742
202202,5호선,동대문역사문화공원,612,804,1416
202202,5호선,둔촌동,4002,4113,8115
202202,5호선,마곡,3249,3303,6552
202202,5호선,마장,2466,2481,4947
202202,5호선,마천,3247,3422,6669
202202,5호선,마포,4196,4263,8459
202202,5호선,명일,4143,4206,8349
202202,5호선,목동,6715,6788,13503
202202,5호선,미사,7444,7444,14888
202202,5호선,발산,8426,8846,17272
202202,5호선,방이,3270,3161,6431
202202,5호선,방화,3066,3064,6130
202202,5호선,상일동,5577,5564,11141
202202,5호선,서대문,4597,4488,9085
202202,5호선,송정,3250,3152,6402
202202,5호선,신금호,2573,2799,5372
202202,5호선,신길,1729,1913,3642
202202,5호선,신정,5477,5040,10517
202202,5호선,아차산,9684,9599,19283
202202,5호선,애오개,2267,2291,4558
202202,5호선,양평,2261,2245,4506
202202,5호선,여의나루,7285,8541,15826
202202,5호선,여의도,8116,7975,16091
202202,5호선,영등포구청,1166,1139,2305
202202,5호선,영등포시장,5027,5231,10258
202202,5호선,오금,1470,1457,2927
202202,5호선,오목교,10252,10512,20764
202202,5호선,올림픽공원,2012,1733,3745
202202,5호선,왕십리,2181,2511,4692
202202,5호선,우장산,5895,6055,11950
202202,5호선,을지로4가,1343,1524,2867
202202,5호선,장한평,6699,6712,13411
202202,5호선,종로3가,7610,7037,14647
202202,5호선,천호,11105,10105,21210
202202,5호선,청구,1622,1507,3129
202202,5호선,충정로,1311,1286,2597
202202,5호선,하남검단산,4072,4090,8162
202202,5호선,하남시청,3325,3315,6640
202202,5호선,하남풍산,1814,1796,3610
202202,5호선,행당,3535,3262,6797
202202,5호선,화곡,12245,11719,23964
202203,5호선,강동,11203,10818,22021
202203,5호선,강일,2327,2248,4575
202203,5호선,개롱,3866,4045,7911
202203,5호선,개화산,3240,3265,6505
202203,5호선,거여,5414,5243,10657
202203,5호선,고덕,5527,5540,11067
202203,5호선,공덕,5928,6158,12086
202203,5호선,광나루,8569,8107,16676
202203,5호선,광화문,16403,16833,33236
202203,5호선,군자,7662,8505,16167
202203,5호선,굽은다리,6227,5782,12009
202203,5호선,길동,5280,5516,10796
202203,5호선,김포공항,6269,6379,12648
202203,5호선,까치산,18445,18025,36470
202203,5호선,답십리,9153,8407,17560
202203,5호선,동대문역사문화공원,897,1164,2061
202203,5호선,둔촌동,5434,5401,10835
202203,5호선,마곡,5001,4994,9995
202203,5호선,마장,3505,3355,6860
202203,5호선,마천,4160,4321,8481
202203,5호선,마포,6327,6429,12756
202203,5호선,명일,5457,5346,10803
202203,5호선,목동,9575,9714,19289
202203,5호선,미사,10149,9920,20069
202203,5호선,발산,11973,12513,24486
202203,5호선,방이,4899,4783,9682
202203,5호선,방화,4141,3996,8137
202203,5호선,상일동,7932,7508,15440
202203,5호선,서대문,6165,6050,12215
202203,5호선,송정,4461,4270,8731
202203,5호선,신금호,3729,3836,7565
202203,5호선,신길,2313,2406,4719
202203,5호선,신정,8018,7050,15068
202203,5호선,아차산,13420,13157,26577
202203,5호선,애오개,3106,3126,6232
202203,5호선,양평,3241,3116,6357
202203,5호선,여의나루,6446,8417,14863
202203,5호선,여의도,11186,11040,22226
202203,5호선,영등포구청,1683,1616,3299
202203,5호선,영등포시장,7165,7571,14736
202203,5호선,오금,2142,2084,4226
202203,5호선,오목교,14324,14671,28995
202203,5호선,올림픽공원,2506,2234,4740
202203,5호선,왕십리,3165,3730,6895
202203,5호선,우장산,8512,8442,16954
202203,5호선,을지로4가,2910,3070,5980
202203,5호선,장한평,9700,9738,19438
202203,5호선,종로3가,10547,10406,20953
202203,5호선,천호,14794,13949,28743
202203,5호선,청구,2208,2071,4279
202203,5호선,충정로,1695,1606,3301
202203,5호선,하남검단산,4377,4453,8830
202203,5호선,하남시청,4642,4554,9196
202203,5호선,하남풍산,2446,2500,4946
202203,5호선,행당,4470,4048,8518
202203,5호선,화곡,17903,16544,34447
202203,5호선,강동,7803,7553,15356
202203,5호선,강일,1752,1624,3376
202203,5호선,개롱,2469,2741,5210
202203,5호선,개화산,2315,2330,4645
202203,5호선,거여,3716,3617,7333
202203,5호선,고덕,3747,3750,7497
202203,5호선,공덕,3810,3947,7757
202203,5호선,광나루,6612,6769,13381
202203,5호선,광화문,9190,9175,18365
202203,5호선,군자,5146,5828,10974
202203,5호선,굽은다리,4629,4374,9003
202203,5호선,길동,3483,3609,7092
202203,5호선,김포공항,5766,5539,11305
202203,5호선,까치산,13056,12672,25728
202203,5호선,답십리,6272,5824,12096
202203,5호선,동대문역사문화공원,605,737,1342
202203,5호선,둔촌동,3658,3785,7443
202203,5호선,마곡,3089,3192,6281
202203,5호선,마장,2419,2273,4692
202203,5호선,마천,3051,3215,6266
202203,5호선,마포,3977,3975,7952
202203,5호선,명일,3897,3926,7823
202203,5호선,목동,6389,6411,12800
202203,5호선,미사,7197,7183,14380
202203,5호선,발산,7784,8034,15818
202203,5호선,방이,3412,3259,6671
202203,5호선,방화,2984,2986,5970
202203,5호선,상일동,5460,5371,10831
202203,5호선,서대문,4367,4210,8577
202203,5호선,송정,3143,3113,6256
202203,5호선,신금호,2535,2715,5250
202203,5호선,신길,1555,1764,3319
202203,5호선,신정,5401,4896,10297
202203,5호선,아차산,9314,9054,18368
202203,5호선,애오개,2182,2268,4450
202203,5호선,양평,2175,2282,4457
202203,5호선,여의나루,6214,7504,13718
202203,5호선,여의도,7551,7403,14954
202203,5호선,영등포구청,1072,1115,2187
202203,5호선,영등포시장,4475,4750,9225
202203,5호선,오금,1371,1297,2668
202203,5호선,오목교,9988,10150,20138
202203,5호선,올림픽공원,1773,1636,3409
202203,5호선,왕십리,2255,2617,4872
202203,5호선,우장산,5612,5854,11466
202203,5호선,을지로4가,1208,1302,2510
202203,5호선,장한평,6467,6378,12845
202203,5호선,종로3가,6976,6221,13197
202203,5호선,천호,10996,9714,20710
202203,5호선,청구,1537,1394,2931
202203,5호선,충정로,1204,1248,2452
202203,5호선,하남검단산,3895,3835,7730
202203,5호선,하남시청,3314,3217,6531
202203,5호선,하남풍산,1850,1798,3648
202203,5호선,행당,3144,2981,6125
202203,5호선,화곡,11813,11214,23027
202203,5호선,강동,11610,11133,22743
202203,5호선,강일,2529,2326,4855
202203,5호선,개롱,3580,3820,7400
202203,5호선,개화산,3410,3331,6741
202203,5호선,거여,5704,5393,11097
202203,5호선,고덕,5631,5376,11007
202203,5호선,공덕,5882,6069,11951
202203,5호선,광나루,9351,8949,18300
202203,5호선,광화문,14077,14408,28485
202203,5호선,군자,7300,8063,15363
202203,5호선,굽은다리,6201,5815,12016
202203,5호선,길동,5355,5505,10860
202203,5호선,김포공항,6192,6319,12511
202203,5호선,까치산,18851,17998,36849
202203,5호선,답십리,9056,8208,17264
202203,5호선,동대문역사문화공원,931,1131,2062
202203,5호선,둔촌동,5428,5263,10691
202203,5호선,마곡,4820,4829,9649
202203,5호선,마장,3379,3204,6583
202203,5호선,마천,4194,4395,8589
202203,5호선,마포,6529,6485,13014
202203,5호선,명일,5301,5304,10605
202203,5호선,목동,9695,9750,19445
202203,5호선,미사,10201,10199,20400
202203,5호선,발산,12326,12800,25126
202203,5호선,방이,4514,4550,9064
202203,5호선,방화,3992,3862,7854
202203,5호선,상일동,7998,7548,15546
202203,5호선,서대문,6075,5868,11943
202203,5호선,송정,4481,4365,8846
202203,5호선,신금호,3516,3622,7138
202203,5호선,신길,2242,2361,4603
202203,5호선,신정,7990,6875,14865
202203,5호선,아차산,12200,11916,24116
202203,5호선,애오개,3179,3106,6285
202203,5호선,양평,3265,3086,6351
202203,5호선,여의나루,10047,11528,21575
202203,5호선,여의도,10759,11118,21877
202203,5호선,영등포구청,1799,1827,3626
202203,5호선,영등포시장,7278,7607,14885
202203,5호선,오금,1818,1736,3554
202203,5호선,오목교,14160,14405,28565
202203,5호선,올림픽공원,2646,2405,5051
202203,5호선,왕십리,2981,3594,6575
202203,5호선,우장산,8398,8399,16797
202203,5호선,을지로4가,2920,3389,6309
202203,5호선,장한평,9735,9581,19316
202203,5호선,종로3가,10428,10548,20976
202203,5호선,천호,14771,14140,28911
202203,5호선,청구,2197,2052,4249
202203,5호선,충정로,1692,1541,3233
202203,5호선,하남검단산,4522,4539,9061
202203,5호선,하남시청,4750,4502,9252
202203,5호선,하남풍산,2309,2281,4590
202203,5호선,행당,4656,4039,8695
202203,5호선,화곡,17686,16387,34073
202203,5호선,강동,6887,6925,13812
202203,5호선,강일,1461,1453,2914
202203,5호선,개롱,2163,2408,4571
202203,5호선,개화산,2161,2114,4275
202203,5호선,거여,3668,3548,7216
202203,5호선,고덕,3098,3058,6156
202203,5호선,공덕,3506,3437,6943
202203,5호선,광나루,5898,5653,11551
202203,5호선,광화문,8077,8164,16241
202203,5호선,군자,4540,5089,9629
202203,5호선,굽은다리,3928,3688,7616
202203,5호선,길동,3259,3320,6579
202203,5호선,김포공항,5493,5357,10850
202203,5호선,까치산,12117,11918,24035
202203,5호선,답십리,5540,5261,10801
202203,5호선,동대문역사문화공원,596,695,1291
202203,5호선,둔촌동,3449,3425,6874
202203,5호선,마곡,2783,3050,5833
202203,5호선,마장,2195,2109,4304
202203,5호선,마천,2578,2691,5269
202203,5호선,마포,3632,3550,7182
202203,5호선,명일,3354,3402,6756
202203,5호선,목동,5825,5901,11726
202203,5호선,미사,6413,6337,12750
202203,5호선,발산,7382,7582,14964
202203,5호선,방이,3037,2832,5869
202203,5호선,방화,2748,2671,5419
202203,5호선,상일동,4759,4551,9310
202203,5호선,서대문,3941,3819,7760
202203,5호선,송정,2752,2835,5587
202203,5호선,신금호,2193,2291,4484
202203,5호선,신길,1479,1692,3171
202203,5호선,신정,4993,4366,9359
202203,5호선,아차산,6914,6800,13714
202203,5호선,애오개,1979,2058,4037
202203,5호선,양평,2032,2006,4038
202203,5호선,여의나루,4746,5809,10555
202203,5호선,여의도,6372,6623,12995
202203,5호선,영등포구청,1001,1018,2019
202203,5호선,영등포시장,4263,4476,8739
202203,5호선,오금,1106,1053,2159
202203,5호선,오목교,9099,9064,18163
202203,5호선,올림픽공원,1518,1443,2961
202203,5호선,왕십리,1836,2224,4060
202203,5호선,우장산,5158,5221,10379
202203,5호선,을지로4가,1151,1175,2326
202203,5호선,장한평,6060,5896,11956
202203,5호선,종로3가,6067,5458,11525
202203,5호선,천호,9738,8979,18717
202203,5호선,청구,1322,1225,2547
202203,5호선,충정로,1122,1080,2202
202203,5호선,하남검단산,2851,2908,5759
202203,5호선,하남시청,2776,2804,5580
202203,5호선,하남풍산,1526,1570,3096
202203,5호선,행당,3007,2771,5778
202203,5호선,화곡,10884,10458,21342
202203,5호선,강동,10266,9776,20042
202203,5호선,강일,2118,1960,4078
202203,5호선,개롱,3259,3404,6663
202203,5호선,개화산,2967,2889,5856
202203,5호선,거여,5032,4848,9880
202203,5호선,고덕,4943,4895,9838
202203,5호선,공덕,5594,5657,11251
202203,5호선,광나루,7030,6386,13416
202203,5호선,광화문,10679,11271,21950
202203,5호선,군자,6782,7560,14342
202203,5호선,굽은다리,5619,5261,10880
202203,5호선,길동,5036,5286,10322
202203,5호선,김포공항,6054,6120,12174
202203,5호선,까치산,16890,16253,33143
202203,5호선,답십리,8402,7808,16210
202203,5호선,동대문역사문화공원,883,1142,2025
202203,5호선,둔촌동,5171,5004,10175
202203,5호선,마곡,4386,4447,8833
202203,5호선,마장,3078,2918,5996
202203,5호선,마천,3698,3801,7499
202203,5호선,마포,6099,6171,12270
202203,5호선,명일,4771,4759,9530
202203,5호선,목동,8958,8908,17866
202203,5호선,미사,9577,9466,19043
202203,5호선,발산,11699,12258,23957
202203,5호선,방이,4373,4295,8668
202203,5호선,방화,3534,3391,6925
202203,5호선,상일동,7238,6751,13989
202203,5호선,서대문,5699,5283,10982
202203,5호선,송정,3942,3762,7704
202203,5호선,신금호,3293,3280,6573
202203,5호선,신길,2186,2208,4394
202203,5호선,신정,7274,6217,13491
202203,5호선,아차산,9100,8722,17822
202203,5호선,애오개,2957,2838,5795
202203,5호선,양평,3124,2961,6085
202203,5호선,여의나루,5427,7100,12527
202203,5호선,여의도,9862,10341,20203
202203,5호선,영등포구청,1586,1583,3169
202203,5호선,영등포시장,6625,6891,13516
202203,5호선,오금,1739,1593,3332
202203,5호선,오목교,13649,13797,27446
202203,5호선,올림픽공원,2115,1951,4066
202203,5호선,왕십리,2854,3263,6117
202203,5호선,우장산,7842,7830,15672
202203,5호선,을지로4가,2531,2878,5409
202203,5호선,장한평,8997,8898,17895
202203,5호선,종로3가,9293,9510,18803
202203,5호선,천호,13525,12708,26233
202203,5호선,청구,2086,1971,4057
202203,5호선,충정로,1592,1393,2985
202203,5호선,하남검단산,3615,3590,7205
202203,5호선,하남시청,4408,4311,8719
202203,5호선,하남풍산,2083,2206,4289
202203,5호선,행당,4037,3527,7564
202203,5호선,화곡,16039,14846,30885
202203,5호선,강동,7461,7447,14908
202203,5호선,강일,1741,1703,3444
202203,5호선,개롱,2470,2701,5171
202203,5호선,개화산,2406,2435,4841
202203,5호선,거여,3815,3761,7576
202203,5호선,고덕,3697,3713,7410
202203,5호선,공덕,3861,3704,7565
202203,5호선,광나루,6271,6213,12484
202203,5호선,광화문,8907,8878,17785
202203,5호선,군자,5224,5772,10996
202203,5호선,굽은다리,4407,4198,8605
202203,5호선,길동,3503,3597,7100
202203,5호선,김포공항,6034,5750,11784
202203,5호선,까치산,13127,12862,25989
202203,5호선,답십리,6407,5935,12342
202203,5호선,동대문역사문화공원,654,757,1411
202203,5호선,둔촌동,3831,3846,7677
202203,5호선,마곡,3109,3275,6384
202203,5호선,마장,2425,2363,4788
202203,5호선,마천,3045,3169,6214
202203,5호선,마포,4204,4131,8335
202203,5호선,명일,4040,4022,8062
202203,5호선,목동,6517,6753,13270
202203,5호선,미사,7485,7538,15023
202203,5호선,발산,8196,8518,16714
202203,5호선,방이,3392,3123,6515
202203,5호선,방화,3083,3038,6121
202203,5호선,상일동,5414,5295,10709
202203,5호선,서대문,4334,4201,8535
202203,5호선,송정,3087,3113,6200
202203,5호선,신금호,2503,2701,5204
202203,5호선,신길,1661,1878,3539
202203,5호선,신정,5374,4971,10345
202203,5호선,아차산,8988,8907,17895
202203,5호선,애오개,2464,2610,5074
202203,5호선,양평,2268,2400,4668
202203,5호선,여의나루,7943,8889,16832
202203,5호선,여의도,7456,7257,14713
202203,5호선,영등포구청,1211,1176,2387
202203,5호선,영등포시장,4496,4795,9291
202203,5호선,오금,1275,1253,2528
202203,5호선,오목교,9717,9919,19636
202203,5호선,올림픽공원,1819,1803,3622
202203,5호선,왕십리,2185,2405,4590
202203,5호선,우장산,5804,5871,11675
202203,5호선,을지로4가,1381,1374,2755
202203,5호선,장한평,6611,6507,13118
202203,5호선,종로3가,7767,6742,14509
202203,5호선,천호,10964,10091,21055
202203,5호선,청구,1601,1399,3000
202203,5호선,충정로,1210,1184,2394
202203,5호선,하남검단산,3824,3769,7593
202203,5호선,하남시청,3363,3335,6698
202203,5호선,하남풍산,1808,1772,3580
202203,5호선,행당,3282,2965,6247
202203,5호선,화곡,12059,11360,23419
202203,5호선,강동,11043,10423,21466
202203,5호선,강일,2312,2249,4561
202203,5호선,개롱,3407,3578,6985
202203,5호선,개화산,3168,3037,6205
202203,5호선,거여,5237,5108,10345
202203,5호선,고덕,6248,5926,12174
202203,5호선,공덕,5942,6231,12173
202203,5호선,광나루,7863,7105,14968
202203,5호선,광화문,12991,13273,26264
202203,5호선,군자,7235,8177,15412
202203,5호선,굽은다리,6004,5533,11537
202203,5호선,길동,5202,5333,10535
202203,5호선,김포공항,6393,6700,13093
202203,5호선,까치산,17881,17120,35001
202203,5호선,답십리,8672,7969,16641
202203,5호선,동대문역사문화공원,906,1175,2081
202203,5호선,둔촌동,5422,5241,10663
202203,5호선,마곡,4598,4729,9327
202203,5호선,마장,3192,3069,6261
202203,5호선,마천,3906,4094,8000
202203,5호선,마포,6256,6334,12590
202203,5호선,명일,5116,5020,10136
202203,5호선,목동,9431,9460,18891
202203,5호선,미사,10233,10042,20275
202203,5호선,발산,11632,12177,23809
202203,5호선,방이,4368,4312,8680
202203,5호선,방화,3906,3657,7563
202203,5호선,상일동,7524,7038,14562
202203,5호선,서대문,6141,5750,11891
202203,5호선,송정,4253,3964,8217
202203,5호선,신금호,3438,3498,6936
202203,5호선,신길,2284,2333,4617
202203,5호선,신정,7610,6535,14145
202203,5호선,아차산,9848,9714,19562
202203,5호선,애오개,3226,3076,6302
202203,5호선,양평,3186,3078,6264
202203,5호선,여의나루,8957,10308,19265
202203,5호선,여의도,10510,11092,21602
202203,5호선,영등포구청,1708,1680,3388
202203,5호선,영등포시장,6798,7161,13959
202203,5호선,오금,1703,1655,3358
202203,5호선,오목교,14673,14743,29416
202203,5호선,올림픽공원,2324,2115,4439
202203,5호선,왕십리,3042,3652,6694
202203,5호선,우장산,8298,8119,16417
202203,5호선,을지로4가,2759,3131,5890
202203,5호선,장한평,9485,9374,18859
202203,5호선,종로3가,10337,10873,21210
202203,5호선,천호,14281,13350,27631
202203,5호선,청구,2320,2041,4361
202203,5호선,충정로,1670,1558,3228
202203,5호선,하남검단산,4007,3830,7837
202203,5호선,하남시청,4357,4326,8683
202203,5호선,하남풍산,2291,2319,4610
202203,5호선,행당,4436,3916,8352
202203,5호선,화곡,17316,15970,33286
202203,5호선,강동,8051,8282,16333
202203,5호선,강일,1956,1858,3814
202203,5호선,개롱,2698,2942,5640
202203,5호선,개화산,2523,2582,5105
202203,5호선,거여,4112,4015,8127
202203,5호선,고덕,3928,3960,7888
202203,5호선,공덕,3973,3928,7901
202203,5호선,광나루,7262,7239,14501
202203,5호선,광화문,9859,9484,19343
202203,5호선,군자,5537,6121,11658
202203,5호선,굽은다리,4554,4221,8775
202203,5호선,길동,3885,4037,7922
202203,5호선,김포공항,6159,6132,12291
202203,5호선,까치산,14114,13950,28064
202203,5호선,답십리,6709,6360,13069
202203,5호선,동대문역사문화공원,641,830,1471
202203,5호선,둔촌동,4194,4236,8430
202203,5호선,마곡,3411,3521,6932
202203,5호선,마장,2574,2497,5071
202203,5호선,마천,3367,3607,6974
202203,5호선,마포,4448,4441,8889
202203,5호선,명일,4383,4279,8662
202203,5호선,목동,6843,7014,13857
202203,5호선,미사,8147,7956,16103
202203,5호선,발산,8636,8820,17456
202203,5호선,방이,3565,3415,6980
202203,5호선,방화,3185,3194,6379
202203,5호선,상일동,5767,5531,11298
202203,5호선,서대문,4609,4515,9124
202203,5호선,송정,3318,3412,6730
202203,5호선,신금호,2666,2865,5531
202203,5호선,신길,1723,2020,3743
202203,5호선,신정,5787,5225,11012
202203,5호선,아차산,10393,10573,20966
202203,5호선,애오개,2330,2484,4814
202203,5호선,양평,2296,2337,4633
202203,5호선,여의나루,11363,12947,24310
202203,5호선,여의도,8592,8131,16723
202203,5호선,영등포구청,1288,1164,2452
202203,5호선,영등포시장,4843,5135,9978
202203,5호선,오금,1335,1284,2619
202203,5호선,오목교,10215,10402,20617
202203,5호선,올림픽공원,2054,1890,3944
202203,5호선,왕십리,2167,2587,4754
202203,5호선,우장산,6094,6283,12377
202203,5호선,을지로4가,1422,1514,2936
202203,5호선,장한평,7181,7124,14305
202203,5호선,종로3가,8346,7732,16078
202203,5호선,천호,11653,10691,22344
202203,5호선,청구,1651,1497,3148
202203,5호선,충정로,1283,1247,2530
202203,5호선,하남검단산,4214,4244,8458
202203,5호선,하남시청,3519,3419,6938
202203,5호선,하남풍산,1964,1978,3942
202203,5호선,행당,3539,3315,6854
202203,5호선,화곡,12819,12302,25121
202204,5호선,강동,12506,11967,24473
202204,5호선,강일,2758,2568,5326
202204,5호선,개롱,3866,4029,7895
202204,5호선,개화산,3554,3613,7167
202204,5호선,거여,6169,5895,12064
202204,5호선,고덕,6270,6144,12414
202204,5호선,공덕,6773,6992,13765
202204,5호선,광나루,9494,9039,18533
202204,5호선,광화문,15813,15649,31462
202204,5호선,군자,8023,8740,16763
202204,5호선,굽은다리,7308,6544,13852
202204,5호선,길동,5521,5817,11338
202204,5호선,김포공항,6827,7113,13940
202204,5호선,까치산,20050,19152,39202
202204,5호선,답십리,9808,8824,18632
202204,5호선,동대문역사문화공원,947,1232,2179
202204,5호선,둔촌동,6030,6031,12061
202204,5호선,마곡,5240,5254,10494
202204,5호선,마장,3979,3787,7766
202204,5호선,마천,4562,4787,9349
202204,5호선,마포,7134,7130,14264
202204,5호선,명일,6118,6086,12204
202204,5호선,목동,10612,10784,21396
202204,5호선,미사,11766,11656,23422
202204,5호선,발산,13018,13683,26701
202204,5호선,방이,5275,5129,10404
202204,5호선,방화,4361,4108,8469
202204,5호선,상일동,8972,8438,17410
202204,5호선,서대문,6990,6549,13539
202204,5호선,송정,4688,4547,9235
202204,5호선,신금호,3859,4044,7903
202204,5호선,신길,2604,2775,5379
202204,5호선,신정,8737,7678,16415
202204,5호선,아차산,13809,13505,27314
202204,5호선,애오개,3476,3378,6854
202204,5호선,양평,3701,3512,7213
202204,5호선,여의나루,22126,25446,47572
202204,5호선,여의도,13757,13833,27590
202204,5호선,영등포구청,1908,1869,3777
202204,5호선,영등포시장,7639,7954,15593
202204,5호선,오금,2531,2274,4805
202204,5호선,오목교,15805,16110,31915
202204,5호선,올림픽공원,3129,2970,6099
202204,5호선,왕십리,3364,4257,7621
202204,5호선,우장산,9357,9124,18481
202204,5호선,을지로4가,3155,3540,6695
202204,5호선,장한평,10783,10548,21331
202204,5호선,종로3가,12914,12845,25759
202204,5호선,천호,16064,15184,31248
202204,5호선,청구,2450,2248,4698
202204,5호선,충정로,1916,1741,3657
202204,5호선,하남검단산,4974,5022,9996
202204,5호선,하남시청,5272,5054,10326
202204,5호선,하남풍산,2780,2740,5520
202204,5호선,행당,5059,4423,9482
202204,5호선,화곡,19269,18025,37294
202204,5호선,강동,8534,8506,17040
202204,5호선,강일,2010,1994,4004
202204,5호선,개롱,2812,3150,5962
202204,5호선,개화산,2724,2707,5431
202204,5호선,거여,4203,4121,8324
202204,5호선,고덕,4189,4243,8432
202204,5호선,공덕,4499,4449,8948
202204,5호선,광나루,7625,7571,15196
202204,5호선,광화문,10738,10539,21277
202204,5호선,군자,5781,6387,12168
202204,5호선,굽은다리,4900,4572,9472
202204,5호선,길동,3866,3867,7733
202204,5호선,김포공항,6614,6306,12920
202204,5호선,까치산,14888,14429,29317
202204,5호선,답십리,7056,6506,13562
202204,5호선,동대문역사문화공원,672,771,1443
202204,5호선,둔촌동,4297,4227,8524
202204,5호선,마곡,3350,3604,6954
202204,5호선,마장,2762,2616,5378
202204,5호선,마천,3439,3677,7116
202204,5호선,마포,4703,4742,9445
202204,5호선,명일,4685,4674,9359
202204,5호선,목동,7113,7412,14525
202204,5호선,미사,8449,8184,16633
202204,5호선,발산,8800,9064,17864
202204,5호선,방이,3707,3559,7266
202204,5호선,방화,3393,3446,6839
202204,5호선,상일동,5994,5885,11879
202204,5호선,서대문,4781,4751,9532
202204,5호선,송정,3517,3421,6938
202204,5호선,신금호,2745,3005,5750
202204,5호선,신길,1889,2139,4028
202204,5호선,신정,6053,5590,11643
202204,5호선,아차산,11690,11840,23530
202204,5호선,애오개,2541,2588,5129
202204,5호선,양평,2473,2525,4998
202204,5호선,여의나루,21355,23226,44581
202204,5호선,여의도,9739,9741,19480
202204,5호선,영등포구청,1313,1316,2629
202204,5호선,영등포시장,5102,5366,10468
202204,5호선,오금,1471,1413,2884
202204,5호선,오목교,10887,11169,22056
202204,5호선,올림픽공원,2344,2156,4500
202204,5호선,왕십리,2474,2945,5419
202204,5호선,우장산,6398,6564,12962
202204,5호선,을지로4가,1644,1599,3243
202204,5호선,장한평,7292,7267,14559
202204,5호선,종로3가,9029,7704,16733
202204,5호선,천호,12160,11116,23276
202204,5호선,청구,1722,1546,3268
202204,5호선,충정로,1375,1316,2691
202204,5호선,하남검단산,4228,4272,8500
202204,5호선,하남시청,3899,3637,7536
202204,5호선,하남풍산,2077,2139,4216
202204,5호선,행당,3622,3333,6955
202204,5호선,화곡,13585,13079,26664
202204,5호선,강동,13322,12406,25728
202204,5호선,강일,3036,2602,5638
202204,5호선,개롱,4213,4438,8651
202204,5호선,개화산,3880,3706,7586
202204,5호선,거여,6260,6043,12303
202204,5호선,고덕,6525,6255,12780
202204,5호선,공덕,8285,8917,17202
202204,5호선,광나루,11291,10574,21865
202204,5호선,광화문,17929,18197,36126
202204,5호선,군자,8869,9568,18437
202204,5호선,굽은다리,7180,6585,13765
202204,5호선,길동,6081,6128,12209
202204,5호선,김포공항,7143,7494,14637
202204,5호선,까치산,21829,20595,42424
202204,5호선,답십리,10485,9189,19674
202204,5호선,동대문역사문화공원,996,1358,2354
202204,5호선,둔촌동,6502,6197,12699
202204,5호선,마곡,5703,5619,11322
202204,5호선,마장,3957,3690,7647
202204,5호선,마천,4824,4918,9742
202204,5호선,마포,8909,8529,17438
202204,5호선,명일,6270,6236,12506
202204,5호선,목동,11796,11676,23472
202204,5호선,미사,12682,12495,25177
202204,5호선,발산,13902,15015,28917
202204,5호선,방이,5339,5033,10372
202204,5호선,방화,4719,4433,9152
202204,5호선,상일동,9621,8889,18510
202204,5호선,서대문,7840,7444,15284
202204,5호선,송정,5174,4705,9879
202204,5호선,신금호,4332,4413,8745
202204,5호선,신길,3117,3228,6345
202204,5호선,신정,9679,8064,17743
202204,5호선,아차산,16766,16301,33067
202204,5호선,애오개,3978,3921,7899
202204,5호선,양평,4578,4310,8888
202204,5호선,여의나루,51164,62797,113961
202204,5호선,여의도,21663,22351,44014
202204,5호선,영등포구청,2325,2243,4568
202204,5호선,영등포시장,8840,9046,17886
202204,5호선,오금,2481,2279,4760
202204,5호선,오목교,17927,18199,36126
202204,5호선,올림픽공원,3929,3770,7699
202204,5호선,왕십리,3656,4474,8130
202204,5호선,우장산,10286,9845,20131
202204,5호선,을지로4가,3608,3982,7590
202204,5호선,장한평,11392,11288,22680
202204,5호선,종로3가,12661,13361,26022
202204,5호선,천호,17004,16015,33019
202204,5호선,청구,2664,2383,5047
202204,5호선,충정로,2143,1891,4034
202204,5호선,하남검단산,5691,5531,11222
202204,5호선,하남시청,5761,5516,11277
202204,5호선,하남풍산,3128,2936,6064
202204,5호선,행당,5520,4771,10291
202204,5호선,화곡,21878,19493,41371
202204,5호선,강동,9274,9201,18475
202204,5호선,강일,2425,2263,4688
202204,5호선,개롱,3010,3293,6303
202204,5호선,개화산,2777,2867,5644
202204,5호선,거여,4712,4596,9308
202204,5호선,고덕,4459,4424,8883
202204,5호선,공덕,5703,5927,11630
202204,5호선,광나루,8947,8839,17786
202204,5호선,광화문,13189,13238,26427
202204,5호선,군자,6538,7103,13641
202204,5호선,굽은다리,5402,4892,10294
202204,5호선,길동,4237,4371,8608
202204,5호선,김포공항,6889,6731,13620
202204,5호선,까치산,16895,15984,32879
202204,5호선,답십리,7760,7100,14860
202204,5호선,동대문역사문화공원,777,878,1655
202204,5호선,둔촌동,4704,4663,9367
202204,5호선,마곡,3841,3979,7820
202204,5호선,마장,3134,2888,6022
202204,5호선,마천,3664,3928,7592
202204,5호선,마포,5796,5437,11233
202204,5호선,명일,5194,5165,10359
202204,5호선,목동,8481,8529,17010
202204,5호선,미사,9454,9513,18967
202204,5호선,발산,9525,10265,19790
202204,5호선,방이,4200,3870,8070
202204,5호선,방화,3704,3681,7385
202204,5호선,상일동,6983,6645,13628
202204,5호선,서대문,5810,5624,11434
202204,5호선,송정,3923,3759,7682
202204,5호선,신금호,3259,3522,6781
202204,5호선,신길,2416,2690,5106
202204,5호선,신정,7211,6392,13603
202204,5호선,아차산,14674,14899,29573
202204,5호선,애오개,2984,2885,5869
202204,5호선,양평,3448,3543,6991
202204,5호선,여의나루,45681,54132,99813
202204,5호선,여의도,16248,16930,33178
202204,5호선,영등포구청,1528,1532,3060
202204,5호선,영등포시장,6081,6327,12408
202204,5호선,오금,1495,1473,2968
202204,5호선,오목교,13159,13630,26789
202204,5호선,올림픽공원,2920,2919,5839
202204,5호선,왕십리,2772,3201,5973
202204,5호선,우장산,7446,7466,14912
202204,5호선,을지로4가,1893,1900,3793
202204,5호선,장한평,8349,8277,16626
202204,5호선,종로3가,9306,8531,17837
202204,5호선,천호,12892,12226,25118
202204,5호선,청구,2016,1698,3714
202204,5호선,충정로,1724,1644,3368
202204,5호선,하남검단산,4948,4826,9774
202204,5호선,하남시청,4124,3941,8065
202204,5호선,하남풍산,2249,2114,4363
202204,5호선,행당,4292,3915,8207
202204,5호선,화곡,15670,14686,30356
202204,5호선,강동,13330,12496,25826
202204,5호선,강일,2987,2703,5690
202204,5호선,개롱,4309,4324,8633
202204,5호선,개화산,3918,3916,7834
202204,5호선,거여,6368,6026,12394
202204,5호선,고덕,6455,6193,12648
202204,5호선,공덕,7207,7405,14612
202204,5호선,광나루,10264,9602,19866
202204,5호선,광화문,15283,15729,31012
202204,5호선,군자,8529,9265,17794
202204,5호선,굽은다리,7167,6619,13786
202204,5호선,길동,5887,6093,11980
202204,5호선,김포공항,7427,7557,14984
202204,5호선,까치산,21753,20284,42037
202204,5호선,답십리,10253,9273,19526
202204,5호선,동대문역사문화공원,954,1361,2315
202204,5호선,둔촌동,6378,6238,12616
202204,5호선,마곡,5531,5738,11269
202204,5호선,마장,3939,3755,7694
202204,5호선,마천,4907,5009,9916
202204,5호선,마포,7873,7831,15704
202204,5호선,명일,6179,6087,12266
202204,5호선,목동,11239,11271,22510
202204,5호선,미사,12351,12293,24644
202204,5호선,발산,13443,14685,28128
202204,5호선,방이,5313,5084,10397
202204,5호선,방화,4729,4392,9121
202204,5호선,상일동,9579,8752,18331
202204,5호선,서대문,7512,7127,14639
202204,5호선,송정,5137,4819,9956
202204,5호선,신금호,4233,4291,8524
202204,5호선,신길,2791,2885,5676
202204,5호선,신정,9064,7656,16720
202204,5호선,아차산,14656,14302,28958
202204,5호선,애오개,3585,3561,7146
202204,5호선,양평,3847,3513,7360
202204,5호선,여의나루,21772,24778,46550
202204,5호선,여의도,13913,14679,28592
202204,5호선,영등포구청,2044,1927,3971
202204,5호선,영등포시장,8087,8624,16711
202204,5호선,오금,2017,1935,3952
202204,5호선,오목교,17146,17515,34661
202204,5호선,올림픽공원,3567,3263,6830
202204,5호선,왕십리,3514,4253,7767
202204,5호선,우장산,9960,9703,19663
202204,5호선,을지로4가,3445,3916,7361
202204,5호선,장한평,11271,10820,22091
202204,5호선,종로3가,13032,13449,26481
202204,5호선,천호,16973,16380,33353
202204,5호선,청구,2664,2344,5008
202204,5호선,충정로,2052,1834,3886
202204,5호선,하남검단산,5495,5372,10867
202204,5호선,하남시청,5742,5413,11155
202204,5호선,하남풍산,2879,2843,5722
202204,5호선,행당,5575,4830,10405
202204,5호선,화곡,20703,18748,39451
202204,5호선,강동,8960,9070,18030
202204,5호선,강일,2220,2114,4334
202204,5호선,개롱,2975,3394,6369
202204,5호선,개화산,2796,2960,5756
202204,5호선,거여,4674,4532,9206
202204,5호선,고덕,4286,4317,8603
202204,5호선,공덕,4712,4677,9389
202204,5호선,광나루,8409,8172,16581
202204,5호선,광화문,11710,12047,23757
202204,5호선,군자,6133,6714,12847
202204,5호선,굽은다리,5394,4985,10379
202204,5호선,길동,4132,4201,8333
202204,5호선,김포공항,7114,6873,13987
202204,5호선,까치산,15895,15474,31369
202204,5호선,답십리,7606,6891,14497
202204,5호선,동대문역사문화공원,686,820,1506
202204,5호선,둔촌동,4492,4555,9047
202204,5호선,마곡,3703,3838,7541
202204,5호선,마장,3062,2907,5969
202204,5호선,마천,3686,3926,7612
202204,5호선,마포,4865,5023,9888
202204,5호선,명일,5119,5179,10298
202204,5호선,목동,7787,7939,15726
202204,5호선,미사,9031,8969,18000
202204,5호선,발산,9157,9843,19000
202204,5호선,방이,4149,3906,8055
202204,5호선,방화,3633,3569,7202
202204,5호선,상일동,6490,6288,12778
202204,5호선,서대문,5459,5255,10714
202204,5호선,송정,3872,3776,7648
202204,5호선,신금호,2972,3236,6208
202204,5호선,신길,1984,2293,4277
202204,5호선,신정,6505,5955,12460
202204,5호선,아차산,12022,11986,24008
202204,5호선,애오개,2749,2822,5571
202204,5호선,양평,2802,2885,5687
202204,5호선,여의나루,17013,18205,35218
202204,5호선,여의도,9171,9493,18664
202204,5호선,영등포구청,1441,1384,2825
202204,5호선,영등포시장,5571,5858,11429
202204,5호선,오금,1608,1455,3063
202204,5호선,오목교,11196,11590,22786
202204,5호선,올림픽공원,2563,2303,4866
202204,5호선,왕십리,2652,3101,5753
202204,5호선,우장산,6821,6947,13768
202204,5호선,을지로4가,1767,1763,3530
202204,5호선,장한평,7863,7833,15696
202204,5호선,종로3가,8598,7772,16370
202204,5호선,천호,12404,11776,24180
202204,5호선,청구,1868,1614,3482
202204,5호선,충정로,1419,1462,2881
202204,5호선,하남검단산,4678,4622,9300
202204,5호선,하남시청,4130,3840,7970
202204,5호선,하남풍산,2076,2121,4197
202204,5호선,행당,3939,3602,7541
202204,5호선,화곡,14576,13631,28207
202204,5호선,강동,13509,12641,26150
202204,5호선,강일,2974,2760,5734
202204,5호선,개롱,4274,4487,8761
202204,5호선,개화산,3864,3823,7687
202204,5호선,거여,6955,6370,13325
202204,5호선,고덕,6349,6159,12508
202204,5호선,공덕,7291,7474,14765
202204,5호선,광나루,10984,10279,21263
202204,5호선,광화문,15781,16199,31980
202204,5호선,군자,8626,9555,18181
202204,5호선,굽은다리,7434,6709,14143
202204,5호선,길동,6007,6090,12097
202204,5호선,김포공항,7539,7709,15248
202204,5호선,까치산,22136,20498,42634
202204,5호선,답십리,10564,9401,19965
202204,5호선,동대문역사문화공원,1036,1332,2368
202204,5호선,둔촌동,5883,5744,11627
202204,5호선,마곡,5613,5800,11413
202204,5호선,마장,3942,3598,7540
202204,5호선,마천,4908,4987,9895
202204,5호선,마포,7753,7741,15494
202204,5호선,명일,6269,6191,12460
202204,5호선,목동,11601,11437,23038
202204,5호선,미사,12924,12943,25867
202204,5호선,발산,14249,15571,29820
202204,5호선,방이,5404,5189,10593
202204,5호선,방화,4976,4732,9708
202204,5호선,상일동,9466,8516,17982
202204,5호선,서대문,7607,7566,15173
202204,5호선,송정,5214,4694,9908
202204,5호선,신금호,4202,4317,8519
202204,5호선,신길,2712,2749,5461
202204,5호선,신정,9436,7946,17382
202204,5호선,아차산,14957,14505,29462
202204,5호선,애오개,3827,3721,7548
202204,5호선,양평,3804,3560,7364
202204,5호선,여의나루,20275,22317,42592
202204,5호선,여의도,12639,13647,26286
202204,5호선,영등포구청,2132,2060,4192
202204,5호선,영등포시장,8330,8667,16997
202204,5호선,오금,2164,2045,4209
202204,5호선,오목교,15477,16051,31528
202204,5호선,올림픽공원,3359,3170,6529
202204,5호선,왕십리,3492,4320,7812
202204,5호선,우장산,9911,9759,19670
202204,5호선,을지로4가,3725,4153,7878
202204,5호선,장한평,11540,11054,22594
202204,5호선,종로3가,12850,13859,26709
202204,5호선,천호,17486,16745,34231
202204,5호선,청구,2648,2365,5013
202204,5호선,충정로,1892,1799,3691
202204,5호선,하남검단산,5615,5454,11069
202204,5호선,하남시청,5975,5522,11497
202204,5호선,하남풍산,2885,2901,5786
202204,5호선,행당,5581,4655,10236
202204,5호선,화곡,20820,18671,39491
202204,5호선,강동,9207,9104,18311
202204,5호선,강일,2218,2208,4426
202204,5호선,개롱,3241,3481,6722
202204,5호선,개화산,2822,2779,5601
202204,5호선,거여,4880,4765,9645
202204,5호선,고덕,4178,4187,8365
202204,5호선,공덕,4584,4653,9237
202204,5호선,광나루,7563,7439,15002
202204,5호선,광화문,10566,10819,21385
202204,5호선,군자,6142,6867,13009
202204,5호선,굽은다리,5344,4809,10153
202204,5호선,길동,4103,4149,8252
202204,5호선,김포공항,6853,6708,13561
202204,5호선,까치산,15757,15442,31199
202204,5호선,답십리,7293,6767,14060
202204,5호선,동대문역사문화공원,677,814,1491
202204,5호선,둔촌동,4507,4426,8933
202204,5호선,마곡,3717,3896,7613
202204,5호선,마장,2911,2714,5625
202204,5호선,마천,3692,3916,7608
202204,5호선,마포,5027,4988,10015
202204,5호선,명일,5047,5105,10152
202204,5호선,목동,7707,7881,15588
202204,5호선,미사,9344,9331,18675
202204,5호선,발산,9297,9789,19086
202204,5호선,방이,4141,3870,8011
202204,5호선,방화,3837,3816,7653
202204,5호선,상일동,6607,6254,12861
202204,5호선,서대문,5200,5374,10574
202204,5호선,송정,3794,3804,7598
202204,5호선,신금호,2903,3239,6142
202204,5호선,신길,1913,2177,4090
202204,5호선,신정,6563,5909,12472
202204,5호선,아차산,11855,11618,23473
202204,5호선,애오개,2812,2845,5657
202204,5호선,양평,2699,2750,5449
202204,5호선,여의나루,14206,15227,29433
202204,5호선,여의도,8540,9010,17550
202204,5호선,영등포구청,1286,1236,2522
202204,5호선,영등포시장,5532,5868,11400
202204,5호선,오금,1922,1777,3699
202204,5호선,오목교,10989,11100,22089
202204,5호선,올림픽공원,2434,2220,4654
202204,5호선,왕십리,2420,2858,5278
202204,5호선,우장산,6746,6861,13607
202204,5호선,을지로4가,1725,1774,3499
202204,5호선,장한평,7816,7913,15729
202204,5호선,종로3가,8661,7896,16557
202204,5호선,천호,12650,12221,24871
202204,5호선,청구,1824,1705,3529
202204,5호선,충정로,1426,1462,2888
202204,5호선,하남검단산,4682,4664,9346
202204,5호선,하남시청,4503,4251,8754
202204,5호선,하남풍산,2268,2227,4495
202204,5호선,행당,3990,3587,7577
202204,5호선,화곡,14371,13681,28052
202204,5호선,강동,14401,13680,28081
202204,5호선,강일,3159,3026,6185
202204,5호선,개롱,4559,4664,9223
202204,5호선,개화산,4075,3864,7939
202204,5호선,거여,7000,6516,13516
202204,5호선,고덕,6741,6405,13146
202204,5호선,공덕,7674,8314,15988
202204,5호선,광나루,11053,10372,21425
202204,5호선,광화문,23300,21987,45287
202204,5호선,군자,9273,10395,19668
202204,5호선,굽은다리,7655,7076,14731
202204,5호선,길동,6344,6475,12819
202204,5호선,김포공항,8410,8278,16688
202204,5호선,까치산,22555,20927,43482
202204,5호선,답십리,11169,10318,21487
202204,5호선,동대문역사문화공원,1126,1447,2573
202204,5호선,둔촌동,6423,6309,12732
202204,5호선,마곡,5825,5787,11612
202204,5호선,마장,4100,3914,8014
202204,5호선,마천,5129,5208,10337
202204,5호선,마포,8250,8544,16794
202204,5호선,명일,6600,6396,12996
202204,5호선,목동,11839,11817,23656
202204,5호선,미사,13367,13577,26944
202204,5호선,발산,14784,15997,30781
202204,5호선,방이,5346,5051,10397
202204,5호선,방화,4944,4683,9627
202204,5호선,상일동,10204,9285,19489
202204,5호선,서대문,9209,8035,17244
202204,5호선,송정,5479,5180,10659
202204,5호선,신금호,4527,4670,9197
202204,5호선,신길,2827,2915,5742
202204,5호선,신정,9706,8136,17842
202204,5호선,아차산,14650,14308,28958
202204,5호선,애오개,3965,3937,7902
202204,5호선,양평,3913,3661,7574
202204,5호선,여의나루,20969,24752,45721
202204,5호선,여의도,14230,14288,28518
202204,5호선,영등포구청,2068,2023,4091
202204,5호선,영등포시장,8765,9259,18024
202204,5호선,오금,2329,2091,4420
202204,5호선,오목교,16958,17672,34630
202204,5호선,올림픽공원,4267,4022,8289
202204,5호선,왕십리,3768,4609,8377
202204,5호선,우장산,10511,10052,20563
202204,5호선,을지로4가,4288,4698,8986
202204,5호선,장한평,12052,11860,23912
202204,5호선,종로3가,16783,17258,34041
202204,5호선,천호,18311,17696,36007
202204,5호선,청구,2806,2554,5360
202204,5호선,충정로,2796,2100,4896
202204,5호선,하남검단산,6139,6017,12156
202204,5호선,하남시청,6058,5754,11812
202204,5호선,하남풍산,2976,2896,5872
202204,5호선,행당,5754,4934,10688
202204,5호선,화곡,21557,19446,41003
202205,5호선,강동,9504,9435,18939
202205,5호선,강일,2256,2264,4520
202205,5호선,개롱,3205,3421,6626
202205,5호선,개화산,2936,3031,5967
202205,5호선,거여,4944,4747,9691
202205,5호선,고덕,4539,4547,9086
202205,5호선,공덕,4955,5004,9959
202205,5호선,광나루,8317,8147,16464
202205,5호선,광화문,16313,14172,30485
202205,5호선,군자,6623,7316,13939
202205,5호선,굽은다리,5627,5450,11077
202205,5호선,길동,4479,4419,8898
202205,5호선,김포공항,7698,7343,15041
202205,5호선,까치산,16647,16104,32751
202205,5호선,답십리,8073,7326,15399
202205,5호선,동대문역사문화공원,726,880,1606
202205,5호선,둔촌동,4995,4937,9932
202205,5호선,마곡,3839,3947,7786
202205,5호선,마장,3106,2951,6057
202205,5호선,마천,3898,4310,8208
202205,5호선,마포,5157,5161,10318
202205,5호선,명일,5221,5450,10671
202205,5호선,목동,8236,8591,16827
202205,5호선,미사,9649,9680,19329
202205,5호선,발산,10120,10761,20881
202205,5호선,방이,4068,3896,7964
202205,5호선,방화,3942,3878,7820
202205,5호선,상일동,7096,6938,14034
202205,5호선,서대문,6022,5664,11686
202205,5호선,송정,4043,4033,8076
202205,5호선,신금호,3151,3461,6612
202205,5호선,신길,2105,2367,4472
202205,5호선,신정,6878,6222,13100
202205,5호선,아차산,12728,12454,25182
202205,5호선,애오개,2816,3054,5870
202205,5호선,양평,2845,2873,5718
202205,5호선,여의나루,19551,21538,41089
202205,5호선,여의도,9768,9626,19394
202205,5호선,영등포구청,1478,1542,3020
202205,5호선,영등포시장,5808,6159,11967
202205,5호선,오금,1736,1716,3452
202205,5호선,오목교,11546,11845,23391
202205,5호선,올림픽공원,3297,3144,6441
202205,5호선,왕십리,2832,3242,6074
202205,5호선,우장산,7110,7347,14457
202205,5호선,을지로4가,2010,2068,4078
202205,5호선,장한평,8338,8266,16604
202205,5호선,종로3가,11019,9990,21009
202205,5호선,천호,14385,13378,27763
202205,5호선,청구,2116,1908,4024
202205,5호선,충정로,1613,1531,3144
202205,5호선,하남검단산,5203,5018,10221
202205,5호선,하남시청,4354,4336,8690
202205,5호선,하남풍산,2165,2261,4426
202205,5호선,행당,4222,3904,8126
202205,5호선,화곡,15111,14421,29532
202205,5호선,강동,12439,11527,23966
202205,5호선,강일,3333,2965,6298
202205,5호선,개롱,4081,4205,8286
202205,5호선,개화산,3818,3552,7370
202205,5호선,거여,6372,6051,12423
202205,5호선,고덕,6626,6369,12995
202205,5호선,공덕,6768,6934,13702
202205,5호선,광나루,10466,9736,20202
202205,5호선,광화문,17041,17825,34866
202205,5호선,군자,8115,9040,17155
202205,5호선,굽은다리,7764,7265,15029
202205,5호선,길동,5940,5961,11901
202205,5호선,김포공항,7775,8216,15991
202205,5호선,까치산,21370,19753,41123
202205,5호선,답십리,10137,9064,19201
202205,5호선,동대문역사문화공원,980,1224,2204
202205,5호선,둔촌동,6120,5982,12102
202205,5호선,마곡,5480,5501,10981
202205,5호선,마장,3837,3583,7420
202205,5호선,마천,4876,4916,9792
202205,5호선,마포,7444,7574,15018
202205,5호선,명일,6131,5954,12085
202205,5호선,목동,11161,11338,22499
202205,5호선,미사,12294,12238,24532
202205,5호선,발산,14014,15018,29032
202205,5호선,방이,5096,5046,10142
202205,5호선,방화,4947,4732,9679
202205,5호선,상일동,9309,8353,17662
202205,5호선,서대문,7258,6984,14242
202205,5호선,송정,5261,4820,10081
202205,5호선,신금호,4068,4237,8305
202205,5호선,신길,2580,2547,5127
202205,5호선,신정,9087,7684,16771
202205,5호선,아차산,13480,13114,26594
202205,5호선,애오개,3589,3481,7070
202205,5호선,양평,3572,3287,6859
202205,5호선,여의나루,23027,24963,47990
202205,5호선,여의도,11659,12407,24066
202205,5호선,영등포구청,1992,1866,3858
202205,5호선,영등포시장,7667,7906,15573
202205,5호선,오금,2195,2014,4209
202205,5호선,오목교,15964,16926,32890
202205,5호선,올림픽공원,3204,2783,5987
202205,5호선,왕십리,3374,4133,7507
202205,5호선,우장산,9766,9579,19345
202205,5호선,을지로4가,3258,3707,6965
202205,5호선,장한평,10841,10433,21274
202205,5호선,종로3가,12728,12967,25695
202205,5호선,천호,17225,16440,33665
202205,5호선,청구,2532,2279,4811
202205,5호선,충정로,1885,1720,3605
202205,5호선,하남검단산,5516,5437,10953
202205,5호선,하남시청,5593,5387,10980
202205,5호선,하남풍산,2830,2803,5633
202205,5호선,행당,5411,4673,10084
202205,5호선,화곡,20772,18656,39428
202205,5호선,강동,8448,8623,17071
202205,5호선,강일,2198,2169,4367
202205,5호선,개롱,2816,3154,5970
202205,5호선,개화산,2785,2912,5697
202205,5호선,거여,4623,4562,9185
202205,5호선,고덕,4188,4219,8407
202205,5호선,공덕,4180,4294,8474
202205,5호선,광나루,7724,7654,15378
202205,5호선,광화문,11034,11029,22063
202205,5호선,군자,5963,6675,12638
202205,5호선,굽은다리,5565,5393,10958
202205,5호선,길동,4109,4236,8345
202205,5호선,김포공항,7702,7125,14827
202205,5호선,까치산,16078,16222,32300
202205,5호선,답십리,7416,7140,14556
202205,5호선,동대문역사문화공원,654,782,1436
202205,5호선,둔촌동,4453,4638,9091
202205,5호선,마곡,3559,3893,7452
202205,5호선,마장,3058,2996,6054
202205,5호선,마천,3913,4057,7970
202205,5호선,마포,4907,5048,9955
202205,5호선,명일,4970,5098,10068
202205,5호선,목동,7670,7952,15622
202205,5호선,미사,8663,8937,17600
202205,5호선,발산,9127,9782,18909
202205,5호선,방이,3718,3699,7417
202205,5호선,방화,4147,4303,8450
202205,5호선,상일동,6509,6590,13099
202205,5호선,서대문,5144,5198,10342
202205,5호선,송정,3845,3871,7716
202205,5호선,신금호,3052,3378,6430
202205,5호선,신길,1696,2161,3857
202205,5호선,신정,6496,6173,12669
202205,5호선,아차산,11670,11556,23226
202205,5호선,애오개,2573,2864,5437
202205,5호선,양평,2437,2728,5165
202205,5호선,여의나루,10362,11952,22314
202205,5호선,여의도,8091,7871,15962
202205,5호선,영등포구청,1329,1251,2580
202205,5호선,영등포시장,4929,5386,10315
202205,5호선,오금,1642,1555,3197
202205,5호선,오목교,10976,11533,22509
202205,5호선,올림픽공원,2187,1886,4073
202205,5호선,왕십리,2363,2852,5215
202205,5호선,우장산,7026,7301,14327
202205,5호선,을지로4가,1423,1558,2981
202205,5호선,장한평,7499,7679,15178
202205,5호선,종로3가,8621,7431,16052
202205,5호선,천호,12337,11953,24290
202205,5호선,청구,1919,1694,3613
202205,5호선,충정로,1459,1522,2981
202205,5호선,하남검단산,4583,4428,9011
202205,5호선,하남시청,4083,3920,8003
202205,5호선,하남풍산,2301,2242,4543
202205,5호선,행당,4088,3768,7856
202205,5호선,화곡,14383,13953,28336
202205,5호선,강동,15074,13844,28918
202205,5호선,강일,3475,3147,6622
202205,5호선,개롱,4939,5104,10043
202205,5호선,개화산,4170,4015,8185
202205,5호선,거여,7469,7074,14543
202205,5호선,고덕,7491,7327,14818
202205,5호선,공덕,8480,8836,17316
202205,5호선,광나루,11779,10982,22761
202205,5호선,광화문,20032,20539,40571
202205,5호선,군자,9755,10874,20629
202205,5호선,굽은다리,8085,7633,15718
202205,5호선,길동,6591,6672,13263
202205,5호선,김포공항,8122,8548,16670
202205,5호선,까치산,23717,21808,45525
202205,5호선,답십리,11448,10199,21647
202205,5호선,동대문역사문화공원,1072,1498,2570
202205,5호선,둔촌동,6986,6896,13882
202205,5호선,마곡,6612,6651,13263
202205,5호선,마장,4444,4088,8532
202205,5호선,마천,5553,5584,11137
202205,5호선,마포,8686,8791,17477
202205,5호선,명일,7156,7109,14265
202205,5호선,목동,12719,12713,25432
202205,5호선,미사,14117,14022,28139
202205,5호선,발산,15815,16940,32755
202205,5호선,방이,6540,6243,12783
202205,5호선,방화,5432,5130,10562
202205,5호선,상일동,10740,9661,20401
202205,5호선,서대문,8689,8210,16899
202205,5호선,송정,5694,5310,11004
202205,5호선,신금호,4820,4775,9595
202205,5호선,신길,2973,2965,5938
202205,5호선,신정,10183,8452,18635
202205,5호선,아차산,14868,14279,29147
202205,5호선,애오개,4233,4135,8368
202205,5호선,양평,4299,3926,8225
202205,5호선,여의나루,22594,25899,48493
202205,5호선,여의도,14273,14642,28915
202205,5호선,영등포구청,2287,2170,4457
202205,5호선,영등포시장,9345,9623,18968
202205,5호선,오금,2991,2833,5824
202205,5호선,오목교,18193,18700,36893
202205,5호선,올림픽공원,4757,4953,9710
202205,5호선,왕십리,3940,4985,8925
202205,5호선,우장산,11393,10855,22248
202205,5호선,을지로4가,3854,4617,8471
202205,5호선,장한평,12527,12130,24657
202205,5호선,종로3가,16153,16171,32324
202205,5호선,천호,19519,18581,38100
202205,5호선,청구,2803,2566,5369
202205,5호선,충정로,2197,2037,4234
202205,5호선,하남검단산,6256,6145,12401
202205,5호선,하남시청,6774,6383,13157
202205,5호선,하남풍산,3303,3178,6481
202205,5호선,행당,6356,5444,11800
202205,5호선,화곡,22778,20598,43376
202205,5호선,강동,10326,10105,20431
202205,5호선,강일,2523,2477,5000
202205,5호선,개롱,3426,3730,7156
202205,5호선,개화산,3043,3077,6120
202205,5호선,거여,5415,5293,10708
202205,5호선,고덕,4983,5042,10025
202205,5호선,공덕,5460,5440,10900
202205,5호선,광나루,9309,9140,18449
202205,5호선,광화문,14660,14578,29238
202205,5호선,군자,6959,7738,14697
202205,5호선,굽은다리,6376,6042,12418
202205,5호선,길동,4505,4674,9179
202205,5호선,김포공항,7695,7592,15287
202205,5호선,까치산,17446,16982,34428
202205,5호선,답십리,8367,7657,16024
202205,5호선,동대문역사문화공원,734,875,1609
202205,5호선,둔촌동,5120,5178,10298
202205,5호선,마곡,4136,4287,8423
202205,5호선,마장,3275,3043,6318
202205,5호선,마천,4052,4297,8349
202205,5호선,마포,5520,5423,10943
202205,5호선,명일,5661,5669,11330
202205,5호선,목동,8758,9073,17831
202205,5호선,미사,10344,10425,20769
202205,5호선,발산,10216,10652,20868
202205,5호선,방이,4709,4619,9328
202205,5호선,방화,4028,4013,8041
202205,5호선,상일동,7504,7094,14598
202205,5호선,서대문,6615,6508,13123
202205,5호선,송정,4134,4091,8225
202205,5호선,신금호,3335,3600,6935
202205,5호선,신길,2059,2326,4385
202205,5호선,신정,7098,6466,13564
202205,5호선,아차산,12741,12466,25207
202205,5호선,애오개,2922,3101,6023
202205,5호선,양평,3180,3202,6382
202205,5호선,여의나루,19723,21333,41056
202205,5호선,여의도,9877,10314,20191
202205,5호선,영등포구청,1645,1529,3174
202205,5호선,영등포시장,6065,6073,12138
202205,5호선,오금,1804,1795,3599
202205,5호선,오목교,12716,13430,26146
202205,5호선,올림픽공원,4247,4301,8548
202205,5호선,왕십리,2863,3440,6303
202205,5호선,우장산,7754,7942,15696
202205,5호선,을지로4가,2030,2057,4087
202205,5호선,장한평,8816,8566,17382
202205,5호선,종로3가,11276,9644,20920
202205,5호선,천호,14866,13825,28691
202205,5호선,청구,2077,1888,3965
202205,5호선,충정로,1613,1713,3326
202205,5호선,하남검단산,5262,5139,10401
202205,5호선,하남시청,4734,4528,9262
202205,5호선,하남풍산,2549,2536,5085
202205,5호선,행당,4537,4105,8642
202205,5호선,화곡,16006,15037,31043
202205,5호선,강동,14497,13625,28122
202205,5호선,강일,3621,3285,6906
202205,5호선,개롱,4651,4829,9480
202205,5호선,개화산,4265,3982,8247
202205,5호선,거여,7657,6964,14621
202205,5호선,고덕,7292,7209,14501
202205,5호선,공덕,8388,8607,16995
202205,5호선,광나루,11670,10759,22429
202205,5호선,광화문,20231,21222,41453
202205,5호선,군자,9675,10942,20617
202205,5호선,굽은다리,8182,7637,15819
202205,5호선,길동,6681,6574,13255
202205,5호선,김포공항,8503,8892,17395
202205,5호선,까치산,23468,21888,45356
202205,5호선,답십리,11495,10270,21765
202205,5호선,동대문역사문화공원,1088,1487,2575
202205,5호선,둔촌동,6763,6627,13390
202205,5호선,마곡,6188,6196,12384
202205,5호선,마장,4448,4117,8565
202205,5호선,마천,5687,5644,11331
202205,5호선,마포,8484,8601,17085
202205,5호선,명일,7271,7098,14369
202205,5호선,목동,12874,12651,25525
202205,5호선,미사,14119,14103,28222
202205,5호선,발산,15936,17304,33240
202205,5호선,방이,5878,5760,11638
202205,5호선,방화,5331,5052,10383
202205,5호선,상일동,10853,9699,20552
202205,5호선,서대문,9011,8751,17762
202205,5호선,송정,5482,5105,10587
202205,5호선,신금호,4783,4736,9519
202205,5호선,신길,2994,3033,6027
202205,5호선,신정,10126,8338,18464
202205,5호선,아차산,15081,14206,29287
202205,5호선,애오개,4178,4027,8205
202205,5호선,양평,4212,3880,8092
202205,5호선,여의나루,22823,24605,47428
202205,5호선,여의도,13774,15191,28965
202205,5호선,영등포구청,2215,2185,4400
202205,5호선,영등포시장,9216,9848,19064
202205,5호선,오금,2378,2254,4632
202205,5호선,오목교,18316,19341,37657
202205,5호선,올림픽공원,4087,3928,8015
202205,5호선,왕십리,3992,5139,9131
202205,5호선,우장산,11461,10921,22382
202205,5호선,을지로4가,4185,4558,8743
202205,5호선,장한평,12741,12011,24752
202205,5호선,종로3가,16245,16594,32839
202205,5호선,천호,19138,18508,37646
202205,5호선,청구,3054,2630,5684
202205,5호선,충정로,2258,2008,4266
202205,5호선,하남검단산,6208,6034,12242
202205,5호선,하남시청,6528,6140,12668
202205,5호선,하남풍산,3237,3119,6356
202205,5호선,행당,6317,5469,11786
202205,5호선,화곡,23043,20637,43680
202205,5호선,강동,9904,9659,19563
202205,5호선,강일,2486,2381,4867
202205,5호선,개롱,3280,3639,6919
202205,5호선,개화산,2955,2946,5901
202205,5호선,거여,5341,5135,10476
202205,5호선,고덕,4929,4964,9893
202205,5호선,공덕,5140,5107,10247
202205,5호선,광나루,8673,8557,17230
202205,5호선,광화문,13602,13642,27244
202205,5호선,군자,6804,7601,14405
202205,5호선,굽은다리,5927,5762,11689
202205,5호선,길동,4679,4589,9268
202205,5호선,김포공항,7550,7758,15308
202205,5호선,까치산,17317,16621,33938
202205,5호선,답십리,8106,7401,15507
202205,5호선,동대문역사문화공원,762,975,1737
202205,5호선,둔촌동,5269,5238,10507
202205,5호선,마곡,3874,4030,7904
202205,5호선,마장,3215,3002,6217
202205,5호선,마천,4023,4322,8345
202205,5호선,마포,5222,5149,10371
202205,5호선,명일,5405,5355,10760
202205,5호선,목동,8940,8980,17920
202205,5호선,미사,9798,10099,19897
202205,5호선,발산,10334,11152,21486
202205,5호선,방이,4490,4289,8779
202205,5호선,방화,3871,3881,7752
202205,5호선,상일동,7375,7055,14430
202205,5호선,서대문,5872,5934,11806
202205,5호선,송정,4064,4005,8069
202205,5호선,신금호,3200,3478,6678
202205,5호선,신길,2157,2266,4423
202205,5호선,신정,7169,6366,13535
202205,5호선,아차산,12091,11402,23493
202205,5호선,애오개,2835,2975,5810
202205,5호선,양평,3007,2959,5966
202205,5호선,여의나루,17291,18150,35441
202205,5호선,여의도,9031,10033,19064
202205,5호선,영등포구청,1505,1408,2913
202205,5호선,영등포시장,6303,6825,13128
202205,5호선,오금,1785,1674,3459
202205,5호선,오목교,12508,12978,25486
202205,5호선,올림픽공원,3194,3024,6218
202205,5호선,왕십리,2670,3409,6079
202205,5호선,우장산,7776,7834,15610
202205,5호선,을지로4가,2061,2026,4087
202205,5호선,장한평,8934,8708,17642
202205,5호선,종로3가,10862,9726,20588
202205,5호선,천호,14471,13538,28009
202205,5호선,청구,1955,1843,3798
202205,5호선,충정로,1614,1632,3246
202205,5호선,하남검단산,5153,5090,10243
202205,5호선,하남시청,4638,4370,9008
202205,5호선,하남풍산,2528,2484,5012
202205,5호선,행당,4343,3953,8296
202205,5호선,화곡,15707,14964,30671
202205,5호선,강동,14799,13929,28728
202205,5호선,강일,3503,3178,6681
202205,5호선,개롱,4666,4961,9627
202205,5호선,개화산,4287,4108,8395
202205,5호선,거여,7536,6966,14502
202205,5호선,고덕,7126,6955,14081
202205,5호선,공덕,8210,8348,16558
202205,5호선,광나루,11709,10894,22603
202205,5호선,광화문,19640,20410,40050
202205,5호선,군자,9432,10673,20105
202205,5호선,굽은다리,7790,7276,15066
202205,5호선,길동,6615,6730,13345
202205,5호선,김포공항,7976,8647,16623
202205,5호선,까치산,23648,21920,45568
202205,5호선,답십리,11202,9888,21090
202205,5호선,동대문역사문화공원,1049,1443,2492
202205,5호선,둔촌동,6509,6299,12808
202205,5호선,마곡,6089,6265,12354
202205,5호선,마장,4238,3921,8159
202205,5호선,마천,5395,5440,10835
202205,5호선,마포,8700,8858,17558
202205,5호선,명일,7147,6950,14097
202205,5호선,목동,12904,12775,25679
202205,5호선,미사,13878,13878,27756
202205,5호선,발산,15347,16618,31965
202205,5호선,방이,6188,5899,12087
202205,5호선,방화,5257,4965,10222
202205,5호선,상일동,10487,9520,20007
202205,5호선,서대문,8949,8763,17712
202205,5호선,송정,5587,5192,10779
202205,5호선,신금호,4710,4722,9432
202205,5호선,신길,3031,2995,6026
202205,5호선,신정,10218,8548,18766
202205,5호선,아차산,14718,13609,28327
202205,5호선,애오개,4173,4168,8341
202205,5호선,양평,4223,3818,8041
202205,5호선,여의나루,20118,21714,41832
202205,5호선,여의도,12784,14526,27310
202205,5호선,영등포구청,2233,2152,4385
202205,5호선,영등포시장,9363,10092,19455
202205,5호선,오금,2618,2443,5061
202205,5호선,오목교,19157,19676,38833
202205,5호선,올림픽공원,4664,4868,9532
202205,5호선,왕십리,3841,4821,8662
202205,5호선,우장산,11099,10661,21760
202205,5호선,을지로4가,3995,4315,8310
202205,5호선,장한평,12508,11856,24364
202205,5호선,종로3가,15306,15953,31259
202205,5호선,천호,18563,17762,36325
202205,5호선,청구,2836,2465,5301
202205,5호선,충정로,2143,2009,4152
202205,5호선,하남검단산,6056,5978,12034
202205,5호선,하남시청,6619,6319,12938
202205,5호선,하남풍산,3185,3020,6205
202205,5호선,행당,6058,5094,11152
202205,5호선,화곡,22824,20472,43296
202205,5호선,강동,9974,9969,19943
202205,5호선,강일,2419,2314,4733
202205,5호선,개롱,3175,3383,6558
202205,5호선,개화산,2842,2866,5708
202205,5호선,거여,5219,5039,10258
202205,5호선,고덕,4715,4800,9515
202205,5호선,공덕,5085,5056,10141
202205,5호선,광나루,8761,8444,17205
202205,5호선,광화문,12900,13231,26131
202205,5호선,군자,6517,7329,13846
202205,5호선,굽은다리,5786,5453,11239
202205,5호선,길동,4455,4531,8986
202205,5호선,김포공항,7268,7599,14867
202205,5호선,까치산,17123,16315,33438
202205,5호선,답십리,7613,7097,14710
202205,5호선,동대문역사문화공원,709,809,1518
202205,5호선,둔촌동,5021,4990,10011
202205,5호선,마곡,3830,4092,7922
202205,5호선,마장,3133,2904,6037
202205,5호선,마천,4010,4239,8249
202205,5호선,마포,5322,5335,10657
202205,5호선,명일,5399,5577,10976
202205,5호선,목동,8675,8864,17539
202205,5호선,미사,9715,9767,19482
202205,5호선,발산,9906,10610,20516
202205,5호선,방이,4574,4379,8953
202205,5호선,방화,3976,3951,7927
202205,5호선,상일동,7317,7034,14351
202205,5호선,서대문,5674,5830,11504
202205,5호선,송정,3951,3852,7803
202205,5호선,신금호,3205,3377,6582
202205,5호선,신길,2025,2194,4219
202205,5호선,신정,7029,6307,13336
202205,5호선,아차산,11476,11195,22671
202205,5호선,애오개,2870,2888,5758
202205,5호선,양평,2838,2923,5761
202205,5호선,여의나루,14925,15599,30524
202205,5호선,여의도,8109,9111,17220
202205,5호선,영등포구청,1453,1447,2900
202205,5호선,영등포시장,6178,6531,12709
202205,5호선,오금,1675,1707,3382
202205,5호선,오목교,12057,12558,24615
202205,5호선,올림픽공원,3882,4063,7945
202205,5호선,왕십리,2781,3281,6062
202205,5호선,우장산,7319,7531,14850
202205,5호선,을지로4가,1879,2019,3898
202205,5호선,장한평,8534,8307,16841
202205,5호선,종로3가,10197,8765,18962
202205,5호선,천호,14065,13306,27371
202205,5호선,청구,1951,1859,3810
202205,5호선,충정로,1574,1543,3117
202205,5호선,하남검단산,5066,5027,10093
202205,5호선,하남시청,4941,4717,9658
202205,5호선,하남풍산,2464,2418,4882
202205,5호선,행당,4331,3888,8219
202205,5호선,화곡,15602,14497,30099
202206,5호선,강동,13806,12777,26583
202206,5호선,강일,3324,3000,6324
202206,5호선,개롱,4464,4602,9066
202206,5호선,개화산,4048,3754,7802
202206,5호선,거여,6845,6127,12972
202206,5호선,고덕,6805,6592,13397
202206,5호선,공덕,7245,7613,14858
202206,5호선,광나루,10637,9769,20406
202206,5호선,광화문,17102,17905,35007
202206,5호선,군자,8639,9467,18106
202206,5호선,굽은다리,7494,6841,14335
202206,5호선,길동,6191,6303,12494
202206,5호선,김포공항,8008,8214,16222
202206,5호선,까치산,22215,20128,42343
202206,5호선,답십리,10336,9134,19470
202206,5호선,동대문역사문화공원,960,1254,2214
202206,5호선,둔촌동,6124,6034,12158
202206,5호선,마곡,5678,5701,11379
202206,5호선,마장,3948,3753,7701
202206,5호선,마천,5191,5199,10390
202206,5호선,마포,7667,7755,15422
202206,5호선,명일,6466,6226,12692
202206,5호선,목동,12034,11762,23796
202206,5호선,미사,13036,13021,26057
202206,5호선,발산,14283,15387,29670
202206,5호선,방이,5551,5372,10923
202206,5호선,방화,4882,4608,9490
202206,5호선,상일동,9875,9014,18889
202206,5호선,서대문,7673,7379,15052
202206,5호선,송정,5221,4839,10060
202206,5호선,신금호,4356,4411,8767
202206,5호선,신길,2887,2914,5801
202206,5호선,신정,9559,7841,17400
202206,5호선,아차산,13494,12524,26018
202206,5호선,애오개,3858,3548,7406
202206,5호선,양평,3808,3439,7247
202206,5호선,여의나루,18156,19845,38001
202206,5호선,여의도,11463,13053,24516
202206,5호선,영등포구청,2153,2035,4188
202206,5호선,영등포시장,8543,8833,17376
202206,5호선,오금,2076,2012,4088
202206,5호선,오목교,16836,17389,34225
202206,5호선,올림픽공원,3872,3525,7397
202206,5호선,왕십리,3462,4433,7895
202206,5호선,우장산,10359,9934,20293
202206,5호선,을지로4가,3761,4288,8049
202206,5호선,장한평,11709,11137,22846
202206,5호선,종로3가,13805,14365,28170
202206,5호선,천호,17858,17107,34965
202206,5호선,청구,2654,2341,4995
202206,5호선,충정로,1881,1730,3611
202206,5호선,하남검단산,6098,5968,12066
202206,5호선,하남시청,6546,6109,12655
202206,5호선,하남풍산,2970,3017,5987
202206,5호선,행당,5636,4631,10267
202206,5호선,화곡,21122,18894,40016
202206,5호선,강동,9438,9026,18464
202206,5호선,강일,2453,2241,4694
202206,5호선,개롱,3171,3316,6487
202206,5호선,개화산,2898,2840,5738
202206,5호선,거여,5054,4730,9784
202206,5호선,고덕,4397,4366,8763
202206,5호선,공덕,4927,5038,9965
202206,5호선,광나루,9221,8755,17976
202206,5호선,광화문,13878,15702,29580
202206,5호선,군자,6372,7130,13502
202206,5호선,굽은다리,5785,5300,11085
202206,5호선,길동,4417,4371,8788
202206,5호선,김포공항,7111,7274,14385
202206,5호선,까치산,16482,15771,32253
202206,5호선,답십리,7919,7020,14939
202206,5호선,동대문역사문화공원,674,928,1602
202206,5호선,둔촌동,4816,4718,9534
202206,5호선,마곡,3840,3958,7798
202206,5호선,마장,3038,2815,5853
202206,5호선,마천,3784,3978,7762
202206,5호선,마포,5135,5133,10268
202206,5호선,명일,5173,5156,10329
202206,5호선,목동,8612,8644,17256
202206,5호선,미사,9519,9672,19191
202206,5호선,발산,9398,10319,19717
202206,5호선,방이,4333,4023,8356
202206,5호선,방화,3862,3663,7525
202206,5호선,상일동,6913,6445,13358
202206,5호선,서대문,5168,5052,10220
202206,5호선,송정,4038,3763,7801
202206,5호선,신금호,3162,3263,6425
202206,5호선,신길,2185,2104,4289
202206,5호선,신정,6803,5668,12471
202206,5호선,아차산,11074,10492,21566
202206,5호선,애오개,2724,2743,5467
202206,5호선,양평,2895,2740,5635
202206,5호선,여의나루,12771,14532,27303
202206,5호선,여의도,8825,8826,17651
202206,5호선,영등포구청,1428,1385,2813
202206,5호선,영등포시장,5825,6178,12003
202206,5호선,오금,1646,1540,3186
202206,5호선,오목교,12080,12860,24940
202206,5호선,올림픽공원,2974,2731,5705
202206,5호선,왕십리,2691,3302,5993
202206,5호선,우장산,7422,7174,14596
202206,5호선,을지로4가,2087,2388,4475
202206,5호선,장한평,8432,8101,16533
202206,5호선,종로3가,11163,10718,21881
202206,5호선,천호,13527,12737,26264
202206,5호선,청구,1921,1781,3702
202206,5호선,충정로,1546,1418,2964
202206,5호선,하남검단산,5015,5024,10039
202206,5호선,하남시청,4526,4175,8701
202206,5호선,하남풍산,2298,2253,4551
202206,5호선,행당,4156,3666,7822
202206,5호선,화곡,15130,13938,29068
202206,5호선,강동,13980,13097,27077
202206,5호선,강일,3681,3323,7004
202206,5호선,개롱,4709,4786,9495
202206,5호선,개화산,4183,4108,8291
202206,5호선,거여,7130,6628,13758
202206,5호선,고덕,7049,6966,14015
202206,5호선,공덕,7953,8164,16117
202206,5호선,광나루,12082,11186,23268
202206,5호선,광화문,18638,20309,38947
202206,5호선,군자,9177,10166,19343
202206,5호선,굽은다리,7718,7261,14979
202206,5호선,길동,6522,6574,13096
202206,5호선,김포공항,8131,8322,16453
202206,5호선,까치산,23094,21180,44274
202206,5호선,답십리,11130,9775,20905
202206,5호선,동대문역사문화공원,1008,1320,2328
202206,5호선,둔촌동,6435,6432,12867
202206,5호선,마곡,6083,6232,12315
202206,5호선,마장,4130,3867,7997
202206,5호선,마천,5467,5425,10892
202206,5호선,마포,8193,8341,16534
202206,5호선,명일,6725,6527,13252
202206,5호선,목동,12844,12761,25605
202206,5호선,미사,13491,13577,27068
202206,5호선,발산,14945,16497,31442
202206,5호선,방이,5924,5689,11613
202206,5호선,방화,5240,4837,10077
202206,5호선,상일동,10460,9343,19803
202206,5호선,서대문,8220,8008,16228
202206,5호선,송정,5551,5103,10654
202206,5호선,신금호,4553,4569,9122
202206,5호선,신길,2972,3074,6046
202206,5호선,신정,10020,8264,18284
202206,5호선,아차산,14042,13012,27054
202206,5호선,애오개,4221,4006,8227
202206,5호선,양평,4069,3681,7750
202206,5호선,여의나루,14059,15084,29143
202206,5호선,여의도,12109,13668,25777
202206,5호선,영등포구청,2314,2191,4505
202206,5호선,영등포시장,9372,9895,19267
202206,5호선,오금,2159,2154,4313
202206,5호선,오목교,17095,17594,34689
202206,5호선,올림픽공원,5245,5706,10951
202206,5호선,왕십리,3878,4750,8628
202206,5호선,우장산,10815,10489,21304
202206,5호선,을지로4가,3853,4449,8302
202206,5호선,장한평,12283,12008,24291
202206,5호선,종로3가,14334,15009,29343
202206,5호선,천호,18607,17932,36539
202206,5호선,청구,2714,2384,5098
202206,5호선,충정로,2184,1995,4179
202206,5호선,하남검단산,6021,5853,11874
202206,5호선,하남시청,6603,6235,12838
202206,5호선,하남풍산,3076,3077,6153
202206,5호선,행당,6173,5211,11384
202206,5호선,화곡,22184,19900,42084
202206,5호선,강동,9609,9421,19030
202206,5호선,강일,2549,2378,4927
202206,5호선,개롱,3270,3603,6873
202206,5호선,개화산,2920,2938,5858
202206,5호선,거여,5053,4927,9980
202206,5호선,고덕,4577,4561,9138
202206,5호선,공덕,4829,5051,9880
202206,5호선,광나루,8550,8401,16951
202206,5호선,광화문,13688,14372,28060
202206,5호선,군자,6513,7211,13724
202206,5호선,굽은다리,5558,5297,10855
202206,5호선,길동,4464,4466,8930
202206,5호선,김포공항,7194,7210,14404
202206,5호선,까치산,16531,16297,32828
202206,5호선,답십리,7873,7370,15243
202206,5호선,동대문역사문화공원,718,811,1529
202206,5호선,둔촌동,4892,4843,9735
202206,5호선,마곡,3787,3986,7773
202206,5호선,마장,2986,2893,5879
202206,5호선,마천,3965,4292,8257
202206,5호선,마포,5141,5109,10250
202206,5호선,명일,5389,5516,10905
202206,5호선,목동,8831,8911,17742
202206,5호선,미사,9655,9875,19530
202206,5호선,발산,9783,10307,20090
202206,5호선,방이,4569,4301,8870
202206,5호선,방화,3761,3797,7558
202206,5호선,상일동,7174,6849,14023
202206,5호선,서대문,7624,7857,15481
202206,5호선,송정,4010,3973,7983
202206,5호선,신금호,3134,3499,6633
202206,5호선,신길,2097,2223,4320
202206,5호선,신정,6775,6058,12833
202206,5호선,아차산,11334,10837,22171
202206,5호선,애오개,2798,2839,5637
202206,5호선,양평,2861,2886,5747
202206,5호선,여의나루,12455,13410,25865
202206,5호선,여의도,8383,9142,17525
202206,5호선,영등포구청,1467,1369,2836
202206,5호선,영등포시장,6267,6508,12775
202206,5호선,오금,1623,1682,3305
202206,5호선,오목교,11812,12288,24100
202206,5호선,올림픽공원,3953,4199,8152
202206,5호선,왕십리,2610,3099,5709
202206,5호선,우장산,7348,7607,14955
202206,5호선,을지로4가,1825,2062,3887
202206,5호선,장한평,8618,8356,16974
202206,5호선,종로3가,9818,8812,18630
202206,5호선,천호,13366,12674,26040
202206,5호선,청구,1899,1835,3734
202206,5호선,충정로,1608,1674,3282
202206,5호선,하남검단산,5332,5143,10475
202206,5호선,하남시청,4534,4414,8948
202206,5호선,하남풍산,2438,2474,4912
202206,5호선,행당,4385,3974,8359
202206,5호선,화곡,15202,14319,29521
202206,5호선,강동,14244,13689,27933
202206,5호선,강일,3544,3178,6722
202206,5호선,개롱,4693,4790,9483
202206,5호선,개화산,4163,3864,8027
202206,5호선,거여,6851,6563,13414
202206,5호선,고덕,7176,6686,13862
202206,5호선,공덕,8057,8348,16405
202206,5호선,광나루,11736,10877,22613
202206,5호선,광화문,17668,18567,36235
202206,5호선,군자,9036,10205,19241
202206,5호선,굽은다리,7824,7343,15167
202206,5호선,길동,6509,6649,13158
202206,5호선,김포공항,8006,8433,16439
202206,5호선,까치산,23032,20907,43939
202206,5호선,답십리,11084,9668,20752
202206,5호선,동대문역사문화공원,1038,1477,2515
202206,5호선,둔촌동,6362,6305,12667
202206,5호선,마곡,6126,6134,12260
202206,5호선,마장,4139,3905,8044
202206,5호선,마천,5372,5319,10691
202206,5호선,마포,8076,8174,16250
202206,5호선,명일,6813,6594,13407
202206,5호선,목동,12874,12651,25525
202206,5호선,미사,13410,13462,26872
202206,5호선,발산,14965,16473,31438
202206,5호선,방이,5801,5618,11419
202206,5호선,방화,5038,4809,9847
202206,5호선,상일동,10276,9220,19496
202206,5호선,서대문,8267,7904,16171
202206,5호선,송정,5537,5140,10677
202206,5호선,신금호,4553,4630,9183
202206,5호선,신길,2951,2937,5888
202206,5호선,신정,9911,8326,18237
202206,5호선,아차산,13228,12292,25520
202206,5호선,애오개,4043,3923,7966
202206,5호선,양평,4136,3750,7886
202206,5호선,여의나루,12242,14160,26402
202206,5호선,여의도,11989,13344,25333
202206,5호선,영등포구청,2169,2142,4311
202206,5호선,영등포시장,9241,9723,18964
202206,5호선,오금,2427,2220,4647
202206,5호선,오목교,17449,18018,35467
202206,5호선,올림픽공원,3472,3009,6481
202206,5호선,왕십리,3632,4724,8356
202206,5호선,우장산,10860,10374,21234
202206,5호선,을지로4가,3626,4179,7805
202206,5호선,장한평,12067,11646,23713
202206,5호선,종로3가,14502,15457,29959
202206,5호선,천호,17884,17261,35145
202206,5호선,청구,2765,2453,5218
202206,5호선,충정로,2156,1957,4113
202206,5호선,하남검단산,5905,5742,11647
202206,5호선,하남시청,6484,6005,12489
202206,5호선,하남풍산,3141,3150,6291
202206,5호선,행당,6008,5106,11114
202206,5호선,화곡,22018,19584,41602
202206,5호선,강동,9182,9204,18386
202206,5호선,강일,2453,2266,4719
202206,5호선,개롱,3161,3429,6590
202206,5호선,개화산,2849,2865,5714
202206,5호선,거여,4866,4832,9698
202206,5호선,고덕,4352,4471,8823
202206,5호선,공덕,4889,5076,9965
202206,5호선,광나루,8220,7801,16021
202206,5호선,광화문,12486,12885,25371
202206,5호선,군자,6410,7348,13758
202206,5호선,굽은다리,5810,5381,11191
202206,5호선,길동,4490,4392,8882
202206,5호선,김포공항,7255,7437,14692
202206,5호선,까치산,16719,15985,32704
202206,5호선,답십리,7720,7108,14828
202206,5호선,동대문역사문화공원,794,827,1621
202206,5호선,둔촌동,4706,4597,9303
202206,5호선,마곡,3759,3988,7747
202206,5호선,마장,3111,2955,6066
202206,5호선,마천,3855,4148,8003
202206,5호선,마포,4980,4973,9953
202206,5호선,명일,5223,5262,10485
202206,5호선,목동,8746,8836,17582
202206,5호선,미사,9150,9436,18586
202206,5호선,발산,9190,9737,18927
202206,5호선,방이,4285,4094,8379
202206,5호선,방화,3791,3772,7563
202206,5호선,상일동,6960,6733,13693
202206,5호선,서대문,5854,5715,11569
202206,5호선,송정,3910,3894,7804
202206,5호선,신금호,3142,3398,6540
202206,5호선,신길,2091,2239,4330
202206,5호선,신정,6600,5901,12501
202206,5호선,아차산,10369,10005,20374
202206,5호선,애오개,2714,2743,5457
202206,5호선,양평,2839,2858,5697
202206,5호선,여의나루,10131,10828,20959
202206,5호선,여의도,7590,8377,15967
202206,5호선,영등포구청,1567,1488,3055
202206,5호선,영등포시장,5964,6222,12186
202206,5호선,오금,1645,1608,3253
202206,5호선,오목교,11726,12109,23835
202206,5호선,올림픽공원,2596,2390,4986
202206,5호선,왕십리,2723,3316,6039
202206,5호선,우장산,7221,7333,14554
202206,5호선,을지로4가,1879,2012,3891
202206,5호선,장한평,8332,8279,16611
202206,5호선,종로3가,9810,8516,18326
202206,5호선,천호,13424,12633,26057
202206,5호선,청구,1835,1710,3545
202206,5호선,충정로,1529,1434,2963
202206,5호선,하남검단산,4870,4890,9760
202206,5호선,하남시청,4701,4470,9171
202206,5호선,하남풍산,2256,2240,4496
202206,5호선,행당,4259,3915,8174
202206,5호선,화곡,14956,14082,29038
202206,5호선,강동,14301,13397,27698
202206,5호선,강일,3524,3233,6757
202206,5호선,개롱,4505,4702,9207
202206,5호선,개화산,4158,3921,8079
202206,5호선,거여,7521,6996,14517
202206,5호선,고덕,6952,6712,13664
202206,5호선,공덕,8036,8358,16394
202206,5호선,광나루,12332,11511,23843
202206,5호선,광화문,18298,19678,37976
202206,5호선,군자,9572,10580,20152
202206,5호선,굽은다리,8007,7548,15555
202206,5호선,길동,6631,6678,13309
202206,5호선,김포공항,8657,8818,17475
202206,5호선,까치산,23267,21526,44793
202206,5호선,답십리,11523,10323,21846
202206,5호선,동대문역사문화공원,1203,1580,2783
202206,5호선,둔촌동,6518,6693,13211
202206,5호선,마곡,5989,6093,12082
202206,5호선,마장,4247,3908,8155
202206,5호선,마천,5364,5373,10737
202206,5호선,마포,8345,8627,16972
202206,5호선,명일,6803,6677,13480
202206,5호선,목동,12312,12141,24453
202206,5호선,미사,13526,13552,27078
202206,5호선,발산,15005,16428,31433
202206,5호선,방이,5814,5535,11349
202206,5호선,방화,5386,5024,10410
202206,5호선,상일동,10717,9750,20467
202206,5호선,서대문,8754,8382,17136
202206,5호선,송정,5387,5241,10628
202206,5호선,신금호,4515,4453,8968
202206,5호선,신길,2924,2979,5903
202206,5호선,신정,10179,8452,18631
202206,5호선,아차산,13324,12320,25644
202206,5호선,애오개,4129,4103,8232
202206,5호선,양평,4099,3788,7887
202206,5호선,여의나루,12396,14306,26702
202206,5호선,여의도,13065,14087,27152
202206,5호선,영등포구청,2211,2094,4305
202206,5호선,영등포시장,9217,9672,18889
202206,5호선,오금,2313,2088,4401
202206,5호선,오목교,17325,18015,35340
202206,5호선,올림픽공원,4911,5115,10026
202206,5호선,왕십리,3784,4870,8654
202206,5호선,우장산,10894,10546,21440
202206,5호선,을지로4가,3761,4191,7952
202206,5호선,장한평,12232,11800,24032
202206,5호선,종로3가,14698,15240,29938
202206,5호선,천호,18724,17857,36581
202206,5호선,청구,2736,2386,5122
202206,5호선,충정로,2221,2065,4286
202206,5호선,하남검단산,6171,5892,12063
202206,5호선,하남시청,6466,5947,12413
202206,5호선,하남풍산,3172,3181,6353
202206,5호선,행당,6279,5445,11724
202206,5호선,화곡,22213,19999,42212
202206,5호선,강동,9001,9040,18041
202206,5호선,강일,2292,2176,4468
202206,5호선,개롱,3041,3334,6375
202206,5호선,개화산,2839,2844,5683
202206,5호선,거여,4777,4676,9453
202206,5호선,고덕,4135,4121,8256
202206,5호선,공덕,4698,4835,9533
202206,5호선,광나루,8140,7841,15981
202206,5호선,광화문,12060,12435,24495
202206,5호선,군자,6341,7088,13429
202206,5호선,굽은다리,5505,5340,10845
202206,5호선,길동,4306,4254,8560
202206,5호선,김포공항,7400,7488,14888
202206,5호선,까치산,16159,15711,31870
202206,5호선,답십리,7556,6992,14548
202206,5호선,동대문역사문화공원,826,962,1788
202206,5호선,둔촌동,4738,4703,9441
202206,5호선,마곡,3788,3905,7693
202206,5호선,마장,2851,2696,5547
202206,5호선,마천,3694,3887,7581
202206,5호선,마포,5042,5032,10074
202206,5호선,명일,5163,5217,10380
202206,5호선,목동,7961,8067,16028
202206,5호선,미사,8980,9231,18211
202206,5호선,발산,9575,10528,20103
202206,5호선,방이,4280,3934,8214
202206,5호선,방화,3665,3668,7333
202206,5호선,상일동,6690,6555,13245
202206,5호선,서대문,5162,5103,10265
202206,5호선,송정,3778,3796,7574
202206,5호선,신금호,2962,3291,6253
202206,5호선,신길,1995,2131,4126
202206,5호선,신정,6575,5840,12415
202206,5호선,아차산,9184,9186,18370
202206,5호선,애오개,2746,2871,5617
202206,5호선,양평,2739,2716,5455
202206,5호선,여의나루,7327,8645,15972
202206,5호선,여의도,8054,8505,16559
202206,5호선,영등포구청,1411,1281,2692
202206,5호선,영등포시장,5995,6279,12274
202206,5호선,오금,1674,1609,3283
202206,5호선,오목교,10982,11635,22617
202206,5호선,올림픽공원,3264,3530,6794
202206,5호선,왕십리,2506,3026,5532
202206,5호선,우장산,7001,7098,14099
202206,5호선,을지로4가,1676,1860,3536
202206,5호선,장한평,8243,8202,16445
202206,5호선,종로3가,9140,8001,17141
202206,5호선,천호,12556,11757,24313
202206,5호선,청구,1861,1784,3645
202206,5호선,충정로,1474,1575,3049
202206,5호선,하남검단산,4465,4376,8841
202206,5호선,하남시청,4103,4001,8104
202206,5호선,하남풍산,2357,2261,4618
202206,5호선,행당,4102,3699,7801
202206,5호선,화곡,15006,14176,29182
202207,5호선,강동,13926,13027,26953
202207,5호선,강일,3269,3004,6273
202207,5호선,개롱,4351,4551,8902
202207,5호선,개화산,4070,3807,7877
202207,5호선,거여,6852,6278,13130
202207,5호선,고덕,6620,6365,12985
202207,5호선,공덕,7811,8127,15938
202207,5호선,광나루,11065,10360,21425
202207,5호선,광화문,17699,18161,35860
202207,5호선,군자,8636,9801,18437
202207,5호선,굽은다리,7871,7480,15351
202207,5호선,길동,6491,6656,13147
202207,5호선,김포공항,8769,8716,17485
202207,5호선,까치산,22020,20266,42286
202207,5호선,답십리,11007,9732,20739
202207,5호선,동대문역사문화공원,1275,1554,2829
202207,5호선,둔촌동,6127,6053,12180
202207,5호선,마곡,5919,5981,11900
202207,5호선,마장,4032,3617,7649
202207,5호선,마천,4999,5011,10010
202207,5호선,마포,8062,8140,16202
202207,5호선,명일,6591,6397,12988
202207,5호선,목동,11759,11794,23553
202207,5호선,미사,13161,13099,26260
202207,5호선,발산,13611,14894,28505
202207,5호선,방이,5408,5254,10662
202207,5호선,방화,4985,4835,9820
202207,5호선,상일동,10087,9261,19348
202207,5호선,서대문,9328,7894,17222
202207,5호선,송정,5447,5230,10677
202207,5호선,신금호,4376,4466,8842
202207,5호선,신길,2922,2923,5845
202207,5호선,신정,9836,8158,17994
202207,5호선,아차산,13355,12976,26331
202207,5호선,애오개,4107,3838,7945
202207,5호선,양평,3851,3501,7352
202207,5호선,여의나루,12774,14627,27401
202207,5호선,여의도,13318,14826,28144
202207,5호선,영등포구청,2006,1974,3980
202207,5호선,영등포시장,8941,9277,18218
202207,5호선,오금,2060,1968,4028
202207,5호선,오목교,17296,17894,35190
202207,5호선,올림픽공원,3618,3289,6907
202207,5호선,왕십리,3570,4536,8106
202207,5호선,우장산,10426,10252,20678
202207,5호선,을지로4가,3633,4035,7668
202207,5호선,장한평,11958,11557,23515
202207,5호선,종로3가,13858,14614,28472
202207,5호선,천호,18508,17585,36093
202207,5호선,청구,2645,2337,4982
202207,5호선,충정로,2567,2025,4592
202207,5호선,하남검단산,5939,5801,11740
202207,5호선,하남시청,5914,5692,11606
202207,5호선,하남풍산,3118,3088,6206
202207,5호선,행당,5790,4915,10705
202207,5호선,화곡,21415,19121,40536
202207,5호선,강동,9237,9003,18240
202207,5호선,강일,2311,2266,4577
202207,5호선,개롱,3080,3370,6450
202207,5호선,개화산,2716,2858,5574
202207,5호선,거여,4644,4646,9290
202207,5호선,고덕,4258,4392,8650
202207,5호선,공덕,4792,4917,9709
202207,5호선,광나루,8080,7452,15532
202207,5호선,광화문,11839,12425,24264
202207,5호선,군자,6230,7005,13235
202207,5호선,굽은다리,5793,5634,11427
202207,5호선,길동,4271,4326,8597
202207,5호선,김포공항,8062,7798,15860
202207,5호선,까치산,15968,15659,31627
202207,5호선,답십리,7723,7230,14953
202207,5호선,동대문역사문화공원,950,969,1919
202207,5호선,둔촌동,4707,4642,9349
202207,5호선,마곡,3688,3899,7587
202207,5호선,마장,3159,2880,6039
202207,5호선,마천,3680,3951,7631
202207,5호선,마포,4892,4986,9878
202207,5호선,명일,5089,5089,10178
202207,5호선,목동,7774,7933,15707
202207,5호선,미사,8816,9391,18207
202207,5호선,발산,9312,9951,19263
202207,5호선,방이,4154,3961,8115
202207,5호선,방화,3869,3807,7676
202207,5호선,상일동,6794,6563,13357
202207,5호선,서대문,5049,4875,9924
202207,5호선,송정,3789,3739,7528
202207,5호선,신금호,2958,3263,6221
202207,5호선,신길,2029,2170,4199
202207,5호선,신정,6636,5943,12579
202207,5호선,아차산,9278,9155,18433
202207,5호선,애오개,2759,2811,5570
202207,5호선,양평,2693,2828,5521
202207,5호선,여의나루,9620,10624,20244
202207,5호선,여의도,8847,9461,18308
202207,5호선,영등포구청,1305,1331,2636
202207,5호선,영등포시장,5837,6172,12009
202207,5호선,오금,1584,1490,3074
202207,5호선,오목교,11541,12025,23566
202207,5호선,올림픽공원,2821,2481,5302
202207,5호선,왕십리,2775,3332,6107
202207,5호선,우장산,7092,7142,14234
202207,5호선,을지로4가,1715,1781,3496
202207,5호선,장한평,8195,8290,16485
202207,5호선,종로3가,8861,7962,16823
202207,5호선,천호,13274,12524,25798
202207,5호선,청구,1856,1720,3576
202207,5호선,충정로,1465,1492,2957
202207,5호선,하남검단산,4824,4745,9569
202207,5호선,하남시청,4249,4061,8310
202207,5호선,하남풍산,2257,2326,4583
202207,5호선,행당,4059,3721,7780
202207,5호선,화곡,14645,13943,28588
202207,5호선,강동,13757,12843,26600
202207,5호선,강일,3437,3061,6498
202207,5호선,개롱,4313,4377,8690
202207,5호선,개화산,3997,3754,7751
202207,5호선,거여,7150,6541,13691
202207,5호선,고덕,6868,6661,13529
202207,5호선,공덕,7667,7783,15450
202207,5호선,광나루,11603,10833,22436
202207,5호선,광화문,17207,18073,35280
202207,5호선,군자,8677,9795,18472
202207,5호선,굽은다리,8095,7675,15770
202207,5호선,길동,6479,6550,13029
202207,5호선,김포공항,8735,8904,17639
202207,5호선,까치산,22276,20489,42765
202207,5호선,답십리,10848,9615,20463
202207,5호선,동대문역사문화공원,1085,1327,2412
202207,5호선,둔촌동,5994,5971,11965
202207,5호선,마곡,5932,6114,12046
202207,5호선,마장,3909,3728,7637
202207,5호선,마천,4932,5001,9933
202207,5호선,마포,7969,8117,16086
202207,5호선,명일,6700,6583,13283
202207,5호선,목동,11875,11753,23628
202207,5호선,미사,13050,13187,26237
202207,5호선,발산,13825,15253,29078
202207,5호선,방이,5256,5200,10456
202207,5호선,방화,4969,4705,9674
202207,5호선,상일동,10020,9199,19219
202207,5호선,서대문,7959,7557,15516
202207,5호선,송정,5283,5054,10337
202207,5호선,신금호,4388,4469,8857
202207,5호선,신길,2890,2778,5668
202207,5호선,신정,9632,7974,17606
202207,5호선,아차산,12356,11614,23970
202207,5호선,애오개,3920,3803,7723
202207,5호선,양평,4009,3656,7665
202207,5호선,여의나루,14470,16494,30964
202207,5호선,여의도,12870,13661,26531
202207,5호선,영등포구청,2188,1962,4150
202207,5호선,영등포시장,8607,8812,17419
202207,5호선,오금,2231,2095,4326
202207,5호선,오목교,17750,18272,36022
202207,5호선,올림픽공원,3338,2701,6039
202207,5호선,왕십리,3639,4796,8435
202207,5호선,우장산,10632,10349,20981
202207,5호선,을지로4가,3451,3814,7265
202207,5호선,장한평,12054,11555,23609
202207,5호선,종로3가,12954,13305,26259
202207,5호선,천호,18560,17645,36205
202207,5호선,청구,2712,2425,5137
202207,5호선,충정로,2117,1901,4018
202207,5호선,하남검단산,6206,6010,12216
202207,5호선,하남시청,6278,5895,12173
202207,5호선,하남풍산,3224,3169,6393
202207,5호선,행당,6053,5057,11110
202207,5호선,화곡,21408,19257,40665
202207,5호선,강동,9282,9091,18373
202207,5호선,강일,2388,2242,4630
202207,5호선,개롱,3034,3305,6339
202207,5호선,개화산,2763,2794,5557
202207,5호선,거여,4722,4465,9187
202207,5호선,고덕,4344,4583,8927
202207,5호선,공덕,4580,4524,9104
202207,5호선,광나루,7714,7294,15008
202207,5호선,광화문,12048,12614,24662
202207,5호선,군자,6128,7020,13148
202207,5호선,굽은다리,5887,5639,11526
202207,5호선,길동,4227,4205,8432
202207,5호선,김포공항,8094,7904,15998
202207,5호선,까치산,15929,15333,31262
202207,5호선,답십리,7645,7097,14742
202207,5호선,동대문역사문화공원,767,858,1625
202207,5호선,둔촌동,4531,4558,9089
202207,5호선,마곡,3814,3929,7743
202207,5호선,마장,2879,2706,5585
202207,5호선,마천,3598,3904,7502
202207,5호선,마포,4898,4856,9754
202207,5호선,명일,5275,5318,10593
202207,5호선,목동,7916,8064,15980
202207,5호선,미사,9214,9448,18662
202207,5호선,발산,9545,10325,19870
202207,5호선,방이,3887,3849,7736
202207,5호선,방화,3699,3712,7411
202207,5호선,상일동,6967,6786,13753
202207,5호선,서대문,5217,5058,10275
202207,5호선,송정,3673,3758,7431
202207,5호선,신금호,3026,3336,6362
202207,5호선,신길,2076,2215,4291
202207,5호선,신정,6389,5842,12231
202207,5호선,아차산,9475,9158,18633
202207,5호선,애오개,2734,2803,5537
202207,5호선,양평,2624,2755,5379
202207,5호선,여의나루,13251,14672,27923
202207,5호선,여의도,9042,9544,18586
202207,5호선,영등포구청,1316,1285,2601
202207,5호선,영등포시장,5468,5618,11086
202207,5호선,오금,1609,1522,3131
202207,5호선,오목교,12184,12733,24917
202207,5호선,올림픽공원,2411,2010,4421
202207,5호선,왕십리,2523,3226,5749
202207,5호선,우장산,7231,7437,14668
202207,5호선,을지로4가,1655,1718,3373
202207,5호선,장한평,8097,8241,16338
202207,5호선,종로3가,8959,8058,17017
202207,5호선,천호,13188,12532,25720
202207,5호선,청구,1884,1710,3594
202207,5호선,충정로,1490,1585,3075
202207,5호선,하남검단산,5001,4846,9847
202207,5호선,하남시청,4277,4120,8397
202207,5호선,하남풍산,2403,2327,4730
202207,5호선,행당,4004,3623,7627
202207,5호선,화곡,14632,14002,28634
202207,5호선,강동,13420,12710,26130
202207,5호선,강일,3132,2925,6057
202207,5호선,개롱,4374,4540,8914
202207,5호선,개화산,3816,3556,7372
202207,5호선,거여,6610,6179,12789
202207,5호선,고덕,6654,6360,13014
202207,5호선,공덕,7400,7785,15185
202207,5호선,광나루,10403,9925,20328
202207,5호선,광화문,18890,18861,37751
202207,5호선,군자,8620,9751,18371
202207,5호선,굽은다리,7623,7219,14842
202207,5호선,길동,6162,6265,12427
202207,5호선,김포공항,7979,8224,16203
202207,5호선,까치산,21784,20268,42052
202207,5호선,답십리,10662,9631,20293
202207,5호선,동대문역사문화공원,1167,1400,2567
202207,5호선,둔촌동,5763,5825,11588
202207,5호선,마곡,5733,5809,11542
202207,5호선,마장,3809,3556,7365
202207,5호선,마천,4784,4853,9637
202207,5호선,마포,7722,7658,15380
202207,5호선,명일,6224,6160,12384
202207,5호선,목동,11544,11532,23076
202207,5호선,미사,12369,12202,24571
202207,5호선,발산,12957,14341,27298
202207,5호선,방이,5316,5179,10495
202207,5호선,방화,4739,4471,9210
202207,5호선,상일동,9541,8662,18203
202207,5호선,서대문,8028,7423,15451
202207,5호선,송정,5268,4822,10090
202207,5호선,신금호,4163,4266,8429
202207,5호선,신길,2860,2896,5756
202207,5호선,신정,9450,7707,17157
202207,5호선,아차산,11593,10746,22339
202207,5호선,애오개,4394,4233,8627
202207,5호선,양평,3955,3611,7566
202207,5호선,여의나루,10860,12389,23249
202207,5호선,여의도,11798,12905,24703
202207,5호선,영등포구청,2052,1936,3988
202207,5호선,영등포시장,8209,8390,16599
202207,5호선,오금,2045,1894,3939
202207,5호선,오목교,17043,17371,34414
202207,5호선,올림픽공원,3325,2617,5942
202207,5호선,왕십리,3395,4370,7765
202207,5호선,우장산,10402,9926,20328
202207,5호선,을지로4가,3409,3734,7143
202207,5호선,장한평,11506,11128,22634
202207,5호선,종로3가,13548,13339,26887
202207,5호선,천호,16556,15913,32469
202207,5호선,청구,2550,2430,4980
202207,5호선,충정로,2165,1976,4141
202207,5호선,하남검단산,5381,5281,10662
202207,5호선,하남시청,5734,5424,11158
202207,5호선,하남풍산,2827,2870,5697
202207,5호선,행당,5738,5116,10854
202207,5호선,화곡,20838,18698,39536
202207,5호선,강동,9508,9384,18892
202207,5호선,강일,2438,2292,4730
202207,5호선,개롱,3033,3294,6327
202207,5호선,개화산,2703,2783,5486
202207,5호선,거여,4698,4467,9165
202207,5호선,고덕,4428,4677,9105
202207,5호선,공덕,4604,4660,9264
202207,5호선,광나루,8221,7662,15883
202207,5호선,광화문,12160,12680,24840
202207,5호선,군자,6147,6798,12945
202207,5호선,굽은다리,5723,5474,11197
202207,5호선,길동,4383,4364,8747
202207,5호선,김포공항,7574,7504,15078
202207,5호선,까치산,16055,15381,31436
202207,5호선,답십리,7666,7146,14812
202207,5호선,동대문역사문화공원,852,937,1789
202207,5호선,둔촌동,4773,4768,9541
202207,5호선,마곡,3719,4052,7771
202207,5호선,마장,2808,2670,5478
202207,5호선,마천,3535,3837,7372
202207,5호선,마포,4918,4851,9769
202207,5호선,명일,4958,5075,10033
202207,5호선,목동,7937,8047,15984
202207,5호선,미사,9078,9457,18535
202207,5호선,발산,8983,9610,18593
202207,5호선,방이,4006,3848,7854
202207,5호선,방화,3682,3592,7274
202207,5호선,상일동,6776,6472,13248
202207,5호선,서대문,4835,4700,9535
202207,5호선,송정,3690,3635,7325
202207,5호선,신금호,2961,3229,6190
202207,5호선,신길,1993,2118,4111
202207,5호선,신정,6463,5808,12271
202207,5호선,아차산,9271,9223,18494
202207,5호선,애오개,2817,2809,5626
202207,5호선,양평,2727,2762,5489
202207,5호선,여의나루,10819,11474,22293
202207,5호선,여의도,7763,8480,16243
202207,5호선,영등포구청,1455,1342,2797
202207,5호선,영등포시장,5856,6065,11921
202207,5호선,오금,1502,1466,2968
202207,5호선,오목교,11409,11920,23329
202207,5호선,올림픽공원,2464,2091,4555
202207,5호선,왕십리,2593,3034,5627
202207,5호선,우장산,7063,7264,14327
202207,5호선,을지로4가,1757,1737,3494
202207,5호선,장한평,7928,7923,15851
202207,5호선,종로3가,9401,8242,17643
202207,5호선,천호,13145,12337,25482
202207,5호선,청구,1816,1646,3462
202207,5호선,충정로,1454,1440,2894
202207,5호선,하남검단산,4812,4728,9540
202207,5호선,하남시청,4297,4034,8331
202207,5호선,하남풍산,2288,2243,4531
202207,5호선,행당,4078,3626,7704
202207,5호선,화곡,14336,13622,27958
202207,5호선,강동,12506,11933,24439
202207,5호선,강일,3174,2908,6082
202207,5호선,개롱,4083,4332,8415
202207,5호선,개화산,3837,3627,7464
202207,5호선,거여,6573,6204,12777
202207,5호선,고덕,6483,6278,12761
202207,5호선,공덕,6957,7132,14089
202207,5호선,광나루,10790,10472,21262
202207,5호선,광화문,16412,16651,33063
202207,5호선,군자,8284,9449,17733
202207,5호선,굽은다리,7599,6970,14569
202207,5호선,길동,6114,6269,12383
202207,5호선,김포공항,7312,7671,14983
202207,5호선,까치산,20799,19337,40136
202207,5호선,답십리,10202,9372,19574
202207,5호선,동대문역사문화공원,1159,1495,2654
202207,5호선,둔촌동,5875,5795,11670
202207,5호선,마곡,5357,5515,10872
202207,5호선,마장,3707,3562,7269
202207,5호선,마천,4776,4907,9683
202207,5호선,마포,7415,7596,15011
202207,5호선,명일,6189,6146,12335
202207,5호선,목동,11130,11038,22168
202207,5호선,미사,12332,12265,24597
202207,5호선,발산,12574,13526,26100
202207,5호선,방이,5285,5120,10405
202207,5호선,방화,4886,4595,9481
202207,5호선,상일동,9284,8897,18181
202207,5호선,서대문,7381,7186,14567
202207,5호선,송정,4977,4639,9616
202207,5호선,신금호,4028,4132,8160
202207,5호선,신길,2675,2792,5467
202207,5호선,신정,9002,7603,16605
202207,5호선,아차산,11556,11170,22726
202207,5호선,애오개,3774,3758,7532
202207,5호선,양평,3699,3552,7251
202207,5호선,여의나루,6614,9013,15627
202207,5호선,여의도,11884,11747,23631
202207,5호선,영등포구청,1916,1852,3768
202207,5호선,영등포시장,7532,7967,15499
202207,5호선,오금,2243,2034,4277
202207,5호선,오목교,15902,16219,32121
202207,5호선,올림픽공원,2839,2382,5221
202207,5호선,왕십리,3224,4200,7424
202207,5호선,우장산,9867,9718,19585
202207,5호선,을지로4가,3259,3589,6848
202207,5호선,장한평,11195,11029,22224
202207,5호선,종로3가,13496,13139,26635
202207,5호선,천호,16477,15486,31963
202207,5호선,청구,2411,2311,4722
202207,5호선,충정로,1848,1745,3593
202207,5호선,하남검단산,5483,5306,10789
202207,5호선,하남시청,5812,5335,11147
202207,5호선,하남풍산,3013,2973,5986
202207,5호선,행당,5678,4931,10609
202207,5호선,화곡,20058,18286,38344
202207,5호선,강동,8617,8613,17230
202207,5호선,강일,2367,2281,4648
202207,5호선,개롱,2884,3129,6013
202207,5호선,개화산,2602,2670,5272
202207,5호선,거여,4723,4577,9300
202207,5호선,고덕,4213,4210,8423
202207,5호선,공덕,4384,4420,8804
202207,5호선,광나루,7319,6964,14283
202207,5호선,광화문,11816,12018,23834
202207,5호선,군자,5813,6696,12509
202207,5호선,굽은다리,5309,4861,10170
202207,5호선,길동,4015,4115,8130
202207,5호선,김포공항,7041,6693,13734
202207,5호선,까치산,15011,14695,29706
202207,5호선,답십리,7311,6727,14038
202207,5호선,동대문역사문화공원,838,954,1792
202207,5호선,둔촌동,4289,4404,8693
202207,5호선,마곡,3606,3827,7433
202207,5호선,마장,2729,2697,5426
202207,5호선,마천,3516,3676,7192
202207,5호선,마포,4554,4619,9173
202207,5호선,명일,4740,4769,9509
202207,5호선,목동,7584,7800,15384
202207,5호선,미사,8962,9147,18109
202207,5호선,발산,8445,9284,17729
202207,5호선,방이,3780,3585,7365
202207,5호선,방화,3769,3559,7328
202207,5호선,상일동,6465,6265,12730
202207,5호선,서대문,4618,4582,9200
202207,5호선,송정,3540,3444,6984
202207,5호선,신금호,2864,3073,5937
202207,5호선,신길,2033,2170,4203
202207,5호선,신정,6116,5586,11702
202207,5호선,아차산,8798,8449,17247
202207,5호선,애오개,2690,2676,5366
202207,5호선,양평,2570,2633,5203
202207,5호선,여의나루,8671,9608,18279
202207,5호선,여의도,7581,7995,15576
202207,5호선,영등포구청,1291,1176,2467
202207,5호선,영등포시장,5383,5618,11001
202207,5호선,오금,1488,1385,2873
202207,5호선,오목교,10954,11474,22428
202207,5호선,올림픽공원,2062,1758,3820
202207,5호선,왕십리,2256,2716,4972
202207,5호선,우장산,6728,6887,13615
202207,5호선,을지로4가,1565,1758,3323
202207,5호선,장한평,7881,7993,15874
202207,5호선,종로3가,8653,7940,16593
202207,5호선,천호,12209,11358,23567
202207,5호선,청구,1787,1676,3463
202207,5호선,충정로,1395,1460,2855
202207,5호선,하남검단산,4393,4328,8721
202207,5호선,하남시청,4286,4171,8457
202207,5호선,하남풍산,2250,2285,4535
202207,5호선,행당,3878,3549,7427
202207,5호선,화곡,13574,12958,26532
202207,5호선,강동,11365,10469,21834
202207,5호선,강일,2888,2601,5489
202207,5호선,개롱,3978,4088,8066
202207,5호선,개화산,3429,3295,6724
202207,5호선,거여,5857,5452,11309
202207,5호선,고덕,6119,5898,12017
202207,5호선,공덕,6365,6479,12844
202207,5호선,광나루,9377,8981,18358
202207,5호선,광화문,15219,16156,31375
202207,5호선,군자,7697,8393,16090
202207,5호선,굽은다리,7083,6593,13676
202207,5호선,길동,5606,5674,11280
202207,5호선,김포공항,8131,8549,16680
202207,5호선,까치산,19611,18196,37807
202207,5호선,답십리,9465,8486,17951
202207,5호선,동대문역사문화공원,1244,1483,2727
202207,5호선,둔촌동,5271,5274,10545
202207,5호선,마곡,4936,5098,10034
202207,5호선,마장,3516,3191,6707
202207,5호선,마천,4346,4462,8808
202207,5호선,마포,6859,6963,13822
202207,5호선,명일,5542,5481,11023
202207,5호선,목동,10227,10036,20263
202207,5호선,미사,11395,11412,22807
202207,5호선,발산,11480,12521,24001
202207,5호선,방이,4805,4826,9631
202207,5호선,방화,4320,4161,8481
202207,5호선,상일동,8732,8094,16826
202207,5호선,서대문,6836,6580,13416
202207,5호선,송정,4660,4306,8966
202207,5호선,신금호,3769,3816,7585
202207,5호선,신길,2788,2716,5504
202207,5호선,신정,8344,6828,15172
202207,5호선,아차산,10494,9938,20432
202207,5호선,애오개,3481,3386,6867
202207,5호선,양평,3509,3264,6773
202207,5호선,여의나루,12180,18907,31087
202207,5호선,여의도,11624,12782,24406
202207,5호선,영등포구청,1798,1615,3413
202207,5호선,영등포시장,6985,7099,14084
202207,5호선,오금,2000,1739,3739
202207,5호선,오목교,14469,15267,29736
202207,5호선,올림픽공원,4023,3405,7428
202207,5호선,왕십리,3052,3912,6964
202207,5호선,우장산,8973,8698,17671
202207,5호선,을지로4가,2914,3175,6089
202207,5호선,장한평,10654,10204,20858
202207,5호선,종로3가,11444,11675,23119
202207,5호선,천호,15804,14997,30801
202207,5호선,청구,2227,2036,4263
202207,5호선,충정로,1844,1624,3468
202207,5호선,하남검단산,5108,5182,10290
202207,5호선,하남시청,5112,4789,9901
202207,5호선,하남풍산,2603,2602,5205
202207,5호선,행당,4850,4088,8938
202207,5호선,화곡,18888,16663,35551
202207,5호선,강동,7727,7795,15522
202207,5호선,강일,1938,1892,3830
202207,5호선,개롱,2649,2990,5639
202207,5호선,개화산,2408,2403,4811
202207,5호선,거여,4098,4063,8161
202207,5호선,고덕,3951,3942,7893
202207,5호선,공덕,4007,4140,8147
202207,5호선,광나루,6874,6433,13307
202207,5호선,광화문,11776,11775,23551
202207,5호선,군자,5134,5752,10886
202207,5호선,굽은다리,5068,4941,10009
202207,5호선,길동,3793,3776,7569
202207,5호선,김포공항,7267,6823,14090
202207,5호선,까치산,13843,13707,27550
202207,5호선,답십리,6758,6339,13097
202207,5호선,동대문역사문화공원,910,1074,1984
202207,5호선,둔촌동,4035,3946,7981
202207,5호선,마곡,3200,3491,6691
202207,5호선,마장,2465,2362,4827
202207,5호선,마천,3080,3310,6390
202207,5호선,마포,4506,4386,8892
202207,5호선,명일,4247,4362,8609
202207,5호선,목동,6592,7023,13615
202207,5호선,미사,7713,7871,15584
202207,5호선,발산,7754,8167,15921
202207,5호선,방이,3462,3300,6762
202207,5호선,방화,3132,3126,6258
202207,5호선,상일동,5847,5936,11783
202207,5호선,서대문,4345,4244,8589
202207,5호선,송정,3140,3219,6359
202207,5호선,신금호,2562,2850,5412
202207,5호선,신길,1841,2182,4023
202207,5호선,신정,5668,5149,10817
202207,5호선,아차산,7686,7489,15175
202207,5호선,애오개,2332,2508,4840
202207,5호선,양평,2393,2471,4864
202207,5호선,여의나루,6205,7500,13705
202207,5호선,여의도,8903,8229,17132
202207,5호선,영등포구청,1175,1145,2320
202207,5호선,영등포시장,4779,5046,9825
202207,5호선,오금,1286,1200,2486
202207,5호선,오목교,10561,10892,21453
202207,5호선,올림픽공원,3027,2539,5566
202207,5호선,왕십리,2241,2772,5013
202207,5호선,우장산,6064,6315,12379
202207,5호선,을지로4가,1370,1663,3033
202207,5호선,장한평,7107,7280,14387
202207,5호선,종로3가,8613,7207,15820
202207,5호선,천호,11277,10651,21928
202207,5호선,청구,1574,1545,3119
202207,5호선,충정로,1387,1453,2840
202207,5호선,하남검단산,3934,3885,7819
202207,5호선,하남시청,3479,3428,6907
202207,5호선,하남풍산,1976,1959,3935
202207,5호선,행당,3426,3210,6636
202207,5호선,화곡,12431,11621,24052
202208,5호선,강동,11981,11238,23219
202208,5호선,강일,3087,2796,5883
202208,5호선,개롱,3889,4013,7902
202208,5호선,개화산,3615,3339,6954
202208,5호선,거여,5870,5453,11323
202208,5호선,고덕,6253,5980,12233
202208,5호선,공덕,6496,6835,13331
202208,5호선,광나루,9496,9091,18587
202208,5호선,광화문,21966,21279,43245
202208,5호선,군자,7812,8642,16454
202208,5호선,굽은다리,6982,6483,13465
202208,5호선,길동,5626,5873,11499
202208,5호선,김포공항,7570,7965,15535
202208,5호선,까치산,19350,17976,37326
202208,5호선,답십리,9605,8465,18070
202208,5호선,동대문역사문화공원,1113,1437,2550
202208,5호선,둔촌동,5526,5475,11001
202208,5호선,마곡,5218,5312,10530
202208,5호선,마장,3501,3240,6741
202208,5호선,마천,4284,4359,8643
202208,5호선,마포,6819,6887,13706
202208,5호선,명일,5790,5674,11464
202208,5호선,목동,10305,10294,20599
202208,5호선,미사,11374,11445,22819
202208,5호선,발산,11150,12506,23656
202208,5호선,방이,5094,4876,9970
202208,5호선,방화,4377,4063,8440
202208,5호선,상일동,8591,7983,16574
202208,5호선,서대문,6802,6713,13515
202208,5호선,송정,4483,4245,8728
202208,5호선,신금호,3747,3780,7527
202208,5호선,신길,2555,2493,5048
202208,5호선,신정,8480,7088,15568
202208,5호선,아차산,10414,9818,20232
202208,5호선,애오개,3391,3210,6601
202208,5호선,양평,3422,3172,6594
202208,5호선,여의나루,8975,11027,20002
202208,5호선,여의도,11366,11745,23111
202208,5호선,영등포구청,1865,1727,3592
202208,5호선,영등포시장,7163,7285,14448
202208,5호선,오금,2485,2284,4769
202208,5호선,오목교,15677,16046,31723
202208,5호선,올림픽공원,4442,4168,8610
202208,5호선,왕십리,3129,3911,7040
202208,5호선,우장산,9186,8936,18122
202208,5호선,을지로4가,3032,3356,6388
202208,5호선,장한평,10556,10114,20670
202208,5호선,종로3가,11188,11585,22773
202208,5호선,천호,16142,15427,31569
202208,5호선,청구,2310,2132,4442
202208,5호선,충정로,1794,1704,3498
202208,5호선,하남검단산,5101,4947,10048
202208,5호선,하남시청,5162,4902,10064
202208,5호선,하남풍산,2669,2646,5315
202208,5호선,행당,4986,4212,9198
202208,5호선,화곡,18983,17249,36232
202208,5호선,강동,8144,8130,16274
202208,5호선,강일,2022,1985,4007
202208,5호선,개롱,2776,3066,5842
202208,5호선,개화산,2475,2550,5025
202208,5호선,거여,4254,4206,8460
202208,5호선,고덕,4064,4245,8309
202208,5호선,공덕,4301,4388,8689
202208,5호선,광나루,7402,6841,14243
202208,5호선,광화문,15753,15852,31605
202208,5호선,군자,5624,6282,11906
202208,5호선,굽은다리,5305,5075,10380
202208,5호선,길동,3880,4028,7908
202208,5호선,김포공항,7407,7014,14421
202208,5호선,까치산,14470,14291,28761
202208,5호선,답십리,7108,6610,13718
202208,5호선,동대문역사문화공원,853,1058,1911
202208,5호선,둔촌동,4305,4229,8534
202208,5호선,마곡,3397,3613,7010
202208,5호선,마장,2582,2409,4991
202208,5호선,마천,3258,3423,6681
202208,5호선,마포,4555,4566,9121
202208,5호선,명일,4499,4633,9132
202208,5호선,목동,7170,7279,14449
202208,5호선,미사,8389,8520,16909
202208,5호선,발산,8083,8792,16875
202208,5호선,방이,3772,3671,7443
202208,5호선,방화,3289,3278,6567
202208,5호선,상일동,6046,5984,12030
202208,5호선,서대문,4705,4627,9332
202208,5호선,송정,3352,3313,6665
202208,5호선,신금호,2684,2938,5622
202208,5호선,신길,1869,2047,3916
202208,5호선,신정,5837,5286,11123
202208,5호선,아차산,7944,8053,15997
202208,5호선,애오개,2488,2530,5018
202208,5호선,양평,2478,2490,4968
202208,5호선,여의나루,8154,9847,18001
202208,5호선,여의도,8034,8394,16428
202208,5호선,영등포구청,1323,1305,2628
202208,5호선,영등포시장,5126,5382,10508
202208,5호선,오금,1404,1419,2823
202208,5호선,오목교,10605,11181,21786
202208,5호선,올림픽공원,3536,3756,7292
202208,5호선,왕십리,2315,2839,5154
202208,5호선,우장산,6491,6580,13071
202208,5호선,을지로4가,1487,1618,3105
202208,5호선,장한평,7363,7466,14829
202208,5호선,종로3가,8120,7214,15334
202208,5호선,천호,12076,11397,23473
202208,5호선,청구,1742,1627,3369
202208,5호선,충정로,1419,1404,2823
202208,5호선,하남검단산,4082,4097,8179
202208,5호선,하남시청,3723,3529,7252
202208,5호선,하남풍산,2146,2103,4249
202208,5호선,행당,3729,3364,7093
202208,5호선,화곡,13175,12531,25706
202208,5호선,강동,11678,10783,22461
202208,5호선,강일,2896,2600,5496
202208,5호선,개롱,3851,3943,7794
202208,5호선,개화산,3394,3167,6561
202208,5호선,거여,5765,5381,11146
202208,5호선,고덕,5899,5573,11472
202208,5호선,공덕,6426,6470,12896
202208,5호선,광나루,10575,10102,20677
202208,5호선,광화문,16668,17511,34179
202208,5호선,군자,7517,8093,15610
202208,5호선,굽은다리,6660,6291,12951
202208,5호선,길동,5476,5578,11054
202208,5호선,김포공항,7422,7731,15153
202208,5호선,까치산,19261,17374,36635
202208,5호선,답십리,9577,8538,18115
202208,5호선,동대문역사문화공원,1117,1422,2539
202208,5호선,둔촌동,5288,5202,10490
202208,5호선,마곡,4953,4959,9912
202208,5호선,마장,3337,2951,6288
202208,5호선,마천,4210,4310,8520
202208,5호선,마포,6755,6745,13500
202208,5호선,명일,5364,5233,10597
202208,5호선,목동,10078,10000,20078
202208,5호선,미사,11404,11306,22710
202208,5호선,발산,11424,12336,23760
202208,5호선,방이,4665,4579,9244
202208,5호선,방화,4180,3998,8178
202208,5호선,상일동,8305,7916,16221
202208,5호선,서대문,6376,6168,12544
202208,5호선,송정,4608,4260,8868
202208,5호선,신금호,3650,3665,7315
202208,5호선,신길,2495,2451,4946
202208,5호선,신정,8091,6717,14808
202208,5호선,아차산,10076,9612,19688
202208,5호선,애오개,3252,3041,6293
202208,5호선,양평,3294,2995,6289
202208,5호선,여의나루,6490,8850,15340
202208,5호선,여의도,11189,11552,22741
202208,5호선,영등포구청,1892,1859,3751
202208,5호선,영등포시장,7040,7208,14248
202208,5호선,오금,1794,1789,3583
202208,5호선,오목교,14621,15043,29664
202208,5호선,올림픽공원,5037,5057,10094
202208,5호선,왕십리,3000,3832,6832
202208,5호선,우장산,8882,8516,17398
202208,5호선,을지로4가,3011,3384,6395
202208,5호선,장한평,10365,9932,20297
202208,5호선,종로3가,10950,11313,22263
202208,5호선,천호,14937,14458,29395
202208,5호선,청구,2225,2117,4342
202208,5호선,충정로,1680,1475,3155
202208,5호선,하남검단산,5006,4904,9910
202208,5호선,하남시청,5214,4895,10109
202208,5호선,하남풍산,2700,2719,5419
202208,5호선,행당,4744,3999,8743
202208,5호선,화곡,18415,16194,34609
202208,5호선,강동,8311,8047,16358
202208,5호선,강일,2302,2154,4456
202208,5호선,개롱,2814,3022,5836
202208,5호선,개화산,2573,2564,5137
202208,5호선,거여,4473,4169,8642
202208,5호선,고덕,3950,3850,7800
202208,5호선,공덕,4447,4576,9023
202208,5호선,광나루,7706,7110,14816
202208,5호선,광화문,18111,18439,36550
202208,5호선,군자,5734,6324,12058
202208,5호선,굽은다리,5273,4994,10267
202208,5호선,길동,4122,4126,8248
202208,5호선,김포공항,7075,7005,14080
202208,5호선,까치산,15450,14642,30092
202208,5호선,답십리,7619,6970,14589
202208,5호선,동대문역사문화공원,947,1211,2158
202208,5호선,둔촌동,4302,4294,8596
202208,5호선,마곡,3534,3662,7196
202208,5호선,마장,2688,2620,5308
202208,5호선,마천,3306,3349,6655
202208,5호선,마포,4679,4808,9487
202208,5호선,명일,4787,4721,9508
202208,5호선,목동,7619,7644,15263
202208,5호선,미사,8921,9106,18027
202208,5호선,발산,8659,9455,18114
202208,5호선,방이,3829,3563,7392
202208,5호선,방화,3551,3426,6977
202208,5호선,상일동,6383,6157,12540
202208,5호선,서대문,5004,4847,9851
202208,5호선,송정,3485,3394,6879
202208,5호선,신금호,2823,3057,5880
202208,5호선,신길,1935,1977,3912
202208,5호선,신정,6097,5323,11420
202208,5호선,아차산,8698,8235,16933
202208,5호선,애오개,2512,2432,4944
202208,5호선,양평,2569,2382,4951
202208,5호선,여의나루,7685,10182,17867
202208,5호선,여의도,9176,8980,18156
202208,5호선,영등포구청,1328,1189,2517
202208,5호선,영등포시장,5381,5578,10959
202208,5호선,오금,1443,1325,2768
202208,5호선,오목교,11608,11836,23444
202208,5호선,올림픽공원,3915,3838,7753
202208,5호선,왕십리,2218,2810,5028
202208,5호선,우장산,6772,6874,13646
202208,5호선,을지로4가,1834,2066,3900
202208,5호선,장한평,7921,7705,15626
202208,5호선,종로3가,9829,9678,19507
202208,5호선,천호,12200,11677,23877
202208,5호선,청구,1739,1626,3365
202208,5호선,충정로,1403,1338,2741
202208,5호선,하남검단산,4729,4663,9392
202208,5호선,하남시청,4251,4073,8324
202208,5호선,하남풍산,2231,2191,4422
202208,5호선,행당,4041,3507,7548
202208,5호선,화곡,14049,12925,26974
202208,5호선,강동,13155,12589,25744
202208,5호선,강일,3200,2966,6166
202208,5호선,개롱,4279,4421,8700
202208,5호선,개화산,3801,3630,7431
202208,5호선,거여,6557,6121,12678
202208,5호선,고덕,6448,6290,12738
202208,5호선,공덕,7243,7586,14829
202208,5호선,광나루,10755,10690,21445
202208,5호선,광화문,19900,20962,40862
202208,5호선,군자,8503,9396,17899
202208,5호선,굽은다리,7570,7170,14740
202208,5호선,길동,6007,5960,11967
202208,5호선,김포공항,7443,7676,15119
202208,5호선,까치산,21138,19408,40546
202208,5호선,답십리,10626,9450,20076
202208,5호선,동대문역사문화공원,1212,1554,2766
202208,5호선,둔촌동,5862,5840,11702
202208,5호선,마곡,5700,5804,11504
202208,5호선,마장,3980,3637,7617
202208,5호선,마천,4877,4740,9617
202208,5호선,마포,7515,7574,15089
202208,5호선,명일,6145,6043,12188
202208,5호선,목동,11347,11317,22664
202208,5호선,미사,12259,12380,24639
202208,5호선,발산,12764,14040,26804
202208,5호선,방이,5256,5159,10415
202208,5호선,방화,4792,4613,9405
202208,5호선,상일동,9579,8616,18195
202208,5호선,서대문,7747,7515,15262
202208,5호선,송정,5033,4627,9660
202208,5호선,신금호,4040,4129,8169
202208,5호선,신길,2755,2732,5487
202208,5호선,신정,9189,7596,16785
202208,5호선,아차산,11699,11117,22816
202208,5호선,애오개,3664,3517,7181
202208,5호선,양평,3898,3666,7564
202208,5호선,여의나루,12555,14062,26617
202208,5호선,여의도,12816,13671,26487
202208,5호선,영등포구청,2132,2029,4161
202208,5호선,영등포시장,8237,8545,16782
202208,5호선,오금,2100,1972,4072
202208,5호선,오목교,17609,17949,35558
202208,5호선,올림픽공원,5392,4851,10243
202208,5호선,왕십리,3427,4324,7751
202208,5호선,우장산,9955,9665,19620
202208,5호선,을지로4가,3413,3960,7373
202208,5호선,장한평,11528,11206,22734
202208,5호선,종로3가,12798,13280,26078
202208,5호선,천호,17194,16672,33866
202208,5호선,청구,2453,2337,4790
202208,5호선,충정로,1911,1751,3662
202208,5호선,하남검단산,5438,5220,10658
202208,5호선,하남시청,5698,5341,11039
202208,5호선,하남풍산,2887,2821,5708
202208,5호선,행당,5543,4744,10287
202208,5호선,화곡,20554,18352,38906
202208,5호선,강동,9241,9206,18447
202208,5호선,강일,2428,2236,4664
202208,5호선,개롱,3018,3380,6398
202208,5호선,개화산,2687,2737,5424
202208,5호선,거여,4561,4415,8976
202208,5호선,고덕,4477,4562,9039
202208,5호선,공덕,4607,4604,9211
202208,5호선,광나루,8241,7846,16087
202208,5호선,광화문,15841,16129,31970
202208,5호선,군자,6138,6745,12883
202208,5호선,굽은다리,5567,5284,10851
202208,5호선,길동,4179,4106,8285
202208,5호선,김포공항,7169,6857,14026
202208,5호선,까치산,15370,14936,30306
202208,5호선,답십리,7985,7325,15310
202208,5호선,동대문역사문화공원,933,1090,2023
202208,5호선,둔촌동,4597,4542,9139
202208,5호선,마곡,3659,3896,7555
202208,5호선,마장,2797,2547,5344
202208,5호선,마천,3609,3882,7491
202208,5호선,마포,4837,4854,9691
202208,5호선,명일,5026,5250,10276
202208,5호선,목동,7737,7849,15586
202208,5호선,미사,8825,9024,17849
202208,5호선,발산,8390,9284,17674
202208,5호선,방이,3959,3753,7712
202208,5호선,방화,3633,3627,7260
202208,5호선,상일동,6569,6267,12836
202208,5호선,서대문,5984,5962,11946
202208,5호선,송정,3652,3507,7159
202208,5호선,신금호,3005,3192,6197
202208,5호선,신길,2008,2202,4210
202208,5호선,신정,6448,5637,12085
202208,5호선,아차산,9347,9049,18396
202208,5호선,애오개,2720,2673,5393
202208,5호선,양평,2696,2769,5465
202208,5호선,여의나루,10820,12028,22848
202208,5호선,여의도,8718,9266,17984
202208,5호선,영등포구청,1577,1389,2966
202208,5호선,영등포시장,5641,5840,11481
202208,5호선,오금,1582,1507,3089
202208,5호선,오목교,11797,11926,23723
202208,5호선,올림픽공원,3611,3403,7014
202208,5호선,왕십리,2531,3176,5707
202208,5호선,우장산,6987,7002,13989
202208,5호선,을지로4가,1730,1847,3577
202208,5호선,장한평,8044,7930,15974
202208,5호선,종로3가,8856,8379,17235
202208,5호선,천호,13011,12273,25284
202208,5호선,청구,1824,1708,3532
202208,5호선,충정로,1583,1474,3057
202208,5호선,하남검단산,4742,4542,9284
202208,5호선,하남시청,4084,3901,7985
202208,5호선,하남풍산,2386,2347,4733
202208,5호선,행당,4076,3594,7670
202208,5호선,화곡,13973,13186,27159
202208,5호선,강동,14377,13550,27927
202208,5호선,강일,3595,3187,6782
202208,5호선,개롱,4434,4599,9033
202208,5호선,개화산,3935,3762,7697
202208,5호선,거여,6847,6219,13066
202208,5호선,고덕,6980,6741,13721
202208,5호선,공덕,7919,8328,16247
202208,5호선,광나루,12306,12047,24353
202208,5호선,광화문,21550,22419,43969
202208,5호선,군자,8799,9926,18725
202208,5호선,굽은다리,7521,6919,14440
202208,5호선,길동,6306,6342,12648
202208,5호선,김포공항,7991,7951,15942
202208,5호선,까치산,22612,21022,43634
202208,5호선,답십리,11515,10139,21654
202208,5호선,동대문역사문화공원,1191,1654,2845
202208,5호선,둔촌동,6094,6074,12168
202208,5호선,마곡,5977,6159,12136
202208,5호선,마장,4313,4039,8352
202208,5호선,마천,5168,5124,10292
202208,5호선,마포,8075,8133,16208
202208,5호선,명일,6533,6364,12897
202208,5호선,목동,12316,12226,24542
202208,5호선,미사,13411,13259,26670
202208,5호선,발산,14028,15281,29309
202208,5호선,방이,5520,5357,10877
202208,5호선,방화,5080,4825,9905
202208,5호선,상일동,10089,9190,19279
202208,5호선,서대문,8105,7883,15988
202208,5호선,송정,5431,4941,10372
202208,5호선,신금호,4388,4604,8992
202208,5호선,신길,3063,3097,6160
202208,5호선,신정,9611,8070,17681
202208,5호선,아차산,13723,12617,26340
202208,5호선,애오개,3942,3824,7766
202208,5호선,양평,4054,3641,7695
202208,5호선,여의나루,23694,24663,48357
202208,5호선,여의도,12905,14642,27547
202208,5호선,영등포구청,2276,2102,4378
202208,5호선,영등포시장,9146,9442,18588
202208,5호선,오금,2118,1860,3978
202208,5호선,오목교,17189,17879,35068
202208,5호선,올림픽공원,4101,3855,7956
202208,5호선,왕십리,3456,4511,7967
202208,5호선,우장산,10778,10367,21145
202208,5호선,을지로4가,3905,4429,8334
202208,5호선,장한평,12618,12193,24811
202208,5호선,종로3가,14296,15078,29374
202208,5호선,천호,18159,17538,35697
202208,5호선,청구,2741,2447,5188
202208,5호선,충정로,2061,1816,3877
202208,5호선,하남검단산,6127,5936,12063
202208,5호선,하남시청,6177,5739,11916
202208,5호선,하남풍산,2960,2956,5916
202208,5호선,행당,6091,5127,11218
202208,5호선,화곡,21827,19481,41308
202208,5호선,강동,9677,9640,19317
202208,5호선,강일,2599,2444,5043
202208,5호선,개롱,3118,3455,6573
202208,5호선,개화산,2821,2872,5693
202208,5호선,거여,4923,4873,9796
202208,5호선,고덕,4333,4391,8724
202208,5호선,공덕,5104,5195,10299
202208,5호선,광나루,9585,9136,18721
202208,5호선,광화문,16877,17138,34015
202208,5호선,군자,6576,7371,13947
202208,5호선,굽은다리,5585,5239,10824
202208,5호선,길동,4190,4375,8565
202208,5호선,김포공항,7174,6950,14124
202208,5호선,까치산,16416,15915,32331
202208,5호선,답십리,8469,7852,16321
202208,5호선,동대문역사문화공원,1019,1159,2178
202208,5호선,둔촌동,4870,4753,9623
202208,5호선,마곡,3847,4205,8052
202208,5호선,마장,3129,3023,6152
202208,5호선,마천,3842,4065,7907
202208,5호선,마포,5162,5294,10456
202208,5호선,명일,5320,5245,10565
202208,5호선,목동,8370,8552,16922
202208,5호선,미사,9455,9738,19193
202208,5호선,발산,9245,9947,19192
202208,5호선,방이,4423,4202,8625
202208,5호선,방화,3749,3570,7319
202208,5호선,상일동,6982,6750,13732
202208,5호선,서대문,5722,5801,11523
202208,5호선,송정,3918,3837,7755
202208,5호선,신금호,3068,3390,6458
202208,5호선,신길,2251,2449,4700
202208,5호선,신정,6623,5962,12585
202208,5호선,아차산,10933,10896,21829
202208,5호선,애오개,2834,2897,5731
202208,5호선,양평,2933,2868,5801
202208,5호선,여의나루,18875,19241,38116
202208,5호선,여의도,9285,10259,19544
202208,5호선,영등포구청,1489,1494,2983
202208,5호선,영등포시장,6308,6728,13036
202208,5호선,오금,1550,1459,3009
202208,5호선,오목교,12088,12506,24594
202208,5호선,올림픽공원,3640,3817,7457
202208,5호선,왕십리,2582,3065,5647
202208,5호선,우장산,7359,7576,14935
202208,5호선,을지로4가,2143,2304,4447
202208,5호선,장한평,8548,8392,16940
202208,5호선,종로3가,10193,9130,19323
202208,5호선,천호,13626,12685,26311
202208,5호선,청구,2004,1883,3887
202208,5호선,충정로,1700,1599,3299
202208,5호선,하남검단산,4998,5001,9999
202208,5호선,하남시청,4433,4101,8534
202208,5호선,하남풍산,2355,2315,4670
202208,5호선,행당,4370,3940,8310
202208,5호선,화곡,15136,14367,29503
202209,5호선,강동,14331,13780,28111
202209,5호선,강일,3694,3308,7002
202209,5호선,개롱,4644,4901,9545
202209,5호선,개화산,4040,3924,7964
202209,5호선,거여,6943,6439,13382
202209,5호선,고덕,7047,6891,13938
202209,5호선,공덕,8175,8269,16444
202209,5호선,광나루,11260,10686,21946
202209,5호선,광화문,22763,22792,45555
202209,5호선,군자,9310,10077,19387
202209,5호선,굽은다리,7760,7249,15009
202209,5호선,길동,6589,6775,13364
202209,5호선,김포공항,7638,7070,14708
202209,5호선,까치산,22722,20918,43640
202209,5호선,답십리,11496,10304,21800
202209,5호선,동대문역사문화공원,1309,1560,2869
202209,5호선,둔촌동,6537,6372,12909
202209,5호선,마곡,5902,6222,12124
202209,5호선,마장,4452,4306,8758
202209,5호선,마천,5364,5454,10818
202209,5호선,마포,8264,8295,16559
202209,5호선,명일,7043,6731,13774
202209,5호선,목동,12154,12000,24154
202209,5호선,미사,13620,13590,27210
202209,5호선,발산,14910,16650,31560
202209,5호선,방이,5955,5698,11653
202209,5호선,방화,5068,4806,9874
202209,5호선,상일동,10225,9213,19438
202209,5호선,서대문,8669,8461,17130
202209,5호선,송정,5497,5058,10555
202209,5호선,신금호,4490,4441,8931
202209,5호선,신길,3063,2946,6009
202209,5호선,신정,9859,8287,18146
202209,5호선,아차산,13727,13280,27007
202209,5호선,애오개,4207,4002,8209
202209,5호선,양평,4247,3771,8018
202209,5호선,여의나루,21712,23416,45128
202209,5호선,여의도,12924,14499,27423
202209,5호선,영등포구청,2255,2170,4425
202209,5호선,영등포시장,9520,10066,19586
202209,5호선,오금,2315,2219,4534
202209,5호선,오목교,18329,18856,37185
202209,5호선,올림픽공원,5712,6607,12319
202209,5호선,왕십리,3849,4724,8573
202209,5호선,우장산,10910,10578,21488
202209,5호선,을지로4가,4465,4863,9328
202209,5호선,장한평,12558,12207,24765
202209,5호선,종로3가,14677,15849,30526
202209,5호선,천호,18446,17753,36199
202209,5호선,청구,2655,2441,5096
202209,5호선,충정로,2117,1958,4075
202209,5호선,하남검단산,6289,6170,12459
202209,5호선,하남시청,6400,5829,12229
202209,5호선,하남풍산,2967,2904,5871
202209,5호선,행당,5996,5112,11108
202209,5호선,화곡,22253,19964,42217
202209,5호선,강동,8623,8733,17356
202209,5호선,강일,2132,2111,4243
202209,5호선,개롱,2882,3222,6104
202209,5호선,개화산,2564,2562,5126
202209,5호선,거여,4385,4256,8641
202209,5호선,고덕,4168,4210,8378
202209,5호선,공덕,4625,4613,9238
202209,5호선,광나루,7246,6915,14161
202209,5호선,광화문,12384,12196,24580
202209,5호선,군자,5735,6379,12114
202209,5호선,굽은다리,5314,5122,10436
202209,5호선,길동,4097,4123,8220
202209,5호선,김포공항,6660,5879,12539
202209,5호선,까치산,14941,14408,29349
202209,5호선,답십리,7563,6976,14539
202209,5호선,동대문역사문화공원,942,1032,1974
202209,5호선,둔촌동,4514,4570,9084
202209,5호선,마곡,3598,3835,7433
202209,5호선,마장,2948,2883,5831
202209,5호선,마천,3502,3604,7106
202209,5호선,마포,4785,4821,9606
202209,5호선,명일,4797,4769,9566
202209,5호선,목동,7544,7673,15217
202209,5호선,미사,8345,8353,16698
202209,5호선,발산,9079,9552,18631
202209,5호선,방이,4270,3922,8192
202209,5호선,방화,3230,3225,6455
202209,5호선,상일동,6212,6209,12421
202209,5호선,서대문,4933,4904,9837
202209,5호선,송정,3445,3398,6843
202209,5호선,신금호,2788,3083,5871
202209,5호선,신길,1942,2076,4018
202209,5호선,신정,6056,5507,11563
202209,5호선,아차산,8158,7948,16106
202209,5호선,애오개,2616,2611,5227
202209,5호선,양평,2716,2801,5517
202209,5호선,여의나루,5054,7082,12136
202209,5호선,여의도,9038,9041,18079
202209,5호선,영등포구청,1370,1294,2664
202209,5호선,영등포시장,5856,6083,11939
202209,5호선,오금,1471,1450,2921
202209,5호선,오목교,11256,11640,22896
202209,5호선,올림픽공원,2776,2707,5483
202209,5호선,왕십리,2373,2840,5213
202209,5호선,우장산,6698,6909,13607
202209,5호선,을지로4가,1608,1761,3369
202209,5호선,장한평,8002,7943,15945
202209,5호선,종로3가,8584,7327,15911
202209,5호선,천호,12014,11330,23344
202209,5호선,청구,1659,1617,3276
202209,5호선,충정로,1485,1584,3069
202209,5호선,하남검단산,3934,3915,7849
202209,5호선,하남시청,4238,4095,8333
202209,5호선,하남풍산,2156,2180,4336
202209,5호선,행당,3946,3606,7552
202209,5호선,화곡,13736,12811,26547
202209,5호선,강동,5925,5590,11515
202209,5호선,강일,1712,1570,3282
202209,5호선,개롱,1926,2132,4058
202209,5호선,개화산,2204,2165,4369
202209,5호선,거여,3054,2950,6004
202209,5호선,고덕,2613,2694,5307
202209,5호선,공덕,3071,3098,6169
202209,5호선,광나루,5030,4675,9705
202209,5호선,광화문,14849,14377,29226
202209,5호선,군자,4116,4343,8459
202209,5호선,굽은다리,3821,3632,7453
202209,5호선,길동,2555,2697,5252
202209,5호선,김포공항,5986,6288,12274
202209,5호선,까치산,11279,11307,22586
202209,5호선,답십리,5510,5113,10623
202209,5호선,동대문역사문화공원,726,910,1636
202209,5호선,둔촌동,2595,2502,5097
202209,5호선,마곡,2094,2208,4302
202209,5호선,마장,1968,1823,3791
202209,5호선,마천,2624,2616,5240
202209,5호선,마포,3385,3229,6614
202209,5호선,명일,2815,2862,5677
202209,5호선,목동,5621,5776,11397
202209,5호선,미사,5977,6013,11990
202209,5호선,발산,4705,5302,10007
202209,5호선,방이,2027,1960,3987
202209,5호선,방화,2675,2715,5390
202209,5호선,상일동,4380,4047,8427
202209,5호선,서대문,3593,3648,7241
202209,5호선,송정,2907,2776,5683
202209,5호선,신금호,2279,2393,4672
202209,5호선,신길,1315,1389,2704
202209,5호선,신정,4916,4426,9342
202209,5호선,아차산,7028,6619,13647
202209,5호선,애오개,1758,1725,3483
202209,5호선,양평,1720,1557,3277
202209,5호선,여의나루,13019,13026,26045
202209,5호선,여의도,3558,4491,8049
202209,5호선,영등포구청,884,792,1676
202209,5호선,영등포시장,2974,3022,5996
202209,5호선,오금,918,876,1794
202209,5호선,오목교,5827,6127,11954
202209,5호선,올림픽공원,1545,1395,2940
202209,5호선,왕십리,1635,1932,3567
202209,5호선,우장산,4412,4598,9010
202209,5호선,을지로4가,1228,1338,2566
202209,5호선,장한평,5076,5014,10090
202209,5호선,종로3가,7657,7471,15128
202209,5호선,천호,6729,6971,13700
202209,5호선,청구,1340,1181,2521
202209,5호선,충정로,949,905,1854
202209,5호선,하남검단산,3481,3361,6842
202209,5호선,하남시청,3026,2931,5957
202209,5호선,하남풍산,1277,1285,2562
202209,5호선,행당,3031,2527,5558
202209,5호선,화곡,10348,9700,20048
202209,5호선,강동,7325,7657,14982
202209,5호선,강일,2370,2059,4429
202209,5호선,개롱,2711,2835,5546
202209,5호선,개화산,2533,2535,5068
202209,5호선,거여,3936,3746,7682
202209,5호선,고덕,3741,3609,7350
202209,5호선,공덕,3781,4060,7841
202209,5호선,광나루,7145,6829,13974
202209,5호선,광화문,19049,18709,37758
202209,5호선,군자,4980,6002,10982
202209,5호선,굽은다리,4914,4637,9551
202209,5호선,길동,3474,3637,7111
202209,5호선,김포공항,7928,6847,14775
202209,5호선,까치산,13737,14209,27946
202209,5호선,답십리,6663,6333,12996
202209,5호선,동대문역사문화공원,845,947,1792
202209,5호선,둔촌동,3772,3888,7660
202209,5호선,마곡,3041,3155,6196
202209,5호선,마장,2483,2370,4853
202209,5호선,마천,3399,3498,6897
202209,5호선,마포,4017,4339,8356
202209,5호선,명일,4507,4467,8974
202209,5호선,목동,6832,7093,13925
202209,5호선,미사,8115,8734,16849
202209,5호선,발산,7342,8895,16237
202209,5호선,방이,3337,3224,6561
202209,5호선,방화,3216,3151,6367
202209,5호선,상일동,6147,5728,11875
202209,5호선,서대문,4403,4517,8920
202209,5호선,송정,3438,3336,6774
202209,5호선,신금호,2604,2775,5379
202209,5호선,신길,1521,1850,3371
202209,5호선,신정,5922,5477,11399
202209,5호선,아차산,9842,9522,19364
202209,5호선,애오개,2228,2340,4568
202209,5호선,양평,2149,2268,4417
202209,5호선,여의나루,14911,16611,31522
202209,5호선,여의도,8587,8417,17004
202209,5호선,영등포구청,1139,1166,2305
202209,5호선,영등포시장,4131,4705,8836
202209,5호선,오금,1277,1158,2435
202209,5호선,오목교,9886,10345,20231
202209,5호선,올림픽공원,2830,2620,5450
202209,5호선,왕십리,1982,2600,4582
202209,5호선,우장산,6180,6290,12470
202209,5호선,을지로4가,1612,1710,3322
202209,5호선,장한평,7214,7631,14845
202209,5호선,종로3가,10655,10368,21023
202209,5호선,천호,10596,10689,21285
202209,5호선,청구,1567,1600,3167
202209,5호선,충정로,1233,1153,2386
202209,5호선,하남검단산,4808,4687,9495
202209,5호선,하남시청,3992,3664,7656
202209,5호선,하남풍산,2079,1962,4041
202209,5호선,행당,3611,3296,6907
202209,5호선,화곡,12962,12614,25576
202209,5호선,강동,14011,13340,27351
202209,5호선,강일,3718,3191,6909
202209,5호선,개롱,4692,4817,9509
202209,5호선,개화산,3954,3864,7818
202209,5호선,거여,7152,6627,13779
202209,5호선,고덕,7048,6679,13727
202209,5호선,공덕,8278,8597,16875
202209,5호선,광나루,11118,10431,21549
202209,5호선,광화문,21875,21904,43779
202209,5호선,군자,9218,10177,19395
202209,5호선,굽은다리,7750,7406,15156
202209,5호선,길동,6505,6723,13228
202209,5호선,김포공항,7671,7749,15420
202209,5호선,까치산,22563,20909,43472
202209,5호선,답십리,11808,10560,22368
202209,5호선,동대문역사문화공원,1439,1690,3129
202209,5호선,둔촌동,6496,6468,12964
202209,5호선,마곡,6205,6306,12511
202209,5호선,마장,4069,3764,7833
202209,5호선,마천,5228,5156,10384
202209,5호선,마포,8265,8403,16668
202209,5호선,명일,6474,6448,12922
202209,5호선,목동,12287,12075,24362
202209,5호선,미사,13640,13785,27425
202209,5호선,발산,15146,16584,31730
202209,5호선,방이,6239,5925,12164
202209,5호선,방화,5134,4844,9978
202209,5호선,상일동,9959,9094,19053
202209,5호선,서대문,8888,8676,17564
202209,5호선,송정,5415,4979,10394
202209,5호선,신금호,4310,4409,8719
202209,5호선,신길,3053,3165,6218
202209,5호선,신정,10031,8466,18497
202209,5호선,아차산,13811,12995,26806
202209,5호선,애오개,4141,3938,8079
202209,5호선,양평,4182,3839,8021
202209,5호선,여의나루,19152,21593,40745
202209,5호선,여의도,13364,14933,28297
202209,5호선,영등포구청,2241,2223,4464
202209,5호선,영등포시장,9788,10571,20359
202209,5호선,오금,2319,2159,4478
202209,5호선,오목교,17183,17759,34942
202209,5호선,올림픽공원,6805,7476,14281
202209,5호선,왕십리,3799,4792,8591
202209,5호선,우장산,10941,10581,21522
202209,5호선,을지로4가,4058,4681,8739
202209,5호선,장한평,12600,12192,24792
202209,5호선,종로3가,15020,15969,30989
202209,5호선,천호,18082,17507,35589
202209,5호선,청구,2801,2761,5562
202209,5호선,충정로,2181,2055,4236
202209,5호선,하남검단산,6018,5766,11784
202209,5호선,하남시청,6380,5864,12244
202209,5호선,하남풍산,3268,3182,6450
202209,5호선,행당,5862,5046,10908
202209,5호선,화곡,22091,19615,41706
202209,5호선,강동,10090,9859,19949
202209,5호선,강일,2572,2368,4940
202209,5호선,개롱,3312,3631,6943
202209,5호선,개화산,2847,2951,5798
202209,5호선,거여,4965,4774,9739
202209,5호선,고덕,4581,4607,9188
202209,5호선,공덕,5209,5410,10619
202209,5호선,광나루,8876,8867,17743
202209,5호선,광화문,15555,15353,30908
202209,5호선,군자,6723,7312,14035
202209,5호선,굽은다리,5672,5583,11255
202209,5호선,길동,4690,4549,9239
202209,5호선,김포공항,7160,7189,14349
202209,5호선,까치산,16735,15706,32441
202209,5호선,답십리,8568,7742,16310
202209,5호선,동대문역사문화공원,1048,1121,2169
202209,5호선,둔촌동,5133,5097,10230
202209,5호선,마곡,4026,4303,8329
202209,5호선,마장,3133,2822,5955
202209,5호선,마천,4086,4307,8393
202209,5호선,마포,5423,5403,10826
202209,5호선,명일,5156,5292,10448
202209,5호선,목동,8725,8696,17421
202209,5호선,미사,9538,9645,19183
202209,5호선,발산,9982,10496,20478
202209,5호선,방이,4642,4321,8963
202209,5호선,방화,3923,3811,7734
202209,5호선,상일동,6909,6758,13667
202209,5호선,서대문,6868,6894,13762
202209,5호선,송정,3871,3722,7593
202209,5호선,신금호,3125,3349,6474
202209,5호선,신길,2334,2415,4749
202209,5호선,신정,6848,6171,13019
202209,5호선,아차산,11588,11299,22887
202209,5호선,애오개,2865,2868,5733
202209,5호선,양평,2998,3023,6021
202209,5호선,여의나루,13809,14742,28551
202209,5호선,여의도,9293,10395,19688
202209,5호선,영등포구청,1597,1544,3141
202209,5호선,영등포시장,6750,7252,14002
202209,5호선,오금,1654,1687,3341
202209,5호선,오목교,12055,12374,24429
202209,5호선,올림픽공원,5918,6571,12489
202209,5호선,왕십리,2779,3436,6215
202209,5호선,우장산,7479,7429,14908
202209,5호선,을지로4가,2044,2167,4211
202209,5호선,장한평,9056,8804,17860
202209,5호선,종로3가,10189,9283,19472
202209,5호선,천호,13676,12838,26514
202209,5호선,청구,1988,1869,3857
202209,5호선,충정로,1650,1646,3296
202209,5호선,하남검단산,5022,5040,10062
202209,5호선,하남시청,4513,4186,8699
202209,5호선,하남풍산,2324,2224,4548
202209,5호선,행당,4283,3929,8212
202209,5호선,화곡,15504,14304,29808
202209,5호선,강동,14796,14078,28874
202209,5호선,강일,3875,3463,7338
202209,5호선,개롱,4902,5046,9948
202209,5호선,개화산,4068,3940,8008
202209,5호선,거여,7470,6888,14358
202209,5호선,고덕,7592,7205,14797
202209,5호선,공덕,8866,9482,18348
202209,5호선,광나루,13479,12584,26063
202209,5호선,광화문,26754,26483,53237
202209,5호선,군자,9842,10978,20820
202209,5호선,굽은다리,8025,7438,15463
202209,5호선,길동,6786,6927,13713
202209,5호선,김포공항,8195,8493,16688
202209,5호선,까치산,23830,21758,45588
202209,5호선,답십리,11938,10636,22574
202209,5호선,동대문역사문화공원,1490,1960,3450
202209,5호선,둔촌동,6821,6586,13407
202209,5호선,마곡,6267,6396,12663
202209,5호선,마장,4473,4027,8500
202209,5호선,마천,5452,5561,11013
202209,5호선,마포,8754,8846,17600
202209,5호선,명일,7154,6882,14036
202209,5호선,목동,13182,12964,26146
202209,5호선,미사,14166,14248,28414
202209,5호선,발산,15783,17144,32927
202209,5호선,방이,6126,5919,12045
202209,5호선,방화,5284,4982,10266
202209,5호선,상일동,10747,9803,20550
202209,5호선,서대문,10031,9358,19389
202209,5호선,송정,5707,5202,10909
202209,5호선,신금호,4759,4883,9642
202209,5호선,신길,3254,3303,6557
202209,5호선,신정,10473,8856,19329
202209,5호선,아차산,15961,15094,31055
202209,5호선,애오개,4264,4101,8365
202209,5호선,양평,4376,4016,8392
202209,5호선,여의나루,24680,26381,51061
202209,5호선,여의도,14523,16369,30892
202209,5호선,영등포구청,2367,2296,4663
202209,5호선,영등포시장,10483,11162,21645
202209,5호선,오금,2332,2188,4520
202209,5호선,오목교,19485,19705,39190
202209,5호선,올림픽공원,4887,4772,9659
202209,5호선,왕십리,4124,4888,9012
202209,5호선,우장산,11315,10903,22218
202209,5호선,을지로4가,4372,4917,9289
202209,5호선,장한평,13180,12789,25969
202209,5호선,종로3가,16298,17213,33511
202209,5호선,천호,19089,18354,37443
202209,5호선,청구,2898,2580,5478
202209,5호선,충정로,2228,2069,4297
202209,5호선,하남검단산,6560,6215,12775
202209,5호선,하남시청,6866,6397,13263
202209,5호선,하남풍산,3146,3070,6216
202209,5호선,행당,6583,5718,12301
202209,5호선,화곡,22986,20953,43939
202209,5호선,강동,10095,9944,20039
202209,5호선,강일,2793,2620,5413
202209,5호선,개롱,3416,3640,7056
202209,5호선,개화산,2893,2919,5812
202209,5호선,거여,5125,5124,10249
202209,5호선,고덕,4554,4604,9158
202209,5호선,공덕,5552,5610,11162
202209,5호선,광나루,10028,9880,19908
202209,5호선,광화문,17866,16715,34581
202209,5호선,군자,7026,7818,14844
202209,5호선,굽은다리,5658,5227,10885
202209,5호선,길동,4572,4587,9159
202209,5호선,김포공항,7287,7275,14562
202209,5호선,까치산,17250,16529,33779
202209,5호선,답십리,8694,8035,16729
202209,5호선,동대문역사문화공원,1067,1198,2265
202209,5호선,둔촌동,5223,5007,10230
202209,5호선,마곡,4198,4412,8610
202209,5호선,마장,3246,3016,6262
202209,5호선,마천,4190,4414,8604
202209,5호선,마포,5635,5589,11224
202209,5호선,명일,5461,5338,10799
202209,5호선,목동,9199,9055,18254
202209,5호선,미사,10014,10056,20070
202209,5호선,발산,10642,11322,21964
202209,5호선,방이,4796,4436,9232
202209,5호선,방화,3980,3875,7855
202209,5호선,상일동,7224,7067,14291
202209,5호선,서대문,6755,6857,13612
202209,5호선,송정,4146,4007,8153
202209,5호선,신금호,3362,3667,7029
202209,5호선,신길,2278,2533,4811
202209,5호선,신정,7203,6459,13662
202209,5호선,아차산,12704,12258,24962
202209,5호선,애오개,3053,3068,6121
202209,5호선,양평,3081,3013,6094
202209,5호선,여의나루,18274,18794,37068
202209,5호선,여의도,9582,10639,20221
202209,5호선,영등포구청,1606,1572,3178
202209,5호선,영등포시장,6872,7179,14051
202209,5호선,오금,1715,1586,3301
202209,5호선,오목교,12642,13035,25677
202209,5호선,올림픽공원,4100,4209,8309
202209,5호선,왕십리,2714,3225,5939
202209,5호선,우장산,7610,7664,15274
202209,5호선,을지로4가,2235,2342,4577
202209,5호선,장한평,9200,8972,18172
202209,5호선,종로3가,11137,10070,21207
202209,5호선,천호,13956,13266,27222
202209,5호선,청구,2050,1980,4030
202209,5호선,충정로,1651,1607,3258
202209,5호선,하남검단산,5212,5054,10266
202209,5호선,하남시청,4625,4336,8961
202209,5호선,하남풍산,2445,2412,4857
202209,5호선,행당,4544,4123,8667
202209,5호선,화곡,16064,15085,31149
202210,5호선,강동,14693,14018,28711
202210,5호선,강일,3762,3441,7203
202210,5호선,개롱,4826,4951,9777
202210,5호선,개화산,4088,3920,8008
202210,5호선,거여,7446,6900,14346
202210,5호선,고덕,7096,6734,13830
202210,5호선,공덕,8213,8258,16471
202210,5호선,광나루,11132,10491,21623
202210,5호선,광화문,23921,23676,47597
202210,5호선,군자,9262,9873,19135
202210,5호선,굽은다리,8112,7341,15453
202210,5호선,길동,6381,6511,12892
202210,5호선,김포공항,7865,8097,15962
202210,5호선,까치산,22698,20555,43253
202210,5호선,답십리,11542,10124,21666
202210,5호선,동대문역사문화공원,1495,1977,3472
202210,5호선,둔촌동,6465,6496,12961
202210,5호선,마곡,5859,6113,11972
202210,5호선,마장,4191,3881,8072
202210,5호선,마천,5392,5411,10803
202210,5호선,마포,7967,7900,15867
202210,5호선,명일,6801,6607,13408
202210,5호선,목동,12540,12208,24748
202210,5호선,미사,13697,13542,27239
202210,5호선,발산,15161,16384,31545
202210,5호선,방이,6011,5674,11685
202210,5호선,방화,5039,4677,9716
202210,5호선,상일동,10217,9512,19729
202210,5호선,서대문,8608,8531,17139
202210,5호선,송정,5343,4964,10307
202210,5호선,신금호,4629,4668,9297
202210,5호선,신길,3071,3142,6213
202210,5호선,신정,9741,8092,17833
202210,5호선,아차산,14944,14197,29141
202210,5호선,애오개,4065,3885,7950
202210,5호선,양평,4207,3699,7906
202210,5호선,여의나루,21494,23148,44642
202210,5호선,여의도,12491,14019,26510
202210,5호선,영등포구청,2184,2188,4372
202210,5호선,영등포시장,9683,10323,20006
202210,5호선,오금,2277,2115,4392
202210,5호선,오목교,17004,17642,34646
202210,5호선,올림픽공원,7416,6557,13973
202210,5호선,왕십리,3572,4473,8045
202210,5호선,우장산,10723,10114,20837
202210,5호선,을지로4가,4214,4844,9058
202210,5호선,장한평,12947,12434,25381
202210,5호선,종로3가,15741,16239,31980
202210,5호선,천호,17966,17395,35361
202210,5호선,청구,2665,2496,5161
202210,5호선,충정로,2089,1897,3986
202210,5호선,하남검단산,6200,6160,12360
202210,5호선,하남시청,6213,5770,11983
202210,5호선,하남풍산,3067,2986,6053
202210,5호선,행당,6314,5305,11619
202210,5호선,화곡,21952,19773,41725
202210,5호선,강동,10364,10109,20473
202210,5호선,강일,2690,2338,5028
202210,5호선,개롱,3333,3489,6822
202210,5호선,개화산,2823,2889,5712
202210,5호선,거여,5469,5205,10674
202210,5호선,고덕,4691,4570,9261
202210,5호선,공덕,5402,5565,10967
202210,5호선,광나루,8189,7817,16006
202210,5호선,광화문,18188,17283,35471
202210,5호선,군자,7014,7657,14671
202210,5호선,굽은다리,5981,5541,11522
202210,5호선,길동,4583,4659,9242
202210,5호선,김포공항,7555,7378,14933
202210,5호선,까치산,16733,15845,32578
202210,5호선,답십리,8391,7480,15871
202210,5호선,동대문역사문화공원,1172,1400,2572
202210,5호선,둔촌동,5276,5152,10428
202210,5호선,마곡,3874,3941,7815
202210,5호선,마장,3271,3157,6428
202210,5호선,마천,4148,4326,8474
202210,5호선,마포,5498,5407,10905
202210,5호선,명일,5122,5220,10342
202210,5호선,목동,8465,8473,16938
202210,5호선,미사,9642,9792,19434
202210,5호선,발산,10684,11468,22152
202210,5호선,방이,4586,4245,8831
202210,5호선,방화,3761,3594,7355
202210,5호선,상일동,7040,6988,14028
202210,5호선,서대문,5569,5680,11249
202210,5호선,송정,3936,3955,7891
202210,5호선,신금호,3277,3490,6767
202210,5호선,신길,2256,2373,4629
202210,5호선,신정,6846,6033,12879
202210,5호선,아차산,11271,10828,22099
202210,5호선,애오개,2969,2980,5949
202210,5호선,양평,3026,2960,5986
202210,5호선,여의나루,9069,12264,21333
202210,5호선,여의도,11807,10685,22492
202210,5호선,영등포구청,1538,1470,3008
202210,5호선,영등포시장,6426,6919,13345
202210,5호선,오금,1764,1675,3439
202210,5호선,오목교,12152,12558,24710
202210,5호선,올림픽공원,5638,5112,10750
202210,5호선,왕십리,2693,3336,6029
202210,5호선,우장산,7516,7669,15185
202210,5호선,을지로4가,2229,2859,5088
202210,5호선,장한평,9020,8873,17893
202210,5호선,종로3가,12858,12150,25008
202210,5호선,천호,13725,12676,26401
202210,5호선,청구,1917,1894,3811
202210,5호선,충정로,1641,1642,3283
202210,5호선,하남검단산,4790,4848,9638
202210,5호선,하남시청,4295,4196,8491
202210,5호선,하남풍산,2431,2407,4838
202210,5호선,행당,4445,3900,8345
202210,5호선,화곡,15789,14302,30091
202210,5호선,강동,14867,14174,29041
202210,5호선,강일,4129,3571,7700
202210,5호선,개롱,4922,4876,9798
202210,5호선,개화산,4379,4093,8472
202210,5호선,거여,7828,7225,15053
202210,5호선,고덕,7466,7161,14627
202210,5호선,공덕,10702,10540,21242
202210,5호선,광나루,14296,13096,27392
202210,5호선,광화문,29201,28063,57264
202210,5호선,군자,10312,11286,21598
202210,5호선,굽은다리,8108,7475,15583
202210,5호선,길동,7036,6908,13944
202210,5호선,김포공항,8987,8945,17932
202210,5호선,까치산,24828,22569,47397
202210,5호선,답십리,12826,10999,23825
202210,5호선,동대문역사문화공원,1517,1938,3455
202210,5호선,둔촌동,6852,6570,13422
202210,5호선,마곡,6632,6517,13149
202210,5호선,마장,4671,4238,8909
202210,5호선,마천,5794,5632,11426
202210,5호선,마포,23964,20898,44862
202210,5호선,명일,7048,6886,13934
202210,5호선,목동,14116,13475,27591
202210,5호선,미사,14987,14432,29419
202210,5호선,발산,16190,17222,33412
202210,5호선,방이,5927,5829,11756
202210,5호선,방화,5547,5277,10824
202210,5호선,상일동,10849,10069,20918
202210,5호선,서대문,10441,9637,20078
202210,5호선,송정,5942,5393,11335
202210,5호선,신금호,4773,4940,9713
202210,5호선,신길,5846,4390,10236
202210,5호선,신정,10979,8967,19946
202210,5호선,아차산,15893,14808,30701
202210,5호선,애오개,4953,4446,9399
202210,5호선,양평,4894,4052,8946
202210,5호선,여의나루,23998,101836,125834
202210,5호선,여의도,50113,43868,93981
202210,5호선,영등포구청,3200,2795,5995
202210,5호선,영등포시장,11634,11025,22659
202210,5호선,오금,2407,2182,4589
202210,5호선,오목교,19378,19028,38406
202210,5호선,올림픽공원,6717,7494,14211
202210,5호선,왕십리,4206,5008,9214
202210,5호선,우장산,11810,11075,22885
202210,5호선,을지로4가,5090,5167,10257
202210,5호선,장한평,14732,14936,29668
202210,5호선,종로3가,17488,18048,35536
202210,5호선,천호,19788,18771,38559
202210,5호선,청구,2931,2741,5672
202210,5호선,충정로,2646,2377,5023
202210,5호선,하남검단산,6750,6421,13171
202210,5호선,하남시청,6752,6094,12846
202210,5호선,하남풍산,3326,3135,6461
202210,5호선,행당,6568,5587,12155
202210,5호선,화곡,24951,21916,46867
202210,5호선,강동,9842,9408,19250
202210,5호선,강일,2414,2233,4647
202210,5호선,개롱,2942,3116,6058
202210,5호선,개화산,2606,2569,5175
202210,5호선,거여,4869,4634,9503
202210,5호선,고덕,4085,4153,8238
202210,5호선,공덕,5236,5414,10650
202210,5호선,광나루,7682,7242,14924
202210,5호선,광화문,17076,17382,34458
202210,5호선,군자,6734,7484,14218
202210,5호선,굽은다리,5417,5098,10515
202210,5호선,길동,4462,4632,9094
202210,5호선,김포공항,7478,7435,14913
202210,5호선,까치산,15655,14917,30572
202210,5호선,답십리,8050,7183,15233
202210,5호선,동대문역사문화공원,1157,1326,2483
202210,5호선,둔촌동,4832,4838,9670
202210,5호선,마곡,3682,3758,7440
202210,5호선,마장,3003,2844,5847
202210,5호선,마천,3638,3841,7479
202210,5호선,마포,5734,5449,11183
202210,5호선,명일,4942,4963,9905
202210,5호선,목동,7788,7953,15741
202210,5호선,미사,9097,9384,18481
202210,5호선,발산,9707,10790,20497
202210,5호선,방이,3986,3832,7818
202210,5호선,방화,3425,3388,6813
202210,5호선,상일동,6787,6588,13375
202210,5호선,서대문,5705,5474,11179
202210,5호선,송정,3637,3627,7264
202210,5호선,신금호,3052,3206,6258
202210,5호선,신길,2454,2488,4942
202210,5호선,신정,6522,5739,12261
202210,5호선,아차산,9100,8869,17969
202210,5호선,애오개,2762,2782,5544
202210,5호선,양평,2847,2732,5579
202210,5호선,여의나루,6560,10275,16835
202210,5호선,여의도,11738,10544,22282
202210,5호선,영등포구청,1410,1341,2751
202210,5호선,영등포시장,6369,6506,12875
202210,5호선,오금,1493,1426,2919
202210,5호선,오목교,11183,11423,22606
202210,5호선,올림픽공원,3237,3327,6564
202210,5호선,왕십리,2622,3087,5709
202210,5호선,우장산,6688,6862,13550
202210,5호선,을지로4가,2122,2573,4695
202210,5호선,장한평,9216,8873,18089
202210,5호선,종로3가,11603,10800,22403
202210,5호선,천호,12982,12222,25204
202210,5호선,청구,1800,1782,3582
202210,5호선,충정로,1601,1433,3034
202210,5호선,하남검단산,4531,4477,9008
202210,5호선,하남시청,4253,4091,8344
202210,5호선,하남풍산,2295,2252,4547
202210,5호선,행당,4158,3722,7880
202210,5호선,화곡,14153,12929,27082
202210,5호선,강동,14726,13902,28628
202210,5호선,강일,4501,4023,8524
202210,5호선,개롱,5137,5244,10381
202210,5호선,개화산,4286,4029,8315
202210,5호선,거여,7522,6882,14404
202210,5호선,고덕,8186,7913,16099
202210,5호선,공덕,8889,9023,17912
202210,5호선,광나루,13715,12849,26564
202210,5호선,광화문,25792,25475,51267
202210,5호선,군자,9895,10692,20587
202210,5호선,굽은다리,8276,7634,15910
202210,5호선,길동,6880,6946,13826
202210,5호선,김포공항,8065,8274,16339
202210,5호선,까치산,23717,21966,45683
202210,5호선,답십리,11819,10575,22394
202210,5호선,동대문역사문화공원,1481,1764,3245
202210,5호선,둔촌동,7134,7042,14176
202210,5호선,마곡,6392,6412,12804
202210,5호선,마장,4623,4235,8858
202210,5호선,마천,5909,6125,12034
202210,5호선,마포,8654,8836,17490
202210,5호선,명일,7357,7095,14452
202210,5호선,목동,12962,13049,26011
202210,5호선,미사,14157,14204,28361
202210,5호선,발산,16163,17746,33909
202210,5호선,방이,6448,6256,12704
202210,5호선,방화,5345,5047,10392
202210,5호선,상일동,10967,10055,21022
202210,5호선,서대문,9285,9074,18359
202210,5호선,송정,5531,5333,10864
202210,5호선,신금호,4786,4907,9693
202210,5호선,신길,3302,3347,6649
202210,5호선,신정,10309,8463,18772
202210,5호선,아차산,15677,14985,30662
202210,5호선,애오개,4278,4019,8297
202210,5호선,양평,4309,3897,8206
202210,5호선,여의나루,19087,20291,39378
202210,5호선,여의도,13321,14537,27858
202210,5호선,영등포구청,2494,2337,4831
202210,5호선,영등포시장,10031,10632,20663
202210,5호선,오금,2796,2463,5259
202210,5호선,오목교,19256,19609,38865
202210,5호선,올림픽공원,6688,6417,13105
202210,5호선,왕십리,3885,4947,8832
202210,5호선,우장산,11153,10842,21995
202210,5호선,을지로4가,4391,4814,9205
202210,5호선,장한평,13339,12885,26224
202210,5호선,종로3가,15669,16460,32129
202210,5호선,천호,19092,18503,37595
202210,5호선,청구,2844,2771,5615
202210,5호선,충정로,2266,2045,4311
202210,5호선,하남검단산,6117,5898,12015
202210,5호선,하남시청,6619,6199,12818
202210,5호선,하남풍산,3191,3031,6222
202210,5호선,행당,6295,5428,11723
202210,5호선,화곡,23313,20830,44143
202210,5호선,강동,10533,10424,20957
202210,5호선,강일,3084,2681,5765
202210,5호선,개롱,3294,3548,6842
202210,5호선,개화산,2999,3005,6004
202210,5호선,거여,5108,4859,9967
202210,5호선,고덕,4878,5002,9880
202210,5호선,공덕,5563,5560,11123
202210,5호선,광나루,8671,8380,17051
202210,5호선,광화문,16235,15802,32037
202210,5호선,군자,6896,7726,14622
202210,5호선,굽은다리,5920,5530,11450
202210,5호선,길동,4621,4583,9204
202210,5호선,김포공항,7091,7396,14487
202210,5호선,까치산,17361,16632,33993
202210,5호선,답십리,8306,7859,16165
202210,5호선,동대문역사문화공원,1095,1181,2276
202210,5호선,둔촌동,5041,5026,10067
202210,5호선,마곡,4047,4216,8263
202210,5호선,마장,3308,3117,6425
202210,5호선,마천,3998,4288,8286
202210,5호선,마포,5752,5686,11438
202210,5호선,명일,5429,5430,10859
202210,5호선,목동,8890,9041,17931
202210,5호선,미사,9950,10003,19953
202210,5호선,발산,10265,11186,21451
202210,5호선,방이,4667,4388,9055
202210,5호선,방화,4005,3993,7998
202210,5호선,상일동,7198,6874,14072
202210,5호선,서대문,7225,7355,14580
202210,5호선,송정,3990,3880,7870
202210,5호선,신금호,3326,3545,6871
202210,5호선,신길,2378,2564,4942
202210,5호선,신정,7034,6240,13274
202210,5호선,아차산,11874,11761,23635
202210,5호선,애오개,3107,2989,6096
202210,5호선,양평,3180,3113,6293
202210,5호선,여의나루,13151,13895,27046
202210,5호선,여의도,8696,9662,18358
202210,5호선,영등포구청,1762,1588,3350
202210,5호선,영등포시장,6902,7296,14198
202210,5호선,오금,1715,1697,3412
202210,5호선,오목교,12402,12751,25153
202210,5호선,올림픽공원,6037,5861,11898
202210,5호선,왕십리,2752,3292,6044
202210,5호선,우장산,7518,7741,15259
202210,5호선,을지로4가,2224,2225,4449
202210,5호선,장한평,9139,8779,17918
202210,5호선,종로3가,10806,9548,20354
202210,5호선,천호,13916,13100,27016
202210,5호선,청구,1977,2027,4004
202210,5호선,충정로,1651,1783,3434
202210,5호선,하남검단산,4974,4886,9860
202210,5호선,하남시청,4509,4347,8856
202210,5호선,하남풍산,2349,2339,4688
202210,5호선,행당,4575,4034,8609
202210,5호선,화곡,16004,15042,31046
202210,5호선,강동,15121,14383,29504
202210,5호선,강일,4125,3593,7718
202210,5호선,개롱,4808,5011,9819
202210,5호선,개화산,4319,4080,8399
202210,5호선,거여,7559,6737,14296
202210,5호선,고덕,7382,7074,14456
202210,5호선,공덕,9152,9515,18667
202210,5호선,광나루,12739,12184,24923
202210,5호선,광화문,31388,33371,64759
202210,5호선,군자,9928,10740,20668
202210,5호선,굽은다리,8036,7494,15530
202210,5호선,길동,6552,6643,13195
202210,5호선,김포공항,7980,7842,15822
202210,5호선,까치산,23849,22456,46305
202210,5호선,답십리,11836,10503,22339
202210,5호선,동대문역사문화공원,1367,1782,3149
202210,5호선,둔촌동,6691,6579,13270
202210,5호선,마곡,6596,6675,13271
202210,5호선,마장,4446,4155,8601
202210,5호선,마천,5336,5441,10777
202210,5호선,마포,9093,9355,18448
202210,5호선,명일,7041,6956,13997
202210,5호선,목동,13124,13174,26298
202210,5호선,미사,14255,14473,28728
202210,5호선,발산,16000,17620,33620
202210,5호선,방이,5837,5870,11707
202210,5호선,방화,5220,4950,10170
202210,5호선,상일동,10599,9708,20307
202210,5호선,서대문,10547,9602,20149
202210,5호선,송정,5584,5304,10888
202210,5호선,신금호,4762,4943,9705
202210,5호선,신길,3376,3454,6830
202210,5호선,신정,10348,8696,19044
202210,5호선,아차산,15514,14931,30445
202210,5호선,애오개,4350,4136,8486
202210,5호선,양평,4364,3812,8176
202210,5호선,여의나루,24084,26513,50597
202210,5호선,여의도,13464,14870,28334
202210,5호선,영등포구청,2291,2250,4541
202210,5호선,영등포시장,10371,10925,21296
202210,5호선,오금,2394,2263,4657
202210,5호선,오목교,17459,18145,35604
202210,5호선,올림픽공원,5076,5380,10456
202210,5호선,왕십리,3810,4742,8552
202210,5호선,우장산,11156,10947,22103
202210,5호선,을지로4가,4507,5023,9530
202210,5호선,장한평,13273,12735,26008
202210,5호선,종로3가,17339,17493,34832
202210,5호선,천호,18544,17867,36411
202210,5호선,청구,2860,2717,5577
202210,5호선,충정로,2337,2048,4385
202210,5호선,하남검단산,6249,5938,12187
202210,5호선,하남시청,6750,6309,13059
202210,5호선,하남풍산,3343,3262,6605
202210,5호선,행당,6439,5501,11940
202210,5호선,화곡,23599,21120,44719
202210,5호선,강동,10235,10309,20544
202210,5호선,강일,2895,2639,5534
202210,5호선,개롱,3398,3603,7001
202210,5호선,개화산,2898,2869,5767
202210,5호선,거여,5026,4960,9986
202210,5호선,고덕,4686,4709,9395
202210,5호선,공덕,5784,5950,11734
202210,5호선,광나루,9420,8934,18354
202210,5호선,광화문,17459,16886,34345
202210,5호선,군자,6907,7580,14487
202210,5호선,굽은다리,5575,5305,10880
202210,5호선,길동,4623,4604,9227
202210,5호선,김포공항,6977,7092,14069
202210,5호선,까치산,17401,16793,34194
202210,5호선,답십리,8525,7864,16389
202210,5호선,동대문역사문화공원,1037,1129,2166
202210,5호선,둔촌동,5109,5037,10146
202210,5호선,마곡,4080,4228,8308
202210,5호선,마장,3216,3191,6407
202210,5호선,마천,4164,4446,8610
202210,5호선,마포,5725,5836,11561
202210,5호선,명일,5486,5502,10988
202210,5호선,목동,8814,9053,17867
202210,5호선,미사,9898,10068,19966
202210,5호선,발산,10460,10972,21432
202210,5호선,방이,4463,4297,8760
202210,5호선,방화,3663,3660,7323
202210,5호선,상일동,7235,7159,14394
202210,5호선,서대문,6447,6730,13177
202210,5호선,송정,3985,3877,7862
202210,5호선,신금호,3320,3695,7015
202210,5호선,신길,2385,2534,4919
202210,5호선,신정,7157,6327,13484
202210,5호선,아차산,12366,12107,24473
202210,5호선,애오개,2868,2982,5850
202210,5호선,양평,2923,2932,5855
202210,5호선,여의나루,17576,18648,36224
202210,5호선,여의도,9300,9862,19162
202210,5호선,영등포구청,1549,1524,3073
202210,5호선,영등포시장,6874,7107,13981
202210,5호선,오금,1682,1551,3233
202210,5호선,오목교,12399,12410,24809
202210,5호선,올림픽공원,3840,4443,8283
202210,5호선,왕십리,2720,3133,5853
202210,5호선,우장산,7613,7734,15347
202210,5호선,을지로4가,2235,2417,4652
202210,5호선,장한평,9281,9044,18325
202210,5호선,종로3가,11915,10338,22253
202210,5호선,천호,13857,12919,26776
202210,5호선,청구,1971,1883,3854
202210,5호선,충정로,1587,1648,3235
202210,5호선,하남검단산,5023,4867,9890
202210,5호선,하남시청,4553,4382,8935
202210,5호선,하남풍산,2476,2415,4891
202210,5호선,행당,4547,4197,8744
202210,5호선,화곡,15815,14849,30664
202210,5호선,강동,15208,14552,29760
202210,5호선,강일,4126,3527,7653
202210,5호선,개롱,5250,5308,10558
202210,5호선,개화산,4367,4151,8518
202210,5호선,거여,7856,7161,15017
202210,5호선,고덕,7942,7390,15332
202210,5호선,공덕,9695,9519,19214
202210,5호선,광나루,13632,12660,26292
202210,5호선,광화문,29622,31065,60687
202210,5호선,군자,10194,11132,21326
202210,5호선,굽은다리,8265,7661,15926
202210,5호선,길동,6839,6674,13513
202210,5호선,김포공항,7964,7780,15744
202210,5호선,까치산,24358,22265,46623
202210,5호선,답십리,12202,10935,23137
202210,5호선,동대문역사문화공원,1660,1915,3575
202210,5호선,둔촌동,7076,6790,13866
202210,5호선,마곡,6381,6531,12912
202210,5호선,마장,4618,4381,8999
202210,5호선,마천,5823,5902,11725
202210,5호선,마포,9228,9336,18564
202210,5호선,명일,7435,7110,14545
202210,5호선,목동,13347,13267,26614
202210,5호선,미사,14887,14825,29712
202210,5호선,발산,15831,17358,33189
202210,5호선,방이,6405,6177,12582
202210,5호선,방화,5605,5213,10818
202210,5호선,상일동,10980,10054,21034
202210,5호선,서대문,11631,10516,22147
202210,5호선,송정,5730,5228,10958
202210,5호선,신금호,4839,4979,9818
202210,5호선,신길,3657,3487,7144
202210,5호선,신정,10638,8759,19397
202210,5호선,아차산,16036,15472,31508
202210,5호선,애오개,4637,4243,8880
202210,5호선,양평,4424,4024,8448
202210,5호선,여의나루,21129,23053,44182
202210,5호선,여의도,13616,15310,28926
202210,5호선,영등포구청,2498,2327,4825
202210,5호선,영등포시장,10112,10435,20547
202210,5호선,오금,2749,2361,5110
202210,5호선,오목교,18406,18813,37219
202210,5호선,올림픽공원,4764,4535,9299
202210,5호선,왕십리,3902,5003,8905
202210,5호선,우장산,11456,10895,22351
202210,5호선,을지로4가,4676,4982,9658
202210,5호선,장한평,13755,13035,26790
202210,5호선,종로3가,18632,18422,37054
202210,5호선,천호,19013,18376,37389
202210,5호선,청구,2909,2964,5873
202210,5호선,충정로,2641,2169,4810
202210,5호선,하남검단산,6615,6320,12935
202210,5호선,하남시청,7093,6696,13789
202210,5호선,하남풍산,3333,3155,6488
202210,5호선,행당,6559,5592,12151
202210,5호선,화곡,23509,21076,44585
202210,5호선,강동,10192,9856,20048
202210,5호선,강일,2747,2574,5321
202210,5호선,개롱,3311,3690,7001
202210,5호선,개화산,2928,3054,5982
202210,5호선,거여,5115,5075,10190
202210,5호선,고덕,4688,4940,9628
202210,5호선,공덕,5457,5518,10975
202210,5호선,광나루,8954,8661,17615
202210,5호선,광화문,17095,16880,33975
202210,5호선,군자,6836,7461,14297
202210,5호선,굽은다리,5851,5482,11333
202210,5호선,길동,4534,4542,9076
202210,5호선,김포공항,6634,6421,13055
202210,5호선,까치산,17043,16352,33395
202210,5호선,답십리,8572,7860,16432
202210,5호선,동대문역사문화공원,1082,1169,2251
202210,5호선,둔촌동,5149,5123,10272
202210,5호선,마곡,4078,4289,8367
202210,5호선,마장,3178,3032,6210
202210,5호선,마천,4111,4366,8477
202210,5호선,마포,5538,5477,11015
202210,5호선,명일,5928,5927,11855
202210,5호선,목동,8617,8654,17271
202210,5호선,미사,10021,10268,20289
202210,5호선,발산,10162,10885,21047
202210,5호선,방이,4508,4288,8796
202210,5호선,방화,3863,3783,7646
202210,5호선,상일동,7191,7015,14206
202210,5호선,서대문,5886,6113,11999
202210,5호선,송정,4015,3923,7938
202210,5호선,신금호,3194,3505,6699
202210,5호선,신길,2398,2579,4977
202210,5호선,신정,6956,6407,13363
202210,5호선,아차산,12388,12315,24703
202210,5호선,애오개,2919,2881,5800
202210,5호선,양평,2925,2953,5878
202210,5호선,여의나루,14055,14810,28865
202210,5호선,여의도,8949,9524,18473
202210,5호선,영등포구청,1580,1582,3162
202210,5호선,영등포시장,6785,6991,13776
202210,5호선,오금,1691,1635,3326
202210,5호선,오목교,12019,12640,24659
202210,5호선,올림픽공원,3568,3535,7103
202210,5호선,왕십리,2646,3278,5924
202210,5호선,우장산,7472,7701,15173
202210,5호선,을지로4가,2073,2194,4267
202210,5호선,장한평,8963,8708,17671
202210,5호선,종로3가,11868,10280,22148
202210,5호선,천호,13548,12914,26462
202210,5호선,청구,2116,1943,4059
202210,5호선,충정로,1649,1608,3257
202210,5호선,하남검단산,4944,4988,9932
202210,5호선,하남시청,4778,4510,9288
202210,5호선,하남풍산,2434,2356,4790
202210,5호선,행당,4484,3991,8475
202210,5호선,화곡,15567,14745,30312
202211,5호선,강동,14171,13392,27563
202211,5호선,강일,3916,3418,7334
202211,5호선,개롱,4696,4683,9379
202211,5호선,개화산,4036,3848,7884
202211,5호선,거여,6916,6424,13340
202211,5호선,고덕,7247,7070,14317
202211,5호선,공덕,8266,8702,16968
202211,5호선,광나루,12086,11282,23368
202211,5호선,광화문,22661,22263,44924
202211,5호선,군자,9449,10482,19931
202211,5호선,굽은다리,7740,7170,14910
202211,5호선,길동,6546,6662,13208
202211,5호선,김포공항,7416,7585,15001
202211,5호선,까치산,22968,21163,44131
202211,5호선,답십리,11405,10302,21707
202211,5호선,동대문역사문화공원,1429,1874,3303
202211,5호선,둔촌동,6681,6754,13435
202211,5호선,마곡,6420,6499,12919
202211,5호선,마장,4378,4122,8500
202211,5호선,마천,5390,5528,10918
202211,5호선,마포,8457,8531,16988
202211,5호선,명일,6741,6495,13236
202211,5호선,목동,12257,12544,24801
202211,5호선,미사,13844,13761,27605
202211,5호선,발산,15984,17703,33687
202211,5호선,방이,6141,6137,12278
202211,5호선,방화,5217,4998,10215
202211,5호선,상일동,10251,9443,19694
202211,5호선,서대문,9518,9139,18657
202211,5호선,송정,5400,5119,10519
202211,5호선,신금호,4442,4561,9003
202211,5호선,신길,3173,3174,6347
202211,5호선,신정,9892,8282,18174
202211,5호선,아차산,14977,14570,29547
202211,5호선,애오개,4117,3911,8028
202211,5호선,양평,4104,3754,7858
202211,5호선,여의나루,14418,17585,32003
202211,5호선,여의도,14772,15221,29993
202211,5호선,영등포구청,2187,2147,4334
202211,5호선,영등포시장,9471,10198,19669
202211,5호선,오금,3156,2837,5993
202211,5호선,오목교,18315,18746,37061
202211,5호선,올림픽공원,3560,3157,6717
202211,5호선,왕십리,3659,4601,8260
202211,5호선,우장산,10831,10511,21342
202211,5호선,을지로4가,4196,4861,9057
202211,5호선,장한평,12456,12106,24562
202211,5호선,종로3가,17124,16813,33937
202211,5호선,천호,18766,17945,36711
202211,5호선,청구,2551,2550,5101
202211,5호선,충정로,2159,1931,4090
202211,5호선,하남검단산,6137,6067,12204
202211,5호선,하남시청,6299,5976,12275
202211,5호선,하남풍산,3091,3032,6123
202211,5호선,행당,6129,5191,11320
202211,5호선,화곡,22166,19963,42129
202211,5호선,강동,10625,10308,20933
202211,5호선,강일,2855,2666,5521
202211,5호선,개롱,3447,3807,7254
202211,5호선,개화산,2835,2949,5784
202211,5호선,거여,5232,5064,10296
202211,5호선,고덕,4766,4799,9565
202211,5호선,공덕,5946,5755,11701
202211,5호선,광나루,9801,9177,18978
202211,5호선,광화문,17357,17076,34433
202211,5호선,군자,7172,7900,15072
202211,5호선,굽은다리,5796,5512,11308
202211,5호선,길동,4518,4564,9082
202211,5호선,김포공항,6598,6493,13091
202211,5호선,까치산,16873,16364,33237
202211,5호선,답십리,8953,8065,17018
202211,5호선,동대문역사문화공원,1077,1203,2280
202211,5호선,둔촌동,5819,5388,11207
202211,5호선,마곡,3840,4013,7853
202211,5호선,마장,3299,2964,6263
202211,5호선,마천,4216,4635,8851
202211,5호선,마포,6169,5806,11975
202211,5호선,명일,5453,5448,10901
202211,5호선,목동,8532,8571,17103
202211,5호선,미사,9673,9865,19538
202211,5호선,발산,10378,11344,21722
202211,5호선,방이,4900,4656,9556
202211,5호선,방화,3924,3896,7820
202211,5호선,상일동,7061,7156,14217
202211,5호선,서대문,6375,6375,12750
202211,5호선,송정,3779,3773,7552
202211,5호선,신금호,3309,3525,6834
202211,5호선,신길,2536,2565,5101
202211,5호선,신정,6866,6181,13047
202211,5호선,아차산,12824,12350,25174
202211,5호선,애오개,3261,3165,6426
202211,5호선,양평,2958,2996,5954
202211,5호선,여의나루,12615,14019,26634
202211,5호선,여의도,13547,10959,24506
202211,5호선,영등포구청,1631,1550,3181
202211,5호선,영등포시장,7118,7312,14430
202211,5호선,오금,1663,1589,3252
202211,5호선,오목교,12437,12784,25221
202211,5호선,올림픽공원,3070,2944,6014
202211,5호선,왕십리,2801,3221,6022
202211,5호선,우장산,7573,7772,15345
202211,5호선,을지로4가,2122,2300,4422
202211,5호선,장한평,9573,9200,18773
202211,5호선,종로3가,12125,10354,22479
202211,5호선,천호,14263,13610,27873
202211,5호선,청구,1989,1962,3951
202211,5호선,충정로,1587,1666,3253
202211,5호선,하남검단산,4972,5032,10004
202211,5호선,하남시청,4508,4301,8809
202211,5호선,하남풍산,2383,2310,4693
202211,5호선,행당,4294,3862,8156
202211,5호선,화곡,15499,14561,30060
202211,5호선,강동,14101,13654,27755
202211,5호선,강일,3714,3201,6915
202211,5호선,개롱,4710,4964,9674
202211,5호선,개화산,3831,3649,7480
202211,5호선,거여,6818,6297,13115
202211,5호선,고덕,6832,6624,13456
202211,5호선,공덕,8272,8750,17022
202211,5호선,광나루,12024,11042,23066
202211,5호선,광화문,25840,26233,52073
202211,5호선,군자,8844,10087,18931
202211,5호선,굽은다리,7506,7272,14778
202211,5호선,길동,6310,6377,12687
202211,5호선,김포공항,7642,7448,15090
202211,5호선,까치산,22222,20992,43214
202211,5호선,답십리,11080,10173,21253
202211,5호선,동대문역사문화공원,1489,1929,3418
202211,5호선,둔촌동,6337,6513,12850
202211,5호선,마곡,5747,5901,11648
202211,5호선,마장,4339,4229,8568
202211,5호선,마천,5069,5066,10135
202211,5호선,마포,8740,8873,17613
202211,5호선,명일,6655,6508,13163
202211,5호선,목동,11834,11979,23813
202211,5호선,미사,13150,13233,26383
202211,5호선,발산,15591,16826,32417
202211,5호선,방이,5757,5496,11253
202211,5호선,방화,4973,4738,9711
202211,5호선,상일동,9623,9405,19028
202211,5호선,서대문,10849,11066,21915
202211,5호선,송정,5187,4986,10173
202211,5호선,신금호,4628,4722,9350
202211,5호선,신길,3118,3283,6401
202211,5호선,신정,9288,8112,17400
202211,5호선,아차산,12656,12161,24817
202211,5호선,애오개,4121,4081,8202
202211,5호선,양평,3890,3741,7631
202211,5호선,여의나루,9712,15594,25306
202211,5호선,여의도,18154,16598,34752
202211,5호선,영등포구청,2219,2208,4427
202211,5호선,영등포시장,9566,10228,19794
202211,5호선,오금,2157,1999,4156
202211,5호선,오목교,17619,18168,35787
202211,5호선,올림픽공원,4815,4287,9102
202211,5호선,왕십리,3808,4473,8281
202211,5호선,우장산,10258,10144,20402
202211,5호선,을지로4가,3997,4740,8737
202211,5호선,장한평,12542,12124,24666
202211,5호선,종로3가,16218,15727,31945
202211,5호선,천호,17627,16734,34361
202211,5호선,청구,2566,2519,5085
202211,5호선,충정로,2497,2194,4691
202211,5호선,하남검단산,5366,5442,10808
202211,5호선,하남시청,6066,5776,11842
202211,5호선,하남풍산,2907,2983,5890
202211,5호선,행당,6015,5328,11343
202211,5호선,화곡,21426,19554,40980
202211,5호선,강동,9797,9743,19540
202211,5호선,강일,2505,2348,4853
202211,5호선,개롱,3042,3388,6430
202211,5호선,개화산,2685,2706,5391
202211,5호선,거여,4858,4562,9420
202211,5호선,고덕,4393,4212,8605
202211,5호선,공덕,5268,5420,10688
202211,5호선,광나루,7909,7811,15720
202211,5호선,광화문,14230,14367,28597
202211,5호선,군자,6441,7117,13558
202211,5호선,굽은다리,5405,5074,10479
202211,5호선,길동,4079,4196,8275
202211,5호선,김포공항,6384,6269,12653
202211,5호선,까치산,16328,15946,32274
202211,5호선,답십리,7974,7326,15300
202211,5호선,동대문역사문화공원,954,1078,2032
202211,5호선,둔촌동,4854,5014,9868
202211,5호선,마곡,3806,4063,7869
202211,5호선,마장,3069,2972,6041
202211,5호선,마천,3784,3944,7728
202211,5호선,마포,5431,5518,10949
202211,5호선,명일,5053,5017,10070
202211,5호선,목동,8380,8453,16833
202211,5호선,미사,8994,9109,18103
202211,5호선,발산,9901,10561,20462
202211,5호선,방이,4473,4120,8593
202211,5호선,방화,3589,3642,7231
202211,5호선,상일동,6541,6454,12995
202211,5호선,서대문,5499,5295,10794
202211,5호선,송정,3632,3601,7233
202211,5호선,신금호,2965,3274,6239
202211,5호선,신길,2235,2349,4584
202211,5호선,신정,6630,5890,12520
202211,5호선,아차산,9601,9449,19050
202211,5호선,애오개,2829,2844,5673
202211,5호선,양평,2685,2751,5436
202211,5호선,여의나루,10390,13299,23689
202211,5호선,여의도,10764,10676,21440
202211,5호선,영등포구청,1459,1459,2918
202211,5호선,영등포시장,6462,6898,13360
202211,5호선,오금,1683,1622,3305
202211,5호선,오목교,11494,11820,23314
202211,5호선,올림픽공원,3527,3710,7237
202211,5호선,왕십리,2588,3000,5588
202211,5호선,우장산,7161,7301,14462
202211,5호선,을지로4가,2085,2173,4258
202211,5호선,장한평,8284,8402,16686
202211,5호선,종로3가,10876,9551,20427
202211,5호선,천호,12770,11928,24698
202211,5호선,청구,1946,1761,3707
202211,5호선,충정로,1501,1449,2950
202211,5호선,하남검단산,4453,4260,8713
202211,5호선,하남시청,4164,3994,8158
202211,5호선,하남풍산,2198,2242,4440
202211,5호선,행당,4239,3793,8032
202211,5호선,화곡,15067,14204,29271
202211,5호선,강동,14529,13718,28247
202211,5호선,강일,3853,3280,7133
202211,5호선,개롱,4793,4932,9725
202211,5호선,개화산,4126,3843,7969
202211,5호선,거여,7257,6757,14014
202211,5호선,고덕,7790,7550,15340
202211,5호선,공덕,8982,9233,18215
202211,5호선,광나루,12781,12685,25466
202211,5호선,광화문,22502,23951,46453
202211,5호선,군자,9385,10311,19696
202211,5호선,굽은다리,7802,7167,14969
202211,5호선,길동,6367,6416,12783
202211,5호선,김포공항,7704,7662,15366
202211,5호선,까치산,22915,21135,44050
202211,5호선,답십리,11515,10293,21808
202211,5호선,동대문역사문화공원,1504,1891,3395
202211,5호선,둔촌동,6872,7157,14029
202211,5호선,마곡,6064,6226,12290
202211,5호선,마장,4413,4240,8653
202211,5호선,마천,5294,5331,10625
202211,5호선,마포,8861,9108,17969
202211,5호선,명일,6721,6744,13465
202211,5호선,목동,12334,12338,24672
202211,5호선,미사,13573,13593,27166
202211,5호선,발산,15361,16818,32179
202211,5호선,방이,5923,5810,11733
202211,5호선,방화,5054,4666,9720
202211,5호선,상일동,10274,9418,19692
202211,5호선,서대문,9973,9309,19282
202211,5호선,송정,5289,5036,10325
202211,5호선,신금호,4637,4861,9498
202211,5호선,신길,3246,3236,6482
202211,5호선,신정,9839,8258,18097
202211,5호선,아차산,14006,13079,27085
202211,5호선,애오개,4120,3910,8030
202211,5호선,양평,4170,3714,7884
202211,5호선,여의나루,16401,19774,36175
202211,5호선,여의도,15289,15874,31163
202211,5호선,영등포구청,2377,2266,4643
202211,5호선,영등포시장,9805,10202,20007
202211,5호선,오금,2453,2078,4531
202211,5호선,오목교,17959,18971,36930
202211,5호선,올림픽공원,4529,4282,8811
202211,5호선,왕십리,3861,4895,8756
202211,5호선,우장산,10639,10360,20999
202211,5호선,을지로4가,4201,4673,8874
202211,5호선,장한평,12758,12336,25094
202211,5호선,종로3가,16113,16560,32673
202211,5호선,천호,18656,18080,36736
202211,5호선,청구,2805,2549,5354
202211,5호선,충정로,2185,1908,4093
202211,5호선,하남검단산,6107,5958,12065
202211,5호선,하남시청,6421,6093,12514
202211,5호선,하남풍산,3220,3164,6384
202211,5호선,행당,6143,5287,11430
202211,5호선,화곡,21973,19940,41913
202211,5호선,강동,9941,9836,19777
202211,5호선,강일,2836,2550,5386
202211,5호선,개롱,3290,3577,6867
202211,5호선,개화산,2937,2858,5795
202211,5호선,거여,5188,4954,10142
202211,5호선,고덕,5051,5155,10206
202211,5호선,공덕,5295,5372,10667
202211,5호선,광나루,9400,9154,18554
202211,5호선,광화문,15624,16343,31967
202211,5호선,군자,6903,7568,14471
202211,5호선,굽은다리,6088,5704,11792
202211,5호선,길동,4445,4402,8847
202211,5호선,김포공항,6906,6663,13569
202211,5호선,까치산,16767,16357,33124
202211,5호선,답십리,8553,7903,16456
202211,5호선,동대문역사문화공원,1050,1190,2240
202211,5호선,둔촌동,5048,4986,10034
202211,5호선,마곡,3950,4075,8025
202211,5호선,마장,3206,2993,6199
202211,5호선,마천,4122,4386,8508
202211,5호선,마포,5627,5704,11331
202211,5호선,명일,5485,5456,10941
202211,5호선,목동,8441,8602,17043
202211,5호선,미사,9630,9918,19548
202211,5호선,발산,10125,10776,20901
202211,5호선,방이,4583,4189,8772
202211,5호선,방화,3793,3826,7619
202211,5호선,상일동,6969,6879,13848
202211,5호선,서대문,6506,6384,12890
202211,5호선,송정,3774,3767,7541
202211,5호선,신금호,3201,3511,6712
202211,5호선,신길,2347,2449,4796
202211,5호선,신정,6787,6252,13039
202211,5호선,아차산,11077,11034,22111
202211,5호선,애오개,2983,3021,6004
202211,5호선,양평,3005,2967,5972
202211,5호선,여의나루,13671,15818,29489
202211,5호선,여의도,10402,10742,21144
202211,5호선,영등포구청,1684,1623,3307
202211,5호선,영등포시장,6822,7304,14126
202211,5호선,오금,1705,1634,3339
202211,5호선,오목교,13121,13707,26828
202211,5호선,올림픽공원,3895,3615,7510
202211,5호선,왕십리,2851,3420,6271
202211,5호선,우장산,7453,7597,15050
202211,5호선,을지로4가,2399,2494,4893
202211,5호선,장한평,9104,8773,17877
202211,5호선,종로3가,11313,9911,21224
202211,5호선,천호,14278,13607,27885
202211,5호선,청구,1973,1894,3867
202211,5호선,충정로,1663,1659,3322
202211,5호선,하남검단산,5124,5079,10203
202211,5호선,하남시청,4461,4254,8715
202211,5호선,하남풍산,2623,2595,5218
202211,5호선,행당,4555,4014,8569
202211,5호선,화곡,15549,14601,30150
202211,5호선,강동,14626,13846,28472
202211,5호선,강일,3932,3379,7311
202211,5호선,개롱,5061,5101,10162
202211,5호선,개화산,4020,3865,7885
202211,5호선,거여,7241,6784,14025
202211,5호선,고덕,7068,6865,13933
202211,5호선,공덕,8793,9156,17949
202211,5호선,광나루,12790,12197,24987
202211,5호선,광화문,23452,24030,47482
202211,5호선,군자,9520,10572,20092
202211,5호선,굽은다리,7687,7198,14885
202211,5호선,길동,6480,6583,13063
202211,5호선,김포공항,7560,7645,15205
202211,5호선,까치산,22637,21413,44050
202211,5호선,답십리,11477,10313,21790
202211,5호선,동대문역사문화공원,1447,1759,3206
202211,5호선,둔촌동,6615,6615,13230
202211,5호선,마곡,6411,6450,12861
202211,5호선,마장,4395,4109,8504
202211,5호선,마천,5218,5364,10582
202211,5호선,마포,9317,9337,18654
202211,5호선,명일,6758,6606,13364
202211,5호선,목동,12336,12520,24856
202211,5호선,미사,13506,13651,27157
202211,5호선,발산,16117,17456,33573
202211,5호선,방이,5889,5691,11580
202211,5호선,방화,4849,4630,9479
202211,5호선,상일동,10165,9548,19713
202211,5호선,서대문,9677,9425,19102
202211,5호선,송정,5331,4950,10281
202211,5호선,신금호,4458,4584,9042
202211,5호선,신길,3076,3068,6144
202211,5호선,신정,9703,8128,17831
202211,5호선,아차산,13269,12544,25813
202211,5호선,애오개,4221,4049,8270
202211,5호선,양평,4045,3732,7777
202211,5호선,여의나루,12895,17371,30266
202211,5호선,여의도,16182,15308,31490
202211,5호선,영등포구청,2251,2208,4459
202211,5호선,영등포시장,9817,10199,20016
202211,5호선,오금,2295,2111,4406
202211,5호선,오목교,18186,18852,37038
202211,5호선,올림픽공원,5220,4765,9985
202211,5호선,왕십리,3820,4755,8575
202211,5호선,우장산,10756,10330,21086
202211,5호선,을지로4가,4101,4662,8763
202211,5호선,장한평,12851,12337,25188
202211,5호선,종로3가,16435,16740,33175
202211,5호선,천호,18176,17560,35736
202211,5호선,청구,2600,2494,5094
202211,5호선,충정로,2182,2066,4248
202211,5호선,하남검단산,5818,5662,11480
202211,5호선,하남시청,6238,5850,12088
202211,5호선,하남풍산,2962,2924,5886
202211,5호선,행당,5972,5247,11219
202211,5호선,화곡,22159,20084,42243
202211,5호선,강동,9764,9649,19413
202211,5호선,강일,2659,2546,5205
202211,5호선,개롱,3184,3584,6768
202211,5호선,개화산,2775,2741,5516
202211,5호선,거여,4811,4777,9588
202211,5호선,고덕,4525,4543,9068
202211,5호선,공덕,5319,5571,10890
202211,5호선,광나루,9284,9089,18373
202211,5호선,광화문,14813,15083,29896
202211,5호선,군자,7009,7974,14983
202211,5호선,굽은다리,5559,5305,10864
202211,5호선,길동,4299,4382,8681
202211,5호선,김포공항,6418,6620,13038
202211,5호선,까치산,16393,15771,32164
202211,5호선,답십리,8156,7516,15672
202211,5호선,동대문역사문화공원,1068,1194,2262
202211,5호선,둔촌동,4824,4850,9674
202211,5호선,마곡,3872,4036,7908
202211,5호선,마장,3155,3074,6229
202211,5호선,마천,3785,4094,7879
202211,5호선,마포,5559,5801,11360
202211,5호선,명일,5296,5334,10630
202211,5호선,목동,8187,8464,16651
202211,5호선,미사,9415,9538,18953
202211,5호선,발산,10778,11136,21914
202211,5호선,방이,4288,3999,8287
202211,5호선,방화,3647,3558,7205
202211,5호선,상일동,6702,6650,13352
202211,5호선,서대문,6009,5922,11931
202211,5호선,송정,3743,3715,7458
202211,5호선,신금호,3095,3447,6542
202211,5호선,신길,2179,2329,4508
202211,5호선,신정,6688,5962,12650
202211,5호선,아차산,10434,10217,20651
202211,5호선,애오개,2809,2863,5672
202211,5호선,양평,2889,2859,5748
202211,5호선,여의나루,10634,13158,23792
202211,5호선,여의도,10867,10645,21512
202211,5호선,영등포구청,1567,1425,2992
202211,5호선,영등포시장,6656,7131,13787
202211,5호선,오금,1641,1506,3147
202211,5호선,오목교,11941,12309,24250
202211,5호선,올림픽공원,4647,3712,8359
202211,5호선,왕십리,2637,3141,5778
202211,5호선,우장산,7249,7362,14611
202211,5호선,을지로4가,2192,2216,4408
202211,5호선,장한평,8889,8791,17680
202211,5호선,종로3가,10945,9695,20640
202211,5호선,천호,13592,12575,26167
202211,5호선,청구,1937,1858,3795
202211,5호선,충정로,1673,1565,3238
202211,5호선,하남검단산,4868,4781,9649
202211,5호선,하남시청,4381,4349,8730
202211,5호선,하남풍산,2397,2340,4737
202211,5호선,행당,4356,3965,8321
202211,5호선,화곡,14908,14169,29077
202212,5호선,강동,14402,13819,28221
202212,5호선,강일,3555,3172,6727
202212,5호선,개롱,4318,4621,8939
202212,5호선,개화산,3896,3809,7705
202212,5호선,거여,6883,6384,13267
202212,5호선,고덕,6873,6458,13331
202212,5호선,공덕,8598,9155,17753
202212,5호선,광나루,11157,10441,21598
202212,5호선,광화문,19126,19169,38295
202212,5호선,군자,9020,10103,19123
202212,5호선,굽은다리,7493,7008,14501
202212,5호선,길동,6281,6434,12715
202212,5호선,김포공항,7418,7554,14972
202212,5호선,까치산,22247,20734,42981
202212,5호선,답십리,11249,10148,21397
202212,5호선,동대문역사문화공원,1406,1746,3152
202212,5호선,둔촌동,6810,6975,13785
202212,5호선,마곡,6033,6091,12124
202212,5호선,마장,4422,4248,8670
202212,5호선,마천,4990,5105,10095
202212,5호선,마포,9292,9422,18714
202212,5호선,명일,6438,6119,12557
202212,5호선,목동,11727,11668,23395
202212,5호선,미사,12962,12876,25838
202212,5호선,발산,16027,17517,33544
202212,5호선,방이,5705,5562,11267
202212,5호선,방화,4933,4658,9591
202212,5호선,상일동,9584,9079,18663
202212,5호선,서대문,8604,8313,16917
202212,5호선,송정,5268,5014,10282
202212,5호선,신금호,4378,4555,8933
202212,5호선,신길,2957,3014,5971
202212,5호선,신정,9545,8115,17660
202212,5호선,아차산,11912,11621,23533
202212,5호선,애오개,3849,3654,7503
202212,5호선,양평,3880,3610,7490
202212,5호선,여의나루,9580,13309,22889
202212,5호선,여의도,15382,16185,31567
202212,5호선,영등포구청,2792,2227,5019
202212,5호선,영등포시장,9916,10260,20176
202212,5호선,오금,2206,2018,4224
202212,5호선,오목교,16669,17322,33991
202212,5호선,올림픽공원,4937,4359,9296
202212,5호선,왕십리,3675,4592,8267
202212,5호선,우장산,10209,10095,20304
202212,5호선,을지로4가,3810,4318,8128
202212,5호선,장한평,12772,12547,25319
202212,5호선,종로3가,14701,15127,29828
202212,5호선,천호,17785,16923,34708
202212,5호선,청구,2555,2373,4928
202212,5호선,충정로,2103,1922,4025
202212,5호선,하남검단산,5700,5531,11231
202212,5호선,하남시청,5964,5663,11627
202212,5호선,하남풍산,2800,2872,5672
202212,5호선,행당,5803,5016,10819
202212,5호선,화곡,21121,19080,40201
202212,5호선,강동,9692,9572,19264
202212,5호선,강일,2653,2469,5122
202212,5호선,개롱,3068,3416,6484
202212,5호선,개화산,2767,2796,5563
202212,5호선,거여,4845,4717,9562
202212,5호선,고덕,4545,4491,9036
202212,5호선,공덕,5062,5173,10235
202212,5호선,광나루,7647,7487,15134
202212,5호선,광화문,12791,13109,25900
202212,5호선,군자,6463,7327,13790
202212,5호선,굽은다리,5743,5577,11320
202212,5호선,길동,4428,4482,8910
202212,5호선,김포공항,6861,6996,13857
202212,5호선,까치산,15970,15372,31342
202212,5호선,답십리,8279,7707,15986
202212,5호선,동대문역사문화공원,998,1138,2136
202212,5호선,둔촌동,5322,5316,10638
202212,5호선,마곡,3804,4002,7806
202212,5호선,마장,3186,3113,6299
202212,5호선,마천,3798,4058,7856
202212,5호선,마포,5521,5582,11103
202212,5호선,명일,5147,5230,10377
202212,5호선,목동,7914,8052,15966
202212,5호선,미사,8905,9156,18061
202212,5호선,발산,10655,10951,21606
202212,5호선,방이,4315,3995,8310
202212,5호선,방화,3516,3591,7107
202212,5호선,상일동,6480,6513,12993
202212,5호선,서대문,5924,5817,11741
202212,5호선,송정,3804,3762,7566
202212,5호선,신금호,2997,3314,6311
202212,5호선,신길,2042,2341,4383
202212,5호선,신정,6417,5782,12199
202212,5호선,아차산,9936,9618,19554
202212,5호선,애오개,2674,2785,5459
202212,5호선,양평,2916,2974,5890
202212,5호선,여의나루,7126,10208,17334
202212,5호선,여의도,11206,10798,22004
202212,5호선,영등포구청,1871,1510,3381
202212,5호선,영등포시장,6716,7159,13875
202212,5호선,오금,1619,1577,3196
202212,5호선,오목교,11325,11866,23191
202212,5호선,올림픽공원,3923,3697,7620
202212,5호선,왕십리,2704,3235,5939
202212,5호선,우장산,7035,7247,14282
202212,5호선,을지로4가,1728,1935,3663
202212,5호선,장한평,8857,8645,17502
202212,5호선,종로3가,10579,8920,19499
202212,5호선,천호,13406,12515,25921
202212,5호선,청구,1801,1801,3602
202212,5호선,충정로,1566,1660,3226
202212,5호선,하남검단산,4544,4561,9105
202212,5호선,하남시청,4506,4417,8923
202212,5호선,하남풍산,2589,2633,5222
202212,5호선,행당,4218,3920,8138
202212,5호선,화곡,14842,14059,28901
202212,5호선,강동,14925,14017,28942
202212,5호선,강일,3947,3406,7353
202212,5호선,개롱,4668,4762,9430
202212,5호선,개화산,4188,4047,8235
202212,5호선,거여,7152,6611,13763
202212,5호선,고덕,7243,6778,14021
202212,5호선,공덕,8974,9360,18334
202212,5호선,광나루,11456,10702,22158
202212,5호선,광화문,21470,22442,43912
202212,5호선,군자,9797,11149,20946
202212,5호선,굽은다리,7889,7262,15151
202212,5호선,길동,6481,6920,13401
202212,5호선,김포공항,7950,7751,15701
202212,5호선,까치산,23550,21932,45482
202212,5호선,답십리,11847,10613,22460
202212,5호선,동대문역사문화공원,1497,1844,3341
202212,5호선,둔촌동,7043,7136,14179
202212,5호선,마곡,6437,6443,12880
202212,5호선,마장,4995,4701,9696
202212,5호선,마천,5409,5404,10813
202212,5호선,마포,9545,9932,19477
202212,5호선,명일,7061,6792,13853
202212,5호선,목동,12587,12673,25260
202212,5호선,미사,13885,13750,27635
202212,5호선,발산,16791,18527,35318
202212,5호선,방이,6020,5955,11975
202212,5호선,방화,5082,4793,9875
202212,5호선,상일동,10267,9572,19839
202212,5호선,서대문,9243,8870,18113
202212,5호선,송정,5537,5145,10682
202212,5호선,신금호,4737,4776,9513
202212,5호선,신길,3188,3228,6416
202212,5호선,신정,9998,8481,18479
202212,5호선,아차산,13126,12386,25512
202212,5호선,애오개,4264,4048,8312
202212,5호선,양평,4185,3853,8038
202212,5호선,여의나루,10896,15557,26453
202212,5호선,여의도,16257,16593,32850
202212,5호선,영등포구청,2368,2244,4612
202212,5호선,영등포시장,10225,10921,21146
202212,5호선,오금,2384,2124,4508
202212,5호선,오목교,18313,18756,37069
202212,5호선,올림픽공원,4778,4490,9268
202212,5호선,왕십리,3797,4778,8575
202212,5호선,우장산,10982,10544,21526
202212,5호선,을지로4가,4312,4983,9295
202212,5호선,장한평,13081,12797,25878
202212,5호선,종로3가,16420,17041,33461
202212,5호선,천호,18753,18128,36881
202212,5호선,청구,2771,2621,5392
202212,5호선,충정로,2267,2168,4435
202212,5호선,하남검단산,6009,5730,11739
202212,5호선,하남시청,6776,6196,12972
202212,5호선,하남풍산,3212,3210,6422
202212,5호선,행당,6041,5251,11292
202212,5호선,화곡,22794,20463,43257
202212,5호선,강동,10211,10109,20320
202212,5호선,강일,2741,2638,5379
202212,5호선,개롱,3171,3425,6596
202212,5호선,개화산,2930,2849,5779
202212,5호선,거여,5062,4846,9908
202212,5호선,고덕,4395,4252,8647
202212,5호선,공덕,5594,5688,11282
202212,5호선,광나루,8759,8332,17091
202212,5호선,광화문,14425,14893,29318
202212,5호선,군자,6979,7801,14780
202212,5호선,굽은다리,5703,5399,11102
202212,5호선,길동,4571,4600,9171
202212,5호선,김포공항,6556,6725,13281
202212,5호선,까치산,16724,16408,33132
202212,5호선,답십리,8355,7712,16067
202212,5호선,동대문역사문화공원,1110,1299,2409
202212,5호선,둔촌동,5294,5332,10626
202212,5호선,마곡,4058,4238,8296
202212,5호선,마장,3435,3369,6804
202212,5호선,마천,3905,4271,8176
202212,5호선,마포,5822,5943,11765
202212,5호선,명일,5470,5354,10824
202212,5호선,목동,8557,8927,17484
202212,5호선,미사,9575,9642,19217
202212,5호선,발산,10655,11228,21883
202212,5호선,방이,4341,4191,8532
202212,5호선,방화,3891,3858,7749
202212,5호선,상일동,6870,6855,13725
202212,5호선,서대문,5772,5950,11722
202212,5호선,송정,3805,3827,7632
202212,5호선,신금호,3161,3492,6653
202212,5호선,신길,2113,2349,4462
202212,5호선,신정,6692,6133,12825
202212,5호선,아차산,10413,10267,20680
202212,5호선,애오개,2808,2888,5696
202212,5호선,양평,3122,3142,6264
202212,5호선,여의나루,9111,12073,21184
202212,5호선,여의도,10965,10937,21902
202212,5호선,영등포구청,1574,1535,3109
202212,5호선,영등포시장,6990,7377,14367
202212,5호선,오금,1667,1633,3300
202212,5호선,오목교,12313,12504,24817
202212,5호선,올림픽공원,4084,3780,7864
202212,5호선,왕십리,2762,3228,5990
202212,5호선,우장산,7461,7562,15023
202212,5호선,을지로4가,2055,2203,4258
202212,5호선,장한평,9147,9028,18175
202212,5호선,종로3가,11482,10189,21671
202212,5호선,천호,13741,13019,26760
202212,5호선,청구,1900,1836,3736
202212,5호선,충정로,1630,1586,3216
202212,5호선,하남검단산,4850,4774,9624
202212,5호선,하남시청,4594,4386,8980
202212,5호선,하남풍산,2709,2750,5459
202212,5호선,행당,4557,4083,8640
202212,5호선,화곡,15478,14599,30077
202212,5호선,강동,14960,13973,28933
202212,5호선,강일,3859,3246,7105
202212,5호선,개롱,4678,4887,9565
202212,5호선,개화산,4184,4018,8202
202212,5호선,거여,7354,6817,14171
202212,5호선,고덕,7110,6853,13963
202212,5호선,공덕,9184,9589,18773
202212,5호선,광나루,11479,10486,21965
202212,5호선,광화문,23638,24404,48042
202212,5호선,군자,9736,11237,20973
202212,5호선,굽은다리,8673,8302,16975
202212,5호선,길동,7054,7183,14237
202212,5호선,김포공항,8342,8567,16909
202212,5호선,까치산,23414,21576,44990
202212,5호선,답십리,11835,10867,22702
202212,5호선,동대문역사문화공원,1647,2122,3769
202212,5호선,둔촌동,7015,7223,14238
202212,5호선,마곡,6517,6673,13190
202212,5호선,마장,4821,4965,9786
202212,5호선,마천,5354,5336,10690
202212,5호선,마포,9993,10451,20444
202212,5호선,명일,6914,6890,13804
202212,5호선,목동,13047,13292,26339
202212,5호선,미사,13981,13846,27827
202212,5호선,발산,17166,18957,36123
202212,5호선,방이,5816,5810,11626
202212,5호선,방화,5154,4921,10075
202212,5호선,상일동,10696,10224,20920
202212,5호선,서대문,9509,9142,18651
202212,5호선,송정,5527,5254,10781
202212,5호선,신금호,4834,4874,9708
202212,5호선,신길,3173,3332,6505
202212,5호선,신정,10313,8719,19032
202212,5호선,아차산,12765,12098,24863
202212,5호선,애오개,4206,4091,8297
202212,5호선,양평,4223,3930,8153
202212,5호선,여의나루,9405,14873,24278
202212,5호선,여의도,18100,17650,35750
202212,5호선,영등포구청,2370,2284,4654
202212,5호선,영등포시장,10740,11502,22242
202212,5호선,오금,2275,2148,4423
202212,5호선,오목교,18602,19303,37905
202212,5호선,올림픽공원,5762,4839,10601
202212,5호선,왕십리,4057,5243,9300
202212,5호선,우장산,11245,11078,22323
202212,5호선,을지로4가,3718,4396,8114
202212,5호선,장한평,13477,13129,26606
202212,5호선,종로3가,16668,16741,33409
202212,5호선,천호,19285,18144,37429
202212,5호선,청구,2759,2611,5370
202212,5호선,충정로,2311,2177,4488
202212,5호선,하남검단산,5937,5709,11646
202212,5호선,하남시청,6589,6212,12801
202212,5호선,하남풍산,3192,3192,6384
202212,5호선,행당,6203,5367,11570
202212,5호선,화곡,23280,20849,44129
202212,5호선,강동,9680,9595,19275
202212,5호선,강일,2505,2276,4781
202212,5호선,개롱,2838,3115,5953
202212,5호선,개화산,2773,2716,5489
202212,5호선,거여,4639,4511,9150
202212,5호선,고덕,4287,4452,8739
202212,5호선,공덕,5267,5528,10795
202212,5호선,광나루,7657,7165,14822
202212,5호선,광화문,13357,13508,26865
202212,5호선,군자,6514,7384,13898
202212,5호선,굽은다리,6170,5924,12094
202212,5호선,길동,4534,4591,9125
202212,5호선,김포공항,6865,7282,14147
202212,5호선,까치산,15893,15400,31293
202212,5호선,답십리,8118,7623,15741
202212,5호선,동대문역사문화공원,1209,1318,2527
202212,5호선,둔촌동,4961,5052,10013
202212,5호선,마곡,4042,4144,8186
202212,5호선,마장,3112,3119,6231
202212,5호선,마천,3595,3809,7404
202212,5호선,마포,5643,5701,11344
202212,5호선,명일,4973,5009,9982
202212,5호선,목동,8035,8325,16360
202212,5호선,미사,9092,9224,18316
202212,5호선,발산,10432,10977,21409
202212,5호선,방이,3925,3708,7633
202212,5호선,방화,3446,3591,7037
202212,5호선,상일동,6445,6635,13080
202212,5호선,서대문,5403,5323,10726
202212,5호선,송정,3923,3723,7646
202212,5호선,신금호,2981,3184,6165
202212,5호선,신길,2213,2457,4670
202212,5호선,신정,6576,5936,12512
202212,5호선,아차산,8688,8736,17424
202212,5호선,애오개,2623,2763,5386
202212,5호선,양평,2736,2913,5649
202212,5호선,여의나루,7060,10718,17778
202212,5호선,여의도,12074,11374,23448
202212,5호선,영등포구청,1579,1459,3038
202212,5호선,영등포시장,6714,6932,13646
202212,5호선,오금,1574,1531,3105
202212,5호선,오목교,12209,12416,24625
202212,5호선,올림픽공원,3175,2925,6100
202212,5호선,왕십리,2645,3350,5995
202212,5호선,우장산,7050,7142,14192
202212,5호선,을지로4가,1838,1965,3803
202212,5호선,장한평,8696,8673,17369
202212,5호선,종로3가,10575,9144,19719
202212,5호선,천호,13576,12482,26058
202212,5호선,청구,1819,1790,3609
202212,5호선,충정로,1706,1680,3386
202212,5호선,하남검단산,4440,4378,8818
202212,5호선,하남시청,4194,4109,8303
202212,5호선,하남풍산,2825,2860,5685
202212,5호선,행당,4048,3677,7725
202212,5호선,화곡,15213,14297,29510
202212,5호선,강동,12526,11662,24188
202212,5호선,강일,3412,2870,6282
202212,5호선,개롱,3779,3960,7739
202212,5호선,개화산,3640,3483,7123
202212,5호선,거여,6163,5686,11849
202212,5호선,고덕,6729,6483,13212
202212,5호선,공덕,6836,7020,13856
202212,5호선,광나루,9328,8657,17985
202212,5호선,광화문,29171,28246,57417
202212,5호선,군자,8639,9616,18255
202212,5호선,굽은다리,7820,7411,15231
202212,5호선,길동,6229,6508,12737
202212,5호선,김포공항,8839,8700,17539
202212,5호선,까치산,20989,19801,40790
202212,5호선,답십리,10620,9641,20261
202212,5호선,동대문역사문화공원,1607,1960,3567
202212,5호선,둔촌동,6186,6155,12341
202212,5호선,마곡,5731,5859,11590
202212,5호선,마장,4130,3885,8015
202212,5호선,마천,4433,4414,8847
202212,5호선,마포,7818,8133,15951
202212,5호선,명일,5908,5742,11650
202212,5호선,목동,10520,10390,20910
202212,5호선,미사,12516,12721,25237
202212,5호선,발산,14557,15991,30548
202212,5호선,방이,4880,5032,9912
202212,5호선,방화,4386,4227,8613
202212,5호선,상일동,9117,8700,17817
202212,5호선,서대문,7370,6851,14221
202212,5호선,송정,4941,4567,9508
202212,5호선,신금호,4223,4244,8467
202212,5호선,신길,2951,2970,5921
202212,5호선,신정,9018,7552,16570
202212,5호선,아차산,11539,10991,22530
202212,5호선,애오개,3767,3587,7354
202212,5호선,양평,3784,3486,7270
202212,5호선,여의나루,10723,15959,26682
202212,5호선,여의도,16449,15426,31875
202212,5호선,영등포구청,1924,1908,3832
202212,5호선,영등포시장,8768,9120,17888
202212,5호선,오금,1931,1786,3717
202212,5호선,오목교,16386,17218,33604
202212,5호선,올림픽공원,3673,3883,7556
202212,5호선,왕십리,3705,4556,8261
202212,5호선,우장산,9875,9492,19367
202212,5호선,을지로4가,3671,4234,7905
202212,5호선,장한평,11697,11581,23278
202212,5호선,종로3가,14566,14772,29338
202212,5호선,천호,18006,16901,34907
202212,5호선,청구,2498,2355,4853
202212,5호선,충정로,1924,1867,3791
202212,5호선,하남검단산,5893,5673,11566
202212,5호선,하남시청,5892,5533,11425
202212,5호선,하남풍산,2860,2863,5723
202212,5호선,행당,5335,4458,9793
202212,5호선,화곡,20854,18796,39650
202212,5호선,강동,8765,8447,17212
202212,5호선,강일,2588,2377,4965
202212,5호선,개롱,2900,3124,6024
202212,5호선,개화산,2783,2708,5491
202212,5호선,거여,4638,4565,9203
202212,5호선,고덕,4835,4724,9559
202212,5호선,공덕,4792,4807,9599
202212,5호선,광나루,7565,7231,14796
202212,5호선,광화문,24099,22495,46594
202212,5호선,군자,6857,7495,14352
202212,5호선,굽은다리,6064,5834,11898
202212,5호선,길동,4579,4562,9141
202212,5호선,김포공항,7359,7086,14445
202212,5호선,까치산,16532,16102,32634
202212,5호선,답십리,8189,7752,15941
202212,5호선,동대문역사문화공원,1295,1522,2817
202212,5호선,둔촌동,4921,5009,9930
202212,5호선,마곡,3983,4186,8169
202212,5호선,마장,3183,3123,6306
202212,5호선,마천,3690,3758,7448
202212,5호선,마포,5330,5515,10845
202212,5호선,명일,5322,5283,10605
202212,5호선,목동,7659,7912,15571
202212,5호선,미사,10108,10092,20200
202212,5호선,발산,11001,11880,22881
202212,5호선,방이,4019,3806,7825
202212,5호선,방화,3598,3548,7146
202212,5호선,상일동,6604,6606,13210
202212,5호선,서대문,4948,4882,9830
202212,5호선,송정,3801,3727,7528
202212,5호선,신금호,3049,3327,6376
202212,5호선,신길,2215,2499,4714
202212,5호선,신정,6603,6097,12700
202212,5호선,아차산,9361,9220,18581
202212,5호선,애오개,2602,2711,5313
202212,5호선,양평,2828,2808,5636
202212,5호선,여의나루,12838,17869,30707
202212,5호선,여의도,13496,11892,25388
202212,5호선,영등포구청,1352,1196,2548
202212,5호선,영등포시장,6420,6629,13049
202212,5호선,오금,1454,1449,2903
202212,5호선,오목교,12329,12527,24856
202212,5호선,올림픽공원,2988,2126,5114
202212,5호선,왕십리,2867,3324,6191
202212,5호선,우장산,7276,7430,14706
202212,5호선,을지로4가,2135,2519,4654
202212,5호선,장한평,8666,8673,17339
202212,5호선,종로3가,13493,11952,25445
202212,5호선,천호,13888,12832,26720
202212,5호선,청구,1879,1798,3677
202212,5호선,충정로,1584,1516,3100
202212,5호선,하남검단산,5533,5360,10893
202212,5호선,하남시청,4601,4247,8848
202212,5호선,하남풍산,2725,2785,5510
202212,5호선,행당,4366,3976,8342
202212,5호선,화곡,15896,14850,30746
202212,5호선,강동,10710,9946,20656
202212,5호선,강일,3358,2804,6162
202212,5호선,개롱,3822,3948,7770
202212,5호선,개화산,3584,3420,7004
202212,5호선,거여,5878,5411,11289
202212,5호선,고덕,6006,5708,11714
202212,5호선,공덕,6367,6558,12925
202212,5호선,광나루,9299,9218,18517
202212,5호선,광화문,28365,26608,54973
202212,5호선,군자,7831,8620,16451
202212,5호선,굽은다리,7408,6803,14211
202212,5호선,길동,5955,5982,11937
202212,5호선,김포공항,7242,7176,14418
202212,5호선,까치산,20428,18712,39140
202212,5호선,답십리,9962,8917,18879
202212,5호선,동대문역사문화공원,1336,1672,3008
202212,5호선,둔촌동,5656,5703,11359
202212,5호선,마곡,4977,5054,10031
202212,5호선,마장,3995,3825,7820
202212,5호선,마천,4408,4426,8834
202212,5호선,마포,7215,7219,14434
202212,5호선,명일,5540,5429,10969
202212,5호선,목동,10121,10083,20204
202212,5호선,미사,11666,12101,23767
202212,5호선,발산,12065,13642,25707
202212,5호선,방이,4986,4748,9734
202212,5호선,방화,4288,4049,8337
202212,5호선,상일동,8531,7977,16508
202212,5호선,서대문,7329,6591,13920
202212,5호선,송정,4795,4608,9403
202212,5호선,신금호,3965,4050,8015
202212,5호선,신길,2638,2702,5340
202212,5호선,신정,8482,6949,15431
202212,5호선,아차산,11344,10690,22034
202212,5호선,애오개,3480,3385,6865
202212,5호선,양평,3464,3114,6578
202212,5호선,여의나루,7585,10060,17645
202212,5호선,여의도,10997,11316,22313
202212,5호선,영등포구청,1806,1765,3571
202212,5호선,영등포시장,6998,7210,14208
202212,5호선,오금,1790,1678,3468
202212,5호선,오목교,14531,15375,29906
202212,5호선,올림픽공원,4594,4353,8947
202212,5호선,왕십리,3183,4091,7274
202212,5호선,우장산,9106,8812,17918
202212,5호선,을지로4가,3516,4107,7623
202212,5호선,장한평,11263,10844,22107
202212,5호선,종로3가,13951,13584,27535
202212,5호선,천호,16129,15289,31418
202212,5호선,청구,2333,2130,4463
202212,5호선,충정로,1773,1529,3302
202212,5호선,하남검단산,5360,5163,10523
202212,5호선,하남시청,5633,5134,10767
202212,5호선,하남풍산,2934,3078,6012
202212,5호선,행당,5009,4297,9306
202212,5호선,화곡,19414,17342,36756
