사용일자,호선명,지하철역,승차총승객수,하차총승객수,승하차총승객수,lat,lng
20210102,2호선,강남,26955,26265,53220,37.4981646510326,127.028307900881
20210102,2호선,강변,12457,11820,24277,37.5351692767888,127.094664569096
20210102,2호선,건대입구,15666,17068,32734,37.5404188872176,127.069173281554
20210102,2호선,교대,8040,8768,16808,37.4928178646055,127.013838469407
20210102,2호선,구로디지털단지,18136,18446,36582,37.4853149237865,126.901494378412
20210102,2호선,구의,8669,8867,17536,37.5371535596228,127.086179228767
20210102,2호선,낙성대,10747,11155,21902,37.4770651843603,126.963409959152
20210102,2호선,당산,6059,6629,12688,37.534956866618,126.90273071003
20210102,2호선,대림,10276,10898,21174,37.4933105886136,126.8949461878
20210102,2호선,도림천,507,483,990,37.5144420510515,126.882702584468
20210102,2호선,동대문역사문화공원,4256,4473,8729,37.5655895229776,127.009131498424
20210102,2호선,뚝섬,4932,5257,10189,37.5471882244091,127.047365178682
20210102,2호선,문래,5148,5313,10461,37.5179214637526,126.894763060556
20210102,2호선,방배,4810,4931,9741,37.4814364876589,126.997694899327
20210102,2호선,봉천,9611,9380,18991,37.4825562153548,126.941495272047
20210102,2호선,사당,14117,15073,29190,37.4765228347619,126.981408909449
20210102,2호선,삼성,13175,12988,26163,37.5088619974404,127.063073009788
20210102,2호선,상왕십리,4956,4992,9948,37.5644687111181,127.029031221392
20210102,2호선,서울대입구,18722,19228,37950,37.4811526631844,126.952645104944
20210102,2호선,서초,4473,4038,8511,37.4918229990093,127.007580814715
20210102,2호선,선릉,10750,9807,20557,37.5045028775835,127.048942471228
20210102,2호선,성수,6548,7352,13900,37.5445023983984,127.056090471223
20210102,2호선,시청,2943,2279,5222,37.5654385176408,126.976983237511
20210102,2호선,신답,488,533,1021,37.5699910562183,127.046820203556
20210102,2호선,신당,5940,6298,12238,37.5656540317328,127.019540574485
20210102,2호선,신대방,11219,11226,22445,37.4875759745635,126.913175585996
20210102,2호선,신도림,19930,19642,39572,37.5087701449787,126.891080501385
20210102,2호선,신림,27580,27810,55390,37.4841196518392,126.928712092948
20210102,2호선,신설동,1796,1811,3607,37.5762451837487,127.023278761358
20210102,2호선,신정네거리,3761,3983,7744,37.5197975266787,126.852991645059
20210102,2호선,신촌,14068,14358,28426,37.5554417865984,126.936119192554
20210102,2호선,아현,3866,3895,7761,37.5573575723061,126.95603374504
20210102,2호선,양천구청,2197,2320,4517,37.5126989358446,126.866065211751
20210102,2호선,역삼,8861,9540,18401,37.5007162693593,127.036618203089
20210102,2호선,영등포구청,6282,6530,12812,37.5256996614804,126.896626898379
20210102,2호선,왕십리,6261,5295,11556,37.5612217415191,127.036655378283
20210102,2호선,용답,1173,1123,2296,37.5620049052662,127.050729309179
20210102,2호선,용두,901,988,1889,37.5739380503267,127.038031119837
20210102,2호선,을지로3가,3833,3671,7504,37.56626594615,126.990308356253
20210102,2호선,을지로4가,3295,3308,6603,37.5666369941572,126.997852780281
20210102,2호선,을지로입구,11279,10899,22178,37.5660509513873,126.982372901787
20210102,2호선,이대,4202,4544,8746,37.5567980142044,126.945758201019
20210102,2호선,잠실,28358,26540,54898,37.513859279255,127.101857941447
20210102,2호선,잠실나루,3707,3690,7397,37.5206867318088,127.103811089444
20210102,2호선,잠실새내,8364,8828,17192,37.5115672093323,127.086373867207
20210102,2호선,종합운동장,2158,2216,4374,37.5109692748993,127.073356018706
20210102,2호선,충정로,2610,2624,5234,37.5598377952439,126.964474043785
20210102,2호선,한양대,1475,1506,2981,37.55557788354,127.043584493543
20210102,2호선,합정,11062,11761,22823,37.5501152068908,126.914638180431
20210102,2호선,홍대입구,22086,23077,45163,37.5577458058734,126.926498328277
20210103,2호선,강남,15585,14888,30473,37.4981646510326,127.028307900881
20210103,2호선,강변,12926,10948,23874,37.5351692767888,127.094664569096
20210103,2호선,건대입구,12637,13651,26288,37.5404188872176,127.069173281554
20210103,2호선,교대,5078,5658,10736,37.4928178646055,127.013838469407
20210103,2호선,구로디지털단지,13608,13914,27522,37.4853149237865,126.901494378412
20210103,2호선,구의,6602,6820,13422,37.5371535596228,127.086179228767
20210103,2호선,낙성대,8457,9615,18072,37.4770651843603,126.963409959152
20210103,2호선,당산,4490,4848,9338,37.534956866618,126.90273071003
20210103,2호선,대림,8910,8812,17722,37.4933105886136,126.8949461878
20210103,2호선,도림천,278,291,569,37.5144420510515,126.882702584468
20210103,2호선,동대문역사문화공원,3603,4537,8140,37.5655895229776,127.009131498424
20210103,2호선,뚝섬,3684,3942,7626,37.5471882244091,127.047365178682
20210103,2호선,문래,3675,3942,7617,37.5179214637526,126.894763060556
20210103,2호선,방배,3381,3670,7051,37.4814364876589,126.997694899327
20210103,2호선,봉천,7086,7396,14482,37.4825562153548,126.941495272047
20210103,2호선,사당,10723,11707,22430,37.4765228347619,126.981408909449
20210103,2호선,삼성,9945,9651,19596,37.5088619974404,127.063073009788
20210103,2호선,상왕십리,3770,3939,7709,37.5644687111181,127.029031221392
20210103,2호선,서울대입구,14441,15858,30299,37.4811526631844,126.952645104944
20210103,2호선,서초,3492,3270,6762,37.4918229990093,127.007580814715
20210103,2호선,선릉,6908,6282,13190,37.5045028775835,127.048942471228
20210103,2호선,성수,4985,5691,10676,37.5445023983984,127.056090471223
20210103,2호선,시청,2120,1741,3861,37.5654385176408,126.976983237511
20210103,2호선,신답,370,425,795,37.5699910562183,127.046820203556
20210103,2호선,신당,4685,5114,9799,37.5656540317328,127.019540574485
20210103,2호선,신대방,8972,9058,18030,37.4875759745635,126.913175585996
20210103,2호선,신도림,14572,14507,29079,37.5087701449787,126.891080501385
20210103,2호선,신림,21370,22647,44017,37.4841196518392,126.928712092948
20210103,2호선,신설동,1742,1890,3632,37.5762451837487,127.023278761358
20210103,2호선,신정네거리,2808,2686,5494,37.5197975266787,126.852991645059
20210103,2호선,신촌,10446,10634,21080,37.5554417865984,126.936119192554
20210103,2호선,아현,2899,3009,5908,37.5573575723061,126.95603374504
20210103,2호선,양천구청,1736,1750,3486,37.5126989358446,126.866065211751
20210103,2호선,역삼,6076,6918,12994,37.5007162693593,127.036618203089
20210103,2호선,영등포구청,4462,4879,9341,37.5256996614804,126.896626898379
20210103,2호선,왕십리,4662,4086,8748,37.5612217415191,127.036655378283
20210103,2호선,용답,950,1029,1979,37.5620049052662,127.050729309179
20210103,2호선,용두,681,748,1429,37.5739380503267,127.038031119837
20210103,2호선,을지로3가,2683,2471,5154,37.56626594615,126.990308356253
20210103,2호선,을지로4가,1508,1444,2952,37.5666369941572,126.997852780281
20210103,2호선,을지로입구,8792,8473,17265,37.5660509513873,126.982372901787
20210103,2호선,이대,3050,3484,6534,37.5567980142044,126.945758201019
20210103,2호선,잠실,22484,21105,43589,37.513859279255,127.101857941447
20210103,2호선,잠실나루,2637,2785,5422,37.5206867318088,127.103811089444
20210103,2호선,잠실새내,5613,5982,11595,37.5115672093323,127.086373867207
20210103,2호선,종합운동장,1635,1846,3481,37.5109692748993,127.073356018706
20210103,2호선,충정로,2018,2117,4135,37.5598377952439,126.964474043785
20210103,2호선,한양대,1171,1361,2532,37.55557788354,127.043584493543
20210103,2호선,합정,8798,9002,17800,37.5501152068908,126.914638180431
20210103,2호선,홍대입구,17297,17265,34562,37.5577458058734,126.926498328277
20210109,2호선,강남,36597,35527,72124,37.4981646510326,127.028307900881
20210109,2호선,강변,14590,14675,29265,37.5351692767888,127.094664569096
20210109,2호선,건대입구,19175,20984,40159,37.5404188872176,127.069173281554
20210109,2호선,교대,11005,12060,23065,37.4928178646055,127.013838469407
20210109,2호선,구로디지털단지,23215,23597,46812,37.4853149237865,126.901494378412
20210109,2호선,구의,11171,11265,22436,37.5371535596228,127.086179228767
20210109,2호선,낙성대,14298,13590,27888,37.4770651843603,126.963409959152
20210109,2호선,당산,7268,8070,15338,37.534956866618,126.90273071003
20210109,2호선,대림,12001,12852,24853,37.4933105886136,126.8949461878
20210109,2호선,도림천,686,656,1342,37.5144420510515,126.882702584468
20210109,2호선,동대문역사문화공원,5569,5751,11320,37.5655895229776,127.009131498424
20210109,2호선,뚝섬,6554,6738,13292,37.5471882244091,127.047365178682
20210109,2호선,문래,7311,7493,14804,37.5179214637526,126.894763060556
20210109,2호선,방배,6461,6640,13101,37.4814364876589,126.997694899327
20210109,2호선,봉천,12101,11561,23662,37.4825562153548,126.941495272047
20210109,2호선,사당,17801,18888,36689,37.4765228347619,126.981408909449
20210109,2호선,삼성,18302,18113,36415,37.5088619974404,127.063073009788
20210109,2호선,상왕십리,6368,6105,12473,37.5644687111181,127.029031221392
20210109,2호선,서울대입구,24782,23907,48689,37.4811526631844,126.952645104944
20210109,2호선,서초,6089,5511,11600,37.4918229990093,127.007580814715
20210109,2호선,선릉,15665,14007,29672,37.5045028775835,127.048942471228
20210109,2호선,성수,9338,10213,19551,37.5445023983984,127.056090471223
20210109,2호선,시청,3740,3266,7006,37.5654385176408,126.976983237511
20210109,2호선,신답,603,668,1271,37.5699910562183,127.046820203556
20210109,2호선,신당,7195,7357,14552,37.5656540317328,127.019540574485
20210109,2호선,신대방,13475,13401,26876,37.4875759745635,126.913175585996
20210109,2호선,신도림,25220,25470,50690,37.5087701449787,126.891080501385
20210109,2호선,신림,35077,34224,69301,37.4841196518392,126.928712092948
20210109,2호선,신설동,2119,1956,4075,37.5762451837487,127.023278761358
20210109,2호선,신정네거리,4491,4718,9209,37.5197975266787,126.852991645059
20210109,2호선,신촌,18366,18536,36902,37.5554417865984,126.936119192554
20210109,2호선,아현,4843,4757,9600,37.5573575723061,126.95603374504
20210109,2호선,양천구청,2765,2959,5724,37.5126989358446,126.866065211751
20210109,2호선,역삼,13663,14337,28000,37.5007162693593,127.036618203089
20210109,2호선,영등포구청,8367,8590,16957,37.5256996614804,126.896626898379
20210109,2호선,왕십리,8790,7365,16155,37.5612217415191,127.036655378283
20210109,2호선,용답,1395,1308,2703,37.5620049052662,127.050729309179
20210109,2호선,용두,1131,1106,2237,37.5739380503267,127.038031119837
20210109,2호선,을지로3가,5270,5208,10478,37.56626594615,126.990308356253
20210109,2호선,을지로4가,4848,4813,9661,37.5666369941572,126.997852780281
20210109,2호선,을지로입구,13031,13002,26033,37.5660509513873,126.982372901787
20210109,2호선,이대,5859,5923,11782,37.5567980142044,126.945758201019
20210109,2호선,잠실,35370,34201,69571,37.513859279255,127.101857941447
20210109,2호선,잠실나루,4631,4478,9109,37.5206867318088,127.103811089444
20210109,2호선,잠실새내,10943,11288,22231,37.5115672093323,127.086373867207
20210109,2호선,종합운동장,2604,2778,5382,37.5109692748993,127.073356018706
20210109,2호선,충정로,3544,3646,7190,37.5598377952439,126.964474043785
20210109,2호선,한양대,2734,2725,5459,37.55557788354,127.043584493543
20210109,2호선,합정,14700,15157,29857,37.5501152068908,126.914638180431
20210109,2호선,홍대입구,28225,29239,57464,37.5577458058734,126.926498328277
20210110,2호선,강남,17351,16793,34144,37.4981646510326,127.028307900881
20210110,2호선,강변,11181,11111,22292,37.5351692767888,127.094664569096
20210110,2호선,건대입구,14025,14833,28858,37.5404188872176,127.069173281554
20210110,2호선,교대,5905,6568,12473,37.4928178646055,127.013838469407
20210110,2호선,구로디지털단지,14857,14606,29463,37.4853149237865,126.901494378412
20210110,2호선,구의,7214,7361,14575,37.5371535596228,127.086179228767
20210110,2호선,낙성대,9578,9799,19377,37.4770651843603,126.963409959152
20210110,2호선,당산,4915,5302,10217,37.534956866618,126.90273071003
20210110,2호선,대림,9403,9330,18733,37.4933105886136,126.8949461878
20210110,2호선,도림천,314,304,618,37.5144420510515,126.882702584468
20210110,2호선,동대문역사문화공원,4167,5171,9338,37.5655895229776,127.009131498424
20210110,2호선,뚝섬,4407,4478,8885,37.5471882244091,127.047365178682
20210110,2호선,문래,3870,4086,7956,37.5179214637526,126.894763060556
20210110,2호선,방배,3907,4211,8118,37.4814364876589,126.997694899327
20210110,2호선,봉천,7943,7841,15784,37.4825562153548,126.941495272047
20210110,2호선,사당,11467,12736,24203,37.4765228347619,126.981408909449
20210110,2호선,삼성,12179,11868,24047,37.5088619974404,127.063073009788
20210110,2호선,상왕십리,4128,4090,8218,37.5644687111181,127.029031221392
20210110,2호선,서울대입구,16483,16693,33176,37.4811526631844,126.952645104944
20210110,2호선,서초,3591,3318,6909,37.4918229990093,127.007580814715
20210110,2호선,선릉,8310,7174,15484,37.5045028775835,127.048942471228
20210110,2호선,성수,5572,6036,11608,37.5445023983984,127.056090471223
20210110,2호선,시청,2474,1960,4434,37.5654385176408,126.976983237511
20210110,2호선,신답,383,421,804,37.5699910562183,127.046820203556
20210110,2호선,신당,5072,5279,10351,37.5656540317328,127.019540574485
20210110,2호선,신대방,9748,9337,19085,37.4875759745635,126.913175585996
20210110,2호선,신도림,16492,16363,32855,37.5087701449787,126.891080501385
20210110,2호선,신림,23886,23482,47368,37.4841196518392,126.928712092948
20210110,2호선,신설동,1737,1768,3505,37.5762451837487,127.023278761358
20210110,2호선,신정네거리,2847,2896,5743,37.5197975266787,126.852991645059
20210110,2호선,신촌,12334,11965,24299,37.5554417865984,126.936119192554
20210110,2호선,아현,3033,3090,6123,37.5573575723061,126.95603374504
20210110,2호선,양천구청,1770,1854,3624,37.5126989358446,126.866065211751
20210110,2호선,역삼,7045,7794,14839,37.5007162693593,127.036618203089
20210110,2호선,영등포구청,4910,4903,9813,37.5256996614804,126.896626898379
20210110,2호선,왕십리,5598,4955,10553,37.5612217415191,127.036655378283
20210110,2호선,용답,1042,1104,2146,37.5620049052662,127.050729309179
20210110,2호선,용두,679,664,1343,37.5739380503267,127.038031119837
20210110,2호선,을지로3가,3377,2991,6368,37.56626594615,126.990308356253
20210110,2호선,을지로4가,1759,1664,3423,37.5666369941572,126.997852780281
20210110,2호선,을지로입구,9868,9566,19434,37.5660509513873,126.982372901787
20210110,2호선,이대,3650,3871,7521,37.5567980142044,126.945758201019
20210110,2호선,잠실,24208,23250,47458,37.513859279255,127.101857941447
20210110,2호선,잠실나루,2868,2999,5867,37.5206867318088,127.103811089444
20210110,2호선,잠실새내,6410,6788,13198,37.5115672093323,127.086373867207
20210110,2호선,종합운동장,1713,1821,3534,37.5109692748993,127.073356018706
20210110,2호선,충정로,2316,2393,4709,37.5598377952439,126.964474043785
20210110,2호선,한양대,4616,4035,8651,37.55557788354,127.043584493543
20210110,2호선,합정,10019,10182,20201,37.5501152068908,126.914638180431
20210110,2호선,홍대입구,20726,20287,41013,37.5577458058734,126.926498328277
20210116,2호선,강남,40353,39736,80089,37.4981646510326,127.028307900881
20210116,2호선,강변,16861,17274,34135,37.5351692767888,127.094664569096
20210116,2호선,건대입구,22665,24503,47168,37.5404188872176,127.069173281554
20210116,2호선,교대,12072,13097,25169,37.4928178646055,127.013838469407
20210116,2호선,구로디지털단지,26077,26266,52343,37.4853149237865,126.901494378412
20210116,2호선,구의,12330,12306,24636,37.5371535596228,127.086179228767
20210116,2호선,낙성대,16066,15383,31449,37.4770651843603,126.963409959152
20210116,2호선,당산,8790,9540,18330,37.534956866618,126.90273071003
20210116,2호선,대림,13932,15010,28942,37.4933105886136,126.8949461878
20210116,2호선,도림천,686,681,1367,37.5144420510515,126.882702584468
20210116,2호선,동대문역사문화공원,6746,7112,13858,37.5655895229776,127.009131498424
20210116,2호선,뚝섬,7326,7811,15137,37.5471882244091,127.047365178682
20210116,2호선,문래,8076,8332,16408,37.5179214637526,126.894763060556
20210116,2호선,방배,7435,7674,15109,37.4814364876589,126.997694899327
20210116,2호선,봉천,13240,12487,25727,37.4825562153548,126.941495272047
20210116,2호선,사당,19741,21643,41384,37.4765228347619,126.981408909449
20210116,2호선,삼성,19054,18846,37900,37.5088619974404,127.063073009788
20210116,2호선,상왕십리,7105,6846,13951,37.5644687111181,127.029031221392
20210116,2호선,서울대입구,27892,27010,54902,37.4811526631844,126.952645104944
20210116,2호선,서초,6781,6095,12876,37.4918229990093,127.007580814715
20210116,2호선,선릉,17347,15251,32598,37.5045028775835,127.048942471228
20210116,2호선,성수,10701,11559,22260,37.5445023983984,127.056090471223
20210116,2호선,시청,5338,4594,9932,37.5654385176408,126.976983237511
20210116,2호선,신답,643,755,1398,37.5699910562183,127.046820203556
20210116,2호선,신당,8298,8521,16819,37.5656540317328,127.019540574485
20210116,2호선,신대방,14915,14833,29748,37.4875759745635,126.913175585996
20210116,2호선,신도림,28644,28212,56856,37.5087701449787,126.891080501385
20210116,2호선,신림,38116,37059,75175,37.4841196518392,126.928712092948
20210116,2호선,신설동,2548,2443,4991,37.5762451837487,127.023278761358
20210116,2호선,신정네거리,5130,5433,10563,37.5197975266787,126.852991645059
20210116,2호선,신촌,21658,21195,42853,37.5554417865984,126.936119192554
20210116,2호선,아현,5495,5409,10904,37.5573575723061,126.95603374504
20210116,2호선,양천구청,3053,3259,6312,37.5126989358446,126.866065211751
20210116,2호선,역삼,14263,15158,29421,37.5007162693593,127.036618203089
20210116,2호선,영등포구청,9231,9314,18545,37.5256996614804,126.896626898379
20210116,2호선,왕십리,9363,7932,17295,37.5612217415191,127.036655378283
20210116,2호선,용답,1562,1496,3058,37.5620049052662,127.050729309179
20210116,2호선,용두,1417,1435,2852,37.5739380503267,127.038031119837
20210116,2호선,을지로3가,6165,6093,12258,37.56626594615,126.990308356253
20210116,2호선,을지로4가,6196,6297,12493,37.5666369941572,126.997852780281
20210116,2호선,을지로입구,14577,14347,28924,37.5660509513873,126.982372901787
20210116,2호선,이대,6820,6931,13751,37.5567980142044,126.945758201019
20210116,2호선,잠실,39752,37982,77734,37.513859279255,127.101857941447
20210116,2호선,잠실나루,5149,4976,10125,37.5206867318088,127.103811089444
20210116,2호선,잠실새내,11731,12214,23945,37.5115672093323,127.086373867207
20210116,2호선,종합운동장,2875,3015,5890,37.5109692748993,127.073356018706
20210116,2호선,충정로,4081,4149,8230,37.5598377952439,126.964474043785
20210116,2호선,한양대,2566,2436,5002,37.55557788354,127.043584493543
20210116,2호선,합정,17269,18041,35310,37.5501152068908,126.914638180431
20210116,2호선,홍대입구,34850,36369,71219,37.5577458058734,126.926498328277
20210117,2호선,강남,20856,19654,40510,37.4981646510326,127.028307900881
20210117,2호선,강변,13763,12873,26636,37.5351692767888,127.094664569096
20210117,2호선,건대입구,16249,17196,33445,37.5404188872176,127.069173281554
20210117,2호선,교대,6669,7248,13917,37.4928178646055,127.013838469407
20210117,2호선,구로디지털단지,16481,16494,32975,37.4853149237865,126.901494378412
20210117,2호선,구의,7769,8083,15852,37.5371535596228,127.086179228767
20210117,2호선,낙성대,10526,10918,21444,37.4770651843603,126.963409959152
20210117,2호선,당산,5616,5954,11570,37.534956866618,126.90273071003
20210117,2호선,대림,10065,10316,20381,37.4933105886136,126.8949461878
20210117,2호선,도림천,324,346,670,37.5144420510515,126.882702584468
20210117,2호선,동대문역사문화공원,4521,5578,10099,37.5655895229776,127.009131498424
20210117,2호선,뚝섬,4782,4934,9716,37.5471882244091,127.047365178682
20210117,2호선,문래,4709,4872,9581,37.5179214637526,126.894763060556
20210117,2호선,방배,4220,4623,8843,37.4814364876589,126.997694899327
20210117,2호선,봉천,8494,8435,16929,37.4825562153548,126.941495272047
20210117,2호선,사당,13388,14539,27927,37.4765228347619,126.981408909449
20210117,2호선,삼성,13196,12554,25750,37.5088619974404,127.063073009788
20210117,2호선,상왕십리,4489,4568,9057,37.5644687111181,127.029031221392
20210117,2호선,서울대입구,18229,18908,37137,37.4811526631844,126.952645104944
20210117,2호선,서초,4260,3848,8108,37.4918229990093,127.007580814715
20210117,2호선,선릉,8964,7776,16740,37.5045028775835,127.048942471228
20210117,2호선,성수,6638,7147,13785,37.5445023983984,127.056090471223
20210117,2호선,시청,3246,2677,5923,37.5654385176408,126.976983237511
20210117,2호선,신답,431,515,946,37.5699910562183,127.046820203556
20210117,2호선,신당,5450,5890,11340,37.5656540317328,127.019540574485
20210117,2호선,신대방,10445,10397,20842,37.4875759745635,126.913175585996
20210117,2호선,신도림,18015,17801,35816,37.5087701449787,126.891080501385
20210117,2호선,신림,25732,26180,51912,37.4841196518392,126.928712092948
20210117,2호선,신설동,1995,2018,4013,37.5762451837487,127.023278761358
20210117,2호선,신정네거리,3334,3371,6705,37.5197975266787,126.852991645059
20210117,2호선,신촌,13397,13419,26816,37.5554417865984,126.936119192554
20210117,2호선,아현,3512,3589,7101,37.5573575723061,126.95603374504
20210117,2호선,양천구청,2090,2124,4214,37.5126989358446,126.866065211751
20210117,2호선,역삼,7683,8437,16120,37.5007162693593,127.036618203089
20210117,2호선,영등포구청,5513,5895,11408,37.5256996614804,126.896626898379
20210117,2호선,왕십리,6222,5326,11548,37.5612217415191,127.036655378283
20210117,2호선,용답,1136,1142,2278,37.5620049052662,127.050729309179
20210117,2호선,용두,807,816,1623,37.5739380503267,127.038031119837
20210117,2호선,을지로3가,3731,3253,6984,37.56626594615,126.990308356253
20210117,2호선,을지로4가,2056,2014,4070,37.5666369941572,126.997852780281
20210117,2호선,을지로입구,10337,9751,20088,37.5660509513873,126.982372901787
20210117,2호선,이대,4026,4303,8329,37.5567980142044,126.945758201019
20210117,2호선,잠실,27903,26484,54387,37.513859279255,127.101857941447
20210117,2호선,잠실나루,3196,3390,6586,37.5206867318088,127.103811089444
20210117,2호선,잠실새내,6951,7290,14241,37.5115672093323,127.086373867207
20210117,2호선,종합운동장,1832,2030,3862,37.5109692748993,127.073356018706
20210117,2호선,충정로,2581,2585,5166,37.5598377952439,126.964474043785
20210117,2호선,한양대,1583,1703,3286,37.55557788354,127.043584493543
20210117,2호선,합정,11281,11633,22914,37.5501152068908,126.914638180431
20210117,2호선,홍대입구,24361,23774,48135,37.5577458058734,126.926498328277
20210123,2호선,강남,46935,45811,92746,37.4981646510326,127.028307900881
20210123,2호선,강변,18559,19568,38127,37.5351692767888,127.094664569096
20210123,2호선,건대입구,25886,27953,53839,37.5404188872176,127.069173281554
20210123,2호선,교대,13612,14905,28517,37.4928178646055,127.013838469407
20210123,2호선,구로디지털단지,28129,28501,56630,37.4853149237865,126.901494378412
20210123,2호선,구의,13240,13359,26599,37.5371535596228,127.086179228767
20210123,2호선,낙성대,17366,16266,33632,37.4770651843603,126.963409959152
20210123,2호선,당산,10120,10860,20980,37.534956866618,126.90273071003
20210123,2호선,대림,14850,15870,30720,37.4933105886136,126.8949461878
20210123,2호선,도림천,715,712,1427,37.5144420510515,126.882702584468
20210123,2호선,동대문역사문화공원,7596,8092,15688,37.5655895229776,127.009131498424
20210123,2호선,뚝섬,9508,9755,19263,37.5471882244091,127.047365178682
20210123,2호선,문래,9012,9405,18417,37.5179214637526,126.894763060556
20210123,2호선,방배,8143,8376,16519,37.4814364876589,126.997694899327
20210123,2호선,봉천,14372,13455,27827,37.4825562153548,126.941495272047
20210123,2호선,사당,22582,24395,46977,37.4765228347619,126.981408909449
20210123,2호선,삼성,20783,20874,41657,37.5088619974404,127.063073009788
20210123,2호선,상왕십리,7768,7441,15209,37.5644687111181,127.029031221392
20210123,2호선,서울대입구,30941,30090,61031,37.4811526631844,126.952645104944
20210123,2호선,서초,8057,7197,15254,37.4918229990093,127.007580814715
20210123,2호선,선릉,19097,16908,36005,37.5045028775835,127.048942471228
20210123,2호선,성수,13204,14556,27760,37.5445023983984,127.056090471223
20210123,2호선,시청,6002,5227,11229,37.5654385176408,126.976983237511
20210123,2호선,신답,799,844,1643,37.5699910562183,127.046820203556
20210123,2호선,신당,8861,9176,18037,37.5656540317328,127.019540574485
20210123,2호선,신대방,16250,15901,32151,37.4875759745635,126.913175585996
20210123,2호선,신도림,31237,30847,62084,37.5087701449787,126.891080501385
20210123,2호선,신림,41656,40024,81680,37.4841196518392,126.928712092948
20210123,2호선,신설동,2622,2601,5223,37.5762451837487,127.023278761358
20210123,2호선,신정네거리,5641,5782,11423,37.5197975266787,126.852991645059
20210123,2호선,신촌,22163,22469,44632,37.5554417865984,126.936119192554
20210123,2호선,아현,6268,6071,12339,37.5573575723061,126.95603374504
20210123,2호선,양천구청,3425,3517,6942,37.5126989358446,126.866065211751
20210123,2호선,역삼,14833,16201,31034,37.5007162693593,127.036618203089
20210123,2호선,영등포구청,10076,10439,20515,37.5256996614804,126.896626898379
20210123,2호선,왕십리,10163,8868,19031,37.5612217415191,127.036655378283
20210123,2호선,용답,1760,1632,3392,37.5620049052662,127.050729309179
20210123,2호선,용두,1571,1572,3143,37.5739380503267,127.038031119837
20210123,2호선,을지로3가,6989,6941,13930,37.56626594615,126.990308356253
20210123,2호선,을지로4가,6786,6911,13697,37.5666369941572,126.997852780281
20210123,2호선,을지로입구,16201,15836,32037,37.5660509513873,126.982372901787
20210123,2호선,이대,7064,7499,14563,37.5567980142044,126.945758201019
20210123,2호선,잠실,44166,42434,86600,37.513859279255,127.101857941447
20210123,2호선,잠실나루,5782,5602,11384,37.5206867318088,127.103811089444
20210123,2호선,잠실새내,12609,13072,25681,37.5115672093323,127.086373867207
20210123,2호선,종합운동장,3145,3310,6455,37.5109692748993,127.073356018706
20210123,2호선,충정로,4247,4403,8650,37.5598377952439,126.964474043785
20210123,2호선,한양대,2923,2719,5642,37.55557788354,127.043584493543
20210123,2호선,합정,20246,21329,41575,37.5501152068908,126.914638180431
20210123,2호선,홍대입구,41910,44057,85967,37.5577458058734,126.926498328277
20210124,2호선,강남,24876,23930,48806,37.4981646510326,127.028307900881
20210124,2호선,강변,14918,14353,29271,37.5351692767888,127.094664569096
20210124,2호선,건대입구,19334,20291,39625,37.5404188872176,127.069173281554
20210124,2호선,교대,7574,8416,15990,37.4928178646055,127.013838469407
20210124,2호선,구로디지털단지,18036,17917,35953,37.4853149237865,126.901494378412
20210124,2호선,구의,8909,9058,17967,37.5371535596228,127.086179228767
20210124,2호선,낙성대,11928,12349,24277,37.4770651843603,126.963409959152
20210124,2호선,당산,6881,7193,14074,37.534956866618,126.90273071003
20210124,2호선,대림,11293,11478,22771,37.4933105886136,126.8949461878
20210124,2호선,도림천,347,369,716,37.5144420510515,126.882702584468
20210124,2호선,동대문역사문화공원,5295,6437,11732,37.5655895229776,127.009131498424
20210124,2호선,뚝섬,6639,6874,13513,37.5471882244091,127.047365178682
20210124,2호선,문래,5422,5630,11052,37.5179214637526,126.894763060556
20210124,2호선,방배,4978,5293,10271,37.4814364876589,126.997694899327
20210124,2호선,봉천,9323,9281,18604,37.4825562153548,126.941495272047
20210124,2호선,사당,15326,17155,32481,37.4765228347619,126.981408909449
20210124,2호선,삼성,14102,13815,27917,37.5088619974404,127.063073009788
20210124,2호선,상왕십리,5310,5407,10717,37.5644687111181,127.029031221392
20210124,2호선,서울대입구,20766,21423,42189,37.4811526631844,126.952645104944
20210124,2호선,서초,6054,5659,11713,37.4918229990093,127.007580814715
20210124,2호선,선릉,9637,8228,17865,37.5045028775835,127.048942471228
20210124,2호선,성수,8857,9687,18544,37.5445023983984,127.056090471223
20210124,2호선,시청,4135,3321,7456,37.5654385176408,126.976983237511
20210124,2호선,신답,576,602,1178,37.5699910562183,127.046820203556
20210124,2호선,신당,6345,6767,13112,37.5656540317328,127.019540574485
20210124,2호선,신대방,11720,11681,23401,37.4875759745635,126.913175585996
20210124,2호선,신도림,20419,20200,40619,37.5087701449787,126.891080501385
20210124,2호선,신림,29027,28694,57721,37.4841196518392,126.928712092948
20210124,2호선,신설동,2347,2411,4758,37.5762451837487,127.023278761358
20210124,2호선,신정네거리,3656,3735,7391,37.5197975266787,126.852991645059
20210124,2호선,신촌,15243,14945,30188,37.5554417865984,126.936119192554
20210124,2호선,아현,3995,3870,7865,37.5573575723061,126.95603374504
20210124,2호선,양천구청,2417,2442,4859,37.5126989358446,126.866065211751
20210124,2호선,역삼,8476,9453,17929,37.5007162693593,127.036618203089
20210124,2호선,영등포구청,5829,6112,11941,37.5256996614804,126.896626898379
20210124,2호선,왕십리,6940,6127,13067,37.5612217415191,127.036655378283
20210124,2호선,용답,1323,1370,2693,37.5620049052662,127.050729309179
20210124,2호선,용두,894,918,1812,37.5739380503267,127.038031119837
20210124,2호선,을지로3가,4680,4180,8860,37.56626594615,126.990308356253
20210124,2호선,을지로4가,2418,2502,4920,37.5666369941572,126.997852780281
20210124,2호선,을지로입구,11433,10901,22334,37.5660509513873,126.982372901787
20210124,2호선,이대,4488,4842,9330,37.5567980142044,126.945758201019
20210124,2호선,잠실,31371,29238,60609,37.513859279255,127.101857941447
20210124,2호선,잠실나루,3821,3869,7690,37.5206867318088,127.103811089444
20210124,2호선,잠실새내,7792,8209,16001,37.5115672093323,127.086373867207
20210124,2호선,종합운동장,2255,2523,4778,37.5109692748993,127.073356018706
20210124,2호선,충정로,2934,3035,5969,37.5598377952439,126.964474043785
20210124,2호선,한양대,1709,1775,3484,37.55557788354,127.043584493543
20210124,2호선,합정,14156,14570,28726,37.5501152068908,126.914638180431
20210124,2호선,홍대입구,31486,31258,62744,37.5577458058734,126.926498328277
20210130,2호선,강남,48890,48134,97024,37.4981646510326,127.028307900881
20210130,2호선,강변,18697,19503,38200,37.5351692767888,127.094664569096
20210130,2호선,건대입구,26762,28794,55556,37.5404188872176,127.069173281554
20210130,2호선,교대,13501,15052,28553,37.4928178646055,127.013838469407
20210130,2호선,구로디지털단지,28651,28766,57417,37.4853149237865,126.901494378412
20210130,2호선,구의,13508,13364,26872,37.5371535596228,127.086179228767
20210130,2호선,낙성대,17099,16195,33294,37.4770651843603,126.963409959152
20210130,2호선,당산,9879,10770,20649,37.534956866618,126.90273071003
20210130,2호선,대림,14812,15805,30617,37.4933105886136,126.8949461878
20210130,2호선,도림천,753,707,1460,37.5144420510515,126.882702584468
20210130,2호선,동대문역사문화공원,7031,7593,14624,37.5655895229776,127.009131498424
20210130,2호선,뚝섬,9709,10000,19709,37.5471882244091,127.047365178682
20210130,2호선,문래,9429,9810,19239,37.5179214637526,126.894763060556
20210130,2호선,방배,8000,8170,16170,37.4814364876589,126.997694899327
20210130,2호선,봉천,14416,13501,27917,37.4825562153548,126.941495272047
20210130,2호선,사당,22676,24606,47282,37.4765228347619,126.981408909449
20210130,2호선,삼성,21860,21986,43846,37.5088619974404,127.063073009788
20210130,2호선,상왕십리,7934,7499,15433,37.5644687111181,127.029031221392
20210130,2호선,서울대입구,31084,30123,61207,37.4811526631844,126.952645104944
20210130,2호선,서초,7557,6662,14219,37.4918229990093,127.007580814715
20210130,2호선,선릉,19292,17171,36463,37.5045028775835,127.048942471228
20210130,2호선,성수,13495,14968,28463,37.5445023983984,127.056090471223
20210130,2호선,시청,6026,5353,11379,37.5654385176408,126.976983237511
20210130,2호선,신답,850,872,1722,37.5699910562183,127.046820203556
20210130,2호선,신당,9135,9370,18505,37.5656540317328,127.019540574485
20210130,2호선,신대방,16217,15966,32183,37.4875759745635,126.913175585996
20210130,2호선,신도림,31746,31558,63304,37.5087701449787,126.891080501385
20210130,2호선,신림,41411,40059,81470,37.4841196518392,126.928712092948
20210130,2호선,신설동,2576,2623,5199,37.5762451837487,127.023278761358
20210130,2호선,신정네거리,5661,5879,11540,37.5197975266787,126.852991645059
20210130,2호선,신촌,22925,23295,46220,37.5554417865984,126.936119192554
20210130,2호선,아현,6151,5950,12101,37.5573575723061,126.95603374504
20210130,2호선,양천구청,3439,3493,6932,37.5126989358446,126.866065211751
20210130,2호선,역삼,14826,16028,30854,37.5007162693593,127.036618203089
20210130,2호선,영등포구청,9980,10157,20137,37.5256996614804,126.896626898379
20210130,2호선,왕십리,10308,9056,19364,37.5612217415191,127.036655378283
20210130,2호선,용답,1590,1612,3202,37.5620049052662,127.050729309179
20210130,2호선,용두,1498,1515,3013,37.5739380503267,127.038031119837
20210130,2호선,을지로3가,7401,7192,14593,37.56626594615,126.990308356253
20210130,2호선,을지로4가,6358,6543,12901,37.5666369941572,126.997852780281
20210130,2호선,을지로입구,16216,15864,32080,37.5660509513873,126.982372901787
20210130,2호선,이대,7282,7589,14871,37.5567980142044,126.945758201019
20210130,2호선,잠실,45980,44184,90164,37.513859279255,127.101857941447
20210130,2호선,잠실나루,5730,5521,11251,37.5206867318088,127.103811089444
20210130,2호선,잠실새내,13385,13839,27224,37.5115672093323,127.086373867207
20210130,2호선,종합운동장,3291,3640,6931,37.5109692748993,127.073356018706
20210130,2호선,충정로,4490,4585,9075,37.5598377952439,126.964474043785
20210130,2호선,한양대,2484,2363,4847,37.55557788354,127.043584493543
20210130,2호선,합정,20632,21993,42625,37.5501152068908,126.914638180431
20210130,2호선,홍대입구,44160,46513,90673,37.5577458058734,126.926498328277
20210131,2호선,강남,26240,25201,51441,37.4981646510326,127.028307900881
20210131,2호선,강변,15446,14811,30257,37.5351692767888,127.094664569096
20210131,2호선,건대입구,20125,21050,41175,37.5404188872176,127.069173281554
20210131,2호선,교대,7552,8563,16115,37.4928178646055,127.013838469407
20210131,2호선,구로디지털단지,18969,18970,37939,37.4853149237865,126.901494378412
20210131,2호선,구의,9035,9021,18056,37.5371535596228,127.086179228767
20210131,2호선,낙성대,12214,12515,24729,37.4770651843603,126.963409959152
20210131,2호선,당산,6786,7280,14066,37.534956866618,126.90273071003
20210131,2호선,대림,11617,11675,23292,37.4933105886136,126.8949461878
20210131,2호선,도림천,383,386,769,37.5144420510515,126.882702584468
20210131,2호선,동대문역사문화공원,5416,6480,11896,37.5655895229776,127.009131498424
20210131,2호선,뚝섬,6724,6994,13718,37.5471882244091,127.047365178682
20210131,2호선,문래,5632,5952,11584,37.5179214637526,126.894763060556
20210131,2호선,방배,5066,5413,10479,37.4814364876589,126.997694899327
20210131,2호선,봉천,9664,9486,19150,37.4825562153548,126.941495272047
20210131,2호선,사당,15543,17251,32794,37.4765228347619,126.981408909449
20210131,2호선,삼성,15281,15070,30351,37.5088619974404,127.063073009788
20210131,2호선,상왕십리,5171,5265,10436,37.5644687111181,127.029031221392
20210131,2호선,서울대입구,21272,21927,43199,37.4811526631844,126.952645104944
20210131,2호선,서초,6574,6130,12704,37.4918229990093,127.007580814715
20210131,2호선,선릉,9673,8596,18269,37.5045028775835,127.048942471228
20210131,2호선,성수,9249,10116,19365,37.5445023983984,127.056090471223
20210131,2호선,시청,4167,3470,7637,37.5654385176408,126.976983237511
20210131,2호선,신답,578,586,1164,37.5699910562183,127.046820203556
20210131,2호선,신당,6625,7043,13668,37.5656540317328,127.019540574485
20210131,2호선,신대방,11855,11467,23322,37.4875759745635,126.913175585996
20210131,2호선,신도림,21259,21040,42299,37.5087701449787,126.891080501385
20210131,2호선,신림,29480,29176,58656,37.4841196518392,126.928712092948
20210131,2호선,신설동,2272,2459,4731,37.5762451837487,127.023278761358
20210131,2호선,신정네거리,3931,3957,7888,37.5197975266787,126.852991645059
20210131,2호선,신촌,16085,15516,31601,37.5554417865984,126.936119192554
20210131,2호선,아현,3975,4058,8033,37.5573575723061,126.95603374504
20210131,2호선,양천구청,2532,2585,5117,37.5126989358446,126.866065211751
20210131,2호선,역삼,8794,9750,18544,37.5007162693593,127.036618203089
20210131,2호선,영등포구청,6074,6434,12508,37.5256996614804,126.896626898379
20210131,2호선,왕십리,7106,6352,13458,37.5612217415191,127.036655378283
20210131,2호선,용답,1297,1228,2525,37.5620049052662,127.050729309179
20210131,2호선,용두,1067,1048,2115,37.5739380503267,127.038031119837
20210131,2호선,을지로3가,4905,4542,9447,37.56626594615,126.990308356253
20210131,2호선,을지로4가,2506,2537,5043,37.5666369941572,126.997852780281
20210131,2호선,을지로입구,11760,11342,23102,37.5660509513873,126.982372901787
20210131,2호선,이대,4715,4989,9704,37.5567980142044,126.945758201019
20210131,2호선,잠실,32832,31151,63983,37.513859279255,127.101857941447
20210131,2호선,잠실나루,3973,3980,7953,37.5206867318088,127.103811089444
20210131,2호선,잠실새내,8151,8397,16548,37.5115672093323,127.086373867207
20210131,2호선,종합운동장,2455,2674,5129,37.5109692748993,127.073356018706
20210131,2호선,충정로,2829,2876,5705,37.5598377952439,126.964474043785
20210131,2호선,한양대,1586,1684,3270,37.55557788354,127.043584493543
20210131,2호선,합정,14490,15358,29848,37.5501152068908,126.914638180431
20210131,2호선,홍대입구,32732,32794,65526,37.5577458058734,126.926498328277
20210206,2호선,강남,50933,50582,101515,37.4981646510326,127.028307900881
20210206,2호선,강변,19728,20428,40156,37.5351692767888,127.094664569096
20210206,2호선,건대입구,23681,24809,48490,37.5404188872176,127.069173281554
20210206,2호선,교대,14693,16232,30925,37.4928178646055,127.013838469407
20210206,2호선,구로디지털단지,30101,30119,60220,37.4853149237865,126.901494378412
20210206,2호선,구의,14349,14087,28436,37.5371535596228,127.086179228767
20210206,2호선,낙성대,18132,16911,35043,37.4770651843603,126.963409959152
20210206,2호선,당산,10541,11496,22037,37.534956866618,126.90273071003
20210206,2호선,대림,15806,16977,32783,37.4933105886136,126.8949461878
20210206,2호선,도림천,794,794,1588,37.5144420510515,126.882702584468
20210206,2호선,동대문역사문화공원,7577,8094,15671,37.5655895229776,127.009131498424
20210206,2호선,뚝섬,10653,10967,21620,37.5471882244091,127.047365178682
20210206,2호선,문래,10060,10566,20626,37.5179214637526,126.894763060556
20210206,2호선,방배,8380,8665,17045,37.4814364876589,126.997694899327
20210206,2호선,봉천,15130,14330,29460,37.4825562153548,126.941495272047
20210206,2호선,사당,24876,26678,51554,37.4765228347619,126.981408909449
20210206,2호선,삼성,21851,21889,43740,37.5088619974404,127.063073009788
20210206,2호선,상왕십리,8147,7847,15994,37.5644687111181,127.029031221392
20210206,2호선,서울대입구,33078,32421,65499,37.4811526631844,126.952645104944
20210206,2호선,서초,8493,7519,16012,37.4918229990093,127.007580814715
20210206,2호선,선릉,19671,17481,37152,37.5045028775835,127.048942471228
20210206,2호선,성수,14715,16410,31125,37.5445023983984,127.056090471223
20210206,2호선,시청,6597,5874,12471,37.5654385176408,126.976983237511
20210206,2호선,신답,917,922,1839,37.5699910562183,127.046820203556
20210206,2호선,신당,9577,10031,19608,37.5656540317328,127.019540574485
20210206,2호선,신대방,16902,16260,33162,37.4875759745635,126.913175585996
20210206,2호선,신도림,33229,32965,66194,37.5087701449787,126.891080501385
20210206,2호선,신림,43649,42048,85697,37.4841196518392,126.928712092948
20210206,2호선,신설동,2715,2646,5361,37.5762451837487,127.023278761358
20210206,2호선,신정네거리,6120,6175,12295,37.5197975266787,126.852991645059
20210206,2호선,신촌,23908,24455,48363,37.5554417865984,126.936119192554
20210206,2호선,아현,6622,6248,12870,37.5573575723061,126.95603374504
20210206,2호선,양천구청,3713,3811,7524,37.5126989358446,126.866065211751
20210206,2호선,역삼,16319,17774,34093,37.5007162693593,127.036618203089
20210206,2호선,영등포구청,10622,10825,21447,37.5256996614804,126.896626898379
20210206,2호선,왕십리,11097,9653,20750,37.5612217415191,127.036655378283
20210206,2호선,용답,1730,1699,3429,37.5620049052662,127.050729309179
20210206,2호선,용두,1732,1739,3471,37.5739380503267,127.038031119837
20210206,2호선,을지로3가,7924,7828,15752,37.56626594615,126.990308356253
20210206,2호선,을지로4가,6691,6874,13565,37.5666369941572,126.997852780281
20210206,2호선,을지로입구,17188,16877,34065,37.5660509513873,126.982372901787
20210206,2호선,이대,7800,8203,16003,37.5567980142044,126.945758201019
20210206,2호선,잠실,48865,46847,95712,37.513859279255,127.101857941447
20210206,2호선,잠실나루,6143,5980,12123,37.5206867318088,127.103811089444
20210206,2호선,잠실새내,13706,14274,27980,37.5115672093323,127.086373867207
20210206,2호선,종합운동장,3408,3772,7180,37.5109692748993,127.073356018706
20210206,2호선,충정로,4500,4709,9209,37.5598377952439,126.964474043785
20210206,2호선,한양대,3231,3215,6446,37.55557788354,127.043584493543
20210206,2호선,합정,22000,23809,45809,37.5501152068908,126.914638180431
20210206,2호선,홍대입구,46793,49822,96615,37.5577458058734,126.926498328277
20210207,2호선,강남,27923,26788,54711,37.4981646510326,127.028307900881
20210207,2호선,강변,15179,14877,30056,37.5351692767888,127.094664569096
20210207,2호선,건대입구,17846,18185,36031,37.5404188872176,127.069173281554
20210207,2호선,교대,8370,9195,17565,37.4928178646055,127.013838469407
20210207,2호선,구로디지털단지,19948,19924,39872,37.4853149237865,126.901494378412
20210207,2호선,구의,9464,9527,18991,37.5371535596228,127.086179228767
20210207,2호선,낙성대,12707,12713,25420,37.4770651843603,126.963409959152
20210207,2호선,당산,6814,7360,14174,37.534956866618,126.90273071003
20210207,2호선,대림,12009,12218,24227,37.4933105886136,126.8949461878
20210207,2호선,도림천,352,403,755,37.5144420510515,126.882702584468
20210207,2호선,동대문역사문화공원,5843,6964,12807,37.5655895229776,127.009131498424
20210207,2호선,뚝섬,7037,7214,14251,37.5471882244091,127.047365178682
20210207,2호선,문래,6412,6600,13012,37.5179214637526,126.894763060556
20210207,2호선,방배,5250,5724,10974,37.4814364876589,126.997694899327
20210207,2호선,봉천,10074,9675,19749,37.4825562153548,126.941495272047
20210207,2호선,사당,15970,17839,33809,37.4765228347619,126.981408909449
20210207,2호선,삼성,15198,14555,29753,37.5088619974404,127.063073009788
20210207,2호선,상왕십리,5571,5526,11097,37.5644687111181,127.029031221392
20210207,2호선,서울대입구,22908,22885,45793,37.4811526631844,126.952645104944
20210207,2호선,서초,6986,6448,13434,37.4918229990093,127.007580814715
20210207,2호선,선릉,9836,8675,18511,37.5045028775835,127.048942471228
20210207,2호선,성수,10028,10913,20941,37.5445023983984,127.056090471223
20210207,2호선,시청,4382,3559,7941,37.5654385176408,126.976983237511
20210207,2호선,신답,581,650,1231,37.5699910562183,127.046820203556
20210207,2호선,신당,7109,7430,14539,37.5656540317328,127.019540574485
20210207,2호선,신대방,12216,12121,24337,37.4875759745635,126.913175585996
20210207,2호선,신도림,21851,22012,43863,37.5087701449787,126.891080501385
20210207,2호선,신림,30461,29752,60213,37.4841196518392,126.928712092948
20210207,2호선,신설동,2479,2454,4933,37.5762451837487,127.023278761358
20210207,2호선,신정네거리,4060,4177,8237,37.5197975266787,126.852991645059
20210207,2호선,신촌,17383,16785,34168,37.5554417865984,126.936119192554
20210207,2호선,아현,4484,4436,8920,37.5573575723061,126.95603374504
20210207,2호선,양천구청,2549,2587,5136,37.5126989358446,126.866065211751
20210207,2호선,역삼,9242,10101,19343,37.5007162693593,127.036618203089
20210207,2호선,영등포구청,6628,6804,13432,37.5256996614804,126.896626898379
20210207,2호선,왕십리,7770,6852,14622,37.5612217415191,127.036655378283
20210207,2호선,용답,1293,1308,2601,37.5620049052662,127.050729309179
20210207,2호선,용두,1199,1204,2403,37.5739380503267,127.038031119837
20210207,2호선,을지로3가,5435,4894,10329,37.56626594615,126.990308356253
20210207,2호선,을지로4가,2794,2719,5513,37.5666369941572,126.997852780281
20210207,2호선,을지로입구,12297,11710,24007,37.5660509513873,126.982372901787
20210207,2호선,이대,5411,5660,11071,37.5567980142044,126.945758201019
20210207,2호선,잠실,34938,33188,68126,37.513859279255,127.101857941447
20210207,2호선,잠실나루,3917,4068,7985,37.5206867318088,127.103811089444
20210207,2호선,잠실새내,8515,9020,17535,37.5115672093323,127.086373867207
20210207,2호선,종합운동장,2423,2715,5138,37.5109692748993,127.073356018706
20210207,2호선,충정로,3005,3161,6166,37.5598377952439,126.964474043785
20210207,2호선,한양대,1873,1877,3750,37.55557788354,127.043584493543
20210207,2호선,합정,15360,15849,31209,37.5501152068908,126.914638180431
20210207,2호선,홍대입구,35830,35093,70923,37.5577458058734,126.926498328277
20210213,2호선,강남,25420,25063,50483,37.4981646510326,127.028307900881
20210213,2호선,강변,20164,15232,35396,37.5351692767888,127.094664569096
20210213,2호선,건대입구,17466,19388,36854,37.5404188872176,127.069173281554
20210213,2호선,교대,7220,8069,15289,37.4928178646055,127.013838469407
20210213,2호선,구로디지털단지,17463,18626,36089,37.4853149237865,126.901494378412
20210213,2호선,구의,8291,8865,17156,37.5371535596228,127.086179228767
20210213,2호선,낙성대,9673,10916,20589,37.4770651843603,126.963409959152
20210213,2호선,당산,7037,7447,14484,37.534956866618,126.90273071003
20210213,2호선,대림,10700,11083,21783,37.4933105886136,126.8949461878
20210213,2호선,도림천,369,391,760,37.5144420510515,126.882702584468
20210213,2호선,동대문역사문화공원,5375,6147,11522,37.5655895229776,127.009131498424
20210213,2호선,뚝섬,6581,7071,13652,37.5471882244091,127.047365178682
20210213,2호선,문래,5630,5904,11534,37.5179214637526,126.894763060556
20210213,2호선,방배,4514,4809,9323,37.4814364876589,126.997694899327
20210213,2호선,봉천,8469,8998,17467,37.4825562153548,126.941495272047
20210213,2호선,사당,15681,17454,33135,37.4765228347619,126.981408909449
20210213,2호선,삼성,14401,14317,28718,37.5088619974404,127.063073009788
20210213,2호선,상왕십리,4888,4975,9863,37.5644687111181,127.029031221392
20210213,2호선,서울대입구,18237,21264,39501,37.4811526631844,126.952645104944
20210213,2호선,서초,4464,3750,8214,37.4918229990093,127.007580814715
20210213,2호선,선릉,7862,7493,15355,37.5045028775835,127.048942471228
20210213,2호선,성수,8872,10423,19295,37.5445023983984,127.056090471223
20210213,2호선,시청,3747,2980,6727,37.5654385176408,126.976983237511
20210213,2호선,신답,574,614,1188,37.5699910562183,127.046820203556
20210213,2호선,신당,5848,6422,12270,37.5656540317328,127.019540574485
20210213,2호선,신대방,10849,11707,22556,37.4875759745635,126.913175585996
20210213,2호선,신도림,20875,21190,42065,37.5087701449787,126.891080501385
20210213,2호선,신림,26538,29288,55826,37.4841196518392,126.928712092948
20210213,2호선,신설동,1881,1884,3765,37.5762451837487,127.023278761358
20210213,2호선,신정네거리,4003,4000,8003,37.5197975266787,126.852991645059
20210213,2호선,신촌,13893,14998,28891,37.5554417865984,126.936119192554
20210213,2호선,아현,3837,3822,7659,37.5573575723061,126.95603374504
20210213,2호선,양천구청,2428,2494,4922,37.5126989358446,126.866065211751
20210213,2호선,역삼,6712,8130,14842,37.5007162693593,127.036618203089
20210213,2호선,영등포구청,5791,6361,12152,37.5256996614804,126.896626898379
20210213,2호선,왕십리,6625,6426,13051,37.5612217415191,127.036655378283
20210213,2호선,용답,1100,1163,2263,37.5620049052662,127.050729309179
20210213,2호선,용두,752,854,1606,37.5739380503267,127.038031119837
20210213,2호선,을지로3가,4577,4435,9012,37.56626594615,126.990308356253
20210213,2호선,을지로4가,2085,2181,4266,37.5666369941572,126.997852780281
20210213,2호선,을지로입구,13003,11914,24917,37.5660509513873,126.982372901787
20210213,2호선,이대,3813,4456,8269,37.5567980142044,126.945758201019
20210213,2호선,잠실,38212,35590,73802,37.513859279255,127.101857941447
20210213,2호선,잠실나루,3715,3752,7467,37.5206867318088,127.103811089444
20210213,2호선,잠실새내,8170,8865,17035,37.5115672093323,127.086373867207
20210213,2호선,종합운동장,2385,2466,4851,37.5109692748993,127.073356018706
20210213,2호선,충정로,2612,2802,5414,37.5598377952439,126.964474043785
20210213,2호선,한양대,1398,1481,2879,37.55557788354,127.043584493543
20210213,2호선,합정,14199,15727,29926,37.5501152068908,126.914638180431
20210213,2호선,홍대입구,35347,39122,74469,37.5577458058734,126.926498328277
20210214,2호선,강남,24652,24027,48679,37.4981646510326,127.028307900881
20210214,2호선,강변,22095,15869,37964,37.5351692767888,127.094664569096
20210214,2호선,건대입구,17712,19498,37210,37.5404188872176,127.069173281554
20210214,2호선,교대,7362,8190,15552,37.4928178646055,127.013838469407
20210214,2호선,구로디지털단지,17496,18365,35861,37.4853149237865,126.901494378412
20210214,2호선,구의,8318,8997,17315,37.5371535596228,127.086179228767
20210214,2호선,낙성대,10999,12695,23694,37.4770651843603,126.963409959152
20210214,2호선,당산,6573,7039,13612,37.534956866618,126.90273071003
20210214,2호선,대림,11452,11495,22947,37.4933105886136,126.8949461878
20210214,2호선,도림천,390,417,807,37.5144420510515,126.882702584468
20210214,2호선,동대문역사문화공원,5291,5940,11231,37.5655895229776,127.009131498424
20210214,2호선,뚝섬,6476,7069,13545,37.5471882244091,127.047365178682
20210214,2호선,문래,5106,5503,10609,37.5179214637526,126.894763060556
20210214,2호선,방배,4832,5316,10148,37.4814364876589,126.997694899327
20210214,2호선,봉천,8874,9686,18560,37.4825562153548,126.941495272047
20210214,2호선,사당,15363,17409,32772,37.4765228347619,126.981408909449
20210214,2호선,삼성,14091,13768,27859,37.5088619974404,127.063073009788
20210214,2호선,상왕십리,5119,5345,10464,37.5644687111181,127.029031221392
20210214,2호선,서울대입구,19164,22625,41789,37.4811526631844,126.952645104944
20210214,2호선,서초,6118,5629,11747,37.4918229990093,127.007580814715
20210214,2호선,선릉,8081,7604,15685,37.5045028775835,127.048942471228
20210214,2호선,성수,8599,9871,18470,37.5445023983984,127.056090471223
20210214,2호선,시청,4001,3325,7326,37.5654385176408,126.976983237511
20210214,2호선,신답,539,600,1139,37.5699910562183,127.046820203556
20210214,2호선,신당,6069,6676,12745,37.5656540317328,127.019540574485
20210214,2호선,신대방,11281,12046,23327,37.4875759745635,126.913175585996
20210214,2호선,신도림,20764,20863,41627,37.5087701449787,126.891080501385
20210214,2호선,신림,27130,30521,57651,37.4841196518392,126.928712092948
20210214,2호선,신설동,2045,2223,4268,37.5762451837487,127.023278761358
20210214,2호선,신정네거리,3927,3965,7892,37.5197975266787,126.852991645059
20210214,2호선,신촌,15377,15714,31091,37.5554417865984,126.936119192554
20210214,2호선,아현,3958,4064,8022,37.5573575723061,126.95603374504
20210214,2호선,양천구청,2463,2547,5010,37.5126989358446,126.866065211751
20210214,2호선,역삼,7523,8876,16399,37.5007162693593,127.036618203089
20210214,2호선,영등포구청,5259,5635,10894,37.5256996614804,126.896626898379
20210214,2호선,왕십리,6631,6490,13121,37.5612217415191,127.036655378283
20210214,2호선,용답,1201,1357,2558,37.5620049052662,127.050729309179
20210214,2호선,용두,734,791,1525,37.5739380503267,127.038031119837
20210214,2호선,을지로3가,4929,4621,9550,37.56626594615,126.990308356253
20210214,2호선,을지로4가,2063,2115,4178,37.5666369941572,126.997852780281
20210214,2호선,을지로입구,12227,11522,23749,37.5660509513873,126.982372901787
20210214,2호선,이대,4083,4807,8890,37.5567980142044,126.945758201019
20210214,2호선,잠실,34562,32548,67110,37.513859279255,127.101857941447
20210214,2호선,잠실나루,3813,3819,7632,37.5206867318088,127.103811089444
20210214,2호선,잠실새내,8082,8729,16811,37.5115672093323,127.086373867207
20210214,2호선,종합운동장,2457,2638,5095,37.5109692748993,127.073356018706
20210214,2호선,충정로,2509,2591,5100,37.5598377952439,126.964474043785
20210214,2호선,한양대,1343,1643,2986,37.55557788354,127.043584493543
20210214,2호선,합정,13615,14895,28510,37.5501152068908,126.914638180431
20210214,2호선,홍대입구,34249,36113,70362,37.5577458058734,126.926498328277
20210220,2호선,강남,56460,53046,109506,37.4981646510326,127.028307900881
20210220,2호선,강변,22884,22718,45602,37.5351692767888,127.094664569096
20210220,2호선,건대입구,29277,30924,60201,37.5404188872176,127.069173281554
20210220,2호선,교대,15816,17726,33542,37.4928178646055,127.013838469407
20210220,2호선,구로디지털단지,31986,31703,63689,37.4853149237865,126.901494378412
20210220,2호선,구의,14838,14505,29343,37.5371535596228,127.086179228767
20210220,2호선,낙성대,19403,18134,37537,37.4770651843603,126.963409959152
20210220,2호선,당산,11751,12703,24454,37.534956866618,126.90273071003
20210220,2호선,대림,16338,17335,33673,37.4933105886136,126.8949461878
20210220,2호선,도림천,878,808,1686,37.5144420510515,126.882702584468
20210220,2호선,동대문역사문화공원,8585,9146,17731,37.5655895229776,127.009131498424
20210220,2호선,뚝섬,11689,12438,24127,37.5471882244091,127.047365178682
20210220,2호선,문래,11039,11501,22540,37.5179214637526,126.894763060556
20210220,2호선,방배,9049,9451,18500,37.4814364876589,126.997694899327
20210220,2호선,봉천,16281,15065,31346,37.4825562153548,126.941495272047
20210220,2호선,사당,26240,28703,54943,37.4765228347619,126.981408909449
20210220,2호선,삼성,24654,24674,49328,37.5088619974404,127.063073009788
20210220,2호선,상왕십리,8639,8199,16838,37.5644687111181,127.029031221392
20210220,2호선,서울대입구,35575,34615,70190,37.4811526631844,126.952645104944
20210220,2호선,서초,9625,8298,17923,37.4918229990093,127.007580814715
20210220,2호선,선릉,21767,19460,41227,37.5045028775835,127.048942471228
20210220,2호선,성수,16034,17893,33927,37.5445023983984,127.056090471223
20210220,2호선,시청,7612,6703,14315,37.5654385176408,126.976983237511
20210220,2호선,신답,992,998,1990,37.5699910562183,127.046820203556
20210220,2호선,신당,10155,10310,20465,37.5656540317328,127.019540574485
20210220,2호선,신대방,17952,17629,35581,37.4875759745635,126.913175585996
20210220,2호선,신도림,37701,37673,75374,37.5087701449787,126.891080501385
20210220,2호선,신림,46128,44792,90920,37.4841196518392,126.928712092948
20210220,2호선,신설동,3012,2937,5949,37.5762451837487,127.023278761358
20210220,2호선,신정네거리,6470,6678,13148,37.5197975266787,126.852991645059
20210220,2호선,신촌,26964,27408,54372,37.5554417865984,126.936119192554
20210220,2호선,아현,6614,6316,12930,37.5573575723061,126.95603374504
20210220,2호선,양천구청,4139,4265,8404,37.5126989358446,126.866065211751
20210220,2호선,역삼,17547,19232,36779,37.5007162693593,127.036618203089
20210220,2호선,영등포구청,11327,11640,22967,37.5256996614804,126.896626898379
20210220,2호선,왕십리,11513,10121,21634,37.5612217415191,127.036655378283
20210220,2호선,용답,1807,1745,3552,37.5620049052662,127.050729309179
20210220,2호선,용두,1667,1583,3250,37.5739380503267,127.038031119837
20210220,2호선,을지로3가,8599,8529,17128,37.56626594615,126.990308356253
20210220,2호선,을지로4가,6658,6769,13427,37.5666369941572,126.997852780281
20210220,2호선,을지로입구,18415,17936,36351,37.5660509513873,126.982372901787
20210220,2호선,이대,8366,9017,17383,37.5567980142044,126.945758201019
20210220,2호선,잠실,55404,52812,108216,37.513859279255,127.101857941447
20210220,2호선,잠실나루,6502,6308,12810,37.5206867318088,127.103811089444
20210220,2호선,잠실새내,14580,15230,29810,37.5115672093323,127.086373867207
20210220,2호선,종합운동장,3864,4148,8012,37.5109692748993,127.073356018706
20210220,2호선,충정로,5041,5241,10282,37.5598377952439,126.964474043785
20210220,2호선,한양대,3265,3410,6675,37.55557788354,127.043584493543
20210220,2호선,합정,24363,26260,50623,37.5501152068908,126.914638180431
20210220,2호선,홍대입구,54166,58150,112316,37.5577458058734,126.926498328277
20210221,2호선,강남,32075,31031,63106,37.4981646510326,127.028307900881
20210221,2호선,강변,17218,16982,34200,37.5351692767888,127.094664569096
20210221,2호선,건대입구,22327,22552,44879,37.5404188872176,127.069173281554
20210221,2호선,교대,8960,10022,18982,37.4928178646055,127.013838469407
20210221,2호선,구로디지털단지,21140,20793,41933,37.4853149237865,126.901494378412
20210221,2호선,구의,9938,10023,19961,37.5371535596228,127.086179228767
20210221,2호선,낙성대,13993,13987,27980,37.4770651843603,126.963409959152
20210221,2호선,당산,7947,8348,16295,37.534956866618,126.90273071003
20210221,2호선,대림,12900,12900,25800,37.4933105886136,126.8949461878
20210221,2호선,도림천,447,492,939,37.5144420510515,126.882702584468
20210221,2호선,동대문역사문화공원,6174,7636,13810,37.5655895229776,127.009131498424
20210221,2호선,뚝섬,8809,9246,18055,37.5471882244091,127.047365178682
20210221,2호선,문래,7082,7384,14466,37.5179214637526,126.894763060556
20210221,2호선,방배,5794,6186,11980,37.4814364876589,126.997694899327
20210221,2호선,봉천,10728,10235,20963,37.4825562153548,126.941495272047
20210221,2호선,사당,17838,20139,37977,37.4765228347619,126.981408909449
20210221,2호선,삼성,17151,16872,34023,37.5088619974404,127.063073009788
20210221,2호선,상왕십리,5903,5808,11711,37.5644687111181,127.029031221392
20210221,2호선,서울대입구,24631,25040,49671,37.4811526631844,126.952645104944
20210221,2호선,서초,8441,7896,16337,37.4918229990093,127.007580814715
20210221,2호선,선릉,11384,10100,21484,37.5045028775835,127.048942471228
20210221,2호선,성수,11246,12541,23787,37.5445023983984,127.056090471223
20210221,2호선,시청,4742,4027,8769,37.5654385176408,126.976983237511
20210221,2호선,신답,661,708,1369,37.5699910562183,127.046820203556
20210221,2호선,신당,7392,7847,15239,37.5656540317328,127.019540574485
20210221,2호선,신대방,13266,13093,26359,37.4875759745635,126.913175585996
20210221,2호선,신도림,25245,25455,50700,37.5087701449787,126.891080501385
20210221,2호선,신림,33364,32322,65686,37.4841196518392,126.928712092948
20210221,2호선,신설동,2624,2616,5240,37.5762451837487,127.023278761358
20210221,2호선,신정네거리,4568,4563,9131,37.5197975266787,126.852991645059
20210221,2호선,신촌,19261,18891,38152,37.5554417865984,126.936119192554
20210221,2호선,아현,4394,4405,8799,37.5573575723061,126.95603374504
20210221,2호선,양천구청,2841,2972,5813,37.5126989358446,126.866065211751
20210221,2호선,역삼,10062,11204,21266,37.5007162693593,127.036618203089
20210221,2호선,영등포구청,7045,7183,14228,37.5256996614804,126.896626898379
20210221,2호선,왕십리,8131,7224,15355,37.5612217415191,127.036655378283
20210221,2호선,용답,1388,1348,2736,37.5620049052662,127.050729309179
20210221,2호선,용두,1042,1070,2112,37.5739380503267,127.038031119837
20210221,2호선,을지로3가,6094,5643,11737,37.56626594615,126.990308356253
20210221,2호선,을지로4가,2770,2507,5277,37.5666369941572,126.997852780281
20210221,2호선,을지로입구,13295,12531,25826,37.5660509513873,126.982372901787
20210221,2호선,이대,5850,6042,11892,37.5567980142044,126.945758201019
20210221,2호선,잠실,39272,37175,76447,37.513859279255,127.101857941447
20210221,2호선,잠실나루,4295,4380,8675,37.5206867318088,127.103811089444
20210221,2호선,잠실새내,9343,9865,19208,37.5115672093323,127.086373867207
20210221,2호선,종합운동장,2819,3068,5887,37.5109692748993,127.073356018706
20210221,2호선,충정로,3400,3542,6942,37.5598377952439,126.964474043785
20210221,2호선,한양대,2139,2291,4430,37.55557788354,127.043584493543
20210221,2호선,합정,17319,18078,35397,37.5501152068908,126.914638180431
20210221,2호선,홍대입구,41508,42091,83599,37.5577458058734,126.926498328277
20210227,2호선,강남,57464,57150,114614,37.4981646510326,127.028307900881
20210227,2호선,강변,24315,26386,50701,37.5351692767888,127.094664569096
20210227,2호선,건대입구,30672,32163,62835,37.5404188872176,127.069173281554
20210227,2호선,교대,16107,17744,33851,37.4928178646055,127.013838469407
20210227,2호선,구로디지털단지,32169,31547,63716,37.4853149237865,126.901494378412
20210227,2호선,구의,15049,14453,29502,37.5371535596228,127.086179228767
20210227,2호선,낙성대,19810,18126,37936,37.4770651843603,126.963409959152
20210227,2호선,당산,12042,12916,24958,37.534956866618,126.90273071003
20210227,2호선,대림,16660,17872,34532,37.4933105886136,126.8949461878
20210227,2호선,도림천,783,797,1580,37.5144420510515,126.882702584468
20210227,2호선,동대문역사문화공원,9395,9940,19335,37.5655895229776,127.009131498424
20210227,2호선,뚝섬,12712,13287,25999,37.5471882244091,127.047365178682
20210227,2호선,문래,11285,11596,22881,37.5179214637526,126.894763060556
20210227,2호선,방배,9221,9429,18650,37.4814364876589,126.997694899327
20210227,2호선,봉천,15908,14680,30588,37.4825562153548,126.941495272047
20210227,2호선,사당,26767,29730,56497,37.4765228347619,126.981408909449
20210227,2호선,삼성,26483,27124,53607,37.5088619974404,127.063073009788
20210227,2호선,상왕십리,9030,8435,17465,37.5644687111181,127.029031221392
20210227,2호선,서울대입구,35583,34114,69697,37.4811526631844,126.952645104944
20210227,2호선,서초,9989,8664,18653,37.4918229990093,127.007580814715
20210227,2호선,선릉,21905,19682,41587,37.5045028775835,127.048942471228
20210227,2호선,성수,16529,18498,35027,37.5445023983984,127.056090471223
20210227,2호선,시청,7683,6570,14253,37.5654385176408,126.976983237511
20210227,2호선,신답,967,1025,1992,37.5699910562183,127.046820203556
20210227,2호선,신당,10203,10626,20829,37.5656540317328,127.019540574485
20210227,2호선,신대방,18497,17845,36342,37.4875759745635,126.913175585996
20210227,2호선,신도림,38297,38679,76976,37.5087701449787,126.891080501385
20210227,2호선,신림,47205,44450,91655,37.4841196518392,126.928712092948
20210227,2호선,신설동,3194,3096,6290,37.5762451837487,127.023278761358
20210227,2호선,신정네거리,6602,6617,13219,37.5197975266787,126.852991645059
20210227,2호선,신촌,26571,26397,52968,37.5554417865984,126.936119192554
20210227,2호선,아현,6833,6747,13580,37.5573575723061,126.95603374504
20210227,2호선,양천구청,4200,4354,8554,37.5126989358446,126.866065211751
20210227,2호선,역삼,17334,18967,36301,37.5007162693593,127.036618203089
20210227,2호선,영등포구청,11645,11883,23528,37.5256996614804,126.896626898379
20210227,2호선,왕십리,12271,10487,22758,37.5612217415191,127.036655378283
20210227,2호선,용답,1887,1853,3740,37.5620049052662,127.050729309179
20210227,2호선,용두,1579,1516,3095,37.5739380503267,127.038031119837
20210227,2호선,을지로3가,9235,9162,18397,37.56626594615,126.990308356253
20210227,2호선,을지로4가,6646,6760,13406,37.5666369941572,126.997852780281
20210227,2호선,을지로입구,19125,18834,37959,37.5660509513873,126.982372901787
20210227,2호선,이대,8990,9133,18123,37.5567980142044,126.945758201019
20210227,2호선,잠실,56574,53383,109957,37.513859279255,127.101857941447
20210227,2호선,잠실나루,6671,6460,13131,37.5206867318088,127.103811089444
20210227,2호선,잠실새내,15103,15807,30910,37.5115672093323,127.086373867207
20210227,2호선,종합운동장,4335,4607,8942,37.5109692748993,127.073356018706
20210227,2호선,충정로,5304,5593,10897,37.5598377952439,126.964474043785
20210227,2호선,한양대,3486,3490,6976,37.55557788354,127.043584493543
20210227,2호선,합정,25124,27068,52192,37.5501152068908,126.914638180431
20210227,2호선,홍대입구,56129,60023,116152,37.5577458058734,126.926498328277
20210228,2호선,강남,34214,33161,67375,37.4981646510326,127.028307900881
20210228,2호선,강변,18926,18855,37781,37.5351692767888,127.094664569096
20210228,2호선,건대입구,24880,25475,50355,37.5404188872176,127.069173281554
20210228,2호선,교대,9597,10616,20213,37.4928178646055,127.013838469407
20210228,2호선,구로디지털단지,22678,21777,44455,37.4853149237865,126.901494378412
20210228,2호선,구의,10767,10554,21321,37.5371535596228,127.086179228767
20210228,2호선,낙성대,15023,14315,29338,37.4770651843603,126.963409959152
20210228,2호선,당산,8361,9132,17493,37.534956866618,126.90273071003
20210228,2호선,대림,13492,13835,27327,37.4933105886136,126.8949461878
20210228,2호선,도림천,480,477,957,37.5144420510515,126.882702584468
20210228,2호선,동대문역사문화공원,7402,8967,16369,37.5655895229776,127.009131498424
20210228,2호선,뚝섬,9429,9696,19125,37.5471882244091,127.047365178682
20210228,2호선,문래,7168,7432,14600,37.5179214637526,126.894763060556
20210228,2호선,방배,6173,6535,12708,37.4814364876589,126.997694899327
20210228,2호선,봉천,11249,10634,21883,37.4825562153548,126.941495272047
20210228,2호선,사당,19225,21952,41177,37.4765228347619,126.981408909449
20210228,2호선,삼성,19391,19404,38795,37.5088619974404,127.063073009788
20210228,2호선,상왕십리,6451,6317,12768,37.5644687111181,127.029031221392
20210228,2호선,서울대입구,26633,26661,53294,37.4811526631844,126.952645104944
20210228,2호선,서초,9060,8285,17345,37.4918229990093,127.007580814715
20210228,2호선,선릉,11609,10305,21914,37.5045028775835,127.048942471228
20210228,2호선,성수,11813,13355,25168,37.5445023983984,127.056090471223
20210228,2호선,시청,5530,4504,10034,37.5654385176408,126.976983237511
20210228,2호선,신답,695,705,1400,37.5699910562183,127.046820203556
20210228,2호선,신당,7795,8262,16057,37.5656540317328,127.019540574485
20210228,2호선,신대방,13826,13454,27280,37.4875759745635,126.913175585996
20210228,2호선,신도림,26936,27063,53999,37.5087701449787,126.891080501385
20210228,2호선,신림,35241,34373,69614,37.4841196518392,126.928712092948
20210228,2호선,신설동,2806,2830,5636,37.5762451837487,127.023278761358
20210228,2호선,신정네거리,4814,4805,9619,37.5197975266787,126.852991645059
20210228,2호선,신촌,20115,20005,40120,37.5554417865984,126.936119192554
20210228,2호선,아현,4857,4750,9607,37.5573575723061,126.95603374504
20210228,2호선,양천구청,3234,3281,6515,37.5126989358446,126.866065211751
20210228,2호선,역삼,10239,11455,21694,37.5007162693593,127.036618203089
20210228,2호선,영등포구청,7326,7359,14685,37.5256996614804,126.896626898379
20210228,2호선,왕십리,8746,7798,16544,37.5612217415191,127.036655378283
20210228,2호선,용답,1606,1511,3117,37.5620049052662,127.050729309179
20210228,2호선,용두,1069,1029,2098,37.5739380503267,127.038031119837
20210228,2호선,을지로3가,7028,6622,13650,37.56626594615,126.990308356253
20210228,2호선,을지로4가,3119,3072,6191,37.5666369941572,126.997852780281
20210228,2호선,을지로입구,15160,14364,29524,37.5660509513873,126.982372901787
20210228,2호선,이대,6326,6494,12820,37.5567980142044,126.945758201019
20210228,2호선,잠실,43141,40772,83913,37.513859279255,127.101857941447
20210228,2호선,잠실나루,4693,4599,9292,37.5206867318088,127.103811089444
20210228,2호선,잠실새내,10183,10717,20900,37.5115672093323,127.086373867207
20210228,2호선,종합운동장,3166,3496,6662,37.5109692748993,127.073356018706
20210228,2호선,충정로,3520,3797,7317,37.5598377952439,126.964474043785
20210228,2호선,한양대,2225,2310,4535,37.55557788354,127.043584493543
20210228,2호선,합정,18742,19732,38474,37.5501152068908,126.914638180431
20210228,2호선,홍대입구,46495,48937,95432,37.5577458058734,126.926498328277
20210306,2호선,강남,59524,58708,118232,37.4981646510326,127.028307900881
20210306,2호선,강변,22859,23302,46161,37.5351692767888,127.094664569096
20210306,2호선,건대입구,32316,33333,65649,37.5404188872176,127.069173281554
20210306,2호선,교대,16418,18317,34735,37.4928178646055,127.013838469407
20210306,2호선,구로디지털단지,32938,32423,65361,37.4853149237865,126.901494378412
20210306,2호선,구의,15123,14832,29955,37.5371535596228,127.086179228767
20210306,2호선,낙성대,20709,19340,40049,37.4770651843603,126.963409959152
20210306,2호선,당산,12120,13307,25427,37.534956866618,126.90273071003
20210306,2호선,대림,17396,18592,35988,37.4933105886136,126.8949461878
20210306,2호선,도림천,825,804,1629,37.5144420510515,126.882702584468
20210306,2호선,동대문역사문화공원,9095,9888,18983,37.5655895229776,127.009131498424
20210306,2호선,뚝섬,12688,12948,25636,37.5471882244091,127.047365178682
20210306,2호선,문래,11566,12025,23591,37.5179214637526,126.894763060556
20210306,2호선,방배,9643,9941,19584,37.4814364876589,126.997694899327
20210306,2호선,봉천,16512,15120,31632,37.4825562153548,126.941495272047
20210306,2호선,사당,28105,31189,59294,37.4765228347619,126.981408909449
20210306,2호선,삼성,30293,30369,60662,37.5088619974404,127.063073009788
20210306,2호선,상왕십리,9089,8572,17661,37.5644687111181,127.029031221392
20210306,2호선,서울대입구,37283,36507,73790,37.4811526631844,126.952645104944
20210306,2호선,서초,9656,8422,18078,37.4918229990093,127.007580814715
20210306,2호선,선릉,23052,20520,43572,37.5045028775835,127.048942471228
20210306,2호선,성수,17048,18756,35804,37.5445023983984,127.056090471223
20210306,2호선,시청,8137,6804,14941,37.5654385176408,126.976983237511
20210306,2호선,신답,956,1025,1981,37.5699910562183,127.046820203556
20210306,2호선,신당,10677,11053,21730,37.5656540317328,127.019540574485
20210306,2호선,신대방,18491,18168,36659,37.4875759745635,126.913175585996
20210306,2호선,신도림,38721,38791,77512,37.5087701449787,126.891080501385
20210306,2호선,신림,47598,45867,93465,37.4841196518392,126.928712092948
20210306,2호선,신설동,3171,2982,6153,37.5762451837487,127.023278761358
20210306,2호선,신정네거리,6778,7033,13811,37.5197975266787,126.852991645059
20210306,2호선,신촌,28446,28611,57057,37.5554417865984,126.936119192554
20210306,2호선,아현,7063,6788,13851,37.5573575723061,126.95603374504
20210306,2호선,양천구청,4102,4177,8279,37.5126989358446,126.866065211751
20210306,2호선,역삼,18223,19875,38098,37.5007162693593,127.036618203089
20210306,2호선,영등포구청,11560,11890,23450,37.5256996614804,126.896626898379
20210306,2호선,왕십리,12953,11092,24045,37.5612217415191,127.036655378283
20210306,2호선,용답,2001,1949,3950,37.5620049052662,127.050729309179
20210306,2호선,용두,1614,1653,3267,37.5739380503267,127.038031119837
20210306,2호선,을지로3가,9458,9209,18667,37.56626594615,126.990308356253
20210306,2호선,을지로4가,6775,7060,13835,37.5666369941572,126.997852780281
20210306,2호선,을지로입구,19378,18578,37956,37.5660509513873,126.982372901787
20210306,2호선,이대,9199,9540,18739,37.5567980142044,126.945758201019
20210306,2호선,잠실,55515,52895,108410,37.513859279255,127.101857941447
20210306,2호선,잠실나루,6754,6818,13572,37.5206867318088,127.103811089444
20210306,2호선,잠실새내,15764,16317,32081,37.5115672093323,127.086373867207
20210306,2호선,종합운동장,4550,4902,9452,37.5109692748993,127.073356018706
20210306,2호선,충정로,5528,5859,11387,37.5598377952439,126.964474043785
20210306,2호선,한양대,3975,4051,8026,37.55557788354,127.043584493543
20210306,2호선,합정,26142,28195,54337,37.5501152068908,126.914638180431
20210306,2호선,홍대입구,58451,61417,119868,37.5577458058734,126.926498328277
20210307,2호선,강남,33301,31925,65226,37.4981646510326,127.028307900881
20210307,2호선,강변,17960,18237,36197,37.5351692767888,127.094664569096
20210307,2호선,건대입구,24060,24506,48566,37.5404188872176,127.069173281554
20210307,2호선,교대,9588,10722,20310,37.4928178646055,127.013838469407
20210307,2호선,구로디지털단지,21955,21273,43228,37.4853149237865,126.901494378412
20210307,2호선,구의,10640,10600,21240,37.5371535596228,127.086179228767
20210307,2호선,낙성대,14974,15156,30130,37.4770651843603,126.963409959152
20210307,2호선,당산,8301,8963,17264,37.534956866618,126.90273071003
20210307,2호선,대림,13825,14019,27844,37.4933105886136,126.8949461878
20210307,2호선,도림천,400,455,855,37.5144420510515,126.882702584468
20210307,2호선,동대문역사문화공원,6932,8542,15474,37.5655895229776,127.009131498424
20210307,2호선,뚝섬,9109,9147,18256,37.5471882244091,127.047365178682
20210307,2호선,문래,7439,7629,15068,37.5179214637526,126.894763060556
20210307,2호선,방배,6204,6657,12861,37.4814364876589,126.997694899327
20210307,2호선,봉천,11313,11086,22399,37.4825562153548,126.941495272047
20210307,2호선,사당,19272,21512,40784,37.4765228347619,126.981408909449
20210307,2호선,삼성,20312,19908,40220,37.5088619974404,127.063073009788
20210307,2호선,상왕십리,6541,6268,12809,37.5644687111181,127.029031221392
20210307,2호선,서울대입구,25956,26463,52419,37.4811526631844,126.952645104944
20210307,2호선,서초,9491,8951,18442,37.4918229990093,127.007580814715
20210307,2호선,선릉,12067,10494,22561,37.5045028775835,127.048942471228
20210307,2호선,성수,11311,12533,23844,37.5445023983984,127.056090471223
20210307,2호선,시청,5086,4200,9286,37.5654385176408,126.976983237511
20210307,2호선,신답,722,716,1438,37.5699910562183,127.046820203556
20210307,2호선,신당,7917,8399,16316,37.5656540317328,127.019540574485
20210307,2호선,신대방,13762,13665,27427,37.4875759745635,126.913175585996
20210307,2호선,신도림,26319,26215,52534,37.5087701449787,126.891080501385
20210307,2호선,신림,34161,33073,67234,37.4841196518392,126.928712092948
20210307,2호선,신설동,2870,2889,5759,37.5762451837487,127.023278761358
20210307,2호선,신정네거리,4690,4849,9539,37.5197975266787,126.852991645059
20210307,2호선,신촌,20516,19659,40175,37.5554417865984,126.936119192554
20210307,2호선,아현,4674,4786,9460,37.5573575723061,126.95603374504
20210307,2호선,양천구청,2890,3022,5912,37.5126989358446,126.866065211751
20210307,2호선,역삼,10440,11618,22058,37.5007162693593,127.036618203089
20210307,2호선,영등포구청,7257,7444,14701,37.5256996614804,126.896626898379
20210307,2호선,왕십리,8917,7869,16786,37.5612217415191,127.036655378283
20210307,2호선,용답,1563,1609,3172,37.5620049052662,127.050729309179
20210307,2호선,용두,1120,1166,2286,37.5739380503267,127.038031119837
20210307,2호선,을지로3가,6309,5867,12176,37.56626594615,126.990308356253
20210307,2호선,을지로4가,2947,2883,5830,37.5666369941572,126.997852780281
20210307,2호선,을지로입구,13906,13048,26954,37.5660509513873,126.982372901787
20210307,2호선,이대,5962,6453,12415,37.5567980142044,126.945758201019
20210307,2호선,잠실,39966,37372,77338,37.513859279255,127.101857941447
20210307,2호선,잠실나루,4657,4762,9419,37.5206867318088,127.103811089444
20210307,2호선,잠실새내,9775,10078,19853,37.5115672093323,127.086373867207
20210307,2호선,종합운동장,3407,3806,7213,37.5109692748993,127.073356018706
20210307,2호선,충정로,3587,3941,7528,37.5598377952439,126.964474043785
20210307,2호선,한양대,2211,2428,4639,37.55557788354,127.043584493543
20210307,2호선,합정,17692,18526,36218,37.5501152068908,126.914638180431
20210307,2호선,홍대입구,42483,42177,84660,37.5577458058734,126.926498328277
20210313,2호선,강남,59848,59603,119451,37.4981646510326,127.028307900881
20210313,2호선,강변,24638,25079,49717,37.5351692767888,127.094664569096
20210313,2호선,건대입구,33315,34652,67967,37.5404188872176,127.069173281554
20210313,2호선,교대,16932,18686,35618,37.4928178646055,127.013838469407
20210313,2호선,구로디지털단지,33358,33282,66640,37.4853149237865,126.901494378412
20210313,2호선,구의,15579,15149,30728,37.5371535596228,127.086179228767
20210313,2호선,낙성대,21132,19275,40407,37.4770651843603,126.963409959152
20210313,2호선,당산,12681,13433,26114,37.534956866618,126.90273071003
20210313,2호선,대림,17634,18830,36464,37.4933105886136,126.8949461878
20210313,2호선,도림천,832,822,1654,37.5144420510515,126.882702584468
20210313,2호선,동대문역사문화공원,9476,10186,19662,37.5655895229776,127.009131498424
20210313,2호선,뚝섬,13172,13534,26706,37.5471882244091,127.047365178682
20210313,2호선,문래,11436,12143,23579,37.5179214637526,126.894763060556
20210313,2호선,방배,9731,9830,19561,37.4814364876589,126.997694899327
20210313,2호선,봉천,16934,15641,32575,37.4825562153548,126.941495272047
20210313,2호선,사당,28554,31504,60058,37.4765228347619,126.981408909449
20210313,2호선,삼성,27236,27107,54343,37.5088619974404,127.063073009788
20210313,2호선,상왕십리,9368,8832,18200,37.5644687111181,127.029031221392
20210313,2호선,서울대입구,37302,36692,73994,37.4811526631844,126.952645104944
20210313,2호선,서초,9904,8585,18489,37.4918229990093,127.007580814715
20210313,2호선,선릉,23357,20937,44294,37.5045028775835,127.048942471228
20210313,2호선,성수,17559,19767,37326,37.5445023983984,127.056090471223
20210313,2호선,시청,7978,6957,14935,37.5654385176408,126.976983237511
20210313,2호선,신답,1013,1070,2083,37.5699910562183,127.046820203556
20210313,2호선,신당,10639,10947,21586,37.5656540317328,127.019540574485
20210313,2호선,신대방,19115,18528,37643,37.4875759745635,126.913175585996
20210313,2호선,신도림,39780,39769,79549,37.5087701449787,126.891080501385
20210313,2호선,신림,49382,46983,96365,37.4841196518392,126.928712092948
20210313,2호선,신설동,3132,3006,6138,37.5762451837487,127.023278761358
20210313,2호선,신정네거리,6821,7100,13921,37.5197975266787,126.852991645059
20210313,2호선,신촌,28795,28890,57685,37.5554417865984,126.936119192554
20210313,2호선,아현,7304,6981,14285,37.5573575723061,126.95603374504
20210313,2호선,양천구청,4758,4706,9464,37.5126989358446,126.866065211751
20210313,2호선,역삼,18245,20020,38265,37.5007162693593,127.036618203089
20210313,2호선,영등포구청,12285,12513,24798,37.5256996614804,126.896626898379
20210313,2호선,왕십리,13532,11622,25154,37.5612217415191,127.036655378283
20210313,2호선,용답,2091,2032,4123,37.5620049052662,127.050729309179
20210313,2호선,용두,1747,1660,3407,37.5739380503267,127.038031119837
20210313,2호선,을지로3가,9761,9469,19230,37.56626594615,126.990308356253
20210313,2호선,을지로4가,6867,7203,14070,37.5666369941572,126.997852780281
20210313,2호선,을지로입구,19760,19296,39056,37.5660509513873,126.982372901787
20210313,2호선,이대,9339,9811,19150,37.5567980142044,126.945758201019
20210313,2호선,잠실,57842,54807,112649,37.513859279255,127.101857941447
20210313,2호선,잠실나루,7620,7422,15042,37.5206867318088,127.103811089444
20210313,2호선,잠실새내,15590,16448,32038,37.5115672093323,127.086373867207
20210313,2호선,종합운동장,4470,4870,9340,37.5109692748993,127.073356018706
20210313,2호선,충정로,5379,5637,11016,37.5598377952439,126.964474043785
20210313,2호선,한양대,4484,4602,9086,37.55557788354,127.043584493543
20210313,2호선,합정,26517,28823,55340,37.5501152068908,126.914638180431
20210313,2호선,홍대입구,59481,64133,123614,37.5577458058734,126.926498328277
20210314,2호선,강남,33791,32573,66364,37.4981646510326,127.028307900881
20210314,2호선,강변,19318,19194,38512,37.5351692767888,127.094664569096
20210314,2호선,건대입구,24420,25097,49517,37.5404188872176,127.069173281554
20210314,2호선,교대,9682,10610,20292,37.4928178646055,127.013838469407
20210314,2호선,구로디지털단지,22322,22004,44326,37.4853149237865,126.901494378412
20210314,2호선,구의,10646,10718,21364,37.5371535596228,127.086179228767
20210314,2호선,낙성대,14987,15337,30324,37.4770651843603,126.963409959152
20210314,2호선,당산,8068,8735,16803,37.534956866618,126.90273071003
20210314,2호선,대림,13819,14241,28060,37.4933105886136,126.8949461878
20210314,2호선,도림천,473,458,931,37.5144420510515,126.882702584468
20210314,2호선,동대문역사문화공원,6567,8009,14576,37.5655895229776,127.009131498424
20210314,2호선,뚝섬,8694,9317,18011,37.5471882244091,127.047365178682
20210314,2호선,문래,6898,7211,14109,37.5179214637526,126.894763060556
20210314,2호선,방배,6389,6781,13170,37.4814364876589,126.997694899327
20210314,2호선,봉천,11328,11080,22408,37.4825562153548,126.941495272047
20210314,2호선,사당,19066,21489,40555,37.4765228347619,126.981408909449
20210314,2호선,삼성,19040,18377,37417,37.5088619974404,127.063073009788
20210314,2호선,상왕십리,6559,6370,12929,37.5644687111181,127.029031221392
20210314,2호선,서울대입구,26608,27343,53951,37.4811526631844,126.952645104944
20210314,2호선,서초,9369,8745,18114,37.4918229990093,127.007580814715
20210314,2호선,선릉,12274,10751,23025,37.5045028775835,127.048942471228
20210314,2호선,성수,11566,13027,24593,37.5445023983984,127.056090471223
20210314,2호선,시청,5113,4261,9374,37.5654385176408,126.976983237511
20210314,2호선,신답,673,762,1435,37.5699910562183,127.046820203556
20210314,2호선,신당,7691,8125,15816,37.5656540317328,127.019540574485
20210314,2호선,신대방,13941,13718,27659,37.4875759745635,126.913175585996
20210314,2호선,신도림,27174,27243,54417,37.5087701449787,126.891080501385
20210314,2호선,신림,34807,34430,69237,37.4841196518392,126.928712092948
20210314,2호선,신설동,2850,2787,5637,37.5762451837487,127.023278761358
20210314,2호선,신정네거리,4843,4760,9603,37.5197975266787,126.852991645059
20210314,2호선,신촌,20931,20243,41174,37.5554417865984,126.936119192554
20210314,2호선,아현,4691,4834,9525,37.5573575723061,126.95603374504
20210314,2호선,양천구청,3013,3100,6113,37.5126989358446,126.866065211751
20210314,2호선,역삼,11014,12118,23132,37.5007162693593,127.036618203089
20210314,2호선,영등포구청,7397,7528,14925,37.5256996614804,126.896626898379
20210314,2호선,왕십리,8604,7506,16110,37.5612217415191,127.036655378283
20210314,2호선,용답,1543,1684,3227,37.5620049052662,127.050729309179
20210314,2호선,용두,984,959,1943,37.5739380503267,127.038031119837
20210314,2호선,을지로3가,6588,6019,12607,37.56626594615,126.990308356253
20210314,2호선,을지로4가,2935,2779,5714,37.5666369941572,126.997852780281
20210314,2호선,을지로입구,14047,13305,27352,37.5660509513873,126.982372901787
20210314,2호선,이대,6193,6562,12755,37.5567980142044,126.945758201019
20210314,2호선,잠실,40886,37801,78687,37.513859279255,127.101857941447
20210314,2호선,잠실나루,4724,4793,9517,37.5206867318088,127.103811089444
20210314,2호선,잠실새내,9967,10467,20434,37.5115672093323,127.086373867207
20210314,2호선,종합운동장,3688,4126,7814,37.5109692748993,127.073356018706
20210314,2호선,충정로,3624,3779,7403,37.5598377952439,126.964474043785
20210314,2호선,한양대,2178,2430,4608,37.55557788354,127.043584493543
20210314,2호선,합정,18005,19163,37168,37.5501152068908,126.914638180431
20210314,2호선,홍대입구,43930,43360,87290,37.5577458058734,126.926498328277
20210320,2호선,강남,59408,58252,117660,37.4981646510326,127.028307900881
20210320,2호선,강변,23186,23367,46553,37.5351692767888,127.094664569096
20210320,2호선,건대입구,30222,31891,62113,37.5404188872176,127.069173281554
20210320,2호선,교대,16234,17942,34176,37.4928178646055,127.013838469407
20210320,2호선,구로디지털단지,31924,31765,63689,37.4853149237865,126.901494378412
20210320,2호선,구의,14874,14611,29485,37.5371535596228,127.086179228767
20210320,2호선,낙성대,19508,17868,37376,37.4770651843603,126.963409959152
20210320,2호선,당산,10985,12202,23187,37.534956866618,126.90273071003
20210320,2호선,대림,16384,17630,34014,37.4933105886136,126.8949461878
20210320,2호선,도림천,733,734,1467,37.5144420510515,126.882702584468
20210320,2호선,동대문역사문화공원,8716,9256,17972,37.5655895229776,127.009131498424
20210320,2호선,뚝섬,11006,11442,22448,37.5471882244091,127.047365178682
20210320,2호선,문래,10873,11561,22434,37.5179214637526,126.894763060556
20210320,2호선,방배,9415,9689,19104,37.4814364876589,126.997694899327
20210320,2호선,봉천,15657,14448,30105,37.4825562153548,126.941495272047
20210320,2호선,사당,26370,28941,55311,37.4765228347619,126.981408909449
20210320,2호선,삼성,29590,30542,60132,37.5088619974404,127.063073009788
20210320,2호선,상왕십리,8971,8414,17385,37.5644687111181,127.029031221392
20210320,2호선,서울대입구,34637,33703,68340,37.4811526631844,126.952645104944
20210320,2호선,서초,9781,8420,18201,37.4918229990093,127.007580814715
20210320,2호선,선릉,22128,19827,41955,37.5045028775835,127.048942471228
20210320,2호선,성수,16117,17817,33934,37.5445023983984,127.056090471223
20210320,2호선,시청,7538,6795,14333,37.5654385176408,126.976983237511
20210320,2호선,신답,846,945,1791,37.5699910562183,127.046820203556
20210320,2호선,신당,9665,9931,19596,37.5656540317328,127.019540574485
20210320,2호선,신대방,17828,17272,35100,37.4875759745635,126.913175585996
20210320,2호선,신도림,36919,36929,73848,37.5087701449787,126.891080501385
20210320,2호선,신림,45755,42805,88560,37.4841196518392,126.928712092948
20210320,2호선,신설동,2443,2374,4817,37.5762451837487,127.023278761358
20210320,2호선,신정네거리,6425,6648,13073,37.5197975266787,126.852991645059
20210320,2호선,신촌,27810,27936,55746,37.5554417865984,126.936119192554
20210320,2호선,아현,6773,6529,13302,37.5573575723061,126.95603374504
20210320,2호선,양천구청,3962,4059,8021,37.5126989358446,126.866065211751
20210320,2호선,역삼,18766,20351,39117,37.5007162693593,127.036618203089
20210320,2호선,영등포구청,12197,12299,24496,37.5256996614804,126.896626898379
20210320,2호선,왕십리,12504,10726,23230,37.5612217415191,127.036655378283
20210320,2호선,용답,1859,1783,3642,37.5620049052662,127.050729309179
20210320,2호선,용두,1509,1556,3065,37.5739380503267,127.038031119837
20210320,2호선,을지로3가,9196,9017,18213,37.56626594615,126.990308356253
20210320,2호선,을지로4가,6365,6265,12630,37.5666369941572,126.997852780281
20210320,2호선,을지로입구,18200,17946,36146,37.5660509513873,126.982372901787
20210320,2호선,이대,8975,9116,18091,37.5567980142044,126.945758201019
20210320,2호선,잠실,54613,52258,106871,37.513859279255,127.101857941447
20210320,2호선,잠실나루,6444,6200,12644,37.5206867318088,127.103811089444
20210320,2호선,잠실새내,15090,15869,30959,37.5115672093323,127.086373867207
20210320,2호선,종합운동장,4184,4720,8904,37.5109692748993,127.073356018706
20210320,2호선,충정로,5094,5447,10541,37.5598377952439,126.964474043785
20210320,2호선,한양대,3767,3823,7590,37.55557788354,127.043584493543
20210320,2호선,합정,24437,26346,50783,37.5501152068908,126.914638180431
20210320,2호선,홍대입구,53907,58015,111922,37.5577458058734,126.926498328277
20210321,2호선,강남,34376,33107,67483,37.4981646510326,127.028307900881
20210321,2호선,강변,19310,19229,38539,37.5351692767888,127.094664569096
20210321,2호선,건대입구,25481,25766,51247,37.5404188872176,127.069173281554
20210321,2호선,교대,9908,11141,21049,37.4928178646055,127.013838469407
20210321,2호선,구로디지털단지,22863,22496,45359,37.4853149237865,126.901494378412
20210321,2호선,구의,10460,10573,21033,37.5371535596228,127.086179228767
20210321,2호선,낙성대,14959,15621,30580,37.4770651843603,126.963409959152
20210321,2호선,당산,8068,9032,17100,37.534956866618,126.90273071003
20210321,2호선,대림,13829,14188,28017,37.4933105886136,126.8949461878
20210321,2호선,도림천,463,499,962,37.5144420510515,126.882702584468
20210321,2호선,동대문역사문화공원,6401,7707,14108,37.5655895229776,127.009131498424
20210321,2호선,뚝섬,8549,9094,17643,37.5471882244091,127.047365178682
20210321,2호선,문래,7109,7370,14479,37.5179214637526,126.894763060556
20210321,2호선,방배,6429,6834,13263,37.4814364876589,126.997694899327
20210321,2호선,봉천,11832,11328,23160,37.4825562153548,126.941495272047
20210321,2호선,사당,20072,22047,42119,37.4765228347619,126.981408909449
20210321,2호선,삼성,20972,20642,41614,37.5088619974404,127.063073009788
20210321,2호선,상왕십리,6446,6354,12800,37.5644687111181,127.029031221392
20210321,2호선,서울대입구,26340,27113,53453,37.4811526631844,126.952645104944
20210321,2호선,서초,9908,9208,19116,37.4918229990093,127.007580814715
20210321,2호선,선릉,12219,10869,23088,37.5045028775835,127.048942471228
20210321,2호선,성수,12169,13283,25452,37.5445023983984,127.056090471223
20210321,2호선,시청,5205,4214,9419,37.5654385176408,126.976983237511
20210321,2호선,신답,702,765,1467,37.5699910562183,127.046820203556
20210321,2호선,신당,7587,8003,15590,37.5656540317328,127.019540574485
20210321,2호선,신대방,14155,14141,28296,37.4875759745635,126.913175585996
20210321,2호선,신도림,26615,26772,53387,37.5087701449787,126.891080501385
20210321,2호선,신림,34889,34177,69066,37.4841196518392,126.928712092948
20210321,2호선,신설동,2953,2814,5767,37.5762451837487,127.023278761358
20210321,2호선,신정네거리,4802,4879,9681,37.5197975266787,126.852991645059
20210321,2호선,신촌,21696,20859,42555,37.5554417865984,126.936119192554
20210321,2호선,아현,4750,4894,9644,37.5573575723061,126.95603374504
20210321,2호선,양천구청,3039,3151,6190,37.5126989358446,126.866065211751
20210321,2호선,역삼,11626,12396,24022,37.5007162693593,127.036618203089
20210321,2호선,영등포구청,8239,8428,16667,37.5256996614804,126.896626898379
20210321,2호선,왕십리,8911,7755,16666,37.5612217415191,127.036655378283
20210321,2호선,용답,1596,1669,3265,37.5620049052662,127.050729309179
20210321,2호선,용두,1129,1126,2255,37.5739380503267,127.038031119837
20210321,2호선,을지로3가,6617,6047,12664,37.56626594615,126.990308356253
20210321,2호선,을지로4가,2975,2834,5809,37.5666369941572,126.997852780281
20210321,2호선,을지로입구,13823,12986,26809,37.5660509513873,126.982372901787
20210321,2호선,이대,6346,6795,13141,37.5567980142044,126.945758201019
20210321,2호선,잠실,42409,39373,81782,37.513859279255,127.101857941447
20210321,2호선,잠실나루,5367,5509,10876,37.5206867318088,127.103811089444
20210321,2호선,잠실새내,9963,10237,20200,37.5115672093323,127.086373867207
20210321,2호선,종합운동장,3630,4129,7759,37.5109692748993,127.073356018706
20210321,2호선,충정로,3582,3800,7382,37.5598377952439,126.964474043785
20210321,2호선,한양대,2454,2636,5090,37.55557788354,127.043584493543
20210321,2호선,합정,18723,19851,38574,37.5501152068908,126.914638180431
20210321,2호선,홍대입구,45513,44339,89852,37.5577458058734,126.926498328277
20210327,2호선,강남,58994,57950,116944,37.4981646510326,127.028307900881
20210327,2호선,강변,23234,23658,46892,37.5351692767888,127.094664569096
20210327,2호선,건대입구,30071,31422,61493,37.5404188872176,127.069173281554
20210327,2호선,교대,16135,17815,33950,37.4928178646055,127.013838469407
20210327,2호선,구로디지털단지,31733,31574,63307,37.4853149237865,126.901494378412
20210327,2호선,구의,14727,14626,29353,37.5371535596228,127.086179228767
20210327,2호선,낙성대,19418,18074,37492,37.4770651843603,126.963409959152
20210327,2호선,당산,10757,12162,22919,37.534956866618,126.90273071003
20210327,2호선,대림,16075,17095,33170,37.4933105886136,126.8949461878
20210327,2호선,도림천,781,735,1516,37.5144420510515,126.882702584468
20210327,2호선,동대문역사문화공원,8675,9579,18254,37.5655895229776,127.009131498424
20210327,2호선,뚝섬,11234,11439,22673,37.5471882244091,127.047365178682
20210327,2호선,문래,10801,11249,22050,37.5179214637526,126.894763060556
20210327,2호선,방배,9307,9511,18818,37.4814364876589,126.997694899327
20210327,2호선,봉천,15704,14656,30360,37.4825562153548,126.941495272047
20210327,2호선,사당,26439,28947,55386,37.4765228347619,126.981408909449
20210327,2호선,삼성,28502,28704,57206,37.5088619974404,127.063073009788
20210327,2호선,상왕십리,9064,8580,17644,37.5644687111181,127.029031221392
20210327,2호선,서울대입구,34618,33042,67660,37.4811526631844,126.952645104944
20210327,2호선,서초,10079,8736,18815,37.4918229990093,127.007580814715
20210327,2호선,선릉,22528,20323,42851,37.5045028775835,127.048942471228
20210327,2호선,성수,15429,16793,32222,37.5445023983984,127.056090471223
20210327,2호선,시청,7621,6427,14048,37.5654385176408,126.976983237511
20210327,2호선,신답,910,935,1845,37.5699910562183,127.046820203556
20210327,2호선,신당,9756,10230,19986,37.5656540317328,127.019540574485
20210327,2호선,신대방,17782,17445,35227,37.4875759745635,126.913175585996
20210327,2호선,신도림,37784,38077,75861,37.5087701449787,126.891080501385
20210327,2호선,신림,45280,43400,88680,37.4841196518392,126.928712092948
20210327,2호선,신설동,2601,2534,5135,37.5762451837487,127.023278761358
20210327,2호선,신정네거리,6677,6811,13488,37.5197975266787,126.852991645059
20210327,2호선,신촌,27702,28000,55702,37.5554417865984,126.936119192554
20210327,2호선,아현,6874,6647,13521,37.5573575723061,126.95603374504
20210327,2호선,양천구청,3957,4237,8194,37.5126989358446,126.866065211751
20210327,2호선,역삼,19437,20718,40155,37.5007162693593,127.036618203089
20210327,2호선,영등포구청,11857,12280,24137,37.5256996614804,126.896626898379
20210327,2호선,왕십리,12665,10745,23410,37.5612217415191,127.036655378283
20210327,2호선,용답,1930,1890,3820,37.5620049052662,127.050729309179
20210327,2호선,용두,1476,1524,3000,37.5739380503267,127.038031119837
20210327,2호선,을지로3가,8933,8804,17737,37.56626594615,126.990308356253
20210327,2호선,을지로4가,6252,6418,12670,37.5666369941572,126.997852780281
20210327,2호선,을지로입구,17999,17922,35921,37.5660509513873,126.982372901787
20210327,2호선,이대,9030,9277,18307,37.5567980142044,126.945758201019
20210327,2호선,잠실,54645,52199,106844,37.513859279255,127.101857941447
20210327,2호선,잠실나루,6650,6536,13186,37.5206867318088,127.103811089444
20210327,2호선,잠실새내,15423,15894,31317,37.5115672093323,127.086373867207
20210327,2호선,종합운동장,4373,5121,9494,37.5109692748993,127.073356018706
20210327,2호선,충정로,5109,5484,10593,37.5598377952439,126.964474043785
20210327,2호선,한양대,3275,3104,6379,37.55557788354,127.043584493543
20210327,2호선,합정,23892,25181,49073,37.5501152068908,126.914638180431
20210327,2호선,홍대입구,51026,53740,104766,37.5577458058734,126.926498328277
20210328,2호선,강남,32904,31774,64678,37.4981646510326,127.028307900881
20210328,2호선,강변,18476,18217,36693,37.5351692767888,127.094664569096
20210328,2호선,건대입구,22538,22796,45334,37.5404188872176,127.069173281554
20210328,2호선,교대,9282,10220,19502,37.4928178646055,127.013838469407
20210328,2호선,구로디지털단지,21255,20845,42100,37.4853149237865,126.901494378412
20210328,2호선,구의,9814,10135,19949,37.5371535596228,127.086179228767
20210328,2호선,낙성대,13785,14635,28420,37.4770651843603,126.963409959152
20210328,2호선,당산,7237,7698,14935,37.534956866618,126.90273071003
20210328,2호선,대림,12856,12940,25796,37.4933105886136,126.8949461878
20210328,2호선,도림천,439,461,900,37.5144420510515,126.882702584468
20210328,2호선,동대문역사문화공원,6457,7684,14141,37.5655895229776,127.009131498424
20210328,2호선,뚝섬,7287,7790,15077,37.5471882244091,127.047365178682
20210328,2호선,문래,6636,6929,13565,37.5179214637526,126.894763060556
20210328,2호선,방배,6176,6590,12766,37.4814364876589,126.997694899327
20210328,2호선,봉천,10618,10503,21121,37.4825562153548,126.941495272047
20210328,2호선,사당,17831,19643,37474,37.4765228347619,126.981408909449
20210328,2호선,삼성,19238,18949,38187,37.5088619974404,127.063073009788
20210328,2호선,상왕십리,5992,5844,11836,37.5644687111181,127.029031221392
20210328,2호선,서울대입구,23799,24395,48194,37.4811526631844,126.952645104944
20210328,2호선,서초,9117,8526,17643,37.4918229990093,127.007580814715
20210328,2호선,선릉,11854,10364,22218,37.5045028775835,127.048942471228
20210328,2호선,성수,10297,11023,21320,37.5445023983984,127.056090471223
20210328,2호선,시청,4664,3864,8528,37.5654385176408,126.976983237511
20210328,2호선,신답,582,605,1187,37.5699910562183,127.046820203556
20210328,2호선,신당,6500,7046,13546,37.5656540317328,127.019540574485
20210328,2호선,신대방,13001,13071,26072,37.4875759745635,126.913175585996
20210328,2호선,신도림,24556,24907,49463,37.5087701449787,126.891080501385
20210328,2호선,신림,32292,31927,64219,37.4841196518392,126.928712092948
20210328,2호선,신설동,2105,2248,4353,37.5762451837487,127.023278761358
20210328,2호선,신정네거리,4400,4472,8872,37.5197975266787,126.852991645059
20210328,2호선,신촌,18898,18735,37633,37.5554417865984,126.936119192554
20210328,2호선,아현,4478,4522,9000,37.5573575723061,126.95603374504
20210328,2호선,양천구청,2725,2879,5604,37.5126989358446,126.866065211751
20210328,2호선,역삼,10871,11662,22533,37.5007162693593,127.036618203089
20210328,2호선,영등포구청,6842,7014,13856,37.5256996614804,126.896626898379
20210328,2호선,왕십리,8220,7253,15473,37.5612217415191,127.036655378283
20210328,2호선,용답,1344,1395,2739,37.5620049052662,127.050729309179
20210328,2호선,용두,913,923,1836,37.5739380503267,127.038031119837
20210328,2호선,을지로3가,6144,5560,11704,37.56626594615,126.990308356253
20210328,2호선,을지로4가,2480,2530,5010,37.5666369941572,126.997852780281
20210328,2호선,을지로입구,13061,12296,25357,37.5660509513873,126.982372901787
20210328,2호선,이대,5928,6363,12291,37.5567980142044,126.945758201019
20210328,2호선,잠실,39448,36770,76218,37.513859279255,127.101857941447
20210328,2호선,잠실나루,4497,4592,9089,37.5206867318088,127.103811089444
20210328,2호선,잠실새내,9360,9595,18955,37.5115672093323,127.086373867207
20210328,2호선,종합운동장,3200,3525,6725,37.5109692748993,127.073356018706
20210328,2호선,충정로,3351,3485,6836,37.5598377952439,126.964474043785
20210328,2호선,한양대,2011,2353,4364,37.55557788354,127.043584493543
20210328,2호선,합정,16457,17162,33619,37.5501152068908,126.914638180431
20210328,2호선,홍대입구,38782,38277,77059,37.5577458058734,126.926498328277
20210403,2호선,강남,53882,53109,106991,37.4981646510326,127.028307900881
20210403,2호선,강변,21401,21484,42885,37.5351692767888,127.094664569096
20210403,2호선,건대입구,27298,28678,55976,37.5404188872176,127.069173281554
20210403,2호선,교대,14999,16695,31694,37.4928178646055,127.013838469407
20210403,2호선,구로디지털단지,28844,28847,57691,37.4853149237865,126.901494378412
20210403,2호선,구의,13570,13444,27014,37.5371535596228,127.086179228767
20210403,2호선,낙성대,18006,16911,34917,37.4770651843603,126.963409959152
20210403,2호선,당산,9672,10880,20552,37.534956866618,126.90273071003
20210403,2호선,대림,14806,16023,30829,37.4933105886136,126.8949461878
20210403,2호선,도림천,779,765,1544,37.5144420510515,126.882702584468
20210403,2호선,동대문역사문화공원,7641,8111,15752,37.5655895229776,127.009131498424
20210403,2호선,뚝섬,10160,10334,20494,37.5471882244091,127.047365178682
20210403,2호선,문래,9826,10259,20085,37.5179214637526,126.894763060556
20210403,2호선,방배,8290,8531,16821,37.4814364876589,126.997694899327
20210403,2호선,봉천,14438,13656,28094,37.4825562153548,126.941495272047
20210403,2호선,사당,24081,26316,50397,37.4765228347619,126.981408909449
20210403,2호선,삼성,27311,27421,54732,37.5088619974404,127.063073009788
20210403,2호선,상왕십리,8422,7964,16386,37.5644687111181,127.029031221392
20210403,2호선,서울대입구,31435,30109,61544,37.4811526631844,126.952645104944
20210403,2호선,서초,8918,7646,16564,37.4918229990093,127.007580814715
20210403,2호선,선릉,20764,18606,39370,37.5045028775835,127.048942471228
20210403,2호선,성수,13829,15073,28902,37.5445023983984,127.056090471223
20210403,2호선,시청,6380,5530,11910,37.5654385176408,126.976983237511
20210403,2호선,신답,748,864,1612,37.5699910562183,127.046820203556
20210403,2호선,신당,8747,9285,18032,37.5656540317328,127.019540574485
20210403,2호선,신대방,16424,16275,32699,37.4875759745635,126.913175585996
20210403,2호선,신도림,34779,34918,69697,37.5087701449787,126.891080501385
20210403,2호선,신림,41559,40081,81640,37.4841196518392,126.928712092948
20210403,2호선,신설동,2379,2266,4645,37.5762451837487,127.023278761358
20210403,2호선,신정네거리,6066,6332,12398,37.5197975266787,126.852991645059
20210403,2호선,신촌,25854,25894,51748,37.5554417865984,126.936119192554
20210403,2호선,아현,6159,5975,12134,37.5573575723061,126.95603374504
20210403,2호선,양천구청,3508,3707,7215,37.5126989358446,126.866065211751
20210403,2호선,역삼,17137,18146,35283,37.5007162693593,127.036618203089
20210403,2호선,영등포구청,10420,10440,20860,37.5256996614804,126.896626898379
20210403,2호선,왕십리,11775,9832,21607,37.5612217415191,127.036655378283
20210403,2호선,용답,1685,1611,3296,37.5620049052662,127.050729309179
20210403,2호선,용두,1387,1328,2715,37.5739380503267,127.038031119837
20210403,2호선,을지로3가,7992,8054,16046,37.56626594615,126.990308356253
20210403,2호선,을지로4가,5798,5776,11574,37.5666369941572,126.997852780281
20210403,2호선,을지로입구,16449,16466,32915,37.5660509513873,126.982372901787
20210403,2호선,이대,8102,8245,16347,37.5567980142044,126.945758201019
20210403,2호선,잠실,51663,49800,101463,37.513859279255,127.101857941447
20210403,2호선,잠실나루,6563,6444,13007,37.5206867318088,127.103811089444
20210403,2호선,잠실새내,15008,15207,30215,37.5115672093323,127.086373867207
20210403,2호선,종합운동장,3889,4531,8420,37.5109692748993,127.073356018706
20210403,2호선,충정로,4808,5041,9849,37.5598377952439,126.964474043785
20210403,2호선,한양대,3345,3326,6671,37.55557788354,127.043584493543
20210403,2호선,합정,21774,23246,45020,37.5501152068908,126.914638180431
20210403,2호선,홍대입구,45310,47709,93019,37.5577458058734,126.926498328277
20210404,2호선,강남,31950,31095,63045,37.4981646510326,127.028307900881
20210404,2호선,강변,18360,18722,37082,37.5351692767888,127.094664569096
20210404,2호선,건대입구,24271,24547,48818,37.5404188872176,127.069173281554
20210404,2호선,교대,9447,10549,19996,37.4928178646055,127.013838469407
20210404,2호선,구로디지털단지,22197,21999,44196,37.4853149237865,126.901494378412
20210404,2호선,구의,10469,10456,20925,37.5371535596228,127.086179228767
20210404,2호선,낙성대,14905,15624,30529,37.4770651843603,126.963409959152
20210404,2호선,당산,8455,9057,17512,37.534956866618,126.90273071003
20210404,2호선,대림,13920,13996,27916,37.4933105886136,126.8949461878
20210404,2호선,도림천,494,578,1072,37.5144420510515,126.882702584468
20210404,2호선,동대문역사문화공원,6347,7779,14126,37.5655895229776,127.009131498424
20210404,2호선,뚝섬,10154,9995,20149,37.5471882244091,127.047365178682
20210404,2호선,문래,6837,7087,13924,37.5179214637526,126.894763060556
20210404,2호선,방배,6496,6866,13362,37.4814364876589,126.997694899327
20210404,2호선,봉천,11384,11229,22613,37.4825562153548,126.941495272047
20210404,2호선,사당,18647,20667,39314,37.4765228347619,126.981408909449
20210404,2호선,삼성,17502,17144,34646,37.5088619974404,127.063073009788
20210404,2호선,상왕십리,6296,6316,12612,37.5644687111181,127.029031221392
20210404,2호선,서울대입구,25240,26085,51325,37.4811526631844,126.952645104944
20210404,2호선,서초,9894,9099,18993,37.4918229990093,127.007580814715
20210404,2호선,선릉,11447,10088,21535,37.5045028775835,127.048942471228
20210404,2호선,성수,11724,12720,24444,37.5445023983984,127.056090471223
20210404,2호선,시청,5240,4336,9576,37.5654385176408,126.976983237511
20210404,2호선,신답,676,704,1380,37.5699910562183,127.046820203556
20210404,2호선,신당,7327,7931,15258,37.5656540317328,127.019540574485
20210404,2호선,신대방,14275,14336,28611,37.4875759745635,126.913175585996
20210404,2호선,신도림,26488,26403,52891,37.5087701449787,126.891080501385
20210404,2호선,신림,33981,33471,67452,37.4841196518392,126.928712092948
20210404,2호선,신설동,2760,2857,5617,37.5762451837487,127.023278761358
20210404,2호선,신정네거리,4722,4844,9566,37.5197975266787,126.852991645059
20210404,2호선,신촌,19928,19835,39763,37.5554417865984,126.936119192554
20210404,2호선,아현,4732,4785,9517,37.5573575723061,126.95603374504
20210404,2호선,양천구청,2932,3032,5964,37.5126989358446,126.866065211751
20210404,2호선,역삼,9914,10699,20613,37.5007162693593,127.036618203089
20210404,2호선,영등포구청,7304,7655,14959,37.5256996614804,126.896626898379
20210404,2호선,왕십리,8770,7455,16225,37.5612217415191,127.036655378283
20210404,2호선,용답,1613,1616,3229,37.5620049052662,127.050729309179
20210404,2호선,용두,1323,1242,2565,37.5739380503267,127.038031119837
20210404,2호선,을지로3가,6613,5905,12518,37.56626594615,126.990308356253
20210404,2호선,을지로4가,2713,2674,5387,37.5666369941572,126.997852780281
20210404,2호선,을지로입구,14241,13145,27386,37.5660509513873,126.982372901787
20210404,2호선,이대,6172,6553,12725,37.5567980142044,126.945758201019
20210404,2호선,잠실,42672,39566,82238,37.513859279255,127.101857941447
20210404,2호선,잠실나루,4945,5148,10093,37.5206867318088,127.103811089444
20210404,2호선,잠실새내,10252,10410,20662,37.5115672093323,127.086373867207
20210404,2호선,종합운동장,5061,5651,10712,37.5109692748993,127.073356018706
20210404,2호선,충정로,3434,3709,7143,37.5598377952439,126.964474043785
20210404,2호선,한양대,2229,2488,4717,37.55557788354,127.043584493543
20210404,2호선,합정,18195,18825,37020,37.5501152068908,126.914638180431
20210404,2호선,홍대입구,42167,41757,83924,37.5577458058734,126.926498328277
20210410,2호선,강남,57271,57591,114862,37.4981646510326,127.028307900881
20210410,2호선,강변,24786,25902,50688,37.5351692767888,127.094664569096
20210410,2호선,건대입구,33946,34755,68701,37.5404188872176,127.069173281554
20210410,2호선,교대,16479,18456,34935,37.4928178646055,127.013838469407
20210410,2호선,구로디지털단지,33728,33076,66804,37.4853149237865,126.901494378412
20210410,2호선,구의,15654,15059,30713,37.5371535596228,127.086179228767
20210410,2호선,낙성대,20886,19454,40340,37.4770651843603,126.963409959152
20210410,2호선,당산,12832,13854,26686,37.534956866618,126.90273071003
20210410,2호선,대림,17957,19417,37374,37.4933105886136,126.8949461878
20210410,2호선,도림천,804,829,1633,37.5144420510515,126.882702584468
20210410,2호선,동대문역사문화공원,9297,9957,19254,37.5655895229776,127.009131498424
20210410,2호선,뚝섬,16287,16144,32431,37.5471882244091,127.047365178682
20210410,2호선,문래,11620,12251,23871,37.5179214637526,126.894763060556
20210410,2호선,방배,9508,9953,19461,37.4814364876589,126.997694899327
20210410,2호선,봉천,16771,15296,32067,37.4825562153548,126.941495272047
20210410,2호선,사당,28086,31192,59278,37.4765228347619,126.981408909449
20210410,2호선,삼성,27101,27455,54556,37.5088619974404,127.063073009788
20210410,2호선,상왕십리,9114,8576,17690,37.5644687111181,127.029031221392
20210410,2호선,서울대입구,36491,35314,71805,37.4811526631844,126.952645104944
20210410,2호선,서초,10760,9337,20097,37.4918229990093,127.007580814715
20210410,2호선,선릉,22748,20343,43091,37.5045028775835,127.048942471228
20210410,2호선,성수,17260,19061,36321,37.5445023983984,127.056090471223
20210410,2호선,시청,8666,7581,16247,37.5654385176408,126.976983237511
20210410,2호선,신답,1056,1080,2136,37.5699910562183,127.046820203556
20210410,2호선,신당,10490,10788,21278,37.5656540317328,127.019540574485
20210410,2호선,신대방,19621,19013,38634,37.4875759745635,126.913175585996
20210410,2호선,신도림,39154,39691,78845,37.5087701449787,126.891080501385
20210410,2호선,신림,48507,45796,94303,37.4841196518392,126.928712092948
20210410,2호선,신설동,3191,3162,6353,37.5762451837487,127.023278761358
20210410,2호선,신정네거리,7009,7085,14094,37.5197975266787,126.852991645059
20210410,2호선,신촌,27338,27597,54935,37.5554417865984,126.936119192554
20210410,2호선,아현,7211,7010,14221,37.5573575723061,126.95603374504
20210410,2호선,양천구청,4287,4378,8665,37.5126989358446,126.866065211751
20210410,2호선,역삼,18211,19559,37770,37.5007162693593,127.036618203089
20210410,2호선,영등포구청,12118,12556,24674,37.5256996614804,126.896626898379
20210410,2호선,왕십리,12903,10596,23499,37.5612217415191,127.036655378283
20210410,2호선,용답,2003,1913,3916,37.5620049052662,127.050729309179
20210410,2호선,용두,1681,1638,3319,37.5739380503267,127.038031119837
20210410,2호선,을지로3가,9339,9305,18644,37.56626594615,126.990308356253
20210410,2호선,을지로4가,6872,7032,13904,37.5666369941572,126.997852780281
20210410,2호선,을지로입구,19616,18927,38543,37.5660509513873,126.982372901787
20210410,2호선,이대,8976,9113,18089,37.5567980142044,126.945758201019
20210410,2호선,잠실,59567,56683,116250,37.513859279255,127.101857941447
20210410,2호선,잠실나루,7560,7517,15077,37.5206867318088,127.103811089444
20210410,2호선,잠실새내,15834,16444,32278,37.5115672093323,127.086373867207
20210410,2호선,종합운동장,5896,6583,12479,37.5109692748993,127.073356018706
20210410,2호선,충정로,5428,5753,11181,37.5598377952439,126.964474043785
20210410,2호선,한양대,3840,3858,7698,37.55557788354,127.043584493543
20210410,2호선,합정,26525,28155,54680,37.5501152068908,126.914638180431
20210410,2호선,홍대입구,55504,59588,115092,37.5577458058734,126.926498328277
20210411,2호선,강남,31961,31210,63171,37.4981646510326,127.028307900881
20210411,2호선,강변,20252,19350,39602,37.5351692767888,127.094664569096
20210411,2호선,건대입구,24692,24787,49479,37.5404188872176,127.069173281554
20210411,2호선,교대,9696,10649,20345,37.4928178646055,127.013838469407
20210411,2호선,구로디지털단지,22588,22461,45049,37.4853149237865,126.901494378412
20210411,2호선,구의,10728,10795,21523,37.5371535596228,127.086179228767
20210411,2호선,낙성대,14725,15330,30055,37.4770651843603,126.963409959152
20210411,2호선,당산,8868,9497,18365,37.534956866618,126.90273071003
20210411,2호선,대림,14165,14471,28636,37.4933105886136,126.8949461878
20210411,2호선,도림천,501,515,1016,37.5144420510515,126.882702584468
20210411,2호선,동대문역사문화공원,7246,8714,15960,37.5655895229776,127.009131498424
20210411,2호선,뚝섬,11611,11698,23309,37.5471882244091,127.047365178682
20210411,2호선,문래,7017,7242,14259,37.5179214637526,126.894763060556
20210411,2호선,방배,6261,6733,12994,37.4814364876589,126.997694899327
20210411,2호선,봉천,11547,11383,22930,37.4825562153548,126.941495272047
20210411,2호선,사당,19479,21981,41460,37.4765228347619,126.981408909449
20210411,2호선,삼성,18146,17763,35909,37.5088619974404,127.063073009788
20210411,2호선,상왕십리,6486,6342,12828,37.5644687111181,127.029031221392
20210411,2호선,서울대입구,25590,26628,52218,37.4811526631844,126.952645104944
20210411,2호선,서초,9677,9050,18727,37.4918229990093,127.007580814715
20210411,2호선,선릉,12248,10610,22858,37.5045028775835,127.048942471228
20210411,2호선,성수,11590,12808,24398,37.5445023983984,127.056090471223
20210411,2호선,시청,5200,4286,9486,37.5654385176408,126.976983237511
20210411,2호선,신답,659,716,1375,37.5699910562183,127.046820203556
20210411,2호선,신당,7684,8056,15740,37.5656540317328,127.019540574485
20210411,2호선,신대방,14664,14361,29025,37.4875759745635,126.913175585996
20210411,2호선,신도림,26705,26683,53388,37.5087701449787,126.891080501385
20210411,2호선,신림,34350,34202,68552,37.4841196518392,126.928712092948
20210411,2호선,신설동,2944,3008,5952,37.5762451837487,127.023278761358
20210411,2호선,신정네거리,4766,4849,9615,37.5197975266787,126.852991645059
20210411,2호선,신촌,19344,19007,38351,37.5554417865984,126.936119192554
20210411,2호선,아현,4825,4947,9772,37.5573575723061,126.95603374504
20210411,2호선,양천구청,3182,3285,6467,37.5126989358446,126.866065211751
20210411,2호선,역삼,10392,11157,21549,37.5007162693593,127.036618203089
20210411,2호선,영등포구청,7294,7574,14868,37.5256996614804,126.896626898379
20210411,2호선,왕십리,8553,7329,15882,37.5612217415191,127.036655378283
20210411,2호선,용답,1559,1544,3103,37.5620049052662,127.050729309179
20210411,2호선,용두,1076,1034,2110,37.5739380503267,127.038031119837
20210411,2호선,을지로3가,6603,5864,12467,37.56626594615,126.990308356253
20210411,2호선,을지로4가,3094,2886,5980,37.5666369941572,126.997852780281
20210411,2호선,을지로입구,13969,13138,27107,37.5660509513873,126.982372901787
20210411,2호선,이대,6084,6500,12584,37.5567980142044,126.945758201019
20210411,2호선,잠실,42232,39230,81462,37.513859279255,127.101857941447
20210411,2호선,잠실나루,4783,4907,9690,37.5206867318088,127.103811089444
20210411,2호선,잠실새내,9770,10212,19982,37.5115672093323,127.086373867207
20210411,2호선,종합운동장,4382,4902,9284,37.5109692748993,127.073356018706
20210411,2호선,충정로,3775,4115,7890,37.5598377952439,126.964474043785
20210411,2호선,한양대,2439,2720,5159,37.55557788354,127.043584493543
20210411,2호선,합정,18132,18928,37060,37.5501152068908,126.914638180431
20210411,2호선,홍대입구,40473,40225,80698,37.5577458058734,126.926498328277
20210417,2호선,강남,54726,54513,109239,37.4981646510326,127.028307900881
20210417,2호선,강변,22726,23794,46520,37.5351692767888,127.094664569096
20210417,2호선,건대입구,29756,31436,61192,37.5404188872176,127.069173281554
20210417,2호선,교대,15786,17517,33303,37.4928178646055,127.013838469407
20210417,2호선,구로디지털단지,32114,31304,63418,37.4853149237865,126.901494378412
20210417,2호선,구의,14998,14732,29730,37.5371535596228,127.086179228767
20210417,2호선,낙성대,19940,18720,38660,37.4770651843603,126.963409959152
20210417,2호선,당산,11568,12980,24548,37.534956866618,126.90273071003
20210417,2호선,대림,17704,18873,36577,37.4933105886136,126.8949461878
20210417,2호선,도림천,828,829,1657,37.5144420510515,126.882702584468
20210417,2호선,동대문역사문화공원,8654,9239,17893,37.5655895229776,127.009131498424
20210417,2호선,뚝섬,13636,13696,27332,37.5471882244091,127.047365178682
20210417,2호선,문래,11251,11872,23123,37.5179214637526,126.894763060556
20210417,2호선,방배,9128,9436,18564,37.4814364876589,126.997694899327
20210417,2호선,봉천,16243,15104,31347,37.4825562153548,126.941495272047
20210417,2호선,사당,26866,29315,56181,37.4765228347619,126.981408909449
20210417,2호선,삼성,24423,24519,48942,37.5088619974404,127.063073009788
20210417,2호선,상왕십리,9039,8607,17646,37.5644687111181,127.029031221392
20210417,2호선,서울대입구,35036,33525,68561,37.4811526631844,126.952645104944
20210417,2호선,서초,10987,8669,19656,37.4918229990093,127.007580814715
20210417,2호선,선릉,22185,19828,42013,37.5045028775835,127.048942471228
20210417,2호선,성수,16168,17659,33827,37.5445023983984,127.056090471223
20210417,2호선,시청,7526,6433,13959,37.5654385176408,126.976983237511
20210417,2호선,신답,858,989,1847,37.5699910562183,127.046820203556
20210417,2호선,신당,10191,10502,20693,37.5656540317328,127.019540574485
20210417,2호선,신대방,18958,18485,37443,37.4875759745635,126.913175585996
20210417,2호선,신도림,38373,38727,77100,37.5087701449787,126.891080501385
20210417,2호선,신림,46824,44792,91616,37.4841196518392,126.928712092948
20210417,2호선,신설동,3023,2854,5877,37.5762451837487,127.023278761358
20210417,2호선,신정네거리,6896,7023,13919,37.5197975266787,126.852991645059
20210417,2호선,신촌,25967,26158,52125,37.5554417865984,126.936119192554
20210417,2호선,아현,6849,6596,13445,37.5573575723061,126.95603374504
20210417,2호선,양천구청,4082,4263,8345,37.5126989358446,126.866065211751
20210417,2호선,역삼,18339,19606,37945,37.5007162693593,127.036618203089
20210417,2호선,영등포구청,11884,12091,23975,37.5256996614804,126.896626898379
20210417,2호선,왕십리,12436,10514,22950,37.5612217415191,127.036655378283
20210417,2호선,용답,1891,1719,3610,37.5620049052662,127.050729309179
20210417,2호선,용두,1609,1565,3174,37.5739380503267,127.038031119837
20210417,2호선,을지로3가,8853,9049,17902,37.56626594615,126.990308356253
20210417,2호선,을지로4가,6718,6678,13396,37.5666369941572,126.997852780281
20210417,2호선,을지로입구,18386,17956,36342,37.5660509513873,126.982372901787
20210417,2호선,이대,8718,8948,17666,37.5567980142044,126.945758201019
20210417,2호선,잠실,54019,51925,105944,37.513859279255,127.101857941447
20210417,2호선,잠실나루,6677,6552,13229,37.5206867318088,127.103811089444
20210417,2호선,잠실새내,15473,16084,31557,37.5115672093323,127.086373867207
20210417,2호선,종합운동장,5149,5769,10918,37.5109692748993,127.073356018706
20210417,2호선,충정로,5660,5979,11639,37.5598377952439,126.964474043785
20210417,2호선,한양대,3646,3713,7359,37.55557788354,127.043584493543
20210417,2호선,합정,24360,25797,50157,37.5501152068908,126.914638180431
20210417,2호선,홍대입구,51111,54201,105312,37.5577458058734,126.926498328277
20210418,2호선,강남,30176,28916,59092,37.4981646510326,127.028307900881
20210418,2호선,강변,18803,18379,37182,37.5351692767888,127.094664569096
20210418,2호선,건대입구,22948,23224,46172,37.5404188872176,127.069173281554
20210418,2호선,교대,9415,10396,19811,37.4928178646055,127.013838469407
20210418,2호선,구로디지털단지,21532,21268,42800,37.4853149237865,126.901494378412
20210418,2호선,구의,10604,10656,21260,37.5371535596228,127.086179228767
20210418,2호선,낙성대,14374,14883,29257,37.4770651843603,126.963409959152
20210418,2호선,당산,8255,9052,17307,37.534956866618,126.90273071003
20210418,2호선,대림,13774,14081,27855,37.4933105886136,126.8949461878
20210418,2호선,도림천,478,499,977,37.5144420510515,126.882702584468
20210418,2호선,동대문역사문화공원,6394,7714,14108,37.5655895229776,127.009131498424
20210418,2호선,뚝섬,11871,11324,23195,37.5471882244091,127.047365178682
20210418,2호선,문래,7077,7435,14512,37.5179214637526,126.894763060556
20210418,2호선,방배,6128,6525,12653,37.4814364876589,126.997694899327
20210418,2호선,봉천,11491,11196,22687,37.4825562153548,126.941495272047
20210418,2호선,사당,18773,20976,39749,37.4765228347619,126.981408909449
20210418,2호선,삼성,16773,16345,33118,37.5088619974404,127.063073009788
20210418,2호선,상왕십리,6324,6345,12669,37.5644687111181,127.029031221392
20210418,2호선,서울대입구,25088,25835,50923,37.4811526631844,126.952645104944
20210418,2호선,서초,9565,9035,18600,37.4918229990093,127.007580814715
20210418,2호선,선릉,11856,10425,22281,37.5045028775835,127.048942471228
20210418,2호선,성수,12200,12860,25060,37.5445023983984,127.056090471223
20210418,2호선,시청,5169,4064,9233,37.5654385176408,126.976983237511
20210418,2호선,신답,711,781,1492,37.5699910562183,127.046820203556
20210418,2호선,신당,7390,8055,15445,37.5656540317328,127.019540574485
20210418,2호선,신대방,14669,14665,29334,37.4875759745635,126.913175585996
20210418,2호선,신도림,26473,26497,52970,37.5087701449787,126.891080501385
20210418,2호선,신림,34142,33519,67661,37.4841196518392,126.928712092948
20210418,2호선,신설동,2861,2957,5818,37.5762451837487,127.023278761358
20210418,2호선,신정네거리,4699,4871,9570,37.5197975266787,126.852991645059
20210418,2호선,신촌,18239,17605,35844,37.5554417865984,126.936119192554
20210418,2호선,아현,4872,4859,9731,37.5573575723061,126.95603374504
20210418,2호선,양천구청,2918,3013,5931,37.5126989358446,126.866065211751
20210418,2호선,역삼,10342,11247,21589,37.5007162693593,127.036618203089
20210418,2호선,영등포구청,7663,7898,15561,37.5256996614804,126.896626898379
20210418,2호선,왕십리,8373,7030,15403,37.5612217415191,127.036655378283
20210418,2호선,용답,1461,1487,2948,37.5620049052662,127.050729309179
20210418,2호선,용두,1144,1129,2273,37.5739380503267,127.038031119837
20210418,2호선,을지로3가,6486,5687,12173,37.56626594615,126.990308356253
20210418,2호선,을지로4가,2818,2766,5584,37.5666369941572,126.997852780281
20210418,2호선,을지로입구,13761,12845,26606,37.5660509513873,126.982372901787
20210418,2호선,이대,5802,6269,12071,37.5567980142044,126.945758201019
20210418,2호선,잠실,39482,37061,76543,37.513859279255,127.101857941447
20210418,2호선,잠실나루,4656,4722,9378,37.5206867318088,127.103811089444
20210418,2호선,잠실새내,9739,9932,19671,37.5115672093323,127.086373867207
20210418,2호선,종합운동장,4100,4649,8749,37.5109692748993,127.073356018706
20210418,2호선,충정로,3554,3795,7349,37.5598377952439,126.964474043785
20210418,2호선,한양대,2030,2373,4403,37.55557788354,127.043584493543
20210418,2호선,합정,17821,18461,36282,37.5501152068908,126.914638180431
20210418,2호선,홍대입구,37447,36959,74406,37.5577458058734,126.926498328277
20210424,2호선,강남,54441,54637,109078,37.4981646510326,127.028307900881
20210424,2호선,강변,24560,25474,50034,37.5351692767888,127.094664569096
20210424,2호선,건대입구,31532,33334,64866,37.5404188872176,127.069173281554
20210424,2호선,교대,15930,17663,33593,37.4928178646055,127.013838469407
20210424,2호선,구로디지털단지,32268,31508,63776,37.4853149237865,126.901494378412
20210424,2호선,구의,14941,14456,29397,37.5371535596228,127.086179228767
20210424,2호선,낙성대,20651,18892,39543,37.4770651843603,126.963409959152
20210424,2호선,당산,12754,13550,26304,37.534956866618,126.90273071003
20210424,2호선,대림,17849,18923,36772,37.4933105886136,126.8949461878
20210424,2호선,도림천,797,777,1574,37.5144420510515,126.882702584468
20210424,2호선,동대문역사문화공원,9149,9714,18863,37.5655895229776,127.009131498424
20210424,2호선,뚝섬,15137,15382,30519,37.5471882244091,127.047365178682
20210424,2호선,문래,11582,12253,23835,37.5179214637526,126.894763060556
20210424,2호선,방배,8995,9292,18287,37.4814364876589,126.997694899327
20210424,2호선,봉천,16448,15019,31467,37.4825562153548,126.941495272047
20210424,2호선,사당,26945,29929,56874,37.4765228347619,126.981408909449
20210424,2호선,삼성,23389,23510,46899,37.5088619974404,127.063073009788
20210424,2호선,상왕십리,9159,8375,17534,37.5644687111181,127.029031221392
20210424,2호선,서울대입구,36176,34845,71021,37.4811526631844,126.952645104944
20210424,2호선,서초,9812,8489,18301,37.4918229990093,127.007580814715
20210424,2호선,선릉,22019,19593,41612,37.5045028775835,127.048942471228
20210424,2호선,성수,16320,18689,35009,37.5445023983984,127.056090471223
20210424,2호선,시청,7768,6578,14346,37.5654385176408,126.976983237511
20210424,2호선,신답,983,1027,2010,37.5699910562183,127.046820203556
20210424,2호선,신당,10431,10676,21107,37.5656540317328,127.019540574485
20210424,2호선,신대방,19366,18749,38115,37.4875759745635,126.913175585996
20210424,2호선,신도림,39284,39477,78761,37.5087701449787,126.891080501385
20210424,2호선,신림,47518,45042,92560,37.4841196518392,126.928712092948
20210424,2호선,신설동,3096,3009,6105,37.5762451837487,127.023278761358
20210424,2호선,신정네거리,6956,6945,13901,37.5197975266787,126.852991645059
20210424,2호선,신촌,26368,26835,53203,37.5554417865984,126.936119192554
20210424,2호선,아현,6993,6624,13617,37.5573575723061,126.95603374504
20210424,2호선,양천구청,4386,4380,8766,37.5126989358446,126.866065211751
20210424,2호선,역삼,17700,18999,36699,37.5007162693593,127.036618203089
20210424,2호선,영등포구청,11968,12251,24219,37.5256996614804,126.896626898379
20210424,2호선,왕십리,12566,10338,22904,37.5612217415191,127.036655378283
20210424,2호선,용답,1968,1876,3844,37.5620049052662,127.050729309179
20210424,2호선,용두,1650,1619,3269,37.5739380503267,127.038031119837
20210424,2호선,을지로3가,9728,9855,19583,37.56626594615,126.990308356253
20210424,2호선,을지로4가,6714,7003,13717,37.5666369941572,126.997852780281
20210424,2호선,을지로입구,18888,18649,37537,37.5660509513873,126.982372901787
20210424,2호선,이대,9065,9252,18317,37.5567980142044,126.945758201019
20210424,2호선,잠실,54554,51944,106498,37.513859279255,127.101857941447
20210424,2호선,잠실나루,7153,7092,14245,37.5206867318088,127.103811089444
20210424,2호선,잠실새내,14876,15509,30385,37.5115672093323,127.086373867207
20210424,2호선,종합운동장,5421,5896,11317,37.5109692748993,127.073356018706
20210424,2호선,충정로,5566,5880,11446,37.5598377952439,126.964474043785
20210424,2호선,한양대,4001,3978,7979,37.55557788354,127.043584493543
20210424,2호선,합정,25233,27279,52512,37.5501152068908,126.914638180431
20210424,2호선,홍대입구,53290,57772,111062,37.5577458058734,126.926498328277
20210425,2호선,강남,30091,29319,59410,37.4981646510326,127.028307900881
20210425,2호선,강변,19338,18796,38134,37.5351692767888,127.094664569096
20210425,2호선,건대입구,23726,24037,47763,37.5404188872176,127.069173281554
20210425,2호선,교대,9493,10316,19809,37.4928178646055,127.013838469407
20210425,2호선,구로디지털단지,21148,20937,42085,37.4853149237865,126.901494378412
20210425,2호선,구의,10337,10572,20909,37.5371535596228,127.086179228767
20210425,2호선,낙성대,14702,15240,29942,37.4770651843603,126.963409959152
20210425,2호선,당산,8887,9384,18271,37.534956866618,126.90273071003
20210425,2호선,대림,14241,14280,28521,37.4933105886136,126.8949461878
20210425,2호선,도림천,440,480,920,37.5144420510515,126.882702584468
20210425,2호선,동대문역사문화공원,7318,8673,15991,37.5655895229776,127.009131498424
20210425,2호선,뚝섬,11619,11331,22950,37.5471882244091,127.047365178682
20210425,2호선,문래,6872,7300,14172,37.5179214637526,126.894763060556
20210425,2호선,방배,6044,6434,12478,37.4814364876589,126.997694899327
20210425,2호선,봉천,11708,11503,23211,37.4825562153548,126.941495272047
20210425,2호선,사당,18753,21291,40044,37.4765228347619,126.981408909449
20210425,2호선,삼성,16561,16139,32700,37.5088619974404,127.063073009788
20210425,2호선,상왕십리,6581,6424,13005,37.5644687111181,127.029031221392
20210425,2호선,서울대입구,25630,26477,52107,37.4811526631844,126.952645104944
20210425,2호선,서초,9674,9237,18911,37.4918229990093,127.007580814715
20210425,2호선,선릉,11810,10417,22227,37.5045028775835,127.048942471228
20210425,2호선,성수,11507,12886,24393,37.5445023983984,127.056090471223
20210425,2호선,시청,5120,4119,9239,37.5654385176408,126.976983237511
20210425,2호선,신답,655,723,1378,37.5699910562183,127.046820203556
20210425,2호선,신당,7914,8397,16311,37.5656540317328,127.019540574485
20210425,2호선,신대방,14463,14312,28775,37.4875759745635,126.913175585996
20210425,2호선,신도림,26059,26075,52134,37.5087701449787,126.891080501385
20210425,2호선,신림,34319,33452,67771,37.4841196518392,126.928712092948
20210425,2호선,신설동,2931,2908,5839,37.5762451837487,127.023278761358
20210425,2호선,신정네거리,4836,4840,9676,37.5197975266787,126.852991645059
20210425,2호선,신촌,18604,18478,37082,37.5554417865984,126.936119192554
20210425,2호선,아현,4796,4825,9621,37.5573575723061,126.95603374504
20210425,2호선,양천구청,3027,3120,6147,37.5126989358446,126.866065211751
20210425,2호선,역삼,10259,11358,21617,37.5007162693593,127.036618203089
20210425,2호선,영등포구청,7095,7476,14571,37.5256996614804,126.896626898379
20210425,2호선,왕십리,8453,7259,15712,37.5612217415191,127.036655378283
20210425,2호선,용답,1522,1515,3037,37.5620049052662,127.050729309179
20210425,2호선,용두,1054,1028,2082,37.5739380503267,127.038031119837
20210425,2호선,을지로3가,6673,6122,12795,37.56626594615,126.990308356253
20210425,2호선,을지로4가,3072,2947,6019,37.5666369941572,126.997852780281
20210425,2호선,을지로입구,13986,12977,26963,37.5660509513873,126.982372901787
20210425,2호선,이대,6044,6531,12575,37.5567980142044,126.945758201019
20210425,2호선,잠실,40132,37095,77227,37.513859279255,127.101857941447
20210425,2호선,잠실나루,4728,4846,9574,37.5206867318088,127.103811089444
20210425,2호선,잠실새내,10002,10184,20186,37.5115672093323,127.086373867207
20210425,2호선,종합운동장,4561,5059,9620,37.5109692748993,127.073356018706
20210425,2호선,충정로,3378,3661,7039,37.5598377952439,126.964474043785
20210425,2호선,한양대,2501,2715,5216,37.55557788354,127.043584493543
20210425,2호선,합정,17265,18341,35606,37.5501152068908,126.914638180431
20210425,2호선,홍대입구,38718,38931,77649,37.5577458058734,126.926498328277
20210501,2호선,강남,51837,50791,102628,37.4981646510326,127.028307900881
20210501,2호선,강변,23363,24802,48165,37.5351692767888,127.094664569096
20210501,2호선,건대입구,30565,31928,62493,37.5404188872176,127.069173281554
20210501,2호선,교대,14843,16632,31475,37.4928178646055,127.013838469407
20210501,2호선,구로디지털단지,29607,28754,58361,37.4853149237865,126.901494378412
20210501,2호선,구의,14184,13855,28039,37.5371535596228,127.086179228767
20210501,2호선,낙성대,18771,17665,36436,37.4770651843603,126.963409959152
20210501,2호선,당산,10871,11926,22797,37.534956866618,126.90273071003
20210501,2호선,대림,16474,17654,34128,37.4933105886136,126.8949461878
20210501,2호선,도림천,656,686,1342,37.5144420510515,126.882702584468
20210501,2호선,동대문역사문화공원,9182,9565,18747,37.5655895229776,127.009131498424
20210501,2호선,뚝섬,11703,11781,23484,37.5471882244091,127.047365178682
20210501,2호선,문래,10628,11187,21815,37.5179214637526,126.894763060556
20210501,2호선,방배,8794,9217,18011,37.4814364876589,126.997694899327
20210501,2호선,봉천,15145,14257,29402,37.4825562153548,126.941495272047
20210501,2호선,사당,25293,27730,53023,37.4765228347619,126.981408909449
20210501,2호선,삼성,29119,28967,58086,37.5088619974404,127.063073009788
20210501,2호선,상왕십리,8640,8027,16667,37.5644687111181,127.029031221392
20210501,2호선,서울대입구,33592,32178,65770,37.4811526631844,126.952645104944
20210501,2호선,서초,10236,8890,19126,37.4918229990093,127.007580814715
20210501,2호선,선릉,20328,18438,38766,37.5045028775835,127.048942471228
20210501,2호선,성수,15048,16651,31699,37.5445023983984,127.056090471223
20210501,2호선,시청,6905,5907,12812,37.5654385176408,126.976983237511
20210501,2호선,신답,862,920,1782,37.5699910562183,127.046820203556
20210501,2호선,신당,9731,10064,19795,37.5656540317328,127.019540574485
20210501,2호선,신대방,17657,17251,34908,37.4875759745635,126.913175585996
20210501,2호선,신도림,37580,37900,75480,37.5087701449787,126.891080501385
20210501,2호선,신림,44694,42146,86840,37.4841196518392,126.928712092948
20210501,2호선,신설동,2989,2727,5716,37.5762451837487,127.023278761358
20210501,2호선,신정네거리,6788,6700,13488,37.5197975266787,126.852991645059
20210501,2호선,신촌,27123,27003,54126,37.5554417865984,126.936119192554
20210501,2호선,아현,6500,6272,12772,37.5573575723061,126.95603374504
20210501,2호선,양천구청,3902,4004,7906,37.5126989358446,126.866065211751
20210501,2호선,역삼,16362,17570,33932,37.5007162693593,127.036618203089
20210501,2호선,영등포구청,11203,11458,22661,37.5256996614804,126.896626898379
20210501,2호선,왕십리,11695,10140,21835,37.5612217415191,127.036655378283
20210501,2호선,용답,1866,1758,3624,37.5620049052662,127.050729309179
20210501,2호선,용두,1566,1527,3093,37.5739380503267,127.038031119837
20210501,2호선,을지로3가,9184,9131,18315,37.56626594615,126.990308356253
20210501,2호선,을지로4가,6097,6223,12320,37.5666369941572,126.997852780281
20210501,2호선,을지로입구,18137,17849,35986,37.5660509513873,126.982372901787
20210501,2호선,이대,8526,8745,17271,37.5567980142044,126.945758201019
20210501,2호선,잠실,55405,53059,108464,37.513859279255,127.101857941447
20210501,2호선,잠실나루,6579,6598,13177,37.5206867318088,127.103811089444
20210501,2호선,잠실새내,15104,15715,30819,37.5115672093323,127.086373867207
20210501,2호선,종합운동장,5062,5516,10578,37.5109692748993,127.073356018706
20210501,2호선,충정로,5176,5656,10832,37.5598377952439,126.964474043785
20210501,2호선,한양대,3024,2921,5945,37.55557788354,127.043584493543
20210501,2호선,합정,24754,26036,50790,37.5501152068908,126.914638180431
20210501,2호선,홍대입구,57658,59726,117384,37.5577458058734,126.926498328277
20210502,2호선,강남,32515,31048,63563,37.4981646510326,127.028307900881
20210502,2호선,강변,20625,20031,40656,37.5351692767888,127.094664569096
20210502,2호선,건대입구,26225,26290,52515,37.5404188872176,127.069173281554
20210502,2호선,교대,9765,10672,20437,37.4928178646055,127.013838469407
20210502,2호선,구로디지털단지,22087,21642,43729,37.4853149237865,126.901494378412
20210502,2호선,구의,10732,10698,21430,37.5371535596228,127.086179228767
20210502,2호선,낙성대,14984,15306,30290,37.4770651843603,126.963409959152
20210502,2호선,당산,8902,9446,18348,37.534956866618,126.90273071003
20210502,2호선,대림,14416,14636,29052,37.4933105886136,126.8949461878
20210502,2호선,도림천,490,492,982,37.5144420510515,126.882702584468
20210502,2호선,동대문역사문화공원,6778,8042,14820,37.5655895229776,127.009131498424
20210502,2호선,뚝섬,11482,11378,22860,37.5471882244091,127.047365178682
20210502,2호선,문래,7216,7627,14843,37.5179214637526,126.894763060556
20210502,2호선,방배,6451,6996,13447,37.4814364876589,126.997694899327
20210502,2호선,봉천,11534,11317,22851,37.4825562153548,126.941495272047
20210502,2호선,사당,19060,21504,40564,37.4765228347619,126.981408909449
20210502,2호선,삼성,17751,17318,35069,37.5088619974404,127.063073009788
20210502,2호선,상왕십리,6471,6504,12975,37.5644687111181,127.029031221392
20210502,2호선,서울대입구,25640,26189,51829,37.4811526631844,126.952645104944
20210502,2호선,서초,9870,9276,19146,37.4918229990093,127.007580814715
20210502,2호선,선릉,11931,10446,22377,37.5045028775835,127.048942471228
20210502,2호선,성수,12179,13705,25884,37.5445023983984,127.056090471223
20210502,2호선,시청,5143,4300,9443,37.5654385176408,126.976983237511
20210502,2호선,신답,712,819,1531,37.5699910562183,127.046820203556
20210502,2호선,신당,7772,8452,16224,37.5656540317328,127.019540574485
20210502,2호선,신대방,14526,14257,28783,37.4875759745635,126.913175585996
20210502,2호선,신도림,26520,26734,53254,37.5087701449787,126.891080501385
20210502,2호선,신림,34610,34314,68924,37.4841196518392,126.928712092948
20210502,2호선,신설동,3030,3034,6064,37.5762451837487,127.023278761358
20210502,2호선,신정네거리,5183,5265,10448,37.5197975266787,126.852991645059
20210502,2호선,신촌,20080,19708,39788,37.5554417865984,126.936119192554
20210502,2호선,아현,4993,4991,9984,37.5573575723061,126.95603374504
20210502,2호선,양천구청,3277,3402,6679,37.5126989358446,126.866065211751
20210502,2호선,역삼,10552,11291,21843,37.5007162693593,127.036618203089
20210502,2호선,영등포구청,7489,7839,15328,37.5256996614804,126.896626898379
20210502,2호선,왕십리,8994,7746,16740,37.5612217415191,127.036655378283
20210502,2호선,용답,1664,1715,3379,37.5620049052662,127.050729309179
20210502,2호선,용두,1243,1227,2470,37.5739380503267,127.038031119837
20210502,2호선,을지로3가,7201,6455,13656,37.56626594615,126.990308356253
20210502,2호선,을지로4가,2973,2950,5923,37.5666369941572,126.997852780281
20210502,2호선,을지로입구,14496,13480,27976,37.5660509513873,126.982372901787
20210502,2호선,이대,6517,6966,13483,37.5567980142044,126.945758201019
20210502,2호선,잠실,44466,41505,85971,37.513859279255,127.101857941447
20210502,2호선,잠실나루,4814,4904,9718,37.5206867318088,127.103811089444
20210502,2호선,잠실새내,10855,11119,21974,37.5115672093323,127.086373867207
20210502,2호선,종합운동장,4855,5392,10247,37.5109692748993,127.073356018706
20210502,2호선,충정로,3407,3585,6992,37.5598377952439,126.964474043785
20210502,2호선,한양대,2295,2493,4788,37.55557788354,127.043584493543
20210502,2호선,합정,18739,19810,38549,37.5501152068908,126.914638180431
20210502,2호선,홍대입구,45763,45830,91593,37.5577458058734,126.926498328277
20210508,2호선,강남,48809,47951,96760,37.4981646510326,127.028307900881
20210508,2호선,강변,21478,24254,45732,37.5351692767888,127.094664569096
20210508,2호선,건대입구,28033,28751,56784,37.5404188872176,127.069173281554
20210508,2호선,교대,14488,16249,30737,37.4928178646055,127.013838469407
20210508,2호선,구로디지털단지,29413,28452,57865,37.4853149237865,126.901494378412
20210508,2호선,구의,13839,13427,27266,37.5371535596228,127.086179228767
20210508,2호선,낙성대,18260,16344,34604,37.4770651843603,126.963409959152
20210508,2호선,당산,10158,11028,21186,37.534956866618,126.90273071003
20210508,2호선,대림,16284,17742,34026,37.4933105886136,126.8949461878
20210508,2호선,도림천,695,763,1458,37.5144420510515,126.882702584468
20210508,2호선,동대문역사문화공원,8367,8483,16850,37.5655895229776,127.009131498424
20210508,2호선,뚝섬,11069,11108,22177,37.5471882244091,127.047365178682
20210508,2호선,문래,9664,9970,19634,37.5179214637526,126.894763060556
20210508,2호선,방배,8499,8811,17310,37.4814364876589,126.997694899327
20210508,2호선,봉천,14901,13768,28669,37.4825562153548,126.941495272047
20210508,2호선,사당,22669,25095,47764,37.4765228347619,126.981408909449
20210508,2호선,삼성,21454,21502,42956,37.5088619974404,127.063073009788
20210508,2호선,상왕십리,8300,7719,16019,37.5644687111181,127.029031221392
20210508,2호선,서울대입구,31789,29556,61345,37.4811526631844,126.952645104944
20210508,2호선,서초,8609,7193,15802,37.4918229990093,127.007580814715
20210508,2호선,선릉,19438,17034,36472,37.5045028775835,127.048942471228
20210508,2호선,성수,13643,15297,28940,37.5445023983984,127.056090471223
20210508,2호선,시청,6343,5138,11481,37.5654385176408,126.976983237511
20210508,2호선,신답,780,840,1620,37.5699910562183,127.046820203556
20210508,2호선,신당,9388,9545,18933,37.5656540317328,127.019540574485
20210508,2호선,신대방,17666,16951,34617,37.4875759745635,126.913175585996
20210508,2호선,신도림,33033,32696,65729,37.5087701449787,126.891080501385
20210508,2호선,신림,43343,40596,83939,37.4841196518392,126.928712092948
20210508,2호선,신설동,2629,2570,5199,37.5762451837487,127.023278761358
20210508,2호선,신정네거리,6318,6478,12796,37.5197975266787,126.852991645059
20210508,2호선,신촌,24080,23949,48029,37.5554417865984,126.936119192554
20210508,2호선,아현,6534,6212,12746,37.5573575723061,126.95603374504
20210508,2호선,양천구청,3981,4152,8133,37.5126989358446,126.866065211751
20210508,2호선,역삼,16180,16850,33030,37.5007162693593,127.036618203089
20210508,2호선,영등포구청,10017,10170,20187,37.5256996614804,126.896626898379
20210508,2호선,왕십리,11096,8932,20028,37.5612217415191,127.036655378283
20210508,2호선,용답,1898,1754,3652,37.5620049052662,127.050729309179
20210508,2호선,용두,1473,1415,2888,37.5739380503267,127.038031119837
20210508,2호선,을지로3가,7646,7680,15326,37.56626594615,126.990308356253
20210508,2호선,을지로4가,5526,5587,11113,37.5666369941572,126.997852780281
20210508,2호선,을지로입구,15586,15525,31111,37.5660509513873,126.982372901787
20210508,2호선,이대,8432,8288,16720,37.5567980142044,126.945758201019
20210508,2호선,잠실,49192,47232,96424,37.513859279255,127.101857941447
20210508,2호선,잠실나루,6138,6104,12242,37.5206867318088,127.103811089444
20210508,2호선,잠실새내,13665,14061,27726,37.5115672093323,127.086373867207
20210508,2호선,종합운동장,4782,5243,10025,37.5109692748993,127.073356018706
20210508,2호선,충정로,4608,4670,9278,37.5598377952439,126.964474043785
20210508,2호선,한양대,4239,3956,8195,37.55557788354,127.043584493543
20210508,2호선,합정,21199,22626,43825,37.5501152068908,126.914638180431
20210508,2호선,홍대입구,47947,50371,98318,37.5577458058734,126.926498328277
20210509,2호선,강남,32612,31654,64266,37.4981646510326,127.028307900881
20210509,2호선,강변,23069,19333,42402,37.5351692767888,127.094664569096
20210509,2호선,건대입구,25773,26377,52150,37.5404188872176,127.069173281554
20210509,2호선,교대,9968,10994,20962,37.4928178646055,127.013838469407
20210509,2호선,구로디지털단지,21471,21719,43190,37.4853149237865,126.901494378412
20210509,2호선,구의,10353,10909,21262,37.5371535596228,127.086179228767
20210509,2호선,낙성대,14034,15732,29766,37.4770651843603,126.963409959152
20210509,2호선,당산,8655,9350,18005,37.534956866618,126.90273071003
20210509,2호선,대림,14153,14470,28623,37.4933105886136,126.8949461878
20210509,2호선,도림천,471,523,994,37.5144420510515,126.882702584468
20210509,2호선,동대문역사문화공원,6706,8135,14841,37.5655895229776,127.009131498424
20210509,2호선,뚝섬,10346,11002,21348,37.5471882244091,127.047365178682
20210509,2호선,문래,6896,7401,14297,37.5179214637526,126.894763060556
20210509,2호선,방배,6299,6877,13176,37.4814364876589,126.997694899327
20210509,2호선,봉천,11220,11548,22768,37.4825562153548,126.941495272047
20210509,2호선,사당,19094,21734,40828,37.4765228347619,126.981408909449
20210509,2호선,삼성,16159,16091,32250,37.5088619974404,127.063073009788
20210509,2호선,상왕십리,6396,6579,12975,37.5644687111181,127.029031221392
20210509,2호선,서울대입구,24911,27517,52428,37.4811526631844,126.952645104944
20210509,2호선,서초,9790,9137,18927,37.4918229990093,127.007580814715
20210509,2호선,선릉,11721,10465,22186,37.5045028775835,127.048942471228
20210509,2호선,성수,11546,13223,24769,37.5445023983984,127.056090471223
20210509,2호선,시청,5037,4014,9051,37.5654385176408,126.976983237511
20210509,2호선,신답,668,727,1395,37.5699910562183,127.046820203556
20210509,2호선,신당,7419,7905,15324,37.5656540317328,127.019540574485
20210509,2호선,신대방,14118,14486,28604,37.4875759745635,126.913175585996
20210509,2호선,신도림,26089,26219,52308,37.5087701449787,126.891080501385
20210509,2호선,신림,33222,34750,67972,37.4841196518392,126.928712092948
20210509,2호선,신설동,2715,2807,5522,37.5762451837487,127.023278761358
20210509,2호선,신정네거리,4982,5029,10011,37.5197975266787,126.852991645059
20210509,2호선,신촌,19402,19935,39337,37.5554417865984,126.936119192554
20210509,2호선,아현,4863,4935,9798,37.5573575723061,126.95603374504
20210509,2호선,양천구청,3196,3250,6446,37.5126989358446,126.866065211751
20210509,2호선,역삼,10116,11298,21414,37.5007162693593,127.036618203089
20210509,2호선,영등포구청,7033,7377,14410,37.5256996614804,126.896626898379
20210509,2호선,왕십리,8546,7706,16252,37.5612217415191,127.036655378283
20210509,2호선,용답,1532,1611,3143,37.5620049052662,127.050729309179
20210509,2호선,용두,955,973,1928,37.5739380503267,127.038031119837
20210509,2호선,을지로3가,6617,6283,12900,37.56626594615,126.990308356253
20210509,2호선,을지로4가,2843,2772,5615,37.5666369941572,126.997852780281
20210509,2호선,을지로입구,13043,12356,25399,37.5660509513873,126.982372901787
20210509,2호선,이대,6107,7028,13135,37.5567980142044,126.945758201019
20210509,2호선,잠실,43228,39519,82747,37.513859279255,127.101857941447
20210509,2호선,잠실나루,5019,5162,10181,37.5206867318088,127.103811089444
20210509,2호선,잠실새내,10404,10886,21290,37.5115672093323,127.086373867207
20210509,2호선,종합운동장,5154,5599,10753,37.5109692748993,127.073356018706
20210509,2호선,충정로,3166,3429,6595,37.5598377952439,126.964474043785
20210509,2호선,한양대,2109,2392,4501,37.55557788354,127.043584493543
20210509,2호선,합정,17873,19468,37341,37.5501152068908,126.914638180431
20210509,2호선,홍대입구,44273,45515,89788,37.5577458058734,126.926498328277
20210515,2호선,강남,59335,58005,117340,37.4981646510326,127.028307900881
20210515,2호선,강변,24377,24643,49020,37.5351692767888,127.094664569096
20210515,2호선,건대입구,31600,33488,65088,37.5404188872176,127.069173281554
20210515,2호선,교대,16776,18686,35462,37.4928178646055,127.013838469407
20210515,2호선,구로디지털단지,31471,31394,62865,37.4853149237865,126.901494378412
20210515,2호선,구의,15320,15204,30524,37.5371535596228,127.086179228767
20210515,2호선,낙성대,19895,18728,38623,37.4770651843603,126.963409959152
20210515,2호선,당산,11215,12627,23842,37.534956866618,126.90273071003
20210515,2호선,대림,17118,18247,35365,37.4933105886136,126.8949461878
20210515,2호선,도림천,903,853,1756,37.5144420510515,126.882702584468
20210515,2호선,동대문역사문화공원,8744,9520,18264,37.5655895229776,127.009131498424
20210515,2호선,뚝섬,12724,12885,25609,37.5471882244091,127.047365178682
20210515,2호선,문래,11647,12105,23752,37.5179214637526,126.894763060556
20210515,2호선,방배,9632,9983,19615,37.4814364876589,126.997694899327
20210515,2호선,봉천,16045,14932,30977,37.4825562153548,126.941495272047
20210515,2호선,사당,27190,29903,57093,37.4765228347619,126.981408909449
20210515,2호선,삼성,27479,27584,55063,37.5088619974404,127.063073009788
20210515,2호선,상왕십리,9250,8797,18047,37.5644687111181,127.029031221392
20210515,2호선,서울대입구,35192,33950,69142,37.4811526631844,126.952645104944
20210515,2호선,서초,10984,9176,20160,37.4918229990093,127.007580814715
20210515,2호선,선릉,22703,20230,42933,37.5045028775835,127.048942471228
20210515,2호선,성수,16629,17973,34602,37.5445023983984,127.056090471223
20210515,2호선,시청,7735,6390,14125,37.5654385176408,126.976983237511
20210515,2호선,신답,873,954,1827,37.5699910562183,127.046820203556
20210515,2호선,신당,10183,10600,20783,37.5656540317328,127.019540574485
20210515,2호선,신대방,18274,18179,36453,37.4875759745635,126.913175585996
20210515,2호선,신도림,38278,37846,76124,37.5087701449787,126.891080501385
20210515,2호선,신림,47057,44697,91754,37.4841196518392,126.928712092948
20210515,2호선,신설동,2750,2653,5403,37.5762451837487,127.023278761358
20210515,2호선,신정네거리,7027,7164,14191,37.5197975266787,126.852991645059
20210515,2호선,신촌,28882,28997,57879,37.5554417865984,126.936119192554
20210515,2호선,아현,6985,6771,13756,37.5573575723061,126.95603374504
20210515,2호선,양천구청,4519,4699,9218,37.5126989358446,126.866065211751
20210515,2호선,역삼,18092,19630,37722,37.5007162693593,127.036618203089
20210515,2호선,영등포구청,11809,11884,23693,37.5256996614804,126.896626898379
20210515,2호선,왕십리,12837,10617,23454,37.5612217415191,127.036655378283
20210515,2호선,용답,1956,1851,3807,37.5620049052662,127.050729309179
20210515,2호선,용두,1489,1571,3060,37.5739380503267,127.038031119837
20210515,2호선,을지로3가,9712,9595,19307,37.56626594615,126.990308356253
20210515,2호선,을지로4가,6508,6723,13231,37.5666369941572,126.997852780281
20210515,2호선,을지로입구,18206,17800,36006,37.5660509513873,126.982372901787
20210515,2호선,이대,9647,9985,19632,37.5567980142044,126.945758201019
20210515,2호선,잠실,56906,54351,111257,37.513859279255,127.101857941447
20210515,2호선,잠실나루,7209,7014,14223,37.5206867318088,127.103811089444
20210515,2호선,잠실새내,15937,16346,32283,37.5115672093323,127.086373867207
20210515,2호선,종합운동장,5238,6042,11280,37.5109692748993,127.073356018706
20210515,2호선,충정로,5132,5559,10691,37.5598377952439,126.964474043785
20210515,2호선,한양대,3430,3389,6819,37.55557788354,127.043584493543
20210515,2호선,합정,25024,26779,51803,37.5501152068908,126.914638180431
20210515,2호선,홍대입구,56950,59996,116946,37.5577458058734,126.926498328277
20210516,2호선,강남,29519,27966,57485,37.4981646510326,127.028307900881
20210516,2호선,강변,17135,16583,33718,37.5351692767888,127.094664569096
20210516,2호선,건대입구,20516,21046,41562,37.5404188872176,127.069173281554
20210516,2호선,교대,8785,9756,18541,37.4928178646055,127.013838469407
20210516,2호선,구로디지털단지,18922,18550,37472,37.4853149237865,126.901494378412
20210516,2호선,구의,9055,9271,18326,37.5371535596228,127.086179228767
20210516,2호선,낙성대,12502,13225,25727,37.4770651843603,126.963409959152
20210516,2호선,당산,6082,7035,13117,37.534956866618,126.90273071003
20210516,2호선,대림,11563,11752,23315,37.4933105886136,126.8949461878
20210516,2호선,도림천,340,359,699,37.5144420510515,126.882702584468
20210516,2호선,동대문역사문화공원,4922,5822,10744,37.5655895229776,127.009131498424
20210516,2호선,뚝섬,6768,7142,13910,37.5471882244091,127.047365178682
20210516,2호선,문래,6364,6665,13029,37.5179214637526,126.894763060556
20210516,2호선,방배,5587,5973,11560,37.4814364876589,126.997694899327
20210516,2호선,봉천,10024,9914,19938,37.4825562153548,126.941495272047
20210516,2호선,사당,15913,17722,33635,37.4765228347619,126.981408909449
20210516,2호선,삼성,18975,18015,36990,37.5088619974404,127.063073009788
20210516,2호선,상왕십리,5743,5594,11337,37.5644687111181,127.029031221392
20210516,2호선,서울대입구,21994,22361,44355,37.4811526631844,126.952645104944
20210516,2호선,서초,9749,8968,18717,37.4918229990093,127.007580814715
20210516,2호선,선릉,10453,9291,19744,37.5045028775835,127.048942471228
20210516,2호선,성수,9648,10161,19809,37.5445023983984,127.056090471223
20210516,2호선,시청,4601,3555,8156,37.5654385176408,126.976983237511
20210516,2호선,신답,508,605,1113,37.5699910562183,127.046820203556
20210516,2호선,신당,5930,6416,12346,37.5656540317328,127.019540574485
20210516,2호선,신대방,12020,11978,23998,37.4875759745635,126.913175585996
20210516,2호선,신도림,23526,23347,46873,37.5087701449787,126.891080501385
20210516,2호선,신림,29546,29549,59095,37.4841196518392,126.928712092948
20210516,2호선,신설동,1632,1580,3212,37.5762451837487,127.023278761358
20210516,2호선,신정네거리,3942,4048,7990,37.5197975266787,126.852991645059
20210516,2호선,신촌,19060,18381,37441,37.5554417865984,126.936119192554
20210516,2호선,아현,4106,4241,8347,37.5573575723061,126.95603374504
20210516,2호선,양천구청,2595,2735,5330,37.5126989358446,126.866065211751
20210516,2호선,역삼,10318,10798,21116,37.5007162693593,127.036618203089
20210516,2호선,영등포구청,6661,6854,13515,37.5256996614804,126.896626898379
20210516,2호선,왕십리,8015,6991,15006,37.5612217415191,127.036655378283
20210516,2호선,용답,1372,1396,2768,37.5620049052662,127.050729309179
20210516,2호선,용두,892,956,1848,37.5739380503267,127.038031119837
20210516,2호선,을지로3가,5903,5256,11159,37.56626594615,126.990308356253
20210516,2호선,을지로4가,2420,2276,4696,37.5666369941572,126.997852780281
20210516,2호선,을지로입구,12069,11322,23391,37.5660509513873,126.982372901787
20210516,2호선,이대,5745,6170,11915,37.5567980142044,126.945758201019
20210516,2호선,잠실,35222,33535,68757,37.513859279255,127.101857941447
20210516,2호선,잠실나루,3888,4067,7955,37.5206867318088,127.103811089444
20210516,2호선,잠실새내,9109,9244,18353,37.5115672093323,127.086373867207
20210516,2호선,종합운동장,2851,3141,5992,37.5109692748993,127.073356018706
20210516,2호선,충정로,3046,3355,6401,37.5598377952439,126.964474043785
20210516,2호선,한양대,2109,2269,4378,37.55557788354,127.043584493543
20210516,2호선,합정,15345,15791,31136,37.5501152068908,126.914638180431
20210516,2호선,홍대입구,35735,34676,70411,37.5577458058734,126.926498328277
20210522,2호선,강남,59531,58745,118276,37.4981646510326,127.028307900881
20210522,2호선,강변,25788,26345,52133,37.5351692767888,127.094664569096
20210522,2호선,건대입구,34315,36168,70483,37.5404188872176,127.069173281554
20210522,2호선,교대,16880,19070,35950,37.4928178646055,127.013838469407
20210522,2호선,구로디지털단지,33083,31922,65005,37.4853149237865,126.901494378412
20210522,2호선,구의,15916,15443,31359,37.5371535596228,127.086179228767
20210522,2호선,낙성대,21243,19628,40871,37.4770651843603,126.963409959152
20210522,2호선,당산,13372,14647,28019,37.534956866618,126.90273071003
20210522,2호선,대림,18561,19678,38239,37.4933105886136,126.8949461878
20210522,2호선,도림천,826,826,1652,37.5144420510515,126.882702584468
20210522,2호선,동대문역사문화공원,9173,9995,19168,37.5655895229776,127.009131498424
20210522,2호선,뚝섬,15432,15554,30986,37.5471882244091,127.047365178682
20210522,2호선,문래,12418,13482,25900,37.5179214637526,126.894763060556
20210522,2호선,방배,9835,10158,19993,37.4814364876589,126.997694899327
20210522,2호선,봉천,17041,15470,32511,37.4825562153548,126.941495272047
20210522,2호선,사당,28353,32078,60431,37.4765228347619,126.981408909449
20210522,2호선,삼성,24719,25095,49814,37.5088619974404,127.063073009788
20210522,2호선,상왕십리,9460,8828,18288,37.5644687111181,127.029031221392
20210522,2호선,서울대입구,37261,36296,73557,37.4811526631844,126.952645104944
20210522,2호선,서초,10501,8970,19471,37.4918229990093,127.007580814715
20210522,2호선,선릉,23163,20691,43854,37.5045028775835,127.048942471228
20210522,2호선,성수,17944,20555,38499,37.5445023983984,127.056090471223
20210522,2호선,시청,8585,6979,15564,37.5654385176408,126.976983237511
20210522,2호선,신답,1065,1064,2129,37.5699910562183,127.046820203556
20210522,2호선,신당,10621,10690,21311,37.5656540317328,127.019540574485
20210522,2호선,신대방,19899,19196,39095,37.4875759745635,126.913175585996
20210522,2호선,신도림,40133,40205,80338,37.5087701449787,126.891080501385
20210522,2호선,신림,48497,46410,94907,37.4841196518392,126.928712092948
20210522,2호선,신설동,3254,3206,6460,37.5762451837487,127.023278761358
20210522,2호선,신정네거리,7173,7319,14492,37.5197975266787,126.852991645059
20210522,2호선,신촌,28809,29040,57849,37.5554417865984,126.936119192554
20210522,2호선,아현,7480,7005,14485,37.5573575723061,126.95603374504
20210522,2호선,양천구청,4838,4883,9721,37.5126989358446,126.866065211751
20210522,2호선,역삼,17713,19478,37191,37.5007162693593,127.036618203089
20210522,2호선,영등포구청,12175,12603,24778,37.5256996614804,126.896626898379
20210522,2호선,왕십리,12881,10740,23621,37.5612217415191,127.036655378283
20210522,2호선,용답,2109,1954,4063,37.5620049052662,127.050729309179
20210522,2호선,용두,1767,1709,3476,37.5739380503267,127.038031119837
20210522,2호선,을지로3가,10815,11050,21865,37.56626594615,126.990308356253
20210522,2호선,을지로4가,6984,7414,14398,37.5666369941572,126.997852780281
20210522,2호선,을지로입구,19188,19095,38283,37.5660509513873,126.982372901787
20210522,2호선,이대,9929,10348,20277,37.5567980142044,126.945758201019
20210522,2호선,잠실,60196,57466,117662,37.513859279255,127.101857941447
20210522,2호선,잠실나루,7353,7293,14646,37.5206867318088,127.103811089444
20210522,2호선,잠실새내,16232,17006,33238,37.5115672093323,127.086373867207
20210522,2호선,종합운동장,5976,6435,12411,37.5109692748993,127.073356018706
20210522,2호선,충정로,5738,6206,11944,37.5598377952439,126.964474043785
20210522,2호선,한양대,4087,4156,8243,37.55557788354,127.043584493543
20210522,2호선,합정,27087,28934,56021,37.5501152068908,126.914638180431
20210522,2호선,홍대입구,59823,65000,124823,37.5577458058734,126.926498328277
20210523,2호선,강남,32650,31681,64331,37.4981646510326,127.028307900881
20210523,2호선,강변,20865,19722,40587,37.5351692767888,127.094664569096
20210523,2호선,건대입구,24472,25116,49588,37.5404188872176,127.069173281554
20210523,2호선,교대,9737,10587,20324,37.4928178646055,127.013838469407
20210523,2호선,구로디지털단지,21841,21377,43218,37.4853149237865,126.901494378412
20210523,2호선,구의,10568,10812,21380,37.5371535596228,127.086179228767
20210523,2호선,낙성대,15009,15507,30516,37.4770651843603,126.963409959152
20210523,2호선,당산,8616,9142,17758,37.534956866618,126.90273071003
20210523,2호선,대림,14218,14378,28596,37.4933105886136,126.8949461878
20210523,2호선,도림천,481,523,1004,37.5144420510515,126.882702584468
20210523,2호선,동대문역사문화공원,6916,8121,15037,37.5655895229776,127.009131498424
20210523,2호선,뚝섬,10003,10236,20239,37.5471882244091,127.047365178682
20210523,2호선,문래,7284,7910,15194,37.5179214637526,126.894763060556
20210523,2호선,방배,6483,6929,13412,37.4814364876589,126.997694899327
20210523,2호선,봉천,11460,11146,22606,37.4825562153548,126.941495272047
20210523,2호선,사당,19393,21717,41110,37.4765228347619,126.981408909449
20210523,2호선,삼성,17458,17088,34546,37.5088619974404,127.063073009788
20210523,2호선,상왕십리,6467,6343,12810,37.5644687111181,127.029031221392
20210523,2호선,서울대입구,25525,26425,51950,37.4811526631844,126.952645104944
20210523,2호선,서초,9749,9365,19114,37.4918229990093,127.007580814715
20210523,2호선,선릉,11925,10463,22388,37.5045028775835,127.048942471228
20210523,2호선,성수,11485,13244,24729,37.5445023983984,127.056090471223
20210523,2호선,시청,5321,4063,9384,37.5654385176408,126.976983237511
20210523,2호선,신답,703,721,1424,37.5699910562183,127.046820203556
20210523,2호선,신당,7689,8073,15762,37.5656540317328,127.019540574485
20210523,2호선,신대방,14438,14074,28512,37.4875759745635,126.913175585996
20210523,2호선,신도림,26689,26658,53347,37.5087701449787,126.891080501385
20210523,2호선,신림,34021,33763,67784,37.4841196518392,126.928712092948
20210523,2호선,신설동,2746,2879,5625,37.5762451837487,127.023278761358
20210523,2호선,신정네거리,4836,4906,9742,37.5197975266787,126.852991645059
20210523,2호선,신촌,19915,19653,39568,37.5554417865984,126.936119192554
20210523,2호선,아현,4838,4888,9726,37.5573575723061,126.95603374504
20210523,2호선,양천구청,3090,3140,6230,37.5126989358446,126.866065211751
20210523,2호선,역삼,10537,11509,22046,37.5007162693593,127.036618203089
20210523,2호선,영등포구청,7136,7316,14452,37.5256996614804,126.896626898379
20210523,2호선,왕십리,8664,7524,16188,37.5612217415191,127.036655378283
20210523,2호선,용답,1737,1654,3391,37.5620049052662,127.050729309179
20210523,2호선,용두,972,968,1940,37.5739380503267,127.038031119837
20210523,2호선,을지로3가,7149,6647,13796,37.56626594615,126.990308356253
20210523,2호선,을지로4가,3009,3013,6022,37.5666369941572,126.997852780281
20210523,2호선,을지로입구,13635,12887,26522,37.5660509513873,126.982372901787
20210523,2호선,이대,6354,6808,13162,37.5567980142044,126.945758201019
20210523,2호선,잠실,41307,38772,80079,37.513859279255,127.101857941447
20210523,2호선,잠실나루,4841,4919,9760,37.5206867318088,127.103811089444
20210523,2호선,잠실새내,10166,10349,20515,37.5115672093323,127.086373867207
20210523,2호선,종합운동장,4734,5269,10003,37.5109692748993,127.073356018706
20210523,2호선,충정로,3619,3839,7458,37.5598377952439,126.964474043785
20210523,2호선,한양대,2428,2617,5045,37.55557788354,127.043584493543
20210523,2호선,합정,18645,19417,38062,37.5501152068908,126.914638180431
20210523,2호선,홍대입구,43695,43553,87248,37.5577458058734,126.926498328277
20210529,2호선,강남,57397,57335,114732,37.4981646510326,127.028307900881
20210529,2호선,강변,24565,25483,50048,37.5351692767888,127.094664569096
20210529,2호선,건대입구,32197,34318,66515,37.5404188872176,127.069173281554
20210529,2호선,교대,16501,18593,35094,37.4928178646055,127.013838469407
20210529,2호선,구로디지털단지,32501,31706,64207,37.4853149237865,126.901494378412
20210529,2호선,구의,15541,15143,30684,37.5371535596228,127.086179228767
20210529,2호선,낙성대,20279,18968,39247,37.4770651843603,126.963409959152
20210529,2호선,당산,12044,13239,25283,37.534956866618,126.90273071003
20210529,2호선,대림,17195,18427,35622,37.4933105886136,126.8949461878
20210529,2호선,도림천,820,824,1644,37.5144420510515,126.882702584468
20210529,2호선,동대문역사문화공원,9014,9611,18625,37.5655895229776,127.009131498424
20210529,2호선,뚝섬,13782,14083,27865,37.5471882244091,127.047365178682
20210529,2호선,문래,11814,12496,24310,37.5179214637526,126.894763060556
20210529,2호선,방배,9850,10296,20146,37.4814364876589,126.997694899327
20210529,2호선,봉천,16757,15229,31986,37.4825562153548,126.941495272047
20210529,2호선,사당,27615,30668,58283,37.4765228347619,126.981408909449
20210529,2호선,삼성,30386,30390,60776,37.5088619974404,127.063073009788
20210529,2호선,상왕십리,9450,8769,18219,37.5644687111181,127.029031221392
20210529,2호선,서울대입구,36480,35248,71728,37.4811526631844,126.952645104944
20210529,2호선,서초,10091,8826,18917,37.4918229990093,127.007580814715
20210529,2호선,선릉,23361,20634,43995,37.5045028775835,127.048942471228
20210529,2호선,성수,17561,19378,36939,37.5445023983984,127.056090471223
20210529,2호선,시청,8178,6577,14755,37.5654385176408,126.976983237511
20210529,2호선,신답,913,984,1897,37.5699910562183,127.046820203556
20210529,2호선,신당,9862,10309,20171,37.5656540317328,127.019540574485
20210529,2호선,신대방,19306,18552,37858,37.4875759745635,126.913175585996
20210529,2호선,신도림,39210,39238,78448,37.5087701449787,126.891080501385
20210529,2호선,신림,47217,45201,92418,37.4841196518392,126.928712092948
20210529,2호선,신설동,2948,2748,5696,37.5762451837487,127.023278761358
20210529,2호선,신정네거리,6896,7062,13958,37.5197975266787,126.852991645059
20210529,2호선,신촌,27482,27706,55188,37.5554417865984,126.936119192554
20210529,2호선,아현,7051,6674,13725,37.5573575723061,126.95603374504
20210529,2호선,양천구청,4214,4334,8548,37.5126989358446,126.866065211751
20210529,2호선,역삼,17482,18973,36455,37.5007162693593,127.036618203089
20210529,2호선,영등포구청,11951,12217,24168,37.5256996614804,126.896626898379
20210529,2호선,왕십리,12626,10655,23281,37.5612217415191,127.036655378283
20210529,2호선,용답,2009,1873,3882,37.5620049052662,127.050729309179
20210529,2호선,용두,1576,1614,3190,37.5739380503267,127.038031119837
20210529,2호선,을지로3가,10253,10407,20660,37.56626594615,126.990308356253
20210529,2호선,을지로4가,6827,7023,13850,37.5666369941572,126.997852780281
20210529,2호선,을지로입구,18589,18299,36888,37.5660509513873,126.982372901787
20210529,2호선,이대,9597,10247,19844,37.5567980142044,126.945758201019
20210529,2호선,잠실,56884,54710,111594,37.513859279255,127.101857941447
20210529,2호선,잠실나루,7372,7270,14642,37.5206867318088,127.103811089444
20210529,2호선,잠실새내,15610,16148,31758,37.5115672093323,127.086373867207
20210529,2호선,종합운동장,5655,6157,11812,37.5109692748993,127.073356018706
20210529,2호선,충정로,5690,6149,11839,37.5598377952439,126.964474043785
20210529,2호선,한양대,3823,3813,7636,37.55557788354,127.043584493543
20210529,2호선,합정,26043,28170,54213,37.5501152068908,126.914638180431
20210529,2호선,홍대입구,57601,61707,119308,37.5577458058734,126.926498328277
20210530,2호선,강남,33132,31630,64762,37.4981646510326,127.028307900881
20210530,2호선,강변,20559,19494,40053,37.5351692767888,127.094664569096
20210530,2호선,건대입구,24870,25081,49951,37.5404188872176,127.069173281554
20210530,2호선,교대,9689,10872,20561,37.4928178646055,127.013838469407
20210530,2호선,구로디지털단지,22173,21592,43765,37.4853149237865,126.901494378412
20210530,2호선,구의,10769,10984,21753,37.5371535596228,127.086179228767
20210530,2호선,낙성대,14990,15486,30476,37.4770651843603,126.963409959152
20210530,2호선,당산,8485,9107,17592,37.534956866618,126.90273071003
20210530,2호선,대림,14319,14520,28839,37.4933105886136,126.8949461878
20210530,2호선,도림천,515,516,1031,37.5144420510515,126.882702584468
20210530,2호선,동대문역사문화공원,7105,8140,15245,37.5655895229776,127.009131498424
20210530,2호선,뚝섬,10121,10566,20687,37.5471882244091,127.047365178682
20210530,2호선,문래,7900,8333,16233,37.5179214637526,126.894763060556
20210530,2호선,방배,6630,7040,13670,37.4814364876589,126.997694899327
20210530,2호선,봉천,11733,11544,23277,37.4825562153548,126.941495272047
20210530,2호선,사당,19215,21445,40660,37.4765228347619,126.981408909449
20210530,2호선,삼성,22168,21678,43846,37.5088619974404,127.063073009788
20210530,2호선,상왕십리,6686,6712,13398,37.5644687111181,127.029031221392
20210530,2호선,서울대입구,26035,26745,52780,37.4811526631844,126.952645104944
20210530,2호선,서초,10080,9450,19530,37.4918229990093,127.007580814715
20210530,2호선,선릉,12336,10827,23163,37.5045028775835,127.048942471228
20210530,2호선,성수,11883,13318,25201,37.5445023983984,127.056090471223
20210530,2호선,시청,5484,4155,9639,37.5654385176408,126.976983237511
20210530,2호선,신답,732,799,1531,37.5699910562183,127.046820203556
20210530,2호선,신당,7827,8426,16253,37.5656540317328,127.019540574485
20210530,2호선,신대방,14398,14594,28992,37.4875759745635,126.913175585996
20210530,2호선,신도림,26834,27361,54195,37.5087701449787,126.891080501385
20210530,2호선,신림,35093,34563,69656,37.4841196518392,126.928712092948
20210530,2호선,신설동,3054,2981,6035,37.5762451837487,127.023278761358
20210530,2호선,신정네거리,4915,5034,9949,37.5197975266787,126.852991645059
20210530,2호선,신촌,20340,19507,39847,37.5554417865984,126.936119192554
20210530,2호선,아현,4904,5048,9952,37.5573575723061,126.95603374504
20210530,2호선,양천구청,3096,3365,6461,37.5126989358446,126.866065211751
20210530,2호선,역삼,10937,11934,22871,37.5007162693593,127.036618203089
20210530,2호선,영등포구청,7744,8116,15860,37.5256996614804,126.896626898379
20210530,2호선,왕십리,8994,7635,16629,37.5612217415191,127.036655378283
20210530,2호선,용답,1636,1659,3295,37.5620049052662,127.050729309179
20210530,2호선,용두,1189,1213,2402,37.5739380503267,127.038031119837
20210530,2호선,을지로3가,7376,6625,14001,37.56626594615,126.990308356253
20210530,2호선,을지로4가,3067,2951,6018,37.5666369941572,126.997852780281
20210530,2호선,을지로입구,14270,13165,27435,37.5660509513873,126.982372901787
20210530,2호선,이대,6555,7252,13807,37.5567980142044,126.945758201019
20210530,2호선,잠실,41905,39050,80955,37.513859279255,127.101857941447
20210530,2호선,잠실나루,5067,5282,10349,37.5206867318088,127.103811089444
20210530,2호선,잠실새내,10433,10533,20966,37.5115672093323,127.086373867207
20210530,2호선,종합운동장,4338,5040,9378,37.5109692748993,127.073356018706
20210530,2호선,충정로,3486,3858,7344,37.5598377952439,126.964474043785
20210530,2호선,한양대,2403,2734,5137,37.55557788354,127.043584493543
20210530,2호선,합정,19001,19798,38799,37.5501152068908,126.914638180431
20210530,2호선,홍대입구,44553,43056,87609,37.5577458058734,126.926498328277
20210605,2호선,강남,56876,56592,113468,37.4981646510326,127.028307900881
20210605,2호선,강변,24790,25474,50264,37.5351692767888,127.094664569096
20210605,2호선,건대입구,32169,34628,66797,37.5404188872176,127.069173281554
20210605,2호선,교대,16354,18257,34611,37.4928178646055,127.013838469407
20210605,2호선,구로디지털단지,33148,32157,65305,37.4853149237865,126.901494378412
20210605,2호선,구의,15881,15104,30985,37.5371535596228,127.086179228767
20210605,2호선,낙성대,20728,18832,39560,37.4770651843603,126.963409959152
20210605,2호선,당산,13066,14018,27084,37.534956866618,126.90273071003
20210605,2호선,대림,17800,18842,36642,37.4933105886136,126.8949461878
20210605,2호선,도림천,823,821,1644,37.5144420510515,126.882702584468
20210605,2호선,동대문역사문화공원,9185,9715,18900,37.5655895229776,127.009131498424
20210605,2호선,뚝섬,15672,16182,31854,37.5471882244091,127.047365178682
20210605,2호선,문래,12057,13066,25123,37.5179214637526,126.894763060556
20210605,2호선,방배,9621,10086,19707,37.4814364876589,126.997694899327
20210605,2호선,봉천,16670,15301,31971,37.4825562153548,126.941495272047
20210605,2호선,사당,28289,31610,59899,37.4765228347619,126.981408909449
20210605,2호선,삼성,26592,27259,53851,37.5088619974404,127.063073009788
20210605,2호선,상왕십리,9478,8947,18425,37.5644687111181,127.029031221392
20210605,2호선,서울대입구,36461,35293,71754,37.4811526631844,126.952645104944
20210605,2호선,서초,9739,8044,17783,37.4918229990093,127.007580814715
20210605,2호선,선릉,23331,20690,44021,37.5045028775835,127.048942471228
20210605,2호선,성수,16602,19074,35676,37.5445023983984,127.056090471223
20210605,2호선,시청,7726,6127,13853,37.5654385176408,126.976983237511
20210605,2호선,신답,966,1004,1970,37.5699910562183,127.046820203556
20210605,2호선,신당,10174,10569,20743,37.5656540317328,127.019540574485
20210605,2호선,신대방,19516,18892,38408,37.4875759745635,126.913175585996
20210605,2호선,신도림,39208,39413,78621,37.5087701449787,126.891080501385
20210605,2호선,신림,48665,46427,95092,37.4841196518392,126.928712092948
20210605,2호선,신설동,3181,3110,6291,37.5762451837487,127.023278761358
20210605,2호선,신정네거리,7377,7425,14802,37.5197975266787,126.852991645059
20210605,2호선,신촌,27392,27820,55212,37.5554417865984,126.936119192554
20210605,2호선,아현,7471,7206,14677,37.5573575723061,126.95603374504
20210605,2호선,양천구청,4431,4497,8928,37.5126989358446,126.866065211751
20210605,2호선,역삼,17740,19349,37089,37.5007162693593,127.036618203089
20210605,2호선,영등포구청,12229,12492,24721,37.5256996614804,126.896626898379
20210605,2호선,왕십리,12920,10869,23789,37.5612217415191,127.036655378283
20210605,2호선,용답,1977,1934,3911,37.5620049052662,127.050729309179
20210605,2호선,용두,1659,1631,3290,37.5739380503267,127.038031119837
20210605,2호선,을지로3가,10666,10703,21369,37.56626594615,126.990308356253
20210605,2호선,을지로4가,6996,7429,14425,37.5666369941572,126.997852780281
20210605,2호선,을지로입구,19129,18968,38097,37.5660509513873,126.982372901787
20210605,2호선,이대,9152,9201,18353,37.5567980142044,126.945758201019
20210605,2호선,잠실,56063,53851,109914,37.513859279255,127.101857941447
20210605,2호선,잠실나루,7560,7314,14874,37.5206867318088,127.103811089444
20210605,2호선,잠실새내,15581,16094,31675,37.5115672093323,127.086373867207
20210605,2호선,종합운동장,5527,5822,11349,37.5109692748993,127.073356018706
20210605,2호선,충정로,5509,5683,11192,37.5598377952439,126.964474043785
20210605,2호선,한양대,4273,4275,8548,37.55557788354,127.043584493543
20210605,2호선,합정,26757,29099,55856,37.5501152068908,126.914638180431
20210605,2호선,홍대입구,58931,63687,122618,37.5577458058734,126.926498328277
20210606,2호선,강남,31080,29926,61006,37.4981646510326,127.028307900881
20210606,2호선,강변,19483,19045,38528,37.5351692767888,127.094664569096
20210606,2호선,건대입구,22825,24093,46918,37.5404188872176,127.069173281554
20210606,2호선,교대,9218,10389,19607,37.4928178646055,127.013838469407
20210606,2호선,구로디지털단지,21734,21525,43259,37.4853149237865,126.901494378412
20210606,2호선,구의,10607,10453,21060,37.5371535596228,127.086179228767
20210606,2호선,낙성대,14435,14997,29432,37.4770651843603,126.963409959152
20210606,2호선,당산,8395,9124,17519,37.534956866618,126.90273071003
20210606,2호선,대림,14413,14576,28989,37.4933105886136,126.8949461878
20210606,2호선,도림천,512,510,1022,37.5144420510515,126.882702584468
20210606,2호선,동대문역사문화공원,6392,7685,14077,37.5655895229776,127.009131498424
20210606,2호선,뚝섬,11034,11454,22488,37.5471882244091,127.047365178682
20210606,2호선,문래,7395,7962,15357,37.5179214637526,126.894763060556
20210606,2호선,방배,6598,7039,13637,37.4814364876589,126.997694899327
20210606,2호선,봉천,11362,11212,22574,37.4825562153548,126.941495272047
20210606,2호선,사당,19377,21625,41002,37.4765228347619,126.981408909449
20210606,2호선,삼성,18270,18107,36377,37.5088619974404,127.063073009788
20210606,2호선,상왕십리,6511,6388,12899,37.5644687111181,127.029031221392
20210606,2호선,서울대입구,24989,25650,50639,37.4811526631844,126.952645104944
20210606,2호선,서초,9690,9148,18838,37.4918229990093,127.007580814715
20210606,2호선,선릉,11776,10188,21964,37.5045028775835,127.048942471228
20210606,2호선,성수,11307,12847,24154,37.5445023983984,127.056090471223
20210606,2호선,시청,4798,3847,8645,37.5654385176408,126.976983237511
20210606,2호선,신답,694,763,1457,37.5699910562183,127.046820203556
20210606,2호선,신당,7563,7959,15522,37.5656540317328,127.019540574485
20210606,2호선,신대방,14283,14274,28557,37.4875759745635,126.913175585996
20210606,2호선,신도림,26563,26898,53461,37.5087701449787,126.891080501385
20210606,2호선,신림,34304,33768,68072,37.4841196518392,126.928712092948
20210606,2호선,신설동,2732,2808,5540,37.5762451837487,127.023278761358
20210606,2호선,신정네거리,4769,4809,9578,37.5197975266787,126.852991645059
20210606,2호선,신촌,18961,18516,37477,37.5554417865984,126.936119192554
20210606,2호선,아현,4831,4668,9499,37.5573575723061,126.95603374504
20210606,2호선,양천구청,3025,3201,6226,37.5126989358446,126.866065211751
20210606,2호선,역삼,10005,10703,20708,37.5007162693593,127.036618203089
20210606,2호선,영등포구청,7162,7439,14601,37.5256996614804,126.896626898379
20210606,2호선,왕십리,8357,7055,15412,37.5612217415191,127.036655378283
20210606,2호선,용답,1582,1587,3169,37.5620049052662,127.050729309179
20210606,2호선,용두,1130,1105,2235,37.5739380503267,127.038031119837
20210606,2호선,을지로3가,7196,6535,13731,37.56626594615,126.990308356253
20210606,2호선,을지로4가,2801,2750,5551,37.5666369941572,126.997852780281
20210606,2호선,을지로입구,13798,13181,26979,37.5660509513873,126.982372901787
20210606,2호선,이대,5875,6371,12246,37.5567980142044,126.945758201019
20210606,2호선,잠실,39359,37109,76468,37.513859279255,127.101857941447
20210606,2호선,잠실나루,4805,4978,9783,37.5206867318088,127.103811089444
20210606,2호선,잠실새내,9801,10074,19875,37.5115672093323,127.086373867207
20210606,2호선,종합운동장,4368,4837,9205,37.5109692748993,127.073356018706
20210606,2호선,충정로,3604,3867,7471,37.5598377952439,126.964474043785
20210606,2호선,한양대,2106,2365,4471,37.55557788354,127.043584493543
20210606,2호선,합정,18446,19069,37515,37.5501152068908,126.914638180431
20210606,2호선,홍대입구,43137,42995,86132,37.5577458058734,126.926498328277
20210612,2호선,강남,56795,56496,113291,37.4981646510326,127.028307900881
20210612,2호선,강변,23780,25081,48861,37.5351692767888,127.094664569096
20210612,2호선,건대입구,30375,33111,63486,37.5404188872176,127.069173281554
20210612,2호선,교대,16116,17964,34080,37.4928178646055,127.013838469407
20210612,2호선,구로디지털단지,32570,31533,64103,37.4853149237865,126.901494378412
20210612,2호선,구의,15199,14783,29982,37.5371535596228,127.086179228767
20210612,2호선,낙성대,20113,18563,38676,37.4770651843603,126.963409959152
20210612,2호선,당산,11955,13000,24955,37.534956866618,126.90273071003
20210612,2호선,대림,17814,18830,36644,37.4933105886136,126.8949461878
20210612,2호선,도림천,754,770,1524,37.5144420510515,126.882702584468
20210612,2호선,동대문역사문화공원,8950,9344,18294,37.5655895229776,127.009131498424
20210612,2호선,뚝섬,14447,15297,29744,37.5471882244091,127.047365178682
20210612,2호선,문래,11612,12372,23984,37.5179214637526,126.894763060556
20210612,2호선,방배,9547,9812,19359,37.4814364876589,126.997694899327
20210612,2호선,봉천,16314,15012,31326,37.4825562153548,126.941495272047
20210612,2호선,사당,27258,29970,57228,37.4765228347619,126.981408909449
20210612,2호선,삼성,27997,28087,56084,37.5088619974404,127.063073009788
20210612,2호선,상왕십리,9267,8635,17902,37.5644687111181,127.029031221392
20210612,2호선,서울대입구,35650,34086,69736,37.4811526631844,126.952645104944
20210612,2호선,서초,9556,8243,17799,37.4918229990093,127.007580814715
20210612,2호선,선릉,22137,19704,41841,37.5045028775835,127.048942471228
20210612,2호선,성수,16295,18821,35116,37.5445023983984,127.056090471223
20210612,2호선,시청,7681,6278,13959,37.5654385176408,126.976983237511
20210612,2호선,신답,889,976,1865,37.5699910562183,127.046820203556
20210612,2호선,신당,10059,10233,20292,37.5656540317328,127.019540574485
20210612,2호선,신대방,19106,18254,37360,37.4875759745635,126.913175585996
20210612,2호선,신도림,37816,38144,75960,37.5087701449787,126.891080501385
20210612,2호선,신림,47447,45141,92588,37.4841196518392,126.928712092948
20210612,2호선,신설동,2875,2881,5756,37.5762451837487,127.023278761358
20210612,2호선,신정네거리,6940,6994,13934,37.5197975266787,126.852991645059
20210612,2호선,신촌,26301,26551,52852,37.5554417865984,126.936119192554
20210612,2호선,아현,7089,6727,13816,37.5573575723061,126.95603374504
20210612,2호선,양천구청,4573,4678,9251,37.5126989358446,126.866065211751
20210612,2호선,역삼,17727,19623,37350,37.5007162693593,127.036618203089
20210612,2호선,영등포구청,11715,11931,23646,37.5256996614804,126.896626898379
20210612,2호선,왕십리,12073,10065,22138,37.5612217415191,127.036655378283
20210612,2호선,용답,1968,1827,3795,37.5620049052662,127.050729309179
20210612,2호선,용두,1679,1594,3273,37.5739380503267,127.038031119837
20210612,2호선,을지로3가,10256,10473,20729,37.56626594615,126.990308356253
20210612,2호선,을지로4가,6614,7064,13678,37.5666369941572,126.997852780281
20210612,2호선,을지로입구,18942,18907,37849,37.5660509513873,126.982372901787
20210612,2호선,이대,9316,9686,19002,37.5567980142044,126.945758201019
20210612,2호선,잠실,55843,53320,109163,37.513859279255,127.101857941447
20210612,2호선,잠실나루,7251,7075,14326,37.5206867318088,127.103811089444
20210612,2호선,잠실새내,15236,16096,31332,37.5115672093323,127.086373867207
20210612,2호선,종합운동장,5705,6226,11931,37.5109692748993,127.073356018706
20210612,2호선,충정로,5301,5638,10939,37.5598377952439,126.964474043785
20210612,2호선,한양대,4162,4316,8478,37.55557788354,127.043584493543
20210612,2호선,합정,26243,28581,54824,37.5501152068908,126.914638180431
20210612,2호선,홍대입구,57136,60844,117980,37.5577458058734,126.926498328277
20210613,2호선,강남,31573,30315,61888,37.4981646510326,127.028307900881
20210613,2호선,강변,19665,19013,38678,37.5351692767888,127.094664569096
20210613,2호선,건대입구,22074,23031,45105,37.5404188872176,127.069173281554
20210613,2호선,교대,9496,10372,19868,37.4928178646055,127.013838469407
20210613,2호선,구로디지털단지,21218,20769,41987,37.4853149237865,126.901494378412
20210613,2호선,구의,10234,10467,20701,37.5371535596228,127.086179228767
20210613,2호선,낙성대,14382,14748,29130,37.4770651843603,126.963409959152
20210613,2호선,당산,7991,8631,16622,37.534956866618,126.90273071003
20210613,2호선,대림,14075,14441,28516,37.4933105886136,126.8949461878
20210613,2호선,도림천,474,449,923,37.5144420510515,126.882702584468
20210613,2호선,동대문역사문화공원,6789,7971,14760,37.5655895229776,127.009131498424
20210613,2호선,뚝섬,10363,10848,21211,37.5471882244091,127.047365178682
20210613,2호선,문래,7125,7486,14611,37.5179214637526,126.894763060556
20210613,2호선,방배,6127,6465,12592,37.4814364876589,126.997694899327
20210613,2호선,봉천,11264,11034,22298,37.4825562153548,126.941495272047
20210613,2호선,사당,18685,21031,39716,37.4765228347619,126.981408909449
20210613,2호선,삼성,19296,19003,38299,37.5088619974404,127.063073009788
20210613,2호선,상왕십리,6482,6413,12895,37.5644687111181,127.029031221392
20210613,2호선,서울대입구,24717,25541,50258,37.4811526631844,126.952645104944
20210613,2호선,서초,9811,9236,19047,37.4918229990093,127.007580814715
20210613,2호선,선릉,11788,10272,22060,37.5045028775835,127.048942471228
20210613,2호선,성수,10758,12051,22809,37.5445023983984,127.056090471223
20210613,2호선,시청,4924,3882,8806,37.5654385176408,126.976983237511
20210613,2호선,신답,643,670,1313,37.5699910562183,127.046820203556
20210613,2호선,신당,7102,7729,14831,37.5656540317328,127.019540574485
20210613,2호선,신대방,13989,13877,27866,37.4875759745635,126.913175585996
20210613,2호선,신도림,26675,27082,53757,37.5087701449787,126.891080501385
20210613,2호선,신림,33721,33124,66845,37.4841196518392,126.928712092948
20210613,2호선,신설동,2595,2664,5259,37.5762451837487,127.023278761358
20210613,2호선,신정네거리,4617,4797,9414,37.5197975266787,126.852991645059
20210613,2호선,신촌,18448,18111,36559,37.5554417865984,126.936119192554
20210613,2호선,아현,4684,4578,9262,37.5573575723061,126.95603374504
20210613,2호선,양천구청,3544,3528,7072,37.5126989358446,126.866065211751
20210613,2호선,역삼,10331,11325,21656,37.5007162693593,127.036618203089
20210613,2호선,영등포구청,7060,7290,14350,37.5256996614804,126.896626898379
20210613,2호선,왕십리,8078,6715,14793,37.5612217415191,127.036655378283
20210613,2호선,용답,1431,1492,2923,37.5620049052662,127.050729309179
20210613,2호선,용두,959,917,1876,37.5739380503267,127.038031119837
20210613,2호선,을지로3가,7090,6590,13680,37.56626594615,126.990308356253
20210613,2호선,을지로4가,3040,2916,5956,37.5666369941572,126.997852780281
20210613,2호선,을지로입구,13741,12969,26710,37.5660509513873,126.982372901787
20210613,2호선,이대,6095,6503,12598,37.5567980142044,126.945758201019
20210613,2호선,잠실,40920,38358,79278,37.513859279255,127.101857941447
20210613,2호선,잠실나루,4973,4920,9893,37.5206867318088,127.103811089444
20210613,2호선,잠실새내,9620,10021,19641,37.5115672093323,127.086373867207
20210613,2호선,종합운동장,4821,5082,9903,37.5109692748993,127.073356018706
20210613,2호선,충정로,3456,3642,7098,37.5598377952439,126.964474043785
20210613,2호선,한양대,2457,2738,5195,37.55557788354,127.043584493543
20210613,2호선,합정,18621,19550,38171,37.5501152068908,126.914638180431
20210613,2호선,홍대입구,40715,40697,81412,37.5577458058734,126.926498328277
20210619,2호선,강남,60951,60877,121828,37.4981646510326,127.028307900881
20210619,2호선,강변,26100,27278,53378,37.5351692767888,127.094664569096
20210619,2호선,건대입구,33217,36395,69612,37.5404188872176,127.069173281554
20210619,2호선,교대,16744,18657,35401,37.4928178646055,127.013838469407
20210619,2호선,구로디지털단지,33556,32737,66293,37.4853149237865,126.901494378412
20210619,2호선,구의,15478,15143,30621,37.5371535596228,127.086179228767
20210619,2호선,낙성대,20964,19150,40114,37.4770651843603,126.963409959152
20210619,2호선,당산,12901,13897,26798,37.534956866618,126.90273071003
20210619,2호선,대림,17973,19355,37328,37.4933105886136,126.8949461878
20210619,2호선,도림천,792,798,1590,37.5144420510515,126.882702584468
20210619,2호선,동대문역사문화공원,9832,10742,20574,37.5655895229776,127.009131498424
20210619,2호선,뚝섬,17135,18142,35277,37.5471882244091,127.047365178682
20210619,2호선,문래,11983,12627,24610,37.5179214637526,126.894763060556
20210619,2호선,방배,9559,10111,19670,37.4814364876589,126.997694899327
20210619,2호선,봉천,17023,15482,32505,37.4825562153548,126.941495272047
20210619,2호선,사당,28726,31747,60473,37.4765228347619,126.981408909449
20210619,2호선,삼성,28675,29348,58023,37.5088619974404,127.063073009788
20210619,2호선,상왕십리,9661,9102,18763,37.5644687111181,127.029031221392
20210619,2호선,서울대입구,37350,35853,73203,37.4811526631844,126.952645104944
20210619,2호선,서초,10844,8983,19827,37.4918229990093,127.007580814715
20210619,2호선,선릉,23123,20470,43593,37.5045028775835,127.048942471228
20210619,2호선,성수,17916,20664,38580,37.5445023983984,127.056090471223
20210619,2호선,시청,8818,7291,16109,37.5654385176408,126.976983237511
20210619,2호선,신답,997,1047,2044,37.5699910562183,127.046820203556
20210619,2호선,신당,10341,10677,21018,37.5656540317328,127.019540574485
20210619,2호선,신대방,19712,18796,38508,37.4875759745635,126.913175585996
20210619,2호선,신도림,40142,40516,80658,37.5087701449787,126.891080501385
20210619,2호선,신림,49051,46302,95353,37.4841196518392,126.928712092948
20210619,2호선,신설동,3147,3079,6226,37.5762451837487,127.023278761358
20210619,2호선,신정네거리,7055,7095,14150,37.5197975266787,126.852991645059
20210619,2호선,신촌,29440,29681,59121,37.5554417865984,126.936119192554
20210619,2호선,아현,7391,6782,14173,37.5573575723061,126.95603374504
20210619,2호선,양천구청,4450,4423,8873,37.5126989358446,126.866065211751
20210619,2호선,역삼,17852,19796,37648,37.5007162693593,127.036618203089
20210619,2호선,영등포구청,12124,12336,24460,37.5256996614804,126.896626898379
20210619,2호선,왕십리,12991,10768,23759,37.5612217415191,127.036655378283
20210619,2호선,용답,2138,1924,4062,37.5620049052662,127.050729309179
20210619,2호선,용두,1757,1685,3442,37.5739380503267,127.038031119837
20210619,2호선,을지로3가,11067,11415,22482,37.56626594615,126.990308356253
20210619,2호선,을지로4가,7146,7631,14777,37.5666369941572,126.997852780281
20210619,2호선,을지로입구,20437,20149,40586,37.5660509513873,126.982372901787
20210619,2호선,이대,10022,10422,20444,37.5567980142044,126.945758201019
20210619,2호선,잠실,60164,58033,118197,37.513859279255,127.101857941447
20210619,2호선,잠실나루,7626,7449,15075,37.5206867318088,127.103811089444
20210619,2호선,잠실새내,16381,16919,33300,37.5115672093323,127.086373867207
20210619,2호선,종합운동장,7096,7982,15078,37.5109692748993,127.073356018706
20210619,2호선,충정로,5755,6221,11976,37.5598377952439,126.964474043785
20210619,2호선,한양대,4137,4235,8372,37.55557788354,127.043584493543
20210619,2호선,합정,28028,30154,58182,37.5501152068908,126.914638180431
20210619,2호선,홍대입구,60826,66128,126954,37.5577458058734,126.926498328277
20210620,2호선,강남,34348,33419,67767,37.4981646510326,127.028307900881
20210620,2호선,강변,21269,19860,41129,37.5351692767888,127.094664569096
20210620,2호선,건대입구,24600,26186,50786,37.5404188872176,127.069173281554
20210620,2호선,교대,9842,10831,20673,37.4928178646055,127.013838469407
20210620,2호선,구로디지털단지,22269,21813,44082,37.4853149237865,126.901494378412
20210620,2호선,구의,10697,10678,21375,37.5371535596228,127.086179228767
20210620,2호선,낙성대,14786,15190,29976,37.4770651843603,126.963409959152
20210620,2호선,당산,8487,9169,17656,37.534956866618,126.90273071003
20210620,2호선,대림,14405,14684,29089,37.4933105886136,126.8949461878
20210620,2호선,도림천,510,544,1054,37.5144420510515,126.882702584468
20210620,2호선,동대문역사문화공원,6794,8035,14829,37.5655895229776,127.009131498424
20210620,2호선,뚝섬,12609,13158,25767,37.5471882244091,127.047365178682
20210620,2호선,문래,7403,7788,15191,37.5179214637526,126.894763060556
20210620,2호선,방배,6378,6886,13264,37.4814364876589,126.997694899327
20210620,2호선,봉천,11697,11163,22860,37.4825562153548,126.941495272047
20210620,2호선,사당,19308,21589,40897,37.4765228347619,126.981408909449
20210620,2호선,삼성,18848,18491,37339,37.5088619974404,127.063073009788
20210620,2호선,상왕십리,6571,6316,12887,37.5644687111181,127.029031221392
20210620,2호선,서울대입구,25778,26846,52624,37.4811526631844,126.952645104944
20210620,2호선,서초,10273,9673,19946,37.4918229990093,127.007580814715
20210620,2호선,선릉,11993,10424,22417,37.5045028775835,127.048942471228
20210620,2호선,성수,11746,13625,25371,37.5445023983984,127.056090471223
20210620,2호선,시청,5670,4521,10191,37.5654385176408,126.976983237511
20210620,2호선,신답,707,766,1473,37.5699910562183,127.046820203556
20210620,2호선,신당,7636,8029,15665,37.5656540317328,127.019540574485
20210620,2호선,신대방,14620,14202,28822,37.4875759745635,126.913175585996
20210620,2호선,신도림,27799,28559,56358,37.5087701449787,126.891080501385
20210620,2호선,신림,34705,34630,69335,37.4841196518392,126.928712092948
20210620,2호선,신설동,2770,2799,5569,37.5762451837487,127.023278761358
20210620,2호선,신정네거리,4918,4905,9823,37.5197975266787,126.852991645059
20210620,2호선,신촌,20493,19897,40390,37.5554417865984,126.936119192554
20210620,2호선,아현,5026,5017,10043,37.5573575723061,126.95603374504
20210620,2호선,양천구청,3538,3645,7183,37.5126989358446,126.866065211751
20210620,2호선,역삼,10961,12068,23029,37.5007162693593,127.036618203089
20210620,2호선,영등포구청,7286,7545,14831,37.5256996614804,126.896626898379
20210620,2호선,왕십리,8451,7521,15972,37.5612217415191,127.036655378283
20210620,2호선,용답,1600,1535,3135,37.5620049052662,127.050729309179
20210620,2호선,용두,1185,1208,2393,37.5739380503267,127.038031119837
20210620,2호선,을지로3가,7631,6976,14607,37.56626594615,126.990308356253
20210620,2호선,을지로4가,3256,3064,6320,37.5666369941572,126.997852780281
20210620,2호선,을지로입구,14377,13591,27968,37.5660509513873,126.982372901787
20210620,2호선,이대,6685,7026,13711,37.5567980142044,126.945758201019
20210620,2호선,잠실,43987,41299,85286,37.513859279255,127.101857941447
20210620,2호선,잠실나루,5139,5110,10249,37.5206867318088,127.103811089444
20210620,2호선,잠실새내,10413,10695,21108,37.5115672093323,127.086373867207
20210620,2호선,종합운동장,5721,6321,12042,37.5109692748993,127.073356018706
20210620,2호선,충정로,3575,3737,7312,37.5598377952439,126.964474043785
20210620,2호선,한양대,2149,2324,4473,37.55557788354,127.043584493543
20210620,2호선,합정,19072,20593,39665,37.5501152068908,126.914638180431
20210620,2호선,홍대입구,44599,44549,89148,37.5577458058734,126.926498328277
20210626,2호선,강남,59659,59498,119157,37.4981646510326,127.028307900881
20210626,2호선,강변,25463,26605,52068,37.5351692767888,127.094664569096
20210626,2호선,건대입구,31892,34948,66840,37.5404188872176,127.069173281554
20210626,2호선,교대,16719,18738,35457,37.4928178646055,127.013838469407
20210626,2호선,구로디지털단지,32893,32024,64917,37.4853149237865,126.901494378412
20210626,2호선,구의,15335,14791,30126,37.5371535596228,127.086179228767
20210626,2호선,낙성대,20504,18817,39321,37.4770651843603,126.963409959152
20210626,2호선,당산,12400,13345,25745,37.534956866618,126.90273071003
20210626,2호선,대림,17739,18793,36532,37.4933105886136,126.8949461878
20210626,2호선,도림천,801,822,1623,37.5144420510515,126.882702584468
20210626,2호선,동대문역사문화공원,9779,10461,20240,37.5655895229776,127.009131498424
20210626,2호선,뚝섬,13780,14514,28294,37.5471882244091,127.047365178682
20210626,2호선,문래,11503,12062,23565,37.5179214637526,126.894763060556
20210626,2호선,방배,9322,9768,19090,37.4814364876589,126.997694899327
20210626,2호선,봉천,16638,15221,31859,37.4825562153548,126.941495272047
20210626,2호선,사당,27529,30253,57782,37.4765228347619,126.981408909449
20210626,2호선,삼성,26873,27462,54335,37.5088619974404,127.063073009788
20210626,2호선,상왕십리,9539,8954,18493,37.5644687111181,127.029031221392
20210626,2호선,서울대입구,36681,35069,71750,37.4811526631844,126.952645104944
20210626,2호선,서초,10018,8458,18476,37.4918229990093,127.007580814715
20210626,2호선,선릉,22663,20034,42697,37.5045028775835,127.048942471228
20210626,2호선,성수,17190,19695,36885,37.5445023983984,127.056090471223
20210626,2호선,시청,8165,7484,15649,37.5654385176408,126.976983237511
20210626,2호선,신답,997,1010,2007,37.5699910562183,127.046820203556
20210626,2호선,신당,10356,10864,21220,37.5656540317328,127.019540574485
20210626,2호선,신대방,19491,18666,38157,37.4875759745635,126.913175585996
20210626,2호선,신도림,38474,38649,77123,37.5087701449787,126.891080501385
20210626,2호선,신림,48005,45297,93302,37.4841196518392,126.928712092948
20210626,2호선,신설동,2802,2678,5480,37.5762451837487,127.023278761358
20210626,2호선,신정네거리,7052,6966,14018,37.5197975266787,126.852991645059
20210626,2호선,신촌,28377,28272,56649,37.5554417865984,126.936119192554
20210626,2호선,아현,7241,6889,14130,37.5573575723061,126.95603374504
20210626,2호선,양천구청,4375,4287,8662,37.5126989358446,126.866065211751
20210626,2호선,역삼,17158,18476,35634,37.5007162693593,127.036618203089
20210626,2호선,영등포구청,11817,11903,23720,37.5256996614804,126.896626898379
20210626,2호선,왕십리,12969,10826,23795,37.5612217415191,127.036655378283
20210626,2호선,용답,2071,1876,3947,37.5620049052662,127.050729309179
20210626,2호선,용두,1648,1587,3235,37.5739380503267,127.038031119837
20210626,2호선,을지로3가,10977,11370,22347,37.56626594615,126.990308356253
20210626,2호선,을지로4가,6874,7107,13981,37.5666369941572,126.997852780281
20210626,2호선,을지로입구,19531,19625,39156,37.5660509513873,126.982372901787
20210626,2호선,이대,9691,10073,19764,37.5567980142044,126.945758201019
20210626,2호선,잠실,59144,57223,116367,37.513859279255,127.101857941447
20210626,2호선,잠실나루,7150,6955,14105,37.5206867318088,127.103811089444
20210626,2호선,잠실새내,15873,16303,32176,37.5115672093323,127.086373867207
20210626,2호선,종합운동장,6554,7312,13866,37.5109692748993,127.073356018706
20210626,2호선,충정로,5373,5585,10958,37.5598377952439,126.964474043785
20210626,2호선,한양대,3221,3143,6364,37.55557788354,127.043584493543
20210626,2호선,합정,26798,28799,55597,37.5501152068908,126.914638180431
20210626,2호선,홍대입구,58916,63384,122300,37.5577458058734,126.926498328277
20210627,2호선,강남,35402,33909,69311,37.4981646510326,127.028307900881
20210627,2호선,강변,22030,20096,42126,37.5351692767888,127.094664569096
20210627,2호선,건대입구,25104,26025,51129,37.5404188872176,127.069173281554
20210627,2호선,교대,10022,11174,21196,37.4928178646055,127.013838469407
20210627,2호선,구로디지털단지,22161,22028,44189,37.4853149237865,126.901494378412
20210627,2호선,구의,10834,10976,21810,37.5371535596228,127.086179228767
20210627,2호선,낙성대,15045,15543,30588,37.4770651843603,126.963409959152
20210627,2호선,당산,8387,9357,17744,37.534956866618,126.90273071003
20210627,2호선,대림,14343,14624,28967,37.4933105886136,126.8949461878
20210627,2호선,도림천,498,533,1031,37.5144420510515,126.882702584468
20210627,2호선,동대문역사문화공원,6926,8411,15337,37.5655895229776,127.009131498424
20210627,2호선,뚝섬,10312,10998,21310,37.5471882244091,127.047365178682
20210627,2호선,문래,7167,7697,14864,37.5179214637526,126.894763060556
20210627,2호선,방배,6302,7107,13409,37.4814364876589,126.997694899327
20210627,2호선,봉천,11843,11464,23307,37.4825562153548,126.941495272047
20210627,2호선,사당,19582,21961,41543,37.4765228347619,126.981408909449
20210627,2호선,삼성,20055,19317,39372,37.5088619974404,127.063073009788
20210627,2호선,상왕십리,6588,6733,13321,37.5644687111181,127.029031221392
20210627,2호선,서울대입구,26451,27528,53979,37.4811526631844,126.952645104944
20210627,2호선,서초,10387,9609,19996,37.4918229990093,127.007580814715
20210627,2호선,선릉,11828,10233,22061,37.5045028775835,127.048942471228
20210627,2호선,성수,12455,14132,26587,37.5445023983984,127.056090471223
20210627,2호선,시청,5729,4509,10238,37.5654385176408,126.976983237511
20210627,2호선,신답,659,783,1442,37.5699910562183,127.046820203556
20210627,2호선,신당,7811,8568,16379,37.5656540317328,127.019540574485
20210627,2호선,신대방,14758,14422,29180,37.4875759745635,126.913175585996
20210627,2호선,신도림,27041,27426,54467,37.5087701449787,126.891080501385
20210627,2호선,신림,35086,34885,69971,37.4841196518392,126.928712092948
20210627,2호선,신설동,2788,2935,5723,37.5762451837487,127.023278761358
20210627,2호선,신정네거리,4867,5086,9953,37.5197975266787,126.852991645059
20210627,2호선,신촌,21594,20791,42385,37.5554417865984,126.936119192554
20210627,2호선,아현,4939,5147,10086,37.5573575723061,126.95603374504
20210627,2호선,양천구청,3128,3261,6389,37.5126989358446,126.866065211751
20210627,2호선,역삼,10560,11517,22077,37.5007162693593,127.036618203089
20210627,2호선,영등포구청,7252,7541,14793,37.5256996614804,126.896626898379
20210627,2호선,왕십리,8811,7761,16572,37.5612217415191,127.036655378283
20210627,2호선,용답,1496,1609,3105,37.5620049052662,127.050729309179
20210627,2호선,용두,1101,1054,2155,37.5739380503267,127.038031119837
20210627,2호선,을지로3가,7886,7323,15209,37.56626594615,126.990308356253
20210627,2호선,을지로4가,3314,3147,6461,37.5666369941572,126.997852780281
20210627,2호선,을지로입구,15221,13821,29042,37.5660509513873,126.982372901787
20210627,2호선,이대,6688,7139,13827,37.5567980142044,126.945758201019
20210627,2호선,잠실,45419,42382,87801,37.513859279255,127.101857941447
20210627,2호선,잠실나루,4845,5016,9861,37.5206867318088,127.103811089444
20210627,2호선,잠실새내,10612,11195,21807,37.5115672093323,127.086373867207
20210627,2호선,종합운동장,6132,6319,12451,37.5109692748993,127.073356018706
20210627,2호선,충정로,3389,3642,7031,37.5598377952439,126.964474043785
20210627,2호선,한양대,2116,2301,4417,37.55557788354,127.043584493543
20210627,2호선,합정,19581,20567,40148,37.5501152068908,126.914638180431
20210627,2호선,홍대입구,45607,45149,90756,37.5577458058734,126.926498328277
20210703,2호선,강남,55661,54163,109824,37.4981646510326,127.028307900881
20210703,2호선,강변,23487,23930,47417,37.5351692767888,127.094664569096
20210703,2호선,건대입구,29728,30857,60585,37.5404188872176,127.069173281554
20210703,2호선,교대,15555,17585,33140,37.4928178646055,127.013838469407
20210703,2호선,구로디지털단지,30190,30140,60330,37.4853149237865,126.901494378412
20210703,2호선,구의,14649,14572,29221,37.5371535596228,127.086179228767
20210703,2호선,낙성대,19118,17917,37035,37.4770651843603,126.963409959152
20210703,2호선,당산,11041,12051,23092,37.534956866618,126.90273071003
20210703,2호선,대림,16211,17306,33517,37.4933105886136,126.8949461878
20210703,2호선,도림천,776,841,1617,37.5144420510515,126.882702584468
20210703,2호선,동대문역사문화공원,9090,9893,18983,37.5655895229776,127.009131498424
20210703,2호선,뚝섬,11250,11605,22855,37.5471882244091,127.047365178682
20210703,2호선,문래,10878,11533,22411,37.5179214637526,126.894763060556
20210703,2호선,방배,8614,8954,17568,37.4814364876589,126.997694899327
20210703,2호선,봉천,15326,14389,29715,37.4825562153548,126.941495272047
20210703,2호선,사당,25634,28121,53755,37.4765228347619,126.981408909449
20210703,2호선,삼성,32266,31844,64110,37.5088619974404,127.063073009788
20210703,2호선,상왕십리,8716,8413,17129,37.5644687111181,127.029031221392
20210703,2호선,서울대입구,34603,32914,67517,37.4811526631844,126.952645104944
20210703,2호선,서초,9028,7448,16476,37.4918229990093,127.007580814715
20210703,2호선,선릉,22319,19997,42316,37.5045028775835,127.048942471228
20210703,2호선,성수,16274,17469,33743,37.5445023983984,127.056090471223
20210703,2호선,시청,7643,6711,14354,37.5654385176408,126.976983237511
20210703,2호선,신답,891,951,1842,37.5699910562183,127.046820203556
20210703,2호선,신당,9586,10286,19872,37.5656540317328,127.019540574485
20210703,2호선,신대방,17904,17745,35649,37.4875759745635,126.913175585996
20210703,2호선,신도림,36956,36789,73745,37.5087701449787,126.891080501385
20210703,2호선,신림,44788,43185,87973,37.4841196518392,126.928712092948
20210703,2호선,신설동,2799,2584,5383,37.5762451837487,127.023278761358
20210703,2호선,신정네거리,6572,6771,13343,37.5197975266787,126.852991645059
20210703,2호선,신촌,27477,27650,55127,37.5554417865984,126.936119192554
20210703,2호선,아현,6876,6749,13625,37.5573575723061,126.95603374504
20210703,2호선,양천구청,4001,4161,8162,37.5126989358446,126.866065211751
20210703,2호선,역삼,16790,17932,34722,37.5007162693593,127.036618203089
20210703,2호선,영등포구청,11411,11851,23262,37.5256996614804,126.896626898379
20210703,2호선,왕십리,12064,10221,22285,37.5612217415191,127.036655378283
20210703,2호선,용답,1843,1891,3734,37.5620049052662,127.050729309179
20210703,2호선,용두,1617,1621,3238,37.5739380503267,127.038031119837
20210703,2호선,을지로3가,10914,10338,21252,37.56626594615,126.990308356253
20210703,2호선,을지로4가,6881,6436,13317,37.5666369941572,126.997852780281
20210703,2호선,을지로입구,18841,18362,37203,37.5660509513873,126.982372901787
20210703,2호선,이대,8985,9687,18672,37.5567980142044,126.945758201019
20210703,2호선,잠실,55559,52978,108537,37.513859279255,127.101857941447
20210703,2호선,잠실나루,6579,6550,13129,37.5206867318088,127.103811089444
20210703,2호선,잠실새내,15776,16214,31990,37.5115672093323,127.086373867207
20210703,2호선,종합운동장,4706,5350,10056,37.5109692748993,127.073356018706
20210703,2호선,충정로,5377,5761,11138,37.5598377952439,126.964474043785
20210703,2호선,한양대,3732,3754,7486,37.55557788354,127.043584493543
20210703,2호선,합정,23263,24901,48164,37.5501152068908,126.914638180431
20210703,2호선,홍대입구,45187,45330,90517,37.5577458058734,126.926498328277
20210704,2호선,강남,30583,29829,60412,37.4981646510326,127.028307900881
20210704,2호선,강변,18132,17286,35418,37.5351692767888,127.094664569096
20210704,2호선,건대입구,20381,21865,42246,37.5404188872176,127.069173281554
20210704,2호선,교대,9391,10113,19504,37.4928178646055,127.013838469407
20210704,2호선,구로디지털단지,19456,19449,38905,37.4853149237865,126.901494378412
20210704,2호선,구의,9565,9563,19128,37.5371535596228,127.086179228767
20210704,2호선,낙성대,12811,13344,26155,37.4770651843603,126.963409959152
20210704,2호선,당산,6699,7546,14245,37.534956866618,126.90273071003
20210704,2호선,대림,12689,12792,25481,37.4933105886136,126.8949461878
20210704,2호선,도림천,347,394,741,37.5144420510515,126.882702584468
20210704,2호선,동대문역사문화공원,5703,6689,12392,37.5655895229776,127.009131498424
20210704,2호선,뚝섬,7253,7499,14752,37.5471882244091,127.047365178682
20210704,2호선,문래,6202,6592,12794,37.5179214637526,126.894763060556
20210704,2호선,방배,5636,5987,11623,37.4814364876589,126.997694899327
20210704,2호선,봉천,10308,10064,20372,37.4825562153548,126.941495272047
20210704,2호선,사당,16832,18447,35279,37.4765228347619,126.981408909449
20210704,2호선,삼성,19801,19908,39709,37.5088619974404,127.063073009788
20210704,2호선,상왕십리,5628,5541,11169,37.5644687111181,127.029031221392
20210704,2호선,서울대입구,22487,23407,45894,37.4811526631844,126.952645104944
20210704,2호선,서초,9752,9126,18878,37.4918229990093,127.007580814715
20210704,2호선,선릉,10624,9251,19875,37.5045028775835,127.048942471228
20210704,2호선,성수,10044,11053,21097,37.5445023983984,127.056090471223
20210704,2호선,시청,4364,3638,8002,37.5654385176408,126.976983237511
20210704,2호선,신답,578,640,1218,37.5699910562183,127.046820203556
20210704,2호선,신당,6085,6558,12643,37.5656540317328,127.019540574485
20210704,2호선,신대방,12861,12706,25567,37.4875759745635,126.913175585996
20210704,2호선,신도림,24109,23946,48055,37.5087701449787,126.891080501385
20210704,2호선,신림,31258,30908,62166,37.4841196518392,126.928712092948
20210704,2호선,신설동,1569,1638,3207,37.5762451837487,127.023278761358
20210704,2호선,신정네거리,4132,4214,8346,37.5197975266787,126.852991645059
20210704,2호선,신촌,17814,17851,35665,37.5554417865984,126.936119192554
20210704,2호선,아현,4294,4280,8574,37.5573575723061,126.95603374504
20210704,2호선,양천구청,2615,2692,5307,37.5126989358446,126.866065211751
20210704,2호선,역삼,9526,10441,19967,37.5007162693593,127.036618203089
20210704,2호선,영등포구청,6633,6881,13514,37.5256996614804,126.896626898379
20210704,2호선,왕십리,7689,6754,14443,37.5612217415191,127.036655378283
20210704,2호선,용답,1318,1314,2632,37.5620049052662,127.050729309179
20210704,2호선,용두,944,921,1865,37.5739380503267,127.038031119837
20210704,2호선,을지로3가,6399,5993,12392,37.56626594615,126.990308356253
20210704,2호선,을지로4가,2488,2316,4804,37.5666369941572,126.997852780281
20210704,2호선,을지로입구,12577,12022,24599,37.5660509513873,126.982372901787
20210704,2호선,이대,5665,6089,11754,37.5567980142044,126.945758201019
20210704,2호선,잠실,37241,35203,72444,37.513859279255,127.101857941447
20210704,2호선,잠실나루,4152,4245,8397,37.5206867318088,127.103811089444
20210704,2호선,잠실새내,9502,9759,19261,37.5115672093323,127.086373867207
20210704,2호선,종합운동장,4320,4622,8942,37.5109692748993,127.073356018706
20210704,2호선,충정로,3182,3313,6495,37.5598377952439,126.964474043785
20210704,2호선,한양대,1961,2094,4055,37.55557788354,127.043584493543
20210704,2호선,합정,15481,16251,31732,37.5501152068908,126.914638180431
20210704,2호선,홍대입구,30461,30337,60798,37.5577458058734,126.926498328277
20210710,2호선,강남,45658,44727,90385,37.4981646510326,127.028307900881
20210710,2호선,강변,18906,20470,39376,37.5351692767888,127.094664569096
20210710,2호선,건대입구,23893,25665,49558,37.5404188872176,127.069173281554
20210710,2호선,교대,13921,15547,29468,37.4928178646055,127.013838469407
20210710,2호선,구로디지털단지,27616,27289,54905,37.4853149237865,126.901494378412
20210710,2호선,구의,13391,12822,26213,37.5371535596228,127.086179228767
20210710,2호선,낙성대,17524,16201,33725,37.4770651843603,126.963409959152
20210710,2호선,당산,9726,10701,20427,37.534956866618,126.90273071003
20210710,2호선,대림,15587,16574,32161,37.4933105886136,126.8949461878
20210710,2호선,도림천,737,685,1422,37.5144420510515,126.882702584468
20210710,2호선,동대문역사문화공원,7467,7885,15352,37.5655895229776,127.009131498424
20210710,2호선,뚝섬,9857,10227,20084,37.5471882244091,127.047365178682
20210710,2호선,문래,9316,9644,18960,37.5179214637526,126.894763060556
20210710,2호선,방배,7929,8189,16118,37.4814364876589,126.997694899327
20210710,2호선,봉천,14777,13329,28106,37.4825562153548,126.941495272047
20210710,2호선,사당,21481,23301,44782,37.4765228347619,126.981408909449
20210710,2호선,삼성,16920,17316,34236,37.5088619974404,127.063073009788
20210710,2호선,상왕십리,7797,7324,15121,37.5644687111181,127.029031221392
20210710,2호선,서울대입구,30505,29406,59911,37.4811526631844,126.952645104944
20210710,2호선,서초,8236,7153,15389,37.4918229990093,127.007580814715
20210710,2호선,선릉,19349,17014,36363,37.5045028775835,127.048942471228
20210710,2호선,성수,13198,15001,28199,37.5445023983984,127.056090471223
20210710,2호선,시청,6115,5447,11562,37.5654385176408,126.976983237511
20210710,2호선,신답,812,839,1651,37.5699910562183,127.046820203556
20210710,2호선,신당,8844,9016,17860,37.5656540317328,127.019540574485
20210710,2호선,신대방,16731,15932,32663,37.4875759745635,126.913175585996
20210710,2호선,신도림,30709,30600,61309,37.5087701449787,126.891080501385
20210710,2호선,신림,41139,39165,80304,37.4841196518392,126.928712092948
20210710,2호선,신설동,2369,2415,4784,37.5762451837487,127.023278761358
20210710,2호선,신정네거리,6023,6116,12139,37.5197975266787,126.852991645059
20210710,2호선,신촌,21855,22076,43931,37.5554417865984,126.936119192554
20210710,2호선,아현,6360,5975,12335,37.5573575723061,126.95603374504
20210710,2호선,양천구청,3524,3610,7134,37.5126989358446,126.866065211751
20210710,2호선,역삼,14045,15301,29346,37.5007162693593,127.036618203089
20210710,2호선,영등포구청,10128,10258,20386,37.5256996614804,126.896626898379
20210710,2호선,왕십리,10024,8387,18411,37.5612217415191,127.036655378283
20210710,2호선,용답,1807,1734,3541,37.5620049052662,127.050729309179
20210710,2호선,용두,1504,1437,2941,37.5739380503267,127.038031119837
20210710,2호선,을지로3가,7238,7373,14611,37.56626594615,126.990308356253
20210710,2호선,을지로4가,5379,5337,10716,37.5666369941572,126.997852780281
20210710,2호선,을지로입구,14958,15262,30220,37.5660509513873,126.982372901787
20210710,2호선,이대,7764,7979,15743,37.5567980142044,126.945758201019
20210710,2호선,잠실,42242,40518,82760,37.513859279255,127.101857941447
20210710,2호선,잠실나루,5978,5869,11847,37.5206867318088,127.103811089444
20210710,2호선,잠실새내,13642,13949,27591,37.5115672093323,127.086373867207
20210710,2호선,종합운동장,3664,4063,7727,37.5109692748993,127.073356018706
20210710,2호선,충정로,4385,4544,8929,37.5598377952439,126.964474043785
20210710,2호선,한양대,3559,3538,7097,37.55557788354,127.043584493543
20210710,2호선,합정,19081,20296,39377,37.5501152068908,126.914638180431
20210710,2호선,홍대입구,36362,37574,73936,37.5577458058734,126.926498328277
20210711,2호선,강남,24776,23822,48598,37.4981646510326,127.028307900881
20210711,2호선,강변,15644,14589,30233,37.5351692767888,127.094664569096
20210711,2호선,건대입구,17579,18872,36451,37.5404188872176,127.069173281554
20210711,2호선,교대,8237,8966,17203,37.4928178646055,127.013838469407
20210711,2호선,구로디지털단지,17776,17502,35278,37.4853149237865,126.901494378412
20210711,2호선,구의,8739,8940,17679,37.5371535596228,127.086179228767
20210711,2호선,낙성대,12045,12520,24565,37.4770651843603,126.963409959152
20210711,2호선,당산,6201,6736,12937,37.534956866618,126.90273071003
20210711,2호선,대림,11324,11453,22777,37.4933105886136,126.8949461878
20210711,2호선,도림천,404,426,830,37.5144420510515,126.882702584468
20210711,2호선,동대문역사문화공원,5180,6182,11362,37.5655895229776,127.009131498424
20210711,2호선,뚝섬,6709,6929,13638,37.5471882244091,127.047365178682
20210711,2호선,문래,5442,5803,11245,37.5179214637526,126.894763060556
20210711,2호선,방배,5078,5417,10495,37.4814364876589,126.997694899327
20210711,2호선,봉천,9584,9420,19004,37.4825562153548,126.941495272047
20210711,2호선,사당,14354,16067,30421,37.4765228347619,126.981408909449
20210711,2호선,삼성,10771,10708,21479,37.5088619974404,127.063073009788
20210711,2호선,상왕십리,5332,5231,10563,37.5644687111181,127.029031221392
20210711,2호선,서울대입구,20979,21671,42650,37.4811526631844,126.952645104944
20210711,2호선,서초,8127,7649,15776,37.4918229990093,127.007580814715
20210711,2호선,선릉,9741,8410,18151,37.5045028775835,127.048942471228
20210711,2호선,성수,8669,9670,18339,37.5445023983984,127.056090471223
20210711,2호선,시청,3963,3319,7282,37.5654385176408,126.976983237511
20210711,2호선,신답,548,618,1166,37.5699910562183,127.046820203556
20210711,2호선,신당,5859,6216,12075,37.5656540317328,127.019540574485
20210711,2호선,신대방,11895,11691,23586,37.4875759745635,126.913175585996
20210711,2호선,신도림,20640,20851,41491,37.5087701449787,126.891080501385
20210711,2호선,신림,28441,28777,57218,37.4841196518392,126.928712092948
20210711,2호선,신설동,1798,1908,3706,37.5762451837487,127.023278761358
20210711,2호선,신정네거리,3853,3899,7752,37.5197975266787,126.852991645059
20210711,2호선,신촌,15452,15281,30733,37.5554417865984,126.936119192554
20210711,2호선,아현,3947,3973,7920,37.5573575723061,126.95603374504
20210711,2호선,양천구청,2549,2690,5239,37.5126989358446,126.866065211751
20210711,2호선,역삼,8158,9216,17374,37.5007162693593,127.036618203089
20210711,2호선,영등포구청,5895,6050,11945,37.5256996614804,126.896626898379
20210711,2호선,왕십리,7006,6030,13036,37.5612217415191,127.036655378283
20210711,2호선,용답,1316,1292,2608,37.5620049052662,127.050729309179
20210711,2호선,용두,803,879,1682,37.5739380503267,127.038031119837
20210711,2호선,을지로3가,5359,5010,10369,37.56626594615,126.990308356253
20210711,2호선,을지로4가,2376,2103,4479,37.5666369941572,126.997852780281
20210711,2호선,을지로입구,11167,10658,21825,37.5660509513873,126.982372901787
20210711,2호선,이대,5182,5595,10777,37.5567980142044,126.945758201019
20210711,2호선,잠실,30082,28364,58446,37.513859279255,127.101857941447
20210711,2호선,잠실나루,4018,4076,8094,37.5206867318088,127.103811089444
20210711,2호선,잠실새내,8096,8538,16634,37.5115672093323,127.086373867207
20210711,2호선,종합운동장,2724,2893,5617,37.5109692748993,127.073356018706
20210711,2호선,충정로,2679,2782,5461,37.5598377952439,126.964474043785
20210711,2호선,한양대,1802,1880,3682,37.55557788354,127.043584493543
20210711,2호선,합정,13201,13699,26900,37.5501152068908,126.914638180431
20210711,2호선,홍대입구,26005,25978,51983,37.5577458058734,126.926498328277
20210717,2호선,강남,41697,40497,82194,37.4981646510326,127.028307900881
20210717,2호선,강변,17064,18659,35723,37.5351692767888,127.094664569096
20210717,2호선,건대입구,21888,23623,45511,37.5404188872176,127.069173281554
20210717,2호선,교대,12775,14199,26974,37.4928178646055,127.013838469407
20210717,2호선,구로디지털단지,25261,24906,50167,37.4853149237865,126.901494378412
20210717,2호선,구의,12339,12026,24365,37.5371535596228,127.086179228767
20210717,2호선,낙성대,16018,14850,30868,37.4770651843603,126.963409959152
20210717,2호선,당산,8668,9552,18220,37.534956866618,126.90273071003
20210717,2호선,대림,13678,14717,28395,37.4933105886136,126.8949461878
20210717,2호선,도림천,630,640,1270,37.5144420510515,126.882702584468
20210717,2호선,동대문역사문화공원,6706,7049,13755,37.5655895229776,127.009131498424
20210717,2호선,뚝섬,8731,9057,17788,37.5471882244091,127.047365178682
20210717,2호선,문래,8066,8270,16336,37.5179214637526,126.894763060556
20210717,2호선,방배,6933,7323,14256,37.4814364876589,126.997694899327
20210717,2호선,봉천,13565,12466,26031,37.4825562153548,126.941495272047
20210717,2호선,사당,19765,21074,40839,37.4765228347619,126.981408909449
20210717,2호선,삼성,15637,15570,31207,37.5088619974404,127.063073009788
20210717,2호선,상왕십리,7461,7010,14471,37.5644687111181,127.029031221392
20210717,2호선,서울대입구,29057,27496,56553,37.4811526631844,126.952645104944
20210717,2호선,서초,6843,6126,12969,37.4918229990093,127.007580814715
20210717,2호선,선릉,17217,15260,32477,37.5045028775835,127.048942471228
20210717,2호선,성수,12200,13695,25895,37.5445023983984,127.056090471223
20210717,2호선,시청,5440,5024,10464,37.5654385176408,126.976983237511
20210717,2호선,신답,783,859,1642,37.5699910562183,127.046820203556
20210717,2호선,신당,8032,8166,16198,37.5656540317328,127.019540574485
20210717,2호선,신대방,15662,15357,31019,37.4875759745635,126.913175585996
20210717,2호선,신도림,27392,26983,54375,37.5087701449787,126.891080501385
20210717,2호선,신림,37639,36329,73968,37.4841196518392,126.928712092948
20210717,2호선,신설동,2481,2434,4915,37.5762451837487,127.023278761358
20210717,2호선,신정네거리,5457,5419,10876,37.5197975266787,126.852991645059
20210717,2호선,신촌,19778,19756,39534,37.5554417865984,126.936119192554
20210717,2호선,아현,5709,5415,11124,37.5573575723061,126.95603374504
20210717,2호선,양천구청,3491,3664,7155,37.5126989358446,126.866065211751
20210717,2호선,역삼,13071,14182,27253,37.5007162693593,127.036618203089
20210717,2호선,영등포구청,8744,9019,17763,37.5256996614804,126.896626898379
20210717,2호선,왕십리,9442,7648,17090,37.5612217415191,127.036655378283
20210717,2호선,용답,1640,1523,3163,37.5620049052662,127.050729309179
20210717,2호선,용두,1426,1399,2825,37.5739380503267,127.038031119837
20210717,2호선,을지로3가,6719,6625,13344,37.56626594615,126.990308356253
20210717,2호선,을지로4가,5185,5007,10192,37.5666369941572,126.997852780281
20210717,2호선,을지로입구,13293,13564,26857,37.5660509513873,126.982372901787
20210717,2호선,이대,7043,7271,14314,37.5567980142044,126.945758201019
20210717,2호선,잠실,39211,37600,76811,37.513859279255,127.101857941447
20210717,2호선,잠실나루,5397,5282,10679,37.5206867318088,127.103811089444
20210717,2호선,잠실새내,12273,12624,24897,37.5115672093323,127.086373867207
20210717,2호선,종합운동장,3389,3841,7230,37.5109692748993,127.073356018706
20210717,2호선,충정로,3810,3790,7600,37.5598377952439,126.964474043785
20210717,2호선,한양대,2954,2787,5741,37.55557788354,127.043584493543
20210717,2호선,합정,17413,18318,35731,37.5501152068908,126.914638180431
20210717,2호선,홍대입구,33792,34612,68404,37.5577458058734,126.926498328277
20210718,2호선,강남,22663,21855,44518,37.4981646510326,127.028307900881
20210718,2호선,강변,14769,13181,27950,37.5351692767888,127.094664569096
20210718,2호선,건대입구,16624,17922,34546,37.5404188872176,127.069173281554
20210718,2호선,교대,7343,8226,15569,37.4928178646055,127.013838469407
20210718,2호선,구로디지털단지,16500,16620,33120,37.4853149237865,126.901494378412
20210718,2호선,구의,8250,8231,16481,37.5371535596228,127.086179228767
20210718,2호선,낙성대,10851,11442,22293,37.4770651843603,126.963409959152
20210718,2호선,당산,5921,6250,12171,37.534956866618,126.90273071003
20210718,2호선,대림,10304,10670,20974,37.4933105886136,126.8949461878
20210718,2호선,도림천,332,346,678,37.5144420510515,126.882702584468
20210718,2호선,동대문역사문화공원,5076,6225,11301,37.5655895229776,127.009131498424
20210718,2호선,뚝섬,6024,6401,12425,37.5471882244091,127.047365178682
20210718,2호선,문래,5219,5513,10732,37.5179214637526,126.894763060556
20210718,2호선,방배,4476,4823,9299,37.4814364876589,126.997694899327
20210718,2호선,봉천,8796,8757,17553,37.4825562153548,126.941495272047
20210718,2호선,사당,13292,14803,28095,37.4765228347619,126.981408909449
20210718,2호선,삼성,10780,10566,21346,37.5088619974404,127.063073009788
20210718,2호선,상왕십리,4850,4773,9623,37.5644687111181,127.029031221392
20210718,2호선,서울대입구,19484,20276,39760,37.4811526631844,126.952645104944
20210718,2호선,서초,4504,4010,8514,37.4918229990093,127.007580814715
20210718,2호선,선릉,9219,8014,17233,37.5045028775835,127.048942471228
20210718,2호선,성수,8224,9504,17728,37.5445023983984,127.056090471223
20210718,2호선,시청,3730,3290,7020,37.5654385176408,126.976983237511
20210718,2호선,신답,493,566,1059,37.5699910562183,127.046820203556
20210718,2호선,신당,5619,6015,11634,37.5656540317328,127.019540574485
20210718,2호선,신대방,11253,11084,22337,37.4875759745635,126.913175585996
20210718,2호선,신도림,19019,19216,38235,37.5087701449787,126.891080501385
20210718,2호선,신림,26402,26360,52762,37.4841196518392,126.928712092948
20210718,2호선,신설동,2097,2211,4308,37.5762451837487,127.023278761358
20210718,2호선,신정네거리,3671,3744,7415,37.5197975266787,126.852991645059
20210718,2호선,신촌,14047,13884,27931,37.5554417865984,126.936119192554
20210718,2호선,아현,3650,3648,7298,37.5573575723061,126.95603374504
20210718,2호선,양천구청,2147,2318,4465,37.5126989358446,126.866065211751
20210718,2호선,역삼,7036,8113,15149,37.5007162693593,127.036618203089
20210718,2호선,영등포구청,5417,5684,11101,37.5256996614804,126.896626898379
20210718,2호선,왕십리,6377,5586,11963,37.5612217415191,127.036655378283
20210718,2호선,용답,1279,1242,2521,37.5620049052662,127.050729309179
20210718,2호선,용두,924,919,1843,37.5739380503267,127.038031119837
20210718,2호선,을지로3가,4096,3870,7966,37.56626594615,126.990308356253
20210718,2호선,을지로4가,2257,1971,4228,37.5666369941572,126.997852780281
20210718,2호선,을지로입구,10216,9901,20117,37.5660509513873,126.982372901787
20210718,2호선,이대,4673,5287,9960,37.5567980142044,126.945758201019
20210718,2호선,잠실,28528,27156,55684,37.513859279255,127.101857941447
20210718,2호선,잠실나루,3521,3668,7189,37.5206867318088,127.103811089444
20210718,2호선,잠실새내,7591,7960,15551,37.5115672093323,127.086373867207
20210718,2호선,종합운동장,2330,2498,4828,37.5109692748993,127.073356018706
20210718,2호선,충정로,2431,2538,4969,37.5598377952439,126.964474043785
20210718,2호선,한양대,1710,1947,3657,37.55557788354,127.043584493543
20210718,2호선,합정,12786,13101,25887,37.5501152068908,126.914638180431
20210718,2호선,홍대입구,25835,25553,51388,37.5577458058734,126.926498328277
20210724,2호선,강남,42937,41636,84573,37.4981646510326,127.028307900881
20210724,2호선,강변,16842,17798,34640,37.5351692767888,127.094664569096
20210724,2호선,건대입구,21729,23279,45008,37.5404188872176,127.069173281554
20210724,2호선,교대,12462,13985,26447,37.4928178646055,127.013838469407
20210724,2호선,구로디지털단지,25287,24704,49991,37.4853149237865,126.901494378412
20210724,2호선,구의,12296,11987,24283,37.5371535596228,127.086179228767
20210724,2호선,낙성대,15918,14823,30741,37.4770651843603,126.963409959152
20210724,2호선,당산,8303,9148,17451,37.534956866618,126.90273071003
20210724,2호선,대림,13672,14586,28258,37.4933105886136,126.8949461878
20210724,2호선,도림천,674,684,1358,37.5144420510515,126.882702584468
20210724,2호선,동대문역사문화공원,6915,7269,14184,37.5655895229776,127.009131498424
20210724,2호선,뚝섬,8550,8944,17494,37.5471882244091,127.047365178682
20210724,2호선,문래,7950,8274,16224,37.5179214637526,126.894763060556
20210724,2호선,방배,6880,7240,14120,37.4814364876589,126.997694899327
20210724,2호선,봉천,13469,12391,25860,37.4825562153548,126.941495272047
20210724,2호선,사당,19558,21213,40771,37.4765228347619,126.981408909449
20210724,2호선,삼성,17511,17258,34769,37.5088619974404,127.063073009788
20210724,2호선,상왕십리,7493,7164,14657,37.5644687111181,127.029031221392
20210724,2호선,서울대입구,28244,27393,55637,37.4811526631844,126.952645104944
20210724,2호선,서초,6837,5899,12736,37.4918229990093,127.007580814715
20210724,2호선,선릉,17225,15176,32401,37.5045028775835,127.048942471228
20210724,2호선,성수,12232,13723,25955,37.5445023983984,127.056090471223
20210724,2호선,시청,5656,5256,10912,37.5654385176408,126.976983237511
20210724,2호선,신답,701,729,1430,37.5699910562183,127.046820203556
20210724,2호선,신당,7987,8172,16159,37.5656540317328,127.019540574485
20210724,2호선,신대방,15247,14855,30102,37.4875759745635,126.913175585996
20210724,2호선,신도림,26918,26611,53529,37.5087701449787,126.891080501385
20210724,2호선,신림,38330,36632,74962,37.4841196518392,126.928712092948
20210724,2호선,신설동,2290,2224,4514,37.5762451837487,127.023278761358
20210724,2호선,신정네거리,5629,5806,11435,37.5197975266787,126.852991645059
20210724,2호선,신촌,20259,20026,40285,37.5554417865984,126.936119192554
20210724,2호선,아현,5588,5433,11021,37.5573575723061,126.95603374504
20210724,2호선,양천구청,3501,3522,7023,37.5126989358446,126.866065211751
20210724,2호선,역삼,13011,14155,27166,37.5007162693593,127.036618203089
20210724,2호선,영등포구청,8858,8857,17715,37.5256996614804,126.896626898379
20210724,2호선,왕십리,8997,7336,16333,37.5612217415191,127.036655378283
20210724,2호선,용답,1657,1585,3242,37.5620049052662,127.050729309179
20210724,2호선,용두,1396,1392,2788,37.5739380503267,127.038031119837
20210724,2호선,을지로3가,6556,6481,13037,37.56626594615,126.990308356253
20210724,2호선,을지로4가,4988,5042,10030,37.5666369941572,126.997852780281
20210724,2호선,을지로입구,13466,13611,27077,37.5660509513873,126.982372901787
20210724,2호선,이대,7011,7170,14181,37.5567980142044,126.945758201019
20210724,2호선,잠실,39735,38475,78210,37.513859279255,127.101857941447
20210724,2호선,잠실나루,5543,5444,10987,37.5206867318088,127.103811089444
20210724,2호선,잠실새내,12245,12568,24813,37.5115672093323,127.086373867207
20210724,2호선,종합운동장,3210,3541,6751,37.5109692748993,127.073356018706
20210724,2호선,충정로,3605,3646,7251,37.5598377952439,126.964474043785
20210724,2호선,한양대,2510,2424,4934,37.55557788354,127.043584493543
20210724,2호선,합정,17232,17959,35191,37.5501152068908,126.914638180431
20210724,2호선,홍대입구,34196,35340,69536,37.5577458058734,126.926498328277
20210725,2호선,강남,23092,21811,44903,37.4981646510326,127.028307900881
20210725,2호선,강변,14220,12988,27208,37.5351692767888,127.094664569096
20210725,2호선,건대입구,16175,17061,33236,37.5404188872176,127.069173281554
20210725,2호선,교대,6985,7884,14869,37.4928178646055,127.013838469407
20210725,2호선,구로디지털단지,15981,15940,31921,37.4853149237865,126.901494378412
20210725,2호선,구의,8018,8194,16212,37.5371535596228,127.086179228767
20210725,2호선,낙성대,10686,11152,21838,37.4770651843603,126.963409959152
20210725,2호선,당산,5601,6026,11627,37.534956866618,126.90273071003
20210725,2호선,대림,10027,10179,20206,37.4933105886136,126.8949461878
20210725,2호선,도림천,345,373,718,37.5144420510515,126.882702584468
20210725,2호선,동대문역사문화공원,5147,6090,11237,37.5655895229776,127.009131498424
20210725,2호선,뚝섬,5553,5929,11482,37.5471882244091,127.047365178682
20210725,2호선,문래,4773,4965,9738,37.5179214637526,126.894763060556
20210725,2호선,방배,4283,4731,9014,37.4814364876589,126.997694899327
20210725,2호선,봉천,8600,8587,17187,37.4825562153548,126.941495272047
20210725,2호선,사당,13011,14481,27492,37.4765228347619,126.981408909449
20210725,2호선,삼성,12061,11701,23762,37.5088619974404,127.063073009788
20210725,2호선,상왕십리,4874,4815,9689,37.5644687111181,127.029031221392
20210725,2호선,서울대입구,19091,20017,39108,37.4811526631844,126.952645104944
20210725,2호선,서초,4248,3762,8010,37.4918229990093,127.007580814715
20210725,2호선,선릉,8750,7575,16325,37.5045028775835,127.048942471228
20210725,2호선,성수,7837,8671,16508,37.5445023983984,127.056090471223
20210725,2호선,시청,3614,3149,6763,37.5654385176408,126.976983237511
20210725,2호선,신답,458,544,1002,37.5699910562183,127.046820203556
20210725,2호선,신당,5503,5898,11401,37.5656540317328,127.019540574485
20210725,2호선,신대방,10761,10741,21502,37.4875759745635,126.913175585996
20210725,2호선,신도림,17664,17981,35645,37.5087701449787,126.891080501385
20210725,2호선,신림,26504,26509,53013,37.4841196518392,126.928712092948
20210725,2호선,신설동,1877,2066,3943,37.5762451837487,127.023278761358
20210725,2호선,신정네거리,3571,3713,7284,37.5197975266787,126.852991645059
20210725,2호선,신촌,14001,13863,27864,37.5554417865984,126.936119192554
20210725,2호선,아현,3683,3727,7410,37.5573575723061,126.95603374504
20210725,2호선,양천구청,2052,2210,4262,37.5126989358446,126.866065211751
20210725,2호선,역삼,7023,7848,14871,37.5007162693593,127.036618203089
20210725,2호선,영등포구청,5113,5187,10300,37.5256996614804,126.896626898379
20210725,2호선,왕십리,6253,5384,11637,37.5612217415191,127.036655378283
20210725,2호선,용답,1235,1237,2472,37.5620049052662,127.050729309179
20210725,2호선,용두,802,804,1606,37.5739380503267,127.038031119837
20210725,2호선,을지로3가,4348,3965,8313,37.56626594615,126.990308356253
20210725,2호선,을지로4가,2164,2101,4265,37.5666369941572,126.997852780281
20210725,2호선,을지로입구,10098,9635,19733,37.5660509513873,126.982372901787
20210725,2호선,이대,4599,5005,9604,37.5567980142044,126.945758201019
20210725,2호선,잠실,29102,27573,56675,37.513859279255,127.101857941447
20210725,2호선,잠실나루,3721,3817,7538,37.5206867318088,127.103811089444
20210725,2호선,잠실새내,7469,7739,15208,37.5115672093323,127.086373867207
20210725,2호선,종합운동장,2161,2316,4477,37.5109692748993,127.073356018706
20210725,2호선,충정로,2624,2684,5308,37.5598377952439,126.964474043785
20210725,2호선,한양대,1921,1861,3782,37.55557788354,127.043584493543
20210725,2호선,합정,12360,12803,25163,37.5501152068908,126.914638180431
20210725,2호선,홍대입구,25789,25701,51490,37.5577458058734,126.926498328277
20210731,2호선,강남,41805,40653,82458,37.4981646510326,127.028307900881
20210731,2호선,강변,17348,18797,36145,37.5351692767888,127.094664569096
20210731,2호선,건대입구,21975,23515,45490,37.5404188872176,127.069173281554
20210731,2호선,교대,11996,13313,25309,37.4928178646055,127.013838469407
20210731,2호선,구로디지털단지,24995,24528,49523,37.4853149237865,126.901494378412
20210731,2호선,구의,12046,11872,23918,37.5371535596228,127.086179228767
20210731,2호선,낙성대,15547,14355,29902,37.4770651843603,126.963409959152
20210731,2호선,당산,8535,9431,17966,37.534956866618,126.90273071003
20210731,2호선,대림,13277,14365,27642,37.4933105886136,126.8949461878
20210731,2호선,도림천,477,474,951,37.5144420510515,126.882702584468
20210731,2호선,동대문역사문화공원,6622,7133,13755,37.5655895229776,127.009131498424
20210731,2호선,뚝섬,8632,8849,17481,37.5471882244091,127.047365178682
20210731,2호선,문래,7756,7994,15750,37.5179214637526,126.894763060556
20210731,2호선,방배,6785,7087,13872,37.4814364876589,126.997694899327
20210731,2호선,봉천,13265,12105,25370,37.4825562153548,126.941495272047
20210731,2호선,사당,19268,21010,40278,37.4765228347619,126.981408909449
20210731,2호선,삼성,18310,18140,36450,37.5088619974404,127.063073009788
20210731,2호선,상왕십리,7226,6964,14190,37.5644687111181,127.029031221392
20210731,2호선,서울대입구,28016,26840,54856,37.4811526631844,126.952645104944
20210731,2호선,서초,6614,5751,12365,37.4918229990093,127.007580814715
20210731,2호선,선릉,16978,14866,31844,37.5045028775835,127.048942471228
20210731,2호선,성수,12226,13843,26069,37.5445023983984,127.056090471223
20210731,2호선,시청,5645,5137,10782,37.5654385176408,126.976983237511
20210731,2호선,신답,687,745,1432,37.5699910562183,127.046820203556
20210731,2호선,신당,8055,8232,16287,37.5656540317328,127.019540574485
20210731,2호선,신대방,15127,14625,29752,37.4875759745635,126.913175585996
20210731,2호선,신도림,26312,25987,52299,37.5087701449787,126.891080501385
20210731,2호선,신림,37748,35749,73497,37.4841196518392,126.928712092948
20210731,2호선,신설동,2255,2292,4547,37.5762451837487,127.023278761358
20210731,2호선,신정네거리,5350,5383,10733,37.5197975266787,126.852991645059
20210731,2호선,신촌,20467,20269,40736,37.5554417865984,126.936119192554
20210731,2호선,아현,5579,5323,10902,37.5573575723061,126.95603374504
20210731,2호선,양천구청,3070,3141,6211,37.5126989358446,126.866065211751
20210731,2호선,역삼,12785,13843,26628,37.5007162693593,127.036618203089
20210731,2호선,영등포구청,8605,8706,17311,37.5256996614804,126.896626898379
20210731,2호선,왕십리,8841,7545,16386,37.5612217415191,127.036655378283
20210731,2호선,용답,1613,1510,3123,37.5620049052662,127.050729309179
20210731,2호선,용두,1292,1364,2656,37.5739380503267,127.038031119837
20210731,2호선,을지로3가,6490,6366,12856,37.56626594615,126.990308356253
20210731,2호선,을지로4가,4755,4782,9537,37.5666369941572,126.997852780281
20210731,2호선,을지로입구,13596,13636,27232,37.5660509513873,126.982372901787
20210731,2호선,이대,7170,7463,14633,37.5567980142044,126.945758201019
20210731,2호선,잠실,40874,39139,80013,37.513859279255,127.101857941447
20210731,2호선,잠실나루,5174,5213,10387,37.5206867318088,127.103811089444
20210731,2호선,잠실새내,11860,12172,24032,37.5115672093323,127.086373867207
20210731,2호선,종합운동장,3199,3530,6729,37.5109692748993,127.073356018706
20210731,2호선,충정로,3488,3556,7044,37.5598377952439,126.964474043785
20210731,2호선,한양대,2443,2275,4718,37.55557788354,127.043584493543
20210731,2호선,합정,17503,18751,36254,37.5501152068908,126.914638180431
20210731,2호선,홍대입구,36540,37316,73856,37.5577458058734,126.926498328277
20210801,2호선,강남,22794,21657,44451,37.4981646510326,127.028307900881
20210801,2호선,강변,14937,13651,28588,37.5351692767888,127.094664569096
20210801,2호선,건대입구,16655,17267,33922,37.5404188872176,127.069173281554
20210801,2호선,교대,7026,7989,15015,37.4928178646055,127.013838469407
20210801,2호선,구로디지털단지,16018,16141,32159,37.4853149237865,126.901494378412
20210801,2호선,구의,7814,8028,15842,37.5371535596228,127.086179228767
20210801,2호선,낙성대,10345,10954,21299,37.4770651843603,126.963409959152
20210801,2호선,당산,5429,5942,11371,37.534956866618,126.90273071003
20210801,2호선,대림,10160,10436,20596,37.4933105886136,126.8949461878
20210801,2호선,도림천,328,341,669,37.5144420510515,126.882702584468
20210801,2호선,동대문역사문화공원,4860,5881,10741,37.5655895229776,127.009131498424
20210801,2호선,뚝섬,5661,5917,11578,37.5471882244091,127.047365178682
20210801,2호선,문래,4893,5277,10170,37.5179214637526,126.894763060556
20210801,2호선,방배,4314,4779,9093,37.4814364876589,126.997694899327
20210801,2호선,봉천,8460,8424,16884,37.4825562153548,126.941495272047
20210801,2호선,사당,12913,13979,26892,37.4765228347619,126.981408909449
20210801,2호선,삼성,13530,13007,26537,37.5088619974404,127.063073009788
20210801,2호선,상왕십리,4753,4749,9502,37.5644687111181,127.029031221392
20210801,2호선,서울대입구,18704,19316,38020,37.4811526631844,126.952645104944
20210801,2호선,서초,4561,4020,8581,37.4918229990093,127.007580814715
20210801,2호선,선릉,8611,7569,16180,37.5045028775835,127.048942471228
20210801,2호선,성수,8158,8951,17109,37.5445023983984,127.056090471223
20210801,2호선,시청,3745,3221,6966,37.5654385176408,126.976983237511
20210801,2호선,신답,491,576,1067,37.5699910562183,127.046820203556
20210801,2호선,신당,5409,5943,11352,37.5656540317328,127.019540574485
20210801,2호선,신대방,10635,10774,21409,37.4875759745635,126.913175585996
20210801,2호선,신도림,17539,17656,35195,37.5087701449787,126.891080501385
20210801,2호선,신림,25620,25776,51396,37.4841196518392,126.928712092948
20210801,2호선,신설동,1710,1912,3622,37.5762451837487,127.023278761358
20210801,2호선,신정네거리,3578,3592,7170,37.5197975266787,126.852991645059
20210801,2호선,신촌,13752,13744,27496,37.5554417865984,126.936119192554
20210801,2호선,아현,3495,3501,6996,37.5573575723061,126.95603374504
20210801,2호선,양천구청,2073,2174,4247,37.5126989358446,126.866065211751
20210801,2호선,역삼,7298,8290,15588,37.5007162693593,127.036618203089
20210801,2호선,영등포구청,5280,5549,10829,37.5256996614804,126.896626898379
20210801,2호선,왕십리,6339,5523,11862,37.5612217415191,127.036655378283
20210801,2호선,용답,1234,1167,2401,37.5620049052662,127.050729309179
20210801,2호선,용두,843,873,1716,37.5739380503267,127.038031119837
20210801,2호선,을지로3가,4271,4004,8275,37.56626594615,126.990308356253
20210801,2호선,을지로4가,2146,2083,4229,37.5666369941572,126.997852780281
20210801,2호선,을지로입구,10285,9709,19994,37.5660509513873,126.982372901787
20210801,2호선,이대,4401,4861,9262,37.5567980142044,126.945758201019
20210801,2호선,잠실,29791,28084,57875,37.513859279255,127.101857941447
20210801,2호선,잠실나루,3646,3752,7398,37.5206867318088,127.103811089444
20210801,2호선,잠실새내,7571,7839,15410,37.5115672093323,127.086373867207
20210801,2호선,종합운동장,2150,2328,4478,37.5109692748993,127.073356018706
20210801,2호선,충정로,2389,2484,4873,37.5598377952439,126.964474043785
20210801,2호선,한양대,1365,1527,2892,37.55557788354,127.043584493543
20210801,2호선,합정,12834,13496,26330,37.5501152068908,126.914638180431
20210801,2호선,홍대입구,27687,27235,54922,37.5577458058734,126.926498328277
20210807,2호선,강남,44891,43388,88279,37.4981646510326,127.028307900881
20210807,2호선,강변,18060,18948,37008,37.5351692767888,127.094664569096
20210807,2호선,건대입구,23513,25339,48852,37.5404188872176,127.069173281554
20210807,2호선,교대,12830,14213,27043,37.4928178646055,127.013838469407
20210807,2호선,구로디지털단지,26272,25628,51900,37.4853149237865,126.901494378412
20210807,2호선,구의,12610,12567,25177,37.5371535596228,127.086179228767
20210807,2호선,낙성대,16761,15622,32383,37.4770651843603,126.963409959152
20210807,2호선,당산,9167,9909,19076,37.534956866618,126.90273071003
20210807,2호선,대림,14365,15260,29625,37.4933105886136,126.8949461878
20210807,2호선,도림천,676,664,1340,37.5144420510515,126.882702584468
20210807,2호선,동대문역사문화공원,7353,7944,15297,37.5655895229776,127.009131498424
20210807,2호선,뚝섬,9736,10125,19861,37.5471882244091,127.047365178682
20210807,2호선,문래,8616,9015,17631,37.5179214637526,126.894763060556
20210807,2호선,방배,7071,7399,14470,37.4814364876589,126.997694899327
20210807,2호선,봉천,13698,12688,26386,37.4825562153548,126.941495272047
20210807,2호선,사당,20493,22147,42640,37.4765228347619,126.981408909449
20210807,2호선,삼성,21104,20986,42090,37.5088619974404,127.063073009788
20210807,2호선,상왕십리,7615,7191,14806,37.5644687111181,127.029031221392
20210807,2호선,서울대입구,29685,28546,58231,37.4811526631844,126.952645104944
20210807,2호선,서초,7009,6047,13056,37.4918229990093,127.007580814715
20210807,2호선,선릉,17593,15500,33093,37.5045028775835,127.048942471228
20210807,2호선,성수,13117,14898,28015,37.5445023983984,127.056090471223
20210807,2호선,시청,5719,5203,10922,37.5654385176408,126.976983237511
20210807,2호선,신답,763,811,1574,37.5699910562183,127.046820203556
20210807,2호선,신당,8323,8674,16997,37.5656540317328,127.019540574485
20210807,2호선,신대방,15659,15154,30813,37.4875759745635,126.913175585996
20210807,2호선,신도림,27944,27578,55522,37.5087701449787,126.891080501385
20210807,2호선,신림,39029,37540,76569,37.4841196518392,126.928712092948
20210807,2호선,신설동,2446,2458,4904,37.5762451837487,127.023278761358
20210807,2호선,신정네거리,5870,5990,11860,37.5197975266787,126.852991645059
20210807,2호선,신촌,21690,21810,43500,37.5554417865984,126.936119192554
20210807,2호선,아현,5835,5529,11364,37.5573575723061,126.95603374504
20210807,2호선,양천구청,3307,3427,6734,37.5126989358446,126.866065211751
20210807,2호선,역삼,13234,14464,27698,37.5007162693593,127.036618203089
20210807,2호선,영등포구청,9000,9123,18123,37.5256996614804,126.896626898379
20210807,2호선,왕십리,9435,7869,17304,37.5612217415191,127.036655378283
20210807,2호선,용답,1662,1608,3270,37.5620049052662,127.050729309179
20210807,2호선,용두,1385,1304,2689,37.5739380503267,127.038031119837
20210807,2호선,을지로3가,7126,7149,14275,37.56626594615,126.990308356253
20210807,2호선,을지로4가,5557,5538,11095,37.5666369941572,126.997852780281
20210807,2호선,을지로입구,14436,14409,28845,37.5660509513873,126.982372901787
20210807,2호선,이대,7150,7331,14481,37.5567980142044,126.945758201019
20210807,2호선,잠실,42549,41255,83804,37.513859279255,127.101857941447
20210807,2호선,잠실나루,5599,5520,11119,37.5206867318088,127.103811089444
20210807,2호선,잠실새내,12354,12882,25236,37.5115672093323,127.086373867207
20210807,2호선,종합운동장,3400,3708,7108,37.5109692748993,127.073356018706
20210807,2호선,충정로,3685,3803,7488,37.5598377952439,126.964474043785
20210807,2호선,한양대,2596,2500,5096,37.55557788354,127.043584493543
20210807,2호선,합정,19433,20625,40058,37.5501152068908,126.914638180431
20210807,2호선,홍대입구,40407,41434,81841,37.5577458058734,126.926498328277
20210808,2호선,강남,24489,23435,47924,37.4981646510326,127.028307900881
20210808,2호선,강변,15064,14021,29085,37.5351692767888,127.094664569096
20210808,2호선,건대입구,17772,18972,36744,37.5404188872176,127.069173281554
20210808,2호선,교대,7434,8458,15892,37.4928178646055,127.013838469407
20210808,2호선,구로디지털단지,16575,16606,33181,37.4853149237865,126.901494378412
20210808,2호선,구의,8465,8661,17126,37.5371535596228,127.086179228767
20210808,2호선,낙성대,10943,11616,22559,37.4770651843603,126.963409959152
20210808,2호선,당산,5905,6480,12385,37.534956866618,126.90273071003
20210808,2호선,대림,10709,10815,21524,37.4933105886136,126.8949461878
20210808,2호선,도림천,348,361,709,37.5144420510515,126.882702584468
20210808,2호선,동대문역사문화공원,5250,5700,10950,37.5655895229776,127.009131498424
20210808,2호선,뚝섬,6661,7092,13753,37.5471882244091,127.047365178682
20210808,2호선,문래,5046,5334,10380,37.5179214637526,126.894763060556
20210808,2호선,방배,4453,4876,9329,37.4814364876589,126.997694899327
20210808,2호선,봉천,8875,8839,17714,37.4825562153548,126.941495272047
20210808,2호선,사당,13870,15200,29070,37.4765228347619,126.981408909449
20210808,2호선,삼성,15048,14970,30018,37.5088619974404,127.063073009788
20210808,2호선,상왕십리,4983,4948,9931,37.5644687111181,127.029031221392
20210808,2호선,서울대입구,20203,20929,41132,37.4811526631844,126.952645104944
20210808,2호선,서초,4496,3874,8370,37.4918229990093,127.007580814715
20210808,2호선,선릉,9172,7947,17119,37.5045028775835,127.048942471228
20210808,2호선,성수,8947,10023,18970,37.5445023983984,127.056090471223
20210808,2호선,시청,3884,3341,7225,37.5654385176408,126.976983237511
20210808,2호선,신답,571,565,1136,37.5699910562183,127.046820203556
20210808,2호선,신당,5892,6327,12219,37.5656540317328,127.019540574485
20210808,2호선,신대방,11180,11253,22433,37.4875759745635,126.913175585996
20210808,2호선,신도림,18299,18420,36719,37.5087701449787,126.891080501385
20210808,2호선,신림,27117,27173,54290,37.4841196518392,126.928712092948
20210808,2호선,신설동,2057,2136,4193,37.5762451837487,127.023278761358
20210808,2호선,신정네거리,3835,3887,7722,37.5197975266787,126.852991645059
20210808,2호선,신촌,14895,14711,29606,37.5554417865984,126.936119192554
20210808,2호선,아현,3727,3848,7575,37.5573575723061,126.95603374504
20210808,2호선,양천구청,2216,2312,4528,37.5126989358446,126.866065211751
20210808,2호선,역삼,7191,8041,15232,37.5007162693593,127.036618203089
20210808,2호선,영등포구청,5217,5311,10528,37.5256996614804,126.896626898379
20210808,2호선,왕십리,6347,5474,11821,37.5612217415191,127.036655378283
20210808,2호선,용답,1188,1201,2389,37.5620049052662,127.050729309179
20210808,2호선,용두,820,821,1641,37.5739380503267,127.038031119837
20210808,2호선,을지로3가,4442,4310,8752,37.56626594615,126.990308356253
20210808,2호선,을지로4가,2338,2328,4666,37.5666369941572,126.997852780281
20210808,2호선,을지로입구,10478,10111,20589,37.5660509513873,126.982372901787
20210808,2호선,이대,4653,5140,9793,37.5567980142044,126.945758201019
20210808,2호선,잠실,31090,29039,60129,37.513859279255,127.101857941447
20210808,2호선,잠실나루,3723,3807,7530,37.5206867318088,127.103811089444
20210808,2호선,잠실새내,7605,8100,15705,37.5115672093323,127.086373867207
20210808,2호선,종합운동장,2235,2465,4700,37.5109692748993,127.073356018706
20210808,2호선,충정로,2543,2674,5217,37.5598377952439,126.964474043785
20210808,2호선,한양대,1419,1590,3009,37.55557788354,127.043584493543
20210808,2호선,합정,13774,14673,28447,37.5501152068908,126.914638180431
20210808,2호선,홍대입구,30789,30715,61504,37.5577458058734,126.926498328277
20210814,2호선,강남,44818,43969,88787,37.4981646510326,127.028307900881
20210814,2호선,강변,18649,21545,40194,37.5351692767888,127.094664569096
20210814,2호선,건대입구,23813,25610,49423,37.5404188872176,127.069173281554
20210814,2호선,교대,12994,14601,27595,37.4928178646055,127.013838469407
20210814,2호선,구로디지털단지,26562,25727,52289,37.4853149237865,126.901494378412
20210814,2호선,구의,12915,12326,25241,37.5371535596228,127.086179228767
20210814,2호선,낙성대,16851,15204,32055,37.4770651843603,126.963409959152
20210814,2호선,당산,9305,10237,19542,37.534956866618,126.90273071003
20210814,2호선,대림,14788,15660,30448,37.4933105886136,126.8949461878
20210814,2호선,도림천,642,603,1245,37.5144420510515,126.882702584468
20210814,2호선,동대문역사문화공원,7095,7999,15094,37.5655895229776,127.009131498424
20210814,2호선,뚝섬,9959,10461,20420,37.5471882244091,127.047365178682
20210814,2호선,문래,8694,9192,17886,37.5179214637526,126.894763060556
20210814,2호선,방배,7227,7479,14706,37.4814364876589,126.997694899327
20210814,2호선,봉천,13920,12709,26629,37.4825562153548,126.941495272047
20210814,2호선,사당,21009,22939,43948,37.4765228347619,126.981408909449
20210814,2호선,삼성,20914,21022,41936,37.5088619974404,127.063073009788
20210814,2호선,상왕십리,7791,7183,14974,37.5644687111181,127.029031221392
20210814,2호선,서울대입구,30111,28318,58429,37.4811526631844,126.952645104944
20210814,2호선,서초,7689,6493,14182,37.4918229990093,127.007580814715
20210814,2호선,선릉,17698,15643,33341,37.5045028775835,127.048942471228
20210814,2호선,성수,13404,15155,28559,37.5445023983984,127.056090471223
20210814,2호선,시청,7132,8098,15230,37.5654385176408,126.976983237511
20210814,2호선,신답,795,842,1637,37.5699910562183,127.046820203556
20210814,2호선,신당,8569,8974,17543,37.5656540317328,127.019540574485
20210814,2호선,신대방,16352,15448,31800,37.4875759745635,126.913175585996
20210814,2호선,신도림,28168,27792,55960,37.5087701449787,126.891080501385
20210814,2호선,신림,39928,37671,77599,37.4841196518392,126.928712092948
20210814,2호선,신설동,2491,2398,4889,37.5762451837487,127.023278761358
20210814,2호선,신정네거리,5695,5747,11442,37.5197975266787,126.852991645059
20210814,2호선,신촌,21462,21352,42814,37.5554417865984,126.936119192554
20210814,2호선,아현,6198,5786,11984,37.5573575723061,126.95603374504
20210814,2호선,양천구청,3488,3514,7002,37.5126989358446,126.866065211751
20210814,2호선,역삼,13437,14689,28126,37.5007162693593,127.036618203089
20210814,2호선,영등포구청,9054,8972,18026,37.5256996614804,126.896626898379
20210814,2호선,왕십리,9606,8165,17771,37.5612217415191,127.036655378283
20210814,2호선,용답,1746,1680,3426,37.5620049052662,127.050729309179
20210814,2호선,용두,1396,1418,2814,37.5739380503267,127.038031119837
20210814,2호선,을지로3가,7339,7344,14683,37.56626594615,126.990308356253
20210814,2호선,을지로4가,5521,5686,11207,37.5666369941572,126.997852780281
20210814,2호선,을지로입구,15252,15216,30468,37.5660509513873,126.982372901787
20210814,2호선,이대,7263,7646,14909,37.5567980142044,126.945758201019
20210814,2호선,잠실,43446,41597,85043,37.513859279255,127.101857941447
20210814,2호선,잠실나루,6068,5983,12051,37.5206867318088,127.103811089444
20210814,2호선,잠실새내,12624,13004,25628,37.5115672093323,127.086373867207
20210814,2호선,종합운동장,3454,3877,7331,37.5109692748993,127.073356018706
20210814,2호선,충정로,4140,4190,8330,37.5598377952439,126.964474043785
20210814,2호선,한양대,2798,2611,5409,37.55557788354,127.043584493543
20210814,2호선,합정,19536,20465,40001,37.5501152068908,126.914638180431
20210814,2호선,홍대입구,40723,42244,82967,37.5577458058734,126.926498328277
20210815,2호선,강남,25274,24398,49672,37.4981646510326,127.028307900881
20210815,2호선,강변,15479,15009,30488,37.5351692767888,127.094664569096
20210815,2호선,건대입구,19118,20738,39856,37.5404188872176,127.069173281554
20210815,2호선,교대,7706,8619,16325,37.4928178646055,127.013838469407
20210815,2호선,구로디지털단지,18045,17441,35486,37.4853149237865,126.901494378412
20210815,2호선,구의,8908,8915,17823,37.5371535596228,127.086179228767
20210815,2호선,낙성대,12097,11817,23914,37.4770651843603,126.963409959152
20210815,2호선,당산,6484,7149,13633,37.534956866618,126.90273071003
20210815,2호선,대림,11066,11270,22336,37.4933105886136,126.8949461878
20210815,2호선,도림천,343,365,708,37.5144420510515,126.882702584468
20210815,2호선,동대문역사문화공원,5652,6505,12157,37.5655895229776,127.009131498424
20210815,2호선,뚝섬,7572,7956,15528,37.5471882244091,127.047365178682
20210815,2호선,문래,5968,6483,12451,37.5179214637526,126.894763060556
20210815,2호선,방배,5006,5334,10340,37.4814364876589,126.997694899327
20210815,2호선,봉천,9599,9043,18642,37.4825562153548,126.941495272047
20210815,2호선,사당,15285,16564,31849,37.4765228347619,126.981408909449
20210815,2호선,삼성,15526,15199,30725,37.5088619974404,127.063073009788
20210815,2호선,상왕십리,5297,5211,10508,37.5644687111181,127.029031221392
20210815,2호선,서울대입구,21450,22061,43511,37.4811526631844,126.952645104944
20210815,2호선,서초,6061,5439,11500,37.4918229990093,127.007580814715
20210815,2호선,선릉,9603,8411,18014,37.5045028775835,127.048942471228
20210815,2호선,성수,9892,11283,21175,37.5445023983984,127.056090471223
20210815,2호선,시청,4295,3432,7727,37.5654385176408,126.976983237511
20210815,2호선,신답,591,629,1220,37.5699910562183,127.046820203556
20210815,2호선,신당,6299,6767,13066,37.5656540317328,127.019540574485
20210815,2호선,신대방,12333,11955,24288,37.4875759745635,126.913175585996
20210815,2호선,신도림,20688,20594,41282,37.5087701449787,126.891080501385
20210815,2호선,신림,29527,29143,58670,37.4841196518392,126.928712092948
20210815,2호선,신설동,2176,2298,4474,37.5762451837487,127.023278761358
20210815,2호선,신정네거리,4016,4036,8052,37.5197975266787,126.852991645059
20210815,2호선,신촌,15638,15626,31264,37.5554417865984,126.936119192554
20210815,2호선,아현,4053,3987,8040,37.5573575723061,126.95603374504
20210815,2호선,양천구청,2388,2527,4915,37.5126989358446,126.866065211751
20210815,2호선,역삼,7444,8188,15632,37.5007162693593,127.036618203089
20210815,2호선,영등포구청,5841,5950,11791,37.5256996614804,126.896626898379
20210815,2호선,왕십리,6771,6007,12778,37.5612217415191,127.036655378283
20210815,2호선,용답,1406,1279,2685,37.5620049052662,127.050729309179
20210815,2호선,용두,973,959,1932,37.5739380503267,127.038031119837
20210815,2호선,을지로3가,5338,5252,10590,37.56626594615,126.990308356253
20210815,2호선,을지로4가,2643,2442,5085,37.5666369941572,126.997852780281
20210815,2호선,을지로입구,12391,11801,24192,37.5660509513873,126.982372901787
20210815,2호선,이대,4901,5288,10189,37.5567980142044,126.945758201019
20210815,2호선,잠실,34759,33065,67824,37.513859279255,127.101857941447
20210815,2호선,잠실나루,3964,4031,7995,37.5206867318088,127.103811089444
20210815,2호선,잠실새내,8316,8688,17004,37.5115672093323,127.086373867207
20210815,2호선,종합운동장,2651,2776,5427,37.5109692748993,127.073356018706
20210815,2호선,충정로,2720,2827,5547,37.5598377952439,126.964474043785
20210815,2호선,한양대,1761,1738,3499,37.55557788354,127.043584493543
20210815,2호선,합정,14978,15853,30831,37.5501152068908,126.914638180431
20210815,2호선,홍대입구,33907,34520,68427,37.5577458058734,126.926498328277
20210821,2호선,강남,43842,42706,86548,37.4981646510326,127.028307900881
20210821,2호선,강변,17489,18374,35863,37.5351692767888,127.094664569096
20210821,2호선,건대입구,22192,23868,46060,37.5404188872176,127.069173281554
20210821,2호선,교대,13027,14448,27475,37.4928178646055,127.013838469407
20210821,2호선,구로디지털단지,24684,24622,49306,37.4853149237865,126.901494378412
20210821,2호선,구의,11988,11918,23906,37.5371535596228,127.086179228767
20210821,2호선,낙성대,15827,14582,30409,37.4770651843603,126.963409959152
20210821,2호선,당산,8355,9308,17663,37.534956866618,126.90273071003
20210821,2호선,대림,13257,14248,27505,37.4933105886136,126.8949461878
20210821,2호선,도림천,620,600,1220,37.5144420510515,126.882702584468
20210821,2호선,동대문역사문화공원,7224,7642,14866,37.5655895229776,127.009131498424
20210821,2호선,뚝섬,9445,9620,19065,37.5471882244091,127.047365178682
20210821,2호선,문래,8437,8857,17294,37.5179214637526,126.894763060556
20210821,2호선,방배,7056,7600,14656,37.4814364876589,126.997694899327
20210821,2호선,봉천,13053,12123,25176,37.4825562153548,126.941495272047
20210821,2호선,사당,20043,21585,41628,37.4765228347619,126.981408909449
20210821,2호선,삼성,19489,19764,39253,37.5088619974404,127.063073009788
20210821,2호선,상왕십리,7406,7115,14521,37.5644687111181,127.029031221392
20210821,2호선,서울대입구,28381,27557,55938,37.4811526631844,126.952645104944
20210821,2호선,서초,7202,6199,13401,37.4918229990093,127.007580814715
20210821,2호선,선릉,17394,15585,32979,37.5045028775835,127.048942471228
20210821,2호선,성수,12537,13981,26518,37.5445023983984,127.056090471223
20210821,2호선,시청,5702,5124,10826,37.5654385176408,126.976983237511
20210821,2호선,신답,662,768,1430,37.5699910562183,127.046820203556
20210821,2호선,신당,7964,8278,16242,37.5656540317328,127.019540574485
20210821,2호선,신대방,15071,14907,29978,37.4875759745635,126.913175585996
20210821,2호선,신도림,27039,27012,54051,37.5087701449787,126.891080501385
20210821,2호선,신림,37745,36401,74146,37.4841196518392,126.928712092948
20210821,2호선,신설동,1945,1929,3874,37.5762451837487,127.023278761358
20210821,2호선,신정네거리,5639,5624,11263,37.5197975266787,126.852991645059
20210821,2호선,신촌,20671,21067,41738,37.5554417865984,126.936119192554
20210821,2호선,아현,5631,5467,11098,37.5573575723061,126.95603374504
20210821,2호선,양천구청,3701,3663,7364,37.5126989358446,126.866065211751
20210821,2호선,역삼,13420,14613,28033,37.5007162693593,127.036618203089
20210821,2호선,영등포구청,8885,8866,17751,37.5256996614804,126.896626898379
20210821,2호선,왕십리,9374,7917,17291,37.5612217415191,127.036655378283
20210821,2호선,용답,1600,1522,3122,37.5620049052662,127.050729309179
20210821,2호선,용두,1310,1287,2597,37.5739380503267,127.038031119837
20210821,2호선,을지로3가,7010,6979,13989,37.56626594615,126.990308356253
20210821,2호선,을지로4가,4972,4930,9902,37.5666369941572,126.997852780281
20210821,2호선,을지로입구,13721,13910,27631,37.5660509513873,126.982372901787
20210821,2호선,이대,7366,7494,14860,37.5567980142044,126.945758201019
20210821,2호선,잠실,41760,40312,82072,37.513859279255,127.101857941447
20210821,2호선,잠실나루,5328,5259,10587,37.5206867318088,127.103811089444
20210821,2호선,잠실새내,11880,12207,24087,37.5115672093323,127.086373867207
20210821,2호선,종합운동장,3166,3525,6691,37.5109692748993,127.073356018706
20210821,2호선,충정로,3947,4072,8019,37.5598377952439,126.964474043785
20210821,2호선,한양대,2924,2720,5644,37.55557788354,127.043584493543
20210821,2호선,합정,18428,19618,38046,37.5501152068908,126.914638180431
20210821,2호선,홍대입구,37771,38827,76598,37.5577458058734,126.926498328277
20210822,2호선,강남,27292,26207,53499,37.4981646510326,127.028307900881
20210822,2호선,강변,16575,15840,32415,37.5351692767888,127.094664569096
20210822,2호선,건대입구,19687,20802,40489,37.5404188872176,127.069173281554
20210822,2호선,교대,8405,9349,17754,37.4928178646055,127.013838469407
20210822,2호선,구로디지털단지,18618,18333,36951,37.4853149237865,126.901494378412
20210822,2호선,구의,9327,9433,18760,37.5371535596228,127.086179228767
20210822,2호선,낙성대,12414,12821,25235,37.4770651843603,126.963409959152
20210822,2호선,당산,6939,7489,14428,37.534956866618,126.90273071003
20210822,2호선,대림,11871,11959,23830,37.4933105886136,126.8949461878
20210822,2호선,도림천,367,379,746,37.5144420510515,126.882702584468
20210822,2호선,동대문역사문화공원,5976,7500,13476,37.5655895229776,127.009131498424
20210822,2호선,뚝섬,7685,8125,15810,37.5471882244091,127.047365178682
20210822,2호선,문래,6007,6520,12527,37.5179214637526,126.894763060556
20210822,2호선,방배,5256,5865,11121,37.4814364876589,126.997694899327
20210822,2호선,봉천,10079,9764,19843,37.4825562153548,126.941495272047
20210822,2호선,사당,15900,17362,33262,37.4765228347619,126.981408909449
20210822,2호선,삼성,14407,14022,28429,37.5088619974404,127.063073009788
20210822,2호선,상왕십리,5457,5356,10813,37.5644687111181,127.029031221392
20210822,2호선,서울대입구,22227,22783,45010,37.4811526631844,126.952645104944
20210822,2호선,서초,6221,5576,11797,37.4918229990093,127.007580814715
20210822,2호선,선릉,10010,8682,18692,37.5045028775835,127.048942471228
20210822,2호선,성수,9874,11355,21229,37.5445023983984,127.056090471223
20210822,2호선,시청,4295,3655,7950,37.5654385176408,126.976983237511
20210822,2호선,신답,603,628,1231,37.5699910562183,127.046820203556
20210822,2호선,신당,6517,6929,13446,37.5656540317328,127.019540574485
20210822,2호선,신대방,12660,12445,25105,37.4875759745635,126.913175585996
20210822,2호선,신도림,20900,20875,41775,37.5087701449787,126.891080501385
20210822,2호선,신림,29569,29569,59138,37.4841196518392,126.928712092948
20210822,2호선,신설동,2289,2431,4720,37.5762451837487,127.023278761358
20210822,2호선,신정네거리,3963,4073,8036,37.5197975266787,126.852991645059
20210822,2호선,신촌,16703,16420,33123,37.5554417865984,126.936119192554
20210822,2호선,아현,4346,4167,8513,37.5573575723061,126.95603374504
20210822,2호선,양천구청,2663,2661,5324,37.5126989358446,126.866065211751
20210822,2호선,역삼,7877,8902,16779,37.5007162693593,127.036618203089
20210822,2호선,영등포구청,5904,5879,11783,37.5256996614804,126.896626898379
20210822,2호선,왕십리,7272,6171,13443,37.5612217415191,127.036655378283
20210822,2호선,용답,1347,1367,2714,37.5620049052662,127.050729309179
20210822,2호선,용두,878,896,1774,37.5739380503267,127.038031119837
20210822,2호선,을지로3가,5433,5408,10841,37.56626594615,126.990308356253
20210822,2호선,을지로4가,2474,2419,4893,37.5666369941572,126.997852780281
20210822,2호선,을지로입구,11573,11309,22882,37.5660509513873,126.982372901787
20210822,2호선,이대,5241,5724,10965,37.5567980142044,126.945758201019
20210822,2호선,잠실,33749,31636,65385,37.513859279255,127.101857941447
20210822,2호선,잠실나루,4227,4355,8582,37.5206867318088,127.103811089444
20210822,2호선,잠실새내,8589,8978,17567,37.5115672093323,127.086373867207
20210822,2호선,종합운동장,2802,2907,5709,37.5109692748993,127.073356018706
20210822,2호선,충정로,2812,2975,5787,37.5598377952439,126.964474043785
20210822,2호선,한양대,2314,2473,4787,37.55557788354,127.043584493543
20210822,2호선,합정,15602,16554,32156,37.5501152068908,126.914638180431
20210822,2호선,홍대입구,34805,35011,69816,37.5577458058734,126.926498328277
20210828,2호선,강남,50235,48830,99065,37.4981646510326,127.028307900881
20210828,2호선,강변,20941,21940,42881,37.5351692767888,127.094664569096
20210828,2호선,건대입구,26494,28794,55288,37.5404188872176,127.069173281554
20210828,2호선,교대,14617,16542,31159,37.4928178646055,127.013838469407
20210828,2호선,구로디지털단지,28689,28416,57105,37.4853149237865,126.901494378412
20210828,2호선,구의,13632,13629,27261,37.5371535596228,127.086179228767
20210828,2호선,낙성대,18394,17070,35464,37.4770651843603,126.963409959152
20210828,2호선,당산,10902,11702,22604,37.534956866618,126.90273071003
20210828,2호선,대림,15312,16223,31535,37.4933105886136,126.8949461878
20210828,2호선,도림천,675,679,1354,37.5144420510515,126.882702584468
20210828,2호선,동대문역사문화공원,8199,8698,16897,37.5655895229776,127.009131498424
20210828,2호선,뚝섬,11637,12039,23676,37.5471882244091,127.047365178682
20210828,2호선,문래,9693,10245,19938,37.5179214637526,126.894763060556
20210828,2호선,방배,8025,8672,16697,37.4814364876589,126.997694899327
20210828,2호선,봉천,15257,13930,29187,37.4825562153548,126.941495272047
20210828,2호선,사당,23649,25927,49576,37.4765228347619,126.981408909449
20210828,2호선,삼성,24181,24456,48637,37.5088619974404,127.063073009788
20210828,2호선,상왕십리,8584,8095,16679,37.5644687111181,127.029031221392
20210828,2호선,서울대입구,33026,32025,65051,37.4811526631844,126.952645104944
20210828,2호선,서초,8852,7678,16530,37.4918229990093,127.007580814715
20210828,2호선,선릉,20001,17467,37468,37.5045028775835,127.048942471228
20210828,2호선,성수,15284,17455,32739,37.5445023983984,127.056090471223
20210828,2호선,시청,7008,6387,13395,37.5654385176408,126.976983237511
20210828,2호선,신답,868,899,1767,37.5699910562183,127.046820203556
20210828,2호선,신당,9495,9844,19339,37.5656540317328,127.019540574485
20210828,2호선,신대방,17349,16790,34139,37.4875759745635,126.913175585996
20210828,2호선,신도림,31860,31671,63531,37.5087701449787,126.891080501385
20210828,2호선,신림,43150,41124,84274,37.4841196518392,126.928712092948
20210828,2호선,신설동,2776,2817,5593,37.5762451837487,127.023278761358
20210828,2호선,신정네거리,6103,6255,12358,37.5197975266787,126.852991645059
20210828,2호선,신촌,24155,24072,48227,37.5554417865984,126.936119192554
20210828,2호선,아현,6712,6333,13045,37.5573575723061,126.95603374504
20210828,2호선,양천구청,3756,3770,7526,37.5126989358446,126.866065211751
20210828,2호선,역삼,14635,16037,30672,37.5007162693593,127.036618203089
20210828,2호선,영등포구청,10441,10702,21143,37.5256996614804,126.896626898379
20210828,2호선,왕십리,10643,8968,19611,37.5612217415191,127.036655378283
20210828,2호선,용답,1808,1756,3564,37.5620049052662,127.050729309179
20210828,2호선,용두,1555,1536,3091,37.5739380503267,127.038031119837
20210828,2호선,을지로3가,8318,8310,16628,37.56626594615,126.990308356253
20210828,2호선,을지로4가,6451,6818,13269,37.5666369941572,126.997852780281
20210828,2호선,을지로입구,16107,16151,32258,37.5660509513873,126.982372901787
20210828,2호선,이대,9008,9366,18374,37.5567980142044,126.945758201019
20210828,2호선,잠실,48746,46341,95087,37.513859279255,127.101857941447
20210828,2호선,잠실나루,6631,6474,13105,37.5206867318088,127.103811089444
20210828,2호선,잠실새내,13847,14185,28032,37.5115672093323,127.086373867207
20210828,2호선,종합운동장,3867,4057,7924,37.5109692748993,127.073356018706
20210828,2호선,충정로,4596,4793,9389,37.5598377952439,126.964474043785
20210828,2호선,한양대,3119,3104,6223,37.55557788354,127.043584493543
20210828,2호선,합정,22772,24376,47148,37.5501152068908,126.914638180431
20210828,2호선,홍대입구,47006,49767,96773,37.5577458058734,126.926498328277
20210829,2호선,강남,28246,26873,55119,37.4981646510326,127.028307900881
20210829,2호선,강변,17636,16475,34111,37.5351692767888,127.094664569096
20210829,2호선,건대입구,20868,21940,42808,37.5404188872176,127.069173281554
20210829,2호선,교대,8704,9587,18291,37.4928178646055,127.013838469407
20210829,2호선,구로디지털단지,19159,18985,38144,37.4853149237865,126.901494378412
20210829,2호선,구의,9395,9356,18751,37.5371535596228,127.086179228767
20210829,2호선,낙성대,13121,13575,26696,37.4770651843603,126.963409959152
20210829,2호선,당산,7210,7728,14938,37.534956866618,126.90273071003
20210829,2호선,대림,11906,12204,24110,37.4933105886136,126.8949461878
20210829,2호선,도림천,372,399,771,37.5144420510515,126.882702584468
20210829,2호선,동대문역사문화공원,5697,6981,12678,37.5655895229776,127.009131498424
20210829,2호선,뚝섬,8136,8736,16872,37.5471882244091,127.047365178682
20210829,2호선,문래,6636,7020,13656,37.5179214637526,126.894763060556
20210829,2호선,방배,5390,6084,11474,37.4814364876589,126.997694899327
20210829,2호선,봉천,10121,10091,20212,37.4825562153548,126.941495272047
20210829,2호선,사당,16542,18275,34817,37.4765228347619,126.981408909449
20210829,2호선,삼성,14863,14592,29455,37.5088619974404,127.063073009788
20210829,2호선,상왕십리,5797,5785,11582,37.5644687111181,127.029031221392
20210829,2호선,서울대입구,22623,23497,46120,37.4811526631844,126.952645104944
20210829,2호선,서초,7965,7366,15331,37.4918229990093,127.007580814715
20210829,2호선,선릉,10682,9115,19797,37.5045028775835,127.048942471228
20210829,2호선,성수,10718,12308,23026,37.5445023983984,127.056090471223
20210829,2호선,시청,4804,3948,8752,37.5654385176408,126.976983237511
20210829,2호선,신답,647,679,1326,37.5699910562183,127.046820203556
20210829,2호선,신당,6830,7284,14114,37.5656540317328,127.019540574485
20210829,2호선,신대방,12520,12447,24967,37.4875759745635,126.913175585996
20210829,2호선,신도림,22176,22447,44623,37.5087701449787,126.891080501385
20210829,2호선,신림,30737,30405,61142,37.4841196518392,126.928712092948
20210829,2호선,신설동,2385,2313,4698,37.5762451837487,127.023278761358
20210829,2호선,신정네거리,4387,4363,8750,37.5197975266787,126.852991645059
20210829,2호선,신촌,17158,17069,34227,37.5554417865984,126.936119192554
20210829,2호선,아현,4413,4392,8805,37.5573575723061,126.95603374504
20210829,2호선,양천구청,2724,2868,5592,37.5126989358446,126.866065211751
20210829,2호선,역삼,8095,9067,17162,37.5007162693593,127.036618203089
20210829,2호선,영등포구청,6667,6856,13523,37.5256996614804,126.896626898379
20210829,2호선,왕십리,7417,6279,13696,37.5612217415191,127.036655378283
20210829,2호선,용답,1436,1440,2876,37.5620049052662,127.050729309179
20210829,2호선,용두,1017,1004,2021,37.5739380503267,127.038031119837
20210829,2호선,을지로3가,5728,5459,11187,37.56626594615,126.990308356253
20210829,2호선,을지로4가,2832,2806,5638,37.5666369941572,126.997852780281
20210829,2호선,을지로입구,12183,11618,23801,37.5660509513873,126.982372901787
20210829,2호선,이대,6135,6548,12683,37.5567980142044,126.945758201019
20210829,2호선,잠실,36540,34443,70983,37.513859279255,127.101857941447
20210829,2호선,잠실나루,4266,4327,8593,37.5206867318088,127.103811089444
20210829,2호선,잠실새내,8438,8824,17262,37.5115672093323,127.086373867207
20210829,2호선,종합운동장,2855,3178,6033,37.5109692748993,127.073356018706
20210829,2호선,충정로,2962,3233,6195,37.5598377952439,126.964474043785
20210829,2호선,한양대,2304,2469,4773,37.55557788354,127.043584493543
20210829,2호선,합정,16519,17253,33772,37.5501152068908,126.914638180431
20210829,2호선,홍대입구,36420,36953,73373,37.5577458058734,126.926498328277
20210904,2호선,강남,51612,50735,102347,37.4981646510326,127.028307900881
20210904,2호선,강변,22448,23337,45785,37.5351692767888,127.094664569096
20210904,2호선,건대입구,28613,30656,59269,37.5404188872176,127.069173281554
20210904,2호선,교대,15128,17064,32192,37.4928178646055,127.013838469407
20210904,2호선,구로디지털단지,29807,29450,59257,37.4853149237865,126.901494378412
20210904,2호선,구의,14419,14144,28563,37.5371535596228,127.086179228767
20210904,2호선,낙성대,19611,17847,37458,37.4770651843603,126.963409959152
20210904,2호선,당산,11483,12428,23911,37.534956866618,126.90273071003
20210904,2호선,대림,16035,16969,33004,37.4933105886136,126.8949461878
20210904,2호선,도림천,740,701,1441,37.5144420510515,126.882702584468
20210904,2호선,동대문역사문화공원,8808,9129,17937,37.5655895229776,127.009131498424
20210904,2호선,뚝섬,13028,13397,26425,37.5471882244091,127.047365178682
20210904,2호선,문래,10463,11011,21474,37.5179214637526,126.894763060556
20210904,2호선,방배,8440,8846,17286,37.4814364876589,126.997694899327
20210904,2호선,봉천,15624,14448,30072,37.4825562153548,126.941495272047
20210904,2호선,사당,25457,27481,52938,37.4765228347619,126.981408909449
20210904,2호선,삼성,22057,22113,44170,37.5088619974404,127.063073009788
20210904,2호선,상왕십리,8880,8513,17393,37.5644687111181,127.029031221392
20210904,2호선,서울대입구,34145,33109,67254,37.4811526631844,126.952645104944
20210904,2호선,서초,8840,7530,16370,37.4918229990093,127.007580814715
20210904,2호선,선릉,20584,18324,38908,37.5045028775835,127.048942471228
20210904,2호선,성수,16285,19406,35691,37.5445023983984,127.056090471223
20210904,2호선,시청,7268,6234,13502,37.5654385176408,126.976983237511
20210904,2호선,신답,883,929,1812,37.5699910562183,127.046820203556
20210904,2호선,신당,9824,10183,20007,37.5656540317328,127.019540574485
20210904,2호선,신대방,18228,17742,35970,37.4875759745635,126.913175585996
20210904,2호선,신도림,34057,34356,68413,37.5087701449787,126.891080501385
20210904,2호선,신림,44750,42655,87405,37.4841196518392,126.928712092948
20210904,2호선,신설동,2906,1475,4381,37.5762451837487,127.023278761358
20210904,2호선,신정네거리,6448,6628,13076,37.5197975266787,126.852991645059
20210904,2호선,신촌,26322,26453,52775,37.5554417865984,126.936119192554
20210904,2호선,아현,6695,6224,12919,37.5573575723061,126.95603374504
20210904,2호선,양천구청,4287,4329,8616,37.5126989358446,126.866065211751
20210904,2호선,역삼,15302,16529,31831,37.5007162693593,127.036618203089
20210904,2호선,영등포구청,10793,10981,21774,37.5256996614804,126.896626898379
20210904,2호선,왕십리,11253,9214,20467,37.5612217415191,127.036655378283
20210904,2호선,용답,1990,1808,3798,37.5620049052662,127.050729309179
20210904,2호선,용두,1687,1598,3285,37.5739380503267,127.038031119837
20210904,2호선,을지로3가,8713,8679,17392,37.56626594615,126.990308356253
20210904,2호선,을지로4가,6778,6924,13702,37.5666369941572,126.997852780281
20210904,2호선,을지로입구,17675,17175,34850,37.5660509513873,126.982372901787
20210904,2호선,이대,9233,9436,18669,37.5567980142044,126.945758201019
20210904,2호선,잠실,52188,50031,102219,37.513859279255,127.101857941447
20210904,2호선,잠실나루,6940,6789,13729,37.5206867318088,127.103811089444
20210904,2호선,잠실새내,14255,14802,29057,37.5115672093323,127.086373867207
20210904,2호선,종합운동장,4185,4518,8703,37.5109692748993,127.073356018706
20210904,2호선,충정로,4819,5084,9903,37.5598377952439,126.964474043785
20210904,2호선,한양대,3018,2886,5904,37.55557788354,127.043584493543
20210904,2호선,합정,23332,25355,48687,37.5501152068908,126.914638180431
20210904,2호선,홍대입구,50402,54030,104432,37.5577458058734,126.926498328277
20210905,2호선,강남,29479,28115,57594,37.4981646510326,127.028307900881
20210905,2호선,강변,18732,17541,36273,37.5351692767888,127.094664569096
20210905,2호선,건대입구,21724,22799,44523,37.5404188872176,127.069173281554
20210905,2호선,교대,8963,9885,18848,37.4928178646055,127.013838469407
20210905,2호선,구로디지털단지,20112,19672,39784,37.4853149237865,126.901494378412
20210905,2호선,구의,10042,10065,20107,37.5371535596228,127.086179228767
20210905,2호선,낙성대,13905,14264,28169,37.4770651843603,126.963409959152
20210905,2호선,당산,8009,8481,16490,37.534956866618,126.90273071003
20210905,2호선,대림,12807,12945,25752,37.4933105886136,126.8949461878
20210905,2호선,도림천,349,378,727,37.5144420510515,126.882702584468
20210905,2호선,동대문역사문화공원,6302,7658,13960,37.5655895229776,127.009131498424
20210905,2호선,뚝섬,9265,9546,18811,37.5471882244091,127.047365178682
20210905,2호선,문래,6906,7475,14381,37.5179214637526,126.894763060556
20210905,2호선,방배,5733,6285,12018,37.4814364876589,126.997694899327
20210905,2호선,봉천,10573,10310,20883,37.4825562153548,126.941495272047
20210905,2호선,사당,17491,19717,37208,37.4765228347619,126.981408909449
20210905,2호선,삼성,15562,15262,30824,37.5088619974404,127.063073009788
20210905,2호선,상왕십리,6213,6185,12398,37.5644687111181,127.029031221392
20210905,2호선,서울대입구,24194,25140,49334,37.4811526631844,126.952645104944
20210905,2호선,서초,7531,6961,14492,37.4918229990093,127.007580814715
20210905,2호선,선릉,11148,9675,20823,37.5045028775835,127.048942471228
20210905,2호선,성수,11175,13195,24370,37.5445023983984,127.056090471223
20210905,2호선,시청,4983,4293,9276,37.5654385176408,126.976983237511
20210905,2호선,신답,639,697,1336,37.5699910562183,127.046820203556
20210905,2호선,신당,7270,7670,14940,37.5656540317328,127.019540574485
20210905,2호선,신대방,13542,13498,27040,37.4875759745635,126.913175585996
20210905,2호선,신도림,23446,23620,47066,37.5087701449787,126.891080501385
20210905,2호선,신림,32188,31808,63996,37.4841196518392,126.928712092948
20210905,2호선,신설동,2603,1471,4074,37.5762451837487,127.023278761358
20210905,2호선,신정네거리,4468,4628,9096,37.5197975266787,126.852991645059
20210905,2호선,신촌,19365,19214,38579,37.5554417865984,126.936119192554
20210905,2호선,아현,4554,4491,9045,37.5573575723061,126.95603374504
20210905,2호선,양천구청,2834,2933,5767,37.5126989358446,126.866065211751
20210905,2호선,역삼,8584,9669,18253,37.5007162693593,127.036618203089
20210905,2호선,영등포구청,6796,7213,14009,37.5256996614804,126.896626898379
20210905,2호선,왕십리,7964,6708,14672,37.5612217415191,127.036655378283
20210905,2호선,용답,1535,1486,3021,37.5620049052662,127.050729309179
20210905,2호선,용두,1084,1084,2168,37.5739380503267,127.038031119837
20210905,2호선,을지로3가,6054,5774,11828,37.56626594615,126.990308356253
20210905,2호선,을지로4가,2995,2956,5951,37.5666369941572,126.997852780281
20210905,2호선,을지로입구,12996,12447,25443,37.5660509513873,126.982372901787
20210905,2호선,이대,6185,6770,12955,37.5567980142044,126.945758201019
20210905,2호선,잠실,37612,35338,72950,37.513859279255,127.101857941447
20210905,2호선,잠실나루,5053,5124,10177,37.5206867318088,127.103811089444
20210905,2호선,잠실새내,9286,9625,18911,37.5115672093323,127.086373867207
20210905,2호선,종합운동장,3026,3175,6201,37.5109692748993,127.073356018706
20210905,2호선,충정로,3151,3299,6450,37.5598377952439,126.964474043785
20210905,2호선,한양대,2122,2323,4445,37.55557788354,127.043584493543
20210905,2호선,합정,17379,17970,35349,37.5501152068908,126.914638180431
20210905,2호선,홍대입구,38652,39131,77783,37.5577458058734,126.926498328277
20210911,2호선,강남,53623,52947,106570,37.4981646510326,127.028307900881
20210911,2호선,강변,23603,23939,47542,37.5351692767888,127.094664569096
20210911,2호선,건대입구,30090,31711,61801,37.5404188872176,127.069173281554
20210911,2호선,교대,15856,17559,33415,37.4928178646055,127.013838469407
20210911,2호선,구로디지털단지,30838,30349,61187,37.4853149237865,126.901494378412
20210911,2호선,구의,15143,14784,29927,37.5371535596228,127.086179228767
20210911,2호선,낙성대,19919,18513,38432,37.4770651843603,126.963409959152
20210911,2호선,당산,11949,12895,24844,37.534956866618,126.90273071003
20210911,2호선,대림,16276,17494,33770,37.4933105886136,126.8949461878
20210911,2호선,도림천,757,737,1494,37.5144420510515,126.882702584468
20210911,2호선,동대문역사문화공원,8836,9731,18567,37.5655895229776,127.009131498424
20210911,2호선,뚝섬,13629,13943,27572,37.5471882244091,127.047365178682
20210911,2호선,문래,11083,11708,22791,37.5179214637526,126.894763060556
20210911,2호선,방배,8729,9006,17735,37.4814364876589,126.997694899327
20210911,2호선,봉천,15962,14727,30689,37.4825562153548,126.941495272047
20210911,2호선,사당,25642,28320,53962,37.4765228347619,126.981408909449
20210911,2호선,삼성,23578,23530,47108,37.5088619974404,127.063073009788
20210911,2호선,상왕십리,9224,8543,17767,37.5644687111181,127.029031221392
20210911,2호선,서울대입구,35364,34593,69957,37.4811526631844,126.952645104944
20210911,2호선,서초,9191,7637,16828,37.4918229990093,127.007580814715
20210911,2호선,선릉,21205,18605,39810,37.5045028775835,127.048942471228
20210911,2호선,성수,19839,23038,42877,37.5445023983984,127.056090471223
20210911,2호선,시청,7735,6828,14563,37.5654385176408,126.976983237511
20210911,2호선,신답,964,1016,1980,37.5699910562183,127.046820203556
20210911,2호선,신당,10033,10527,20560,37.5656540317328,127.019540574485
20210911,2호선,신대방,18520,17933,36453,37.4875759745635,126.913175585996
20210911,2호선,신도림,35847,35862,71709,37.5087701449787,126.891080501385
20210911,2호선,신림,45823,43817,89640,37.4841196518392,126.928712092948
20210911,2호선,신설동,2938,1516,4454,37.5762451837487,127.023278761358
20210911,2호선,신정네거리,6883,7037,13920,37.5197975266787,126.852991645059
20210911,2호선,신촌,28900,29777,58677,37.5554417865984,126.936119192554
20210911,2호선,아현,7008,6521,13529,37.5573575723061,126.95603374504
20210911,2호선,양천구청,4294,4384,8678,37.5126989358446,126.866065211751
20210911,2호선,역삼,16151,17831,33982,37.5007162693593,127.036618203089
20210911,2호선,영등포구청,11396,11754,23150,37.5256996614804,126.896626898379
20210911,2호선,왕십리,11689,9686,21375,37.5612217415191,127.036655378283
20210911,2호선,용답,2068,1924,3992,37.5620049052662,127.050729309179
20210911,2호선,용두,1751,1709,3460,37.5739380503267,127.038031119837
20210911,2호선,을지로3가,9146,9292,18438,37.56626594615,126.990308356253
20210911,2호선,을지로4가,7128,7286,14414,37.5666369941572,126.997852780281
20210911,2호선,을지로입구,18217,18409,36626,37.5660509513873,126.982372901787
20210911,2호선,이대,9439,9872,19311,37.5567980142044,126.945758201019
20210911,2호선,잠실,53510,50813,104323,37.513859279255,127.101857941447
20210911,2호선,잠실나루,7152,7019,14171,37.5206867318088,127.103811089444
20210911,2호선,잠실새내,14888,15423,30311,37.5115672093323,127.086373867207
20210911,2호선,종합운동장,4530,4874,9404,37.5109692748993,127.073356018706
20210911,2호선,충정로,5044,5289,10333,37.5598377952439,126.964474043785
20210911,2호선,한양대,3372,3410,6782,37.55557788354,127.043584493543
20210911,2호선,합정,24974,27557,52531,37.5501152068908,126.914638180431
20210911,2호선,홍대입구,54257,57135,111392,37.5577458058734,126.926498328277
20210912,2호선,강남,30940,29417,60357,37.4981646510326,127.028307900881
20210912,2호선,강변,18661,17810,36471,37.5351692767888,127.094664569096
20210912,2호선,건대입구,23023,24288,47311,37.5404188872176,127.069173281554
20210912,2호선,교대,9163,10257,19420,37.4928178646055,127.013838469407
20210912,2호선,구로디지털단지,20963,20453,41416,37.4853149237865,126.901494378412
20210912,2호선,구의,10352,10299,20651,37.5371535596228,127.086179228767
20210912,2호선,낙성대,14597,14886,29483,37.4770651843603,126.963409959152
20210912,2호선,당산,8037,8609,16646,37.534956866618,126.90273071003
20210912,2호선,대림,13077,13221,26298,37.4933105886136,126.8949461878
20210912,2호선,도림천,428,415,843,37.5144420510515,126.882702584468
20210912,2호선,동대문역사문화공원,6658,8037,14695,37.5655895229776,127.009131498424
20210912,2호선,뚝섬,10103,10579,20682,37.5471882244091,127.047365178682
20210912,2호선,문래,6854,7322,14176,37.5179214637526,126.894763060556
20210912,2호선,방배,5682,6149,11831,37.4814364876589,126.997694899327
20210912,2호선,봉천,11084,10594,21678,37.4825562153548,126.941495272047
20210912,2호선,사당,18290,20318,38608,37.4765228347619,126.981408909449
20210912,2호선,삼성,17037,16647,33684,37.5088619974404,127.063073009788
20210912,2호선,상왕십리,6337,6238,12575,37.5644687111181,127.029031221392
20210912,2호선,서울대입구,25112,25838,50950,37.4811526631844,126.952645104944
20210912,2호선,서초,8070,7153,15223,37.4918229990093,127.007580814715
20210912,2호선,선릉,11223,9705,20928,37.5045028775835,127.048942471228
20210912,2호선,성수,13829,16154,29983,37.5445023983984,127.056090471223
20210912,2호선,시청,4851,4101,8952,37.5654385176408,126.976983237511
20210912,2호선,신답,666,772,1438,37.5699910562183,127.046820203556
20210912,2호선,신당,7436,8034,15470,37.5656540317328,127.019540574485
20210912,2호선,신대방,14024,13835,27859,37.4875759745635,126.913175585996
20210912,2호선,신도림,24820,24760,49580,37.5087701449787,126.891080501385
20210912,2호선,신림,33416,32597,66013,37.4841196518392,126.928712092948
20210912,2호선,신설동,2595,1448,4043,37.5762451837487,127.023278761358
20210912,2호선,신정네거리,4794,4879,9673,37.5197975266787,126.852991645059
20210912,2호선,신촌,21624,21504,43128,37.5554417865984,126.936119192554
20210912,2호선,아현,4710,4713,9423,37.5573575723061,126.95603374504
20210912,2호선,양천구청,3182,3337,6519,37.5126989358446,126.866065211751
20210912,2호선,역삼,9499,10503,20002,37.5007162693593,127.036618203089
20210912,2호선,영등포구청,6925,7036,13961,37.5256996614804,126.896626898379
20210912,2호선,왕십리,8258,6730,14988,37.5612217415191,127.036655378283
20210912,2호선,용답,1568,1499,3067,37.5620049052662,127.050729309179
20210912,2호선,용두,1125,1103,2228,37.5739380503267,127.038031119837
20210912,2호선,을지로3가,6393,6188,12581,37.56626594615,126.990308356253
20210912,2호선,을지로4가,3265,3338,6603,37.5666369941572,126.997852780281
20210912,2호선,을지로입구,13928,13217,27145,37.5660509513873,126.982372901787
20210912,2호선,이대,6689,7065,13754,37.5567980142044,126.945758201019
20210912,2호선,잠실,39566,37352,76918,37.513859279255,127.101857941447
20210912,2호선,잠실나루,4684,4803,9487,37.5206867318088,127.103811089444
20210912,2호선,잠실새내,9593,9912,19505,37.5115672093323,127.086373867207
20210912,2호선,종합운동장,3011,3236,6247,37.5109692748993,127.073356018706
20210912,2호선,충정로,3273,3432,6705,37.5598377952439,126.964474043785
20210912,2호선,한양대,2422,2548,4970,37.55557788354,127.043584493543
20210912,2호선,합정,18951,20391,39342,37.5501152068908,126.914638180431
20210912,2호선,홍대입구,43492,44064,87556,37.5577458058734,126.926498328277
20210918,2호선,강남,45511,45410,90921,37.4981646510326,127.028307900881
20210918,2호선,강변,20947,29780,50727,37.5351692767888,127.094664569096
20210918,2호선,건대입구,26927,27938,54865,37.5404188872176,127.069173281554
20210918,2호선,교대,13406,14927,28333,37.4928178646055,127.013838469407
20210918,2호선,구로디지털단지,27380,25558,52938,37.4853149237865,126.901494378412
20210918,2호선,구의,13511,12623,26134,37.5371535596228,127.086179228767
20210918,2호선,낙성대,17956,14600,32556,37.4770651843603,126.963409959152
20210918,2호선,당산,9838,10431,20269,37.534956866618,126.90273071003
20210918,2호선,대림,15757,16661,32418,37.4933105886136,126.8949461878
20210918,2호선,도림천,725,642,1367,37.5144420510515,126.882702584468
20210918,2호선,동대문역사문화공원,7965,8790,16755,37.5655895229776,127.009131498424
20210918,2호선,뚝섬,11111,11305,22416,37.5471882244091,127.047365178682
20210918,2호선,문래,8536,8838,17374,37.5179214637526,126.894763060556
20210918,2호선,방배,7662,7858,15520,37.4814364876589,126.997694899327
20210918,2호선,봉천,15038,12651,27689,37.4825562153548,126.941495272047
20210918,2호선,사당,22266,24456,46722,37.4765228347619,126.981408909449
20210918,2호선,삼성,20086,20174,40260,37.5088619974404,127.063073009788
20210918,2호선,상왕십리,8303,7525,15828,37.5644687111181,127.029031221392
20210918,2호선,서울대입구,30976,27405,58381,37.4811526631844,126.952645104944
20210918,2호선,서초,7186,6191,13377,37.4918229990093,127.007580814715
20210918,2호선,선릉,17334,15210,32544,37.5045028775835,127.048942471228
20210918,2호선,성수,13635,15667,29302,37.5445023983984,127.056090471223
20210918,2호선,시청,6389,5681,12070,37.5654385176408,126.976983237511
20210918,2호선,신답,842,846,1688,37.5699910562183,127.046820203556
20210918,2호선,신당,9436,9487,18923,37.5656540317328,127.019540574485
20210918,2호선,신대방,17176,15430,32606,37.4875759745635,126.913175585996
20210918,2호선,신도림,29968,29518,59486,37.5087701449787,126.891080501385
20210918,2호선,신림,42384,36815,79199,37.4841196518392,126.928712092948
20210918,2호선,신설동,2603,2411,5014,37.5762451837487,127.023278761358
20210918,2호선,신정네거리,6327,6191,12518,37.5197975266787,126.852991645059
20210918,2호선,신촌,23445,22341,45786,37.5554417865984,126.936119192554
20210918,2호선,아현,6132,5613,11745,37.5573575723061,126.95603374504
20210918,2호선,양천구청,3779,3816,7595,37.5126989358446,126.866065211751
20210918,2호선,역삼,13171,14256,27427,37.5007162693593,127.036618203089
20210918,2호선,영등포구청,9474,9302,18776,37.5256996614804,126.896626898379
20210918,2호선,왕십리,10250,8116,18366,37.5612217415191,127.036655378283
20210918,2호선,용답,1965,1694,3659,37.5620049052662,127.050729309179
20210918,2호선,용두,1765,1722,3487,37.5739380503267,127.038031119837
20210918,2호선,을지로3가,7575,7439,15014,37.56626594615,126.990308356253
20210918,2호선,을지로4가,5786,5893,11679,37.5666369941572,126.997852780281
20210918,2호선,을지로입구,15656,15856,31512,37.5660509513873,126.982372901787
20210918,2호선,이대,8124,7924,16048,37.5567980142044,126.945758201019
20210918,2호선,잠실,47144,45719,92863,37.513859279255,127.101857941447
20210918,2호선,잠실나루,6181,6135,12316,37.5206867318088,127.103811089444
20210918,2호선,잠실새내,13614,13824,27438,37.5115672093323,127.086373867207
20210918,2호선,종합운동장,3950,4062,8012,37.5109692748993,127.073356018706
20210918,2호선,충정로,3980,3962,7942,37.5598377952439,126.964474043785
20210918,2호선,한양대,2462,2209,4671,37.55557788354,127.043584493543
20210918,2호선,합정,20873,22140,43013,37.5501152068908,126.914638180431
20210918,2호선,홍대입구,47689,49695,97384,37.5577458058734,126.926498328277
20210919,2호선,강남,25909,25349,51258,37.4981646510326,127.028307900881
20210919,2호선,강변,16619,23365,39984,37.5351692767888,127.094664569096
20210919,2호선,건대입구,20017,20578,40595,37.5404188872176,127.069173281554
20210919,2호선,교대,7538,8361,15899,37.4928178646055,127.013838469407
20210919,2호선,구로디지털단지,18813,17292,36105,37.4853149237865,126.901494378412
20210919,2호선,구의,9334,8435,17769,37.5371535596228,127.086179228767
20210919,2호선,낙성대,12338,10142,22480,37.4770651843603,126.963409959152
20210919,2호선,당산,6760,7087,13847,37.534956866618,126.90273071003
20210919,2호선,대림,12763,13478,26241,37.4933105886136,126.8949461878
20210919,2호선,도림천,342,363,705,37.5144420510515,126.882702584468
20210919,2호선,동대문역사문화공원,6020,7063,13083,37.5655895229776,127.009131498424
20210919,2호선,뚝섬,7998,7984,15982,37.5471882244091,127.047365178682
20210919,2호선,문래,5824,5961,11785,37.5179214637526,126.894763060556
20210919,2호선,방배,4770,4802,9572,37.4814364876589,126.997694899327
20210919,2호선,봉천,10016,8409,18425,37.4825562153548,126.941495272047
20210919,2호선,사당,15244,16593,31837,37.4765228347619,126.981408909449
20210919,2호선,삼성,14023,13962,27985,37.5088619974404,127.063073009788
20210919,2호선,상왕십리,5772,5204,10976,37.5644687111181,127.029031221392
20210919,2호선,서울대입구,21160,18598,39758,37.4811526631844,126.952645104944
20210919,2호선,서초,6257,5839,12096,37.4918229990093,127.007580814715
20210919,2호선,선릉,8962,7604,16566,37.5045028775835,127.048942471228
20210919,2호선,성수,9430,10907,20337,37.5445023983984,127.056090471223
20210919,2호선,시청,4541,3756,8297,37.5654385176408,126.976983237511
20210919,2호선,신답,613,558,1171,37.5699910562183,127.046820203556
20210919,2호선,신당,6999,7240,14239,37.5656540317328,127.019540574485
20210919,2호선,신대방,12577,11371,23948,37.4875759745635,126.913175585996
20210919,2호선,신도림,20972,20575,41547,37.5087701449787,126.891080501385
20210919,2호선,신림,30333,25872,56205,37.4841196518392,126.928712092948
20210919,2호선,신설동,2272,2033,4305,37.5762451837487,127.023278761358
20210919,2호선,신정네거리,4519,4431,8950,37.5197975266787,126.852991645059
20210919,2호선,신촌,16030,14981,31011,37.5554417865984,126.936119192554
20210919,2호선,아현,4246,4011,8257,37.5573575723061,126.95603374504
20210919,2호선,양천구청,2689,2728,5417,37.5126989358446,126.866065211751
20210919,2호선,역삼,7515,7954,15469,37.5007162693593,127.036618203089
20210919,2호선,영등포구청,5898,5862,11760,37.5256996614804,126.896626898379
20210919,2호선,왕십리,7048,5480,12528,37.5612217415191,127.036655378283
20210919,2호선,용답,1529,1394,2923,37.5620049052662,127.050729309179
20210919,2호선,용두,1275,1265,2540,37.5739380503267,127.038031119837
20210919,2호선,을지로3가,5086,5283,10369,37.56626594615,126.990308356253
20210919,2호선,을지로4가,2555,2566,5121,37.5666369941572,126.997852780281
20210919,2호선,을지로입구,11856,11597,23453,37.5660509513873,126.982372901787
20210919,2호선,이대,5354,5002,10356,37.5567980142044,126.945758201019
20210919,2호선,잠실,36356,35074,71430,37.513859279255,127.101857941447
20210919,2호선,잠실나루,4145,4063,8208,37.5206867318088,127.103811089444
20210919,2호선,잠실새내,8660,9071,17731,37.5115672093323,127.086373867207
20210919,2호선,종합운동장,2859,2946,5805,37.5109692748993,127.073356018706
20210919,2호선,충정로,2770,2686,5456,37.5598377952439,126.964474043785
20210919,2호선,한양대,1635,1435,3070,37.55557788354,127.043584493543
20210919,2호선,합정,14692,15332,30024,37.5501152068908,126.914638180431
20210919,2호선,홍대입구,35828,36299,72127,37.5577458058734,126.926498328277
20210925,2호선,강남,52434,51433,103867,37.4981646510326,127.028307900881
20210925,2호선,강변,21701,21631,43332,37.5351692767888,127.094664569096
20210925,2호선,건대입구,27667,29958,57625,37.5404188872176,127.069173281554
20210925,2호선,교대,15293,17060,32353,37.4928178646055,127.013838469407
20210925,2호선,구로디지털단지,29399,28841,58240,37.4853149237865,126.901494378412
20210925,2호선,구의,14284,13892,28176,37.5371535596228,127.086179228767
20210925,2호선,낙성대,18730,17643,36373,37.4770651843603,126.963409959152
20210925,2호선,당산,11287,12091,23378,37.534956866618,126.90273071003
20210925,2호선,대림,15532,16374,31906,37.4933105886136,126.8949461878
20210925,2호선,도림천,720,703,1423,37.5144420510515,126.882702584468
20210925,2호선,동대문역사문화공원,8021,8613,16634,37.5655895229776,127.009131498424
20210925,2호선,뚝섬,12154,12845,24999,37.5471882244091,127.047365178682
20210925,2호선,문래,10142,10716,20858,37.5179214637526,126.894763060556
20210925,2호선,방배,8499,8859,17358,37.4814364876589,126.997694899327
20210925,2호선,봉천,15300,14326,29626,37.4825562153548,126.941495272047
20210925,2호선,사당,25306,28028,53334,37.4765228347619,126.981408909449
20210925,2호선,삼성,22392,22744,45136,37.5088619974404,127.063073009788
20210925,2호선,상왕십리,8475,8083,16558,37.5644687111181,127.029031221392
20210925,2호선,서울대입구,33450,32610,66060,37.4811526631844,126.952645104944
20210925,2호선,서초,8799,7795,16594,37.4918229990093,127.007580814715
20210925,2호선,선릉,20603,18246,38849,37.5045028775835,127.048942471228
20210925,2호선,성수,15471,18118,33589,37.5445023983984,127.056090471223
20210925,2호선,시청,7243,6627,13870,37.5654385176408,126.976983237511
20210925,2호선,신답,885,875,1760,37.5699910562183,127.046820203556
20210925,2호선,신당,9631,9809,19440,37.5656540317328,127.019540574485
20210925,2호선,신대방,18128,17617,35745,37.4875759745635,126.913175585996
20210925,2호선,신도림,33781,33650,67431,37.5087701449787,126.891080501385
20210925,2호선,신림,43875,42489,86364,37.4841196518392,126.928712092948
20210925,2호선,신설동,2803,2789,5592,37.5762451837487,127.023278761358
20210925,2호선,신정네거리,6462,6533,12995,37.5197975266787,126.852991645059
20210925,2호선,신촌,25161,25471,50632,37.5554417865984,126.936119192554
20210925,2호선,아현,6691,6292,12983,37.5573575723061,126.95603374504
20210925,2호선,양천구청,4122,4241,8363,37.5126989358446,126.866065211751
20210925,2호선,역삼,15879,17546,33425,37.5007162693593,127.036618203089
20210925,2호선,영등포구청,11212,11555,22767,37.5256996614804,126.896626898379
20210925,2호선,왕십리,11015,9144,20159,37.5612217415191,127.036655378283
20210925,2호선,용답,1867,1876,3743,37.5620049052662,127.050729309179
20210925,2호선,용두,1455,1444,2899,37.5739380503267,127.038031119837
20210925,2호선,을지로3가,8509,8748,17257,37.56626594615,126.990308356253
20210925,2호선,을지로4가,5894,5946,11840,37.5666369941572,126.997852780281
20210925,2호선,을지로입구,16653,16526,33179,37.5660509513873,126.982372901787
20210925,2호선,이대,8826,9164,17990,37.5567980142044,126.945758201019
20210925,2호선,잠실,51558,48887,100445,37.513859279255,127.101857941447
20210925,2호선,잠실나루,6557,6444,13001,37.5206867318088,127.103811089444
20210925,2호선,잠실새내,14054,14492,28546,37.5115672093323,127.086373867207
20210925,2호선,종합운동장,4262,4637,8899,37.5109692748993,127.073356018706
20210925,2호선,충정로,4833,4971,9804,37.5598377952439,126.964474043785
20210925,2호선,한양대,2916,2962,5878,37.55557788354,127.043584493543
20210925,2호선,합정,23247,25311,48558,37.5501152068908,126.914638180431
20210925,2호선,홍대입구,48935,52770,101705,37.5577458058734,126.926498328277
20210926,2호선,강남,29143,28016,57159,37.4981646510326,127.028307900881
20210926,2호선,강변,17269,16706,33975,37.5351692767888,127.094664569096
20210926,2호선,건대입구,21486,22292,43778,37.5404188872176,127.069173281554
20210926,2호선,교대,9027,10023,19050,37.4928178646055,127.013838469407
20210926,2호선,구로디지털단지,19654,19312,38966,37.4853149237865,126.901494378412
20210926,2호선,구의,9686,9680,19366,37.5371535596228,127.086179228767
20210926,2호선,낙성대,13631,13976,27607,37.4770651843603,126.963409959152
20210926,2호선,당산,8010,8304,16314,37.534956866618,126.90273071003
20210926,2호선,대림,12482,12720,25202,37.4933105886136,126.8949461878
20210926,2호선,도림천,449,418,867,37.5144420510515,126.882702584468
20210926,2호선,동대문역사문화공원,5886,7183,13069,37.5655895229776,127.009131498424
20210926,2호선,뚝섬,9018,9397,18415,37.5471882244091,127.047365178682
20210926,2호선,문래,6512,6923,13435,37.5179214637526,126.894763060556
20210926,2호선,방배,5702,5991,11693,37.4814364876589,126.997694899327
20210926,2호선,봉천,10602,10147,20749,37.4825562153548,126.941495272047
20210926,2호선,사당,18149,20315,38464,37.4765228347619,126.981408909449
20210926,2호선,삼성,16306,16136,32442,37.5088619974404,127.063073009788
20210926,2호선,상왕십리,5786,5857,11643,37.5644687111181,127.029031221392
20210926,2호선,서울대입구,23955,24846,48801,37.4811526631844,126.952645104944
20210926,2호선,서초,8058,7555,15613,37.4918229990093,127.007580814715
20210926,2호선,선릉,10991,9492,20483,37.5045028775835,127.048942471228
20210926,2호선,성수,10698,12554,23252,37.5445023983984,127.056090471223
20210926,2호선,시청,4865,4317,9182,37.5654385176408,126.976983237511
20210926,2호선,신답,661,687,1348,37.5699910562183,127.046820203556
20210926,2호선,신당,7149,7411,14560,37.5656540317328,127.019540574485
20210926,2호선,신대방,13483,13236,26719,37.4875759745635,126.913175585996
20210926,2호선,신도림,22692,22947,45639,37.5087701449787,126.891080501385
20210926,2호선,신림,31555,30850,62405,37.4841196518392,126.928712092948
20210926,2호선,신설동,2568,2737,5305,37.5762451837487,127.023278761358
20210926,2호선,신정네거리,4433,4542,8975,37.5197975266787,126.852991645059
20210926,2호선,신촌,18251,17828,36079,37.5554417865984,126.936119192554
20210926,2호선,아현,4457,4457,8914,37.5573575723061,126.95603374504
20210926,2호선,양천구청,2723,2864,5587,37.5126989358446,126.866065211751
20210926,2호선,역삼,9628,10623,20251,37.5007162693593,127.036618203089
20210926,2호선,영등포구청,6512,6819,13331,37.5256996614804,126.896626898379
20210926,2호선,왕십리,7801,6460,14261,37.5612217415191,127.036655378283
20210926,2호선,용답,1525,1480,3005,37.5620049052662,127.050729309179
20210926,2호선,용두,942,898,1840,37.5739380503267,127.038031119837
20210926,2호선,을지로3가,6165,5747,11912,37.56626594615,126.990308356253
20210926,2호선,을지로4가,2523,2468,4991,37.5666369941572,126.997852780281
20210926,2호선,을지로입구,12399,11721,24120,37.5660509513873,126.982372901787
20210926,2호선,이대,5949,6486,12435,37.5567980142044,126.945758201019
20210926,2호선,잠실,37329,34938,72267,37.513859279255,127.101857941447
20210926,2호선,잠실나루,4365,4479,8844,37.5206867318088,127.103811089444
20210926,2호선,잠실새내,8938,9251,18189,37.5115672093323,127.086373867207
20210926,2호선,종합운동장,3071,3285,6356,37.5109692748993,127.073356018706
20210926,2호선,충정로,3352,3470,6822,37.5598377952439,126.964474043785
20210926,2호선,한양대,2493,2634,5127,37.55557788354,127.043584493543
20210926,2호선,합정,17186,18202,35388,37.5501152068908,126.914638180431
20210926,2호선,홍대입구,37124,37426,74550,37.5577458058734,126.926498328277
20211002,2호선,강남,52868,52299,105167,37.4981646510326,127.028307900881
20211002,2호선,강변,23646,25858,49504,37.5351692767888,127.094664569096
20211002,2호선,건대입구,29741,31568,61309,37.5404188872176,127.069173281554
20211002,2호선,교대,15617,17476,33093,37.4928178646055,127.013838469407
20211002,2호선,구로디지털단지,30413,29820,60233,37.4853149237865,126.901494378412
20211002,2호선,구의,14679,14313,28992,37.5371535596228,127.086179228767
20211002,2호선,낙성대,19877,18103,37980,37.4770651843603,126.963409959152
20211002,2호선,당산,11925,12799,24724,37.534956866618,126.90273071003
20211002,2호선,대림,16630,17460,34090,37.4933105886136,126.8949461878
20211002,2호선,도림천,742,689,1431,37.5144420510515,126.882702584468
20211002,2호선,동대문역사문화공원,9000,9676,18676,37.5655895229776,127.009131498424
20211002,2호선,뚝섬,13181,13457,26638,37.5471882244091,127.047365178682
20211002,2호선,문래,11147,11563,22710,37.5179214637526,126.894763060556
20211002,2호선,방배,9073,9164,18237,37.4814364876589,126.997694899327
20211002,2호선,봉천,15681,14162,29843,37.4825562153548,126.941495272047
20211002,2호선,사당,26401,29341,55742,37.4765228347619,126.981408909449
20211002,2호선,삼성,24033,24203,48236,37.5088619974404,127.063073009788
20211002,2호선,상왕십리,9038,8355,17393,37.5644687111181,127.029031221392
20211002,2호선,서울대입구,35053,33356,68409,37.4811526631844,126.952645104944
20211002,2호선,서초,9207,8137,17344,37.4918229990093,127.007580814715
20211002,2호선,선릉,21747,19225,40972,37.5045028775835,127.048942471228
20211002,2호선,성수,16352,19083,35435,37.5445023983984,127.056090471223
20211002,2호선,시청,7812,6978,14790,37.5654385176408,126.976983237511
20211002,2호선,신답,937,958,1895,37.5699910562183,127.046820203556
20211002,2호선,신당,9886,10173,20059,37.5656540317328,127.019540574485
20211002,2호선,신대방,18334,17507,35841,37.4875759745635,126.913175585996
20211002,2호선,신도림,35293,35479,70772,37.5087701449787,126.891080501385
20211002,2호선,신림,45477,43500,88977,37.4841196518392,126.928712092948
20211002,2호선,신설동,2861,2699,5560,37.5762451837487,127.023278761358
20211002,2호선,신정네거리,6867,6769,13636,37.5197975266787,126.852991645059
20211002,2호선,신촌,38019,36582,74601,37.5554417865984,126.936119192554
20211002,2호선,아현,7177,6549,13726,37.5573575723061,126.95603374504
20211002,2호선,양천구청,4785,4795,9580,37.5126989358446,126.866065211751
20211002,2호선,역삼,16342,18020,34362,37.5007162693593,127.036618203089
20211002,2호선,영등포구청,11926,12283,24209,37.5256996614804,126.896626898379
20211002,2호선,왕십리,12143,10102,22245,37.5612217415191,127.036655378283
20211002,2호선,용답,1993,1891,3884,37.5620049052662,127.050729309179
20211002,2호선,용두,1556,1479,3035,37.5739380503267,127.038031119837
20211002,2호선,을지로3가,9389,9235,18624,37.56626594615,126.990308356253
20211002,2호선,을지로4가,6460,6804,13264,37.5666369941572,126.997852780281
20211002,2호선,을지로입구,18022,18359,36381,37.5660509513873,126.982372901787
20211002,2호선,이대,9963,9748,19711,37.5567980142044,126.945758201019
20211002,2호선,잠실,55475,52828,108303,37.513859279255,127.101857941447
20211002,2호선,잠실나루,7779,7590,15369,37.5206867318088,127.103811089444
20211002,2호선,잠실새내,14971,15438,30409,37.5115672093323,127.086373867207
20211002,2호선,종합운동장,4486,4839,9325,37.5109692748993,127.073356018706
20211002,2호선,충정로,5192,5483,10675,37.5598377952439,126.964474043785
20211002,2호선,한양대,3596,3643,7239,37.55557788354,127.043584493543
20211002,2호선,합정,24937,27274,52211,37.5501152068908,126.914638180431
20211002,2호선,홍대입구,52207,55757,107964,37.5577458058734,126.926498328277
20211003,2호선,강남,31137,30519,61656,37.4981646510326,127.028307900881
20211003,2호선,강변,18561,18093,36654,37.5351692767888,127.094664569096
20211003,2호선,건대입구,24060,25448,49508,37.5404188872176,127.069173281554
20211003,2호선,교대,9242,10128,19370,37.4928178646055,127.013838469407
20211003,2호선,구로디지털단지,21505,20876,42381,37.4853149237865,126.901494378412
20211003,2호선,구의,10541,10360,20901,37.5371535596228,127.086179228767
20211003,2호선,낙성대,14970,14264,29234,37.4770651843603,126.963409959152
20211003,2호선,당산,8645,9450,18095,37.534956866618,126.90273071003
20211003,2호선,대림,13244,13400,26644,37.4933105886136,126.8949461878
20211003,2호선,도림천,417,429,846,37.5144420510515,126.882702584468
20211003,2호선,동대문역사문화공원,6763,8455,15218,37.5655895229776,127.009131498424
20211003,2호선,뚝섬,10729,11125,21854,37.5471882244091,127.047365178682
20211003,2호선,문래,7581,8179,15760,37.5179214637526,126.894763060556
20211003,2호선,방배,6151,6346,12497,37.4814364876589,126.997694899327
20211003,2호선,봉천,11259,10700,21959,37.4825562153548,126.941495272047
20211003,2호선,사당,19747,21945,41692,37.4765228347619,126.981408909449
20211003,2호선,삼성,17700,17790,35490,37.5088619974404,127.063073009788
20211003,2호선,상왕십리,6438,6235,12673,37.5644687111181,127.029031221392
20211003,2호선,서울대입구,25883,26117,52000,37.4811526631844,126.952645104944
20211003,2호선,서초,8566,7832,16398,37.4918229990093,127.007580814715
20211003,2호선,선릉,11844,10180,22024,37.5045028775835,127.048942471228
20211003,2호선,성수,12465,14438,26903,37.5445023983984,127.056090471223
20211003,2호선,시청,5607,4850,10457,37.5654385176408,126.976983237511
20211003,2호선,신답,715,745,1460,37.5699910562183,127.046820203556
20211003,2호선,신당,7664,8213,15877,37.5656540317328,127.019540574485
20211003,2호선,신대방,13985,13749,27734,37.4875759745635,126.913175585996
20211003,2호선,신도림,26085,25984,52069,37.5087701449787,126.891080501385
20211003,2호선,신림,34598,33214,67812,37.4841196518392,126.928712092948
20211003,2호선,신설동,2636,2710,5346,37.5762451837487,127.023278761358
20211003,2호선,신정네거리,4760,4826,9586,37.5197975266787,126.852991645059
20211003,2호선,신촌,21345,21139,42484,37.5554417865984,126.936119192554
20211003,2호선,아현,4877,4701,9578,37.5573575723061,126.95603374504
20211003,2호선,양천구청,3326,3375,6701,37.5126989358446,126.866065211751
20211003,2호선,역삼,9751,10616,20367,37.5007162693593,127.036618203089
20211003,2호선,영등포구청,7931,8149,16080,37.5256996614804,126.896626898379
20211003,2호선,왕십리,8582,7411,15993,37.5612217415191,127.036655378283
20211003,2호선,용답,1568,1537,3105,37.5620049052662,127.050729309179
20211003,2호선,용두,1084,1021,2105,37.5739380503267,127.038031119837
20211003,2호선,을지로3가,7250,6839,14089,37.56626594615,126.990308356253
20211003,2호선,을지로4가,3042,3069,6111,37.5666369941572,126.997852780281
20211003,2호선,을지로입구,13897,13430,27327,37.5660509513873,126.982372901787
20211003,2호선,이대,6324,6792,13116,37.5567980142044,126.945758201019
20211003,2호선,잠실,43771,41039,84810,37.513859279255,127.101857941447
20211003,2호선,잠실나루,4769,4808,9577,37.5206867318088,127.103811089444
20211003,2호선,잠실새내,10011,10379,20390,37.5115672093323,127.086373867207
20211003,2호선,종합운동장,3331,3547,6878,37.5109692748993,127.073356018706
20211003,2호선,충정로,3476,3581,7057,37.5598377952439,126.964474043785
20211003,2호선,한양대,3021,3253,6274,37.55557788354,127.043584493543
20211003,2호선,합정,19629,20971,40600,37.5501152068908,126.914638180431
20211003,2호선,홍대입구,43475,44586,88061,37.5577458058734,126.926498328277
20211009,2호선,강남,45442,45107,90549,37.4981646510326,127.028307900881
20211009,2호선,강변,23398,26230,49628,37.5351692767888,127.094664569096
20211009,2호선,건대입구,30016,31386,61402,37.5404188872176,127.069173281554
20211009,2호선,교대,13548,15471,29019,37.4928178646055,127.013838469407
20211009,2호선,구로디지털단지,28904,28013,56917,37.4853149237865,126.901494378412
20211009,2호선,구의,13814,13324,27138,37.5371535596228,127.086179228767
20211009,2호선,낙성대,18625,16866,35491,37.4770651843603,126.963409959152
20211009,2호선,당산,11304,12090,23394,37.534956866618,126.90273071003
20211009,2호선,대림,15580,16481,32061,37.4933105886136,126.8949461878
20211009,2호선,도림천,671,679,1350,37.5144420510515,126.882702584468
20211009,2호선,동대문역사문화공원,9011,9808,18819,37.5655895229776,127.009131498424
20211009,2호선,뚝섬,12366,12916,25282,37.5471882244091,127.047365178682
20211009,2호선,문래,10159,10723,20882,37.5179214637526,126.894763060556
20211009,2호선,방배,8000,8216,16216,37.4814364876589,126.997694899327
20211009,2호선,봉천,15037,13521,28558,37.4825562153548,126.941495272047
20211009,2호선,사당,24756,27383,52139,37.4765228347619,126.981408909449
20211009,2호선,삼성,23002,23408,46410,37.5088619974404,127.063073009788
20211009,2호선,상왕십리,8426,7827,16253,37.5644687111181,127.029031221392
20211009,2호선,서울대입구,32361,30871,63232,37.4811526631844,126.952645104944
20211009,2호선,서초,8368,6949,15317,37.4918229990093,127.007580814715
20211009,2호선,선릉,19295,16911,36206,37.5045028775835,127.048942471228
20211009,2호선,성수,15748,18121,33869,37.5445023983984,127.056090471223
20211009,2호선,시청,7803,6913,14716,37.5654385176408,126.976983237511
20211009,2호선,신답,881,933,1814,37.5699910562183,127.046820203556
20211009,2호선,신당,9855,10160,20015,37.5656540317328,127.019540574485
20211009,2호선,신대방,18145,17143,35288,37.4875759745635,126.913175585996
20211009,2호선,신도림,35502,35873,71375,37.5087701449787,126.891080501385
20211009,2호선,신림,43711,41075,84786,37.4841196518392,126.928712092948
20211009,2호선,신설동,2698,2632,5330,37.5762451837487,127.023278761358
20211009,2호선,신정네거리,6280,6179,12459,37.5197975266787,126.852991645059
20211009,2호선,신촌,23483,23588,47071,37.5554417865984,126.936119192554
20211009,2호선,아현,6416,5977,12393,37.5573575723061,126.95603374504
20211009,2호선,양천구청,4138,4055,8193,37.5126989358446,126.866065211751
20211009,2호선,역삼,14701,16366,31067,37.5007162693593,127.036618203089
20211009,2호선,영등포구청,11134,11786,22920,37.5256996614804,126.896626898379
20211009,2호선,왕십리,11468,9510,20978,37.5612217415191,127.036655378283
20211009,2호선,용답,1988,1828,3816,37.5620049052662,127.050729309179
20211009,2호선,용두,1475,1495,2970,37.5739380503267,127.038031119837
20211009,2호선,을지로3가,8791,8921,17712,37.56626594615,126.990308356253
20211009,2호선,을지로4가,6031,6369,12400,37.5666369941572,126.997852780281
20211009,2호선,을지로입구,17363,17184,34547,37.5660509513873,126.982372901787
20211009,2호선,이대,8356,8496,16852,37.5567980142044,126.945758201019
20211009,2호선,잠실,56248,53641,109889,37.513859279255,127.101857941447
20211009,2호선,잠실나루,6906,6734,13640,37.5206867318088,127.103811089444
20211009,2호선,잠실새내,13685,14134,27819,37.5115672093323,127.086373867207
20211009,2호선,종합운동장,4116,4558,8674,37.5109692748993,127.073356018706
20211009,2호선,충정로,4584,4855,9439,37.5598377952439,126.964474043785
20211009,2호선,한양대,3866,3915,7781,37.55557788354,127.043584493543
20211009,2호선,합정,24398,26547,50945,37.5501152068908,126.914638180431
20211009,2호선,홍대입구,55233,58820,114053,37.5577458058734,126.926498328277
20211010,2호선,강남,31152,30307,61459,37.4981646510326,127.028307900881
20211010,2호선,강변,18949,17926,36875,37.5351692767888,127.094664569096
20211010,2호선,건대입구,23680,24720,48400,37.5404188872176,127.069173281554
20211010,2호선,교대,9103,10002,19105,37.4928178646055,127.013838469407
20211010,2호선,구로디지털단지,20318,19674,39992,37.4853149237865,126.901494378412
20211010,2호선,구의,10014,9914,19928,37.5371535596228,127.086179228767
20211010,2호선,낙성대,13788,13493,27281,37.4770651843603,126.963409959152
20211010,2호선,당산,7549,8272,15821,37.534956866618,126.90273071003
20211010,2호선,대림,12577,12822,25399,37.4933105886136,126.8949461878
20211010,2호선,도림천,409,386,795,37.5144420510515,126.882702584468
20211010,2호선,동대문역사문화공원,6434,8002,14436,37.5655895229776,127.009131498424
20211010,2호선,뚝섬,8557,8747,17304,37.5471882244091,127.047365178682
20211010,2호선,문래,6887,7153,14040,37.5179214637526,126.894763060556
20211010,2호선,방배,5727,6017,11744,37.4814364876589,126.997694899327
20211010,2호선,봉천,10750,10161,20911,37.4825562153548,126.941495272047
20211010,2호선,사당,18608,20351,38959,37.4765228347619,126.981408909449
20211010,2호선,삼성,20131,19645,39776,37.5088619974404,127.063073009788
20211010,2호선,상왕십리,6222,6066,12288,37.5644687111181,127.029031221392
20211010,2호선,서울대입구,23688,23828,47516,37.4811526631844,126.952645104944
20211010,2호선,서초,8445,7588,16033,37.4918229990093,127.007580814715
20211010,2호선,선릉,11457,10209,21666,37.5045028775835,127.048942471228
20211010,2호선,성수,11332,12383,23715,37.5445023983984,127.056090471223
20211010,2호선,시청,5471,4603,10074,37.5654385176408,126.976983237511
20211010,2호선,신답,587,679,1266,37.5699910562183,127.046820203556
20211010,2호선,신당,6801,7541,14342,37.5656540317328,127.019540574485
20211010,2호선,신대방,13249,13089,26338,37.4875759745635,126.913175585996
20211010,2호선,신도림,25825,25778,51603,37.5087701449787,126.891080501385
20211010,2호선,신림,32283,31869,64152,37.4841196518392,126.928712092948
20211010,2호선,신설동,2331,1875,4206,37.5762451837487,127.023278761358
20211010,2호선,신정네거리,4478,4616,9094,37.5197975266787,126.852991645059
20211010,2호선,신촌,18770,18527,37297,37.5554417865984,126.936119192554
20211010,2호선,아현,4532,4565,9097,37.5573575723061,126.95603374504
20211010,2호선,양천구청,2631,2850,5481,37.5126989358446,126.866065211751
20211010,2호선,역삼,9854,10774,20628,37.5007162693593,127.036618203089
20211010,2호선,영등포구청,7487,7561,15048,37.5256996614804,126.896626898379
20211010,2호선,왕십리,8432,7303,15735,37.5612217415191,127.036655378283
20211010,2호선,용답,1411,1328,2739,37.5620049052662,127.050729309179
20211010,2호선,용두,846,869,1715,37.5739380503267,127.038031119837
20211010,2호선,을지로3가,6763,6474,13237,37.56626594615,126.990308356253
20211010,2호선,을지로4가,3077,2955,6032,37.5666369941572,126.997852780281
20211010,2호선,을지로입구,13495,13031,26526,37.5660509513873,126.982372901787
20211010,2호선,이대,6011,6521,12532,37.5567980142044,126.945758201019
20211010,2호선,잠실,43430,40189,83619,37.513859279255,127.101857941447
20211010,2호선,잠실나루,4765,4798,9563,37.5206867318088,127.103811089444
20211010,2호선,잠실새내,10135,10530,20665,37.5115672093323,127.086373867207
20211010,2호선,종합운동장,3188,3464,6652,37.5109692748993,127.073356018706
20211010,2호선,충정로,3340,3673,7013,37.5598377952439,126.964474043785
20211010,2호선,한양대,2770,2802,5572,37.55557788354,127.043584493543
20211010,2호선,합정,18649,19738,38387,37.5501152068908,126.914638180431
20211010,2호선,홍대입구,44911,44858,89769,37.5577458058734,126.926498328277
20211016,2호선,강남,56982,56416,113398,37.4981646510326,127.028307900881
20211016,2호선,강변,24639,25408,50047,37.5351692767888,127.094664569096
20211016,2호선,건대입구,30832,32419,63251,37.5404188872176,127.069173281554
20211016,2호선,교대,16700,18722,35422,37.4928178646055,127.013838469407
20211016,2호선,구로디지털단지,32156,31707,63863,37.4853149237865,126.901494378412
20211016,2호선,구의,15376,15110,30486,37.5371535596228,127.086179228767
20211016,2호선,낙성대,20165,18975,39140,37.4770651843603,126.963409959152
20211016,2호선,당산,11534,12840,24374,37.534956866618,126.90273071003
20211016,2호선,대림,16652,17864,34516,37.4933105886136,126.8949461878
20211016,2호선,도림천,821,828,1649,37.5144420510515,126.882702584468
20211016,2호선,동대문역사문화공원,9276,10037,19313,37.5655895229776,127.009131498424
20211016,2호선,뚝섬,13126,13358,26484,37.5471882244091,127.047365178682
20211016,2호선,문래,11664,12044,23708,37.5179214637526,126.894763060556
20211016,2호선,방배,9765,10047,19812,37.4814364876589,126.997694899327
20211016,2호선,봉천,16610,15338,31948,37.4825562153548,126.941495272047
20211016,2호선,사당,28286,31252,59538,37.4765228347619,126.981408909449
20211016,2호선,삼성,30924,30527,61451,37.5088619974404,127.063073009788
20211016,2호선,상왕십리,9449,9064,18513,37.5644687111181,127.029031221392
20211016,2호선,서울대입구,35980,34738,70718,37.4811526631844,126.952645104944
20211016,2호선,서초,9947,8295,18242,37.4918229990093,127.007580814715
20211016,2호선,선릉,23185,20209,43394,37.5045028775835,127.048942471228
20211016,2호선,성수,17539,19132,36671,37.5445023983984,127.056090471223
20211016,2호선,시청,8559,7129,15688,37.5654385176408,126.976983237511
20211016,2호선,신답,938,989,1927,37.5699910562183,127.046820203556
20211016,2호선,신당,10283,10847,21130,37.5656540317328,127.019540574485
20211016,2호선,신대방,19046,18599,37645,37.4875759745635,126.913175585996
20211016,2호선,신도림,39613,39667,79280,37.5087701449787,126.891080501385
20211016,2호선,신림,47798,46126,93924,37.4841196518392,126.928712092948
20211016,2호선,신설동,3111,1478,4589,37.5762451837487,127.023278761358
20211016,2호선,신정네거리,7246,7285,14531,37.5197975266787,126.852991645059
20211016,2호선,신촌,27138,26751,53889,37.5554417865984,126.936119192554
20211016,2호선,아현,7082,6801,13883,37.5573575723061,126.95603374504
20211016,2호선,양천구청,4339,4425,8764,37.5126989358446,126.866065211751
20211016,2호선,역삼,17834,18878,36712,37.5007162693593,127.036618203089
20211016,2호선,영등포구청,12319,12830,25149,37.5256996614804,126.896626898379
20211016,2호선,왕십리,12870,10781,23651,37.5612217415191,127.036655378283
20211016,2호선,용답,2153,2045,4198,37.5620049052662,127.050729309179
20211016,2호선,용두,1576,1700,3276,37.5739380503267,127.038031119837
20211016,2호선,을지로3가,9987,9682,19669,37.56626594615,126.990308356253
20211016,2호선,을지로4가,6578,6524,13102,37.5666369941572,126.997852780281
20211016,2호선,을지로입구,18446,18457,36903,37.5660509513873,126.982372901787
20211016,2호선,이대,9239,9701,18940,37.5567980142044,126.945758201019
20211016,2호선,잠실,59481,56888,116369,37.513859279255,127.101857941447
20211016,2호선,잠실나루,7100,7055,14155,37.5206867318088,127.103811089444
20211016,2호선,잠실새내,16070,16240,32310,37.5115672093323,127.086373867207
20211016,2호선,종합운동장,4691,5619,10310,37.5109692748993,127.073356018706
20211016,2호선,충정로,5365,5644,11009,37.5598377952439,126.964474043785
20211016,2호선,한양대,3937,3868,7805,37.55557788354,127.043584493543
20211016,2호선,합정,26025,27503,53528,37.5501152068908,126.914638180431
20211016,2호선,홍대입구,56503,58125,114628,37.5577458058734,126.926498328277
20211017,2호선,강남,31812,30617,62429,37.4981646510326,127.028307900881
20211017,2호선,강변,19268,18826,38094,37.5351692767888,127.094664569096
20211017,2호선,건대입구,22912,23731,46643,37.5404188872176,127.069173281554
20211017,2호선,교대,9323,10221,19544,37.4928178646055,127.013838469407
20211017,2호선,구로디지털단지,21091,20810,41901,37.4853149237865,126.901494378412
20211017,2호선,구의,10468,10318,20786,37.5371535596228,127.086179228767
20211017,2호선,낙성대,13902,14531,28433,37.4770651843603,126.963409959152
20211017,2호선,당산,7746,8479,16225,37.534956866618,126.90273071003
20211017,2호선,대림,13151,13504,26655,37.4933105886136,126.8949461878
20211017,2호선,도림천,447,458,905,37.5144420510515,126.882702584468
20211017,2호선,동대문역사문화공원,6325,7849,14174,37.5655895229776,127.009131498424
20211017,2호선,뚝섬,8814,8947,17761,37.5471882244091,127.047365178682
20211017,2호선,문래,7231,7570,14801,37.5179214637526,126.894763060556
20211017,2호선,방배,6075,6473,12548,37.4814364876589,126.997694899327
20211017,2호선,봉천,10986,10786,21772,37.4825562153548,126.941495272047
20211017,2호선,사당,19577,21298,40875,37.4765228347619,126.981408909449
20211017,2호선,삼성,20838,20796,41634,37.5088619974404,127.063073009788
20211017,2호선,상왕십리,6192,6131,12323,37.5644687111181,127.029031221392
20211017,2호선,서울대입구,24514,24888,49402,37.4811526631844,126.952645104944
20211017,2호선,서초,8849,8211,17060,37.4918229990093,127.007580814715
20211017,2호선,선릉,11911,10268,22179,37.5045028775835,127.048942471228
20211017,2호선,성수,11867,12883,24750,37.5445023983984,127.056090471223
20211017,2호선,시청,5324,4342,9666,37.5654385176408,126.976983237511
20211017,2호선,신답,648,720,1368,37.5699910562183,127.046820203556
20211017,2호선,신당,7414,7750,15164,37.5656540317328,127.019540574485
20211017,2호선,신대방,14139,13897,28036,37.4875759745635,126.913175585996
20211017,2호선,신도림,25865,26181,52046,37.5087701449787,126.891080501385
20211017,2호선,신림,33963,32885,66848,37.4841196518392,126.928712092948
20211017,2호선,신설동,2545,1327,3872,37.5762451837487,127.023278761358
20211017,2호선,신정네거리,4689,4686,9375,37.5197975266787,126.852991645059
20211017,2호선,신촌,19030,18293,37323,37.5554417865984,126.936119192554
20211017,2호선,아현,4656,4751,9407,37.5573575723061,126.95603374504
20211017,2호선,양천구청,2818,2932,5750,37.5126989358446,126.866065211751
20211017,2호선,역삼,10212,11073,21285,37.5007162693593,127.036618203089
20211017,2호선,영등포구청,7780,7947,15727,37.5256996614804,126.896626898379
20211017,2호선,왕십리,8455,7443,15898,37.5612217415191,127.036655378283
20211017,2호선,용답,1616,1654,3270,37.5620049052662,127.050729309179
20211017,2호선,용두,1096,1145,2241,37.5739380503267,127.038031119837
20211017,2호선,을지로3가,6564,6007,12571,37.56626594615,126.990308356253
20211017,2호선,을지로4가,2798,2727,5525,37.5666369941572,126.997852780281
20211017,2호선,을지로입구,13184,12595,25779,37.5660509513873,126.982372901787
20211017,2호선,이대,6022,6331,12353,37.5567980142044,126.945758201019
20211017,2호선,잠실,44553,41612,86165,37.513859279255,127.101857941447
20211017,2호선,잠실나루,4933,5037,9970,37.5206867318088,127.103811089444
20211017,2호선,잠실새내,9555,9736,19291,37.5115672093323,127.086373867207
20211017,2호선,종합운동장,3446,3666,7112,37.5109692748993,127.073356018706
20211017,2호선,충정로,3423,3544,6967,37.5598377952439,126.964474043785
20211017,2호선,한양대,2557,2662,5219,37.55557788354,127.043584493543
20211017,2호선,합정,18201,19260,37461,37.5501152068908,126.914638180431
20211017,2호선,홍대입구,40576,40377,80953,37.5577458058734,126.926498328277
20211023,2호선,강남,57308,57246,114554,37.4981646510326,127.028307900881
20211023,2호선,강변,26733,27531,54264,37.5351692767888,127.094664569096
20211023,2호선,건대입구,33038,35149,68187,37.5404188872176,127.069173281554
20211023,2호선,교대,17063,19234,36297,37.4928178646055,127.013838469407
20211023,2호선,구로디지털단지,33158,32466,65624,37.4853149237865,126.901494378412
20211023,2호선,구의,15976,15217,31193,37.5371535596228,127.086179228767
20211023,2호선,낙성대,21172,19569,40741,37.4770651843603,126.963409959152
20211023,2호선,당산,12968,13894,26862,37.534956866618,126.90273071003
20211023,2호선,대림,17394,18582,35976,37.4933105886136,126.8949461878
20211023,2호선,도림천,746,735,1481,37.5144420510515,126.882702584468
20211023,2호선,동대문역사문화공원,9566,11064,20630,37.5655895229776,127.009131498424
20211023,2호선,뚝섬,13910,14019,27929,37.5471882244091,127.047365178682
20211023,2호선,문래,12246,12634,24880,37.5179214637526,126.894763060556
20211023,2호선,방배,9723,10203,19926,37.4814364876589,126.997694899327
20211023,2호선,봉천,16504,15392,31896,37.4825562153548,126.941495272047
20211023,2호선,사당,29594,33149,62743,37.4765228347619,126.981408909449
20211023,2호선,삼성,27743,28348,56091,37.5088619974404,127.063073009788
20211023,2호선,상왕십리,9427,8846,18273,37.5644687111181,127.029031221392
20211023,2호선,서울대입구,37590,36381,73971,37.4811526631844,126.952645104944
20211023,2호선,서초,10167,8477,18644,37.4918229990093,127.007580814715
20211023,2호선,선릉,23859,20972,44831,37.5045028775835,127.048942471228
20211023,2호선,성수,19166,21052,40218,37.5445023983984,127.056090471223
20211023,2호선,시청,9181,8091,17272,37.5654385176408,126.976983237511
20211023,2호선,신답,948,1044,1992,37.5699910562183,127.046820203556
20211023,2호선,신당,10680,10980,21660,37.5656540317328,127.019540574485
20211023,2호선,신대방,19577,18781,38358,37.4875759745635,126.913175585996
20211023,2호선,신도림,40268,40546,80814,37.5087701449787,126.891080501385
20211023,2호선,신림,48909,46702,95611,37.4841196518392,126.928712092948
20211023,2호선,신설동,3057,3105,6162,37.5762451837487,127.023278761358
20211023,2호선,신정네거리,7559,7611,15170,37.5197975266787,126.852991645059
20211023,2호선,신촌,27825,28178,56003,37.5554417865984,126.936119192554
20211023,2호선,아현,7422,6968,14390,37.5573575723061,126.95603374504
20211023,2호선,양천구청,4885,4826,9711,37.5126989358446,126.866065211751
20211023,2호선,역삼,17735,19281,37016,37.5007162693593,127.036618203089
20211023,2호선,영등포구청,12797,13263,26060,37.5256996614804,126.896626898379
20211023,2호선,왕십리,13516,11399,24915,37.5612217415191,127.036655378283
20211023,2호선,용답,2104,1981,4085,37.5620049052662,127.050729309179
20211023,2호선,용두,1638,1640,3278,37.5739380503267,127.038031119837
20211023,2호선,을지로3가,10651,10265,20916,37.56626594615,126.990308356253
20211023,2호선,을지로4가,7341,7487,14828,37.5666369941572,126.997852780281
20211023,2호선,을지로입구,19413,19083,38496,37.5660509513873,126.982372901787
20211023,2호선,이대,9787,10279,20066,37.5567980142044,126.945758201019
20211023,2호선,잠실,64989,61557,126546,37.513859279255,127.101857941447
20211023,2호선,잠실나루,7401,7267,14668,37.5206867318088,127.103811089444
20211023,2호선,잠실새내,16137,16682,32819,37.5115672093323,127.086373867207
20211023,2호선,종합운동장,6781,7272,14053,37.5109692748993,127.073356018706
20211023,2호선,충정로,5624,5971,11595,37.5598377952439,126.964474043785
20211023,2호선,한양대,3893,4110,8003,37.55557788354,127.043584493543
20211023,2호선,합정,26786,29126,55912,37.5501152068908,126.914638180431
20211023,2호선,홍대입구,60260,64158,124418,37.5577458058734,126.926498328277
20211024,2호선,강남,33739,32249,65988,37.4981646510326,127.028307900881
20211024,2호선,강변,22151,20990,43141,37.5351692767888,127.094664569096
20211024,2호선,건대입구,24926,25678,50604,37.5404188872176,127.069173281554
20211024,2호선,교대,10112,11088,21200,37.4928178646055,127.013838469407
20211024,2호선,구로디지털단지,22551,22283,44834,37.4853149237865,126.901494378412
20211024,2호선,구의,10985,10990,21975,37.5371535596228,127.086179228767
20211024,2호선,낙성대,15093,15397,30490,37.4770651843603,126.963409959152
20211024,2호선,당산,8812,9523,18335,37.534956866618,126.90273071003
20211024,2호선,대림,14551,14903,29454,37.4933105886136,126.8949461878
20211024,2호선,도림천,464,552,1016,37.5144420510515,126.882702584468
20211024,2호선,동대문역사문화공원,7312,9181,16493,37.5655895229776,127.009131498424
20211024,2호선,뚝섬,10108,10270,20378,37.5471882244091,127.047365178682
20211024,2호선,문래,7616,8122,15738,37.5179214637526,126.894763060556
20211024,2호선,방배,6401,6754,13155,37.4814364876589,126.997694899327
20211024,2호선,봉천,11808,11591,23399,37.4825562153548,126.941495272047
20211024,2호선,사당,21032,23407,44439,37.4765228347619,126.981408909449
20211024,2호선,삼성,19067,18657,37724,37.5088619974404,127.063073009788
20211024,2호선,상왕십리,6572,6550,13122,37.5644687111181,127.029031221392
20211024,2호선,서울대입구,26187,27373,53560,37.4811526631844,126.952645104944
20211024,2호선,서초,9548,8778,18326,37.4918229990093,127.007580814715
20211024,2호선,선릉,12921,11224,24145,37.5045028775835,127.048942471228
20211024,2호선,성수,12838,14168,27006,37.5445023983984,127.056090471223
20211024,2호선,시청,5954,5126,11080,37.5654385176408,126.976983237511
20211024,2호선,신답,753,747,1500,37.5699910562183,127.046820203556
20211024,2호선,신당,7919,8336,16255,37.5656540317328,127.019540574485
20211024,2호선,신대방,14667,14623,29290,37.4875759745635,126.913175585996
20211024,2호선,신도림,28408,28787,57195,37.5087701449787,126.891080501385
20211024,2호선,신림,35397,35047,70444,37.4841196518392,126.928712092948
20211024,2호선,신설동,2883,2911,5794,37.5762451837487,127.023278761358
20211024,2호선,신정네거리,5218,5215,10433,37.5197975266787,126.852991645059
20211024,2호선,신촌,19646,18990,38636,37.5554417865984,126.936119192554
20211024,2호선,아현,4904,4963,9867,37.5573575723061,126.95603374504
20211024,2호선,양천구청,3687,3856,7543,37.5126989358446,126.866065211751
20211024,2호선,역삼,9850,10844,20694,37.5007162693593,127.036618203089
20211024,2호선,영등포구청,8315,8575,16890,37.5256996614804,126.896626898379
20211024,2호선,왕십리,8916,7746,16662,37.5612217415191,127.036655378283
20211024,2호선,용답,1574,1577,3151,37.5620049052662,127.050729309179
20211024,2호선,용두,1070,1018,2088,37.5739380503267,127.038031119837
20211024,2호선,을지로3가,7225,6916,14141,37.56626594615,126.990308356253
20211024,2호선,을지로4가,3249,3262,6511,37.5666369941572,126.997852780281
20211024,2호선,을지로입구,14474,13428,27902,37.5660509513873,126.982372901787
20211024,2호선,이대,6748,7214,13962,37.5567980142044,126.945758201019
20211024,2호선,잠실,48901,45286,94187,37.513859279255,127.101857941447
20211024,2호선,잠실나루,5045,5185,10230,37.5206867318088,127.103811089444
20211024,2호선,잠실새내,10320,10732,21052,37.5115672093323,127.086373867207
20211024,2호선,종합운동장,6427,6614,13041,37.5109692748993,127.073356018706
20211024,2호선,충정로,3754,3987,7741,37.5598377952439,126.964474043785
20211024,2호선,한양대,2175,2490,4665,37.55557788354,127.043584493543
20211024,2호선,합정,19226,20600,39826,37.5501152068908,126.914638180431
20211024,2호선,홍대입구,44831,44711,89542,37.5577458058734,126.926498328277
20211030,2호선,강남,60381,60378,120759,37.4981646510326,127.028307900881
20211030,2호선,강변,27869,28422,56291,37.5351692767888,127.094664569096
20211030,2호선,건대입구,35191,37688,72879,37.5404188872176,127.069173281554
20211030,2호선,교대,16670,18591,35261,37.4928178646055,127.013838469407
20211030,2호선,구로디지털단지,34238,33771,68009,37.4853149237865,126.901494378412
20211030,2호선,구의,16157,15609,31766,37.5371535596228,127.086179228767
20211030,2호선,낙성대,22126,20194,42320,37.4770651843603,126.963409959152
20211030,2호선,당산,13345,14683,28028,37.534956866618,126.90273071003
20211030,2호선,대림,18124,19240,37364,37.4933105886136,126.8949461878
20211030,2호선,도림천,802,850,1652,37.5144420510515,126.882702584468
20211030,2호선,동대문역사문화공원,9975,11320,21295,37.5655895229776,127.009131498424
20211030,2호선,뚝섬,15416,15385,30801,37.5471882244091,127.047365178682
20211030,2호선,문래,12229,12832,25061,37.5179214637526,126.894763060556
20211030,2호선,방배,9827,10201,20028,37.4814364876589,126.997694899327
20211030,2호선,봉천,17015,15610,32625,37.4825562153548,126.941495272047
20211030,2호선,사당,30865,34375,65240,37.4765228347619,126.981408909449
20211030,2호선,삼성,27052,27617,54669,37.5088619974404,127.063073009788
20211030,2호선,상왕십리,10168,9617,19785,37.5644687111181,127.029031221392
20211030,2호선,서울대입구,38219,37105,75324,37.4811526631844,126.952645104944
20211030,2호선,서초,10500,8917,19417,37.4918229990093,127.007580814715
20211030,2호선,선릉,24150,21361,45511,37.5045028775835,127.048942471228
20211030,2호선,성수,19963,22146,42109,37.5445023983984,127.056090471223
20211030,2호선,시청,9595,8924,18519,37.5654385176408,126.976983237511
20211030,2호선,신답,1058,1037,2095,37.5699910562183,127.046820203556
20211030,2호선,신당,10865,11274,22139,37.5656540317328,127.019540574485
20211030,2호선,신대방,20181,19150,39331,37.4875759745635,126.913175585996
20211030,2호선,신도림,41644,42476,84120,37.5087701449787,126.891080501385
20211030,2호선,신림,50615,47831,98446,37.4841196518392,126.928712092948
20211030,2호선,신설동,3154,3076,6230,37.5762451837487,127.023278761358
20211030,2호선,신정네거리,7912,7843,15755,37.5197975266787,126.852991645059
20211030,2호선,신촌,29423,30064,59487,37.5554417865984,126.936119192554
20211030,2호선,아현,7585,7005,14590,37.5573575723061,126.95603374504
20211030,2호선,양천구청,4876,4991,9867,37.5126989358446,126.866065211751
20211030,2호선,역삼,18240,19980,38220,37.5007162693593,127.036618203089
20211030,2호선,영등포구청,12872,13259,26131,37.5256996614804,126.896626898379
20211030,2호선,왕십리,13323,11717,25040,37.5612217415191,127.036655378283
20211030,2호선,용답,2234,2113,4347,37.5620049052662,127.050729309179
20211030,2호선,용두,1709,1687,3396,37.5739380503267,127.038031119837
20211030,2호선,을지로3가,11308,11035,22343,37.56626594615,126.990308356253
20211030,2호선,을지로4가,7271,7616,14887,37.5666369941572,126.997852780281
20211030,2호선,을지로입구,19848,19738,39586,37.5660509513873,126.982372901787
20211030,2호선,이대,10835,11249,22084,37.5567980142044,126.945758201019
20211030,2호선,잠실,69975,66688,136663,37.513859279255,127.101857941447
20211030,2호선,잠실나루,7924,7775,15699,37.5206867318088,127.103811089444
20211030,2호선,잠실새내,16710,17027,33737,37.5115672093323,127.086373867207
20211030,2호선,종합운동장,5083,5528,10611,37.5109692748993,127.073356018706
20211030,2호선,충정로,5580,5976,11556,37.5598377952439,126.964474043785
20211030,2호선,한양대,4305,4374,8679,37.55557788354,127.043584493543
20211030,2호선,합정,28921,30678,59599,37.5501152068908,126.914638180431
20211030,2호선,홍대입구,64173,69749,133922,37.5577458058734,126.926498328277
20211031,2호선,강남,35888,34675,70563,37.4981646510326,127.028307900881
20211031,2호선,강변,23076,21854,44930,37.5351692767888,127.094664569096
20211031,2호선,건대입구,27632,28507,56139,37.5404188872176,127.069173281554
20211031,2호선,교대,10300,11338,21638,37.4928178646055,127.013838469407
20211031,2호선,구로디지털단지,23613,23126,46739,37.4853149237865,126.901494378412
20211031,2호선,구의,11326,11423,22749,37.5371535596228,127.086179228767
20211031,2호선,낙성대,15638,16186,31824,37.4770651843603,126.963409959152
20211031,2호선,당산,9163,9788,18951,37.534956866618,126.90273071003
20211031,2호선,대림,14736,15019,29755,37.4933105886136,126.8949461878
20211031,2호선,도림천,435,459,894,37.5144420510515,126.882702584468
20211031,2호선,동대문역사문화공원,7468,9054,16522,37.5655895229776,127.009131498424
20211031,2호선,뚝섬,11258,11119,22377,37.5471882244091,127.047365178682
20211031,2호선,문래,8408,8728,17136,37.5179214637526,126.894763060556
20211031,2호선,방배,6501,6957,13458,37.4814364876589,126.997694899327
20211031,2호선,봉천,11985,11684,23669,37.4825562153548,126.941495272047
20211031,2호선,사당,21870,24310,46180,37.4765228347619,126.981408909449
20211031,2호선,삼성,19838,19529,39367,37.5088619974404,127.063073009788
20211031,2호선,상왕십리,6873,6874,13747,37.5644687111181,127.029031221392
20211031,2호선,서울대입구,27414,28535,55949,37.4811526631844,126.952645104944
20211031,2호선,서초,9922,9291,19213,37.4918229990093,127.007580814715
20211031,2호선,선릉,13499,11539,25038,37.5045028775835,127.048942471228
20211031,2호선,성수,14153,15759,29912,37.5445023983984,127.056090471223
20211031,2호선,시청,6953,6038,12991,37.5654385176408,126.976983237511
20211031,2호선,신답,745,801,1546,37.5699910562183,127.046820203556
20211031,2호선,신당,8429,8960,17389,37.5656540317328,127.019540574485
20211031,2호선,신대방,14973,14883,29856,37.4875759745635,126.913175585996
20211031,2호선,신도림,28880,29664,58544,37.5087701449787,126.891080501385
20211031,2호선,신림,36634,36238,72872,37.4841196518392,126.928712092948
20211031,2호선,신설동,2948,3028,5976,37.5762451837487,127.023278761358
20211031,2호선,신정네거리,5182,5336,10518,37.5197975266787,126.852991645059
20211031,2호선,신촌,21883,21438,43321,37.5554417865984,126.936119192554
20211031,2호선,아현,5125,5290,10415,37.5573575723061,126.95603374504
20211031,2호선,양천구청,3414,3488,6902,37.5126989358446,126.866065211751
20211031,2호선,역삼,10909,12147,23056,37.5007162693593,127.036618203089
20211031,2호선,영등포구청,8538,8961,17499,37.5256996614804,126.896626898379
20211031,2호선,왕십리,9452,8680,18132,37.5612217415191,127.036655378283
20211031,2호선,용답,1704,1790,3494,37.5620049052662,127.050729309179
20211031,2호선,용두,1121,1137,2258,37.5739380503267,127.038031119837
20211031,2호선,을지로3가,8148,7614,15762,37.56626594615,126.990308356253
20211031,2호선,을지로4가,3449,3257,6706,37.5666369941572,126.997852780281
20211031,2호선,을지로입구,15156,13873,29029,37.5660509513873,126.982372901787
20211031,2호선,이대,7190,7806,14996,37.5567980142044,126.945758201019
20211031,2호선,잠실,54985,50559,105544,37.513859279255,127.101857941447
20211031,2호선,잠실나루,5481,5764,11245,37.5206867318088,127.103811089444
20211031,2호선,잠실새내,10734,10969,21703,37.5115672093323,127.086373867207
20211031,2호선,종합운동장,3706,3838,7544,37.5109692748993,127.073356018706
20211031,2호선,충정로,3796,4097,7893,37.5598377952439,126.964474043785
20211031,2호선,한양대,2299,2640,4939,37.55557788354,127.043584493543
20211031,2호선,합정,20553,21506,42059,37.5501152068908,126.914638180431
20211031,2호선,홍대입구,51690,51428,103118,37.5577458058734,126.926498328277
20211106,2호선,강남,60591,64409,125000,37.4981646510326,127.028307900881
20211106,2호선,강변,28721,29315,58036,37.5351692767888,127.094664569096
20211106,2호선,건대입구,35237,39682,74919,37.5404188872176,127.069173281554
20211106,2호선,교대,17251,19735,36986,37.4928178646055,127.013838469407
20211106,2호선,구로디지털단지,35364,34203,69567,37.4853149237865,126.901494378412
20211106,2호선,구의,16566,15737,32303,37.5371535596228,127.086179228767
20211106,2호선,낙성대,22828,20319,43147,37.4770651843603,126.963409959152
20211106,2호선,당산,13740,14839,28579,37.534956866618,126.90273071003
20211106,2호선,대림,18608,19438,38046,37.4933105886136,126.8949461878
20211106,2호선,도림천,745,753,1498,37.5144420510515,126.882702584468
20211106,2호선,동대문역사문화공원,9830,10861,20691,37.5655895229776,127.009131498424
20211106,2호선,뚝섬,16184,15775,31959,37.5471882244091,127.047365178682
20211106,2호선,문래,12767,13682,26449,37.5179214637526,126.894763060556
20211106,2호선,방배,10057,10221,20278,37.4814364876589,126.997694899327
20211106,2호선,봉천,17332,15248,32580,37.4825562153548,126.941495272047
20211106,2호선,사당,31880,35805,67685,37.4765228347619,126.981408909449
20211106,2호선,삼성,29887,30384,60271,37.5088619974404,127.063073009788
20211106,2호선,상왕십리,10201,9477,19678,37.5644687111181,127.029031221392
20211106,2호선,서울대입구,39064,37781,76845,37.4811526631844,126.952645104944
20211106,2호선,서초,10954,8975,19929,37.4918229990093,127.007580814715
20211106,2호선,선릉,24278,21006,45284,37.5045028775835,127.048942471228
20211106,2호선,성수,20647,24064,44711,37.5445023983984,127.056090471223
20211106,2호선,시청,11570,11224,22794,37.5654385176408,126.976983237511
20211106,2호선,신답,1015,1074,2089,37.5699910562183,127.046820203556
20211106,2호선,신당,11002,11179,22181,37.5656540317328,127.019540574485
20211106,2호선,신대방,20871,19560,40431,37.4875759745635,126.913175585996
20211106,2호선,신도림,41727,42227,83954,37.5087701449787,126.891080501385
20211106,2호선,신림,51403,48329,99732,37.4841196518392,126.928712092948
20211106,2호선,신설동,3314,3204,6518,37.5762451837487,127.023278761358
20211106,2호선,신정네거리,8070,8038,16108,37.5197975266787,126.852991645059
20211106,2호선,신촌,29194,29811,59005,37.5554417865984,126.936119192554
20211106,2호선,아현,7541,6893,14434,37.5573575723061,126.95603374504
20211106,2호선,양천구청,4664,4679,9343,37.5126989358446,126.866065211751
20211106,2호선,역삼,18059,19559,37618,37.5007162693593,127.036618203089
20211106,2호선,영등포구청,13268,13932,27200,37.5256996614804,126.896626898379
20211106,2호선,왕십리,14061,12294,26355,37.5612217415191,127.036655378283
20211106,2호선,용답,2293,2104,4397,37.5620049052662,127.050729309179
20211106,2호선,용두,1771,1755,3526,37.5739380503267,127.038031119837
20211106,2호선,을지로3가,12083,11787,23870,37.56626594615,126.990308356253
20211106,2호선,을지로4가,7508,7724,15232,37.5666369941572,126.997852780281
20211106,2호선,을지로입구,21611,21080,42691,37.5660509513873,126.982372901787
20211106,2호선,이대,10503,10795,21298,37.5567980142044,126.945758201019
20211106,2호선,잠실,70753,67285,138038,37.513859279255,127.101857941447
20211106,2호선,잠실나루,8910,8495,17405,37.5206867318088,127.103811089444
20211106,2호선,잠실새내,16848,17247,34095,37.5115672093323,127.086373867207
20211106,2호선,종합운동장,5093,5407,10500,37.5109692748993,127.073356018706
20211106,2호선,충정로,5894,6204,12098,37.5598377952439,126.964474043785
20211106,2호선,한양대,5019,5115,10134,37.55557788354,127.043584493543
20211106,2호선,합정,27577,31468,59045,37.5501152068908,126.914638180431
20211106,2호선,홍대입구,61055,70358,131413,37.5577458058734,126.926498328277
20211107,2호선,강남,35654,35479,71133,37.4981646510326,127.028307900881
20211107,2호선,강변,24127,22748,46875,37.5351692767888,127.094664569096
20211107,2호선,건대입구,27038,28553,55591,37.5404188872176,127.069173281554
20211107,2호선,교대,10762,11707,22469,37.4928178646055,127.013838469407
20211107,2호선,구로디지털단지,24601,24146,48747,37.4853149237865,126.901494378412
20211107,2호선,구의,11446,11455,22901,37.5371535596228,127.086179228767
20211107,2호선,낙성대,16399,16640,33039,37.4770651843603,126.963409959152
20211107,2호선,당산,9265,9955,19220,37.534956866618,126.90273071003
20211107,2호선,대림,14931,15289,30220,37.4933105886136,126.8949461878
20211107,2호선,도림천,551,552,1103,37.5144420510515,126.882702584468
20211107,2호선,동대문역사문화공원,6830,8389,15219,37.5655895229776,127.009131498424
20211107,2호선,뚝섬,11457,11522,22979,37.5471882244091,127.047365178682
20211107,2호선,문래,8539,9032,17571,37.5179214637526,126.894763060556
20211107,2호선,방배,6932,7347,14279,37.4814364876589,126.997694899327
20211107,2호선,봉천,12433,11877,24310,37.4825562153548,126.941495272047
20211107,2호선,사당,22937,25672,48609,37.4765228347619,126.981408909449
20211107,2호선,삼성,20963,20382,41345,37.5088619974404,127.063073009788
20211107,2호선,상왕십리,7218,7079,14297,37.5644687111181,127.029031221392
20211107,2호선,서울대입구,27963,29088,57051,37.4811526631844,126.952645104944
20211107,2호선,서초,11196,10339,21535,37.4918229990093,127.007580814715
20211107,2호선,선릉,13300,11601,24901,37.5045028775835,127.048942471228
20211107,2호선,성수,15672,17441,33113,37.5445023983984,127.056090471223
20211107,2호선,시청,7994,7170,15164,37.5654385176408,126.976983237511
20211107,2호선,신답,841,835,1676,37.5699910562183,127.046820203556
20211107,2호선,신당,8115,8621,16736,37.5656540317328,127.019540574485
20211107,2호선,신대방,15808,15690,31498,37.4875759745635,126.913175585996
20211107,2호선,신도림,29452,29843,59295,37.5087701449787,126.891080501385
20211107,2호선,신림,37386,36835,74221,37.4841196518392,126.928712092948
20211107,2호선,신설동,2938,3028,5966,37.5762451837487,127.023278761358
20211107,2호선,신정네거리,5563,5475,11038,37.5197975266787,126.852991645059
20211107,2호선,신촌,21865,21207,43072,37.5554417865984,126.936119192554
20211107,2호선,아현,5135,5141,10276,37.5573575723061,126.95603374504
20211107,2호선,양천구청,3502,3580,7082,37.5126989358446,126.866065211751
20211107,2호선,역삼,11432,12100,23532,37.5007162693593,127.036618203089
20211107,2호선,영등포구청,8724,9201,17925,37.5256996614804,126.896626898379
20211107,2호선,왕십리,9864,8866,18730,37.5612217415191,127.036655378283
20211107,2호선,용답,1794,1764,3558,37.5620049052662,127.050729309179
20211107,2호선,용두,1216,1207,2423,37.5739380503267,127.038031119837
20211107,2호선,을지로3가,8630,7688,16318,37.56626594615,126.990308356253
20211107,2호선,을지로4가,3605,3396,7001,37.5666369941572,126.997852780281
20211107,2호선,을지로입구,15673,14454,30127,37.5660509513873,126.982372901787
20211107,2호선,이대,7445,7754,15199,37.5567980142044,126.945758201019
20211107,2호선,잠실,52461,49225,101686,37.513859279255,127.101857941447
20211107,2호선,잠실나루,5272,5520,10792,37.5206867318088,127.103811089444
20211107,2호선,잠실새내,12063,12072,24135,37.5115672093323,127.086373867207
20211107,2호선,종합운동장,16168,18223,34391,37.5109692748993,127.073356018706
20211107,2호선,충정로,3862,4247,8109,37.5598377952439,126.964474043785
20211107,2호선,한양대,2351,2677,5028,37.55557788354,127.043584493543
20211107,2호선,합정,20273,21645,41918,37.5501152068908,126.914638180431
20211107,2호선,홍대입구,48166,48680,96846,37.5577458058734,126.926498328277
20211113,2호선,강남,61857,65399,127256,37.4981646510326,127.028307900881
20211113,2호선,강변,28791,29332,58123,37.5351692767888,127.094664569096
20211113,2호선,건대입구,34797,39327,74124,37.5404188872176,127.069173281554
20211113,2호선,교대,17349,19639,36988,37.4928178646055,127.013838469407
20211113,2호선,구로디지털단지,35418,34467,69885,37.4853149237865,126.901494378412
20211113,2호선,구의,16429,15697,32126,37.5371535596228,127.086179228767
20211113,2호선,낙성대,21828,19684,41512,37.4770651843603,126.963409959152
20211113,2호선,당산,12854,13839,26693,37.534956866618,126.90273071003
20211113,2호선,대림,17723,18793,36516,37.4933105886136,126.8949461878
20211113,2호선,도림천,859,832,1691,37.5144420510515,126.882702584468
20211113,2호선,동대문역사문화공원,11340,12143,23483,37.5655895229776,127.009131498424
20211113,2호선,뚝섬,14710,14647,29357,37.5471882244091,127.047365178682
20211113,2호선,문래,12555,13311,25866,37.5179214637526,126.894763060556
20211113,2호선,방배,10056,10106,20162,37.4814364876589,126.997694899327
20211113,2호선,봉천,17385,15219,32604,37.4825562153548,126.941495272047
20211113,2호선,사당,32804,36423,69227,37.4765228347619,126.981408909449
20211113,2호선,삼성,35051,35456,70507,37.5088619974404,127.063073009788
20211113,2호선,상왕십리,10095,9046,19141,37.5644687111181,127.029031221392
20211113,2호선,서울대입구,38510,36841,75351,37.4811526631844,126.952645104944
20211113,2호선,서초,12329,8855,21184,37.4918229990093,127.007580814715
20211113,2호선,선릉,24571,21664,46235,37.5045028775835,127.048942471228
20211113,2호선,성수,19234,21897,41131,37.5445023983984,127.056090471223
20211113,2호선,시청,8933,8169,17102,37.5654385176408,126.976983237511
20211113,2호선,신답,1098,1075,2173,37.5699910562183,127.046820203556
20211113,2호선,신당,11137,11206,22343,37.5656540317328,127.019540574485
20211113,2호선,신대방,20194,19016,39210,37.4875759745635,126.913175585996
20211113,2호선,신도림,41812,42474,84286,37.5087701449787,126.891080501385
20211113,2호선,신림,50467,47690,98157,37.4841196518392,126.928712092948
20211113,2호선,신설동,3709,3269,6978,37.5762451837487,127.023278761358
20211113,2호선,신정네거리,7472,7395,14867,37.5197975266787,126.852991645059
20211113,2호선,신촌,30612,30875,61487,37.5554417865984,126.936119192554
20211113,2호선,아현,7789,7163,14952,37.5573575723061,126.95603374504
20211113,2호선,양천구청,4605,4636,9241,37.5126989358446,126.866065211751
20211113,2호선,역삼,19021,20647,39668,37.5007162693593,127.036618203089
20211113,2호선,영등포구청,13306,13766,27072,37.5256996614804,126.896626898379
20211113,2호선,왕십리,14122,12211,26333,37.5612217415191,127.036655378283
20211113,2호선,용답,2215,2099,4314,37.5620049052662,127.050729309179
20211113,2호선,용두,1818,1737,3555,37.5739380503267,127.038031119837
20211113,2호선,을지로3가,13565,15088,28653,37.56626594615,126.990308356253
20211113,2호선,을지로4가,7903,8207,16110,37.5666369941572,126.997852780281
20211113,2호선,을지로입구,18843,18267,37110,37.5660509513873,126.982372901787
20211113,2호선,이대,10691,10929,21620,37.5567980142044,126.945758201019
20211113,2호선,잠실,67050,64393,131443,37.513859279255,127.101857941447
20211113,2호선,잠실나루,7797,7480,15277,37.5206867318088,127.103811089444
20211113,2호선,잠실새내,16445,17023,33468,37.5115672093323,127.086373867207
20211113,2호선,종합운동장,4828,5435,10263,37.5109692748993,127.073356018706
20211113,2호선,충정로,6462,7462,13924,37.5598377952439,126.964474043785
20211113,2호선,한양대,4082,4036,8118,37.55557788354,127.043584493543
20211113,2호선,합정,27704,31873,59577,37.5501152068908,126.914638180431
20211113,2호선,홍대입구,62614,71630,134244,37.5577458058734,126.926498328277
20211114,2호선,강남,35726,35775,71501,37.4981646510326,127.028307900881
20211114,2호선,강변,23232,22201,45433,37.5351692767888,127.094664569096
20211114,2호선,건대입구,26433,28073,54506,37.5404188872176,127.069173281554
20211114,2호선,교대,10407,11626,22033,37.4928178646055,127.013838469407
20211114,2호선,구로디지털단지,24040,23804,47844,37.4853149237865,126.901494378412
20211114,2호선,구의,11405,11379,22784,37.5371535596228,127.086179228767
20211114,2호선,낙성대,15823,16165,31988,37.4770651843603,126.963409959152
20211114,2호선,당산,8980,9760,18740,37.534956866618,126.90273071003
20211114,2호선,대림,15445,15605,31050,37.4933105886136,126.8949461878
20211114,2호선,도림천,478,503,981,37.5144420510515,126.882702584468
20211114,2호선,동대문역사문화공원,7339,8875,16214,37.5655895229776,127.009131498424
20211114,2호선,뚝섬,10332,10315,20647,37.5471882244091,127.047365178682
20211114,2호선,문래,8012,8461,16473,37.5179214637526,126.894763060556
20211114,2호선,방배,6834,7191,14025,37.4814364876589,126.997694899327
20211114,2호선,봉천,12225,11842,24067,37.4825562153548,126.941495272047
20211114,2호선,사당,22342,25012,47354,37.4765228347619,126.981408909449
20211114,2호선,삼성,19899,19598,39497,37.5088619974404,127.063073009788
20211114,2호선,상왕십리,6953,6840,13793,37.5644687111181,127.029031221392
20211114,2호선,서울대입구,27255,28326,55581,37.4811526631844,126.952645104944
20211114,2호선,서초,10998,10267,21265,37.4918229990093,127.007580814715
20211114,2호선,선릉,13071,11351,24422,37.5045028775835,127.048942471228
20211114,2호선,성수,12923,14466,27389,37.5445023983984,127.056090471223
20211114,2호선,시청,6664,5841,12505,37.5654385176408,126.976983237511
20211114,2호선,신답,699,754,1453,37.5699910562183,127.046820203556
20211114,2호선,신당,8101,8494,16595,37.5656540317328,127.019540574485
20211114,2호선,신대방,15261,15026,30287,37.4875759745635,126.913175585996
20211114,2호선,신도림,30181,30247,60428,37.5087701449787,126.891080501385
20211114,2호선,신림,36729,36061,72790,37.4841196518392,126.928712092948
20211114,2호선,신설동,2953,2970,5923,37.5762451837487,127.023278761358
20211114,2호선,신정네거리,5166,5234,10400,37.5197975266787,126.852991645059
20211114,2호선,신촌,21795,21161,42956,37.5554417865984,126.936119192554
20211114,2호선,아현,5149,5089,10238,37.5573575723061,126.95603374504
20211114,2호선,양천구청,3339,3416,6755,37.5126989358446,126.866065211751
20211114,2호선,역삼,11492,12339,23831,37.5007162693593,127.036618203089
20211114,2호선,영등포구청,8361,8673,17034,37.5256996614804,126.896626898379
20211114,2호선,왕십리,9526,8280,17806,37.5612217415191,127.036655378283
20211114,2호선,용답,1662,1725,3387,37.5620049052662,127.050729309179
20211114,2호선,용두,1035,1032,2067,37.5739380503267,127.038031119837
20211114,2호선,을지로3가,8454,7762,16216,37.56626594615,126.990308356253
20211114,2호선,을지로4가,3368,3215,6583,37.5666369941572,126.997852780281
20211114,2호선,을지로입구,15612,14366,29978,37.5660509513873,126.982372901787
20211114,2호선,이대,6967,7463,14430,37.5567980142044,126.945758201019
20211114,2호선,잠실,49688,46499,96187,37.513859279255,127.101857941447
20211114,2호선,잠실나루,5356,5485,10841,37.5206867318088,127.103811089444
20211114,2호선,잠실새내,10604,10913,21517,37.5115672093323,127.086373867207
20211114,2호선,종합운동장,3928,4337,8265,37.5109692748993,127.073356018706
20211114,2호선,충정로,3867,4099,7966,37.5598377952439,126.964474043785
20211114,2호선,한양대,2511,2803,5314,37.55557788354,127.043584493543
20211114,2호선,합정,20959,22256,43215,37.5501152068908,126.914638180431
20211114,2호선,홍대입구,48120,48022,96142,37.5577458058734,126.926498328277
20211120,2호선,강남,62393,65968,128361,37.4981646510326,127.028307900881
20211120,2호선,강변,29192,29384,58576,37.5351692767888,127.094664569096
20211120,2호선,건대입구,37526,42014,79540,37.5404188872176,127.069173281554
20211120,2호선,교대,17663,20071,37734,37.4928178646055,127.013838469407
20211120,2호선,구로디지털단지,34881,34172,69053,37.4853149237865,126.901494378412
20211120,2호선,구의,17115,16390,33505,37.5371535596228,127.086179228767
20211120,2호선,낙성대,21312,18932,40244,37.4770651843603,126.963409959152
20211120,2호선,당산,13042,14225,27267,37.534956866618,126.90273071003
20211120,2호선,대림,17695,18524,36219,37.4933105886136,126.8949461878
20211120,2호선,도림천,704,732,1436,37.5144420510515,126.882702584468
20211120,2호선,동대문역사문화공원,10059,11038,21097,37.5655895229776,127.009131498424
20211120,2호선,뚝섬,15670,15246,30916,37.5471882244091,127.047365178682
20211120,2호선,문래,12835,13605,26440,37.5179214637526,126.894763060556
20211120,2호선,방배,10935,11100,22035,37.4814364876589,126.997694899327
20211120,2호선,봉천,17129,15221,32350,37.4825562153548,126.941495272047
20211120,2호선,사당,31994,35854,67848,37.4765228347619,126.981408909449
20211120,2호선,삼성,32589,33036,65625,37.5088619974404,127.063073009788
20211120,2호선,상왕십리,10258,9640,19898,37.5644687111181,127.029031221392
20211120,2호선,서울대입구,37880,36556,74436,37.4811526631844,126.952645104944
20211120,2호선,서초,11498,9318,20816,37.4918229990093,127.007580814715
20211120,2호선,선릉,25307,22328,47635,37.5045028775835,127.048942471228
20211120,2호선,성수,19682,22430,42112,37.5445023983984,127.056090471223
20211120,2호선,시청,9949,9081,19030,37.5654385176408,126.976983237511
20211120,2호선,신답,1013,1059,2072,37.5699910562183,127.046820203556
20211120,2호선,신당,11128,11380,22508,37.5656540317328,127.019540574485
20211120,2호선,신대방,20197,19008,39205,37.4875759745635,126.913175585996
20211120,2호선,신도림,41837,43031,84868,37.5087701449787,126.891080501385
20211120,2호선,신림,50344,47394,97738,37.4841196518392,126.928712092948
20211120,2호선,신설동,3078,3128,6206,37.5762451837487,127.023278761358
20211120,2호선,신정네거리,7600,7505,15105,37.5197975266787,126.852991645059
20211120,2호선,신촌,32733,32988,65721,37.5554417865984,126.936119192554
20211120,2호선,아현,7624,6974,14598,37.5573575723061,126.95603374504
20211120,2호선,양천구청,4711,4635,9346,37.5126989358446,126.866065211751
20211120,2호선,역삼,18427,20221,38648,37.5007162693593,127.036618203089
20211120,2호선,영등포구청,13544,13950,27494,37.5256996614804,126.896626898379
20211120,2호선,왕십리,13981,12224,26205,37.5612217415191,127.036655378283
20211120,2호선,용답,2083,1948,4031,37.5620049052662,127.050729309179
20211120,2호선,용두,1665,1647,3312,37.5739380503267,127.038031119837
20211120,2호선,을지로3가,11841,12099,23940,37.56626594615,126.990308356253
20211120,2호선,을지로4가,7147,7342,14489,37.5666369941572,126.997852780281
20211120,2호선,을지로입구,21393,21585,42978,37.5660509513873,126.982372901787
20211120,2호선,이대,11019,11295,22314,37.5567980142044,126.945758201019
20211120,2호선,잠실,64746,61778,126524,37.513859279255,127.101857941447
20211120,2호선,잠실나루,7585,7299,14884,37.5206867318088,127.103811089444
20211120,2호선,잠실새내,16542,17426,33968,37.5115672093323,127.086373867207
20211120,2호선,종합운동장,6229,6785,13014,37.5109692748993,127.073356018706
20211120,2호선,충정로,6084,6315,12399,37.5598377952439,126.964474043785
20211120,2호선,한양대,4771,4988,9759,37.55557788354,127.043584493543
20211120,2호선,합정,28574,32399,60973,37.5501152068908,126.914638180431
20211120,2호선,홍대입구,64178,73567,137745,37.5577458058734,126.926498328277
20211121,2호선,강남,36846,36126,72972,37.4981646510326,127.028307900881
20211121,2호선,강변,23100,22551,45651,37.5351692767888,127.094664569096
20211121,2호선,건대입구,26082,27216,53298,37.5404188872176,127.069173281554
20211121,2호선,교대,10548,11809,22357,37.4928178646055,127.013838469407
20211121,2호선,구로디지털단지,23944,23532,47476,37.4853149237865,126.901494378412
20211121,2호선,구의,11189,11301,22490,37.5371535596228,127.086179228767
20211121,2호선,낙성대,15345,15808,31153,37.4770651843603,126.963409959152
20211121,2호선,당산,8441,9528,17969,37.534956866618,126.90273071003
20211121,2호선,대림,14341,14829,29170,37.4933105886136,126.8949461878
20211121,2호선,도림천,425,437,862,37.5144420510515,126.882702584468
20211121,2호선,동대문역사문화공원,7701,9094,16795,37.5655895229776,127.009131498424
20211121,2호선,뚝섬,10779,11100,21879,37.5471882244091,127.047365178682
20211121,2호선,문래,7992,8435,16427,37.5179214637526,126.894763060556
20211121,2호선,방배,6618,7005,13623,37.4814364876589,126.997694899327
20211121,2호선,봉천,11856,11621,23477,37.4825562153548,126.941495272047
20211121,2호선,사당,22026,24345,46371,37.4765228347619,126.981408909449
20211121,2호선,삼성,24394,23738,48132,37.5088619974404,127.063073009788
20211121,2호선,상왕십리,6768,6822,13590,37.5644687111181,127.029031221392
20211121,2호선,서울대입구,26402,27393,53795,37.4811526631844,126.952645104944
20211121,2호선,서초,11842,11010,22852,37.4918229990093,127.007580814715
20211121,2호선,선릉,14034,12184,26218,37.5045028775835,127.048942471228
20211121,2호선,성수,13527,14974,28501,37.5445023983984,127.056090471223
20211121,2호선,시청,6430,5429,11859,37.5654385176408,126.976983237511
20211121,2호선,신답,746,801,1547,37.5699910562183,127.046820203556
20211121,2호선,신당,7876,8443,16319,37.5656540317328,127.019540574485
20211121,2호선,신대방,14832,14734,29566,37.4875759745635,126.913175585996
20211121,2호선,신도림,28342,28508,56850,37.5087701449787,126.891080501385
20211121,2호선,신림,36161,35602,71763,37.4841196518392,126.928712092948
20211121,2호선,신설동,2865,2921,5786,37.5762451837487,127.023278761358
20211121,2호선,신정네거리,5209,5279,10488,37.5197975266787,126.852991645059
20211121,2호선,신촌,24444,23090,47534,37.5554417865984,126.936119192554
20211121,2호선,아현,5049,5038,10087,37.5573575723061,126.95603374504
20211121,2호선,양천구청,3258,3388,6646,37.5126989358446,126.866065211751
20211121,2호선,역삼,11573,12742,24315,37.5007162693593,127.036618203089
20211121,2호선,영등포구청,8861,9061,17922,37.5256996614804,126.896626898379
20211121,2호선,왕십리,9799,8691,18490,37.5612217415191,127.036655378283
20211121,2호선,용답,1590,1635,3225,37.5620049052662,127.050729309179
20211121,2호선,용두,1087,1121,2208,37.5739380503267,127.038031119837
20211121,2호선,을지로3가,8620,8068,16688,37.56626594615,126.990308356253
20211121,2호선,을지로4가,3282,3143,6425,37.5666369941572,126.997852780281
20211121,2호선,을지로입구,15969,14902,30871,37.5660509513873,126.982372901787
20211121,2호선,이대,7154,7700,14854,37.5567980142044,126.945758201019
20211121,2호선,잠실,47623,45380,93003,37.513859279255,127.101857941447
20211121,2호선,잠실나루,5170,5344,10514,37.5206867318088,127.103811089444
20211121,2호선,잠실새내,10751,10983,21734,37.5115672093323,127.086373867207
20211121,2호선,종합운동장,6861,7523,14384,37.5109692748993,127.073356018706
20211121,2호선,충정로,4029,4324,8353,37.5598377952439,126.964474043785
20211121,2호선,한양대,2417,2681,5098,37.55557788354,127.043584493543
20211121,2호선,합정,21008,22295,43303,37.5501152068908,126.914638180431
20211121,2호선,홍대입구,49496,48657,98153,37.5577458058734,126.926498328277
20211127,2호선,강남,62641,65972,128613,37.4981646510326,127.028307900881
20211127,2호선,강변,27767,28060,55827,37.5351692767888,127.094664569096
20211127,2호선,건대입구,34602,38491,73093,37.5404188872176,127.069173281554
20211127,2호선,교대,17853,20345,38198,37.4928178646055,127.013838469407
20211127,2호선,구로디지털단지,34434,33904,68338,37.4853149237865,126.901494378412
20211127,2호선,구의,16411,15860,32271,37.5371535596228,127.086179228767
20211127,2호선,낙성대,21509,19122,40631,37.4770651843603,126.963409959152
20211127,2호선,당산,13028,14199,27227,37.534956866618,126.90273071003
20211127,2호선,대림,17159,18193,35352,37.4933105886136,126.8949461878
20211127,2호선,도림천,808,818,1626,37.5144420510515,126.882702584468
20211127,2호선,동대문역사문화공원,11637,12691,24328,37.5655895229776,127.009131498424
20211127,2호선,뚝섬,13999,14060,28059,37.5471882244091,127.047365178682
20211127,2호선,문래,12264,13056,25320,37.5179214637526,126.894763060556
20211127,2호선,방배,10928,11154,22082,37.4814364876589,126.997694899327
20211127,2호선,봉천,16885,15148,32033,37.4825562153548,126.941495272047
20211127,2호선,사당,32089,36139,68228,37.4765228347619,126.981408909449
20211127,2호선,삼성,34818,35158,69976,37.5088619974404,127.063073009788
20211127,2호선,상왕십리,9989,9187,19176,37.5644687111181,127.029031221392
20211127,2호선,서울대입구,38552,36848,75400,37.4811526631844,126.952645104944
20211127,2호선,서초,11924,9944,21868,37.4918229990093,127.007580814715
20211127,2호선,선릉,25012,22366,47378,37.5045028775835,127.048942471228
20211127,2호선,성수,19175,21850,41025,37.5445023983984,127.056090471223
20211127,2호선,시청,9862,8703,18565,37.5654385176408,126.976983237511
20211127,2호선,신답,973,1071,2044,37.5699910562183,127.046820203556
20211127,2호선,신당,10877,11420,22297,37.5656540317328,127.019540574485
20211127,2호선,신대방,19947,18832,38779,37.4875759745635,126.913175585996
20211127,2호선,신도림,41001,41582,82583,37.5087701449787,126.891080501385
20211127,2호선,신림,50133,47392,97525,37.4841196518392,126.928712092948
20211127,2호선,신설동,3429,3393,6822,37.5762451837487,127.023278761358
20211127,2호선,신정네거리,7320,7276,14596,37.5197975266787,126.852991645059
20211127,2호선,신촌,31283,31813,63096,37.5554417865984,126.936119192554
20211127,2호선,아현,7610,7055,14665,37.5573575723061,126.95603374504
20211127,2호선,양천구청,4533,4622,9155,37.5126989358446,126.866065211751
20211127,2호선,역삼,18902,20410,39312,37.5007162693593,127.036618203089
20211127,2호선,영등포구청,13600,14000,27600,37.5256996614804,126.896626898379
20211127,2호선,왕십리,14819,12542,27361,37.5612217415191,127.036655378283
20211127,2호선,용답,2256,2026,4282,37.5620049052662,127.050729309179
20211127,2호선,용두,1692,1648,3340,37.5739380503267,127.038031119837
20211127,2호선,을지로3가,11743,11877,23620,37.56626594615,126.990308356253
20211127,2호선,을지로4가,7267,7755,15022,37.5666369941572,126.997852780281
20211127,2호선,을지로입구,22413,22345,44758,37.5660509513873,126.982372901787
20211127,2호선,이대,12950,12981,25931,37.5567980142044,126.945758201019
20211127,2호선,잠실,65625,63482,129107,37.513859279255,127.101857941447
20211127,2호선,잠실나루,7925,7701,15626,37.5206867318088,127.103811089444
20211127,2호선,잠실새내,16553,17028,33581,37.5115672093323,127.086373867207
20211127,2호선,종합운동장,6644,7283,13927,37.5109692748993,127.073356018706
20211127,2호선,충정로,5762,5979,11741,37.5598377952439,126.964474043785
20211127,2호선,한양대,12383,12380,24763,37.55557788354,127.043584493543
20211127,2호선,합정,28711,32463,61174,37.5501152068908,126.914638180431
20211127,2호선,홍대입구,63451,71886,135337,37.5577458058734,126.926498328277
20211128,2호선,강남,36019,35870,71889,37.4981646510326,127.028307900881
20211128,2호선,강변,22894,22458,45352,37.5351692767888,127.094664569096
20211128,2호선,건대입구,26604,27916,54520,37.5404188872176,127.069173281554
20211128,2호선,교대,10646,11902,22548,37.4928178646055,127.013838469407
20211128,2호선,구로디지털단지,23582,23295,46877,37.4853149237865,126.901494378412
20211128,2호선,구의,11724,11787,23511,37.5371535596228,127.086179228767
20211128,2호선,낙성대,15759,16081,31840,37.4770651843603,126.963409959152
20211128,2호선,당산,8971,9586,18557,37.534956866618,126.90273071003
20211128,2호선,대림,14607,14722,29329,37.4933105886136,126.8949461878
20211128,2호선,도림천,470,501,971,37.5144420510515,126.882702584468
20211128,2호선,동대문역사문화공원,8062,9872,17934,37.5655895229776,127.009131498424
20211128,2호선,뚝섬,10068,10042,20110,37.5471882244091,127.047365178682
20211128,2호선,문래,7875,8420,16295,37.5179214637526,126.894763060556
20211128,2호선,방배,6750,7238,13988,37.4814364876589,126.997694899327
20211128,2호선,봉천,11955,11618,23573,37.4825562153548,126.941495272047
20211128,2호선,사당,21829,24966,46795,37.4765228347619,126.981408909449
20211128,2호선,삼성,23342,22836,46178,37.5088619974404,127.063073009788
20211128,2호선,상왕십리,6950,6760,13710,37.5644687111181,127.029031221392
20211128,2호선,서울대입구,27304,27949,55253,37.4811526631844,126.952645104944
20211128,2호선,서초,11176,10212,21388,37.4918229990093,127.007580814715
20211128,2호선,선릉,13886,11879,25765,37.5045028775835,127.048942471228
20211128,2호선,성수,13490,14901,28391,37.5445023983984,127.056090471223
20211128,2호선,시청,6608,5596,12204,37.5654385176408,126.976983237511
20211128,2호선,신답,739,774,1513,37.5699910562183,127.046820203556
20211128,2호선,신당,8250,8821,17071,37.5656540317328,127.019540574485
20211128,2호선,신대방,14922,14696,29618,37.4875759745635,126.913175585996
20211128,2호선,신도림,28921,29233,58154,37.5087701449787,126.891080501385
20211128,2호선,신림,36960,36087,73047,37.4841196518392,126.928712092948
20211128,2호선,신설동,2941,3154,6095,37.5762451837487,127.023278761358
20211128,2호선,신정네거리,5156,5329,10485,37.5197975266787,126.852991645059
20211128,2호선,신촌,22568,21605,44173,37.5554417865984,126.936119192554
20211128,2호선,아현,5148,5231,10379,37.5573575723061,126.95603374504
20211128,2호선,양천구청,3284,3316,6600,37.5126989358446,126.866065211751
20211128,2호선,역삼,11780,12975,24755,37.5007162693593,127.036618203089
20211128,2호선,영등포구청,8661,8886,17547,37.5256996614804,126.896626898379
20211128,2호선,왕십리,10323,9025,19348,37.5612217415191,127.036655378283
20211128,2호선,용답,1643,1719,3362,37.5620049052662,127.050729309179
20211128,2호선,용두,1082,1073,2155,37.5739380503267,127.038031119837
20211128,2호선,을지로3가,8389,7817,16206,37.56626594615,126.990308356253
20211128,2호선,을지로4가,3401,3352,6753,37.5666369941572,126.997852780281
20211128,2호선,을지로입구,16694,15408,32102,37.5660509513873,126.982372901787
20211128,2호선,이대,8852,9055,17907,37.5567980142044,126.945758201019
20211128,2호선,잠실,49546,47343,96889,37.513859279255,127.101857941447
20211128,2호선,잠실나루,5598,5707,11305,37.5206867318088,127.103811089444
20211128,2호선,잠실새내,11799,11996,23795,37.5115672093323,127.086373867207
20211128,2호선,종합운동장,9030,9855,18885,37.5109692748993,127.073356018706
20211128,2호선,충정로,3882,4093,7975,37.5598377952439,126.964474043785
20211128,2호선,한양대,12222,12102,24324,37.55557788354,127.043584493543
20211128,2호선,합정,20714,22149,42863,37.5501152068908,126.914638180431
20211128,2호선,홍대입구,48702,48609,97311,37.5577458058734,126.926498328277
20211204,2호선,강남,58404,60898,119302,37.4981646510326,127.028307900881
20211204,2호선,강변,25170,24965,50135,37.5351692767888,127.094664569096
20211204,2호선,건대입구,31462,34816,66278,37.5404188872176,127.069173281554
20211204,2호선,교대,16999,19050,36049,37.4928178646055,127.013838469407
20211204,2호선,구로디지털단지,33488,32550,66038,37.4853149237865,126.901494378412
20211204,2호선,구의,15882,15457,31339,37.5371535596228,127.086179228767
20211204,2호선,낙성대,19995,18336,38331,37.4770651843603,126.963409959152
20211204,2호선,당산,12169,13113,25282,37.534956866618,126.90273071003
20211204,2호선,대림,16528,17527,34055,37.4933105886136,126.8949461878
20211204,2호선,도림천,752,768,1520,37.5144420510515,126.882702584468
20211204,2호선,동대문역사문화공원,9852,10937,20789,37.5655895229776,127.009131498424
20211204,2호선,뚝섬,14051,13943,27994,37.5471882244091,127.047365178682
20211204,2호선,문래,12130,12698,24828,37.5179214637526,126.894763060556
20211204,2호선,방배,9784,10081,19865,37.4814364876589,126.997694899327
20211204,2호선,봉천,16675,14936,31611,37.4825562153548,126.941495272047
20211204,2호선,사당,30324,33482,63806,37.4765228347619,126.981408909449
20211204,2호선,삼성,28058,28277,56335,37.5088619974404,127.063073009788
20211204,2호선,상왕십리,9526,8728,18254,37.5644687111181,127.029031221392
20211204,2호선,서울대입구,36092,34443,70535,37.4811526631844,126.952645104944
20211204,2호선,서초,10097,8664,18761,37.4918229990093,127.007580814715
20211204,2호선,선릉,24113,21141,45254,37.5045028775835,127.048942471228
20211204,2호선,성수,17791,19903,37694,37.5445023983984,127.056090471223
20211204,2호선,시청,8868,7748,16616,37.5654385176408,126.976983237511
20211204,2호선,신답,947,968,1915,37.5699910562183,127.046820203556
20211204,2호선,신당,10374,10974,21348,37.5656540317328,127.019540574485
20211204,2호선,신대방,19112,18191,37303,37.4875759745635,126.913175585996
20211204,2호선,신도림,38708,39086,77794,37.5087701449787,126.891080501385
20211204,2호선,신림,48772,46136,94908,37.4841196518392,126.928712092948
20211204,2호선,신설동,3102,3134,6236,37.5762451837487,127.023278761358
20211204,2호선,신정네거리,7197,7215,14412,37.5197975266787,126.852991645059
20211204,2호선,신촌,28419,28973,57392,37.5554417865984,126.936119192554
20211204,2호선,아현,7013,6610,13623,37.5573575723061,126.95603374504
20211204,2호선,양천구청,4500,4450,8950,37.5126989358446,126.866065211751
20211204,2호선,역삼,18463,20148,38611,37.5007162693593,127.036618203089
20211204,2호선,영등포구청,13002,13324,26326,37.5256996614804,126.896626898379
20211204,2호선,왕십리,13056,11386,24442,37.5612217415191,127.036655378283
20211204,2호선,용답,1979,1873,3852,37.5620049052662,127.050729309179
20211204,2호선,용두,1614,1571,3185,37.5739380503267,127.038031119837
20211204,2호선,을지로3가,10801,10831,21632,37.56626594615,126.990308356253
20211204,2호선,을지로4가,6737,6977,13714,37.5666369941572,126.997852780281
20211204,2호선,을지로입구,22043,21585,43628,37.5660509513873,126.982372901787
20211204,2호선,이대,9797,10033,19830,37.5567980142044,126.945758201019
20211204,2호선,잠실,59837,57205,117042,37.513859279255,127.101857941447
20211204,2호선,잠실나루,7001,6766,13767,37.5206867318088,127.103811089444
20211204,2호선,잠실새내,15481,16299,31780,37.5115672093323,127.086373867207
20211204,2호선,종합운동장,4491,4970,9461,37.5109692748993,127.073356018706
20211204,2호선,충정로,5730,6114,11844,37.5598377952439,126.964474043785
20211204,2호선,한양대,4985,5157,10142,37.55557788354,127.043584493543
20211204,2호선,합정,26974,30580,57554,37.5501152068908,126.914638180431
20211204,2호선,홍대입구,56846,63681,120527,37.5577458058734,126.926498328277
20211205,2호선,강남,32171,31549,63720,37.4981646510326,127.028307900881
20211205,2호선,강변,19483,18968,38451,37.5351692767888,127.094664569096
20211205,2호선,건대입구,23408,24585,47993,37.5404188872176,127.069173281554
20211205,2호선,교대,9664,10657,20321,37.4928178646055,127.013838469407
20211205,2호선,구로디지털단지,22857,22499,45356,37.4853149237865,126.901494378412
20211205,2호선,구의,10627,10605,21232,37.5371535596228,127.086179228767
20211205,2호선,낙성대,14572,14853,29425,37.4770651843603,126.963409959152
20211205,2호선,당산,8300,8957,17257,37.534956866618,126.90273071003
20211205,2호선,대림,13533,13617,27150,37.4933105886136,126.8949461878
20211205,2호선,도림천,426,458,884,37.5144420510515,126.882702584468
20211205,2호선,동대문역사문화공원,7436,8846,16282,37.5655895229776,127.009131498424
20211205,2호선,뚝섬,10364,10300,20664,37.5471882244091,127.047365178682
20211205,2호선,문래,7785,8213,15998,37.5179214637526,126.894763060556
20211205,2호선,방배,6324,6822,13146,37.4814364876589,126.997694899327
20211205,2호선,봉천,11403,11036,22439,37.4825562153548,126.941495272047
20211205,2호선,사당,20059,22629,42688,37.4765228347619,126.981408909449
20211205,2호선,삼성,20147,19461,39608,37.5088619974404,127.063073009788
20211205,2호선,상왕십리,6422,6392,12814,37.5644687111181,127.029031221392
20211205,2호선,서울대입구,25432,26077,51509,37.4811526631844,126.952645104944
20211205,2호선,서초,10298,9554,19852,37.4918229990093,127.007580814715
20211205,2호선,선릉,12601,10905,23506,37.5045028775835,127.048942471228
20211205,2호선,성수,12360,13445,25805,37.5445023983984,127.056090471223
20211205,2호선,시청,5934,4624,10558,37.5654385176408,126.976983237511
20211205,2호선,신답,707,751,1458,37.5699910562183,127.046820203556
20211205,2호선,신당,7457,8134,15591,37.5656540317328,127.019540574485
20211205,2호선,신대방,14025,13834,27859,37.4875759745635,126.913175585996
20211205,2호선,신도림,26845,27166,54011,37.5087701449787,126.891080501385
20211205,2호선,신림,34547,34211,68758,37.4841196518392,126.928712092948
20211205,2호선,신설동,2852,2940,5792,37.5762451837487,127.023278761358
20211205,2호선,신정네거리,4812,4841,9653,37.5197975266787,126.852991645059
20211205,2호선,신촌,20508,19859,40367,37.5554417865984,126.936119192554
20211205,2호선,아현,4917,4896,9813,37.5573575723061,126.95603374504
20211205,2호선,양천구청,3153,3165,6318,37.5126989358446,126.866065211751
20211205,2호선,역삼,10857,11869,22726,37.5007162693593,127.036618203089
20211205,2호선,영등포구청,8652,8887,17539,37.5256996614804,126.896626898379
20211205,2호선,왕십리,9066,7911,16977,37.5612217415191,127.036655378283
20211205,2호선,용답,1536,1583,3119,37.5620049052662,127.050729309179
20211205,2호선,용두,1168,1161,2329,37.5739380503267,127.038031119837
20211205,2호선,을지로3가,7636,7179,14815,37.56626594615,126.990308356253
20211205,2호선,을지로4가,3111,2996,6107,37.5666369941572,126.997852780281
20211205,2호선,을지로입구,16071,14541,30612,37.5660509513873,126.982372901787
20211205,2호선,이대,6571,6978,13549,37.5567980142044,126.945758201019
20211205,2호선,잠실,43381,40487,83868,37.513859279255,127.101857941447
20211205,2호선,잠실나루,4680,4737,9417,37.5206867318088,127.103811089444
20211205,2호선,잠실새내,9764,10202,19966,37.5115672093323,127.086373867207
20211205,2호선,종합운동장,3537,4203,7740,37.5109692748993,127.073356018706
20211205,2호선,충정로,3661,3842,7503,37.5598377952439,126.964474043785
20211205,2호선,한양대,2503,2790,5293,37.55557788354,127.043584493543
20211205,2호선,합정,19927,21346,41273,37.5501152068908,126.914638180431
20211205,2호선,홍대입구,42958,42457,85415,37.5577458058734,126.926498328277
20211211,2호선,강남,55516,57470,112986,37.4981646510326,127.028307900881
20211211,2호선,강변,24413,23991,48404,37.5351692767888,127.094664569096
20211211,2호선,건대입구,29670,32890,62560,37.5404188872176,127.069173281554
20211211,2호선,교대,15495,17775,33270,37.4928178646055,127.013838469407
20211211,2호선,구로디지털단지,32565,31871,64436,37.4853149237865,126.901494378412
20211211,2호선,구의,15549,15027,30576,37.5371535596228,127.086179228767
20211211,2호선,낙성대,19794,18174,37968,37.4770651843603,126.963409959152
20211211,2호선,당산,11809,13114,24923,37.534956866618,126.90273071003
20211211,2호선,대림,16626,17402,34028,37.4933105886136,126.8949461878
20211211,2호선,도림천,681,720,1401,37.5144420510515,126.882702584468
20211211,2호선,동대문역사문화공원,10095,11249,21344,37.5655895229776,127.009131498424
20211211,2호선,뚝섬,14157,14188,28345,37.5471882244091,127.047365178682
20211211,2호선,문래,11489,12275,23764,37.5179214637526,126.894763060556
20211211,2호선,방배,9443,9724,19167,37.4814364876589,126.997694899327
20211211,2호선,봉천,16003,14262,30265,37.4825562153548,126.941495272047
20211211,2호선,사당,28535,31885,60420,37.4765228347619,126.981408909449
20211211,2호선,삼성,30696,30856,61552,37.5088619974404,127.063073009788
20211211,2호선,상왕십리,9304,8550,17854,37.5644687111181,127.029031221392
20211211,2호선,서울대입구,36115,34304,70419,37.4811526631844,126.952645104944
20211211,2호선,서초,9982,8524,18506,37.4918229990093,127.007580814715
20211211,2호선,선릉,23201,20399,43600,37.5045028775835,127.048942471228
20211211,2호선,성수,17015,19689,36704,37.5445023983984,127.056090471223
20211211,2호선,시청,8328,7509,15837,37.5654385176408,126.976983237511
20211211,2호선,신답,911,1011,1922,37.5699910562183,127.046820203556
20211211,2호선,신당,10197,10764,20961,37.5656540317328,127.019540574485
20211211,2호선,신대방,18930,17674,36604,37.4875759745635,126.913175585996
20211211,2호선,신도림,37436,37861,75297,37.5087701449787,126.891080501385
20211211,2호선,신림,47801,45203,93004,37.4841196518392,126.928712092948
20211211,2호선,신설동,3040,3006,6046,37.5762451837487,127.023278761358
20211211,2호선,신정네거리,6712,6639,13351,37.5197975266787,126.852991645059
20211211,2호선,신촌,26888,27000,53888,37.5554417865984,126.936119192554
20211211,2호선,아현,6815,6389,13204,37.5573575723061,126.95603374504
20211211,2호선,양천구청,4003,4015,8018,37.5126989358446,126.866065211751
20211211,2호선,역삼,17302,18917,36219,37.5007162693593,127.036618203089
20211211,2호선,영등포구청,12860,13063,25923,37.5256996614804,126.896626898379
20211211,2호선,왕십리,12300,10981,23281,37.5612217415191,127.036655378283
20211211,2호선,용답,1908,1889,3797,37.5620049052662,127.050729309179
20211211,2호선,용두,1607,1574,3181,37.5739380503267,127.038031119837
20211211,2호선,을지로3가,10142,10463,20605,37.56626594615,126.990308356253
20211211,2호선,을지로4가,6879,7016,13895,37.5666369941572,126.997852780281
20211211,2호선,을지로입구,21690,21326,43016,37.5660509513873,126.982372901787
20211211,2호선,이대,8842,9272,18114,37.5567980142044,126.945758201019
20211211,2호선,잠실,57926,55816,113742,37.513859279255,127.101857941447
20211211,2호선,잠실나루,6843,6521,13364,37.5206867318088,127.103811089444
20211211,2호선,잠실새내,15043,15703,30746,37.5115672093323,127.086373867207
20211211,2호선,종합운동장,4224,4675,8899,37.5109692748993,127.073356018706
20211211,2호선,충정로,5406,5562,10968,37.5598377952439,126.964474043785
20211211,2호선,한양대,3820,3962,7782,37.55557788354,127.043584493543
20211211,2호선,합정,25547,28545,54092,37.5501152068908,126.914638180431
20211211,2호선,홍대입구,54580,60635,115215,37.5577458058734,126.926498328277
20211212,2호선,강남,32164,31683,63847,37.4981646510326,127.028307900881
20211212,2호선,강변,19058,18635,37693,37.5351692767888,127.094664569096
20211212,2호선,건대입구,22520,23439,45959,37.5404188872176,127.069173281554
20211212,2호선,교대,9481,10602,20083,37.4928178646055,127.013838469407
20211212,2호선,구로디지털단지,21822,21762,43584,37.4853149237865,126.901494378412
20211212,2호선,구의,10572,10823,21395,37.5371535596228,127.086179228767
20211212,2호선,낙성대,13996,14666,28662,37.4770651843603,126.963409959152
20211212,2호선,당산,7785,8671,16456,37.534956866618,126.90273071003
20211212,2호선,대림,13075,13285,26360,37.4933105886136,126.8949461878
20211212,2호선,도림천,458,497,955,37.5144420510515,126.882702584468
20211212,2호선,동대문역사문화공원,7426,9031,16457,37.5655895229776,127.009131498424
20211212,2호선,뚝섬,10816,10673,21489,37.5471882244091,127.047365178682
20211212,2호선,문래,7126,7601,14727,37.5179214637526,126.894763060556
20211212,2호선,방배,6168,6489,12657,37.4814364876589,126.997694899327
20211212,2호선,봉천,11400,11013,22413,37.4825562153548,126.941495272047
20211212,2호선,사당,19485,21705,41190,37.4765228347619,126.981408909449
20211212,2호선,삼성,23213,22600,45813,37.5088619974404,127.063073009788
20211212,2호선,상왕십리,6203,6391,12594,37.5644687111181,127.029031221392
20211212,2호선,서울대입구,25011,25899,50910,37.4811526631844,126.952645104944
20211212,2호선,서초,9905,9097,19002,37.4918229990093,127.007580814715
20211212,2호선,선릉,12816,11118,23934,37.5045028775835,127.048942471228
20211212,2호선,성수,12000,13076,25076,37.5445023983984,127.056090471223
20211212,2호선,시청,5574,4250,9824,37.5654385176408,126.976983237511
20211212,2호선,신답,675,732,1407,37.5699910562183,127.046820203556
20211212,2호선,신당,7415,8225,15640,37.5656540317328,127.019540574485
20211212,2호선,신대방,13756,13503,27259,37.4875759745635,126.913175585996
20211212,2호선,신도림,25333,25803,51136,37.5087701449787,126.891080501385
20211212,2호선,신림,34503,34420,68923,37.4841196518392,126.928712092948
20211212,2호선,신설동,2888,2887,5775,37.5762451837487,127.023278761358
20211212,2호선,신정네거리,4526,4724,9250,37.5197975266787,126.852991645059
20211212,2호선,신촌,19455,18461,37916,37.5554417865984,126.936119192554
20211212,2호선,아현,4579,4766,9345,37.5573575723061,126.95603374504
20211212,2호선,양천구청,2868,2969,5837,37.5126989358446,126.866065211751
20211212,2호선,역삼,11175,11986,23161,37.5007162693593,127.036618203089
20211212,2호선,영등포구청,8377,8435,16812,37.5256996614804,126.896626898379
20211212,2호선,왕십리,8848,7987,16835,37.5612217415191,127.036655378283
20211212,2호선,용답,1426,1476,2902,37.5620049052662,127.050729309179
20211212,2호선,용두,1007,1019,2026,37.5739380503267,127.038031119837
20211212,2호선,을지로3가,7371,7170,14541,37.56626594615,126.990308356253
20211212,2호선,을지로4가,2979,2916,5895,37.5666369941572,126.997852780281
20211212,2호선,을지로입구,15876,14499,30375,37.5660509513873,126.982372901787
20211212,2호선,이대,6302,6735,13037,37.5567980142044,126.945758201019
20211212,2호선,잠실,44408,41283,85691,37.513859279255,127.101857941447
20211212,2호선,잠실나루,4560,4653,9213,37.5206867318088,127.103811089444
20211212,2호선,잠실새내,9668,10046,19714,37.5115672093323,127.086373867207
20211212,2호선,종합운동장,4002,4228,8230,37.5109692748993,127.073356018706
20211212,2호선,충정로,3603,3870,7473,37.5598377952439,126.964474043785
20211212,2호선,한양대,2277,2589,4866,37.55557788354,127.043584493543
20211212,2호선,합정,18432,19355,37787,37.5501152068908,126.914638180431
20211212,2호선,홍대입구,41697,41043,82740,37.5577458058734,126.926498328277
20211218,2호선,강남,58475,54861,113336,37.4981646510326,127.028307900881
20211218,2호선,강변,24210,24566,48776,37.5351692767888,127.094664569096
20211218,2호선,건대입구,30754,31937,62691,37.5404188872176,127.069173281554
20211218,2호선,교대,15684,17449,33133,37.4928178646055,127.013838469407
20211218,2호선,구로디지털단지,31531,31507,63038,37.4853149237865,126.901494378412
20211218,2호선,구의,15255,15252,30507,37.5371535596228,127.086179228767
20211218,2호선,낙성대,19708,18671,38379,37.4770651843603,126.963409959152
20211218,2호선,당산,10923,12156,23079,37.534956866618,126.90273071003
20211218,2호선,대림,15620,16432,32052,37.4933105886136,126.8949461878
20211218,2호선,도림천,730,728,1458,37.5144420510515,126.882702584468
20211218,2호선,동대문역사문화공원,9331,10166,19497,37.5655895229776,127.009131498424
20211218,2호선,뚝섬,14157,14068,28225,37.5471882244091,127.047365178682
20211218,2호선,문래,11467,11815,23282,37.5179214637526,126.894763060556
20211218,2호선,방배,9198,9579,18777,37.4814364876589,126.997694899327
20211218,2호선,봉천,15353,14713,30066,37.4825562153548,126.941495272047
20211218,2호선,사당,26566,29142,55708,37.4765228347619,126.981408909449
20211218,2호선,삼성,33263,32312,65575,37.5088619974404,127.063073009788
20211218,2호선,상왕십리,9330,9095,18425,37.5644687111181,127.029031221392
20211218,2호선,서울대입구,34613,34267,68880,37.4811526631844,126.952645104944
20211218,2호선,서초,10322,8657,18979,37.4918229990093,127.007580814715
20211218,2호선,선릉,23041,19627,42668,37.5045028775835,127.048942471228
20211218,2호선,성수,17632,18280,35912,37.5445023983984,127.056090471223
20211218,2호선,시청,8781,6998,15779,37.5654385176408,126.976983237511
20211218,2호선,신답,862,1037,1899,37.5699910562183,127.046820203556
20211218,2호선,신당,9898,10714,20612,37.5656540317328,127.019540574485
20211218,2호선,신대방,18054,18058,36112,37.4875759745635,126.913175585996
20211218,2호선,신도림,37479,37437,74916,37.5087701449787,126.891080501385
20211218,2호선,신림,46263,45162,91425,37.4841196518392,126.928712092948
20211218,2호선,신설동,3036,2977,6013,37.5762451837487,127.023278761358
20211218,2호선,신정네거리,6592,6853,13445,37.5197975266787,126.852991645059
20211218,2호선,신촌,29979,28694,58673,37.5554417865984,126.936119192554
20211218,2호선,아현,6910,6858,13768,37.5573575723061,126.95603374504
20211218,2호선,양천구청,3894,4178,8072,37.5126989358446,126.866065211751
20211218,2호선,역삼,18907,19416,38323,37.5007162693593,127.036618203089
20211218,2호선,영등포구청,12545,12607,25152,37.5256996614804,126.896626898379
20211218,2호선,왕십리,12808,10859,23667,37.5612217415191,127.036655378283
20211218,2호선,용답,1820,1851,3671,37.5620049052662,127.050729309179
20211218,2호선,용두,1480,1487,2967,37.5739380503267,127.038031119837
20211218,2호선,을지로3가,10307,9747,20054,37.56626594615,126.990308356253
20211218,2호선,을지로4가,6318,6214,12532,37.5666369941572,126.997852780281
20211218,2호선,을지로입구,22917,21909,44826,37.5660509513873,126.982372901787
20211218,2호선,이대,9631,9971,19602,37.5567980142044,126.945758201019
20211218,2호선,잠실,61401,57946,119347,37.513859279255,127.101857941447
20211218,2호선,잠실나루,6933,6796,13729,37.5206867318088,127.103811089444
20211218,2호선,잠실새내,15647,15884,31531,37.5115672093323,127.086373867207
20211218,2호선,종합운동장,4990,5471,10461,37.5109692748993,127.073356018706
20211218,2호선,충정로,5508,5809,11317,37.5598377952439,126.964474043785
20211218,2호선,한양대,3948,3919,7867,37.55557788354,127.043584493543
20211218,2호선,합정,25133,26230,51363,37.5501152068908,126.914638180431
20211218,2호선,홍대입구,57138,57477,114615,37.5577458058734,126.926498328277
20211219,2호선,강남,33169,32132,65301,37.4981646510326,127.028307900881
20211219,2호선,강변,19317,19105,38422,37.5351692767888,127.094664569096
20211219,2호선,건대입구,24240,25115,49355,37.5404188872176,127.069173281554
20211219,2호선,교대,9672,10767,20439,37.4928178646055,127.013838469407
20211219,2호선,구로디지털단지,22462,22648,45110,37.4853149237865,126.901494378412
20211219,2호선,구의,10801,10907,21708,37.5371535596228,127.086179228767
20211219,2호선,낙성대,15021,15118,30139,37.4770651843603,126.963409959152
20211219,2호선,당산,7883,8753,16636,37.534956866618,126.90273071003
20211219,2호선,대림,12715,12808,25523,37.4933105886136,126.8949461878
20211219,2호선,도림천,428,434,862,37.5144420510515,126.882702584468
20211219,2호선,동대문역사문화공원,7251,8696,15947,37.5655895229776,127.009131498424
20211219,2호선,뚝섬,11079,10928,22007,37.5471882244091,127.047365178682
20211219,2호선,문래,7586,7901,15487,37.5179214637526,126.894763060556
20211219,2호선,방배,6514,6847,13361,37.4814364876589,126.997694899327
20211219,2호선,봉천,11186,10871,22057,37.4825562153548,126.941495272047
20211219,2호선,사당,19490,21753,41243,37.4765228347619,126.981408909449
20211219,2호선,삼성,22864,22445,45309,37.5088619974404,127.063073009788
20211219,2호선,상왕십리,6706,6613,13319,37.5644687111181,127.029031221392
20211219,2호선,서울대입구,25606,26307,51913,37.4811526631844,126.952645104944
20211219,2호선,서초,10425,9813,20238,37.4918229990093,127.007580814715
20211219,2호선,선릉,13206,11524,24730,37.5045028775835,127.048942471228
20211219,2호선,성수,12801,13829,26630,37.5445023983984,127.056090471223
20211219,2호선,시청,5725,4601,10326,37.5654385176408,126.976983237511
20211219,2호선,신답,671,746,1417,37.5699910562183,127.046820203556
20211219,2호선,신당,7349,7846,15195,37.5656540317328,127.019540574485
20211219,2호선,신대방,14251,13982,28233,37.4875759745635,126.913175585996
20211219,2호선,신도림,27456,27887,55343,37.5087701449787,126.891080501385
20211219,2호선,신림,35290,34804,70094,37.4841196518392,126.928712092948
20211219,2호선,신설동,2551,2717,5268,37.5762451837487,127.023278761358
20211219,2호선,신정네거리,4609,4773,9382,37.5197975266787,126.852991645059
20211219,2호선,신촌,20919,20267,41186,37.5554417865984,126.936119192554
20211219,2호선,아현,4695,4700,9395,37.5573575723061,126.95603374504
20211219,2호선,양천구청,2953,3136,6089,37.5126989358446,126.866065211751
20211219,2호선,역삼,11544,12388,23932,37.5007162693593,127.036618203089
20211219,2호선,영등포구청,8332,8838,17170,37.5256996614804,126.896626898379
20211219,2호선,왕십리,8986,8047,17033,37.5612217415191,127.036655378283
20211219,2호선,용답,1513,1552,3065,37.5620049052662,127.050729309179
20211219,2호선,용두,1060,1039,2099,37.5739380503267,127.038031119837
20211219,2호선,을지로3가,7746,7346,15092,37.56626594615,126.990308356253
20211219,2호선,을지로4가,3289,3031,6320,37.5666369941572,126.997852780281
20211219,2호선,을지로입구,17811,16212,34023,37.5660509513873,126.982372901787
20211219,2호선,이대,8677,8961,17638,37.5567980142044,126.945758201019
20211219,2호선,잠실,48123,45270,93393,37.513859279255,127.101857941447
20211219,2호선,잠실나루,5007,5129,10136,37.5206867318088,127.103811089444
20211219,2호선,잠실새내,10239,10546,20785,37.5115672093323,127.086373867207
20211219,2호선,종합운동장,4379,4749,9128,37.5109692748993,127.073356018706
20211219,2호선,충정로,3717,3986,7703,37.5598377952439,126.964474043785
20211219,2호선,한양대,2240,2429,4669,37.55557788354,127.043584493543
20211219,2호선,합정,18845,19633,38478,37.5501152068908,126.914638180431
20211219,2호선,홍대입구,44317,43782,88099,37.5577458058734,126.926498328277
20211225,2호선,강남,39794,38813,78607,37.4981646510326,127.028307900881
20211225,2호선,강변,20435,19992,40427,37.5351692767888,127.094664569096
20211225,2호선,건대입구,30161,31459,61620,37.5404188872176,127.069173281554
20211225,2호선,교대,9828,10847,20675,37.4928178646055,127.013838469407
20211225,2호선,구로디지털단지,25372,25162,50534,37.4853149237865,126.901494378412
20211225,2호선,구의,12338,12139,24477,37.5371535596228,127.086179228767
20211225,2호선,낙성대,15957,14952,30909,37.4770651843603,126.963409959152
20211225,2호선,당산,8206,9324,17530,37.534956866618,126.90273071003
20211225,2호선,대림,12770,13673,26443,37.4933105886136,126.8949461878
20211225,2호선,도림천,393,428,821,37.5144420510515,126.882702584468
20211225,2호선,동대문역사문화공원,9096,10626,19722,37.5655895229776,127.009131498424
20211225,2호선,뚝섬,9589,9671,19260,37.5471882244091,127.047365178682
20211225,2호선,문래,7951,8289,16240,37.5179214637526,126.894763060556
20211225,2호선,방배,6159,6545,12704,37.4814364876589,126.997694899327
20211225,2호선,봉천,12458,11664,24122,37.4825562153548,126.941495272047
20211225,2호선,사당,19937,21701,41638,37.4765228347619,126.981408909449
20211225,2호선,삼성,38331,36240,74571,37.5088619974404,127.063073009788
20211225,2호선,상왕십리,7495,7345,14840,37.5644687111181,127.029031221392
20211225,2호선,서울대입구,28375,27656,56031,37.4811526631844,126.952645104944
20211225,2호선,서초,8731,7737,16468,37.4918229990093,127.007580814715
20211225,2호선,선릉,14148,12562,26710,37.5045028775835,127.048942471228
20211225,2호선,성수,14682,16170,30852,37.5445023983984,127.056090471223
20211225,2호선,시청,10664,6222,16886,37.5654385176408,126.976983237511
20211225,2호선,신답,667,791,1458,37.5699910562183,127.046820203556
20211225,2호선,신당,8147,8752,16899,37.5656540317328,127.019540574485
20211225,2호선,신대방,15139,14713,29852,37.4875759745635,126.913175585996
20211225,2호선,신도림,27061,27853,54914,37.5087701449787,126.891080501385
20211225,2호선,신림,40232,38740,78972,37.4841196518392,126.928712092948
20211225,2호선,신설동,2738,2666,5404,37.5762451837487,127.023278761358
20211225,2호선,신정네거리,5180,5237,10417,37.5197975266787,126.852991645059
20211225,2호선,신촌,25813,25505,51318,37.5554417865984,126.936119192554
20211225,2호선,아현,5306,5416,10722,37.5573575723061,126.95603374504
20211225,2호선,양천구청,3109,3240,6349,37.5126989358446,126.866065211751
20211225,2호선,역삼,13151,14118,27269,37.5007162693593,127.036618203089
20211225,2호선,영등포구청,8277,8676,16953,37.5256996614804,126.896626898379
20211225,2호선,왕십리,10488,9372,19860,37.5612217415191,127.036655378283
20211225,2호선,용답,1744,1704,3448,37.5620049052662,127.050729309179
20211225,2호선,용두,1164,1207,2371,37.5739380503267,127.038031119837
20211225,2호선,을지로3가,12021,10889,22910,37.56626594615,126.990308356253
20211225,2호선,을지로4가,4928,4984,9912,37.5666369941572,126.997852780281
20211225,2호선,을지로입구,31788,26553,58341,37.5660509513873,126.982372901787
20211225,2호선,이대,7259,7841,15100,37.5567980142044,126.945758201019
20211225,2호선,잠실,68897,64657,133554,37.513859279255,127.101857941447
20211225,2호선,잠실나루,4979,4973,9952,37.5206867318088,127.103811089444
20211225,2호선,잠실새내,13203,14021,27224,37.5115672093323,127.086373867207
20211225,2호선,종합운동장,4123,4656,8779,37.5109692748993,127.073356018706
20211225,2호선,충정로,3683,3974,7657,37.5598377952439,126.964474043785
20211225,2호선,한양대,2076,2143,4219,37.55557788354,127.043584493543
20211225,2호선,합정,21250,22817,44067,37.5501152068908,126.914638180431
20211225,2호선,홍대입구,63119,64892,128011,37.5577458058734,126.926498328277
20211226,2호선,강남,29494,28184,57678,37.4981646510326,127.028307900881
20211226,2호선,강변,17393,16725,34118,37.5351692767888,127.094664569096
20211226,2호선,건대입구,21369,21862,43231,37.5404188872176,127.069173281554
20211226,2호선,교대,8147,9128,17275,37.4928178646055,127.013838469407
20211226,2호선,구로디지털단지,18975,18966,37941,37.4853149237865,126.901494378412
20211226,2호선,구의,9247,9525,18772,37.5371535596228,127.086179228767
20211226,2호선,낙성대,12413,13262,25675,37.4770651843603,126.963409959152
20211226,2호선,당산,6383,7068,13451,37.534956866618,126.90273071003
20211226,2호선,대림,10912,11172,22084,37.4933105886136,126.8949461878
20211226,2호선,도림천,316,353,669,37.5144420510515,126.882702584468
20211226,2호선,동대문역사문화공원,6487,7482,13969,37.5655895229776,127.009131498424
20211226,2호선,뚝섬,6751,6901,13652,37.5471882244091,127.047365178682
20211226,2호선,문래,5578,5846,11424,37.5179214637526,126.894763060556
20211226,2호선,방배,5448,5803,11251,37.4814364876589,126.997694899327
20211226,2호선,봉천,9834,9863,19697,37.4825562153548,126.941495272047
20211226,2호선,사당,16394,18302,34696,37.4765228347619,126.981408909449
20211226,2호선,삼성,27947,26454,54401,37.5088619974404,127.063073009788
20211226,2호선,상왕십리,5587,5663,11250,37.5644687111181,127.029031221392
20211226,2호선,서울대입구,21931,22637,44568,37.4811526631844,126.952645104944
20211226,2호선,서초,9269,8406,17675,37.4918229990093,127.007580814715
20211226,2호선,선릉,11172,9504,20676,37.5045028775835,127.048942471228
20211226,2호선,성수,10201,10824,21025,37.5445023983984,127.056090471223
20211226,2호선,시청,5397,3640,9037,37.5654385176408,126.976983237511
20211226,2호선,신답,518,614,1132,37.5699910562183,127.046820203556
20211226,2호선,신당,5978,6649,12627,37.5656540317328,127.019540574485
20211226,2호선,신대방,12040,12114,24154,37.4875759745635,126.913175585996
20211226,2호선,신도림,20976,21441,42417,37.5087701449787,126.891080501385
20211226,2호선,신림,31465,31055,62520,37.4841196518392,126.928712092948
20211226,2호선,신설동,2435,2542,4977,37.5762451837487,127.023278761358
20211226,2호선,신정네거리,3997,4137,8134,37.5197975266787,126.852991645059
20211226,2호선,신촌,18577,17784,36361,37.5554417865984,126.936119192554
20211226,2호선,아현,4067,4247,8314,37.5573575723061,126.95603374504
20211226,2호선,양천구청,2496,2625,5121,37.5126989358446,126.866065211751
20211226,2호선,역삼,10114,10621,20735,37.5007162693593,127.036618203089
20211226,2호선,영등포구청,6345,6528,12873,37.5256996614804,126.896626898379
20211226,2호선,왕십리,7932,7085,15017,37.5612217415191,127.036655378283
20211226,2호선,용답,1284,1413,2697,37.5620049052662,127.050729309179
20211226,2호선,용두,725,799,1524,37.5739380503267,127.038031119837
20211226,2호선,을지로3가,7197,6653,13850,37.56626594615,126.990308356253
20211226,2호선,을지로4가,2662,2305,4967,37.5666369941572,126.997852780281
20211226,2호선,을지로입구,16609,14939,31548,37.5660509513873,126.982372901787
20211226,2호선,이대,5838,6260,12098,37.5567980142044,126.945758201019
20211226,2호선,잠실,42732,40278,83010,37.513859279255,127.101857941447
20211226,2호선,잠실나루,3810,3943,7753,37.5206867318088,127.103811089444
20211226,2호선,잠실새내,9126,9530,18656,37.5115672093323,127.086373867207
20211226,2호선,종합운동장,2866,3267,6133,37.5109692748993,127.073356018706
20211226,2호선,충정로,2906,3165,6071,37.5598377952439,126.964474043785
20211226,2호선,한양대,1707,1909,3616,37.55557788354,127.043584493543
20211226,2호선,합정,16532,17063,33595,37.5501152068908,126.914638180431
20211226,2호선,홍대입구,41179,40204,81383,37.5577458058734,126.926498328277
