사용월,호선명,지하철역,승차총승객수,하차총승객수,승하차총승객수
202201,1호선,동대문,8844,8651,17495
202201,1호선,동묘앞,6324,6598,12922
202201,1호선,서울,40413,36361,76774
202201,1호선,시청,19725,19839,39564
202201,1호선,신설동,12680,12483,25163
202201,1호선,제기동,15506,15998,31504
202201,1호선,종각,33790,32789,66579
202201,1호선,종로3가,23162,21718,44880
202201,1호선,종로5가,20166,19926,40092
202201,1호선,청량리,17754,17906,35660
202201,1호선,동대문,10058,9421,19479
202201,1호선,동묘앞,6868,7110,13978
202201,1호선,서울,39092,36147,75239
202201,1호선,시청,21043,21137,42180
202201,1호선,신설동,12888,12612,25500
202201,1호선,제기동,16388,16850,33238
202201,1호선,종각,33848,32900,66748
202201,1호선,종로3가,23970,22267,46237
202201,1호선,종로5가,21139,20766,41905
202201,1호선,청량리,18462,18619,37081
202201,1호선,동대문,9999,9324,19323
202201,1호선,동묘앞,6762,7136,13898
202201,1호선,서울,38744,36262,75006
202201,1호선,시청,21174,21287,42461
202201,1호선,신설동,13140,12803,25943
202201,1호선,제기동,16043,16367,32410
202201,1호선,종각,33946,33241,67187
202201,1호선,종로3가,24322,22268,46590
202201,1호선,종로5가,21062,20595,41657
202201,1호선,청량리,18158,18070,36228
202201,1호선,동대문,10266,9601,19867
202201,1호선,동묘앞,6982,7278,14260
202201,1호선,서울,40340,38347,78687
202201,1호선,시청,21276,21242,42518
202201,1호선,신설동,13285,12895,26180
202201,1호선,제기동,17035,17370,34405
202201,1호선,종각,34091,33098,67189
202201,1호선,종로3가,24996,22827,47823
202201,1호선,종로5가,21472,21415,42887
202201,1호선,청량리,18919,18856,37775
202201,1호선,동대문,10577,9613,20190
202201,1호선,동묘앞,7400,7679,15079
202201,1호선,서울,43576,42324,85900
202201,1호선,시청,21016,21220,42236
202201,1호선,신설동,13673,13125,26798
202201,1호선,제기동,17405,17836,35241
202201,1호선,종각,34088,33298,67386
202201,1호선,종로3가,25665,23798,49463
202201,1호선,종로5가,22208,22010,44218
202201,1호선,청량리,19858,19994,39852
202201,1호선,동대문,10169,9667,19836
202201,1호선,동묘앞,6756,7002,13758
202201,1호선,서울,41049,39058,80107
202201,1호선,시청,20759,20958,41717
202201,1호선,신설동,13445,13034,26479
202201,1호선,제기동,17374,17838,35212
202201,1호선,종각,34149,32860,67009
202201,1호선,종로3가,24887,22972,47859
202201,1호선,종로5가,21434,21249,42683
202201,1호선,청량리,19105,19182,38287
202201,1호선,동대문,9740,9100,18840
202201,1호선,동묘앞,6097,6329,12426
202201,1호선,서울,41022,39000,80022
202201,1호선,시청,21594,21421,43015
202201,1호선,신설동,12847,12527,25374
202201,1호선,제기동,15156,15468,30624
202201,1호선,종각,34616,33532,68148
202201,1호선,종로3가,23828,21952,45780
202201,1호선,종로5가,21316,20888,42204
202201,1호선,청량리,17880,17908,35788
202201,1호선,동대문,9894,9059,18953
202201,1호선,동묘앞,5976,6169,12145
202201,1호선,서울,40827,38656,79483
202201,1호선,시청,21425,21176,42601
202201,1호선,신설동,12914,12586,25500
202201,1호선,제기동,14907,15034,29941
202201,1호선,종각,34756,33411,68167
202201,1호선,종로3가,23112,21411,44523
202201,1호선,종로5가,20613,20381,40994
202201,1호선,청량리,17052,16862,33914
202201,1호선,동대문,9843,9082,18925
202201,1호선,동묘앞,6199,6529,12728
202201,1호선,서울,41730,39204,80934
202201,1호선,시청,21327,21565,42892
202201,1호선,신설동,13313,12895,26208
202201,1호선,제기동,15891,16088,31979
202201,1호선,종각,34704,33454,68158
202201,1호선,종로3가,23658,21882,45540
202201,1호선,종로5가,21386,21057,42443
202201,1호선,청량리,17950,18129,36079
202201,1호선,동대문,10215,9507,19722
202201,1호선,동묘앞,6843,7135,13978
202201,1호선,서울,44956,43212,88168
202201,1호선,시청,21008,21187,42195
202201,1호선,신설동,13837,13340,27177
202201,1호선,제기동,17368,17602,34970
202201,1호선,종각,34432,32858,67290
202201,1호선,종로3가,24875,23082,47957
202201,1호선,종로5가,21969,21703,43672
202201,1호선,청량리,19577,19999,39576
202201,1호선,동대문,10235,9573,19808
202201,1호선,동묘앞,6486,6641,13127
202201,1호선,서울,41857,39516,81373
202201,1호선,시청,21072,21112,42184
202201,1호선,신설동,13535,13129,26664
202201,1호선,제기동,16940,17430,34370
202201,1호선,종각,35176,33692,68868
202201,1호선,종로3가,23959,22259,46218
202201,1호선,종로5가,21497,20975,42472
202201,1호선,청량리,18860,18814,37674
202201,1호선,동대문,10026,9379,19405
202201,1호선,동묘앞,6886,7125,14011
202201,1호선,서울,41563,39218,80781
202201,1호선,시청,22017,22175,44192
202201,1호선,신설동,13254,12908,26162
202201,1호선,제기동,17059,17386,34445
202201,1호선,종각,34898,33710,68608
202201,1호선,종로3가,23936,21806,45742
202201,1호선,종로5가,21331,21065,42396
202201,1호선,청량리,19069,19169,38238
202201,1호선,동대문,10185,9373,19558
202201,1호선,동묘앞,5813,6394,12207
202201,1호선,서울,43713,40739,84452
202201,1호선,시청,22757,22640,45397
202201,1호선,신설동,13758,13386,27144
202201,1호선,제기동,15643,15705,31348
202201,1호선,종각,36458,34681,71139
202201,1호선,종로3가,23900,21803,45703
202201,1호선,종로5가,21523,20787,42310
202201,1호선,청량리,17724,18086,35810
202201,1호선,동대문,10441,9353,19794
202201,1호선,동묘앞,7247,7631,14878
202201,1호선,서울,43402,41037,84439
202201,1호선,시청,22125,22266,44391
202201,1호선,신설동,13742,13361,27103
202201,1호선,제기동,17689,18394,36083
202201,1호선,종각,35826,34909,70735
202201,1호선,종로3가,25062,22768,47830
202201,1호선,종로5가,22152,22033,44185
202201,1호선,청량리,20370,20097,40467
202201,1호선,동대문,11068,10066,21134
202201,1호선,동묘앞,7810,8186,15996
202201,1호선,서울,46637,44427,91064
202201,1호선,시청,22081,22228,44309
202201,1호선,신설동,14300,13665,27965
202201,1호선,제기동,19997,20638,40635
202201,1호선,종각,36003,34974,70977
202201,1호선,종로3가,26719,24562,51281
202201,1호선,종로5가,23292,22980,46272
202201,1호선,청량리,21669,21812,43481
202201,1호선,동대문,10477,9794,20271
202201,1호선,동묘앞,7115,7417,14532
202201,1호선,서울,41306,39822,81128
202201,1호선,시청,21013,21267,42280
202201,1호선,신설동,13549,13040,26589
202201,1호선,제기동,19915,20683,40598
202201,1호선,종각,34229,33503,67732
202201,1호선,종로3가,24867,22725,47592
202201,1호선,종로5가,21737,21575,43312
202201,1호선,청량리,20846,21012,41858
202201,1호선,동대문,10203,9494,19697
202201,1호선,동묘앞,6342,6640,12982
202201,1호선,서울,41537,39739,81276
202201,1호선,시청,22124,22099,44223
202201,1호선,신설동,13446,13092,26538
202201,1호선,제기동,18781,19241,38022
202201,1호선,종각,34558,33662,68220
202201,1호선,종로3가,24710,22412,47122
202201,1호선,종로5가,22005,21675,43680
202201,1호선,청량리,20098,20142,40240
202201,1호선,동대문,10782,9880,20662
202201,1호선,동묘앞,7813,8166,15979
202201,1호선,서울,42167,41207,83374
202201,1호선,시청,22733,22803,45536
202201,1호선,신설동,14042,13539,27581
202201,1호선,제기동,20506,21250,41756
202201,1호선,종각,35346,34368,69714
202201,1호선,종로3가,25502,23461,48963
202201,1호선,종로5가,22828,22386,45214
202201,1호선,청량리,21722,22121,43843
202201,1호선,동대문,10541,9703,20244
202201,1호선,동묘앞,7534,7763,15297
202201,1호선,서울,40907,44780,85687
202201,1호선,시청,21888,21799,43687
202201,1호선,신설동,13602,13058,26660
202201,1호선,제기동,19563,20404,39967
202201,1호선,종각,34149,33315,67464
202201,1호선,종로3가,24453,22290,46743
202201,1호선,종로5가,22600,21405,44005
202201,1호선,청량리,20872,21268,42140
202201,1호선,동대문,10582,9624,20206
202201,1호선,동묘앞,7723,7949,15672
202201,1호선,서울,38242,39895,78137
202201,1호선,시청,19955,20181,40136
202201,1호선,신설동,13659,12886,26545
202201,1호선,제기동,19090,19678,38768
202201,1호선,종각,31832,30911,62743
202201,1호선,종로3가,24404,22454,46858
202201,1호선,종로5가,23053,21716,44769
202201,1호선,청량리,21027,21465,42492
202201,1호선,동대문,6744,6720,13464
202201,1호선,동묘앞,6014,6136,12150
202201,1호선,서울,15649,16857,32506
202201,1호선,시청,4315,4155,8470
202201,1호선,신설동,4267,3770,8037
202201,1호선,제기동,7217,7169,14386
202201,1호선,종각,7447,6393,13840
202201,1호선,종로3가,8629,7556,16185
202201,1호선,종로5가,6658,6303,12961
202201,1호선,청량리,9670,10051,19721
202202,1호선,동대문,5813,5304,11117
202202,1호선,동묘앞,3082,3500,6582
202202,1호선,서울,16407,14010,30417
202202,1호선,시청,3743,3740,7483
202202,1호선,신설동,3126,3237,6363
202202,1호선,제기동,3458,3693,7151
202202,1호선,종각,7295,6513,13808
202202,1호선,종로3가,6012,5363,11375
202202,1호선,종로5가,3389,3142,6531
202202,1호선,청량리,6194,6306,12500
202202,1호선,동대문,5875,5428,11303
202202,1호선,동묘앞,5716,6138,11854
202202,1호선,서울,19614,15617,35231
202202,1호선,시청,5463,5437,10900
202202,1호선,신설동,4381,4819,9200
202202,1호선,제기동,5266,5764,11030
202202,1호선,종각,9460,8673,18133
202202,1호선,종로3가,10190,9097,19287
202202,1호선,종로5가,6412,6474,12886
202202,1호선,청량리,8259,8385,16644
202202,1호선,동대문,8433,8191,16624
202202,1호선,동묘앞,6253,6630,12883
202202,1호선,서울,40979,32120,73099
202202,1호선,시청,18621,18945,37566
202202,1호선,신설동,11718,11721,23439
202202,1호선,제기동,13138,13361,26499
202202,1호선,종각,28418,27821,56239
202202,1호선,종로3가,21582,20138,41720
202202,1호선,종로5가,19561,19651,39212
202202,1호선,청량리,15691,15706,31397
202202,1호선,동대문,9723,8884,18607
202202,1호선,동묘앞,6658,7054,13712
202202,1호선,서울,39412,35770,75182
202202,1호선,시청,19724,19912,39636
202202,1호선,신설동,12654,12366,25020
202202,1호선,제기동,14132,14326,28458
202202,1호선,종각,30369,29494,59863
202202,1호선,종로3가,23615,22179,45794
202202,1호선,종로5가,21502,21115,42617
202202,1호선,청량리,16692,16750,33442
202202,1호선,동대문,9510,8983,18493
202202,1호선,동묘앞,6524,6950,13474
202202,1호선,서울,37914,36091,74005
202202,1호선,시청,20241,20422,40663
202202,1호선,신설동,13051,12717,25768
202202,1호선,제기동,15013,15221,30234
202202,1호선,종각,32283,31701,63984
202202,1호선,종로3가,22857,21276,44133
202202,1호선,종로5가,20565,20554,41119
202202,1호선,청량리,17660,17491,35151
202202,1호선,동대문,9815,8977,18792
202202,1호선,동묘앞,7185,7389,14574
202202,1호선,서울,38004,35865,73869
202202,1호선,시청,20754,20986,41740
202202,1호선,신설동,12760,12527,25287
202202,1호선,제기동,15944,16194,32138
202202,1호선,종각,32313,31758,64071
202202,1호선,종로3가,23444,21501,44945
202202,1호선,종로5가,21626,21278,42904
202202,1호선,청량리,18061,18076,36137
202202,1호선,동대문,9908,9132,19040
202202,1호선,동묘앞,7348,7491,14839
202202,1호선,서울,38756,36031,74787
202202,1호선,시청,21132,21446,42578
202202,1호선,신설동,13339,13000,26339
202202,1호선,제기동,15979,16256,32235
202202,1호선,종각,32742,32205,64947
202202,1호선,종로3가,24002,21924,45926
202202,1호선,종로5가,20849,20647,41496
202202,1호선,청량리,18412,18307,36719
202202,1호선,동대문,9818,9130,18948
202202,1호선,동묘앞,6957,7271,14228
202202,1호선,서울,38849,36875,75724
202202,1호선,시청,20919,21339,42258
202202,1호선,신설동,13261,12981,26242
202202,1호선,제기동,16315,16369,32684
202202,1호선,종각,31926,31261,63187
202202,1호선,종로3가,23631,21759,45390
202202,1호선,종로5가,21142,20939,42081
202202,1호선,청량리,18451,18420,36871
202202,1호선,동대문,10400,9513,19913
202202,1호선,동묘앞,7135,7397,14532
202202,1호선,서울,42390,40709,83099
202202,1호선,시청,20307,20842,41149
202202,1호선,신설동,13936,13376,27312
202202,1호선,제기동,16387,16673,33060
202202,1호선,종각,31765,30900,62665
202202,1호선,종로3가,24998,23043,48041
202202,1호선,종로5가,21710,21776,43486
202202,1호선,청량리,19246,19344,38590
202202,1호선,동대문,9746,9166,18912
202202,1호선,동묘앞,6217,6505,12722
202202,1호선,서울,38551,37346,75897
202202,1호선,시청,19787,20335,40122
202202,1호선,신설동,13023,12930,25953
202202,1호선,제기동,15516,15567,31083
202202,1호선,종각,31755,30760,62515
202202,1호선,종로3가,22677,21188,43865
202202,1호선,종로5가,20692,20170,40862
202202,1호선,청량리,18270,18221,36491
202202,1호선,동대문,9724,8933,18657
202202,1호선,동묘앞,6006,6331,12337
202202,1호선,서울,37878,35755,73633
202202,1호선,시청,21803,21945,43748
202202,1호선,신설동,12655,12434,25089
202202,1호선,제기동,14133,14482,28615
202202,1호선,종각,32639,31849,64488
202202,1호선,종로3가,22148,20516,42664
202202,1호선,종로5가,20638,20219,40857
202202,1호선,청량리,17467,17104,34571
202202,1호선,동대문,9149,8620,17769
202202,1호선,동묘앞,5702,6011,11713
202202,1호선,서울,37631,35674,73305
202202,1호선,시청,20616,20948,41564
202202,1호선,신설동,12633,12379,25012
202202,1호선,제기동,13505,13392,26897
202202,1호선,종각,31581,30571,62152
202202,1호선,종로3가,21177,19675,40852
202202,1호선,종로5가,19702,19361,39063
202202,1호선,청량리,16253,16283,32536
202202,1호선,동대문,9389,8704,18093
202202,1호선,동묘앞,5995,6220,12215
202202,1호선,서울,37548,35823,73371
202202,1호선,시청,20034,20242,40276
202202,1호선,신설동,12559,12316,24875
202202,1호선,제기동,13645,13676,27321
202202,1호선,종각,30827,30022,60849
202202,1호선,종로3가,21485,19944,41429
202202,1호선,종로5가,19833,19655,39488
202202,1호선,청량리,16772,16543,33315
202202,1호선,동대문,9967,9127,19094
202202,1호선,동묘앞,7033,7310,14343
202202,1호선,서울,41323,39749,81072
202202,1호선,시청,19717,20247,39964
202202,1호선,신설동,13219,12864,26083
202202,1호선,제기동,15603,15727,31330
202202,1호선,종각,30834,29832,60666
202202,1호선,종로3가,24092,22175,46267
202202,1호선,종로5가,20951,20774,41725
202202,1호선,청량리,18698,18761,37459
202202,1호선,동대문,9408,9006,18414
202202,1호선,동묘앞,5979,6286,12265
202202,1호선,서울,37553,36039,73592
202202,1호선,시청,19281,19453,38734
202202,1호선,신설동,12592,12360,24952
202202,1호선,제기동,14798,15091,29889
202202,1호선,종각,30447,29514,59961
202202,1호선,종로3가,22017,20250,42267
202202,1호선,종로5가,20321,19222,39543
202202,1호선,청량리,17422,17620,35042
202202,1호선,동대문,9552,8926,18478
202202,1호선,동묘앞,6033,6571,12604
202202,1호선,서울,37054,35325,72379
202202,1호선,시청,20259,20377,40636
202202,1호선,신설동,12214,11992,24206
202202,1호선,제기동,14557,14695,29252
202202,1호선,종각,30255,29544,59799
202202,1호선,종로3가,21815,20056,41871
202202,1호선,종로5가,20274,20064,40338
202202,1호선,청량리,17344,17412,34756
202202,1호선,동대문,9497,8868,18365
202202,1호선,동묘앞,5953,6296,12249
202202,1호선,서울,37127,35236,72363
202202,1호선,시청,20290,20409,40699
202202,1호선,신설동,12480,12257,24737
202202,1호선,제기동,14352,14292,28644
202202,1호선,종각,30684,29634,60318
202202,1호선,종로3가,21239,19509,40748
202202,1호선,종로5가,19701,19394,39095
202202,1호선,청량리,16795,16840,33635
202202,1호선,동대문,9556,8859,18415
202202,1호선,동묘앞,6531,6841,13372
202202,1호선,서울,37837,35692,73529
202202,1호선,시청,20005,20204,40209
202202,1호선,신설동,12651,12414,25065
202202,1호선,제기동,15014,15319,30333
202202,1호선,종각,30155,29396,59551
202202,1호선,종로3가,22333,20489,42822
202202,1호선,종로5가,20479,19916,40395
202202,1호선,청량리,17450,17775,35225
202202,1호선,동대문,10233,9572,19805
202202,1호선,동묘앞,7198,7720,14918
202202,1호선,서울,41491,40496,81987
202202,1호선,시청,19899,20338,40237
202202,1호선,신설동,13337,12932,26269
202202,1호선,제기동,16181,16616,32797
202202,1호선,종각,30665,29559,60224
202202,1호선,종로3가,23849,21836,45685
202202,1호선,종로5가,21823,21594,43417
202202,1호선,청량리,19380,19483,38863
202202,1호선,동대문,10159,9709,19868
202202,1호선,동묘앞,7188,7339,14527
202202,1호선,서울,37038,34360,71398
202202,1호선,시청,17878,18388,36266
202202,1호선,신설동,12533,12300,24833
202202,1호선,제기동,15913,16250,32163
202202,1호선,종각,27981,27637,55618
202202,1호선,종로3가,23565,21630,45195
202202,1호선,종로5가,20531,20461,40992
202202,1호선,청량리,18473,18410,36883
202203,1호선,동대문,8153,7978,16131
202203,1호선,동묘앞,7106,7394,14500
202203,1호선,서울,20994,19468,40462
202203,1호선,시청,12439,12379,24818
202203,1호선,신설동,6374,6211,12585
202203,1호선,제기동,10733,11414,22147
202203,1호선,종각,15750,13544,29294
202203,1호선,종로3가,16349,14533,30882
202203,1호선,종로5가,14036,13472,27508
202203,1호선,청량리,13021,12958,25979
202203,1호선,동대문,10037,9347,19384
202203,1호선,동묘앞,7000,7349,14349
202203,1호선,서울,35974,34212,70186
202203,1호선,시청,20111,20187,40298
202203,1호선,신설동,13284,13035,26319
202203,1호선,제기동,15660,15915,31575
202203,1호선,종각,30162,29499,59661
202203,1호선,종로3가,21817,19803,41620
202203,1호선,종로5가,20566,20001,40567
202203,1호선,청량리,18246,18182,36428
202203,1호선,동대문,9897,9400,19297
202203,1호선,동묘앞,7314,7692,15006
202203,1호선,서울,35847,34633,70480
202203,1호선,시청,19914,19971,39885
202203,1호선,신설동,13047,12795,25842
202203,1호선,제기동,16041,16009,32050
202203,1호선,종각,31468,30836,62304
202203,1호선,종로3가,22398,20259,42657
202203,1호선,종로5가,20530,20199,40729
202203,1호선,청량리,18350,18397,36747
202203,1호선,동대문,9761,8911,18672
202203,1호선,동묘앞,6935,7403,14338
202203,1호선,서울,40023,38144,78167
202203,1호선,시청,19824,19714,39538
202203,1호선,신설동,13281,12971,26252
202203,1호선,제기동,14998,15113,30111
202203,1호선,종각,30186,29482,59668
202203,1호선,종로3가,22378,20647,43025
202203,1호선,종로5가,20378,20033,40411
202203,1호선,청량리,18005,18165,36170
202203,1호선,동대문,9882,9146,19028
202203,1호선,동묘앞,6492,6887,13379
202203,1호선,서울,35599,34253,69852
202203,1호선,시청,18881,19131,38012
202203,1호선,신설동,12760,12504,25264
202203,1호선,제기동,15194,15482,30676
202203,1호선,종각,29721,29183,58904
202203,1호선,종로3가,21986,20146,42132
202203,1호선,종로5가,19945,19901,39846
202203,1호선,청량리,17979,18021,36000
202203,1호선,동대문,10275,9580,19855
202203,1호선,동묘앞,7215,7617,14832
202203,1호선,서울,37193,35485,72678
202203,1호선,시청,27134,28043,55177
202203,1호선,신설동,12618,12464,25082
202203,1호선,제기동,15670,16026,31696
202203,1호선,종각,32567,31518,64085
202203,1호선,종로3가,23079,21367,44446
202203,1호선,종로5가,21276,21016,42292
202203,1호선,청량리,18749,18725,37474
202203,1호선,동대문,8223,8040,16263
202203,1호선,동묘앞,7668,8132,15800
202203,1호선,서울,17151,16519,33670
202203,1호선,시청,6860,6938,13798
202203,1호선,신설동,6888,6415,13303
202203,1호선,제기동,11165,11391,22556
202203,1호선,종각,12453,11279,23732
202203,1호선,종로3가,16041,14513,30554
202203,1호선,종로5가,13381,13338,26719
202203,1호선,청량리,13217,13311,26528
202203,1호선,동대문,9575,8890,18465
202203,1호선,동묘앞,6850,7163,14013
202203,1호선,서울,35453,34369,69822
202203,1호선,시청,19311,19104,38415
202203,1호선,신설동,12558,12402,24960
202203,1호선,제기동,14214,14392,28606
202203,1호선,종각,29050,28418,57468
202203,1호선,종로3가,21856,20128,41984
202203,1호선,종로5가,19594,19441,39035
202203,1호선,청량리,17347,17265,34612
202203,1호선,동대문,10036,9151,19187
202203,1호선,동묘앞,7824,8125,15949
202203,1호선,서울,39094,37789,76883
202203,1호선,시청,19268,19380,38648
202203,1호선,신설동,13091,12808,25899
202203,1호선,제기동,15802,15972,31774
202203,1호선,종각,29589,29151,58740
202203,1호선,종로3가,23442,21631,45073
202203,1호선,종로5가,20876,20700,41576
202203,1호선,청량리,18888,19012,37900
202203,1호선,동대문,9186,8709,17895
202203,1호선,동묘앞,5339,5594,10933
202203,1호선,서울,34426,33042,67468
202203,1호선,시청,18916,18773,37689
202203,1호선,신설동,12299,12054,24353
202203,1호선,제기동,13108,13205,26313
202203,1호선,종각,28726,28161,56887
202203,1호선,종로3가,19548,18284,37832
202203,1호선,종로5가,18731,18528,37259
202203,1호선,청량리,16120,15968,32088
202203,1호선,동대문,9754,9202,18956
202203,1호선,동묘앞,7646,7923,15569
202203,1호선,서울,34864,33272,68136
202203,1호선,시청,19279,19369,38648
202203,1호선,신설동,12565,12161,24726
202203,1호선,제기동,15904,16393,32297
202203,1호선,종각,29079,28525,57604
202203,1호선,종로3가,22064,20370,42434
202203,1호선,종로5가,20652,20400,41052
202203,1호선,청량리,18638,18134,36772
202203,1호선,동대문,9767,8999,18766
202203,1호선,동묘앞,7418,7668,15086
202203,1호선,서울,35130,33573,68703
202203,1호선,시청,19287,19449,38736
202203,1호선,신설동,12621,12433,25054
202203,1호선,제기동,15439,15800,31239
202203,1호선,종각,28749,28425,57174
202203,1호선,종로3가,22185,20198,42383
202203,1호선,종로5가,20073,19914,39987
202203,1호선,청량리,17547,17476,35023
202203,1호선,동대문,9401,8841,18242
202203,1호선,동묘앞,6999,7313,14312
202203,1호선,서울,35000,33191,68191
202203,1호선,시청,19082,19172,38254
202203,1호선,신설동,12677,12425,25102
202203,1호선,제기동,14994,15420,30414
202203,1호선,종각,29055,28218,57273
202203,1호선,종로3가,21224,19739,40963
202203,1호선,종로5가,19764,19409,39173
202203,1호선,청량리,17342,17334,34676
202203,1호선,동대문,9835,8950,18785
202203,1호선,동묘앞,6874,7516,14390
202203,1호선,서울,38907,38083,76990
202203,1호선,시청,18980,19371,38351
202203,1호선,신설동,12963,12584,25547
202203,1호선,제기동,14819,14866,29685
202203,1호선,종각,29468,28687,58155
202203,1호선,종로3가,21645,20341,41986
202203,1호선,종로5가,20277,20114,40391
202203,1호선,청량리,18003,17601,35604
202203,1호선,동대문,9677,9087,18764
202203,1호선,동묘앞,6911,7286,14197
202203,1호선,서울,35748,34264,70012
202203,1호선,시청,19074,19163,38237
202203,1호선,신설동,12654,12294,24948
202203,1호선,제기동,15581,16128,31709
202203,1호선,종각,28985,28398,57383
202203,1호선,종로3가,20936,19631,40567
202203,1호선,종로5가,20336,20046,40382
202203,1호선,청량리,17839,17641,35480
202203,1호선,동대문,9881,9111,18992
202203,1호선,동묘앞,7427,7892,15319
202203,1호선,서울,35208,33766,68974
202203,1호선,시청,19331,19517,38848
202203,1호선,신설동,12604,12277,24881
202203,1호선,제기동,15886,16163,32049
202203,1호선,종각,29389,28756,58145
202203,1호선,종로3가,21802,19938,41740
202203,1호선,종로5가,20822,20495,41317
202203,1호선,청량리,18348,18077,36425
202203,1호선,동대문,9738,8905,18643
202203,1호선,동묘앞,6728,7139,13867
202203,1호선,서울,34841,33672,68513
202203,1호선,시청,19755,19712,39467
202203,1호선,신설동,12934,12524,25458
202203,1호선,제기동,15156,15402,30558
202203,1호선,종각,29914,28877,58791
202203,1호선,종로3가,21093,19443,40536
202203,1호선,종로5가,19828,19783,39611
202203,1호선,청량리,17703,17456,35159
202203,1호선,동대문,9623,8946,18569
202203,1호선,동묘앞,6830,7222,14052
202203,1호선,서울,36679,35202,71881
202203,1호선,시청,20518,20281,40799
202203,1호선,신설동,12799,12465,25264
202203,1호선,제기동,15464,15884,31348
202203,1호선,종각,29672,28801,58473
202203,1호선,종로3가,21443,19786,41229
202203,1호선,종로5가,20324,20007,40331
202203,1호선,청량리,18090,17710,35800
202203,1호선,동대문,10329,9197,19526
202203,1호선,동묘앞,7559,8048,15607
202203,1호선,서울,41104,41346,82450
202203,1호선,시청,19905,20390,40295
202203,1호선,신설동,13506,12929,26435
202203,1호선,제기동,16243,16604,32847
202203,1호선,종각,31002,29242,60244
202203,1호선,종로3가,22837,21496,44333
202203,1호선,종로5가,21678,21554,43232
202203,1호선,청량리,19315,19401,38716
202203,1호선,동대문,10196,9446,19642
202203,1호선,동묘앞,7126,7541,14667
202203,1호선,서울,37708,36335,74043
202203,1호선,시청,19669,19809,39478
202203,1호선,신설동,12869,12569,25438
202203,1호선,제기동,16524,17031,33555
202203,1호선,종각,30214,29494,59708
202203,1호선,종로3가,22353,20317,42670
202203,1호선,종로5가,20827,20945,41772
202203,1호선,청량리,18720,18497,37217
202203,1호선,동대문,10204,9481,19685
202203,1호선,동묘앞,7921,8189,16110
202203,1호선,서울,36740,35596,72336
202203,1호선,시청,20580,20818,41398
202203,1호선,신설동,12849,12484,25333
202203,1호선,제기동,17062,17547,34609
202203,1호선,종각,30237,29737,59974
202203,1호선,종로3가,22602,20418,43020
202203,1호선,종로5가,21686,21424,43110
202203,1호선,청량리,19113,18996,38109
202203,1호선,동대문,9694,9044,18738
202203,1호선,동묘앞,6487,6837,13324
202203,1호선,서울,36714,35489,72203
202203,1호선,시청,20409,20659,41068
202203,1호선,신설동,12956,12775,25731
202203,1호선,제기동,15198,15640,30838
202203,1호선,종각,30848,29966,60814
202203,1호선,종로3가,21661,19682,41343
202203,1호선,종로5가,20613,20180,40793
202203,1호선,청량리,17755,17474,35229
202203,1호선,동대문,10216,9399,19615
202203,1호선,동묘앞,7818,8339,16157
202203,1호선,서울,37698,36841,74539
202203,1호선,시청,20126,20703,40829
202203,1호선,신설동,13167,12803,25970
202203,1호선,제기동,16410,16854,33264
202203,1호선,종각,30278,29527,59805
202203,1호선,종로3가,22938,21049,43987
202203,1호선,종로5가,21556,21270,42826
202203,1호선,청량리,18972,18820,37792
202204,1호선,동대문,10776,9652,20428
202204,1호선,동묘앞,8297,8644,16941
202204,1호선,서울,43089,43731,86820
202204,1호선,시청,20773,21177,41950
202204,1호선,신설동,13637,13185,26822
202204,1호선,제기동,17133,17426,34559
202204,1호선,종각,31866,30795,62661
202204,1호선,종로3가,24279,22331,46610
202204,1호선,종로5가,22217,22157,44374
202204,1호선,청량리,19844,19618,39462
202204,1호선,동대문,10189,9693,19882
202204,1호선,동묘앞,7412,7753,15165
202204,1호선,서울,39136,37312,76448
202204,1호선,시청,20788,20597,41385
202204,1호선,신설동,13260,13173,26433
202204,1호선,제기동,16651,17157,33808
202204,1호선,종각,31125,30741,61866
202204,1호선,종로3가,22588,20757,43345
202204,1호선,종로5가,21283,21355,42638
202204,1호선,청량리,19062,18819,37881
202204,1호선,동대문,10543,9724,20267
202204,1호선,동묘앞,7797,8125,15922
202204,1호선,서울,38512,37425,75937
202204,1호선,시청,21895,21825,43720
202204,1호선,신설동,13044,12791,25835
202204,1호선,제기동,17223,17507,34730
202204,1호선,종각,32121,31438,63559
202204,1호선,종로3가,23299,21360,44659
202204,1호선,종로5가,22152,21995,44147
202204,1호선,청량리,19367,18999,38366
202204,1호선,동대문,10441,9838,20279
202204,1호선,동묘앞,7881,8398,16279
202204,1호선,서울,38934,37846,76780
202204,1호선,시청,21854,22135,43989
202204,1호선,신설동,13589,13280,26869
202204,1호선,제기동,16886,17057,33943
202204,1호선,종각,32109,31388,63497
202204,1호선,종로3가,23789,21607,45396
202204,1호선,종로5가,21565,21739,43304
202204,1호선,청량리,19081,19041,38122
202204,1호선,동대문,10633,9921,20554
202204,1호선,동묘앞,8053,8431,16484
202204,1호선,서울,40672,39178,79850
202204,1호선,시청,21680,22129,43809
202204,1호선,신설동,13561,13229,26790
202204,1호선,제기동,17143,17384,34527
202204,1호선,종각,32486,31686,64172
202204,1호선,종로3가,23894,22044,45938
202204,1호선,종로5가,22201,22162,44363
202204,1호선,청량리,19668,19531,39199
202204,1호선,동대문,10828,9819,20647
202204,1호선,동묘앞,8476,8825,17301
202204,1호선,서울,45182,45468,90650
202204,1호선,시청,21934,22451,44385
202204,1호선,신설동,14096,13489,27585
202204,1호선,제기동,17671,17747,35418
202204,1호선,종각,32486,32460,64946
202204,1호선,종로3가,25503,23356,48859
202204,1호선,종로5가,22639,22759,45398
202204,1호선,청량리,20347,20253,40600
202204,1호선,동대문,10718,10028,20746
202204,1호선,동묘앞,7508,7802,15310
202204,1호선,서울,40811,39414,80225
202204,1호선,시청,21273,21609,42882
202204,1호선,신설동,13550,13159,26709
202204,1호선,제기동,16767,17254,34021
202204,1호선,종각,31970,31458,63428
202204,1호선,종로3가,23844,21452,45296
202204,1호선,종로5가,21860,21947,43807
202204,1호선,청량리,19353,18786,38139
202204,1호선,동대문,10597,9861,20458
202204,1호선,동묘앞,7618,8115,15733
202204,1호선,서울,40094,38562,78656
202204,1호선,시청,22164,22247,44411
202204,1호선,신설동,13353,13068,26421
202204,1호선,제기동,17130,17419,34549
202204,1호선,종각,33391,32587,65978
202204,1호선,종로3가,23683,21619,45302
202204,1호선,종로5가,22771,22235,45006
202204,1호선,청량리,19739,19332,39071
202204,1호선,동대문,10531,9788,20319
202204,1호선,동묘앞,6745,7192,13937
202204,1호선,서울,40496,39098,79594
202204,1호선,시청,21967,22742,44709
202204,1호선,신설동,13348,13236,26584
202204,1호선,제기동,15324,15375,30699
202204,1호선,종각,34012,32933,66945
202204,1호선,종로3가,24483,22707,47190
202204,1호선,종로5가,22076,21442,43518
202204,1호선,청량리,18288,17868,36156
202204,1호선,동대문,10529,10090,20619
202204,1호선,동묘앞,7460,7831,15291
202204,1호선,서울,41503,40369,81872
202204,1호선,시청,22527,22645,45172
202204,1호선,신설동,13729,13443,27172
202204,1호선,제기동,16818,17180,33998
202204,1호선,종각,33674,33025,66699
202204,1호선,종로3가,24054,21759,45813
202204,1호선,종로5가,22173,22123,44296
202204,1호선,청량리,19187,18912,38099
202204,1호선,동대문,11210,9977,21187
202204,1호선,동묘앞,8638,9057,17695
202204,1호선,서울,46888,46616,93504
202204,1호선,시청,22215,22793,45008
202204,1호선,신설동,14173,13906,28079
202204,1호선,제기동,18098,18464,36562
202204,1호선,종각,34175,33628,67803
202204,1호선,종로3가,26258,24349,50607
202204,1호선,종로5가,23487,23394,46881
202204,1호선,청량리,21332,21033,42365
202204,1호선,동대문,10763,10283,21046
202204,1호선,동묘앞,7593,7927,15520
202204,1호선,서울,42230,40071,82301
202204,1호선,시청,21645,21771,43416
202204,1호선,신설동,13645,13395,27040
202204,1호선,제기동,17398,17791,35189
202204,1호선,종각,33326,32917,66243
202204,1호선,종로3가,23829,21690,45519
202204,1호선,종로5가,21978,21965,43943
202204,1호선,청량리,20018,19649,39667
202204,1호선,동대문,10904,10274,21178
202204,1호선,동묘앞,8156,8431,16587
202204,1호선,서울,41853,40525,82378
202204,1호선,시청,22963,23441,46404
202204,1호선,신설동,13882,13615,27497
202204,1호선,제기동,18042,18455,36497
202204,1호선,종각,34293,33761,68054
202204,1호선,종로3가,24763,22355,47118
202204,1호선,종로5가,22966,22983,45949
202204,1호선,청량리,20141,19766,39907
202204,1호선,동대문,11231,10600,21831
202204,1호선,동묘앞,8450,8748,17198
202204,1호선,서울,42565,41248,83813
202204,1호선,시청,23391,23265,46656
202204,1호선,신설동,14105,13841,27946
202204,1호선,제기동,17771,18134,35905
202204,1호선,종각,34907,34433,69340
202204,1호선,종로3가,25294,23016,48310
202204,1호선,종로5가,22874,22938,45812
202204,1호선,청량리,20517,20034,40551
202204,1호선,동대문,11082,10505,21587
202204,1호선,동묘앞,8283,8639,16922
202204,1호선,서울,44195,43114,87309
202204,1호선,시청,23597,25100,48697
202204,1호선,신설동,14052,13765,27817
202204,1호선,제기동,17825,18052,35877
202204,1호선,종각,35016,34374,69390
202204,1호선,종로3가,25965,23867,49832
202204,1호선,종로5가,23177,23185,46362
202204,1호선,청량리,20770,20175,40945
202204,1호선,동대문,10928,9643,20571
202204,1호선,동묘앞,7520,7972,15492
202204,1호선,서울,48821,48438,97259
202204,1호선,시청,22611,23832,46443
202204,1호선,신설동,14414,13787,28201
202204,1호선,제기동,17011,17072,34083
202204,1호선,종각,34937,34797,69734
202204,1호선,종로3가,25306,23825,49131
202204,1호선,종로5가,22687,22655,45342
202204,1호선,청량리,20235,19868,40103
202204,1호선,동대문,10861,10447,21308
202204,1호선,동묘앞,7436,7809,15245
202204,1호선,서울,43225,41194,84419
202204,1호선,시청,22449,22688,45137
202204,1호선,신설동,13849,13648,27497
202204,1호선,제기동,17410,17894,35304
202204,1호선,종각,33955,33545,67500
202204,1호선,종로3가,24262,22181,46443
202204,1호선,종로5가,22046,22104,44150
202204,1호선,청량리,20184,19855,40039
202204,1호선,동대문,11219,10476,21695
202204,1호선,동묘앞,8130,8680,16810
202204,1호선,서울,42381,41142,83523
202204,1호선,시청,23658,23877,47535
202204,1호선,신설동,13931,13783,27714
202204,1호선,제기동,17711,17913,35624
202204,1호선,종각,35305,34994,70299
202204,1호선,종로3가,25090,22982,48072
202204,1호선,종로5가,22922,22832,45754
202204,1호선,청량리,20382,20091,40473
202204,1호선,동대문,11298,10780,22078
202204,1호선,동묘앞,8576,8898,17474
202204,1호선,서울,44113,42814,86927
202204,1호선,시청,24331,24870,49201
202204,1호선,신설동,14489,14285,28774
202204,1호선,제기동,17989,18351,36340
202204,1호선,종각,36181,35822,72003
202204,1호선,종로3가,26612,23949,50561
202204,1호선,종로5가,23261,23483,46744
202204,1호선,청량리,20896,20700,41596
202204,1호선,동대문,11548,10870,22418
202204,1호선,동묘앞,8411,8911,17322
202204,1호선,서울,46191,44495,90686
202204,1호선,시청,24057,24502,48559
202204,1호선,신설동,14533,14189,28722
202204,1호선,제기동,17976,18384,36360
202204,1호선,종각,36749,36231,72980
202204,1호선,종로3가,26841,24207,51048
202204,1호선,종로5가,24233,24246,48479
202204,1호선,청량리,21378,20922,42300
202204,1호선,동대문,11585,10363,21948
202204,1호선,동묘앞,8364,8826,17190
202204,1호선,서울,52299,51354,103653
202204,1호선,시청,24144,24798,48942
202204,1호선,신설동,14941,14473,29414
202204,1호선,제기동,17526,17495,35021
202204,1호선,종각,37840,37622,75462
202204,1호선,종로3가,27685,25791,53476
202204,1호선,종로5가,24213,24475,48688
202204,1호선,청량리,21288,21089,42377
202205,1호선,동대문,11656,10962,22618
202205,1호선,동묘앞,8083,8483,16566
202205,1호선,서울,45673,43758,89431
202205,1호선,시청,23408,23673,47081
202205,1호선,신설동,14255,13997,28252
202205,1호선,제기동,18008,18507,36515
202205,1호선,종각,36817,36210,73027
202205,1호선,종로3가,25480,23165,48645
202205,1호선,종로5가,22917,22841,45758
202205,1호선,청량리,20887,20708,41595
202205,1호선,동대문,11928,11294,23222
202205,1호선,동묘앞,8561,8987,17548
202205,1호선,서울,45870,44727,90597
202205,1호선,시청,25077,25061,50138
202205,1호선,신설동,14516,14188,28704
202205,1호선,제기동,18558,19067,37625
202205,1호선,종각,38218,37531,75749
202205,1호선,종로3가,26656,24076,50732
202205,1호선,종로5가,23724,23827,47551
202205,1호선,청량리,21587,21235,42822
202205,1호선,동대문,12152,11686,23838
202205,1호선,동묘앞,8658,9185,17843
202205,1호선,서울,52571,53277,105848
202205,1호선,시청,25734,26222,51956
202205,1호선,신설동,15123,14522,29645
202205,1호선,제기동,18795,18833,37628
202205,1호선,종각,39812,39262,79074
202205,1호선,종로3가,28591,26215,54806
202205,1호선,종로5가,24653,24810,49463
202205,1호선,청량리,22469,21984,44453
202205,1호선,동대문,12065,12237,24302
202205,1호선,동묘앞,10707,10997,21704
202205,1호선,서울,30025,33845,63870
202205,1호선,시청,11447,11372,22819
202205,1호선,신설동,8146,7642,15788
202205,1호선,제기동,14421,15039,29460
202205,1호선,종각,19703,16928,36631
202205,1호선,종로3가,22327,19653,41980
202205,1호선,종로5가,19567,19213,38780
202205,1호선,청량리,17256,17404,34660
202205,1호선,동대문,12405,11325,23730
202205,1호선,동묘앞,8728,9074,17802
202205,1호선,서울,46752,49960,96712
202205,1호선,시청,22315,22286,44601
202205,1호선,신설동,14106,13425,27531
202205,1호선,제기동,17293,17737,35030
202205,1호선,종각,34085,32666,66751
202205,1호선,종로3가,28097,25720,53817
202205,1호선,종로5가,24716,24499,49215
202205,1호선,청량리,21493,21508,43001
202205,1호선,동대문,11542,10841,22383
202205,1호선,동묘앞,7920,8308,16228
202205,1호선,서울,49727,44700,94427
202205,1호선,시청,23955,24233,48188
202205,1호선,신설동,14252,14175,28427
202205,1호선,제기동,17311,17976,35287
202205,1호선,종각,36885,36258,73143
202205,1호선,종로3가,26127,24010,50137
202205,1호선,종로5가,23599,23521,47120
202205,1호선,청량리,20747,20350,41097
202205,1호선,동대문,11612,10904,22516
202205,1호선,동묘앞,8216,8821,17037
202205,1호선,서울,48574,46887,95461
202205,1호선,시청,25177,25080,50257
202205,1호선,신설동,14518,14025,28543
202205,1호선,제기동,17805,18010,35815
202205,1호선,종각,38366,37819,76185
202205,1호선,종로3가,26942,24331,51273
202205,1호선,종로5가,23572,23441,47013
202205,1호선,청량리,21761,20939,42700
202205,1호선,동대문,11803,11071,22874
202205,1호선,동묘앞,8553,9186,17739
202205,1호선,서울,47203,45505,92708
202205,1호선,시청,25501,25925,51426
202205,1호선,신설동,14807,14442,29249
202205,1호선,제기동,18062,18412,36474
202205,1호선,종각,38959,38270,77229
202205,1호선,종로3가,27776,24969,52745
202205,1호선,종로5가,24615,24512,49127
202205,1호선,청량리,21685,20960,42645
202205,1호선,동대문,11576,10958,22534
202205,1호선,동묘앞,8626,9052,17678
202205,1호선,서울,49050,47408,96458
202205,1호선,시청,25542,26184,51726
202205,1호선,신설동,14884,14541,29425
202205,1호선,제기동,18312,18663,36975
202205,1호선,종각,38943,38342,77285
202205,1호선,종로3가,28000,25395,53395
202205,1호선,종로5가,24924,25101,50025
202205,1호선,청량리,21545,21314,42859
202205,1호선,동대문,12014,10699,22713
202205,1호선,동묘앞,8837,9277,18114
202205,1호선,서울,54795,54091,108886
202205,1호선,시청,25954,27062,53016
202205,1호선,신설동,15322,14968,30290
202205,1호선,제기동,18225,18535,36760
202205,1호선,종각,40065,39947,80012
202205,1호선,종로3가,29662,27432,57094
202205,1호선,종로5가,25201,25790,50991
202205,1호선,청량리,22199,21980,44179
202205,1호선,동대문,11664,11157,22821
202205,1호선,동묘앞,8064,8422,16486
202205,1호선,서울,48277,46482,94759
202205,1호선,시청,24430,24510,48940
202205,1호선,신설동,14290,13926,28216
202205,1호선,제기동,17923,18458,36381
202205,1호선,종각,37722,36969,74691
202205,1호선,종로3가,27333,24377,51710
202205,1호선,종로5가,23979,23062,47041
202205,1호선,청량리,20996,20905,41901
202205,1호선,동대문,11548,11101,22649
202205,1호선,동묘앞,8443,8820,17263
202205,1호선,서울,47179,45823,93002
202205,1호선,시청,25334,25398,50732
202205,1호선,신설동,14433,14243,28676
202205,1호선,제기동,18480,18859,37339
202205,1호선,종각,37766,37016,74782
202205,1호선,종로3가,27499,24737,52236
202205,1호선,종로5가,24796,23392,48188
202205,1호선,청량리,21477,21220,42697
202205,1호선,동대문,11225,10706,21931
202205,1호선,동묘앞,7790,7914,15704
202205,1호선,서울,47049,45696,92745
202205,1호선,시청,25853,26322,52175
202205,1호선,신설동,14552,14221,28773
202205,1호선,제기동,17117,17314,34431
202205,1호선,종각,38526,38018,76544
202205,1호선,종로3가,26949,24083,51032
202205,1호선,종로5가,23904,23240,47144
202205,1호선,청량리,20626,20375,41001
202205,1호선,동대문,11449,10871,22320
202205,1호선,동묘앞,8468,8818,17286
202205,1호선,서울,49283,48314,97597
202205,1호선,시청,25640,25755,51395
202205,1호선,신설동,14698,14332,29030
202205,1호선,제기동,18547,18759,37306
202205,1호선,종각,39084,38652,77736
202205,1호선,종로3가,28272,25236,53508
202205,1호선,종로5가,24507,24409,48916
202205,1호선,청량리,21753,21702,43455
202205,1호선,동대문,12014,10815,22829
202205,1호선,동묘앞,8980,9466,18446
202205,1호선,서울,55250,54967,110217
202205,1호선,시청,26169,26690,52859
202205,1호선,신설동,15355,15034,30389
202205,1호선,제기동,18477,18514,36991
202205,1호선,종각,39714,39777,79491
202205,1호선,종로3가,29985,27749,57734
202205,1호선,종로5가,25717,25831,51548
202205,1호선,청량리,22742,22841,45583
202205,1호선,동대문,11415,10895,22310
202205,1호선,동묘앞,7997,8353,16350
202205,1호선,서울,47889,46597,94486
202205,1호선,시청,24186,24360,48546
202205,1호선,신설동,14394,14023,28417
202205,1호선,제기동,17468,17712,35180
202205,1호선,종각,37287,36422,73709
202205,1호선,종로3가,26042,23587,49629
202205,1호선,종로5가,23702,23562,47264
202205,1호선,청량리,20946,20629,41575
202205,1호선,동대문,11327,10764,22091
202205,1호선,동묘앞,8329,8715,17044
202205,1호선,서울,47761,45919,93680
202205,1호선,시청,25702,26158,51860
202205,1호선,신설동,14636,14239,28875
202205,1호선,제기동,17700,17913,35613
202205,1호선,종각,37742,37357,75099
202205,1호선,종로3가,26818,24481,51299
202205,1호선,종로5가,24565,24367,48932
202205,1호선,청량리,21197,20992,42189
202205,1호선,동대문,11732,10994,22726
202205,1호선,동묘앞,8700,9036,17736
202205,1호선,서울,48790,47082,95872
202205,1호선,시청,26242,26445,52687
202205,1호선,신설동,15024,14744,29768
202205,1호선,제기동,17983,18289,36272
202205,1호선,종각,40417,38603,79020
202205,1호선,종로3가,26899,24595,51494
202205,1호선,종로5가,25157,24807,49964
202205,1호선,청량리,21728,21521,43249
202205,1호선,동대문,11920,11150,23070
202205,1호선,동묘앞,8963,9317,18280
202205,1호선,서울,50053,48046,98099
202205,1호선,시청,25925,26529,52454
202205,1호선,신설동,15108,14738,29846
202205,1호선,제기동,18660,18610,37270
202205,1호선,종각,39347,38453,77800
202205,1호선,종로3가,28206,25240,53446
202205,1호선,종로5가,25284,25128,50412
202205,1호선,청량리,21604,21629,43233
202205,1호선,동대문,12180,10821,23001
202205,1호선,동묘앞,8992,9482,18474
202205,1호선,서울,57079,55250,112329
202205,1호선,시청,25949,26749,52698
202205,1호선,신설동,15431,15057,30488
202205,1호선,제기동,18277,18660,36937
202205,1호선,종각,39943,39535,79478
202205,1호선,종로3가,29898,27274,57172
202205,1호선,종로5가,25760,26091,51851
202205,1호선,청량리,22410,22420,44830
202205,1호선,동대문,11246,10806,22052
202205,1호선,동묘앞,7746,7902,15648
202205,1호선,서울,48112,46166,94278
202205,1호선,시청,21280,24142,45422
202205,1호선,신설동,14231,13815,28046
202205,1호선,제기동,17241,17582,34823
202205,1호선,종각,38213,37520,75733
202205,1호선,종로3가,25502,22892,48394
202205,1호선,종로5가,23335,23485,46820
202205,1호선,청량리,20091,20203,40294
202205,1호선,동대문,12020,11398,23418
202205,1호선,동묘앞,8770,9175,17945
202205,1호선,서울,49864,48244,98108
202205,1호선,시청,26014,26307,52321
202205,1호선,신설동,14745,14437,29182
202205,1호선,제기동,18554,18894,37448
202205,1호선,종각,40117,40193,80310
202205,1호선,종로3가,28428,25876,54304
202205,1호선,종로5가,26035,26143,52178
202205,1호선,청량리,22705,22452,45157
202206,1호선,동대문,10394,10390,20784
202206,1호선,동묘앞,9565,9909,19474
202206,1호선,서울,26040,25835,51875
202206,1호선,시청,10235,10086,20321
202206,1호선,신설동,8182,7806,15988
202206,1호선,제기동,14062,14635,28697
202206,1호선,종각,17948,15679,33627
202206,1호선,종로3가,21148,18271,39419
202206,1호선,종로5가,19108,18748,37856
202206,1호선,청량리,16081,16524,32605
202206,1호선,동대문,11251,10754,22005
202206,1호선,동묘앞,8358,8815,17173
202206,1호선,서울,47618,46920,94538
202206,1호선,시청,24949,25417,50366
202206,1호선,신설동,14522,14208,28730
202206,1호선,제기동,17684,17859,35543
202206,1호선,종각,37924,37450,75374
202206,1호선,종로3가,26535,24028,50563
202206,1호선,종로5가,24155,23994,48149
202206,1호선,청량리,20968,20930,41898
202206,1호선,동대문,11770,10500,22270
202206,1호선,동묘앞,8887,9068,17955
202206,1호선,서울,53042,55340,108382
202206,1호선,시청,25245,25818,51063
202206,1호선,신설동,15061,14364,29425
202206,1호선,제기동,17962,18342,36304
202206,1호선,종각,39350,38906,78256
202206,1호선,종로3가,28464,26557,55021
202206,1호선,종로5가,25609,25682,51291
202206,1호선,청량리,21689,21683,43372
202206,1호선,동대문,9613,9204,18817
202206,1호선,동묘앞,8022,8494,16516
202206,1호선,서울,33562,30937,64499
202206,1호선,시청,10353,8345,18698
202206,1호선,신설동,6871,6931,13802
202206,1호선,제기동,12630,13666,26296
202206,1호선,종각,14662,12235,26897
202206,1호선,종로3가,18097,15798,33895
202206,1호선,종로5가,16106,16174,32280
202206,1호선,청량리,14404,14777,29181
202206,1호선,동대문,11296,10862,22158
202206,1호선,동묘앞,8446,8829,17275
202206,1호선,서울,50399,46486,96885
202206,1호선,시청,25194,25304,50498
202206,1호선,신설동,14490,14175,28665
202206,1호선,제기동,18358,18782,37140
202206,1호선,종각,38432,37972,76404
202206,1호선,종로3가,27134,24553,51687
202206,1호선,종로5가,24228,24223,48451
202206,1호선,청량리,21219,21243,42462
202206,1호선,동대문,11470,10813,22283
202206,1호선,동묘앞,8536,8846,17382
202206,1호선,서울,47442,45883,93325
202206,1호선,시청,25713,25939,51652
202206,1호선,신설동,14554,14324,28878
202206,1호선,제기동,18177,18482,36659
202206,1호선,종각,39054,38638,77692
202206,1호선,종로3가,27379,24530,51909
202206,1호선,종로5가,24322,24408,48730
202206,1호선,청량리,21123,20881,42004
202206,1호선,동대문,11238,10641,21879
202206,1호선,동묘앞,7807,8147,15954
202206,1호선,서울,48521,46760,95281
202206,1호선,시청,25254,25677,50931
202206,1호선,신설동,14566,14083,28649
202206,1호선,제기동,17643,17832,35475
202206,1호선,종각,39050,38764,77814
202206,1호선,종로3가,27591,24955,52546
202206,1호선,종로5가,24409,24339,48748
202206,1호선,청량리,20945,20486,41431
202206,1호선,동대문,11689,10457,22146
202206,1호선,동묘앞,8507,8751,17258
202206,1호선,서울,54261,53081,107342
202206,1호선,시청,26084,26734,52818
202206,1호선,신설동,15301,14228,29529
202206,1호선,제기동,18117,18401,36518
202206,1호선,종각,39910,39654,79564
202206,1호선,종로3가,28758,26919,55677
202206,1호선,종로5가,25268,25241,50509
202206,1호선,청량리,21786,21564,43350
202206,1호선,동대문,11179,10794,21973
202206,1호선,동묘앞,7819,7993,15812
202206,1호선,서울,48140,44778,92918
202206,1호선,시청,23957,22242,46199
202206,1호선,신설동,14198,12936,27134
202206,1호선,제기동,17455,17599,35054
202206,1호선,종각,37732,34409,72141
202206,1호선,종로3가,26505,23891,50396
202206,1호선,종로5가,23452,22493,45945
202206,1호선,청량리,20221,19785,40006
202206,1호선,동대문,11506,10883,22389
202206,1호선,동묘앞,8289,8733,17022
202206,1호선,서울,47808,46245,94053
202206,1호선,시청,25152,25142,50294
202206,1호선,신설동,14264,13290,27554
202206,1호선,제기동,18352,18733,37085
202206,1호선,종각,38846,38203,77049
202206,1호선,종로3가,26825,24460,51285
202206,1호선,종로5가,24093,24164,48257
202206,1호선,청량리,21512,21475,42987
202206,1호선,동대문,11172,10520,21692
202206,1호선,동묘앞,6861,7125,13986
202206,1호선,서울,48013,46691,94704
202206,1호선,시청,25782,25848,51630
202206,1호선,신설동,14468,13313,27781
202206,1호선,제기동,16356,16452,32808
202206,1호선,종각,39068,38557,77625
202206,1호선,종로3가,26925,24609,51534
202206,1호선,종로5가,23471,23293,46764
202206,1호선,청량리,20004,19655,39659
202206,1호선,동대문,11556,11007,22563
202206,1호선,동묘앞,8719,9164,17883
202206,1호선,서울,50271,48951,99222
202206,1호선,시청,26216,26760,52976
202206,1호선,신설동,14845,13664,28509
202206,1호선,제기동,18652,18954,37606
202206,1호선,종각,40019,39674,79693
202206,1호선,종로3가,28409,25805,54214
202206,1호선,종로5가,24675,24981,49656
202206,1호선,청량리,21999,21801,43800
202206,1호선,동대문,11831,10658,22489
202206,1호선,동묘앞,9002,9309,18311
202206,1호선,서울,55480,55203,110683
202206,1호선,시청,25638,26189,51827
202206,1호선,신설동,15435,13987,29422
202206,1호선,제기동,18769,19031,37800
202206,1호선,종각,40480,40283,80763
202206,1호선,종로3가,29621,27365,56986
202206,1호선,종로5가,25120,25053,50173
202206,1호선,청량리,22430,22379,44809
202206,1호선,동대문,11584,11058,22642
202206,1호선,동묘앞,8297,8734,17031
202206,1호선,서울,49576,48118,97694
202206,1호선,시청,24632,25219,49851
202206,1호선,신설동,14412,13536,27948
202206,1호선,제기동,18345,18745,37090
202206,1호선,종각,38349,37741,76090
202206,1호선,종로3가,26868,24120,50988
202206,1호선,종로5가,23684,23953,47637
202206,1호선,청량리,20874,21023,41897
202206,1호선,동대문,11557,10734,22291
202206,1호선,동묘앞,8329,8528,16857
202206,1호선,서울,48594,47324,95918
202206,1호선,시청,25878,26065,51943
202206,1호선,신설동,14538,13927,28465
202206,1호선,제기동,17900,18292,36192
202206,1호선,종각,39741,39028,78769
202206,1호선,종로3가,27088,24735,51823
202206,1호선,종로5가,24736,24515,49251
202206,1호선,청량리,20952,21021,41973
202206,1호선,동대문,11535,10889,22424
202206,1호선,동묘앞,8626,8894,17520
202206,1호선,서울,49443,48383,97826
202206,1호선,시청,25705,26072,51777
202206,1호선,신설동,14629,14252,28881
202206,1호선,제기동,18601,18765,37366
202206,1호선,종각,40869,40548,81417
202206,1호선,종로3가,27930,25241,53171
202206,1호선,종로5가,25115,25206,50321
202206,1호선,청량리,20966,20982,41948
202206,1호선,동대문,10332,9788,20120
202206,1호선,동묘앞,6130,6462,12592
202206,1호선,서울,50409,48028,98437
202206,1호선,시청,25110,25719,50829
202206,1호선,신설동,13634,13629,27263
202206,1호선,제기동,15449,15716,31165
202206,1호선,종각,41326,39745,81071
202206,1호선,종로3가,23445,22423,45868
202206,1호선,종로5가,24143,23226,47369
202206,1호선,청량리,18418,18378,36796
202206,1호선,동대문,11663,10348,22011
202206,1호선,동묘앞,8520,8805,17325
202206,1호선,서울,55677,54538,110215
202206,1호선,시청,24778,25878,50656
202206,1호선,신설동,15148,14519,29667
202206,1호선,제기동,17733,17922,35655
202206,1호선,종각,40049,40404,80453
202206,1호선,종로3가,29210,27395,56605
202206,1호선,종로5가,25330,25727,51057
202206,1호선,청량리,21877,21656,43533
202206,1호선,동대문,10697,10215,20912
202206,1호선,동묘앞,6411,6792,13203
202206,1호선,서울,48415,47729,96144
202206,1호선,시청,23534,24448,47982
202206,1호선,신설동,13907,13513,27420
202206,1호선,제기동,16216,16461,32677
202206,1호선,종각,37766,37284,75050
202206,1호선,종로3가,24688,22491,47179
202206,1호선,종로5가,22794,22939,45733
202206,1호선,청량리,19068,19036,38104
202206,1호선,동대문,10621,9921,20542
202206,1호선,동묘앞,6812,7266,14078
202206,1호선,서울,48231,47227,95458
202206,1호선,시청,24583,24903,49486
202206,1호선,신설동,13747,13306,27053
202206,1호선,제기동,16250,16370,32620
202206,1호선,종각,38697,38025,76722
202206,1호선,종로3가,24977,22889,47866
202206,1호선,종로5가,23326,22994,46320
202206,1호선,청량리,19037,18836,37873
202206,1호선,동대문,10557,9977,20534
202206,1호선,동묘앞,6739,7059,13798
202206,1호선,서울,48258,46324,94582
202206,1호선,시청,25294,25090,50384
202206,1호선,신설동,13910,13635,27545
202206,1호선,제기동,15404,15447,30851
202206,1호선,종각,40295,39014,79309
202206,1호선,종로3가,24550,22601,47151
202206,1호선,종로5가,23236,23072,46308
202206,1호선,청량리,18578,18281,36859
202206,1호선,동대문,10463,9478,19941
202206,1호선,동묘앞,5655,6012,11667
202206,1호선,서울,48882,46503,95385
202206,1호선,시청,24220,24441,48661
202206,1호선,신설동,13537,13062,26599
202206,1호선,제기동,13911,13700,27611
202206,1호선,종각,38576,38282,76858
202206,1호선,종로3가,22328,20655,42983
202206,1호선,종로5가,22691,22333,45024
202206,1호선,청량리,17031,16793,33824
202207,1호선,동대문,12013,10593,22606
202207,1호선,동묘앞,9062,9335,18397
202207,1호선,서울,51298,54304,105602
202207,1호선,시청,25798,26720,52518
202207,1호선,신설동,15358,14550,29908
202207,1호선,제기동,18330,18625,36955
202207,1호선,종각,39956,39840,79796
202207,1호선,종로3가,28252,26092,54344
202207,1호선,종로5가,25748,26118,51866
202207,1호선,청량리,21619,21718,43337
202207,1호선,동대문,11145,10679,21824
202207,1호선,동묘앞,7504,7889,15393
202207,1호선,서울,47157,46887,94044
202207,1호선,시청,23939,24804,48743
202207,1호선,신설동,14370,13883,28253
202207,1호선,제기동,17095,17521,34616
202207,1호선,종각,38812,38361,77173
202207,1호선,종로3가,26642,24736,51378
202207,1호선,종로5가,23157,23254,46411
202207,1호선,청량리,20091,19949,40040
202207,1호선,동대문,11014,10507,21521
202207,1호선,동묘앞,7992,8247,16239
202207,1호선,서울,46491,45419,91910
202207,1호선,시청,25190,25600,50790
202207,1호선,신설동,14332,13960,28292
202207,1호선,제기동,17314,17480,34794
202207,1호선,종각,39391,38964,78355
202207,1호선,종로3가,26669,24600,51269
202207,1호선,종로5가,23391,23343,46734
202207,1호선,청량리,19886,19841,39727
202207,1호선,동대문,11469,10726,22195
202207,1호선,동묘앞,8388,8693,17081
202207,1호선,서울,47279,45824,93103
202207,1호선,시청,25214,25540,50754
202207,1호선,신설동,14465,14049,28514
202207,1호선,제기동,17595,17973,35568
202207,1호선,종각,41504,39785,81289
202207,1호선,종로3가,26723,25075,51798
202207,1호선,종로5가,24088,23618,47706
202207,1호선,청량리,20049,20142,40191
202207,1호선,동대문,10690,10067,20757
202207,1호선,동묘앞,7531,7842,15373
202207,1호선,서울,47343,46539,93882
202207,1호선,시청,25624,25939,51563
202207,1호선,신설동,14065,13753,27818
202207,1호선,제기동,16763,17075,33838
202207,1호선,종각,39889,39164,79053
202207,1호선,종로3가,26191,24293,50484
202207,1호선,종로5가,22880,22794,45674
202207,1호선,청량리,19487,19525,39012
202207,1호선,동대문,11418,9930,21348
202207,1호선,동묘앞,8251,8626,16877
202207,1호선,서울,53055,52623,105678
202207,1호선,시청,25408,25658,51066
202207,1호선,신설동,14755,14044,28799
202207,1호선,제기동,17661,17919,35580
202207,1호선,종각,40341,40323,80664
202207,1호선,종로3가,28695,27060,55755
202207,1호선,종로5가,23758,24263,48021
202207,1호선,청량리,20840,20906,41746
202207,1호선,동대문,11009,10566,21575
202207,1호선,동묘앞,7440,7673,15113
202207,1호선,서울,46309,45502,91811
202207,1호선,시청,23460,23939,47399
202207,1호선,신설동,14129,13681,27810
202207,1호선,제기동,16884,17249,34133
202207,1호선,종각,38293,37796,76089
202207,1호선,종로3가,26288,24204,50492
202207,1호선,종로5가,23018,22893,45911
202207,1호선,청량리,19615,19512,39127
202207,1호선,동대문,11382,10718,22100
202207,1호선,동묘앞,8225,8615,16840
202207,1호선,서울,46923,46024,92947
202207,1호선,시청,25155,25451,50606
202207,1호선,신설동,14246,14050,28296
202207,1호선,제기동,18130,18413,36543
202207,1호선,종각,39419,39011,78430
202207,1호선,종로3가,26951,24697,51648
202207,1호선,종로5가,24573,24549,49122
202207,1호선,청량리,20685,20896,41581
202207,1호선,동대문,9763,9233,18996
202207,1호선,동묘앞,5631,5962,11593
202207,1호선,서울,48276,45551,93827
202207,1호선,시청,24150,24239,48389
202207,1호선,신설동,13155,13048,26203
202207,1호선,제기동,13686,13512,27198
202207,1호선,종각,39552,38868,78420
202207,1호선,종로3가,22367,21122,43489
202207,1호선,종로5가,21593,21168,42761
202207,1호선,청량리,16803,16442,33245
202207,1호선,동대문,11336,10581,21917
202207,1호선,동묘앞,8495,8802,17297
202207,1호선,서울,48500,47714,96214
202207,1호선,시청,25208,25821,51029
202207,1호선,신설동,14307,13802,28109
202207,1호선,제기동,18710,19222,37932
202207,1호선,종각,40307,40154,80461
202207,1호선,종로3가,27697,25379,53076
202207,1호선,종로5가,24217,24282,48499
202207,1호선,청량리,21128,20934,42062
202207,1호선,동대문,11660,10420,22080
202207,1호선,동묘앞,8642,8942,17584
202207,1호선,서울,53146,52667,105813
202207,1호선,시청,24715,25463,50178
202207,1호선,신설동,15277,14613,29890
202207,1호선,제기동,19129,19637,38766
202207,1호선,종각,40764,40402,81166
202207,1호선,종로3가,28474,26574,55048
202207,1호선,종로5가,24476,24466,48942
202207,1호선,청량리,21901,21931,43832
202207,1호선,동대문,10974,10253,21227
202207,1호선,동묘앞,7426,7975,15401
202207,1호선,서울,46822,45348,92170
202207,1호선,시청,23220,23606,46826
202207,1호선,신설동,14107,13745,27852
202207,1호선,제기동,16824,16920,33744
202207,1호선,종각,38017,37878,75895
202207,1호선,종로3가,25979,24010,49989
202207,1호선,종로5가,22973,22777,45750
202207,1호선,청량리,19503,19236,38739
202207,1호선,동대문,11031,10377,21408
202207,1호선,동묘앞,7753,8167,15920
202207,1호선,서울,47044,45244,92288
202207,1호선,시청,24808,25201,50009
202207,1호선,신설동,14106,13694,27800
202207,1호선,제기동,16810,16969,33779
202207,1호선,종각,39144,38835,77979
202207,1호선,종로3가,26471,24237,50708
202207,1호선,종로5가,23585,23529,47114
202207,1호선,청량리,19784,19491,39275
202207,1호선,동대문,11302,10735,22037
202207,1호선,동묘앞,8017,8393,16410
202207,1호선,서울,48149,46822,94971
202207,1호선,시청,25469,26079,51548
202207,1호선,신설동,14218,14102,28320
202207,1호선,제기동,17152,17256,34408
202207,1호선,종각,40874,39934,80808
202207,1호선,종로3가,26587,24767,51354
202207,1호선,종로5가,24035,23644,47679
202207,1호선,청량리,20096,20031,40127
202207,1호선,동대문,10890,10143,21033
202207,1호선,동묘앞,7313,7656,14969
202207,1호선,서울,47832,46734,94566
202207,1호선,시청,24624,25402,50026
202207,1호선,신설동,13902,13459,27361
202207,1호선,제기동,16980,17036,34016
202207,1호선,종각,39127,39372,78499
202207,1호선,종로3가,26655,24492,51147
202207,1호선,종로5가,23296,23652,46948
202207,1호선,청량리,19900,19371,39271
202207,1호선,동대문,11479,10209,21688
202207,1호선,동묘앞,8020,8258,16278
202207,1호선,서울,53137,52368,105505
202207,1호선,시청,24428,25315,49743
202207,1호선,신설동,14451,14039,28490
202207,1호선,제기동,17285,17643,34928
202207,1호선,종각,40065,39956,80021
202207,1호선,종로3가,28175,26412,54587
202207,1호선,종로5가,24181,24154,48335
202207,1호선,청량리,21117,21008,42125
202207,1호선,동대문,10791,10578,21369
202207,1호선,동묘앞,7575,7862,15437
202207,1호선,서울,47357,45890,93247
202207,1호선,시청,22878,23486,46364
202207,1호선,신설동,13674,13441,27115
202207,1호선,제기동,17492,17862,35354
202207,1호선,종각,37963,37313,75276
202207,1호선,종로3가,26087,24172,50259
202207,1호선,종로5가,23312,23141,46453
202207,1호선,청량리,19826,19774,39600
202207,1호선,동대문,10877,10463,21340
202207,1호선,동묘앞,7106,7270,14376
202207,1호선,서울,46582,44443,91025
202207,1호선,시청,24549,25028,49577
202207,1호선,신설동,13509,13479,26988
202207,1호선,제기동,16883,17186,34069
202207,1호선,종각,38309,37681,75990
202207,1호선,종로3가,26076,23811,49887
202207,1호선,종로5가,23523,23436,46959
202207,1호선,청량리,20365,20470,40835
202207,1호선,동대문,10903,10347,21250
202207,1호선,동묘앞,7677,7975,15652
202207,1호선,서울,48224,46488,94712
202207,1호선,시청,24879,25515,50394
202207,1호선,신설동,13826,13629,27455
202207,1호선,제기동,16446,16614,33060
202207,1호선,종각,38668,38118,76786
202207,1호선,종로3가,26034,23841,49875
202207,1호선,종로5가,23441,23048,46489
202207,1호선,청량리,19216,19176,38392
202207,1호선,동대문,11213,10590,21803
202207,1호선,동묘앞,7445,7766,15211
202207,1호선,서울,48499,47581,96080
202207,1호선,시청,24179,24670,48849
202207,1호선,신설동,13604,13216,26820
202207,1호선,제기동,16520,16544,33064
202207,1호선,종각,38689,38118,76807
202207,1호선,종로3가,25805,23701,49506
202207,1호선,종로5가,23456,23356,46812
202207,1호선,청량리,19164,19377,38541
202207,1호선,동대문,11287,10124,21411
202207,1호선,동묘앞,7316,7514,14830
202207,1호선,서울,52759,53172,105931
202207,1호선,시청,23833,24476,48309
202207,1호선,신설동,14142,13553,27695
202207,1호선,제기동,16263,16198,32461
202207,1호선,종각,38828,38328,77156
202207,1호선,종로3가,25957,24498,50455
202207,1호선,종로5가,23537,23417,46954
202207,1호선,청량리,19619,19977,39596
202208,1호선,동대문,11640,10931,22571
202208,1호선,동묘앞,6776,7056,13832
202208,1호선,서울,47711,45432,93143
202208,1호선,시청,21830,22357,44187
202208,1호선,신설동,11936,11565,23501
202208,1호선,제기동,15315,15439,30754
202208,1호선,종각,35945,35727,71672
202208,1호선,종로3가,19983,18539,38522
202208,1호선,종로5가,18002,18063,36065
202208,1호선,청량리,17892,17792,35684
202208,1호선,동대문,10771,9997,20768
202208,1호선,동묘앞,5979,6224,12203
202208,1호선,서울,46815,43759,90574
202208,1호선,시청,23308,23317,46625
202208,1호선,신설동,11952,11657,23609
202208,1호선,제기동,15017,15413,30430
202208,1호선,종각,36981,35629,72610
202208,1호선,종로3가,19273,17958,37231
202208,1호선,종로5가,18290,17848,36138
202208,1호선,청량리,17870,17859,35729
202208,1호선,동대문,10404,9807,20211
202208,1호선,동묘앞,6424,6636,13060
202208,1호선,서울,46124,44255,90379
202208,1호선,시청,23034,23408,46442
202208,1호선,신설동,11920,11569,23489
202208,1호선,제기동,14692,14785,29477
202208,1호선,종각,37184,36840,74024
202208,1호선,종로3가,20688,19068,39756
202208,1호선,종로5가,17393,17459,34852
202208,1호선,청량리,17512,17334,34846
202208,1호선,동대문,11100,10569,21669
202208,1호선,동묘앞,7138,7395,14533
202208,1호선,서울,46776,45483,92259
202208,1호선,시청,23973,24448,48421
202208,1호선,신설동,12939,12636,25575
202208,1호선,제기동,16097,16429,32526
202208,1호선,종각,38662,37604,76266
202208,1호선,종로3가,25961,23869,49830
202208,1호선,종로5가,22640,22523,45163
202208,1호선,청량리,19211,19176,38387
202208,1호선,동대문,10918,9623,20541
202208,1호선,동묘앞,7276,7360,14636
202208,1호선,서울,49735,49242,98977
202208,1호선,시청,23395,23970,47365
202208,1호선,신설동,13283,12805,26088
202208,1호선,제기동,16291,16302,32593
202208,1호선,종각,38185,37503,75688
202208,1호선,종로3가,26170,24557,50727
202208,1호선,종로5가,23023,22976,45999
202208,1호선,청량리,19302,19398,38700
202208,1호선,동대문,7884,7275,15159
202208,1호선,동묘앞,4514,4901,9415
202208,1호선,서울,44544,43670,88214
202208,1호선,시청,20943,22866,43809
202208,1호선,신설동,11498,11892,23390
202208,1호선,제기동,13467,13714,27181
202208,1호선,종각,36092,36408,72500
202208,1호선,종로3가,21147,20913,42060
202208,1호선,종로5가,20208,20151,40359
202208,1호선,청량리,16351,16950,33301
202208,1호선,동대문,7269,6475,13744
202208,1호선,동묘앞,4205,4565,8770
202208,1호선,서울,42032,40050,82082
202208,1호선,시청,21602,21565,43167
202208,1호선,신설동,11045,11077,22122
202208,1호선,제기동,12203,12196,24399
202208,1호선,종각,34458,32557,67015
202208,1호선,종로3가,19594,18829,38423
202208,1호선,종로5가,19312,18485,37797
202208,1호선,청량리,15456,15455,30911
202208,1호선,동대문,8616,7880,16496
202208,1호선,동묘앞,6744,7081,13825
202208,1호선,서울,45329,44310,89639
202208,1호선,시청,23373,24044,47417
202208,1호선,신설동,13121,12741,25862
202208,1호선,제기동,16171,16622,32793
202208,1호선,종각,37574,36483,74057
202208,1호선,종로3가,25336,23458,48794
202208,1호선,종로5가,22845,22667,45512
202208,1호선,청량리,19103,19128,38231
202208,1호선,동대문,8632,7800,16432
202208,1호선,동묘앞,6442,6527,12969
202208,1호선,서울,45932,45132,91064
202208,1호선,시청,23105,23727,46832
202208,1호선,신설동,12718,12399,25117
202208,1호선,제기동,15707,15933,31640
202208,1호선,종각,37345,37044,74389
202208,1호선,종로3가,25195,23142,48337
202208,1호선,종로5가,21675,21838,43513
202208,1호선,청량리,18737,18626,37363
202208,1호선,동대문,9733,8860,18593
202208,1호선,동묘앞,8006,8159,16165
202208,1호선,서울,51661,53036,104697
202208,1호선,시청,23816,24257,48073
202208,1호선,신설동,13626,13004,26630
202208,1호선,제기동,17598,17864,35462
202208,1호선,종각,39001,38704,77705
202208,1호선,종로3가,27525,25653,53178
202208,1호선,종로5가,24241,24336,48577
202208,1호선,청량리,21099,21164,42263
202208,1호선,동대문,7840,8053,15893
202208,1호선,동묘앞,7302,7898,15200
202208,1호선,서울,32920,29633,62553
202208,1호선,시청,19918,19136,39054
202208,1호선,신설동,6500,6685,13185
202208,1호선,제기동,11834,12488,24322
202208,1호선,종각,18931,16095,35026
202208,1호선,종로3가,17198,15589,32787
202208,1호선,종로5가,15078,14474,29552
202208,1호선,청량리,13636,14305,27941
202208,1호선,동대문,10886,10419,21305
202208,1호선,동묘앞,7241,7644,14885
202208,1호선,서울,48749,44367,93116
202208,1호선,시청,22703,23176,45879
202208,1호선,신설동,12806,12638,25444
202208,1호선,제기동,16618,17021,33639
202208,1호선,종각,36681,36104,72785
202208,1호선,종로3가,25808,23847,49655
202208,1호선,종로5가,22540,22619,45159
202208,1호선,청량리,19435,19268,38703
202208,1호선,동대문,10971,10158,21129
202208,1호선,동묘앞,7377,7657,15034
202208,1호선,서울,48154,46350,94504
202208,1호선,시청,23927,24637,48564
202208,1호선,신설동,13788,13400,27188
202208,1호선,제기동,16795,17270,34065
202208,1호선,종각,38314,37549,75863
202208,1호선,종로3가,26253,23999,50252
202208,1호선,종로5가,23117,23313,46430
202208,1호선,청량리,19322,19276,38598
202208,1호선,동대문,10849,10079,20928
202208,1호선,동묘앞,7645,7852,15497
202208,1호선,서울,48506,46806,95312
202208,1호선,시청,24026,24738,48764
202208,1호선,신설동,13874,13499,27373
202208,1호선,제기동,17482,17945,35427
202208,1호선,종각,38727,38073,76800
202208,1호선,종로3가,26838,24437,51275
202208,1호선,종로5가,23249,23427,46676
202208,1호선,청량리,20372,19667,40039
202208,1호선,동대문,10683,9455,20138
202208,1호선,동묘앞,7102,7292,14394
202208,1호선,서울,52600,51610,104210
202208,1호선,시청,24165,24392,48557
202208,1호선,신설동,13890,13726,27616
202208,1호선,제기동,16795,17088,33883
202208,1호선,종각,38615,37725,76340
202208,1호선,종로3가,25597,24420,50017
202208,1호선,종로5가,24039,23393,47432
202208,1호선,청량리,19780,19914,39694
202208,1호선,동대문,10784,10111,20895
202208,1호선,동묘앞,7484,7838,15322
202208,1호선,서울,46390,45083,91473
202208,1호선,시청,22636,23381,46017
202208,1호선,신설동,13533,13250,26783
202208,1호선,제기동,17180,17839,35019
202208,1호선,종각,37521,36719,74240
202208,1호선,종로3가,25365,23195,48560
202208,1호선,종로5가,22568,22825,45393
202208,1호선,청량리,19767,19731,39498
202208,1호선,동대문,10946,10074,21020
202208,1호선,동묘앞,7963,8268,16231
202208,1호선,서울,46672,44148,90820
202208,1호선,시청,26097,26901,52998
202208,1호선,신설동,13664,13140,26804
202208,1호선,제기동,17665,17970,35635
202208,1호선,종각,37839,37299,75138
202208,1호선,종로3가,26083,23818,49901
202208,1호선,종로5가,23191,22876,46067
202208,1호선,청량리,20047,19865,39912
202208,1호선,동대문,10889,10360,21249
202208,1호선,동묘앞,8213,8479,16692
202208,1호선,서울,48101,45766,93867
202208,1호선,시청,24469,24814,49283
202208,1호선,신설동,14151,13693,27844
202208,1호선,제기동,18139,18492,36631
202208,1호선,종각,38327,37994,76321
202208,1호선,종로3가,26327,23712,50039
202208,1호선,종로5가,23106,23119,46225
202208,1호선,청량리,20183,19874,40057
202208,1호선,동대문,10776,10253,21029
202208,1호선,동묘앞,7317,7621,14938
202208,1호선,서울,48513,46600,95113
202208,1호선,시청,24614,24853,49467
202208,1호선,신설동,13961,13553,27514
202208,1호선,제기동,17609,18041,35650
202208,1호선,종각,38514,37819,76333
202208,1호선,종로3가,25890,23997,49887
202208,1호선,종로5가,23346,23382,46728
202208,1호선,청량리,20237,20166,40403
202208,1호선,동대문,11446,10129,21575
202208,1호선,동묘앞,9030,9309,18339
202208,1호선,서울,54837,53283,108120
202208,1호선,시청,25120,25756,50876
202208,1호선,신설동,15046,14254,29300
202208,1호선,제기동,19605,19885,39490
202208,1호선,종각,38864,38778,77642
202208,1호선,종로3가,28480,26427,54907
202208,1호선,종로5가,24816,25236,50052
202208,1호선,청량리,21929,22236,44165
202208,1호선,동대문,10914,10390,21304
202208,1호선,동묘앞,7052,7522,14574
202208,1호선,서울,48834,46678,95512
202208,1호선,시청,25245,25415,50660
202208,1호선,신설동,13840,13304,27144
202208,1호선,제기동,18269,18892,37161
202208,1호선,종각,37137,36814,73951
202208,1호선,종로3가,24406,22152,46558
202208,1호선,종로5가,22750,22623,45373
202208,1호선,청량리,20508,20100,40608
202208,1호선,동대문,10139,9317,19456
202208,1호선,동묘앞,6109,6386,12495
202208,1호선,서울,47548,45011,92559
202208,1호선,시청,25057,24830,49887
202208,1호선,신설동,13398,13107,26505
202208,1호선,제기동,15680,15629,31309
202208,1호선,종각,37848,37232,75080
202208,1호선,종로3가,22591,20692,43283
202208,1호선,종로5가,22569,22361,44930
202208,1호선,청량리,18315,18050,36365
202208,1호선,동대문,11024,10694,21718
202208,1호선,동묘앞,8427,8999,17426
202208,1호선,서울,49311,46839,96150
202208,1호선,시청,25407,25185,50592
202208,1호선,신설동,14466,14153,28619
202208,1호선,제기동,20801,21500,42301
202208,1호선,종각,38849,38522,77371
202208,1호선,종로3가,26689,23990,50679
202208,1호선,종로5가,24246,24238,48484
202208,1호선,청량리,21818,21928,43746
202209,1호선,동대문,11465,10762,22227
202209,1호선,동묘앞,8759,8937,17696
202209,1호선,서울,49081,47845,96926
202209,1호선,시청,26721,26378,53099
202209,1호선,신설동,14979,14453,29432
202209,1호선,제기동,21748,22507,44255
202209,1호선,종각,40534,39678,80212
202209,1호선,종로3가,27728,25170,52898
202209,1호선,종로5가,24956,24754,49710
202209,1호선,청량리,22981,23353,46334
202209,1호선,동대문,11733,10125,21858
202209,1호선,동묘앞,8944,9180,18124
202209,1호선,서울,54463,52615,107078
202209,1호선,시청,26029,26471,52500
202209,1호선,신설동,15401,14870,30271
202209,1호선,제기동,21944,22863,44807
202209,1호선,종각,39966,40247,80213
202209,1호선,종로3가,28474,26575,55049
202209,1호선,종로5가,26190,26500,52690
202209,1호선,청량리,23763,23870,47633
202209,1호선,동대문,9800,9021,18821
202209,1호선,동묘앞,5330,5759,11089
202209,1호선,서울,44945,43305,88250
202209,1호선,시청,23816,23746,47562
202209,1호선,신설동,13049,12957,26006
202209,1호선,제기동,14830,15173,30003
202209,1호선,종각,37311,35855,73166
202209,1호선,종로3가,19961,19028,38989
202209,1호선,종로5가,21616,21093,42709
202209,1호선,청량리,17687,17480,35167
202209,1호선,동대문,10841,10088,20929
202209,1호선,동묘앞,7994,8148,16142
202209,1호선,서울,37357,38248,75605
202209,1호선,시청,23587,23852,47439
202209,1호선,신설동,13599,13097,26696
202209,1호선,제기동,20745,21710,42455
202209,1호선,종각,33890,33998,67888
202209,1호선,종로3가,25424,22947,48371
202209,1호선,종로5가,23491,23391,46882
202209,1호선,청량리,22355,22359,44714
202209,1호선,동대문,11967,11093,23060
202209,1호선,동묘앞,9222,9507,18729
202209,1호선,서울,48689,54143,102832
202209,1호선,시청,26756,26857,53613
202209,1호선,신설동,15493,14655,30148
202209,1호선,제기동,23141,24376,47517
202209,1호선,종각,40239,39405,79644
202209,1호선,종로3가,28234,25539,53773
202209,1호선,종로5가,25644,25558,51202
202209,1호선,청량리,25223,25507,50730
202209,1호선,동대문,11670,10257,21927
202209,1호선,동묘앞,9376,9354,18730
202209,1호선,서울,49174,58571,107745
202209,1호선,시청,24680,24317,48997
202209,1호선,신설동,15293,13793,29086
202209,1호선,제기동,21622,22079,43701
202209,1호선,종각,36404,35575,71979
202209,1호선,종로3가,26741,24599,51340
202209,1호선,종로5가,24831,24328,49159
202209,1호선,청량리,25257,25784,51041
202209,1호선,동대문,9757,10446,20203
202209,1호선,동묘앞,8823,8918,17741
202209,1호선,서울,26967,38417,65384
202209,1호선,시청,8251,7969,16220
202209,1호선,신설동,6706,5262,11968
202209,1호선,제기동,11315,11053,22368
202209,1호선,종각,12578,11273,23851
202209,1호선,종로3가,13701,12200,25901
202209,1호선,종로5가,12022,11758,23780
202209,1호선,청량리,14563,14784,29347
202209,1호선,동대문,8368,8141,16509
202209,1호선,동묘앞,8996,9818,18814
202209,1호선,서울,36137,27420,63557
202209,1호선,시청,9469,9168,18637
202209,1호선,신설동,6208,6790,12998
202209,1호선,제기동,9380,10304,19684
202209,1호선,종각,14754,12500,27254
202209,1호선,종로3가,18614,15917,34531
202209,1호선,종로5가,11580,11799,23379
202209,1호선,청량리,11875,12317,24192
202209,1호선,동대문,10586,9963,20549
202209,1호선,동묘앞,7857,8331,16188
202209,1호선,서울,50597,43054,93651
202209,1호선,시청,23986,24697,48683
202209,1호선,신설동,13603,13571,27174
202209,1호선,제기동,16163,16458,32621
202209,1호선,종각,35018,34889,69907
202209,1호선,종로3가,25827,23694,49521
202209,1호선,종로5가,22836,23251,46087
202209,1호선,청량리,19286,19379,38665
202209,1호선,동대문,11227,10565,21792
202209,1호선,동묘앞,8322,8653,16975
202209,1호선,서울,49381,46245,95626
202209,1호선,시청,26381,26231,52612
202209,1호선,신설동,14483,14116,28599
202209,1호선,제기동,16887,16896,33783
202209,1호선,종각,39448,39168,78616
202209,1호선,종로3가,26488,24161,50649
202209,1호선,종로5가,24129,24349,48478
202209,1호선,청량리,19896,20032,39928
202209,1호선,동대문,11229,10492,21721
202209,1호선,동묘앞,8507,8962,17469
202209,1호선,서울,50504,48531,99035
202209,1호선,시청,26952,27225,54177
202209,1호선,신설동,14711,14274,28985
202209,1호선,제기동,17820,17964,35784
202209,1호선,종각,39919,39872,79791
202209,1호선,종로3가,27852,25161,53013
202209,1호선,종로5가,25009,25268,50277
202209,1호선,청량리,20563,20558,41121
202209,1호선,동대문,11417,10127,21544
202209,1호선,동묘앞,8538,8895,17433
202209,1호선,서울,59887,55390,115277
202209,1호선,시청,29259,32530,61789
202209,1호선,신설동,15318,14754,30072
202209,1호선,제기동,17441,17473,34914
202209,1호선,종각,42045,41797,83842
202209,1호선,종로3가,28773,27632,56405
202209,1호선,종로5가,25735,25779,51514
202209,1호선,청량리,20766,20924,41690
202209,1호선,동대문,11149,10459,21608
202209,1호선,동묘앞,7751,8178,15929
202209,1호선,서울,48798,48175,96973
202209,1호선,시청,25249,25900,51149
202209,1호선,신설동,14399,13751,28150
202209,1호선,제기동,17444,17716,35160
202209,1호선,종각,39268,39054,78322
202209,1호선,종로3가,26340,23860,50200
202209,1호선,종로5가,23673,23781,47454
202209,1호선,청량리,20017,19760,39777
202209,1호선,동대문,11407,10866,22273
202209,1호선,동묘앞,8857,9194,18051
202209,1호선,서울,49585,48440,98025
202209,1호선,시청,27115,27218,54333
202209,1호선,신설동,14595,14175,28770
202209,1호선,제기동,18699,18937,37636
202209,1호선,종각,39786,39667,79453
202209,1호선,종로3가,28014,25575,53589
202209,1호선,종로5가,24560,24493,49053
202209,1호선,청량리,21262,21181,42443
202209,1호선,동대문,11648,10973,22621
202209,1호선,동묘앞,8777,9082,17859
202209,1호선,서울,50430,49003,99433
202209,1호선,시청,27220,27598,54818
202209,1호선,신설동,14710,14132,28842
202209,1호선,제기동,18078,18462,36540
202209,1호선,종각,40881,40247,81128
202209,1호선,종로3가,28162,25355,53517
202209,1호선,종로5가,24370,24327,48697
202209,1호선,청량리,21014,20853,41867
202209,1호선,동대문,11504,10874,22378
202209,1호선,동묘앞,8909,9320,18229
202209,1호선,서울,51885,50427,102312
202209,1호선,시청,27503,27993,55496
202209,1호선,신설동,14825,14418,29243
202209,1호선,제기동,18343,18792,37135
202209,1호선,종각,40650,40570,81220
202209,1호선,종로3가,28735,25828,54563
202209,1호선,종로5가,24582,24825,49407
202209,1호선,청량리,21411,21040,42451
202209,1호선,동대문,12004,10664,22668
202209,1호선,동묘앞,8862,9153,18015
202209,1호선,서울,57535,55995,113530
202209,1호선,시청,27989,28850,56839
202209,1호선,신설동,15426,14894,30320
202209,1호선,제기동,18419,18328,36747
202209,1호선,종각,41294,41151,82445
202209,1호선,종로3가,29760,27730,57490
202209,1호선,종로5가,25187,25714,50901
202209,1호선,청량리,21758,21689,43447
202209,1호선,동대문,11397,10935,22332
202209,1호선,동묘앞,8374,8752,17126
202209,1호선,서울,50484,49337,99821
202209,1호선,시청,25827,26203,52030
202209,1호선,신설동,14760,14137,28897
202209,1호선,제기동,18165,18552,36717
202209,1호선,종각,39527,39042,78569
202209,1호선,종로3가,27005,24304,51309
202209,1호선,종로5가,23986,24100,48086
202209,1호선,청량리,20933,20681,41614
202209,1호선,동대문,11612,10921,22533
202209,1호선,동묘앞,8895,9192,18087
202209,1호선,서울,50442,49278,99720
202209,1호선,시청,27127,27500,54627
202209,1호선,신설동,14666,14298,28964
202209,1호선,제기동,18617,18960,37577
202209,1호선,종각,40098,39625,79723
202209,1호선,종로3가,28000,25286,53286
202209,1호선,종로5가,24553,24609,49162
202209,1호선,청량리,21545,21950,43495
202209,1호선,동대문,11659,10985,22644
202209,1호선,동묘앞,8840,9137,17977
202209,1호선,서울,50639,49173,99812
202209,1호선,시청,28072,28754,56826
202209,1호선,신설동,14881,14425,29306
202209,1호선,제기동,18463,18649,37112
202209,1호선,종각,41036,40793,81829
202209,1호선,종로3가,28140,25691,53831
202209,1호선,종로5가,25048,24778,49826
202209,1호선,청량리,21254,21130,42384
202209,1호선,동대문,11456,10680,22136
202209,1호선,동묘앞,8552,8816,17368
202209,1호선,서울,51719,50514,102233
202209,1호선,시청,27448,27919,55367
202209,1호선,신설동,14920,14580,29500
202209,1호선,제기동,18564,18874,37438
202209,1호선,종각,41063,40476,81539
202209,1호선,종로3가,28537,25533,54070
202209,1호선,종로5가,24437,24773,49210
202209,1호선,청량리,21300,21237,42537
202209,1호선,동대문,12059,10872,22931
202209,1호선,동묘앞,9397,9483,18880
202209,1호선,서울,58193,58620,116813
202209,1호선,시청,27677,28597,56274
202209,1호선,신설동,15455,14708,30163
202209,1호선,제기동,19013,18951,37964
202209,1호선,종각,41821,42353,84174
202209,1호선,종로3가,29834,27558,57392
202209,1호선,종로5가,25496,25780,51276
202209,1호선,청량리,22309,22155,44464
202210,1호선,동대문,8574,8021,16595
202210,1호선,동묘앞,4597,4890,9487
202210,1호선,서울,35360,32951,68311
202210,1호선,시청,22145,21045,43190
202210,1호선,신설동,6248,6337,12585
202210,1호선,제기동,9770,10343,20113
202210,1호선,종각,20180,18477,38657
202210,1호선,종로3가,17320,15667,32987
202210,1호선,종로5가,17066,15809,32875
202210,1호선,청량리,11883,12281,24164
202210,1호선,동대문,11353,10786,22139
202210,1호선,동묘앞,8267,8714,16981
202210,1호선,서울,50224,48333,98557
202210,1호선,시청,26178,26255,52433
202210,1호선,신설동,14592,14186,28778
202210,1호선,제기동,17729,18122,35851
202210,1호선,종각,39597,39597,79194
202210,1호선,종로3가,26566,24244,50810
202210,1호선,종로5가,24130,24081,48211
202210,1호선,청량리,20925,20770,41695
202210,1호선,동대문,11813,11248,23061
202210,1호선,동묘앞,8955,9350,18305
202210,1호선,서울,49946,49324,99270
202210,1호선,시청,28282,28476,56758
202210,1호선,신설동,15446,14789,30235
202210,1호선,제기동,19115,19377,38492
202210,1호선,종각,43104,42595,85699
202210,1호선,종로3가,28558,25508,54066
202210,1호선,종로5가,25266,24982,50248
202210,1호선,청량리,21437,21227,42664
202210,1호선,동대문,11970,11278,23248
202210,1호선,동묘앞,8687,9074,17761
202210,1호선,서울,51791,51553,103344
202210,1호선,시청,27343,27233,54576
202210,1호선,신설동,15127,14681,29808
202210,1호선,제기동,19172,19572,38744
202210,1호선,종각,41507,40658,82165
202210,1호선,종로3가,28215,26093,54308
202210,1호선,종로5가,25361,25019,50380
202210,1호선,청량리,21606,21343,42949
202210,1호선,동대문,12560,11053,23613
202210,1호선,동묘앞,9497,9849,19346
202210,1호선,서울,59379,59698,119077
202210,1호선,시청,28383,28559,56942
202210,1호선,신설동,15833,15083,30916
202210,1호선,제기동,19682,19787,39469
202210,1호선,종각,42045,42044,84089
202210,1호선,종로3가,30268,28011,58279
202210,1호선,종로5가,25889,25903,51792
202210,1호선,청량리,22439,22583,45022
202210,1호선,동대문,10068,10095,20163
202210,1호선,동묘앞,9232,9586,18818
202210,1호선,서울,38354,36260,74614
202210,1호선,시청,19372,18230,37602
202210,1호선,신설동,7593,7631,15224
202210,1호선,제기동,14203,15047,29250
202210,1호선,종각,19028,17523,36551
202210,1호선,종로3가,19725,18193,37918
202210,1호선,종로5가,19724,18552,38276
202210,1호선,청량리,15540,15926,31466
202210,1호선,동대문,11790,11249,23039
202210,1호선,동묘앞,8969,9433,18402
202210,1호선,서울,52941,50452,103393
202210,1호선,시청,26578,26455,53033
202210,1호선,신설동,14610,14308,28918
202210,1호선,제기동,18483,18801,37284
202210,1호선,종각,39915,39484,79399
202210,1호선,종로3가,27808,25047,52855
202210,1호선,종로5가,24671,24521,49192
202210,1호선,청량리,21296,21319,42615
202210,1호선,동대문,11785,11121,22906
202210,1호선,동묘앞,9094,9531,18625
202210,1호선,서울,51393,50516,101909
202210,1호선,시청,27809,27365,55174
202210,1호선,신설동,15130,14658,29788
202210,1호선,제기동,18809,19058,37867
202210,1호선,종각,41552,40474,82026
202210,1호선,종로3가,28391,25483,53874
202210,1호선,종로5가,25673,25345,51018
202210,1호선,청량리,21543,20951,42494
202210,1호선,동대문,11903,11224,23127
202210,1호선,동묘앞,9126,9432,18558
202210,1호선,서울,53544,51467,105011
202210,1호선,시청,27828,28073,55901
202210,1호선,신설동,14850,14589,29439
202210,1호선,제기동,19119,19365,38484
202210,1호선,종각,41420,40657,82077
202210,1호선,종로3가,28958,26095,55053
202210,1호선,종로5가,25714,25686,51400
202210,1호선,청량리,21592,21509,43101
202210,1호선,동대문,12042,10732,22774
202210,1호선,동묘앞,9555,9695,19250
202210,1호선,서울,58607,58245,116852
202210,1호선,시청,28612,28838,57450
202210,1호선,신설동,15704,14924,30628
202210,1호선,제기동,19209,19491,38700
202210,1호선,종각,40611,40085,80696
202210,1호선,종로3가,30297,27751,58048
202210,1호선,종로5가,26324,26308,52632
202210,1호선,청량리,22049,22170,44219
202210,1호선,동대문,11542,11082,22624
202210,1호선,동묘앞,8514,8808,17322
202210,1호선,서울,52535,50584,103119
202210,1호선,시청,26622,26697,53319
202210,1호선,신설동,14740,14408,29148
202210,1호선,제기동,18588,18694,37282
202210,1호선,종각,40254,40083,80337
202210,1호선,종로3가,27226,24912,52138
202210,1호선,종로5가,24557,24564,49121
202210,1호선,청량리,21146,20862,42008
202210,1호선,동대문,11553,10896,22449
202210,1호선,동묘앞,8851,9148,17999
202210,1호선,서울,51698,50819,102517
202210,1호선,시청,28303,28003,56306
202210,1호선,신설동,14523,14276,28799
202210,1호선,제기동,18899,19204,38103
202210,1호선,종각,41155,40597,81752
202210,1호선,종로3가,27642,24876,52518
202210,1호선,종로5가,25226,24795,50021
202210,1호선,청량리,21419,21317,42736
202210,1호선,동대문,11894,11292,23186
202210,1호선,동묘앞,9099,9292,18391
202210,1호선,서울,52174,51606,103780
202210,1호선,시청,28219,29340,57559
202210,1호선,신설동,15121,14638,29759
202210,1호선,제기동,18610,18631,37241
202210,1호선,종각,41846,41541,83387
202210,1호선,종로3가,28162,25444,53606
202210,1호선,종로5가,25015,24879,49894
202210,1호선,청량리,21126,20915,42041
202210,1호선,동대문,11912,11485,23397
202210,1호선,동묘앞,9278,9682,18960
202210,1호선,서울,53565,52283,105848
202210,1호선,시청,28822,28789,57611
202210,1호선,신설동,15102,14723,29825
202210,1호선,제기동,19135,19445,38580
202210,1호선,종각,41483,40743,82226
202210,1호선,종로3가,29722,26309,56031
202210,1호선,종로5가,25685,25931,51616
202210,1호선,청량리,21807,21684,43491
202210,1호선,동대문,12134,10864,22998
202210,1호선,동묘앞,9420,9848,19268
202210,1호선,서울,58988,57555,116543
202210,1호선,시청,28885,29288,58173
202210,1호선,신설동,15763,14871,30634
202210,1호선,제기동,19137,19174,38311
202210,1호선,종각,43041,42191,85232
202210,1호선,종로3가,30681,28140,58821
202210,1호선,종로5가,26584,26366,52950
202210,1호선,청량리,21905,22278,44183
202210,1호선,동대문,11604,11129,22733
202210,1호선,동묘앞,8222,8675,16897
202210,1호선,서울,52086,50671,102757
202210,1호선,시청,25980,26138,52118
202210,1호선,신설동,15864,15086,30950
202210,1호선,제기동,18337,18478,36815
202210,1호선,종각,40155,39028,79183
202210,1호선,종로3가,26964,24226,51190
202210,1호선,종로5가,24685,24301,48986
202210,1호선,청량리,20615,20629,41244
202210,1호선,동대문,12004,11325,23329
202210,1호선,동묘앞,8931,9514,18445
202210,1호선,서울,52070,51386,103456
202210,1호선,시청,28481,28450,56931
202210,1호선,신설동,15158,14663,29821
202210,1호선,제기동,18710,19014,37724
202210,1호선,종각,41722,41136,82858
202210,1호선,종로3가,28074,25194,53268
202210,1호선,종로5가,25347,25174,50521
202210,1호선,청량리,21518,21481,42999
202210,1호선,동대문,11932,11263,23195
202210,1호선,동묘앞,8888,9606,18494
202210,1호선,서울,53323,52499,105822
202210,1호선,시청,28757,29284,58041
202210,1호선,신설동,15065,14557,29622
202210,1호선,제기동,18701,18940,37641
202210,1호선,종각,42253,41452,83705
202210,1호선,종로3가,29006,25793,54799
202210,1호선,종로5가,26216,25895,52111
202210,1호선,청량리,21335,21478,42813
202210,1호선,동대문,12074,11427,23501
202210,1호선,동묘앞,8986,9468,18454
202210,1호선,서울,54756,53221,107977
202210,1호선,시청,29069,29198,58267
202210,1호선,신설동,15318,14855,30173
202210,1호선,제기동,18991,19310,38301
202210,1호선,종각,42552,41660,84212
202210,1호선,종로3가,29650,26220,55870
202210,1호선,종로5가,25982,25596,51578
202210,1호선,청량리,22002,21892,43894
202210,1호선,동대문,12266,11076,23342
202210,1호선,동묘앞,9555,9833,19388
202210,1호선,서울,61206,60155,121361
202210,1호선,시청,29943,29985,59928
202210,1호선,신설동,15802,15216,31018
202210,1호선,제기동,19547,19767,39314
202210,1호선,종각,41939,41756,83695
202210,1호선,종로3가,31032,28542,59574
202210,1호선,종로5가,26371,26513,52884
202210,1호선,청량리,22332,22593,44925
202210,1호선,동대문,11584,11013,22597
202210,1호선,동묘앞,8406,8914,17320
202210,1호선,서울,51812,49852,101664
202210,1호선,시청,27624,27940,55564
202210,1호선,신설동,14955,14507,29462
202210,1호선,제기동,18165,18612,36777
202210,1호선,종각,39708,38525,78233
202210,1호선,종로3가,26958,23684,50642
202210,1호선,종로5가,23843,23690,47533
202210,1호선,청량리,20983,20777,41760
202211,1호선,동대문,11548,10926,22474
202211,1호선,동묘앞,8558,9034,17592
202211,1호선,서울,50185,48097,98282
202211,1호선,시청,29081,29006,58087
202211,1호선,신설동,14648,14218,28866
202211,1호선,제기동,18538,18779,37317
202211,1호선,종각,40310,39217,79527
202211,1호선,종로3가,27166,24126,51292
202211,1호선,종로5가,24585,24181,48766
202211,1호선,청량리,21411,21308,42719
202211,1호선,동대문,11566,10905,22471
202211,1호선,동묘앞,8872,9204,18076
202211,1호선,서울,50193,49702,99895
202211,1호선,시청,29083,29093,58176
202211,1호선,신설동,15018,14616,29634
202211,1호선,제기동,18354,18670,37024
202211,1호선,종각,41265,40379,81644
202211,1호선,종로3가,27907,24962,52869
202211,1호선,종로5가,25162,25035,50197
202211,1호선,청량리,21040,21018,42058
202211,1호선,동대문,11379,10933,22312
202211,1호선,동묘앞,8229,8833,17062
202211,1호선,서울,52637,50876,103513
202211,1호선,시청,28222,29000,57222
202211,1호선,신설동,14705,14428,29133
202211,1호선,제기동,18513,18727,37240
202211,1호선,종각,41876,40571,82447
202211,1호선,종로3가,27631,24588,52219
202211,1호선,종로5가,25366,25235,50601
202211,1호선,청량리,21386,21168,42554
202211,1호선,동대문,11944,10519,22463
202211,1호선,동묘앞,8965,9258,18223
202211,1호선,서울,59662,59072,118734
202211,1호선,시청,29414,29513,58927
202211,1호선,신설동,15458,14747,30205
202211,1호선,제기동,18391,18685,37076
202211,1호선,종각,43005,41806,84811
202211,1호선,종로3가,29241,26993,56234
202211,1호선,종로5가,26642,26104,52746
202211,1호선,청량리,21809,21746,43555
202211,1호선,동대문,11308,11252,22560
202211,1호선,동묘앞,7946,8620,16566
202211,1호선,서울,52389,47370,99759
202211,1호선,시청,22070,21140,43210
202211,1호선,신설동,13961,13251,27212
202211,1호선,제기동,17064,16999,34063
202211,1호선,종각,34480,32324,66804
202211,1호선,종로3가,25792,23137,48929
202211,1호선,종로5가,21848,21432,43280
202211,1호선,청량리,19540,20019,39559
202211,1호선,동대문,11588,10803,22391
202211,1호선,동묘앞,8714,9071,17785
202211,1호선,서울,50378,48616,98994
202211,1호선,시청,27417,27069,54486
202211,1호선,신설동,14481,14061,28542
202211,1호선,제기동,18758,18996,37754
202211,1호선,종각,40115,39528,79643
202211,1호선,종로3가,27817,24743,52560
202211,1호선,종로5가,24535,24080,48615
202211,1호선,청량리,21411,21335,42746
202211,1호선,동대문,11360,10743,22103
202211,1호선,동묘앞,8699,9126,17825
202211,1호선,서울,50576,49559,100135
202211,1호선,시청,28254,28413,56667
202211,1호선,신설동,14791,14136,28927
202211,1호선,제기동,18323,18651,36974
202211,1호선,종각,41002,40330,81332
202211,1호선,종로3가,28369,25191,53560
202211,1호선,종로5가,24599,24686,49285
202211,1호선,청량리,21173,20753,41926
202211,1호선,동대문,11637,10970,22607
202211,1호선,동묘앞,8798,9080,17878
202211,1호선,서울,53405,51659,105064
202211,1호선,시청,28353,29286,57639
202211,1호선,신설동,14953,14380,29333
202211,1호선,제기동,18637,18775,37412
202211,1호선,종각,41435,41153,82588
202211,1호선,종로3가,28673,25584,54257
202211,1호선,종로5가,25045,24854,49899
202211,1호선,청량리,21326,21378,42704
202211,1호선,동대문,11996,10623,22619
202211,1호선,동묘앞,9257,9786,19043
202211,1호선,서울,58928,59230,118158
202211,1호선,시청,28787,29277,58064
202211,1호선,신설동,15605,14798,30403
202211,1호선,제기동,18773,18730,37503
202211,1호선,종각,42053,41542,83595
202211,1호선,종로3가,30361,28189,58550
202211,1호선,종로5가,25584,25835,51419
202211,1호선,청량리,22134,22206,44340
202211,1호선,동대문,11053,10623,21676
202211,1호선,동묘앞,8246,8501,16747
202211,1호선,서울,52325,49644,101969
202211,1호선,시청,25719,25978,51697
202211,1호선,신설동,14285,14019,28304
202211,1호선,제기동,17780,18303,36083
202211,1호선,종각,38814,38378,77192
202211,1호선,종로3가,26061,23616,49677
202211,1호선,종로5가,23643,23334,46977
202211,1호선,청량리,20419,20162,40581
202211,1호선,동대문,11134,10512,21646
202211,1호선,동묘앞,8232,8510,16742
202211,1호선,서울,50826,48685,99511
202211,1호선,시청,27522,27654,55176
202211,1호선,신설동,14283,13983,28266
202211,1호선,제기동,17898,18049,35947
202211,1호선,종각,40703,39754,80457
202211,1호선,종로3가,26815,24298,51113
202211,1호선,종로5가,24217,23935,48152
202211,1호선,청량리,20890,20859,41749
202211,1호선,동대문,11669,11076,22745
202211,1호선,동묘앞,8789,9095,17884
202211,1호선,서울,51174,50582,101756
202211,1호선,시청,27689,27596,55285
202211,1호선,신설동,14995,14319,29314
202211,1호선,제기동,18049,18252,36301
202211,1호선,종각,41341,40381,81722
202211,1호선,종로3가,28028,25112,53140
202211,1호선,종로5가,24549,24469,49018
202211,1호선,청량리,20581,20557,41138
202211,1호선,동대문,11457,10814,22271
202211,1호선,동묘앞,8744,9069,17813
202211,1호선,서울,52524,52124,104648
202211,1호선,시청,27677,27612,55289
202211,1호선,신설동,14779,14222,29001
202211,1호선,제기동,18382,18609,36991
202211,1호선,종각,40935,40225,81160
202211,1호선,종로3가,28425,25450,53875
202211,1호선,종로5가,24761,24793,49554
202211,1호선,청량리,20851,20833,41684
202211,1호선,동대문,11877,10527,22404
202211,1호선,동묘앞,9491,9627,19118
202211,1호선,서울,59914,59000,118914
202211,1호선,시청,27660,28156,55816
202211,1호선,신설동,15430,14736,30166
202211,1호선,제기동,18177,18265,36442
202211,1호선,종각,41138,40489,81627
202211,1호선,종로3가,29692,27523,57215
202211,1호선,종로5가,25936,26035,51971
202211,1호선,청량리,21806,21890,43696
202211,1호선,동대문,11208,10906,22114
202211,1호선,동묘앞,8137,8478,16615
202211,1호선,서울,52397,50716,103113
202211,1호선,시청,26008,25963,51971
202211,1호선,신설동,14420,13923,28343
202211,1호선,제기동,17608,17935,35543
202211,1호선,종각,39104,38342,77446
202211,1호선,종로3가,26411,23840,50251
202211,1호선,종로5가,23693,23691,47384
202211,1호선,청량리,20373,20261,40634
202211,1호선,동대문,11138,10582,21720
202211,1호선,동묘앞,8137,8447,16584
202211,1호선,서울,52251,49543,101794
202211,1호선,시청,28479,32104,60583
202211,1호선,신설동,14479,13971,28450
202211,1호선,제기동,17411,17505,34916
202211,1호선,종각,40507,39759,80266
202211,1호선,종로3가,26631,24108,50739
202211,1호선,종로5가,24174,23962,48136
202211,1호선,청량리,20348,20141,40489
202211,1호선,동대문,11400,10734,22134
202211,1호선,동묘앞,8524,8916,17440
202211,1호선,서울,52196,50180,102376
202211,1호선,시청,28040,28400,56440
202211,1호선,신설동,14761,14288,29049
202211,1호선,제기동,17777,17996,35773
202211,1호선,종각,41308,40760,82068
202211,1호선,종로3가,27924,24702,52626
202211,1호선,종로5가,24706,24528,49234
202211,1호선,청량리,20351,20180,40531
202211,1호선,동대문,11437,10818,22255
202211,1호선,동묘앞,8558,9020,17578
202211,1호선,서울,54880,52078,106958
202211,1호선,시청,29027,28932,57959
202211,1호선,신설동,15030,14359,29389
202211,1호선,제기동,17982,18028,36010
202211,1호선,종각,42866,41837,84703
202211,1호선,종로3가,27693,24905,52598
202211,1호선,종로5가,24948,24828,49776
202211,1호선,청량리,20936,20924,41860
202211,1호선,동대문,11820,10561,22381
202211,1호선,동묘앞,9041,9396,18437
202211,1호선,서울,61510,59273,120783
202211,1호선,시청,28069,28445,56514
202211,1호선,신설동,15400,14713,30113
202211,1호선,제기동,18118,18216,36334
202211,1호선,종각,42377,41472,83849
202211,1호선,종로3가,29707,27452,57159
202211,1호선,종로5가,25580,25310,50890
202211,1호선,청량리,21771,21809,43580
202211,1호선,동대문,10520,10069,20589
202211,1호선,동묘앞,6971,7258,14229
202211,1호선,서울,52074,49506,101580
202211,1호선,시청,25742,25159,50901
202211,1호선,신설동,13898,13806,27704
202211,1호선,제기동,16493,16635,33128
202211,1호선,종각,38907,37307,76214
202211,1호선,종로3가,23504,21649,45153
202211,1호선,종로5가,23497,22549,46046
202211,1호선,청량리,19149,18936,38085
202211,1호선,동대문,11126,10428,21554
202211,1호선,동묘앞,7855,8191,16046
202211,1호선,서울,51236,48225,99461
202211,1호선,시청,27105,26837,53942
202211,1호선,신설동,14329,13867,28196
202211,1호선,제기동,17053,17353,34406
202211,1호선,종각,40670,38732,79402
202211,1호선,종로3가,25943,23304,49247
202211,1호선,종로5가,24488,23854,48342
202211,1호선,청량리,20401,20060,40461
202211,1호선,동대문,10602,9877,20479
202211,1호선,동묘앞,7288,7470,14758
202211,1호선,서울,49894,47287,97181
202211,1호선,시청,26897,26371,53268
202211,1호선,신설동,13918,13389,27307
202211,1호선,제기동,14753,14911,29664
202211,1호선,종각,39534,37524,77058
202211,1호선,종로3가,23608,22636,46244
202211,1호선,종로5가,22176,21361,43537
202211,1호선,청량리,18204,18204,36408
202212,1호선,동대문,10626,9780,20406
202212,1호선,동묘앞,7226,7769,14995
202212,1호선,서울,50274,47936,98210
202212,1호선,시청,27381,27020,54401
202212,1호선,신설동,14059,13419,27478
202212,1호선,제기동,15135,15341,30476
202212,1호선,종각,40262,38766,79028
202212,1호선,종로3가,24380,22222,46602
202212,1호선,종로5가,22642,22225,44867
202212,1호선,청량리,18751,18622,37373
202212,1호선,동대문,11717,10477,22194
202212,1호선,동묘앞,8418,8740,17158
202212,1호선,서울,56380,55408,111788
202212,1호선,시청,27666,28152,55818
202212,1호선,신설동,15167,14291,29458
202212,1호선,제기동,17384,17385,34769
202212,1호선,종각,41940,41629,83569
202212,1호선,종로3가,27534,25613,53147
202212,1호선,종로5가,25170,25079,50249
202212,1호선,청량리,20701,20671,41372
202212,1호선,동대문,11023,10367,21390
202212,1호선,동묘앞,7486,7825,15311
202212,1호선,서울,50578,48790,99368
202212,1호선,시청,26503,26275,52778
202212,1호선,신설동,14395,13842,28237
202212,1호선,제기동,16594,16772,33366
202212,1호선,종각,39231,38848,78079
202212,1호선,종로3가,24887,22756,47643
202212,1호선,종로5가,23570,23224,46794
202212,1호선,청량리,19385,19321,38706
202212,1호선,동대문,11198,10547,21745
202212,1호선,동묘앞,7712,8179,15891
202212,1호선,서울,49796,48317,98113
202212,1호선,시청,28130,27374,55504
202212,1호선,신설동,14301,13752,28053
202212,1호선,제기동,16963,17339,34302
202212,1호선,종각,40828,39272,80100
202212,1호선,종로3가,25794,23310,49104
202212,1호선,종로5가,24145,23999,48144
202212,1호선,청량리,20094,19781,39875
202212,1호선,동대문,11687,11171,22858
202212,1호선,동묘앞,8541,8940,17481
202212,1호선,서울,51041,49129,100170
202212,1호선,시청,27903,28176,56079
202212,1호선,신설동,15076,14460,29536
202212,1호선,제기동,18210,18404,36614
202212,1호선,종각,42116,41006,83122
202212,1호선,종로3가,27259,24711,51970
202212,1호선,종로5가,25166,24949,50115
202212,1호선,청량리,20851,20632,41483
202212,1호선,동대문,11762,10949,22711
202212,1호선,동묘앞,8713,9016,17729
202212,1호선,서울,53010,51617,104627
202212,1호선,시청,28866,28902,57768
202212,1호선,신설동,14868,14302,29170
202212,1호선,제기동,18564,18789,37353
202212,1호선,종각,42619,41793,84412
202212,1호선,종로3가,28457,25630,54087
202212,1호선,종로5가,25663,25656,51319
202212,1호선,청량리,21373,21035,42408
202212,1호선,동대문,11974,10694,22668
202212,1호선,동묘앞,8952,9290,18242
202212,1호선,서울,59613,58184,117797
202212,1호선,시청,28423,28749,57172
202212,1호선,신설동,15592,14843,30435
202212,1호선,제기동,18818,18911,37729
202212,1호선,종각,43088,43431,86519
202212,1호선,종로3가,30343,28387,58730
202212,1호선,종로5가,26084,26593,52677
202212,1호선,청량리,21838,21783,43621
202212,1호선,동대문,11470,10848,22318
202212,1호선,동묘앞,7990,8185,16175
202212,1호선,서울,53062,50958,104020
202212,1호선,시청,26455,26303,52758
202212,1호선,신설동,14303,14006,28309
202212,1호선,제기동,18057,18490,36547
202212,1호선,종각,41575,39721,81296
202212,1호선,종로3가,25935,23961,49896
202212,1호선,종로5가,25344,24632,49976
202212,1호선,청량리,20406,20554,40960
202212,1호선,동대문,11549,10983,22532
202212,1호선,동묘앞,7839,8083,15922
202212,1호선,서울,53234,50857,104091
202212,1호선,시청,28772,28481,57253
202212,1호선,신설동,14532,14218,28750
202212,1호선,제기동,17699,18226,35925
202212,1호선,종각,43985,41758,85743
202212,1호선,종로3가,27284,25268,52552
202212,1호선,종로5가,26969,25851,52820
202212,1호선,청량리,21200,20848,42048
202212,1호선,동대문,10769,10137,20906
202212,1호선,동묘앞,6958,7246,14204
202212,1호선,서울,51393,49508,100901
202212,1호선,시청,27539,27322,54861
202212,1호선,신설동,13924,13511,27435
202212,1호선,제기동,14724,14728,29452
202212,1호선,종각,41911,40906,82817
202212,1호선,종로3가,24754,22707,47461
202212,1호선,종로5가,23119,22508,45627
202212,1호선,청량리,18057,17754,35811
202212,1호선,동대문,11235,10647,21882
202212,1호선,동묘앞,6584,6888,13472
202212,1호선,서울,55622,53440,109062
202212,1호선,시청,29519,29465,58984
202212,1호선,신설동,14616,14244,28860
202212,1호선,제기동,15478,15506,30984
202212,1호선,종각,45191,43329,88520
202212,1호선,종로3가,26801,24595,51396
202212,1호선,종로5가,25146,24447,49593
202212,1호선,청량리,19495,19047,38542
202212,1호선,동대문,11738,10429,22167
202212,1호선,동묘앞,8053,8374,16427
202212,1호선,서울,59873,58758,118631
202212,1호선,시청,28923,28991,57914
202212,1호선,신설동,15097,14482,29579
202212,1호선,제기동,16585,16663,33248
202212,1호선,종각,45342,45202,90544
202212,1호선,종로3가,28503,26905,55408
202212,1호선,종로5가,26281,25882,52163
202212,1호선,청량리,20293,20142,40435
202212,1호선,동대문,11110,10807,21917
202212,1호선,동묘앞,7117,8338,15455
202212,1호선,서울,51494,48234,99728
202212,1호선,시청,26225,24163,50388
202212,1호선,신설동,13886,13979,27865
202212,1호선,제기동,15780,16014,31794
202212,1호선,종각,40372,36945,77317
202212,1호선,종로3가,24957,22829,47786
202212,1호선,종로5가,24051,23674,47725
202212,1호선,청량리,18862,18592,37454
202212,1호선,동대문,11992,11346,23338
202212,1호선,동묘앞,8570,8935,17505
202212,1호선,서울,52974,50839,103813
202212,1호선,시청,29026,28614,57640
202212,1호선,신설동,14558,14043,28601
202212,1호선,제기동,19222,19706,38928
202212,1호선,종각,44119,42911,87030
202212,1호선,종로3가,28497,26025,54522
202212,1호선,종로5가,27203,26740,53943
202212,1호선,청량리,21371,21468,42839
202212,1호선,동대문,11664,10879,22543
202212,1호선,동묘앞,7371,7748,15119
202212,1호선,서울,56474,53942,110416
202212,1호선,시청,30241,30181,60422
202212,1호선,신설동,15271,14693,29964
202212,1호선,제기동,16252,16400,32652
202212,1호선,종각,45163,44203,89366
202212,1호선,종로3가,27905,25176,53081
202212,1호선,종로5가,25841,25476,51317
202212,1호선,청량리,20294,20156,40450
202212,1호선,동대문,11589,10795,22384
202212,1호선,동묘앞,7712,7977,15689
202212,1호선,서울,57310,54458,111768
202212,1호선,시청,29419,29273,58692
202212,1호선,신설동,14424,14132,28556
202212,1호선,제기동,16593,16945,33538
202212,1호선,종각,46987,45240,92227
202212,1호선,종로3가,27140,25098,52238
202212,1호선,종로5가,26249,25505,51754
202212,1호선,청량리,20360,19968,40328
202212,1호선,동대문,11213,9907,21120
202212,1호선,동묘앞,7345,7442,14787
202212,1호선,서울,58160,56540,114700
202212,1호선,시청,28180,27839,56019
202212,1호선,신설동,14467,13948,28415
202212,1호선,제기동,14677,14646,29323
202212,1호선,종각,42535,41955,84490
202212,1호선,종로3가,25797,24888,50685
202212,1호선,종로5가,24577,23254,47831
202212,1호선,청량리,18470,18455,36925
202212,1호선,동대문,11310,10751,22061
202212,1호선,동묘앞,7642,7825,15467
202212,1호선,서울,53674,50761,104435
202212,1호선,시청,26518,26650,53168
202212,1호선,신설동,14048,13593,27641
202212,1호선,제기동,17789,18137,35926
202212,1호선,종각,40193,38696,78889
202212,1호선,종로3가,26582,24409,50991
202212,1호선,종로5가,25976,25263,51239
202212,1호선,청량리,20217,20250,40467
202212,1호선,동대문,11957,11237,23194
202212,1호선,동묘앞,7996,8234,16230
202212,1호선,서울,52705,50977,103682
202212,1호선,시청,28147,28643,56790
202212,1호선,신설동,14150,13741,27891
202212,1호선,제기동,18906,19457,38363
202212,1호선,종각,42389,41224,83613
202212,1호선,종로3가,29159,26711,55870
202212,1호선,종로5가,27207,26303,53510
202212,1호선,청량리,20803,21051,41854
202212,1호선,동대문,11844,11267,23111
202212,1호선,동묘앞,7942,8090,16032
202212,1호선,서울,53531,51826,105357
202212,1호선,시청,28575,29077,57652
202212,1호선,신설동,14437,14090,28527
202212,1호선,제기동,18701,18834,37535
202212,1호선,종각,43050,41597,84647
202212,1호선,종로3가,28601,26072,54673
202212,1호선,종로5가,27916,27416,55332
202212,1호선,청량리,20631,20473,41104
202212,1호선,동대문,12076,11182,23258
202212,1호선,동묘앞,8107,8378,16485
202212,1호선,서울,52937,52354,105291
202212,1호선,시청,27757,28423,56180
202212,1호선,신설동,14464,13713,28177
202212,1호선,제기동,18509,18667,37176
202212,1호선,종각,41319,40119,81438
202212,1호선,종로3가,29170,26596,55766
202212,1호선,종로5가,27301,27019,54320
202212,1호선,청량리,20305,20513,40818
202212,1호선,동대문,12171,11017,23188
202212,1호선,동묘앞,8633,8884,17517
202212,1호선,서울,53890,54534,108424
202212,1호선,시청,26963,27195,54158
202212,1호선,신설동,14443,13440,27883
202212,1호선,제기동,18927,19311,38238
202212,1호선,종각,39419,38318,77737
202212,1호선,종로3가,29723,28038,57761
202212,1호선,종로5가,27648,27462,55110
202212,1호선,청량리,21184,21199,42383
