사용일자,호선명,지하철역,승차총승객수,하차총승객수,승하차총승객수
20210102,5호선,하남풍산,1961,2075,4036
20210102,5호선,미사,5132,5025,10157
20210102,5호선,마천,2697,2727,5424
20210102,5호선,거여,2728,2694,5422
20210102,5호선,개롱,2164,2332,4496
20210102,5호선,오금,1137,1075,2212
20210102,5호선,방이,2556,2556,5112
20210102,5호선,올림픽공원,1467,1400,2867
20210102,5호선,둔촌동,3209,3303,6512
20210102,5호선,상일동,5309,4957,10266
20210102,5호선,고덕,3056,3041,6097
20210102,5호선,명일,3062,3233,6295
20210102,5호선,굽은다리,3964,3793,7757
20210102,5호선,길동,3472,3703,7175
20210102,5호선,강동,6910,6645,13555
20210102,5호선,천호,9660,9100,18760
20210102,5호선,광나루,5249,5256,10505
20210102,5호선,아차산,7252,7315,14567
20210102,5호선,군자,4480,5024,9504
20210102,5호선,장한평,5681,5816,11497
20210102,5호선,답십리,5586,5168,10754
20210102,5호선,마장,2155,2068,4223
20210102,5호선,왕십리,1921,2160,4081
20210102,5호선,행당,2995,2679,5674
20210102,5호선,신금호,2310,2486,4796
20210102,5호선,청구,1361,1234,2595
20210102,5호선,동대문역사문화공원,539,685,1224
20210102,5호선,을지로4가,1453,1517,2970
20210102,5호선,종로3가,4181,4145,8326
20210102,5호선,광화문,6381,6228,12609
20210102,5호선,서대문,3620,3560,7180
20210102,5호선,충정로,982,1008,1990
20210102,5호선,애오개,2004,2046,4050
20210102,5호선,공덕,3398,3437,6835
20210102,5호선,마포,3624,3728,7352
20210102,5호선,여의나루,2112,2044,4156
20210102,5호선,여의도,3804,4079,7883
20210102,5호선,신길,1197,1468,2665
20210102,5호선,영등포시장,3497,3779,7276
20210102,5호선,영등포구청,971,1029,2000
20210102,5호선,양평,1891,1984,3875
20210102,5호선,오목교,8760,9030,17790
20210102,5호선,목동,5949,6108,12057
20210102,5호선,신정,4974,4269,9243
20210102,5호선,까치산,12160,12147,24307
20210102,5호선,화곡,10906,10210,21116
20210102,5호선,우장산,5247,5401,10648
20210102,5호선,발산,6102,6281,12383
20210102,5호선,마곡,2427,2461,4888
20210102,5호선,송정,2807,2883,5690
20210102,5호선,김포공항,4315,3887,8202
20210102,5호선,개화산,2149,2192,4341
20210102,5호선,방화,2726,2626,5352
20210103,5호선,하남풍산,1445,1568,3013
20210103,5호선,미사,3878,4022,7900
20210103,5호선,마천,1953,2173,4126
20210103,5호선,거여,2030,1971,4001
20210103,5호선,개롱,1628,1760,3388
20210103,5호선,오금,839,812,1651
20210103,5호선,방이,1858,1890,3748
20210103,5호선,올림픽공원,1133,1006,2139
20210103,5호선,둔촌동,2341,2404,4745
20210103,5호선,상일동,3911,3736,7647
20210103,5호선,고덕,2272,2273,4545
20210103,5호선,명일,2173,2198,4371
20210103,5호선,굽은다리,3075,2846,5921
20210103,5호선,길동,2377,2599,4976
20210103,5호선,강동,5301,5306,10607
20210103,5호선,천호,7152,6685,13837
20210103,5호선,광나루,4423,4415,8838
20210103,5호선,아차산,5998,6060,12058
20210103,5호선,군자,3403,3885,7288
20210103,5호선,장한평,4016,4184,8200
20210103,5호선,답십리,4217,4055,8272
20210103,5호선,마장,1545,1543,3088
20210103,5호선,왕십리,1439,1604,3043
20210103,5호선,행당,2267,2019,4286
20210103,5호선,신금호,1715,1884,3599
20210103,5호선,청구,979,927,1906
20210103,5호선,동대문역사문화공원,412,458,870
20210103,5호선,을지로4가,699,701,1400
20210103,5호선,종로3가,2957,2903,5860
20210103,5호선,광화문,5189,5285,10474
20210103,5호선,서대문,2561,2567,5128
20210103,5호선,충정로,810,842,1652
20210103,5호선,애오개,1510,1638,3148
20210103,5호선,공덕,2283,2466,4749
20210103,5호선,마포,2501,2615,5116
20210103,5호선,여의나루,1788,1825,3613
20210103,5호선,여의도,2917,3053,5970
20210103,5호선,신길,989,1256,2245
20210103,5호선,영등포시장,2347,2523,4870
20210103,5호선,영등포구청,732,787,1519
20210103,5호선,양평,1433,1618,3051
20210103,5호선,오목교,6415,6801,13216
20210103,5호선,목동,4298,4382,8680
20210103,5호선,신정,3676,3329,7005
20210103,5호선,까치산,9147,9325,18472
20210103,5호선,화곡,8121,7819,15940
20210103,5호선,우장산,3503,3673,7176
20210103,5호선,발산,4377,4545,8922
20210103,5호선,마곡,1694,1750,3444
20210103,5호선,송정,2161,2235,4396
20210103,5호선,김포공항,4661,3779,8440
20210103,5호선,개화산,1609,1698,3307
20210103,5호선,방화,2112,2108,4220
20210109,5호선,청구,1786,1615,3401
20210109,5호선,하남풍산,2159,2493,4652
20210109,5호선,미사,6433,6434,12867
20210109,5호선,마천,3016,3010,6026
20210109,5호선,거여,3480,3485,6965
20210109,5호선,개롱,2847,2980,5827
20210109,5호선,오금,1460,1375,2835
20210109,5호선,방이,3369,3298,6667
20210109,5호선,올림픽공원,1756,1584,3340
20210109,5호선,둔촌동,4235,4199,8434
20210109,5호선,상일동,6664,6308,12972
20210109,5호선,고덕,3819,3732,7551
20210109,5호선,명일,3784,3836,7620
20210109,5호선,굽은다리,4880,4629,9509
20210109,5호선,길동,4279,4499,8778
20210109,5호선,강동,9153,8577,17730
20210109,5호선,천호,11652,10961,22613
20210109,5호선,광나루,5639,5281,10920
20210109,5호선,아차산,7439,7501,14940
20210109,5호선,군자,5619,6053,11672
20210109,5호선,장한평,7245,7346,14591
20210109,5호선,답십리,7080,6647,13727
20210109,5호선,마장,2719,2581,5300
20210109,5호선,왕십리,2311,2749,5060
20210109,5호선,행당,3869,3403,7272
20210109,5호선,신금호,2782,2844,5626
20210109,5호선,동대문역사문화공원,777,953,1730
20210109,5호선,을지로4가,2132,2356,4488
20210109,5호선,종로3가,5267,5296,10563
20210109,5호선,광화문,7795,7786,15581
20210109,5호선,서대문,4395,4189,8584
20210109,5호선,충정로,1292,1179,2471
20210109,5호선,애오개,2476,2385,4861
20210109,5호선,공덕,4294,4731,9025
20210109,5호선,마포,4755,4785,9540
20210109,5호선,여의나루,2200,2195,4395
20210109,5호선,여의도,5389,5592,10981
20210109,5호선,신길,1704,1796,3500
20210109,5호선,영등포시장,4595,4634,9229
20210109,5호선,영등포구청,1284,1262,2546
20210109,5호선,양평,2501,2536,5037
20210109,5호선,오목교,10533,10848,21381
20210109,5호선,목동,7359,7556,14915
20210109,5호선,신정,6201,5282,11483
20210109,5호선,까치산,14392,14053,28445
20210109,5호선,화곡,13019,12245,25264
20210109,5호선,우장산,6129,6289,12418
20210109,5호선,발산,7784,8029,15813
20210109,5호선,마곡,2972,2826,5798
20210109,5호선,송정,3417,3385,6802
20210109,5호선,김포공항,4624,4711,9335
20210109,5호선,개화산,2343,2295,4638
20210109,5호선,방화,3246,3116,6362
20210110,5호선,서대문,3088,2994,6082
20210110,5호선,하남풍산,1676,1811,3487
20210110,5호선,미사,4277,4231,8508
20210110,5호선,마천,1928,2054,3982
20210110,5호선,거여,2195,2112,4307
20210110,5호선,개롱,1767,1917,3684
20210110,5호선,오금,961,953,1914
20210110,5호선,방이,2207,2154,4361
20210110,5호선,올림픽공원,1132,1005,2137
20210110,5호선,둔촌동,2691,2787,5478
20210110,5호선,상일동,4186,4092,8278
20210110,5호선,고덕,2289,2214,4503
20210110,5호선,명일,2363,2419,4782
20210110,5호선,굽은다리,3039,2986,6025
20210110,5호선,길동,2613,2805,5418
20210110,5호선,강동,5650,5537,11187
20210110,5호선,천호,7777,7267,15044
20210110,5호선,광나루,4117,3936,8053
20210110,5호선,아차산,5599,5679,11278
20210110,5호선,군자,3650,4031,7681
20210110,5호선,장한평,4473,4464,8937
20210110,5호선,답십리,4308,4115,8423
20210110,5호선,마장,1811,1785,3596
20210110,5호선,왕십리,1445,1599,3044
20210110,5호선,행당,2312,2156,4468
20210110,5호선,신금호,1831,1951,3782
20210110,5호선,청구,1058,1040,2098
20210110,5호선,동대문역사문화공원,494,586,1080
20210110,5호선,을지로4가,731,765,1496
20210110,5호선,종로3가,3553,3172,6725
20210110,5호선,광화문,5596,5671,11267
20210110,5호선,충정로,907,911,1818
20210110,5호선,애오개,1617,1699,3316
20210110,5호선,공덕,2587,2628,5215
20210110,5호선,마포,2955,2942,5897
20210110,5호선,여의나루,1620,1627,3247
20210110,5호선,여의도,3404,3799,7203
20210110,5호선,신길,1139,1346,2485
20210110,5호선,영등포시장,2667,2836,5503
20210110,5호선,영등포구청,746,767,1513
20210110,5호선,양평,1607,1606,3213
20210110,5호선,오목교,7074,7306,14380
20210110,5호선,목동,4596,4796,9392
20210110,5호선,신정,3883,3484,7367
20210110,5호선,까치산,9640,9480,19120
20210110,5호선,화곡,8524,8161,16685
20210110,5호선,우장산,3782,3954,7736
20210110,5호선,발산,4795,4871,9666
20210110,5호선,마곡,1838,1860,3698
20210110,5호선,송정,2230,2248,4478
20210110,5호선,김포공항,4021,3775,7796
20210110,5호선,개화산,1631,1727,3358
20210110,5호선,방화,2144,2138,4282
20210116,5호선,방화,3626,3502,7128
20210116,5호선,개화산,2717,2739,5456
20210116,5호선,김포공항,4983,5039,10022
20210116,5호선,송정,3774,3713,7487
20210116,5호선,마곡,3475,3376,6851
20210116,5호선,발산,8549,8806,17355
20210116,5호선,우장산,6933,7061,13994
20210116,5호선,화곡,14822,14161,28983
20210116,5호선,까치산,15939,15734,31673
20210116,5호선,신정,6636,5843,12479
20210116,5호선,목동,8275,8597,16872
20210116,5호선,오목교,12128,12561,24689
20210116,5호선,양평,2835,2758,5593
20210116,5호선,영등포구청,1459,1386,2845
20210116,5호선,영등포시장,5126,5320,10446
20210116,5호선,신길,1766,2008,3774
20210116,5호선,여의도,6041,6365,12406
20210116,5호선,여의나루,2713,2684,5397
20210116,5호선,마포,5269,5313,10582
20210116,5호선,공덕,4833,5035,9868
20210116,5호선,애오개,2783,2635,5418
20210116,5호선,충정로,1427,1373,2800
20210116,5호선,서대문,5018,4851,9869
20210116,5호선,광화문,9472,9126,18598
20210116,5호선,종로3가,6679,6566,13245
20210116,5호선,을지로4가,2445,2526,4971
20210116,5호선,동대문역사문화공원,855,1023,1878
20210116,5호선,청구,2010,1846,3856
20210116,5호선,신금호,3120,3202,6322
20210116,5호선,행당,4086,3624,7710
20210116,5호선,왕십리,2638,2943,5581
20210116,5호선,마장,3131,3050,6181
20210116,5호선,답십리,7887,7301,15188
20210116,5호선,장한평,8213,8149,16362
20210116,5호선,군자,6319,6810,13129
20210116,5호선,아차산,8981,9079,18060
20210116,5호선,광나루,6752,6306,13058
20210116,5호선,천호,12860,12290,25150
20210116,5호선,강동,9916,9291,19207
20210116,5호선,길동,4674,4840,9514
20210116,5호선,굽은다리,5149,4976,10125
20210116,5호선,명일,4265,4360,8625
20210116,5호선,고덕,4803,4616,9419
20210116,5호선,상일동,7462,6943,14405
20210116,5호선,둔촌동,4885,4836,9721
20210116,5호선,올림픽공원,2150,1831,3981
20210116,5호선,방이,3540,3525,7065
20210116,5호선,오금,1501,1468,2969
20210116,5호선,개롱,3156,3295,6451
20210116,5호선,거여,3967,3802,7769
20210116,5호선,마천,3317,3460,6777
20210116,5호선,미사,7198,7008,14206
20210116,5호선,하남풍산,2558,2875,5433
20210117,5호선,방화,2414,2485,4899
20210117,5호선,개화산,1809,1946,3755
20210117,5호선,김포공항,4961,4471,9432
20210117,5호선,송정,2500,2567,5067
20210117,5호선,마곡,2264,2260,4524
20210117,5호선,발산,5356,5385,10741
20210117,5호선,우장산,4231,4380,8611
20210117,5호선,화곡,9449,9065,18514
20210117,5호선,까치산,10613,10557,21170
20210117,5호선,신정,4251,3879,8130
20210117,5호선,목동,5153,5311,10464
20210117,5호선,오목교,7864,8066,15930
20210117,5호선,양평,1843,1982,3825
20210117,5호선,영등포구청,986,958,1944
20210117,5호선,영등포시장,2907,3105,6012
20210117,5호선,신길,1256,1485,2741
20210117,5호선,여의도,3684,3789,7473
20210117,5호선,여의나루,1839,1834,3673
20210117,5호선,마포,3115,3142,6257
20210117,5호선,공덕,2960,3104,6064
20210117,5호선,애오개,1741,1910,3651
20210117,5호선,충정로,896,1029,1925
20210117,5호선,서대문,3242,3090,6332
20210117,5호선,광화문,6232,6008,12240
20210117,5호선,종로3가,4307,3718,8025
20210117,5호선,을지로4가,861,801,1662
20210117,5호선,동대문역사문화공원,491,592,1083
20210117,5호선,청구,1241,1139,2380
20210117,5호선,신금호,1985,2122,4107
20210117,5호선,행당,2607,2382,4989
20210117,5호선,왕십리,1695,1925,3620
20210117,5호선,마장,1828,1845,3673
20210117,5호선,답십리,4909,4717,9626
20210117,5호선,장한평,4919,4951,9870
20210117,5호선,군자,3991,4353,8344
20210117,5호선,아차산,6589,6583,13172
20210117,5호선,광나루,4791,4837,9628
20210117,5호선,천호,8631,8274,16905
20210117,5호선,강동,6215,6228,12443
20210117,5호선,길동,2901,3144,6045
20210117,5호선,굽은다리,3505,3371,6876
20210117,5호선,명일,2576,2675,5251
20210117,5호선,고덕,2714,2760,5474
20210117,5호선,상일동,4820,4580,9400
20210117,5호선,둔촌동,3023,3059,6082
20210117,5호선,올림픽공원,1267,1173,2440
20210117,5호선,방이,2333,2278,4611
20210117,5호선,오금,1006,960,1966
20210117,5호선,개롱,1948,2127,4075
20210117,5호선,거여,2442,2446,4888
20210117,5호선,마천,2230,2446,4676
20210117,5호선,미사,4920,4883,9803
20210117,5호선,하남풍산,1989,2049,4038
20210123,5호선,마곡,3760,3655,7415
20210123,5호선,방화,3859,3701,7560
20210123,5호선,개화산,3000,3001,6001
20210123,5호선,김포공항,5320,5548,10868
20210123,5호선,송정,4147,3862,8009
20210123,5호선,발산,9319,10128,19447
20210123,5호선,우장산,7727,7812,15539
20210123,5호선,화곡,16342,15263,31605
20210123,5호선,까치산,17347,17033,34380
20210123,5호선,신정,7291,6197,13488
20210123,5호선,목동,8969,9341,18310
20210123,5호선,오목교,13816,14312,28128
20210123,5호선,양평,3028,2934,5962
20210123,5호선,영등포구청,1741,1625,3366
20210123,5호선,영등포시장,5675,5986,11661
20210123,5호선,신길,2030,2160,4190
20210123,5호선,여의도,6395,6902,13297
20210123,5호선,여의나루,3654,3621,7275
20210123,5호선,마포,5773,5848,11621
20210123,5호선,공덕,5659,5727,11386
20210123,5호선,애오개,3120,2927,6047
20210123,5호선,충정로,1612,1505,3117
20210123,5호선,서대문,5444,5410,10854
20210123,5호선,광화문,10463,10272,20735
20210123,5호선,종로3가,7774,8186,15960
20210123,5호선,을지로4가,2579,2803,5382
20210123,5호선,동대문역사문화공원,795,995,1790
20210123,5호선,청구,2084,1972,4056
20210123,5호선,신금호,3427,3408,6835
20210123,5호선,행당,4462,3932,8394
20210123,5호선,왕십리,2753,3222,5975
20210123,5호선,마장,3410,3295,6705
20210123,5호선,답십리,8326,7819,16145
20210123,5호선,장한평,8854,8817,17671
20210123,5호선,군자,6637,7382,14019
20210123,5호선,아차산,9869,9899,19768
20210123,5호선,광나루,7417,6953,14370
20210123,5호선,천호,13415,12899,26314
20210123,5호선,강동,10902,10262,21164
20210123,5호선,길동,4903,5051,9954
20210123,5호선,굽은다리,5557,5259,10816
20210123,5호선,명일,4723,4742,9465
20210123,5호선,고덕,4789,4644,9433
20210123,5호선,상일동,8235,7654,15889
20210123,5호선,둔촌동,5210,5080,10290
20210123,5호선,올림픽공원,2253,2000,4253
20210123,5호선,방이,4066,3993,8059
20210123,5호선,오금,1929,1802,3731
20210123,5호선,개롱,3480,3659,7139
20210123,5호선,거여,4250,4102,8352
20210123,5호선,마천,3631,3751,7382
20210123,5호선,미사,7918,7870,15788
20210123,5호선,하남풍산,2795,3106,5901
20210124,5호선,방화,2902,2762,5664
20210124,5호선,개화산,2039,2139,4178
20210124,5호선,김포공항,4881,4601,9482
20210124,5호선,송정,2676,2775,5451
20210124,5호선,마곡,2407,2430,4837
20210124,5호선,발산,6045,6234,12279
20210124,5호선,우장산,4836,4976,9812
20210124,5호선,화곡,10432,9929,20361
20210124,5호선,까치산,11913,11742,23655
20210124,5호선,신정,4837,4381,9218
20210124,5호선,목동,5756,6021,11777
20210124,5호선,오목교,8782,9101,17883
20210124,5호선,양평,1895,1976,3871
20210124,5호선,영등포구청,1039,1056,2095
20210124,5호선,영등포시장,3376,3497,6873
20210124,5호선,신길,1366,1599,2965
20210124,5호선,여의도,4120,4427,8547
20210124,5호선,여의나루,3759,3697,7456
20210124,5호선,마포,3536,3610,7146
20210124,5호선,공덕,3175,3298,6473
20210124,5호선,애오개,2024,2190,4214
20210124,5호선,충정로,1052,1142,2194
20210124,5호선,서대문,3675,3717,7392
20210124,5호선,광화문,7769,7574,15343
20210124,5호선,종로3가,5822,5183,11005
20210124,5호선,을지로4가,1060,1039,2099
20210124,5호선,동대문역사문화공원,547,665,1212
20210124,5호선,청구,1390,1263,2653
20210124,5호선,신금호,2217,2463,4680
20210124,5호선,행당,3108,2863,5971
20210124,5호선,왕십리,1799,2024,3823
20210124,5호선,마장,2331,2317,4648
20210124,5호선,답십리,5658,5217,10875
20210124,5호선,장한평,5552,5460,11012
20210124,5호선,군자,4533,4936,9469
20210124,5호선,아차산,8245,8272,16517
20210124,5호선,광나루,5685,5626,11311
20210124,5호선,천호,9209,8633,17842
20210124,5호선,강동,7185,7075,14260
20210124,5호선,길동,3201,3357,6558
20210124,5호선,굽은다리,3756,3512,7268
20210124,5호선,명일,3171,3245,6416
20210124,5호선,고덕,2870,2878,5748
20210124,5호선,상일동,5397,5304,10701
20210124,5호선,둔촌동,3345,3399,6744
20210124,5호선,올림픽공원,1582,1346,2928
20210124,5호선,방이,3000,2882,5882
20210124,5호선,오금,1306,1170,2476
20210124,5호선,개롱,2278,2413,4691
20210124,5호선,거여,2769,2816,5585
20210124,5호선,마천,2585,2823,5408
20210124,5호선,미사,5402,5379,10781
20210124,5호선,하남풍산,2085,2226,4311
20210130,5호선,방화,3814,3619,7433
20210130,5호선,개화산,2978,2984,5962
20210130,5호선,김포공항,5604,5798,11402
20210130,5호선,송정,4096,4117,8213
20210130,5호선,마곡,3934,3813,7747
20210130,5호선,발산,9529,10167,19696
20210130,5호선,우장산,7982,8007,15989
20210130,5호선,화곡,16318,15360,31678
20210130,5호선,까치산,17582,16973,34555
20210130,5호선,신정,7421,6490,13911
20210130,5호선,목동,9181,9489,18670
20210130,5호선,오목교,13989,14331,28320
20210130,5호선,양평,2970,2904,5874
20210130,5호선,영등포구청,1604,1611,3215
20210130,5호선,영등포시장,5592,5746,11338
20210130,5호선,신길,1937,2256,4193
20210130,5호선,여의도,6369,6811,13180
20210130,5호선,여의나루,3187,3165,6352
20210130,5호선,마포,5809,5964,11773
20210130,5호선,공덕,5702,5893,11595
20210130,5호선,애오개,3125,3019,6144
20210130,5호선,충정로,1511,1395,2906
20210130,5호선,서대문,5355,5348,10703
20210130,5호선,광화문,10969,10624,21593
20210130,5호선,종로3가,8158,8147,16305
20210130,5호선,을지로4가,2878,3149,6027
20210130,5호선,동대문역사문화공원,848,1140,1988
20210130,5호선,청구,2098,1988,4086
20210130,5호선,신금호,3389,3306,6695
20210130,5호선,행당,4677,4075,8752
20210130,5호선,왕십리,2792,3188,5980
20210130,5호선,마장,3605,3567,7172
20210130,5호선,답십리,8672,7970,16642
20210130,5호선,장한평,9018,9014,18032
20210130,5호선,군자,7003,7745,14748
20210130,5호선,아차산,9477,9485,18962
20210130,5호선,광나루,7184,6690,13874
20210130,5호선,천호,13549,12943,26492
20210130,5호선,강동,10814,10196,21010
20210130,5호선,길동,4973,5153,10126
20210130,5호선,굽은다리,5763,5386,11149
20210130,5호선,명일,4867,4778,9645
20210130,5호선,고덕,4875,4654,9529
20210130,5호선,상일동,8540,7823,16363
20210130,5호선,둔촌동,5091,5021,10112
20210130,5호선,올림픽공원,2256,2037,4293
20210130,5호선,방이,4111,4045,8156
20210130,5호선,오금,1778,1600,3378
20210130,5호선,개롱,3460,3572,7032
20210130,5호선,거여,4338,4249,8587
20210130,5호선,마천,3558,3595,7153
20210130,5호선,미사,8050,8091,16141
20210130,5호선,하남풍산,2816,3042,5858
20210131,5호선,방화,2755,2745,5500
20210131,5호선,개화산,2146,2255,4401
20210131,5호선,김포공항,5250,4893,10143
20210131,5호선,송정,2924,2921,5845
20210131,5호선,마곡,2511,2595,5106
20210131,5호선,발산,6214,6414,12628
20210131,5호선,우장산,4991,5058,10049
20210131,5호선,화곡,11013,10504,21517
20210131,5호선,까치산,11984,11938,23922
20210131,5호선,신정,4994,4388,9382
20210131,5호선,목동,5764,6041,11805
20210131,5호선,오목교,9421,9750,19171
20210131,5호선,양평,2042,2074,4116
20210131,5호선,영등포구청,1125,1125,2250
20210131,5호선,영등포시장,3459,3649,7108
20210131,5호선,신길,1415,1495,2910
20210131,5호선,여의도,4229,4462,8691
20210131,5호선,여의나루,3328,3303,6631
20210131,5호선,마포,3592,3645,7237
20210131,5호선,공덕,3422,3513,6935
20210131,5호선,애오개,2108,2245,4353
20210131,5호선,충정로,1128,1202,2330
20210131,5호선,서대문,3547,3558,7105
20210131,5호선,광화문,7821,7871,15692
20210131,5호선,종로3가,5819,5083,10902
20210131,5호선,을지로4가,1073,1140,2213
20210131,5호선,동대문역사문화공원,557,617,1174
20210131,5호선,청구,1436,1336,2772
20210131,5호선,신금호,2359,2440,4799
20210131,5호선,행당,3019,2782,5801
20210131,5호선,왕십리,1904,2185,4089
20210131,5호선,마장,2306,2302,4608
20210131,5호선,답십리,5718,5415,11133
20210131,5호선,장한평,5522,5526,11048
20210131,5호선,군자,4587,5122,9709
20210131,5호선,아차산,7683,8034,15717
20210131,5호선,광나루,5747,5735,11482
20210131,5호선,천호,9688,9062,18750
20210131,5호선,강동,7162,6924,14086
20210131,5호선,길동,3248,3418,6666
20210131,5호선,굽은다리,3996,3902,7898
20210131,5호선,명일,3272,3295,6567
20210131,5호선,고덕,3202,3177,6379
20210131,5호선,상일동,5625,5349,10974
20210131,5호선,둔촌동,3293,3523,6816
20210131,5호선,올림픽공원,1593,1468,3061
20210131,5호선,방이,2999,2828,5827
20210131,5호선,오금,1094,1104,2198
20210131,5호선,개롱,2482,2685,5167
20210131,5호선,거여,2896,2804,5700
20210131,5호선,마천,2606,2791,5397
20210131,5호선,미사,5555,5494,11049
20210131,5호선,하남풍산,2107,2297,4404
20210206,5호선,방화,4002,3879,7881
20210206,5호선,개화산,3177,3140,6317
20210206,5호선,김포공항,5681,6184,11865
20210206,5호선,송정,4296,4149,8445
20210206,5호선,마곡,4058,4000,8058
20210206,5호선,발산,10043,10823,20866
20210206,5호선,우장산,8277,8412,16689
20210206,5호선,화곡,17134,15899,33033
20210206,5호선,까치산,18151,17752,35903
20210206,5호선,신정,7703,6739,14442
20210206,5호선,목동,9727,9672,19399
20210206,5호선,오목교,14067,14518,28585
20210206,5호선,양평,3224,3086,6310
20210206,5호선,영등포구청,1784,1648,3432
20210206,5호선,영등포시장,5989,6232,12221
20210206,5호선,신길,2106,2298,4404
20210206,5호선,여의도,6635,7123,13758
20210206,5호선,여의나루,4014,3901,7915
20210206,5호선,마포,6274,6300,12574
20210206,5호선,공덕,5809,6122,11931
20210206,5호선,애오개,3259,3092,6351
20210206,5호선,충정로,1700,1554,3254
20210206,5호선,서대문,5986,5876,11862
20210206,5호선,광화문,11524,11535,23059
20210206,5호선,종로3가,9014,9049,18063
20210206,5호선,을지로4가,2969,3307,6276
20210206,5호선,동대문역사문화공원,902,1085,1987
20210206,5호선,청구,2269,2127,4396
20210206,5호선,신금호,3742,3832,7574
20210206,5호선,행당,4591,3995,8586
20210206,5호선,왕십리,3019,3525,6544
20210206,5호선,마장,3959,3848,7807
20210206,5호선,답십리,8884,8211,17095
20210206,5호선,장한평,9360,9056,18416
20210206,5호선,군자,7267,8057,15324
20210206,5호선,아차산,10270,10229,20499
20210206,5호선,광나루,8061,7851,15912
20210206,5호선,천호,14525,13710,28235
20210206,5호선,강동,11131,10528,21659
20210206,5호선,길동,5193,5410,10603
20210206,5호선,굽은다리,6102,5659,11761
20210206,5호선,명일,5328,5260,10588
20210206,5호선,고덕,5289,5047,10336
20210206,5호선,상일동,8743,8210,16953
20210206,5호선,둔촌동,5706,5730,11436
20210206,5호선,올림픽공원,2457,2105,4562
20210206,5호선,방이,4287,4184,8471
20210206,5호선,오금,1908,1739,3647
20210206,5호선,개롱,4038,4089,8127
20210206,5호선,거여,4618,4564,9182
20210206,5호선,마천,3830,3969,7799
20210206,5호선,미사,8314,8295,16609
20210206,5호선,하남풍산,3001,3233,6234
20210207,5호선,신금호,2376,2618,4994
20210207,5호선,하남풍산,2117,2359,4476
20210207,5호선,미사,5733,5626,11359
20210207,5호선,마천,2632,2813,5445
20210207,5호선,거여,2966,2878,5844
20210207,5호선,개롱,2396,2635,5031
20210207,5호선,오금,1319,1275,2594
20210207,5호선,방이,3110,2966,6076
20210207,5호선,올림픽공원,1519,1318,2837
20210207,5호선,둔촌동,3752,3920,7672
20210207,5호선,상일동,5832,5581,11413
20210207,5호선,고덕,3354,3261,6615
20210207,5호선,명일,3495,3577,7072
20210207,5호선,굽은다리,4298,3983,8281
20210207,5호선,길동,3456,3641,7097
20210207,5호선,강동,7512,7149,14661
20210207,5호선,천호,10286,9504,19790
20210207,5호선,광나루,5844,5726,11570
20210207,5호선,아차산,8089,8115,16204
20210207,5호선,군자,4773,5147,9920
20210207,5호선,장한평,5909,5775,11684
20210207,5호선,답십리,5901,5562,11463
20210207,5호선,마장,2730,2800,5530
20210207,5호선,왕십리,2137,2377,4514
20210207,5호선,행당,3181,2832,6013
20210207,5호선,청구,1557,1426,2983
20210207,5호선,동대문역사문화공원,584,639,1223
20210207,5호선,을지로4가,1207,1299,2506
20210207,5호선,종로3가,6241,5687,11928
20210207,5호선,광화문,8780,8615,17395
20210207,5호선,서대문,3916,3956,7872
20210207,5호선,충정로,1176,1228,2404
20210207,5호선,애오개,2239,2366,4605
20210207,5호선,공덕,3522,3546,7068
20210207,5호선,마포,3785,3851,7636
20210207,5호선,여의나루,3181,3327,6508
20210207,5호선,여의도,4321,4512,8833
20210207,5호선,신길,1477,1672,3149
20210207,5호선,영등포시장,3514,3638,7152
20210207,5호선,영등포구청,1076,1068,2144
20210207,5호선,양평,2226,2221,4447
20210207,5호선,오목교,9607,9832,19439
20210207,5호선,목동,6091,6297,12388
20210207,5호선,신정,5114,4624,9738
20210207,5호선,까치산,12769,12555,25324
20210207,5호선,화곡,11426,10882,22308
20210207,5호선,우장산,5375,5572,10947
20210207,5호선,발산,6491,6625,13116
20210207,5호선,마곡,2650,2662,5312
20210207,5호선,송정,2903,2922,5825
20210207,5호선,김포공항,5541,5591,11132
20210207,5호선,개화산,2136,2253,4389
20210207,5호선,방화,2953,2936,5889
20210213,5호선,방화,2928,2865,5793
20210213,5호선,개화산,2321,2417,4738
20210213,5호선,김포공항,6742,5709,12451
20210213,5호선,송정,2898,2938,5836
20210213,5호선,마곡,2414,2361,4775
20210213,5호선,발산,6274,6743,13017
20210213,5호선,우장산,5158,5159,10317
20210213,5호선,화곡,11204,10955,22159
20210213,5호선,까치산,12337,12581,24918
20210213,5호선,신정,4890,4477,9367
20210213,5호선,목동,6014,6255,12269
20210213,5호선,오목교,9522,9967,19489
20210213,5호선,양평,1627,1893,3520
20210213,5호선,영등포구청,1044,1028,2072
20210213,5호선,영등포시장,3147,3586,6733
20210213,5호선,신길,1143,1434,2577
20210213,5호선,여의도,3987,4393,8380
20210213,5호선,여의나루,4649,4473,9122
20210213,5호선,마포,3613,3712,7325
20210213,5호선,공덕,3449,3677,7126
20210213,5호선,애오개,1893,1992,3885
20210213,5호선,충정로,918,965,1883
20210213,5호선,서대문,3385,3571,6956
20210213,5호선,광화문,9966,9895,19861
20210213,5호선,종로3가,7148,7253,14401
20210213,5호선,을지로4가,1059,1124,2183
20210213,5호선,동대문역사문화공원,456,628,1084
20210213,5호선,청구,1380,1336,2716
20210213,5호선,신금호,2298,2468,4766
20210213,5호선,행당,3056,2636,5692
20210213,5호선,왕십리,1872,2343,4215
20210213,5호선,마장,2035,1956,3991
20210213,5호선,답십리,5473,5272,10745
20210213,5호선,장한평,5414,5614,11028
20210213,5호선,군자,4555,5241,9796
20210213,5호선,아차산,8276,8615,16891
20210213,5호선,광나루,6057,5943,12000
20210213,5호선,천호,10110,9504,19614
20210213,5호선,강동,6614,6549,13163
20210213,5호선,길동,3050,3188,6238
20210213,5호선,굽은다리,4309,3970,8279
20210213,5호선,명일,3229,3166,6395
20210213,5호선,고덕,3207,3167,6374
20210213,5호선,상일동,6060,5509,11569
20210213,5호선,둔촌동,3057,3203,6260
20210213,5호선,올림픽공원,1704,1536,3240
20210213,5호선,방이,2513,2439,4952
20210213,5호선,오금,1035,1046,2081
20210213,5호선,개롱,2374,2463,4837
20210213,5호선,거여,2771,2687,5458
20210213,5호선,마천,2678,2760,5438
20210213,5호선,미사,5497,5765,11262
20210213,5호선,하남풍산,2427,2552,4979
20210214,5호선,하남풍산,2315,2450,4765
20210214,5호선,미사,5376,5568,10944
20210214,5호선,마천,2581,2802,5383
20210214,5호선,거여,2832,2807,5639
20210214,5호선,개롱,2184,2437,4621
20210214,5호선,오금,1132,1087,2219
20210214,5호선,방이,2721,2695,5416
20210214,5호선,올림픽공원,1544,1408,2952
20210214,5호선,둔촌동,3237,3385,6622
20210214,5호선,상일동,5642,5479,11121
20210214,5호선,고덕,3008,2973,5981
20210214,5호선,명일,3204,3193,6397
20210214,5호선,굽은다리,3945,3737,7682
20210214,5호선,길동,3061,3177,6238
20210214,5호선,강동,6513,6979,13492
20210214,5호선,천호,9529,9249,18778
20210214,5호선,광나루,5809,5629,11438
20210214,5호선,아차산,7771,8036,15807
20210214,5호선,군자,4360,5179,9539
20210214,5호선,장한평,5345,5647,10992
20210214,5호선,답십리,5398,5269,10667
20210214,5호선,마장,2006,1923,3929
20210214,5호선,왕십리,1737,1999,3736
20210214,5호선,행당,3045,2808,5853
20210214,5호선,신금호,2154,2437,4591
20210214,5호선,청구,1358,1299,2657
20210214,5호선,동대문역사문화공원,474,518,992
20210214,5호선,을지로4가,983,1039,2022
20210214,5호선,종로3가,6134,5637,11771
20210214,5호선,광화문,8361,8627,16988
20210214,5호선,서대문,3366,3386,6752
20210214,5호선,충정로,1057,1190,2247
20210214,5호선,애오개,1976,2143,4119
20210214,5호선,공덕,3030,3216,6246
20210214,5호선,마포,3601,3674,7275
20210214,5호선,여의나루,3784,3804,7588
20210214,5호선,여의도,3969,4394,8363
20210214,5호선,신길,1254,1663,2917
20210214,5호선,영등포시장,3013,3399,6412
20210214,5호선,영등포구청,1005,1053,2058
20210214,5호선,양평,1715,2061,3776
20210214,5호선,오목교,9218,9497,18715
20210214,5호선,목동,5854,6110,11964
20210214,5호선,신정,4782,4453,9235
20210214,5호선,까치산,11835,12333,24168
20210214,5호선,화곡,10580,10503,21083
20210214,5호선,우장산,4891,5101,9992
20210214,5호선,발산,6204,6599,12803
20210214,5호선,마곡,2337,2545,4882
20210214,5호선,송정,2746,2915,5661
20210214,5호선,김포공항,7306,5883,13189
20210214,5호선,개화산,2143,2184,4327
20210214,5호선,방화,2760,2728,5488
20210220,5호선,하남풍산,3374,3585,6959
20210220,5호선,미사,8993,8864,17857
20210220,5호선,마천,4018,4153,8171
20210220,5호선,거여,4995,4760,9755
20210220,5호선,개롱,3771,4007,7778
20210220,5호선,오금,1955,1852,3807
20210220,5호선,방이,4653,4558,9211
20210220,5호선,올림픽공원,2672,2406,5078
20210220,5호선,둔촌동,5600,5673,11273
20210220,5호선,상일동,9501,8808,18309
20210220,5호선,고덕,5353,5187,10540
20210220,5호선,명일,5432,5331,10763
20210220,5호선,굽은다리,6239,5845,12084
20210220,5호선,길동,5377,5459,10836
20210220,5호선,강동,11971,11286,23257
20210220,5호선,천호,15116,14446,29562
20210220,5호선,광나루,8760,8436,17196
20210220,5호선,아차산,11566,11400,22966
20210220,5호선,군자,7675,8638,16313
20210220,5호선,장한평,9904,9836,19740
20210220,5호선,답십리,9365,8550,17915
20210220,5호선,마장,3652,3380,7032
20210220,5호선,왕십리,3245,3694,6939
20210220,5호선,행당,5025,4354,9379
20210220,5호선,신금호,3823,3938,7761
20210220,5호선,청구,2328,2140,4468
20210220,5호선,동대문역사문화공원,930,1154,2084
20210220,5호선,을지로4가,3131,3451,6582
20210220,5호선,종로3가,10467,10905,21372
20210220,5호선,광화문,13177,12928,26105
20210220,5호선,서대문,6231,6128,12359
20210220,5호선,충정로,1799,1694,3493
20210220,5호선,애오개,3417,3259,6676
20210220,5호선,공덕,6432,6780,13212
20210220,5호선,마포,6441,6655,13096
20210220,5호선,여의나루,6891,6860,13751
20210220,5호선,여의도,7768,8832,16600
20210220,5호선,신길,2327,2554,4881
20210220,5호선,영등포시장,6626,7059,13685
20210220,5호선,영등포구청,1779,1768,3547
20210220,5호선,양평,3372,3274,6646
20210220,5호선,오목교,15529,16061,31590
20210220,5호선,목동,10107,10335,20442
20210220,5호선,신정,8165,6992,15157
20210220,5호선,까치산,19559,19039,38598
20210220,5호선,화곡,18156,16806,34962
20210220,5호선,우장산,8641,8593,17234
20210220,5호선,발산,11771,12273,24044
20210220,5호선,마곡,4272,4297,8569
20210220,5호선,송정,4664,4537,9201
20210220,5호선,김포공항,6611,6587,13198
20210220,5호선,개화산,3417,3396,6813
20210220,5호선,방화,4364,4120,8484
20210221,5호선,하남풍산,2441,2577,5018
20210221,5호선,미사,6458,6231,12689
20210221,5호선,마천,2952,3306,6258
20210221,5호선,거여,3190,3131,6321
20210221,5호선,개롱,2702,2900,5602
20210221,5호선,오금,1452,1346,2798
20210221,5호선,방이,3102,3117,6219
20210221,5호선,올림픽공원,1892,1696,3588
20210221,5호선,둔촌동,3998,3955,7953
20210221,5호선,상일동,6523,6202,12725
20210221,5호선,고덕,3624,3606,7230
20210221,5호선,명일,3838,3837,7675
20210221,5호선,굽은다리,4588,4320,8908
20210221,5호선,길동,3576,3631,7207
20210221,5호선,강동,8257,8046,16303
20210221,5호선,천호,10999,10387,21386
20210221,5호선,광나루,6574,6642,13216
20210221,5호선,아차산,9197,9463,18660
20210221,5호선,군자,5308,5807,11115
20210221,5호선,장한평,6188,6152,12340
20210221,5호선,답십리,6353,6021,12374
20210221,5호선,마장,2476,2384,4860
20210221,5호선,왕십리,2164,2501,4665
20210221,5호선,행당,3595,3200,6795
20210221,5호선,신금호,2668,2851,5519
20210221,5호선,청구,1616,1451,3067
20210221,5호선,동대문역사문화공원,593,666,1259
20210221,5호선,을지로4가,1337,1433,2770
20210221,5호선,종로3가,7358,6816,14174
20210221,5호선,광화문,9834,9502,19336
20210221,5호선,서대문,3977,4008,7985
20210221,5호선,충정로,1283,1291,2574
20210221,5호선,애오개,2330,2422,4752
20210221,5호선,공덕,3914,4031,7945
20210221,5호선,마포,4122,4107,8229
20210221,5호선,여의나루,8953,9083,18036
20210221,5호선,여의도,5559,5893,11452
20210221,5호선,신길,1678,1878,3556
20210221,5호선,영등포시장,4064,4281,8345
20210221,5호선,영등포구청,1194,1208,2402
20210221,5호선,양평,2306,2286,4592
20210221,5호선,오목교,10475,11059,21534
20210221,5호선,목동,6708,6955,13663
20210221,5호선,신정,5654,4999,10653
20210221,5호선,까치산,13887,13588,27475
20210221,5호선,화곡,12366,11861,24227
20210221,5호선,우장산,5694,5798,11492
20210221,5호선,발산,7529,7830,15359
20210221,5호선,마곡,2791,2968,5759
20210221,5호선,송정,3253,3243,6496
20210221,5호선,김포공항,6083,5777,11860
20210221,5호선,개화산,2360,2407,4767
20210221,5호선,방화,3302,3163,6465
20210227,5호선,방화,4451,4208,8659
20210227,5호선,개화산,3469,3453,6922
20210227,5호선,김포공항,6841,6966,13807
20210227,5호선,송정,4870,4723,9593
20210227,5호선,마곡,4466,4392,8858
20210227,5호선,발산,12167,12840,25007
20210227,5호선,우장산,8963,8915,17878
20210227,5호선,화곡,19150,17636,36786
20210227,5호선,까치산,20172,19380,39552
20210227,5호선,신정,8481,7286,15767
20210227,5호선,목동,10922,10887,21809
20210227,5호선,오목교,15935,16735,32670
20210227,5호선,양평,3482,3322,6804
20210227,5호선,영등포구청,1916,1973,3889
20210227,5호선,영등포시장,6959,7417,14376
20210227,5호선,신길,2464,2623,5087
20210227,5호선,여의도,15387,14654,30041
20210227,5호선,여의나루,16216,19325,35541
20210227,5호선,마포,6895,7115,14010
20210227,5호선,공덕,6865,7310,14175
20210227,5호선,애오개,3544,3363,6907
20210227,5호선,충정로,1892,1691,3583
20210227,5호선,서대문,6518,6265,12783
20210227,5호선,광화문,13922,13808,27730
20210227,5호선,종로3가,10933,11254,22187
20210227,5호선,을지로4가,3243,3584,6827
20210227,5호선,동대문역사문화공원,951,1235,2186
20210227,5호선,청구,2369,2163,4532
20210227,5호선,신금호,3860,3929,7789
20210227,5호선,행당,5365,4604,9969
20210227,5호선,왕십리,3331,3874,7205
20210227,5호선,마장,3625,3424,7049
20210227,5호선,답십리,9737,8966,18703
20210227,5호선,장한평,10269,9932,20201
20210227,5호선,군자,7960,8594,16554
20210227,5호선,아차산,11990,11805,23795
20210227,5호선,광나루,9561,9155,18716
20210227,5호선,천호,15773,15273,31046
20210227,5호선,강동,12541,11611,24152
20210227,5호선,길동,5548,5620,11168
20210227,5호선,굽은다리,6392,5943,12335
20210227,5호선,명일,5712,5709,11421
20210227,5호선,고덕,5520,5438,10958
20210227,5호선,상일동,9946,9225,19171
20210227,5호선,둔촌동,5828,5835,11663
20210227,5호선,올림픽공원,2630,2375,5005
20210227,5호선,방이,4744,4577,9321
20210227,5호선,오금,2445,2154,4599
20210227,5호선,개롱,4225,4333,8558
20210227,5호선,거여,5043,4780,9823
20210227,5호선,마천,4262,4330,8592
20210227,5호선,미사,9401,9171,18572
20210227,5호선,하남풍산,3322,3487,6809
20210228,5호선,방화,3384,3361,6745
20210228,5호선,개화산,2569,2609,5178
20210228,5호선,김포공항,6290,5988,12278
20210228,5호선,송정,3558,3377,6935
20210228,5호선,마곡,3252,3319,6571
20210228,5호선,발산,7947,8421,16368
20210228,5호선,우장산,6168,6303,12471
20210228,5호선,화곡,13245,12503,25748
20210228,5호선,까치산,14871,14648,29519
20210228,5호선,신정,6144,5271,11415
20210228,5호선,목동,7318,7532,14850
20210228,5호선,오목교,11326,11699,23025
20210228,5호선,양평,2429,2410,4839
20210228,5호선,영등포구청,1272,1244,2516
20210228,5호선,영등포시장,4271,4520,8791
20210228,5호선,신길,1755,1901,3656
20210228,5호선,여의도,12921,11062,23983
20210228,5호선,여의나루,13955,17798,31753
20210228,5호선,마포,4632,4700,9332
20210228,5호선,공덕,4487,4526,9013
20210228,5호선,애오개,2605,2665,5270
20210228,5호선,충정로,1469,1422,2891
20210228,5호선,서대문,4576,4458,9034
20210228,5호선,광화문,10953,10930,21883
20210228,5호선,종로3가,8669,8440,17109
20210228,5호선,을지로4가,1545,1574,3119
20210228,5호선,동대문역사문화공원,614,747,1361
20210228,5호선,청구,1758,1611,3369
20210228,5호선,신금호,2745,2915,5660
20210228,5호선,행당,3867,3509,7376
20210228,5호선,왕십리,2110,2620,4730
20210228,5호선,마장,2795,2702,5497
20210228,5호선,답십리,6975,6340,13315
20210228,5호선,장한평,6827,6676,13503
20210228,5호선,군자,5731,6409,12140
20210228,5호선,아차산,10226,10178,20404
20210228,5호선,광나루,7382,7085,14467
20210228,5호선,천호,11519,10878,22397
20210228,5호선,강동,8784,8372,17156
20210228,5호선,길동,3756,3896,7652
20210228,5호선,굽은다리,4730,4371,9101
20210228,5호선,명일,4314,4301,8615
20210228,5호선,고덕,3835,3775,7610
20210228,5호선,상일동,7049,6486,13535
20210228,5호선,둔촌동,4358,4311,8669
20210228,5호선,올림픽공원,1944,1777,3721
20210228,5호선,방이,3415,3377,6792
20210228,5호선,오금,1566,1390,2956
20210228,5호선,개롱,2752,3029,5781
20210228,5호선,거여,3453,3336,6789
20210228,5호선,마천,3127,3382,6509
20210228,5호선,미사,6853,6878,13731
20210228,5호선,하남풍산,2685,2894,5579
20210306,5호선,방화,4544,4257,8801
20210306,5호선,개화산,3453,3463,6916
20210306,5호선,김포공항,6567,6952,13519
20210306,5호선,송정,4826,4696,9522
20210306,5호선,마곡,4572,4562,9134
20210306,5호선,발산,12211,12828,25039
20210306,5호선,우장산,9082,9231,18313
20210306,5호선,화곡,18880,17826,36706
20210306,5호선,까치산,19930,19324,39254
20210306,5호선,신정,8541,7317,15858
20210306,5호선,목동,10830,11010,21840
20210306,5호선,오목교,15629,16304,31933
20210306,5호선,양평,3510,3338,6848
20210306,5호선,영등포구청,2012,1867,3879
20210306,5호선,영등포시장,6554,6829,13383
20210306,5호선,신길,2439,2621,5060
20210306,5호선,여의도,13906,12961,26867
20210306,5호선,여의나루,11428,15426,26854
20210306,5호선,마포,6861,6854,13715
20210306,5호선,공덕,6675,7126,13801
20210306,5호선,애오개,3673,3535,7208
20210306,5호선,충정로,1975,1814,3789
20210306,5호선,서대문,6597,6390,12987
20210306,5호선,광화문,13775,13820,27595
20210306,5호선,종로3가,11588,11417,23005
20210306,5호선,을지로4가,3263,3559,6822
20210306,5호선,동대문역사문화공원,854,1186,2040
20210306,5호선,청구,2476,2308,4784
20210306,5호선,신금호,3878,3930,7808
20210306,5호선,행당,5476,4742,10218
20210306,5호선,왕십리,3396,3936,7332
20210306,5호선,마장,3757,3644,7401
20210306,5호선,답십리,9867,9092,18959
20210306,5호선,장한평,10444,10317,20761
20210306,5호선,군자,7968,8757,16725
20210306,5호선,아차산,12292,12024,24316
20210306,5호선,광나루,9047,8723,17770
20210306,5호선,천호,15828,15247,31075
20210306,5호선,강동,12675,11904,24579
20210306,5호선,길동,5495,5645,11140
20210306,5호선,굽은다리,6560,6147,12707
20210306,5호선,명일,5808,5642,11450
20210306,5호선,고덕,6829,6441,13270
20210306,5호선,상일동,9877,9154,19031
20210306,5호선,둔촌동,6074,6008,12082
20210306,5호선,올림픽공원,2691,2479,5170
20210306,5호선,방이,4822,4658,9480
20210306,5호선,오금,2100,1899,3999
20210306,5호선,개롱,4108,4237,8345
20210306,5호선,거여,5005,4906,9911
20210306,5호선,마천,4170,4345,8515
20210306,5호선,미사,9382,9223,18605
20210306,5호선,하남풍산,3254,3627,6881
20210307,5호선,하남풍산,2530,2683,5213
20210307,5호선,미사,6569,6523,13092
20210307,5호선,마천,3097,3360,6457
20210307,5호선,거여,3567,3576,7143
20210307,5호선,개롱,3090,3285,6375
20210307,5호선,오금,1601,1523,3124
20210307,5호선,방이,3554,3476,7030
20210307,5호선,올림픽공원,2036,1813,3849
20210307,5호선,둔촌동,4098,4184,8282
20210307,5호선,상일동,6869,6624,13493
20210307,5호선,고덕,4002,3931,7933
20210307,5호선,명일,4115,4126,8241
20210307,5호선,굽은다리,4725,4424,9149
20210307,5호선,길동,3746,3913,7659
20210307,5호선,강동,8559,8440,16999
20210307,5호선,천호,11524,10758,22282
20210307,5호선,광나루,6990,7091,14081
20210307,5호선,아차산,9771,9783,19554
20210307,5호선,군자,5536,6055,11591
20210307,5호선,장한평,6641,6464,13105
20210307,5호선,답십리,6825,6355,13180
20210307,5호선,마장,2639,2519,5158
20210307,5호선,왕십리,2406,2604,5010
20210307,5호선,행당,3633,3387,7020
20210307,5호선,신금호,2648,2910,5558
20210307,5호선,청구,1765,1532,3297
20210307,5호선,동대문역사문화공원,587,672,1259
20210307,5호선,을지로4가,1344,1399,2743
20210307,5호선,종로3가,7492,6906,14398
20210307,5호선,광화문,10671,10335,21006
20210307,5호선,서대문,4196,4219,8415
20210307,5호선,충정로,1347,1432,2779
20210307,5호선,애오개,2500,2529,5029
20210307,5호선,공덕,4309,4283,8592
20210307,5호선,마포,4525,4321,8846
20210307,5호선,여의나루,10941,13146,24087
20210307,5호선,여의도,9649,9037,18686
20210307,5호선,신길,1730,1934,3664
20210307,5호선,영등포시장,4092,4253,8345
20210307,5호선,영등포구청,1326,1312,2638
20210307,5호선,양평,2430,2412,4842
20210307,5호선,오목교,11462,11708,23170
20210307,5호선,목동,7197,7220,14417
20210307,5호선,신정,5872,5375,11247
20210307,5호선,까치산,14674,14247,28921
20210307,5호선,화곡,12908,12124,25032
20210307,5호선,우장산,6016,6216,12232
20210307,5호선,발산,7865,8312,16177
20210307,5호선,마곡,3076,3095,6171
20210307,5호선,송정,3509,3545,7054
20210307,5호선,김포공항,6253,5868,12121
20210307,5호선,개화산,2580,2658,5238
20210307,5호선,방화,3408,3372,6780
20210313,5호선,방화,4541,4324,8865
20210313,5호선,개화산,3570,3600,7170
20210313,5호선,김포공항,6927,7340,14267
20210313,5호선,송정,4959,4870,9829
20210313,5호선,마곡,4623,4748,9371
20210313,5호선,발산,12968,13456,26424
20210313,5호선,우장산,9286,9254,18540
20210313,5호선,화곡,19517,18234,37751
20210313,5호선,까치산,20745,19827,40572
20210313,5호선,신정,8736,7396,16132
20210313,5호선,목동,11023,11246,22269
20210313,5호선,오목교,16407,16946,33353
20210313,5호선,양평,3611,3442,7053
20210313,5호선,영등포구청,2063,1980,4043
20210313,5호선,영등포시장,6690,6999,13689
20210313,5호선,신길,2511,2682,5193
20210313,5호선,여의도,13691,13434,27125
20210313,5호선,여의나루,14694,18094,32788
20210313,5호선,마포,7147,7098,14245
20210313,5호선,공덕,6979,7222,14201
20210313,5호선,애오개,3772,3583,7355
20210313,5호선,충정로,1979,1792,3771
20210313,5호선,서대문,6637,6362,12999
20210313,5호선,광화문,14731,14671,29402
20210313,5호선,종로3가,11700,11937,23637
20210313,5호선,을지로4가,3303,3676,6979
20210313,5호선,동대문역사문화공원,935,1141,2076
20210313,5호선,청구,2617,2345,4962
20210313,5호선,신금호,3936,3993,7929
20210313,5호선,행당,5577,4828,10405
20210313,5호선,왕십리,3444,3837,7281
20210313,5호선,마장,3696,3501,7197
20210313,5호선,답십리,10039,9193,19232
20210313,5호선,장한평,10401,10270,20671
20210313,5호선,군자,8082,8905,16987
20210313,5호선,아차산,12182,12157,24339
20210313,5호선,광나루,10417,10110,20527
20210313,5호선,천호,16126,15319,31445
20210313,5호선,강동,12586,11716,24302
20210313,5호선,길동,5636,5723,11359
20210313,5호선,굽은다리,6760,6274,13034
20210313,5호선,명일,5497,5577,11074
20210313,5호선,고덕,5672,5586,11258
20210313,5호선,상일동,10294,9566,19860
20210313,5호선,둔촌동,6100,5945,12045
20210313,5호선,올림픽공원,2813,2515,5328
20210313,5호선,방이,5015,4943,9958
20210313,5호선,오금,2545,2185,4730
20210313,5호선,개롱,4409,4617,9026
20210313,5호선,거여,5337,5155,10492
20210313,5호선,마천,4353,4436,8789
20210313,5호선,미사,9608,9501,19109
20210313,5호선,하남풍산,3426,3636,7062
20210314,5호선,하남풍산,2506,2632,5138
20210314,5호선,미사,6626,6545,13171
20210314,5호선,마천,3128,3351,6479
20210314,5호선,거여,3516,3465,6981
20210314,5호선,개롱,2897,3076,5973
20210314,5호선,오금,1399,1278,2677
20210314,5호선,방이,3462,3494,6956
20210314,5호선,올림픽공원,1997,1759,3756
20210314,5호선,둔촌동,4121,4254,8375
20210314,5호선,상일동,6962,6643,13605
20210314,5호선,고덕,3667,3596,7263
20210314,5호선,명일,3976,4038,8014
20210314,5호선,굽은다리,4843,4383,9226
20210314,5호선,길동,3749,3842,7591
20210314,5호선,강동,8565,8376,16941
20210314,5호선,천호,11347,10897,22244
20210314,5호선,광나루,6858,6877,13735
20210314,5호선,아차산,9566,9655,19221
20210314,5호선,군자,5548,6110,11658
20210314,5호선,장한평,6727,6618,13345
20210314,5호선,답십리,6709,6233,12942
20210314,5호선,마장,2695,2525,5220
20210314,5호선,왕십리,2180,2477,4657
20210314,5호선,행당,3696,3363,7059
20210314,5호선,신금호,2718,2889,5607
20210314,5호선,청구,1651,1639,3290
20210314,5호선,동대문역사문화공원,592,740,1332
20210314,5호선,을지로4가,1389,1419,2808
20210314,5호선,종로3가,8230,7434,15664
20210314,5호선,광화문,10520,10462,20982
20210314,5호선,서대문,4532,4500,9032
20210314,5호선,충정로,1424,1496,2920
20210314,5호선,애오개,2471,2561,5032
20210314,5호선,공덕,4197,4288,8485
20210314,5호선,마포,4356,4394,8750
20210314,5호선,여의나루,12307,14789,27096
20210314,5호선,여의도,9720,9061,18781
20210314,5호선,신길,1711,1922,3633
20210314,5호선,영등포시장,4204,4581,8785
20210314,5호선,영등포구청,1247,1140,2387
20210314,5호선,양평,2316,2389,4705
20210314,5호선,오목교,11148,11530,22678
20210314,5호선,목동,7231,7298,14529
20210314,5호선,신정,6031,5400,11431
20210314,5호선,까치산,14663,14468,29131
20210314,5호선,화곡,13208,12347,25555
20210314,5호선,우장산,6082,6304,12386
20210314,5호선,발산,8237,8586,16823
20210314,5호선,마곡,3132,3247,6379
20210314,5호선,송정,3523,3459,6982
20210314,5호선,김포공항,6352,6133,12485
20210314,5호선,개화산,2596,2648,5244
20210314,5호선,방화,3387,3221,6608
20210320,5호선,방화,4069,3905,7974
20210320,5호선,개화산,3210,3131,6341
20210320,5호선,김포공항,6674,6998,13672
20210320,5호선,송정,4505,4324,8829
20210320,5호선,마곡,4499,4458,8957
20210320,5호선,발산,12170,12602,24772
20210320,5호선,우장산,8671,8555,17226
20210320,5호선,화곡,17946,16498,34444
20210320,5호선,까치산,18783,18181,36964
20210320,5호선,신정,8266,7091,15357
20210320,5호선,목동,10251,10394,20645
20210320,5호선,오목교,14807,15316,30123
20210320,5호선,양평,3382,3264,6646
20210320,5호선,영등포구청,1778,1762,3540
20210320,5호선,영등포시장,6558,6818,13376
20210320,5호선,신길,2332,2428,4760
20210320,5호선,여의도,12025,11858,23883
20210320,5호선,여의나루,6956,9555,16511
20210320,5호선,마포,6804,6824,13628
20210320,5호선,공덕,6604,6865,13469
20210320,5호선,애오개,3448,3310,6758
20210320,5호선,충정로,2068,1848,3916
20210320,5호선,서대문,6364,6124,12488
20210320,5호선,광화문,11918,12209,24127
20210320,5호선,종로3가,10386,10200,20586
20210320,5호선,을지로4가,2875,3118,5993
20210320,5호선,동대문역사문화공원,963,1168,2131
20210320,5호선,청구,2385,2237,4622
20210320,5호선,신금호,3652,3703,7355
20210320,5호선,행당,5042,4377,9419
20210320,5호선,왕십리,3154,3582,6736
20210320,5호선,마장,3439,3265,6704
20210320,5호선,답십리,9422,8594,18016
20210320,5호선,장한평,9783,9749,19532
20210320,5호선,군자,7540,8480,16020
20210320,5호선,아차산,10327,10133,20460
20210320,5호선,광나루,8460,7894,16354
20210320,5호선,천호,14836,14036,28872
20210320,5호선,강동,12347,11337,23684
20210320,5호선,길동,5273,5403,10676
20210320,5호선,굽은다리,6429,6044,12473
20210320,5호선,명일,5122,5176,10298
20210320,5호선,고덕,5292,5069,10361
20210320,5호선,상일동,9565,8933,18498
20210320,5호선,둔촌동,5682,5694,11376
20210320,5호선,올림픽공원,2407,2174,4581
20210320,5호선,방이,4832,4775,9607
20210320,5호선,오금,1970,1791,3761
20210320,5호선,개롱,3836,4015,7851
20210320,5호선,거여,5050,4781,9831
20210320,5호선,마천,3855,3962,7817
20210320,5호선,미사,8803,8786,17589
20210320,5호선,하남풍산,3205,3532,6737
20210321,5호선,방화,3304,3338,6642
20210321,5호선,개화산,2472,2613,5085
20210321,5호선,김포공항,6800,6506,13306
20210321,5호선,송정,3509,3401,6910
20210321,5호선,마곡,3155,3285,6440
20210321,5호선,발산,8467,8739,17206
20210321,5호선,우장산,6162,6321,12483
20210321,5호선,화곡,13142,12339,25481
20210321,5호선,까치산,14641,14356,28997
20210321,5호선,신정,6006,5442,11448
20210321,5호선,목동,7254,7582,14836
20210321,5호선,오목교,11109,11285,22394
20210321,5호선,양평,2469,2560,5029
20210321,5호선,영등포구청,1357,1338,2695
20210321,5호선,영등포시장,4523,4809,9332
20210321,5호선,신길,1618,2023,3641
20210321,5호선,여의도,9210,8624,17834
20210321,5호선,여의나루,9111,11442,20553
20210321,5호선,마포,4376,4406,8782
20210321,5호선,공덕,4308,4312,8620
20210321,5호선,애오개,2485,2578,5063
20210321,5호선,충정로,1522,1496,3018
20210321,5호선,서대문,4414,4311,8725
20210321,5호선,광화문,10120,9840,19960
20210321,5호선,종로3가,8427,7512,15939
20210321,5호선,을지로4가,1288,1422,2710
20210321,5호선,동대문역사문화공원,616,747,1363
20210321,5호선,청구,1627,1559,3186
20210321,5호선,신금호,2653,2838,5491
20210321,5호선,행당,3556,3339,6895
20210321,5호선,왕십리,2341,2637,4978
20210321,5호선,마장,2693,2469,5162
20210321,5호선,답십리,6722,6380,13102
20210321,5호선,장한평,6740,6789,13529
20210321,5호선,군자,5538,6130,11668
20210321,5호선,아차산,10257,10265,20522
20210321,5호선,광나루,6932,6802,13734
20210321,5호선,천호,11736,11046,22782
20210321,5호선,강동,9075,8916,17991
20210321,5호선,길동,3791,3882,7673
20210321,5호선,굽은다리,5042,4690,9732
20210321,5호선,명일,4047,4049,8096
20210321,5호선,고덕,3852,3975,7827
20210321,5호선,상일동,6915,6792,13707
20210321,5호선,둔촌동,4279,4324,8603
20210321,5호선,올림픽공원,1918,1677,3595
20210321,5호선,방이,3644,3503,7147
20210321,5호선,오금,1475,1381,2856
20210321,5호선,개롱,2715,2975,5690
20210321,5호선,거여,3376,3421,6797
20210321,5호선,마천,3182,3374,6556
20210321,5호선,미사,6794,6641,13435
20210321,5호선,하남풍산,2545,2694,5239
20210327,5호선,영등포시장,6581,6976,13557
20210327,5호선,신길,2275,2545,4820
20210327,5호선,여의도,13563,11933,25496
20210327,5호선,여의나루,5903,9876,15779
20210327,5호선,마포,7048,7199,14247
20210327,5호선,공덕,6703,7197,13900
20210327,5호선,애오개,3576,3445,7021
20210327,5호선,충정로,1852,1665,3517
20210327,5호선,서대문,6598,6366,12964
20210327,5호선,광화문,12969,12906,25875
20210327,5호선,종로3가,10714,10255,20969
20210327,5호선,을지로4가,3029,3375,6404
20210327,5호선,동대문역사문화공원,990,1151,2141
20210327,5호선,청구,2333,2314,4647
20210327,5호선,신금호,3675,3735,7410
20210327,5호선,행당,5211,4691,9902
20210327,5호선,왕십리,3281,3583,6864
20210327,5호선,마장,3601,3480,7081
20210327,5호선,답십리,9612,8796,18408
20210327,5호선,장한평,10010,9896,19906
20210327,5호선,군자,7788,8425,16213
20210327,5호선,아차산,11665,11367,23032
20210327,5호선,광나루,8997,8458,17455
20210327,5호선,천호,15950,14687,30637
20210327,5호선,강동,12026,11582,23608
20210327,5호선,길동,5800,5990,11790
20210327,5호선,굽은다리,6585,6286,12871
20210327,5호선,명일,5698,5687,11385
20210327,5호선,고덕,5567,5448,11015
20210327,5호선,상일동,9283,8758,18041
20210327,5호선,둔촌동,5826,5737,11563
20210327,5호선,올림픽공원,2485,2251,4736
20210327,5호선,방이,5054,4922,9976
20210327,5호선,오금,2089,1900,3989
20210327,5호선,개롱,3961,4297,8258
20210327,5호선,거여,5185,4950,10135
20210327,5호선,하남검단산,6883,7075,13958
20210327,5호선,하남시청,4765,4691,9456
20210327,5호선,하남풍산,2936,2872,5808
20210327,5호선,미사,10413,10280,20693
20210327,5호선,강일,2496,2533,5029
20210327,5호선,마천,4034,4257,8291
20210327,5호선,방화,4454,4250,8704
20210327,5호선,개화산,3401,3352,6753
20210327,5호선,김포공항,7121,7222,14343
20210327,5호선,송정,4752,4560,9312
20210327,5호선,마곡,4576,4645,9221
20210327,5호선,발산,12000,12343,24343
20210327,5호선,우장산,8696,8833,17529
20210327,5호선,화곡,18128,16895,35023
20210327,5호선,까치산,19040,18478,37518
20210327,5호선,신정,8346,7246,15592
20210327,5호선,목동,10281,10449,20730
20210327,5호선,오목교,15468,15763,31231
20210327,5호선,양평,3372,3397,6769
20210327,5호선,영등포구청,1826,1777,3603
20210328,5호선,광나루,5674,5351,11025
20210328,5호선,천호,10739,9858,20597
20210328,5호선,강동,7914,7914,15828
20210328,5호선,길동,3643,3908,7551
20210328,5호선,굽은다리,4498,4258,8756
20210328,5호선,명일,3947,3924,7871
20210328,5호선,고덕,3443,3548,6991
20210328,5호선,상일동,6123,5950,12073
20210328,5호선,둔촌동,3973,4105,8078
20210328,5호선,올림픽공원,1653,1459,3112
20210328,5호선,방이,3401,3299,6700
20210328,5호선,오금,1324,1267,2591
20210328,5호선,개롱,2506,2809,5315
20210328,5호선,거여,3314,3331,6645
20210328,5호선,마천,2645,2907,5552
20210328,5호선,강일,1767,1788,3555
20210328,5호선,미사,6985,6928,13913
20210328,5호선,하남풍산,2118,2113,4231
20210328,5호선,하남시청,3229,3216,6445
20210328,5호선,하남검단산,4653,4642,9295
20210328,5호선,아차산,8106,8328,16434
20210328,5호선,군자,5192,5808,11000
20210328,5호선,장한평,6265,6322,12587
20210328,5호선,답십리,6153,5838,11991
20210328,5호선,마장,2369,2408,4777
20210328,5호선,왕십리,1953,2268,4221
20210328,5호선,행당,3384,3153,6537
20210328,5호선,신금호,2461,2577,5038
20210328,5호선,청구,1550,1491,3041
20210328,5호선,동대문역사문화공원,647,710,1357
20210328,5호선,을지로4가,1237,1339,2576
20210328,5호선,종로3가,7351,6609,13960
20210328,5호선,광화문,9057,8911,17968
20210328,5호선,서대문,4005,3804,7809
20210328,5호선,충정로,1314,1345,2659
20210328,5호선,애오개,2335,2382,4717
20210328,5호선,공덕,4142,4241,8383
20210328,5호선,마포,4097,4167,8264
20210328,5호선,여의나루,7354,9556,16910
20210328,5호선,여의도,8523,8041,16564
20210328,5호선,신길,1749,1905,3654
20210328,5호선,영등포시장,4168,4409,8577
20210328,5호선,영등포구청,1200,1139,2339
20210328,5호선,양평,2313,2420,4733
20210328,5호선,오목교,10225,10257,20482
20210328,5호선,목동,6688,7010,13698
20210328,5호선,신정,5546,4934,10480
20210328,5호선,까치산,13594,13380,26974
20210328,5호선,화곡,12276,11611,23887
20210328,5호선,우장산,5687,5973,11660
20210328,5호선,발산,7919,8037,15956
20210328,5호선,마곡,2962,3049,6011
20210328,5호선,송정,3248,3319,6567
20210328,5호선,김포공항,6283,5854,12137
20210328,5호선,개화산,2306,2364,4670
20210328,5호선,방화,3122,3117,6239
20210403,5호선,방화,3781,3632,7413
20210403,5호선,개화산,2974,2940,5914
20210403,5호선,김포공항,6559,6819,13378
20210403,5호선,송정,4300,4221,8521
20210403,5호선,마곡,4252,4210,8462
20210403,5호선,발산,11152,11472,22624
20210403,5호선,우장산,8103,8167,16270
20210403,5호선,화곡,16519,15618,32137
20210403,5호선,까치산,17539,17103,34642
20210403,5호선,신정,7672,6732,14404
20210403,5호선,목동,9585,9816,19401
20210403,5호선,오목교,14233,14508,28741
20210403,5호선,양평,3230,3051,6281
20210403,5호선,영등포구청,1585,1575,3160
20210403,5호선,영등포시장,5983,6159,12142
20210403,5호선,신길,2172,2308,4480
20210403,5호선,여의도,12645,11954,24599
20210403,5호선,여의나루,5524,8114,13638
20210403,5호선,마포,6419,6367,12786
20210403,5호선,공덕,6322,6635,12957
20210403,5호선,애오개,3256,3200,6456
20210403,5호선,충정로,1775,1687,3462
20210403,5호선,서대문,5706,5330,11036
20210403,5호선,광화문,11074,11310,22384
20210403,5호선,종로3가,9431,9263,18694
20210403,5호선,을지로4가,2566,2742,5308
20210403,5호선,동대문역사문화공원,824,1073,1897
20210403,5호선,청구,2227,2075,4302
20210403,5호선,신금호,3459,3508,6967
20210403,5호선,행당,5068,4510,9578
20210403,5호선,왕십리,3104,3532,6636
20210403,5호선,마장,3330,3225,6555
20210403,5호선,답십리,8723,8185,16908
20210403,5호선,장한평,9161,9200,18361
20210403,5호선,군자,7111,7910,15021
20210403,5호선,아차산,9800,9704,19504
20210403,5호선,광나루,7496,6893,14389
20210403,5호선,천호,14054,12990,27044
20210403,5호선,강동,11262,10645,21907
20210403,5호선,길동,5397,5576,10973
20210403,5호선,굽은다리,5987,5812,11799
20210403,5호선,명일,5147,5261,10408
20210403,5호선,고덕,5114,5006,10120
20210403,5호선,상일동,8232,7930,16162
20210403,5호선,둔촌동,5281,5233,10514
20210403,5호선,올림픽공원,2167,1964,4131
20210403,5호선,방이,4315,4122,8437
20210403,5호선,오금,2115,1918,4033
20210403,5호선,개롱,4037,4252,8289
20210403,5호선,거여,4578,4508,9086
20210403,5호선,마천,3563,3708,7271
20210403,5호선,강일,1695,1695,3390
20210403,5호선,미사,9052,8909,17961
20210403,5호선,하남풍산,2407,2435,4842
20210403,5호선,하남시청,3498,3534,7032
20210403,5호선,하남검단산,3615,3727,7342
20210404,5호선,방화,3354,3263,6617
20210404,5호선,개화산,2623,2685,5308
20210404,5호선,김포공항,6707,6335,13042
20210404,5호선,송정,3521,3538,7059
20210404,5호선,마곡,3264,3336,6600
20210404,5호선,발산,8114,8512,16626
20210404,5호선,우장산,6133,6417,12550
20210404,5호선,화곡,12976,12251,25227
20210404,5호선,까치산,14740,14569,29309
20210404,5호선,신정,5873,5212,11085
20210404,5호선,목동,7150,7295,14445
20210404,5호선,오목교,10967,11484,22451
20210404,5호선,양평,2450,2550,5000
20210404,5호선,영등포구청,1355,1321,2676
20210404,5호선,영등포시장,4312,4699,9011
20210404,5호선,신길,1711,1891,3602
20210404,5호선,여의도,9337,9076,18413
20210404,5호선,여의나루,14424,14920,29344
20210404,5호선,마포,4664,4542,9206
20210404,5호선,공덕,4364,4403,8767
20210404,5호선,애오개,2507,2655,5162
20210404,5호선,충정로,1388,1417,2805
20210404,5호선,서대문,4275,4115,8390
20210404,5호선,광화문,9348,9069,18417
20210404,5호선,종로3가,7810,7106,14916
20210404,5호선,을지로4가,1369,1415,2784
20210404,5호선,동대문역사문화공원,612,754,1366
20210404,5호선,청구,1692,1507,3199
20210404,5호선,신금호,2754,2972,5726
20210404,5호선,행당,3579,3300,6879
20210404,5호선,왕십리,2416,2629,5045
20210404,5호선,마장,2635,2628,5263
20210404,5호선,답십리,6649,6209,12858
20210404,5호선,장한평,6721,6874,13595
20210404,5호선,군자,5480,5972,11452
20210404,5호선,아차산,10632,10655,21287
20210404,5호선,광나루,7019,6967,13986
20210404,5호선,천호,11702,10900,22602
20210404,5호선,강동,7952,8116,16068
20210404,5호선,길동,3886,3966,7852
20210404,5호선,굽은다리,4879,4696,9575
20210404,5호선,명일,4635,4651,9286
20210404,5호선,고덕,4045,4038,8083
20210404,5호선,상일동,6424,6308,12732
20210404,5호선,둔촌동,4245,4374,8619
20210404,5호선,올림픽공원,2182,2133,4315
20210404,5호선,방이,3473,3392,6865
20210404,5호선,오금,1520,1383,2903
20210404,5호선,개롱,2829,2999,5828
20210404,5호선,거여,3367,3390,6757
20210404,5호선,마천,3168,3425,6593
20210404,5호선,강일,1782,1729,3511
20210404,5호선,미사,7591,7552,15143
20210404,5호선,하남풍산,2194,2123,4317
20210404,5호선,하남시청,3421,3302,6723
20210404,5호선,하남검단산,4847,4952,9799
20210410,5호선,하남검단산,5851,6026,11877
20210410,5호선,하남시청,4480,4254,8734
20210410,5호선,하남풍산,2738,2706,5444
20210410,5호선,미사,10796,10710,21506
20210410,5호선,강일,2296,2141,4437
20210410,5호선,마천,4472,4482,8954
20210410,5호선,거여,5345,5234,10579
20210410,5호선,개롱,4451,4678,9129
20210410,5호선,오금,2188,2008,4196
20210410,5호선,방이,5006,4874,9880
20210410,5호선,올림픽공원,3115,2945,6060
20210410,5호선,둔촌동,6124,6009,12133
20210410,5호선,상일동,9430,8740,18170
20210410,5호선,고덕,5980,5806,11786
20210410,5호선,명일,6182,6105,12287
20210410,5호선,굽은다리,6743,6325,13068
20210410,5호선,길동,5941,6067,12008
20210410,5호선,강동,12865,12445,25310
20210410,5호선,천호,16332,15390,31722
20210410,5호선,광나루,9874,9415,19289
20210410,5호선,아차산,14168,14169,28337
20210410,5호선,군자,8560,9113,17673
20210410,5호선,장한평,10625,10371,20996
20210410,5호선,답십리,10005,9217,19222
20210410,5호선,마장,3828,3629,7457
20210410,5호선,왕십리,3477,3836,7313
20210410,5호선,행당,5553,4834,10387
20210410,5호선,신금호,4036,3997,8033
20210410,5호선,청구,2521,2269,4790
20210410,5호선,동대문역사문화공원,911,1245,2156
20210410,5호선,을지로4가,3295,3610,6905
20210410,5호선,종로3가,11538,12031,23569
20210410,5호선,광화문,13947,13909,27856
20210410,5호선,서대문,6782,6645,13427
20210410,5호선,충정로,1943,1845,3788
20210410,5호선,애오개,3810,3581,7391
20210410,5호선,공덕,6991,7351,14342
20210410,5호선,마포,7065,7220,14285
20210410,5호선,여의나루,18518,21278,39796
20210410,5호선,여의도,12294,12552,24846
20210410,5호선,신길,2470,2750,5220
20210410,5호선,영등포시장,7144,7482,14626
20210410,5호선,영등포구청,1976,1881,3857
20210410,5호선,양평,3518,3385,6903
20210410,5호선,오목교,16360,16966,33326
20210410,5호선,목동,11188,11378,22566
20210410,5호선,신정,8877,7604,16481
20210410,5호선,까치산,21007,20215,41222
20210410,5호선,화곡,19709,18186,37895
20210410,5호선,우장산,9404,9385,18789
20210410,5호선,발산,12719,13302,26021
20210410,5호선,마곡,4930,4878,9808
20210410,5호선,송정,5013,4955,9968
20210410,5호선,김포공항,7028,7538,14566
20210410,5호선,개화산,3642,3615,7257
20210410,5호선,방화,4545,4322,8867
20210411,5호선,발산,8576,8926,17502
20210411,5호선,하남검단산,5183,5259,10442
20210411,5호선,하남시청,3117,2959,6076
20210411,5호선,하남풍산,2141,2132,4273
20210411,5호선,미사,7776,7826,15602
20210411,5호선,강일,1817,1774,3591
20210411,5호선,마천,3272,3578,6850
20210411,5호선,거여,3451,3389,6840
20210411,5호선,개롱,2876,3128,6004
20210411,5호선,오금,1597,1489,3086
20210411,5호선,방이,3654,3508,7162
20210411,5호선,올림픽공원,2190,2108,4298
20210411,5호선,둔촌동,4404,4472,8876
20210411,5호선,상일동,6422,6300,12722
20210411,5호선,고덕,3888,3812,7700
20210411,5호선,명일,4639,4692,9331
20210411,5호선,굽은다리,4922,4580,9502
20210411,5호선,길동,3920,4162,8082
20210411,5호선,강동,8350,8503,16853
20210411,5호선,천호,11731,11002,22733
20210411,5호선,광나루,7524,7486,15010
20210411,5호선,아차산,11604,11547,23151
20210411,5호선,군자,5729,6318,12047
20210411,5호선,장한평,6761,6761,13522
20210411,5호선,답십리,6863,6526,13389
20210411,5호선,마장,2695,2576,5271
20210411,5호선,왕십리,2236,2527,4763
20210411,5호선,행당,3805,3540,7345
20210411,5호선,신금호,3034,3197,6231
20210411,5호선,청구,1732,1465,3197
20210411,5호선,동대문역사문화공원,649,824,1473
20210411,5호선,을지로4가,1450,1430,2880
20210411,5호선,종로3가,7606,7220,14826
20210411,5호선,광화문,10028,9906,19934
20210411,5호선,서대문,4795,4610,9405
20210411,5호선,충정로,1428,1466,2894
20210411,5호선,애오개,2471,2591,5062
20210411,5호선,공덕,4409,4350,8759
20210411,5호선,마포,4333,4287,8620
20210411,5호선,여의나루,15575,16911,32486
20210411,5호선,여의도,8318,8341,16659
20210411,5호선,신길,1838,2020,3858
20210411,5호선,영등포시장,4370,4633,9003
20210411,5호선,영등포구청,1262,1254,2516
20210411,5호선,양평,2433,2442,4875
20210411,5호선,오목교,10878,11251,22129
20210411,5호선,목동,7151,7464,14615
20210411,5호선,신정,6249,5538,11787
20210411,5호선,까치산,15016,15103,30119
20210411,5호선,화곡,13654,12926,26580
20210411,5호선,우장산,6251,6483,12734
20210411,5호선,마곡,3429,3588,7017
20210411,5호선,송정,3681,3729,7410
20210411,5호선,김포공항,6654,5915,12569
20210411,5호선,개화산,2642,2842,5484
20210411,5호선,방화,3259,3247,6506
20210417,5호선,하남검단산,4589,4767,9356
20210417,5호선,하남시청,4090,4005,8095
20210417,5호선,하남풍산,2582,2634,5216
20210417,5호선,미사,10503,10349,20852
20210417,5호선,강일,2164,2020,4184
20210417,5호선,마천,4241,4378,8619
20210417,5호선,거여,5325,4990,10315
20210417,5호선,개롱,4259,4538,8797
20210417,5호선,오금,2557,2382,4939
20210417,5호선,방이,4944,4862,9806
20210417,5호선,올림픽공원,2694,2262,4956
20210417,5호선,둔촌동,5897,5874,11771
20210417,5호선,상일동,9058,8572,17630
20210417,5호선,고덕,5728,5558,11286
20210417,5호선,명일,5984,5922,11906
20210417,5호선,굽은다리,6814,6442,13256
20210417,5호선,길동,5568,5799,11367
20210417,5호선,강동,11972,11309,23281
20210417,5호선,천호,15422,14401,29823
20210417,5호선,광나루,8617,8245,16862
20210417,5호선,아차산,12053,11911,23964
20210417,5호선,군자,8091,8799,16890
20210417,5호선,장한평,10089,9958,20047
20210417,5호선,답십리,9578,8963,18541
20210417,5호선,마장,3990,3841,7831
20210417,5호선,왕십리,3342,3738,7080
20210417,5호선,행당,5571,4911,10482
20210417,5호선,신금호,3762,3800,7562
20210417,5호선,청구,2381,2199,4580
20210417,5호선,동대문역사문화공원,844,1055,1899
20210417,5호선,을지로4가,3049,3333,6382
20210417,5호선,종로3가,10582,10756,21338
20210417,5호선,광화문,11643,12031,23674
20210417,5호선,서대문,6905,6415,13320
20210417,5호선,충정로,1920,1692,3612
20210417,5호선,애오개,3523,3460,6983
20210417,5호선,공덕,6547,6784,13331
20210417,5호선,마포,6689,6772,13461
20210417,5호선,여의나루,9118,11291,20409
20210417,5호선,여의도,11780,11691,23471
20210417,5호선,신길,2390,2570,4960
20210417,5호선,영등포시장,6533,6886,13419
20210417,5호선,영등포구청,1910,1823,3733
20210417,5호선,양평,3357,3197,6554
20210417,5호선,오목교,15302,15584,30886
20210417,5호선,목동,10642,10808,21450
20210417,5호선,신정,8417,7167,15584
20210417,5호선,까치산,19809,19004,38813
20210417,5호선,화곡,18943,17592,36535
20210417,5호선,우장산,8958,8999,17957
20210417,5호선,발산,12364,12948,25312
20210417,5호선,마곡,4744,4726,9470
20210417,5호선,송정,4811,4704,9515
20210417,5호선,김포공항,6944,7261,14205
20210417,5호선,개화산,3419,3425,6844
20210417,5호선,방화,4462,4181,8643
20210418,5호선,하남검단산,4911,4895,9806
20210418,5호선,하남시청,3104,2999,6103
20210418,5호선,하남풍산,2035,2083,4118
20210418,5호선,미사,7764,7742,15506
20210418,5호선,강일,1691,1593,3284
20210418,5호선,마천,3235,3561,6796
20210418,5호선,거여,3462,3442,6904
20210418,5호선,개롱,2840,3126,5966
20210418,5호선,오금,1503,1353,2856
20210418,5호선,방이,3575,3525,7100
20210418,5호선,올림픽공원,2182,1904,4086
20210418,5호선,둔촌동,4199,4383,8582
20210418,5호선,상일동,6486,6221,12707
20210418,5호선,고덕,4038,4052,8090
20210418,5호선,명일,4364,4409,8773
20210418,5호선,굽은다리,4991,4650,9641
20210418,5호선,길동,3872,4077,7949
20210418,5호선,강동,8370,8385,16755
20210418,5호선,천호,11624,10718,22342
20210418,5호선,광나루,7250,7068,14318
20210418,5호선,아차산,11209,11395,22604
20210418,5호선,군자,5527,6223,11750
20210418,5호선,장한평,6683,6677,13360
20210418,5호선,답십리,6769,6440,13209
20210418,5호선,마장,2648,2570,5218
20210418,5호선,왕십리,2379,2535,4914
20210418,5호선,행당,3693,3256,6949
20210418,5호선,신금호,2648,2881,5529
20210418,5호선,청구,1671,1547,3218
20210418,5호선,동대문역사문화공원,588,754,1342
20210418,5호선,을지로4가,1421,1470,2891
20210418,5호선,종로3가,7231,6745,13976
20210418,5호선,광화문,9609,9364,18973
20210418,5호선,서대문,4363,4267,8630
20210418,5호선,충정로,1328,1410,2738
20210418,5호선,애오개,2503,2621,5124
20210418,5호선,공덕,4199,4220,8419
20210418,5호선,마포,4470,4446,8916
20210418,5호선,여의나루,10904,12481,23385
20210418,5호선,여의도,8016,7648,15664
20210418,5호선,신길,1771,1998,3769
20210418,5호선,영등포시장,4275,4585,8860
20210418,5호선,영등포구청,1246,1246,2492
20210418,5호선,양평,2465,2611,5076
20210418,5호선,오목교,10532,10884,21416
20210418,5호선,목동,7024,7288,14312
20210418,5호선,신정,5833,5299,11132
20210418,5호선,까치산,14782,14634,29416
20210418,5호선,화곡,13256,12424,25680
20210418,5호선,우장산,6118,6383,12501
20210418,5호선,발산,7822,8272,16094
20210418,5호선,마곡,3208,3350,6558
20210418,5호선,송정,3555,3604,7159
20210418,5호선,김포공항,6738,6122,12860
20210418,5호선,개화산,2557,2694,5251
20210418,5호선,방화,3304,3283,6587
20210424,5호선,까치산,20738,19737,40475
20210424,5호선,신정,8716,7270,15986
20210424,5호선,목동,10695,10914,21609
20210424,5호선,오목교,16083,16784,32867
20210424,5호선,양평,3645,3511,7156
20210424,5호선,영등포구청,1980,1920,3900
20210424,5호선,영등포시장,6686,7040,13726
20210424,5호선,신길,2539,2564,5103
20210424,5호선,여의도,10828,11473,22301
20210424,5호선,여의나루,15983,17906,33889
20210424,5호선,마포,6882,6921,13803
20210424,5호선,공덕,6730,6981,13711
20210424,5호선,애오개,3486,3367,6853
20210424,5호선,충정로,1966,1737,3703
20210424,5호선,서대문,6647,6554,13201
20210424,5호선,광화문,13010,13128,26138
20210424,5호선,종로3가,10903,11399,22302
20210424,5호선,을지로4가,3165,3531,6696
20210424,5호선,동대문역사문화공원,919,1183,2102
20210424,5호선,청구,2396,2175,4571
20210424,5호선,신금호,3864,3904,7768
20210424,5호선,행당,5497,4645,10142
20210424,5호선,왕십리,3239,3805,7044
20210424,5호선,마장,3729,3543,7272
20210424,5호선,답십리,9650,8872,18522
20210424,5호선,장한평,10686,10221,20907
20210424,5호선,군자,8009,8495,16504
20210424,5호선,아차산,12887,12901,25788
20210424,5호선,광나루,9842,9209,19051
20210424,5호선,천호,16002,15261,31263
20210424,5호선,강동,11826,11234,23060
20210424,5호선,길동,5775,5828,11603
20210424,5호선,굽은다리,6724,6224,12948
20210424,5호선,명일,5866,5792,11658
20210424,5호선,고덕,5893,5768,11661
20210424,5호선,상일동,9364,8654,18018
20210424,5호선,둔촌동,5847,5850,11697
20210424,5호선,올림픽공원,2893,2485,5378
20210424,5호선,방이,4903,4733,9636
20210424,5호선,오금,2231,2009,4240
20210424,5호선,개롱,4153,4347,8500
20210424,5호선,거여,5297,5055,10352
20210424,5호선,마천,4417,4489,8906
20210424,5호선,강일,2229,2081,4310
20210424,5호선,미사,10658,10726,21384
20210424,5호선,하남풍산,2664,2605,5269
20210424,5호선,하남시청,4485,4428,8913
20210424,5호선,하남검단산,5190,5300,10490
20210424,5호선,방화,4795,4570,9365
20210424,5호선,개화산,3622,3582,7204
20210424,5호선,김포공항,6914,7406,14320
20210424,5호선,송정,4949,4744,9693
20210424,5호선,마곡,4823,4864,9687
20210424,5호선,발산,13308,13971,27279
20210424,5호선,우장산,9257,9164,18421
20210424,5호선,화곡,19466,17791,37257
20210425,5호선,하남검단산,4732,4768,9500
20210425,5호선,하남시청,3214,2904,6118
20210425,5호선,하남풍산,2127,2145,4272
20210425,5호선,미사,7681,7795,15476
20210425,5호선,강일,1628,1690,3318
20210425,5호선,마천,3240,3608,6848
20210425,5호선,거여,3722,3668,7390
20210425,5호선,개롱,2845,3148,5993
20210425,5호선,오금,1596,1464,3060
20210425,5호선,방이,3769,3568,7337
20210425,5호선,올림픽공원,2060,2028,4088
20210425,5호선,둔촌동,4185,4196,8381
20210425,5호선,상일동,6445,6216,12661
20210425,5호선,고덕,3967,3897,7864
20210425,5호선,명일,4441,4489,8930
20210425,5호선,굽은다리,4673,4434,9107
20210425,5호선,길동,3951,4011,7962
20210425,5호선,강동,8318,8376,16694
20210425,5호선,천호,11294,10475,21769
20210425,5호선,광나루,7374,7440,14814
20210425,5호선,아차산,11425,11643,23068
20210425,5호선,군자,5692,6071,11763
20210425,5호선,장한평,6687,6695,13382
20210425,5호선,답십리,6789,6406,13195
20210425,5호선,마장,2767,2522,5289
20210425,5호선,왕십리,2259,2514,4773
20210425,5호선,행당,3814,3478,7292
20210425,5호선,신금호,2781,2968,5749
20210425,5호선,청구,1712,1523,3235
20210425,5호선,동대문역사문화공원,655,852,1507
20210425,5호선,을지로4가,1434,1558,2992
20210425,5호선,종로3가,7390,7027,14417
20210425,5호선,광화문,9617,9551,19168
20210425,5호선,서대문,4345,4342,8687
20210425,5호선,충정로,1403,1419,2822
20210425,5호선,애오개,2564,2614,5178
20210425,5호선,공덕,4382,4407,8789
20210425,5호선,마포,4480,4552,9032
20210425,5호선,여의나루,15442,16356,31798
20210425,5호선,여의도,7311,7754,15065
20210425,5호선,신길,1817,1948,3765
20210425,5호선,영등포시장,4001,4141,8142
20210425,5호선,영등포구청,1301,1271,2572
20210425,5호선,양평,2505,2457,4962
20210425,5호선,오목교,11011,11282,22293
20210425,5호선,목동,7268,7509,14777
20210425,5호선,신정,6023,5356,11379
20210425,5호선,까치산,14741,14543,29284
20210425,5호선,화곡,13434,12792,26226
20210425,5호선,우장산,6108,6225,12333
20210425,5호선,발산,8531,8830,17361
20210425,5호선,마곡,3337,3491,6828
20210425,5호선,송정,3612,3654,7266
20210425,5호선,김포공항,6739,6151,12890
20210425,5호선,개화산,2585,2842,5427
20210425,5호선,방화,3662,3605,7267
20210501,5호선,올림픽공원,2406,1953,4359
20210501,5호선,방이,4454,4330,8784
20210501,5호선,오금,2047,1889,3936
20210501,5호선,개롱,3667,3832,7499
20210501,5호선,거여,4254,4158,8412
20210501,5호선,마천,3633,3768,7401
20210501,5호선,강일,1847,1780,3627
20210501,5호선,미사,9348,9153,18501
20210501,5호선,하남풍산,2319,2417,4736
20210501,5호선,하남시청,3829,3728,7557
20210501,5호선,하남검단산,4032,4180,8212
20210501,5호선,고덕,4900,4891,9791
20210501,5호선,명일,5125,5212,10337
20210501,5호선,굽은다리,6209,5897,12106
20210501,5호선,길동,5317,5548,10865
20210501,5호선,강동,10935,10470,21405
20210501,5호선,천호,15026,13681,28707
20210501,5호선,광나루,7991,7427,15418
20210501,5호선,아차산,10476,10284,20760
20210501,5호선,군자,7569,8370,15939
20210501,5호선,장한평,9463,9355,18818
20210501,5호선,답십리,9133,8521,17654
20210501,5호선,마장,3465,3386,6851
20210501,5호선,왕십리,3153,3563,6716
20210501,5호선,행당,4783,4163,8946
20210501,5호선,신금호,3541,3682,7223
20210501,5호선,청구,2264,2072,4336
20210501,5호선,동대문역사문화공원,909,1168,2077
20210501,5호선,을지로4가,2973,3386,6359
20210501,5호선,종로3가,11340,10915,22255
20210501,5호선,광화문,12313,12388,24701
20210501,5호선,서대문,5822,5670,11492
20210501,5호선,충정로,1857,1761,3618
20210501,5호선,애오개,3355,3289,6644
20210501,5호선,공덕,6925,6898,13823
20210501,5호선,마포,7045,6525,13570
20210501,5호선,여의나루,7497,11165,18662
20210501,5호선,여의도,12743,11626,24369
20210501,5호선,신길,2253,2463,4716
20210501,5호선,영등포시장,6348,6858,13206
20210501,5호선,영등포구청,1682,1695,3377
20210501,5호선,양평,3251,3101,6352
20210501,5호선,오목교,15144,15464,30608
20210501,5호선,목동,10157,10299,20456
20210501,5호선,신정,7912,6836,14748
20210501,5호선,까치산,18818,18198,37016
20210501,5호선,화곡,17535,16511,34046
20210501,5호선,우장산,8742,8555,17297
20210501,5호선,발산,11932,12400,24332
20210501,5호선,마곡,4703,4658,9361
20210501,5호선,송정,4635,4575,9210
20210501,5호선,김포공항,7260,7146,14406
20210501,5호선,개화산,3231,3155,6386
20210501,5호선,방화,4102,3894,7996
20210501,5호선,둔촌동,5156,5188,10344
20210501,5호선,상일동,8508,8000,16508
20210502,5호선,방화,3501,3446,6947
20210502,5호선,개화산,2694,2785,5479
20210502,5호선,김포공항,6900,6400,13300
20210502,5호선,송정,3644,3761,7405
20210502,5호선,마곡,3304,3500,6804
20210502,5호선,발산,8345,8832,17177
20210502,5호선,우장산,6282,6543,12825
20210502,5호선,화곡,13651,12961,26612
20210502,5호선,까치산,14990,14800,29790
20210502,5호선,신정,6018,5509,11527
20210502,5호선,목동,7586,7728,15314
20210502,5호선,오목교,11730,12005,23735
20210502,5호선,양평,2503,2525,5028
20210502,5호선,영등포구청,1313,1280,2593
20210502,5호선,영등포시장,4155,4580,8735
20210502,5호선,신길,1783,1988,3771
20210502,5호선,여의도,8459,8204,16663
20210502,5호선,여의나루,17438,18527,35965
20210502,5호선,마포,4624,4530,9154
20210502,5호선,공덕,4380,4405,8785
20210502,5호선,애오개,2577,2523,5100
20210502,5호선,충정로,1407,1355,2762
20210502,5호선,서대문,4527,4471,8998
20210502,5호선,광화문,10483,10315,20798
20210502,5호선,종로3가,8286,7529,15815
20210502,5호선,을지로4가,1396,1480,2876
20210502,5호선,동대문역사문화공원,633,714,1347
20210502,5호선,청구,1699,1517,3216
20210502,5호선,신금호,2837,3078,5915
20210502,5호선,행당,3785,3462,7247
20210502,5호선,왕십리,2377,2680,5057
20210502,5호선,마장,2677,2557,5234
20210502,5호선,답십리,6913,6481,13394
20210502,5호선,장한평,7043,6978,14021
20210502,5호선,군자,5680,6224,11904
20210502,5호선,아차산,11102,11168,22270
20210502,5호선,광나루,7438,7319,14757
20210502,5호선,천호,12153,11336,23489
20210502,5호선,강동,8024,7903,15927
20210502,5호선,길동,4022,4182,8204
20210502,5호선,굽은다리,5014,4743,9757
20210502,5호선,명일,4465,4524,8989
20210502,5호선,고덕,4078,4170,8248
20210502,5호선,상일동,6783,6607,13390
20210502,5호선,둔촌동,4340,4519,8859
20210502,5호선,올림픽공원,2226,2046,4272
20210502,5호선,방이,3556,3423,6979
20210502,5호선,오금,1449,1357,2806
20210502,5호선,개롱,2956,3274,6230
20210502,5호선,거여,3484,3462,6946
20210502,5호선,마천,3266,3541,6807
20210502,5호선,강일,1748,1697,3445
20210502,5호선,미사,7878,7895,15773
20210502,5호선,하남풍산,2033,1978,4011
20210502,5호선,하남시청,3182,3074,6256
20210502,5호선,하남검단산,4766,4824,9590
20210508,5호선,신길,2105,2110,4215
20210508,5호선,방화,4201,4019,8220
20210508,5호선,개화산,3296,3319,6615
20210508,5호선,김포공항,6862,6939,13801
20210508,5호선,송정,4571,4450,9021
20210508,5호선,마곡,4458,4438,8896
20210508,5호선,발산,11390,11964,23354
20210508,5호선,우장산,8519,8667,17186
20210508,5호선,화곡,17856,16462,34318
20210508,5호선,까치산,19247,18224,37471
20210508,5호선,신정,7935,6929,14864
20210508,5호선,목동,9950,10124,20074
20210508,5호선,오목교,14670,15320,29990
20210508,5호선,양평,3175,2959,6134
20210508,5호선,영등포구청,1743,1672,3415
20210508,5호선,영등포시장,5767,5945,11712
20210508,5호선,여의도,9535,9674,19209
20210508,5호선,여의나루,10717,12218,22935
20210508,5호선,마포,6208,6294,12502
20210508,5호선,공덕,5866,5711,11577
20210508,5호선,애오개,3208,3066,6274
20210508,5호선,충정로,1728,1599,3327
20210508,5호선,서대문,5654,5427,11081
20210508,5호선,광화문,10727,11015,21742
20210508,5호선,종로3가,8663,9048,17711
20210508,5호선,을지로4가,2580,2821,5401
20210508,5호선,동대문역사문화공원,763,970,1733
20210508,5호선,청구,2259,1963,4222
20210508,5호선,신금호,3629,3746,7375
20210508,5호선,행당,4834,4352,9186
20210508,5호선,왕십리,2955,3249,6204
20210508,5호선,마장,3316,3296,6612
20210508,5호선,답십리,9234,8420,17654
20210508,5호선,장한평,9538,9393,18931
20210508,5호선,군자,7295,7825,15120
20210508,5호선,아차산,11090,11093,22183
20210508,5호선,광나루,7879,7536,15415
20210508,5호선,천호,14178,13062,27240
20210508,5호선,강동,10434,9664,20098
20210508,5호선,길동,5253,5394,10647
20210508,5호선,굽은다리,6059,5797,11856
20210508,5호선,명일,5132,5148,10280
20210508,5호선,고덕,5351,5335,10686
20210508,5호선,상일동,8232,7803,16035
20210508,5호선,둔촌동,5416,5434,10850
20210508,5호선,올림픽공원,2442,2120,4562
20210508,5호선,방이,4375,4463,8838
20210508,5호선,오금,1914,1796,3710
20210508,5호선,개롱,3656,3904,7560
20210508,5호선,거여,4620,4558,9178
20210508,5호선,마천,3972,4013,7985
20210508,5호선,강일,1914,1878,3792
20210508,5호선,미사,9299,9066,18365
20210508,5호선,하남풍산,2262,2306,4568
20210508,5호선,하남시청,3671,3656,7327
20210508,5호선,하남검단산,3929,4080,8009
20210509,5호선,하남검단산,4581,4569,9150
20210509,5호선,하남시청,3555,3338,6893
20210509,5호선,하남풍산,2127,2026,4153
20210509,5호선,미사,7684,7963,15647
20210509,5호선,강일,1769,1702,3471
20210509,5호선,마천,3360,3545,6905
20210509,5호선,거여,3483,3422,6905
20210509,5호선,개롱,2859,3130,5989
20210509,5호선,오금,1461,1395,2856
20210509,5호선,방이,3536,3399,6935
20210509,5호선,올림픽공원,2263,1935,4198
20210509,5호선,둔촌동,4190,4337,8527
20210509,5호선,상일동,6754,6525,13279
20210509,5호선,고덕,3919,3937,7856
20210509,5호선,명일,4465,4494,8959
20210509,5호선,굽은다리,4702,4490,9192
20210509,5호선,길동,3770,3837,7607
20210509,5호선,강동,8075,8256,16331
20210509,5호선,천호,11292,10837,22129
20210509,5호선,광나루,7765,7688,15453
20210509,5호선,아차산,11156,11039,22195
20210509,5호선,군자,5661,6314,11975
20210509,5호선,장한평,7033,7090,14123
20210509,5호선,답십리,6763,6444,13207
20210509,5호선,마장,2798,2711,5509
20210509,5호선,왕십리,2122,2457,4579
20210509,5호선,행당,3880,3551,7431
20210509,5호선,신금호,2778,3026,5804
20210509,5호선,청구,1682,1510,3192
20210509,5호선,동대문역사문화공원,570,771,1341
20210509,5호선,을지로4가,1271,1327,2598
20210509,5호선,종로3가,7942,7549,15491
20210509,5호선,광화문,9777,9786,19563
20210509,5호선,방화,3511,3401,6912
20210509,5호선,개화산,2756,2799,5555
20210509,5호선,김포공항,6840,5975,12815
20210509,5호선,송정,3472,3583,7055
20210509,5호선,마곡,3244,3516,6760
20210509,5호선,발산,8310,8698,17008
20210509,5호선,우장산,6293,6500,12793
20210509,5호선,화곡,13498,13079,26577
20210509,5호선,까치산,14756,14891,29647
20210509,5호선,신정,6102,5523,11625
20210509,5호선,목동,7274,7495,14769
20210509,5호선,오목교,11104,11365,22469
20210509,5호선,양평,2255,2561,4816
20210509,5호선,영등포구청,1250,1269,2519
20210509,5호선,영등포시장,3959,4416,8375
20210509,5호선,신길,1664,1973,3637
20210509,5호선,여의도,7577,7620,15197
20210509,5호선,여의나루,16640,17929,34569
20210509,5호선,마포,4557,4492,9049
20210509,5호선,공덕,4175,4275,8450
20210509,5호선,애오개,2389,2539,4928
20210509,5호선,충정로,1302,1363,2665
20210509,5호선,서대문,4379,4338,8717
20210515,5호선,방화,4575,4384,8959
20210515,5호선,개화산,3407,3324,6731
20210515,5호선,김포공항,6976,6992,13968
20210515,5호선,송정,4775,4752,9527
20210515,5호선,마곡,5003,5018,10021
20210515,5호선,발산,12596,13166,25762
20210515,5호선,우장산,9005,9167,18172
20210515,5호선,화곡,18430,17200,35630
20210515,5호선,까치산,19414,18885,38299
20210515,5호선,신정,8426,7446,15872
20210515,5호선,목동,10665,10997,21662
20210515,5호선,오목교,16020,16161,32181
20210515,5호선,양평,3465,3363,6828
20210515,5호선,영등포구청,1712,1765,3477
20210515,5호선,영등포시장,6621,7021,13642
20210515,5호선,신길,2318,2494,4812
20210515,5호선,여의도,12610,11868,24478
20210515,5호선,여의나루,5764,9046,14810
20210515,5호선,마포,6774,6932,13706
20210515,5호선,공덕,6726,6969,13695
20210515,5호선,애오개,3572,3574,7146
20210515,5호선,충정로,1867,1748,3615
20210515,5호선,서대문,6970,6752,13722
20210515,5호선,광화문,12739,13022,25761
20210515,5호선,종로3가,11313,11221,22534
20210515,5호선,을지로4가,3042,3392,6434
20210515,5호선,동대문역사문화공원,979,1266,2245
20210515,5호선,청구,2416,2205,4621
20210515,5호선,신금호,3831,3894,7725
20210515,5호선,행당,5473,4943,10416
20210515,5호선,왕십리,3226,3679,6905
20210515,5호선,마장,3532,3480,7012
20210515,5호선,답십리,9716,8857,18573
20210515,5호선,장한평,10357,10324,20681
20210515,5호선,군자,7861,8716,16577
20210515,5호선,아차산,11976,11672,23648
20210515,5호선,광나루,9463,8771,18234
20210515,5호선,천호,15631,14557,30188
20210515,5호선,강동,12128,11746,23874
20210515,5호선,길동,5673,5828,11501
20210515,5호선,굽은다리,6715,6390,13105
20210515,5호선,명일,6066,6115,12181
20210515,5호선,고덕,5850,5612,11462
20210515,5호선,상일동,9127,8720,17847
20210515,5호선,둔촌동,6019,6026,12045
20210515,5호선,올림픽공원,2741,2336,5077
20210515,5호선,방이,5300,5124,10424
20210515,5호선,오금,2522,2364,4886
20210515,5호선,개롱,4182,4359,8541
20210515,5호선,거여,5361,5151,10512
20210515,5호선,마천,4281,4330,8611
20210515,5호선,강일,2165,2078,4243
20210515,5호선,미사,10307,10200,20507
20210515,5호선,하남풍산,2473,2512,4985
20210515,5호선,하남시청,3898,3852,7750
20210515,5호선,하남검단산,4432,4486,8918
20210516,5호선,방화,2791,2876,5667
20210516,5호선,개화산,2096,2167,4263
20210516,5호선,김포공항,6231,5595,11826
20210516,5호선,송정,3028,3021,6049
20210516,5호선,마곡,2917,3050,5967
20210516,5호선,발산,7347,7802,15149
20210516,5호선,우장산,5204,5342,10546
20210516,5호선,화곡,11022,10517,21539
20210516,5호선,까치산,12310,12113,24423
20210516,5호선,신정,5157,4805,9962
20210516,5호선,목동,6087,6347,12434
20210516,5호선,오목교,9483,9696,19179
20210516,5호선,양평,2167,2265,4432
20210516,5호선,영등포구청,1022,976,1998
20210516,5호선,영등포시장,3609,3812,7421
20210516,5호선,신길,1497,1756,3253
20210516,5호선,여의도,7589,7023,14612
20210516,5호선,여의나루,3672,5756,9428
20210516,5호선,마포,3915,4033,7948
20210516,5호선,공덕,3613,3786,7399
20210516,5호선,애오개,2300,2290,4590
20210516,5호선,충정로,1169,1181,2350
20210516,5호선,서대문,3823,3838,7661
20210516,5호선,광화문,7876,7929,15805
20210516,5호선,종로3가,6377,5601,11978
20210516,5호선,을지로4가,1079,1133,2212
20210516,5호선,동대문역사문화공원,564,618,1182
20210516,5호선,청구,1474,1360,2834
20210516,5호선,신금호,2206,2451,4657
20210516,5호선,행당,2969,2783,5752
20210516,5호선,왕십리,1975,2234,4209
20210516,5호선,마장,2416,2344,4760
20210516,5호선,답십리,5740,5540,11280
20210516,5호선,장한평,5843,5902,11745
20210516,5호선,군자,4717,5348,10065
20210516,5호선,아차산,6992,6981,13973
20210516,5호선,광나루,5123,4646,9769
20210516,5호선,천호,9994,8936,18930
20210516,5호선,강동,7313,7418,14731
20210516,5호선,길동,3366,3509,6875
20210516,5호선,굽은다리,4337,4116,8453
20210516,5호선,명일,3764,3765,7529
20210516,5호선,고덕,3449,3438,6887
20210516,5호선,상일동,5524,5346,10870
20210516,5호선,둔촌동,3797,3852,7649
20210516,5호선,올림픽공원,1435,1293,2728
20210516,5호선,방이,3443,3307,6750
20210516,5호선,오금,1381,1216,2597
20210516,5호선,개롱,2244,2553,4797
20210516,5호선,거여,2937,2930,5867
20210516,5호선,마천,2470,2727,5197
20210516,5호선,강일,1176,1241,2417
20210516,5호선,미사,6084,6014,12098
20210516,5호선,하남풍산,1682,1721,3403
20210516,5호선,하남시청,2343,2406,4749
20210516,5호선,하남검단산,2557,2632,5189
20210522,5호선,하남검단산,5383,5330,10713
20210522,5호선,하남시청,4373,4320,8693
20210522,5호선,하남풍산,2782,2781,5563
20210522,5호선,미사,11102,10967,22069
20210522,5호선,강일,2453,2301,4754
20210522,5호선,마천,4631,4747,9378
20210522,5호선,거여,5383,5071,10454
20210522,5호선,개롱,4499,4731,9230
20210522,5호선,오금,2244,2055,4299
20210522,5호선,방이,5247,5023,10270
20210522,5호선,올림픽공원,3286,3063,6349
20210522,5호선,둔촌동,6168,6143,12311
20210522,5호선,상일동,9920,9195,19115
20210522,5호선,고덕,6352,6313,12665
20210522,5호선,명일,6063,6091,12154
20210522,5호선,굽은다리,7191,6631,13822
20210522,5호선,길동,5940,6040,11980
20210522,5호선,강동,12588,11888,24476
20210522,5호선,천호,16640,15860,32500
20210522,5호선,광나루,10289,9990,20279
20210522,5호선,아차산,14066,13813,27879
20210522,5호선,군자,8404,9034,17438
20210522,5호선,장한평,10955,10672,21627
20210522,5호선,답십리,10169,9212,19381
20210522,5호선,마장,3773,3564,7337
20210522,5호선,왕십리,3358,3917,7275
20210522,5호선,행당,5868,5183,11051
20210522,5호선,신금호,4246,4177,8423
20210522,5호선,청구,2460,2157,4617
20210522,5호선,동대문역사문화공원,988,1326,2314
20210522,5호선,을지로4가,3415,3733,7148
20210522,5호선,종로3가,12269,12577,24846
20210522,5호선,광화문,14814,15360,30174
20210522,5호선,서대문,7316,7117,14433
20210522,5호선,충정로,2083,1877,3960
20210522,5호선,애오개,3758,3702,7460
20210522,5호선,공덕,7375,7425,14800
20210522,5호선,마포,7388,7297,14685
20210522,5호선,여의나루,16383,18123,34506
20210522,5호선,여의도,11609,12241,23850
20210522,5호선,신길,2490,2613,5103
20210522,5호선,영등포시장,6872,7390,14262
20210522,5호선,영등포구청,2014,1939,3953
20210522,5호선,양평,3813,3569,7382
20210522,5호선,오목교,16810,17327,34137
20210522,5호선,목동,11461,11671,23132
20210522,5호선,신정,8989,7516,16505
20210522,5호선,까치산,20971,20002,40973
20210522,5호선,화곡,20218,18435,38653
20210522,5호선,우장산,9888,9767,19655
20210522,5호선,발산,13580,14516,28096
20210522,5호선,마곡,5229,5307,10536
20210522,5호선,송정,5129,4912,10041
20210522,5호선,김포공항,7369,7294,14663
20210522,5호선,개화산,3738,3790,7528
20210522,5호선,방화,4800,4555,9355
20210523,5호선,방화,3686,3629,7315
20210523,5호선,개화산,2622,2798,5420
20210523,5호선,김포공항,6627,5958,12585
20210523,5호선,송정,3588,3701,7289
20210523,5호선,마곡,3536,3696,7232
20210523,5호선,발산,8347,8879,17226
20210523,5호선,우장산,6306,6544,12850
20210523,5호선,화곡,13216,12670,25886
20210523,5호선,까치산,14802,14596,29398
20210523,5호선,신정,6032,5432,11464
20210523,5호선,목동,7236,7462,14698
20210523,5호선,오목교,10490,10873,21363
20210523,5호선,양평,2342,2403,4745
20210523,5호선,영등포구청,1299,1343,2642
20210523,5호선,영등포시장,4302,4402,8704
20210523,5호선,신길,1738,1833,3571
20210523,5호선,여의도,7436,7722,15158
20210523,5호선,여의나루,12054,13201,25255
20210523,5호선,마포,4389,4358,8747
20210523,5호선,공덕,4132,4166,8298
20210523,5호선,애오개,2535,2621,5156
20210523,5호선,충정로,1324,1340,2664
20210523,5호선,서대문,5293,5195,10488
20210523,5호선,광화문,11224,11380,22604
20210523,5호선,종로3가,8070,7574,15644
20210523,5호선,을지로4가,1443,1459,2902
20210523,5호선,동대문역사문화공원,673,828,1501
20210523,5호선,청구,1655,1447,3102
20210523,5호선,신금호,2812,3050,5862
20210523,5호선,행당,3879,3586,7465
20210523,5호선,왕십리,2243,2618,4861
20210523,5호선,마장,2816,2648,5464
20210523,5호선,답십리,6871,6521,13392
20210523,5호선,장한평,7105,7022,14127
20210523,5호선,군자,5615,6248,11863
20210523,5호선,아차산,11160,11142,22302
20210523,5호선,광나루,7511,7675,15186
20210523,5호선,천호,11599,10950,22549
20210523,5호선,강동,8319,8298,16617
20210523,5호선,길동,3936,3947,7883
20210523,5호선,굽은다리,4939,4589,9528
20210523,5호선,명일,4543,4602,9145
20210523,5호선,고덕,4078,4018,8096
20210523,5호선,상일동,6663,6526,13189
20210523,5호선,둔촌동,4568,4678,9246
20210523,5호선,올림픽공원,2357,2114,4471
20210523,5호선,방이,3672,3627,7299
20210523,5호선,오금,1396,1334,2730
20210523,5호선,개롱,2818,3208,6026
20210523,5호선,거여,3702,3548,7250
20210523,5호선,마천,3469,3715,7184
20210523,5호선,강일,1730,1693,3423
20210523,5호선,미사,7809,7693,15502
20210523,5호선,하남풍산,1997,2062,4059
20210523,5호선,하남시청,3139,2989,6128
20210523,5호선,하남검단산,4452,4598,9050
20210529,5호선,방화,4576,4326,8902
20210529,5호선,개화산,3639,3479,7118
20210529,5호선,김포공항,7149,7299,14448
20210529,5호선,송정,4832,4690,9522
20210529,5호선,마곡,5017,5000,10017
20210529,5호선,발산,12832,13723,26555
20210529,5호선,우장산,9312,9237,18549
20210529,5호선,화곡,19306,17751,37057
20210529,5호선,까치산,20404,19445,39849
20210529,5호선,신정,8672,7417,16089
20210529,5호선,목동,10841,11081,21922
20210529,5호선,오목교,16008,16459,32467
20210529,5호선,양평,3694,3535,7229
20210529,5호선,영등포구청,1996,1872,3868
20210529,5호선,영등포시장,6677,6998,13675
20210529,5호선,신길,2418,2531,4949
20210529,5호선,여의도,11845,11822,23667
20210529,5호선,여의나루,8127,10987,19114
20210529,5호선,마포,6894,6882,13776
20210529,5호선,공덕,6551,6791,13342
20210529,5호선,애오개,3562,3523,7085
20210529,5호선,충정로,1952,1820,3772
20210529,5호선,서대문,6921,6653,13574
20210529,5호선,광화문,13247,13466,26713
20210529,5호선,종로3가,11522,11527,23049
20210529,5호선,을지로4가,3194,3779,6973
20210529,5호선,동대문역사문화공원,897,1108,2005
20210529,5호선,청구,2417,2210,4627
20210529,5호선,신금호,4014,4002,8016
20210529,5호선,행당,5566,4784,10350
20210529,5호선,왕십리,3264,3868,7132
20210529,5호선,마장,3619,3491,7110
20210529,5호선,답십리,10046,9024,19070
20210529,5호선,장한평,10415,10192,20607
20210529,5호선,군자,8182,8851,17033
20210529,5호선,아차산,12637,12344,24981
20210529,5호선,광나루,9640,9255,18895
20210529,5호선,천호,16079,15084,31163
20210529,5호선,강동,12166,11464,23630
20210529,5호선,길동,5750,5717,11467
20210529,5호선,굽은다리,6705,6440,13145
20210529,5호선,명일,6027,5994,12021
20210529,5호선,고덕,5818,5652,11470
20210529,5호선,상일동,9330,8619,17949
20210529,5호선,둔촌동,6888,6873,13761
20210529,5호선,올림픽공원,3038,2748,5786
20210529,5호선,방이,5233,5036,10269
20210529,5호선,오금,2085,1884,3969
20210529,5호선,개롱,4357,4485,8842
20210529,5호선,거여,5191,4970,10161
20210529,5호선,마천,4446,4470,8916
20210529,5호선,강일,2225,2145,4370
20210529,5호선,미사,10582,10443,21025
20210529,5호선,하남풍산,2597,2679,5276
20210529,5호선,하남시청,4338,4276,8614
20210529,5호선,하남검단산,4668,4717,9385
20210530,5호선,명일,4641,4630,9271
20210530,5호선,하남검단산,4187,4262,8449
20210530,5호선,하남시청,3192,3105,6297
20210530,5호선,하남풍산,2076,2028,4104
20210530,5호선,미사,7673,7686,15359
20210530,5호선,강일,1748,1611,3359
20210530,5호선,마천,3319,3693,7012
20210530,5호선,거여,3722,3620,7342
20210530,5호선,개롱,2946,3198,6144
20210530,5호선,오금,1527,1511,3038
20210530,5호선,방이,3775,3704,7479
20210530,5호선,올림픽공원,2390,2417,4807
20210530,5호선,둔촌동,4300,4432,8732
20210530,5호선,상일동,6686,6606,13292
20210530,5호선,고덕,4077,4101,8178
20210530,5호선,굽은다리,5185,4894,10079
20210530,5호선,길동,4038,4176,8214
20210530,5호선,강동,8488,8542,17030
20210530,5호선,천호,12017,11060,23077
20210530,5호선,광나루,7749,7778,15527
20210530,5호선,아차산,11952,11994,23946
20210530,5호선,군자,5662,6315,11977
20210530,5호선,장한평,6963,7010,13973
20210530,5호선,답십리,6960,6567,13527
20210530,5호선,마장,2764,2635,5399
20210530,5호선,왕십리,2529,2797,5326
20210530,5호선,행당,3799,3496,7295
20210530,5호선,신금호,2866,3141,6007
20210530,5호선,청구,1714,1490,3204
20210530,5호선,동대문역사문화공원,649,680,1329
20210530,5호선,을지로4가,1380,1494,2874
20210530,5호선,종로3가,8360,7322,15682
20210530,5호선,광화문,10489,10554,21043
20210530,5호선,서대문,5243,5121,10364
20210530,5호선,충정로,1334,1434,2768
20210530,5호선,애오개,2582,2725,5307
20210530,5호선,마포,4736,4779,9515
20210530,5호선,여의나루,10186,11504,21690
20210530,5호선,여의도,8146,7504,15650
20210530,5호선,신길,1739,2057,3796
20210530,5호선,영등포시장,4206,4599,8805
20210530,5호선,영등포구청,1398,1353,2751
20210530,5호선,양평,2545,2612,5157
20210530,5호선,오목교,11466,11798,23264
20210530,5호선,목동,7309,7744,15053
20210530,5호선,신정,6104,5634,11738
20210530,5호선,까치산,15160,14853,30013
20210530,5호선,화곡,13461,12712,26173
20210530,5호선,우장산,6245,6636,12881
20210530,5호선,발산,8698,8897,17595
20210530,5호선,마곡,3382,3535,6917
20210530,5호선,송정,3638,3703,7341
20210530,5호선,김포공항,6847,6049,12896
20210530,5호선,개화산,2592,2814,5406
20210530,5호선,방화,3673,3541,7214
20210530,5호선,공덕,4420,4496,8916
20210605,5호선,하남검단산,4943,4962,9905
20210605,5호선,하남시청,4398,4243,8641
20210605,5호선,하남풍산,2733,2714,5447
20210605,5호선,미사,11160,10991,22151
20210605,5호선,강일,2415,2224,4639
20210605,5호선,마천,4551,4603,9154
20210605,5호선,거여,5165,5032,10197
20210605,5호선,개롱,4464,4728,9192
20210605,5호선,오금,2155,1983,4138
20210605,5호선,방이,5191,5011,10202
20210605,5호선,올림픽공원,3077,3078,6155
20210605,5호선,둔촌동,6241,6100,12341
20210605,5호선,상일동,9548,8757,18305
20210605,5호선,고덕,6025,5886,11911
20210605,5호선,명일,5979,6061,12040
20210605,5호선,굽은다리,7063,6563,13626
20210605,5호선,길동,5857,5926,11783
20210605,5호선,강동,12112,11338,23450
20210605,5호선,천호,16071,15298,31369
20210605,5호선,광나루,10372,10004,20376
20210605,5호선,아차산,12900,12342,25242
20210605,5호선,군자,8169,8805,16974
20210605,5호선,장한평,10997,10441,21438
20210605,5호선,답십리,10064,9006,19070
20210605,5호선,마장,3984,3737,7721
20210605,5호선,왕십리,3603,4161,7764
20210605,5호선,행당,5601,4896,10497
20210605,5호선,신금호,4132,4116,8248
20210605,5호선,청구,2507,2240,4747
20210605,5호선,동대문역사문화공원,891,1187,2078
20210605,5호선,을지로4가,3345,3761,7106
20210605,5호선,종로3가,11506,12171,23677
20210605,5호선,광화문,13491,14078,27569
20210605,5호선,서대문,6707,6590,13297
20210605,5호선,충정로,1969,1846,3815
20210605,5호선,애오개,3699,3553,7252
20210605,5호선,공덕,6736,6963,13699
20210605,5호선,마포,6854,6787,13641
20210605,5호선,여의나루,14222,15665,29887
20210605,5호선,여의도,11105,11963,23068
20210605,5호선,신길,2481,2528,5009
20210605,5호선,영등포시장,6649,7025,13674
20210605,5호선,영등포구청,2008,1848,3856
20210605,5호선,양평,3582,3396,6978
20210605,5호선,오목교,16410,17018,33428
20210605,5호선,목동,11496,11424,22920
20210605,5호선,신정,8732,7544,16276
20210605,5호선,까치산,20789,19605,40394
20210605,5호선,화곡,19577,18039,37616
20210605,5호선,우장산,9740,9543,19283
20210605,5호선,발산,12786,13815,26601
20210605,5호선,마곡,5253,5178,10431
20210605,5호선,송정,5028,4850,9878
20210605,5호선,김포공항,7159,7330,14489
20210605,5호선,개화산,3687,3605,7292
20210605,5호선,방화,4664,4372,9036
20210606,5호선,방화,3379,3419,6798
20210606,5호선,개화산,2623,2642,5265
20210606,5호선,김포공항,6830,6126,12956
20210606,5호선,송정,3409,3498,6907
20210606,5호선,마곡,3142,3305,6447
20210606,5호선,발산,8012,8486,16498
20210606,5호선,우장산,6100,6305,12405
20210606,5호선,화곡,13114,12521,25635
20210606,5호선,까치산,14794,14463,29257
20210606,5호선,신정,5858,5240,11098
20210606,5호선,목동,7530,7755,15285
20210606,5호선,오목교,10706,11206,21912
20210606,5호선,양평,2372,2449,4821
20210606,5호선,영등포구청,1252,1252,2504
20210606,5호선,영등포시장,3996,4323,8319
20210606,5호선,신길,1665,1866,3531
20210606,5호선,여의도,6967,7450,14417
20210606,5호선,여의나루,10469,11281,21750
20210606,5호선,마포,4195,4291,8486
20210606,5호선,공덕,3927,4107,8034
20210606,5호선,애오개,2421,2460,4881
20210606,5호선,충정로,1339,1414,2753
20210606,5호선,서대문,4744,4742,9486
20210606,5호선,광화문,9521,9466,18987
20210606,5호선,종로3가,7530,6909,14439
20210606,5호선,을지로4가,1451,1496,2947
20210606,5호선,동대문역사문화공원,655,722,1377
20210606,5호선,청구,1717,1597,3314
20210606,5호선,신금호,2834,3051,5885
20210606,5호선,행당,3681,3421,7102
20210606,5호선,왕십리,2241,2565,4806
20210606,5호선,마장,2656,2583,5239
20210606,5호선,답십리,6673,6258,12931
20210606,5호선,장한평,6841,6748,13589
20210606,5호선,군자,5560,6037,11597
20210606,5호선,아차산,10250,9988,20238
20210606,5호선,광나루,7243,7175,14418
20210606,5호선,천호,11586,10859,22445
20210606,5호선,강동,7977,7969,15946
20210606,5호선,길동,3717,3923,7640
20210606,5호선,굽은다리,5028,4762,9790
20210606,5호선,명일,4190,4296,8486
20210606,5호선,고덕,4041,4042,8083
20210606,5호선,상일동,6343,6043,12386
20210606,5호선,둔촌동,4313,4515,8828
20210606,5호선,올림픽공원,2260,2284,4544
20210606,5호선,방이,3665,3455,7120
20210606,5호선,오금,1420,1325,2745
20210606,5호선,개롱,2755,2980,5735
20210606,5호선,거여,3618,3440,7058
20210606,5호선,마천,3252,3679,6931
20210606,5호선,강일,1712,1641,3353
20210606,5호선,미사,7627,7710,15337
20210606,5호선,하남풍산,1934,1994,3928
20210606,5호선,하남시청,3187,3116,6303
20210606,5호선,하남검단산,4326,4421,8747
20210612,5호선,김포공항,7178,7442,14620
20210612,5호선,송정,4917,4817,9734
20210612,5호선,마곡,4830,4947,9777
20210612,5호선,발산,12378,13305,25683
20210612,5호선,우장산,9340,9146,18486
20210612,5호선,화곡,19210,17627,36837
20210612,5호선,까치산,20086,19070,39156
20210612,5호선,신정,8487,7280,15767
20210612,5호선,목동,11286,11376,22662
20210612,5호선,오목교,15558,15982,31540
20210612,5호선,양평,3607,3365,6972
20210612,5호선,영등포구청,1859,1754,3613
20210612,5호선,영등포시장,6591,6978,13569
20210612,5호선,신길,2405,2509,4914
20210612,5호선,여의도,10979,11643,22622
20210612,5호선,여의나루,11860,13818,25678
20210612,5호선,마포,6503,6637,13140
20210612,5호선,공덕,6593,6642,13235
20210612,5호선,애오개,3611,3429,7040
20210612,5호선,충정로,1888,1777,3665
20210612,5호선,서대문,6697,6439,13136
20210612,5호선,광화문,12539,12967,25506
20210612,5호선,종로3가,10889,11409,22298
20210612,5호선,을지로4가,3203,3584,6787
20210612,5호선,동대문역사문화공원,887,1231,2118
20210612,5호선,청구,2449,2177,4626
20210612,5호선,신금호,3876,3923,7799
20210612,5호선,행당,5457,4794,10251
20210612,5호선,왕십리,3324,3753,7077
20210612,5호선,마장,3570,3257,6827
20210612,5호선,답십리,9662,8745,18407
20210612,5호선,장한평,10438,10114,20552
20210612,5호선,군자,7830,8390,16220
20210612,5호선,아차산,11982,11507,23489
20210612,5호선,광나루,9004,8647,17651
20210612,5호선,천호,15775,15068,30843
20210612,5호선,강동,11715,11129,22844
20210612,5호선,길동,5755,5794,11549
20210612,5호선,굽은다리,6731,6412,13143
20210612,5호선,명일,5702,5675,11377
20210612,5호선,고덕,5918,5871,11789
20210612,5호선,상일동,9166,8412,17578
20210612,5호선,둔촌동,5974,5974,11948
20210612,5호선,올림픽공원,2873,2560,5433
20210612,5호선,방이,4986,4750,9736
20210612,5호선,오금,2048,1897,3945
20210612,5호선,개롱,4041,4336,8377
20210612,5호선,거여,5208,5000,10208
20210612,5호선,마천,4323,4445,8768
20210612,5호선,강일,2318,2217,4535
20210612,5호선,미사,10804,10672,21476
20210612,5호선,하남풍산,2526,2622,5148
20210612,5호선,하남시청,4178,4109,8287
20210612,5호선,하남검단산,4746,4865,9611
20210612,5호선,개화산,3631,3598,7229
20210612,5호선,방화,4585,4361,8946
20210613,5호선,방화,3328,3288,6616
20210613,5호선,개화산,2540,2719,5259
20210613,5호선,김포공항,6454,5998,12452
20210613,5호선,송정,3397,3468,6865
20210613,5호선,마곡,3173,3293,6466
20210613,5호선,발산,8141,8497,16638
20210613,5호선,우장산,6126,6300,12426
20210613,5호선,화곡,12903,12407,25310
20210613,5호선,까치산,14296,14001,28297
20210613,5호선,신정,5951,5358,11309
20210613,5호선,목동,7468,7595,15063
20210613,5호선,오목교,10684,10892,21576
20210613,5호선,양평,2416,2451,4867
20210613,5호선,영등포구청,1236,1168,2404
20210613,5호선,영등포시장,4086,4315,8401
20210613,5호선,신길,1722,1825,3547
20210613,5호선,여의도,7637,7972,15609
20210613,5호선,여의나루,9429,10268,19697
20210613,5호선,마포,4246,4181,8427
20210613,5호선,공덕,4056,4116,8172
20210613,5호선,애오개,2478,2467,4945
20210613,5호선,충정로,1355,1359,2714
20210613,5호선,서대문,4780,4760,9540
20210613,5호선,광화문,8851,9262,18113
20210613,5호선,종로3가,7535,6932,14467
20210613,5호선,을지로4가,1370,1507,2877
20210613,5호선,동대문역사문화공원,650,776,1426
20210613,5호선,청구,1601,1443,3044
20210613,5호선,신금호,2653,2962,5615
20210613,5호선,행당,3698,3366,7064
20210613,5호선,왕십리,2114,2304,4418
20210613,5호선,마장,2612,2502,5114
20210613,5호선,답십리,6422,6028,12450
20210613,5호선,장한평,6671,6645,13316
20210613,5호선,군자,5442,6047,11489
20210613,5호선,아차산,9195,8994,18189
20210613,5호선,광나루,6976,6907,13883
20210613,5호선,천호,11089,10407,21496
20210613,5호선,강동,7857,7883,15740
20210613,5호선,길동,3820,3827,7647
20210613,5호선,굽은다리,4785,4474,9259
20210613,5호선,명일,4430,4407,8837
20210613,5호선,고덕,3748,3725,7473
20210613,5호선,상일동,6321,6122,12443
20210613,5호선,둔촌동,4181,4342,8523
20210613,5호선,올림픽공원,1928,1736,3664
20210613,5호선,방이,3662,3403,7065
20210613,5호선,오금,1487,1394,2881
20210613,5호선,개롱,2719,2993,5712
20210613,5호선,거여,3493,3387,6880
20210613,5호선,마천,3383,3520,6903
20210613,5호선,강일,1591,1557,3148
20210613,5호선,미사,7404,7487,14891
20210613,5호선,하남풍산,1968,2082,4050
20210613,5호선,하남시청,3127,2995,6122
20210613,5호선,하남검단산,4217,4328,8545
20210619,5호선,답십리,9854,8977,18831
20210619,5호선,마장,3836,3488,7324
20210619,5호선,왕십리,3443,3977,7420
20210619,5호선,행당,5765,4895,10660
20210619,5호선,신금호,3994,4038,8032
20210619,5호선,청구,2452,2225,4677
20210619,5호선,동대문역사문화공원,938,1307,2245
20210619,5호선,을지로4가,3380,3677,7057
20210619,5호선,종로3가,12005,12079,24084
20210619,5호선,군자,8051,8762,16813
20210619,5호선,아차산,12374,11885,24259
20210619,5호선,광나루,9626,9244,18870
20210619,5호선,천호,16194,15430,31624
20210619,5호선,강동,12900,12254,25154
20210619,5호선,길동,5718,5710,11428
20210619,5호선,굽은다리,6966,6476,13442
20210619,5호선,명일,6032,5913,11945
20210619,5호선,고덕,6133,6066,12199
20210619,5호선,상일동,9564,8806,18370
20210619,5호선,둔촌동,6281,6060,12341
20210619,5호선,올림픽공원,3158,2895,6053
20210619,5호선,방이,5309,4957,10266
20210619,5호선,오금,2109,1984,4093
20210619,5호선,개롱,4360,4510,8870
20210619,5호선,거여,5458,5167,10625
20210619,5호선,마천,4494,4633,9127
20210619,5호선,강일,2334,2121,4455
20210619,5호선,미사,10915,10794,21709
20210619,5호선,하남풍산,2666,2693,5359
20210619,5호선,하남시청,4473,4360,8833
20210619,5호선,하남검단산,5144,5153,10297
20210619,5호선,광화문,13825,14320,28145
20210619,5호선,서대문,7262,7196,14458
20210619,5호선,충정로,2091,1889,3980
20210619,5호선,애오개,3603,3409,7012
20210619,5호선,공덕,6780,7052,13832
20210619,5호선,마포,6987,6935,13922
20210619,5호선,여의나루,14261,16331,30592
20210619,5호선,여의도,11652,12587,24239
20210619,5호선,신길,2465,2591,5056
20210619,5호선,영등포시장,7031,7461,14492
20210619,5호선,영등포구청,1913,1878,3791
20210619,5호선,양평,3680,3441,7121
20210619,5호선,오목교,15802,16458,32260
20210619,5호선,목동,11796,11901,23697
20210619,5호선,신정,8881,7360,16241
20210619,5호선,까치산,20633,19462,40095
20210619,5호선,화곡,19961,18317,38278
20210619,5호선,우장산,9548,9468,19016
20210619,5호선,발산,13136,14165,27301
20210619,5호선,마곡,5120,4964,10084
20210619,5호선,송정,4905,4665,9570
20210619,5호선,김포공항,7656,7623,15279
20210619,5호선,개화산,3658,3666,7324
20210619,5호선,방화,4682,4375,9057
20210619,5호선,장한평,10891,10519,21410
20210620,5호선,하남검단산,4146,4216,8362
20210620,5호선,하남시청,3137,3057,6194
20210620,5호선,하남풍산,2035,2009,4044
20210620,5호선,미사,7539,7569,15108
20210620,5호선,강일,1679,1653,3332
20210620,5호선,마천,3256,3642,6898
20210620,5호선,거여,3623,3686,7309
20210620,5호선,개롱,2937,3244,6181
20210620,5호선,오금,1464,1347,2811
20210620,5호선,방이,3905,3704,7609
20210620,5호선,올림픽공원,2266,2008,4274
20210620,5호선,둔촌동,4326,4514,8840
20210620,5호선,상일동,6485,6251,12736
20210620,5호선,고덕,4040,4063,8103
20210620,5호선,명일,4408,4454,8862
20210620,5호선,굽은다리,5074,4870,9944
20210620,5호선,길동,3924,3865,7789
20210620,5호선,강동,8174,8175,16349
20210620,5호선,천호,11717,10889,22606
20210620,5호선,광나루,7222,7246,14468
20210620,5호선,아차산,9592,9391,18983
20210620,5호선,군자,5691,6198,11889
20210620,5호선,장한평,6993,6942,13935
20210620,5호선,답십리,6953,6463,13416
20210620,5호선,마장,2773,2552,5325
20210620,5호선,왕십리,2403,2585,4988
20210620,5호선,행당,3741,3469,7210
20210620,5호선,신금호,2746,2955,5701
20210620,5호선,청구,1694,1546,3240
20210620,5호선,동대문역사문화공원,607,697,1304
20210620,5호선,을지로4가,1474,1532,3006
20210620,5호선,종로3가,8147,7604,15751
20210620,5호선,광화문,9570,9824,19394
20210620,5호선,서대문,6130,5803,11933
20210620,5호선,충정로,1398,1478,2876
20210620,5호선,애오개,2442,2582,5024
20210620,5호선,공덕,4348,4336,8684
20210620,5호선,마포,4359,4310,8669
20210620,5호선,여의나루,10818,11658,22476
20210620,5호선,여의도,7663,7976,15639
20210620,5호선,신길,1757,1968,3725
20210620,5호선,영등포시장,4132,4434,8566
20210620,5호선,영등포구청,1258,1308,2566
20210620,5호선,양평,2445,2493,4938
20210620,5호선,오목교,10788,11267,22055
20210620,5호선,목동,7924,8142,16066
20210620,5호선,신정,5910,5393,11303
20210620,5호선,까치산,14912,14639,29551
20210620,5호선,화곡,13620,12798,26418
20210620,5호선,우장산,6268,6387,12655
20210620,5호선,발산,8313,8741,17054
20210620,5호선,마곡,3235,3491,6726
20210620,5호선,송정,3525,3541,7066
20210620,5호선,김포공항,7006,6729,13735
20210620,5호선,개화산,2730,2792,5522
20210620,5호선,방화,3448,3361,6809
20210626,5호선,방화,4366,4167,8533
20210626,5호선,개화산,3535,3449,6984
20210626,5호선,김포공항,7458,7552,15010
20210626,5호선,송정,4852,4666,9518
20210626,5호선,마곡,4871,4922,9793
20210626,5호선,발산,12682,13635,26317
20210626,5호선,우장산,9035,8799,17834
20210626,5호선,화곡,19409,17773,37182
20210626,5호선,까치산,20083,19237,39320
20210626,5호선,신정,8484,7126,15610
20210626,5호선,목동,11080,11047,22127
20210626,5호선,오목교,15930,16457,32387
20210626,5호선,양평,3594,3467,7061
20210626,5호선,영등포구청,1963,1927,3890
20210626,5호선,영등포시장,6633,6815,13448
20210626,5호선,신길,2470,2504,4974
20210626,5호선,여의도,10985,11994,22979
20210626,5호선,여의나루,11879,13711,25590
20210626,5호선,마포,6775,6866,13641
20210626,5호선,공덕,6813,7044,13857
20210626,5호선,애오개,3655,3476,7131
20210626,5호선,충정로,1827,1727,3554
20210626,5호선,서대문,6843,6763,13606
20210626,5호선,광화문,13553,14049,27602
20210626,5호선,종로3가,11696,12460,24156
20210626,5호선,을지로4가,3245,3762,7007
20210626,5호선,동대문역사문화공원,930,1345,2275
20210626,5호선,청구,2476,2406,4882
20210626,5호선,신금호,4001,3986,7987
20210626,5호선,행당,5678,4900,10578
20210626,5호선,왕십리,3284,3873,7157
20210626,5호선,마장,3666,3484,7150
20210626,5호선,답십리,9789,8808,18597
20210626,5호선,장한평,10654,10439,21093
20210626,5호선,군자,8189,8880,17069
20210626,5호선,아차산,11249,10856,22105
20210626,5호선,광나루,9447,8845,18292
20210626,5호선,천호,15438,14778,30216
20210626,5호선,강동,11987,11186,23173
20210626,5호선,길동,5650,5703,11353
20210626,5호선,굽은다리,6983,6692,13675
20210626,5호선,명일,5847,5716,11563
20210626,5호선,고덕,5850,5880,11730
20210626,5호선,상일동,9556,8784,18340
20210626,5호선,둔촌동,6106,6161,12267
20210626,5호선,올림픽공원,3177,3097,6274
20210626,5호선,방이,5162,4975,10137
20210626,5호선,오금,2108,1983,4091
20210626,5호선,개롱,4351,4590,8941
20210626,5호선,거여,5495,5096,10591
20210626,5호선,마천,4242,4404,8646
20210626,5호선,강일,2289,2150,4439
20210626,5호선,미사,10857,10545,21402
20210626,5호선,하남풍산,2537,2716,5253
20210626,5호선,하남시청,4214,4101,8315
20210626,5호선,하남검단산,4451,4568,9019
20210627,5호선,방화,3605,3451,7056
20210627,5호선,개화산,2550,2724,5274
20210627,5호선,김포공항,6872,6357,13229
20210627,5호선,송정,3529,3528,7057
20210627,5호선,마곡,3284,3329,6613
20210627,5호선,발산,8204,8653,16857
20210627,5호선,우장산,6332,6579,12911
20210627,5호선,화곡,13260,12765,26025
20210627,5호선,까치산,14836,14465,29301
20210627,5호선,신정,6073,5546,11619
20210627,5호선,목동,7124,7559,14683
20210627,5호선,오목교,10810,10976,21786
20210627,5호선,양평,2458,2585,5043
20210627,5호선,영등포구청,1280,1223,2503
20210627,5호선,영등포시장,4153,4416,8569
20210627,5호선,신길,1720,1948,3668
20210627,5호선,여의도,8082,8174,16256
20210627,5호선,여의나루,9370,10804,20174
20210627,5호선,마포,4463,4531,8994
20210627,5호선,공덕,4006,4193,8199
20210627,5호선,애오개,2571,2655,5226
20210627,5호선,충정로,1462,1488,2950
20210627,5호선,서대문,5619,5675,11294
20210627,5호선,광화문,10320,10227,20547
20210627,5호선,종로3가,8666,7546,16212
20210627,5호선,을지로4가,1497,1635,3132
20210627,5호선,동대문역사문화공원,761,857,1618
20210627,5호선,청구,1745,1732,3477
20210627,5호선,신금호,2790,2955,5745
20210627,5호선,행당,3854,3587,7441
20210627,5호선,왕십리,2295,2564,4859
20210627,5호선,마장,2767,2716,5483
20210627,5호선,답십리,7035,6570,13605
20210627,5호선,장한평,7084,7116,14200
20210627,5호선,군자,5632,6368,12000
20210627,5호선,아차산,9912,9677,19589
20210627,5호선,광나루,7339,7228,14567
20210627,5호선,천호,11804,10881,22685
20210627,5호선,강동,8346,8159,16505
20210627,5호선,길동,4001,4115,8116
20210627,5호선,굽은다리,5087,4741,9828
20210627,5호선,명일,4562,4588,9150
20210627,5호선,고덕,3981,4013,7994
20210627,5호선,상일동,6646,6481,13127
20210627,5호선,둔촌동,4350,4548,8898
20210627,5호선,올림픽공원,2737,2743,5480
20210627,5호선,방이,3989,3788,7777
20210627,5호선,오금,1567,1484,3051
20210627,5호선,개롱,3035,3333,6368
20210627,5호선,거여,3804,3702,7506
20210627,5호선,마천,3388,3621,7009
20210627,5호선,강일,1646,1697,3343
20210627,5호선,미사,7744,7812,15556
20210627,5호선,하남풍산,2033,2060,4093
20210627,5호선,하남시청,3183,3105,6288
20210627,5호선,하남검단산,4385,4441,8826
20210703,5호선,하남검단산,4066,4221,8287
20210703,5호선,하남시청,4024,3918,7942
20210703,5호선,하남풍산,2494,2565,5059
20210703,5호선,미사,9866,9846,19712
20210703,5호선,강일,2072,1958,4030
20210703,5호선,마천,4137,4224,8361
20210703,5호선,거여,4916,4768,9684
20210703,5호선,개롱,3986,4124,8110
20210703,5호선,오금,1991,1893,3884
20210703,5호선,방이,4454,4505,8959
20210703,5호선,올림픽공원,4512,4080,8592
20210703,5호선,둔촌동,5841,5792,11633
20210703,5호선,상일동,8783,8544,17327
20210703,5호선,고덕,5661,5557,11218
20210703,5호선,명일,5490,5411,10901
20210703,5호선,굽은다리,6571,6262,12833
20210703,5호선,길동,5592,5733,11325
20210703,5호선,강동,11245,10823,22068
20210703,5호선,천호,14934,13898,28832
20210703,5호선,광나루,8547,8384,16931
20210703,5호선,아차산,10588,10213,20801
20210703,5호선,군자,7722,8502,16224
20210703,5호선,장한평,10095,10034,20129
20210703,5호선,답십리,9409,8739,18148
20210703,5호선,마장,3534,3478,7012
20210703,5호선,왕십리,3234,3640,6874
20210703,5호선,행당,5016,4437,9453
20210703,5호선,신금호,3542,3745,7287
20210703,5호선,청구,2292,2246,4538
20210703,5호선,동대문역사문화공원,933,1163,2096
20210703,5호선,을지로4가,3587,3955,7542
20210703,5호선,종로3가,9371,9355,18726
20210703,5호선,광화문,13099,13885,26984
20210703,5호선,서대문,6734,6467,13201
20210703,5호선,충정로,2061,1912,3973
20210703,5호선,애오개,3622,3554,7176
20210703,5호선,공덕,7308,7366,14674
20210703,5호선,마포,7573,7100,14673
20210703,5호선,여의나루,5190,8390,13580
20210703,5호선,여의도,14019,12739,26758
20210703,5호선,신길,2563,2550,5113
20210703,5호선,영등포시장,6741,6726,13467
20210703,5호선,영등포구청,1951,1794,3745
20210703,5호선,양평,3451,3306,6757
20210703,5호선,오목교,14932,15209,30141
20210703,5호선,목동,10210,10410,20620
20210703,5호선,신정,8133,7302,15435
20210703,5호선,까치산,18924,18455,37379
20210703,5호선,화곡,17964,16659,34623
20210703,5호선,우장산,8371,8611,16982
20210703,5호선,발산,12137,12670,24807
20210703,5호선,마곡,4705,4760,9465
20210703,5호선,송정,4568,4516,9084
20210703,5호선,김포공항,7285,7218,14503
20210703,5호선,개화산,3337,3259,6596
20210703,5호선,방화,4182,4011,8193
20210704,5호선,방화,2842,2865,5707
20210704,5호선,개화산,2256,2287,4543
20210704,5호선,김포공항,6380,5984,12364
20210704,5호선,송정,3039,3109,6148
20210704,5호선,마곡,2814,3028,5842
20210704,5호선,발산,6921,7344,14265
20210704,5호선,우장산,5392,5386,10778
20210704,5호선,화곡,11623,11188,22811
20210704,5호선,까치산,13031,12760,25791
20210704,5호선,신정,5405,4849,10254
20210704,5호선,목동,6371,6343,12714
20210704,5호선,오목교,9684,10230,19914
20210704,5호선,양평,2252,2355,4607
20210704,5호선,영등포구청,1142,1113,2255
20210704,5호선,영등포시장,3714,3950,7664
20210704,5호선,신길,1559,1758,3317
20210704,5호선,여의도,6837,6824,13661
20210704,5호선,여의나루,4830,6035,10865
20210704,5호선,마포,3990,3941,7931
20210704,5호선,공덕,3658,3696,7354
20210704,5호선,애오개,2258,2358,4616
20210704,5호선,충정로,1206,1185,2391
20210704,5호선,서대문,4055,4087,8142
20210704,5호선,광화문,8109,8265,16374
20210704,5호선,종로3가,6434,5779,12213
20210704,5호선,을지로4가,1151,1234,2385
20210704,5호선,동대문역사문화공원,620,640,1260
20210704,5호선,청구,1376,1338,2714
20210704,5호선,신금호,2419,2601,5020
20210704,5호선,행당,3328,3011,6339
20210704,5호선,왕십리,2036,2309,4345
20210704,5호선,마장,2504,2362,4866
20210704,5호선,답십리,6087,5712,11799
20210704,5호선,장한평,6224,6102,12326
20210704,5호선,군자,5130,5827,10957
20210704,5호선,아차산,6854,6783,13637
20210704,5호선,광나루,5818,5447,11265
20210704,5호선,천호,10132,9602,19734
20210704,5호선,강동,7409,7480,14889
20210704,5호선,길동,3444,3545,6989
20210704,5호선,굽은다리,4574,4322,8896
20210704,5호선,명일,3951,3970,7921
20210704,5호선,고덕,3436,3458,6894
20210704,5호선,상일동,5730,5645,11375
20210704,5호선,둔촌동,3766,3813,7579
20210704,5호선,올림픽공원,3687,3145,6832
20210704,5호선,방이,3326,3140,6466
20210704,5호선,오금,1370,1307,2677
20210704,5호선,개롱,2584,2794,5378
20210704,5호선,거여,3216,3137,6353
20210704,5호선,마천,2660,2878,5538
20210704,5호선,강일,1326,1332,2658
20210704,5호선,미사,6639,6705,13344
20210704,5호선,하남풍산,1692,1737,3429
20210704,5호선,하남시청,2802,2743,5545
20210704,5호선,하남검단산,2939,2944,5883
20210710,5호선,방화,4199,4100,8299
20210710,5호선,개화산,3122,2999,6121
20210710,5호선,김포공항,6147,6687,12834
20210710,5호선,송정,4357,4281,8638
20210710,5호선,마곡,4495,4529,9024
20210710,5호선,발산,10562,11386,21948
20210710,5호선,우장산,8119,7943,16062
20210710,5호선,화곡,16620,15302,31922
20210710,5호선,까치산,17905,17133,35038
20210710,5호선,신정,7421,6305,13726
20210710,5호선,목동,9447,9535,18982
20210710,5호선,오목교,13677,14212,27889
20210710,5호선,양평,2921,2840,5761
20210710,5호선,영등포구청,1693,1626,3319
20210710,5호선,영등포시장,5559,5603,11162
20210710,5호선,신길,2087,2092,4179
20210710,5호선,여의도,7218,7834,15052
20210710,5호선,여의나루,5833,6386,12219
20210710,5호선,마포,5764,5814,11578
20210710,5호선,공덕,5245,5454,10699
20210710,5호선,애오개,3166,2918,6084
20210710,5호선,충정로,1573,1474,3047
20210710,5호선,서대문,5485,5342,10827
20210710,5호선,광화문,10062,10638,20700
20210710,5호선,종로3가,7611,7883,15494
20210710,5호선,을지로4가,2504,2742,5246
20210710,5호선,동대문역사문화공원,762,994,1756
20210710,5호선,청구,2172,1853,4025
20210710,5호선,신금호,3496,3541,7037
20210710,5호선,행당,4689,4054,8743
20210710,5호선,왕십리,2774,3187,5961
20210710,5호선,마장,3122,2905,6027
20210710,5호선,답십리,8660,7791,16451
20210710,5호선,장한평,9354,8994,18348
20210710,5호선,군자,6930,7642,14572
20210710,5호선,아차산,9769,9417,19186
20210710,5호선,광나루,7965,7523,15488
20210710,5호선,천호,13423,12793,26216
20210710,5호선,강동,10208,9788,19996
20210710,5호선,길동,5093,5192,10285
20210710,5호선,굽은다리,6567,6231,12798
20210710,5호선,명일,5027,5043,10070
20210710,5호선,고덕,5079,4924,10003
20210710,5호선,상일동,7996,7309,15305
20210710,5호선,둔촌동,6300,6205,12505
20210710,5호선,올림픽공원,2390,2109,4499
20210710,5호선,방이,4335,4340,8675
20210710,5호선,오금,2036,1908,3944
20210710,5호선,개롱,3981,4191,8172
20210710,5호선,거여,4887,4618,9505
20210710,5호선,마천,3686,3770,7456
20210710,5호선,강일,1845,1717,3562
20210710,5호선,미사,9189,9192,18381
20210710,5호선,하남풍산,2201,2371,4572
20210710,5호선,하남시청,3642,3634,7276
20210710,5호선,하남검단산,3575,3562,7137
20210711,5호선,개화산,2043,2139,4182
20210711,5호선,김포공항,5639,5366,11005
20210711,5호선,송정,2908,2986,5894
20210711,5호선,마곡,2740,2852,5592
20210711,5호선,발산,6561,6823,13384
20210711,5호선,우장산,4884,5128,10012
20210711,5호선,화곡,10843,10137,20980
20210711,5호선,까치산,12429,12473,24902
20210711,5호선,신정,5010,4592,9602
20210711,5호선,목동,5867,6000,11867
20210711,5호선,오목교,8855,9279,18134
20210711,5호선,양평,1980,2014,3994
20210711,5호선,영등포구청,992,960,1952
20210711,5호선,영등포시장,3291,3534,6825
20210711,5호선,신길,1459,1576,3035
20210711,5호선,여의도,4543,4991,9534
20210711,5호선,여의나루,4313,4545,8858
20210711,5호선,마포,3368,3374,6742
20210711,5호선,공덕,3317,3297,6614
20210711,5호선,애오개,1919,1948,3867
20210711,5호선,충정로,1156,1145,2301
20210711,5호선,서대문,3752,3685,7437
20210711,5호선,광화문,7687,8116,15803
20210711,5호선,종로3가,5172,4906,10078
20210711,5호선,을지로4가,982,1070,2052
20210711,5호선,동대문역사문화공원,562,580,1142
20210711,5호선,청구,1333,1206,2539
20210711,5호선,신금호,2163,2376,4539
20210711,5호선,행당,2858,2664,5522
20210711,5호선,왕십리,1854,2013,3867
20210711,5호선,마장,2126,2040,4166
20210711,5호선,답십리,5557,5163,10720
20210711,5호선,장한평,5585,5810,11395
20210711,5호선,군자,4529,5020,9549
20210711,5호선,아차산,6958,6882,13840
20210711,5호선,광나루,5358,5128,10486
20210711,5호선,천호,8874,8480,17354
20210711,5호선,강동,6493,6565,13058
20210711,5호선,길동,3329,3422,6751
20210711,5호선,굽은다리,4158,3932,8090
20210711,5호선,명일,3278,3432,6710
20210711,5호선,고덕,3115,3067,6182
20210711,5호선,상일동,5258,5009,10267
20210711,5호선,둔촌동,3446,3527,6973
20210711,5호선,올림픽공원,1552,1305,2857
20210711,5호선,방이,3021,2934,5955
20210711,5호선,오금,1215,1132,2347
20210711,5호선,개롱,2295,2478,4773
20210711,5호선,거여,2910,2863,5773
20210711,5호선,마천,2648,2788,5436
20210711,5호선,강일,1237,1211,2448
20210711,5호선,미사,6157,6261,12418
20210711,5호선,하남풍산,1593,1639,3232
20210711,5호선,하남시청,2489,2433,4922
20210711,5호선,하남검단산,2738,2799,5537
20210711,5호선,방화,2645,2724,5369
20210717,5호선,방화,3707,3565,7272
20210717,5호선,개화산,2885,2839,5724
20210717,5호선,김포공항,5889,6036,11925
20210717,5호선,송정,3810,3733,7543
20210717,5호선,마곡,4178,4151,8329
20210717,5호선,발산,9424,9687,19111
20210717,5호선,우장산,7147,7302,14449
20210717,5호선,화곡,15143,14199,29342
20210717,5호선,까치산,16179,15679,31858
20210717,5호선,신정,6693,5863,12556
20210717,5호선,목동,8543,8546,17089
20210717,5호선,오목교,12296,12628,24924
20210717,5호선,양평,2685,2542,5227
20210717,5호선,영등포구청,1541,1431,2972
20210717,5호선,영등포시장,4905,5007,9912
20210717,5호선,신길,1802,1976,3778
20210717,5호선,여의도,6298,6829,13127
20210717,5호선,여의나루,4787,5089,9876
20210717,5호선,마포,5182,5112,10294
20210717,5호선,공덕,4835,4928,9763
20210717,5호선,애오개,2888,2724,5612
20210717,5호선,충정로,1407,1292,2699
20210717,5호선,서대문,4772,4651,9423
20210717,5호선,광화문,9143,9385,18528
20210717,5호선,종로3가,7025,7236,14261
20210717,5호선,을지로4가,2399,2635,5034
20210717,5호선,동대문역사문화공원,771,906,1677
20210717,5호선,청구,2032,1702,3734
20210717,5호선,신금호,3001,3077,6078
20210717,5호선,행당,4247,3629,7876
20210717,5호선,왕십리,2638,3023,5661
20210717,5호선,마장,2840,2600,5440
20210717,5호선,답십리,8007,7255,15262
20210717,5호선,장한평,8458,8378,16836
20210717,5호선,군자,6248,6780,13028
20210717,5호선,아차산,8986,8712,17698
20210717,5호선,광나루,7482,7192,14674
20210717,5호선,천호,12441,11786,24227
20210717,5호선,강동,9428,8951,18379
20210717,5호선,길동,4898,5022,9920
20210717,5호선,굽은다리,5727,5494,11221
20210717,5호선,명일,4467,4457,8924
20210717,5호선,고덕,4731,4617,9348
20210717,5호선,상일동,7336,6736,14072
20210717,5호선,둔촌동,4768,4740,9508
20210717,5호선,올림픽공원,2193,1841,4034
20210717,5호선,방이,4008,3967,7975
20210717,5호선,오금,1661,1509,3170
20210717,5호선,개롱,3450,3645,7095
20210717,5호선,거여,4300,4083,8383
20210717,5호선,마천,3448,3564,7012
20210717,5호선,강일,1743,1695,3438
20210717,5호선,미사,8364,8332,16696
20210717,5호선,하남풍산,2026,2159,4185
20210717,5호선,하남시청,3358,3291,6649
20210717,5호선,하남검단산,3707,3725,7432
20210718,5호선,상일동,4806,4763,9569
20210718,5호선,천호,8864,8257,17121
20210718,5호선,강동,6221,6119,12340
20210718,5호선,하남검단산,3091,3087,6178
20210718,5호선,하남시청,2281,2283,4564
20210718,5호선,하남풍산,1464,1549,3013
20210718,5호선,미사,5655,5688,11343
20210718,5호선,강일,1165,1130,2295
20210718,5호선,마천,2524,2650,5174
20210718,5호선,거여,2798,2742,5540
20210718,5호선,개롱,2235,2424,4659
20210718,5호선,오금,1057,1039,2096
20210718,5호선,방이,2595,2580,5175
20210718,5호선,올림픽공원,1517,1241,2758
20210718,5호선,둔촌동,2973,3052,6025
20210718,5호선,고덕,3003,3110,6113
20210718,5호선,명일,2907,2992,5899
20210718,5호선,굽은다리,3928,3818,7746
20210718,5호선,길동,3162,3256,6418
20210718,5호선,광나루,5422,5283,10705
20210718,5호선,아차산,6716,6627,13343
20210718,5호선,군자,4221,4712,8933
20210718,5호선,장한평,5211,5346,10557
20210718,5호선,답십리,5064,4687,9751
20210718,5호선,마장,1983,1797,3780
20210718,5호선,왕십리,1838,2077,3915
20210718,5호선,행당,2732,2405,5137
20210718,5호선,신금호,2100,2311,4411
20210718,5호선,청구,1247,1143,2390
20210718,5호선,동대문역사문화공원,463,589,1052
20210718,5호선,을지로4가,985,1021,2006
20210718,5호선,종로3가,4913,4618,9531
20210718,5호선,광화문,7215,7355,14570
20210718,5호선,서대문,3116,3138,6254
20210718,5호선,충정로,921,972,1893
20210718,5호선,애오개,1758,1847,3605
20210718,5호선,공덕,2969,3097,6066
20210718,5호선,마포,3153,3218,6371
20210718,5호선,여의나루,4083,4182,8265
20210718,5호선,여의도,4333,4726,9059
20210718,5호선,신길,1289,1428,2717
20210718,5호선,영등포시장,3073,3140,6213
20210718,5호선,영등포구청,925,952,1877
20210718,5호선,양평,1718,1858,3576
20210718,5호선,오목교,8544,8856,17400
20210718,5호선,목동,5334,5575,10909
20210718,5호선,신정,4535,4123,8658
20210718,5호선,까치산,11326,11330,22656
20210718,5호선,화곡,10067,9541,19608
20210718,5호선,우장산,4492,4604,9096
20210718,5호선,발산,6142,6476,12618
20210718,5호선,마곡,2492,2546,5038
20210718,5호선,송정,2774,2796,5570
20210718,5호선,김포공항,5981,5255,11236
20210718,5호선,개화산,2101,2136,4237
20210718,5호선,방화,2616,2632,5248
20210724,5호선,방화,3723,3612,7335
20210724,5호선,개화산,2847,2809,5656
20210724,5호선,김포공항,6162,6065,12227
20210724,5호선,송정,3978,3742,7720
20210724,5호선,마곡,4093,4159,8252
20210724,5호선,발산,9168,9699,18867
20210724,5호선,우장산,7227,7238,14465
20210724,5호선,화곡,15246,14194,29440
20210724,5호선,까치산,16096,15544,31640
20210724,5호선,신정,6764,5908,12672
20210724,5호선,목동,8451,8548,16999
20210724,5호선,오목교,12511,12876,25387
20210724,5호선,양평,2718,2595,5313
20210724,5호선,영등포구청,1433,1407,2840
20210724,5호선,영등포시장,4772,4826,9598
20210724,5호선,신길,1891,1923,3814
20210724,5호선,여의도,7099,7586,14685
20210724,5호선,여의나루,4519,5102,9621
20210724,5호선,마포,5200,5280,10480
20210724,5호선,공덕,4847,4978,9825
20210724,5호선,애오개,2674,2519,5193
20210724,5호선,충정로,1471,1422,2893
20210724,5호선,서대문,4888,4743,9631
20210724,5호선,광화문,9530,9770,19300
20210724,5호선,종로3가,7275,7391,14666
20210724,5호선,을지로4가,2316,2474,4790
20210724,5호선,동대문역사문화공원,778,936,1714
20210724,5호선,청구,2071,1754,3825
20210724,5호선,신금호,3155,3251,6406
20210724,5호선,행당,4095,3607,7702
20210724,5호선,왕십리,2652,2944,5596
20210724,5호선,마장,2971,2747,5718
20210724,5호선,답십리,7788,7203,14991
20210724,5호선,장한평,8371,8257,16628
20210724,5호선,군자,6132,6892,13024
20210724,5호선,아차산,8884,8513,17397
20210724,5호선,광나루,7240,6767,14007
20210724,5호선,천호,12414,11858,24272
20210724,5호선,강동,9161,8739,17900
20210724,5호선,길동,4824,5038,9862
20210724,5호선,굽은다리,5772,5475,11247
20210724,5호선,명일,4423,4472,8895
20210724,5호선,고덕,4769,4726,9495
20210724,5호선,상일동,7226,6760,13986
20210724,5호선,둔촌동,4936,4939,9875
20210724,5호선,올림픽공원,2107,1737,3844
20210724,5호선,방이,4098,3943,8041
20210724,5호선,오금,1973,1857,3830
20210724,5호선,개롱,3127,3353,6480
20210724,5호선,거여,4456,4356,8812
20210724,5호선,마천,3433,3445,6878
20210724,5호선,강일,1628,1598,3226
20210724,5호선,미사,8188,8143,16331
20210724,5호선,하남풍산,1962,2108,4070
20210724,5호선,하남시청,3395,3283,6678
20210724,5호선,하남검단산,3663,3639,7302
20210725,5호선,방화,2678,2705,5383
20210725,5호선,개화산,1974,2041,4015
20210725,5호선,김포공항,6156,5195,11351
20210725,5호선,송정,2611,2729,5340
20210725,5호선,마곡,2506,2614,5120
20210725,5호선,발산,6017,6308,12325
20210725,5호선,우장산,4508,4771,9279
20210725,5호선,화곡,9817,9445,19262
20210725,5호선,까치산,11010,10952,21962
20210725,5호선,신정,4403,4034,8437
20210725,5호선,목동,5214,5351,10565
20210725,5호선,오목교,8289,8588,16877
20210725,5호선,양평,1776,1769,3545
20210725,5호선,영등포구청,885,863,1748
20210725,5호선,영등포시장,2995,3040,6035
20210725,5호선,신길,1336,1529,2865
20210725,5호선,여의도,4913,5172,10085
20210725,5호선,여의나루,4283,4758,9041
20210725,5호선,마포,3202,3227,6429
20210725,5호선,공덕,2891,3013,5904
20210725,5호선,애오개,1789,1824,3613
20210725,5호선,충정로,968,1011,1979
20210725,5호선,서대문,3077,3029,6106
20210725,5호선,광화문,7090,7350,14440
20210725,5호선,종로3가,5128,4736,9864
20210725,5호선,을지로4가,1026,1053,2079
20210725,5호선,동대문역사문화공원,501,567,1068
20210725,5호선,청구,1216,1115,2331
20210725,5호선,신금호,2025,2209,4234
20210725,5호선,행당,2802,2576,5378
20210725,5호선,왕십리,1635,1833,3468
20210725,5호선,마장,1993,1918,3911
20210725,5호선,답십리,4994,4656,9650
20210725,5호선,장한평,5289,5297,10586
20210725,5호선,군자,4124,4709,8833
20210725,5호선,아차산,6402,6294,12696
20210725,5호선,광나루,5299,5017,10316
20210725,5호선,천호,8551,8068,16619
20210725,5호선,강동,5879,6022,11901
20210725,5호선,길동,3004,3230,6234
20210725,5호선,굽은다리,3726,3396,7122
20210725,5호선,명일,2844,2918,5762
20210725,5호선,고덕,2931,2963,5894
20210725,5호선,상일동,4525,4432,8957
20210725,5호선,둔촌동,3126,3197,6323
20210725,5호선,올림픽공원,1318,1136,2454
20210725,5호선,방이,2505,2483,4988
20210725,5호선,오금,1313,1148,2461
20210725,5호선,개롱,2204,2375,4579
20210725,5호선,거여,2607,2596,5203
20210725,5호선,마천,2413,2622,5035
20210725,5호선,강일,1140,1119,2259
20210725,5호선,미사,5476,5596,11072
20210725,5호선,하남풍산,1495,1601,3096
20210725,5호선,하남시청,2216,2175,4391
20210725,5호선,하남검단산,3116,3005,6121
20210731,5호선,하남검단산,3577,3469,7046
20210731,5호선,하남시청,3199,3137,6336
20210731,5호선,하남풍산,1972,2064,4036
20210731,5호선,미사,8060,8007,16067
20210731,5호선,강일,1656,1641,3297
20210731,5호선,마천,3380,3366,6746
20210731,5호선,거여,4171,4032,8203
20210731,5호선,개롱,3180,3349,6529
20210731,5호선,오금,1580,1414,2994
20210731,5호선,방이,3583,3512,7095
20210731,5호선,올림픽공원,1909,1594,3503
20210731,5호선,둔촌동,4610,4636,9246
20210731,5호선,상일동,7046,6553,13599
20210731,5호선,고덕,4441,4469,8910
20210731,5호선,명일,4173,4317,8490
20210731,5호선,굽은다리,5581,5111,10692
20210731,5호선,길동,4634,4704,9338
20210731,5호선,강동,8888,8484,17372
20210731,5호선,천호,12185,11516,23701
20210731,5호선,광나루,6882,6399,13281
20210731,5호선,아차산,8696,8401,17097
20210731,5호선,군자,5940,6524,12464
20210731,5호선,장한평,7977,7983,15960
20210731,5호선,답십리,7521,6816,14337
20210731,5호선,마장,2845,2629,5474
20210731,5호선,왕십리,2599,2963,5562
20210731,5호선,행당,4055,3474,7529
20210731,5호선,신금호,2974,3091,6065
20210731,5호선,청구,1950,1677,3627
20210731,5호선,동대문역사문화공원,728,921,1649
20210731,5호선,을지로4가,2158,2309,4467
20210731,5호선,종로3가,7312,7611,14923
20210731,5호선,광화문,9516,10007,19523
20210731,5호선,서대문,5028,4867,9895
20210731,5호선,충정로,1419,1321,2740
20210731,5호선,애오개,2777,2677,5454
20210731,5호선,공덕,4620,4604,9224
20210731,5호선,마포,5032,5054,10086
20210731,5호선,여의나루,4710,5406,10116
20210731,5호선,여의도,7041,7373,14414
20210731,5호선,신길,1782,1870,3652
20210731,5호선,영등포시장,4832,4807,9639
20210731,5호선,영등포구청,1417,1372,2789
20210731,5호선,양평,2605,2451,5056
20210731,5호선,오목교,11996,12496,24492
20210731,5호선,목동,8316,8363,16679
20210731,5호선,신정,6513,5727,12240
20210731,5호선,까치산,15848,15452,31300
20210731,5호선,화곡,14717,13726,28443
20210731,5호선,우장산,7024,7054,14078
20210731,5호선,발산,8734,9084,17818
20210731,5호선,마곡,3785,3790,7575
20210731,5호선,송정,3701,3683,7384
20210731,5호선,김포공항,6163,6366,12529
20210731,5호선,개화산,2891,2857,5748
20210731,5호선,방화,3571,3573,7144
20210801,5호선,하남검단산,2782,2757,5539
20210801,5호선,하남시청,2257,2232,4489
20210801,5호선,하남풍산,1461,1458,2919
20210801,5호선,미사,5538,5677,11215
20210801,5호선,강일,1154,1141,2295
20210801,5호선,마천,2271,2441,4712
20210801,5호선,거여,2622,2629,5251
20210801,5호선,개롱,2062,2307,4369
20210801,5호선,오금,1088,985,2073
20210801,5호선,방이,2384,2286,4670
20210801,5호선,올림픽공원,1372,1111,2483
20210801,5호선,둔촌동,2918,3075,5993
20210801,5호선,상일동,4686,4554,9240
20210801,5호선,고덕,3072,3125,6197
20210801,5호선,명일,2900,2966,5866
20210801,5호선,굽은다리,3822,3672,7494
20210801,5호선,길동,3054,3218,6272
20210801,5호선,강동,5953,6142,12095
20210801,5호선,천호,8653,8247,16900
20210801,5호선,광나루,4822,4505,9327
20210801,5호선,아차산,6224,6162,12386
20210801,5호선,군자,4064,4609,8673
20210801,5호선,장한평,5033,5210,10243
20210801,5호선,답십리,4978,4824,9802
20210801,5호선,마장,1967,1879,3846
20210801,5호선,왕십리,1722,1944,3666
20210801,5호선,행당,2683,2426,5109
20210801,5호선,신금호,1991,2162,4153
20210801,5호선,청구,1209,1182,2391
20210801,5호선,동대문역사문화공원,568,670,1238
20210801,5호선,을지로4가,981,1064,2045
20210801,5호선,종로3가,5435,4954,10389
20210801,5호선,광화문,7584,7761,15345
20210801,5호선,서대문,3124,3059,6183
20210801,5호선,충정로,988,1051,2039
20210801,5호선,애오개,1748,1884,3632
20210801,5호선,공덕,2970,2987,5957
20210801,5호선,마포,3215,3308,6523
20210801,5호선,여의나루,3386,4066,7452
20210801,5호선,여의도,4873,5008,9881
20210801,5호선,신길,1281,1521,2802
20210801,5호선,영등포시장,2848,3133,5981
20210801,5호선,영등포구청,893,917,1810
20210801,5호선,양평,1790,1907,3697
20210801,5호선,오목교,8598,8843,17441
20210801,5호선,목동,5283,5450,10733
20210801,5호선,신정,4480,4062,8542
20210801,5호선,까치산,10898,10756,21654
20210801,5호선,화곡,9790,9301,19091
20210801,5호선,우장산,4431,4649,9080
20210801,5호선,발산,6023,6203,12226
20210801,5호선,마곡,2376,2537,4913
20210801,5호선,송정,2617,2628,5245
20210801,5호선,김포공항,6140,5442,11582
20210801,5호선,개화산,2098,2052,4150
20210801,5호선,방화,2566,2540,5106
20210807,5호선,목동,8762,8859,17621
20210807,5호선,방화,3749,3702,7451
20210807,5호선,개화산,3030,3020,6050
20210807,5호선,김포공항,6029,5985,12014
20210807,5호선,송정,3998,3900,7898
20210807,5호선,마곡,4278,4227,8505
20210807,5호선,발산,9514,10087,19601
20210807,5호선,우장산,7741,7706,15447
20210807,5호선,화곡,15465,14690,30155
20210807,5호선,까치산,16764,16187,32951
20210807,5호선,신정,6848,6047,12895
20210807,5호선,오목교,13207,13446,26653
20210807,5호선,양평,2804,2757,5561
20210807,5호선,영등포구청,1474,1454,2928
20210807,5호선,영등포시장,5023,5095,10118
20210807,5호선,신길,1877,2095,3972
20210807,5호선,여의도,7300,7802,15102
20210807,5호선,여의나루,6350,6887,13237
20210807,5호선,마포,5348,5297,10645
20210807,5호선,공덕,5043,5161,10204
20210807,5호선,애오개,2908,2793,5701
20210807,5호선,충정로,1540,1393,2933
20210807,5호선,서대문,5068,4781,9849
20210807,5호선,광화문,10532,10790,21322
20210807,5호선,종로3가,8122,8481,16603
20210807,5호선,을지로4가,2495,2842,5337
20210807,5호선,동대문역사문화공원,789,987,1776
20210807,5호선,청구,2024,1809,3833
20210807,5호선,신금호,3317,3404,6721
20210807,5호선,행당,4229,3695,7924
20210807,5호선,왕십리,2764,3213,5977
20210807,5호선,마장,2985,2767,5752
20210807,5호선,답십리,8072,7233,15305
20210807,5호선,장한평,8684,8724,17408
20210807,5호선,군자,6436,6966,13402
20210807,5호선,아차산,9161,8831,17992
20210807,5호선,광나루,7069,6611,13680
20210807,5호선,천호,13037,12301,25338
20210807,5호선,강동,9442,8998,18440
20210807,5호선,길동,4972,5140,10112
20210807,5호선,굽은다리,5813,5455,11268
20210807,5호선,명일,4470,4546,9016
20210807,5호선,고덕,4933,4973,9906
20210807,5호선,상일동,7391,7035,14426
20210807,5호선,둔촌동,4888,4933,9821
20210807,5호선,올림픽공원,2194,1879,4073
20210807,5호선,방이,4207,4216,8423
20210807,5호선,오금,2480,2266,4746
20210807,5호선,개롱,3269,3529,6798
20210807,5호선,거여,4296,4067,8363
20210807,5호선,마천,3419,3583,7002
20210807,5호선,강일,1753,1699,3452
20210807,5호선,미사,8739,8717,17456
20210807,5호선,하남풍산,2076,2116,4192
20210807,5호선,하남시청,3490,3507,6997
20210807,5호선,하남검단산,3787,3745,7532
20210808,5호선,방화,2688,2662,5350
20210808,5호선,개화산,2054,2120,4174
20210808,5호선,김포공항,5660,4984,10644
20210808,5호선,송정,2769,2817,5586
20210808,5호선,마곡,2651,2694,5345
20210808,5호선,발산,6274,6687,12961
20210808,5호선,우장산,4801,4938,9739
20210808,5호선,화곡,10229,9710,19939
20210808,5호선,까치산,11427,11408,22835
20210808,5호선,신정,4716,4331,9047
20210808,5호선,목동,5397,5773,11170
20210808,5호선,오목교,8536,8646,17182
20210808,5호선,양평,1816,1894,3710
20210808,5호선,영등포구청,924,959,1883
20210808,5호선,영등포시장,3111,3273,6384
20210808,5호선,신길,1402,1638,3040
20210808,5호선,여의도,5346,5237,10583
20210808,5호선,여의나루,3982,4854,8836
20210808,5호선,마포,3397,3424,6821
20210808,5호선,공덕,2923,3093,6016
20210808,5호선,애오개,1851,1931,3782
20210808,5호선,충정로,1040,1061,2101
20210808,5호선,서대문,3600,3639,7239
20210808,5호선,광화문,7949,7982,15931
20210808,5호선,종로3가,5686,5237,10923
20210808,5호선,을지로4가,1037,1131,2168
20210808,5호선,동대문역사문화공원,485,572,1057
20210808,5호선,청구,1306,1152,2458
20210808,5호선,신금호,2120,2303,4423
20210808,5호선,행당,2940,2722,5662
20210808,5호선,왕십리,1607,1862,3469
20210808,5호선,마장,2035,1985,4020
20210808,5호선,답십리,5246,4945,10191
20210808,5호선,장한평,5532,5626,11158
20210808,5호선,군자,4457,4972,9429
20210808,5호선,아차산,6962,6802,13764
20210808,5호선,광나루,5227,5138,10365
20210808,5호선,천호,8989,8538,17527
20210808,5호선,강동,6285,6419,12704
20210808,5호선,길동,3203,3320,6523
20210808,5호선,굽은다리,3735,3533,7268
20210808,5호선,명일,3022,3087,6109
20210808,5호선,고덕,3041,3042,6083
20210808,5호선,상일동,4891,4839,9730
20210808,5호선,둔촌동,3299,3385,6684
20210808,5호선,올림픽공원,1544,1340,2884
20210808,5호선,방이,2706,2668,5374
20210808,5호선,오금,1183,1084,2267
20210808,5호선,개롱,2154,2475,4629
20210808,5호선,거여,2879,2832,5711
20210808,5호선,마천,2530,2704,5234
20210808,5호선,강일,1283,1242,2525
20210808,5호선,미사,6049,6066,12115
20210808,5호선,하남풍산,1491,1575,3066
20210808,5호선,하남시청,2424,2286,4710
20210808,5호선,하남검단산,3062,2987,6049
20210814,5호선,하남검단산,3876,3905,7781
20210814,5호선,하남시청,3813,3700,7513
20210814,5호선,하남풍산,2122,2245,4367
20210814,5호선,미사,9168,9136,18304
20210814,5호선,강일,1866,1758,3624
20210814,5호선,마천,3699,3690,7389
20210814,5호선,거여,4789,4626,9415
20210814,5호선,개롱,3720,3776,7496
20210814,5호선,오금,1884,1701,3585
20210814,5호선,방이,3947,3899,7846
20210814,5호선,올림픽공원,2511,2173,4684
20210814,5호선,둔촌동,4996,4900,9896
20210814,5호선,상일동,7674,7066,14740
20210814,5호선,고덕,5311,5266,10577
20210814,5호선,명일,4800,4815,9615
20210814,5호선,굽은다리,5791,5454,11245
20210814,5호선,길동,4973,5068,10041
20210814,5호선,강동,9404,8811,18215
20210814,5호선,천호,12780,12155,24935
20210814,5호선,광나루,7494,7097,14591
20210814,5호선,아차산,9662,9233,18895
20210814,5호선,군자,6607,7058,13665
20210814,5호선,장한평,9173,8747,17920
20210814,5호선,답십리,8046,7279,15325
20210814,5호선,마장,3055,2800,5855
20210814,5호선,왕십리,2655,3023,5678
20210814,5호선,행당,4450,3779,8229
20210814,5호선,신금호,3334,3426,6760
20210814,5호선,청구,2038,1904,3942
20210814,5호선,동대문역사문화공원,738,1029,1767
20210814,5호선,을지로4가,2641,2950,5591
20210814,5호선,종로3가,8503,8726,17229
20210814,5호선,광화문,8167,9571,17738
20210814,5호선,서대문,5619,5331,10950
20210814,5호선,충정로,1564,1525,3089
20210814,5호선,애오개,3036,2864,5900
20210814,5호선,공덕,5045,5228,10273
20210814,5호선,마포,5584,5536,11120
20210814,5호선,여의나루,7184,7490,14674
20210814,5호선,여의도,7377,8069,15446
20210814,5호선,신길,1978,1952,3930
20210814,5호선,영등포시장,5214,5154,10368
20210814,5호선,영등포구청,1448,1487,2935
20210814,5호선,양평,2979,2666,5645
20210814,5호선,오목교,12264,12665,24929
20210814,5호선,목동,8869,8874,17743
20210814,5호선,신정,7182,6181,13363
20210814,5호선,까치산,17099,16425,33524
20210814,5호선,화곡,16093,14665,30758
20210814,5호선,우장산,7789,7748,15537
20210814,5호선,발산,9377,9894,19271
20210814,5호선,마곡,4185,4248,8433
20210814,5호선,송정,4185,4085,8270
20210814,5호선,김포공항,6074,6468,12542
20210814,5호선,개화산,3004,2991,5995
20210814,5호선,방화,4119,3818,7937
20210815,5호선,하남검단산,3599,3710,7309
20210815,5호선,하남시청,2729,2604,5333
20210815,5호선,하남풍산,1585,1654,3239
20210815,5호선,미사,6715,6756,13471
20210815,5호선,강일,1425,1333,2758
20210815,5호선,마천,2606,2882,5488
20210815,5호선,거여,3122,3058,6180
20210815,5호선,개롱,2282,2528,4810
20210815,5호선,오금,1158,1121,2279
20210815,5호선,방이,2995,2849,5844
20210815,5호선,올림픽공원,1765,1509,3274
20210815,5호선,둔촌동,3493,3460,6953
20210815,5호선,상일동,5392,5225,10617
20210815,5호선,고덕,3534,3550,7084
20210815,5호선,명일,3280,3282,6562
20210815,5호선,굽은다리,4238,4007,8245
20210815,5호선,길동,3402,3528,6930
20210815,5호선,강동,6717,6613,13330
20210815,5호선,천호,9781,9347,19128
20210815,5호선,광나루,5859,5606,11465
20210815,5호선,아차산,8249,7984,16233
20210815,5호선,군자,4736,5214,9950
20210815,5호선,장한평,5890,5811,11701
20210815,5호선,답십리,5663,5210,10873
20210815,5호선,마장,2291,2129,4420
20210815,5호선,왕십리,1856,2241,4097
20210815,5호선,행당,3212,2732,5944
20210815,5호선,신금호,2353,2500,4853
20210815,5호선,청구,1403,1272,2675
20210815,5호선,동대문역사문화공원,538,682,1220
20210815,5호선,을지로4가,1231,1330,2561
20210815,5호선,종로3가,6526,6919,13445
20210815,5호선,광화문,6248,6682,12930
20210815,5호선,서대문,4485,4351,8836
20210815,5호선,충정로,1133,1053,2186
20210815,5호선,애오개,1963,1991,3954
20210815,5호선,공덕,3371,3481,6852
20210815,5호선,마포,3743,3691,7434
20210815,5호선,여의나루,7919,8199,16118
20210815,5호선,여의도,5510,5910,11420
20210815,5호선,신길,1370,1421,2791
20210815,5호선,영등포시장,3219,3335,6554
20210815,5호선,영등포구청,1103,1033,2136
20210815,5호선,양평,2053,2039,4092
20210815,5호선,오목교,9048,9674,18722
20210815,5호선,목동,5912,5985,11897
20210815,5호선,신정,5115,4528,9643
20210815,5호선,까치산,12461,12264,24725
20210815,5호선,화곡,11181,10614,21795
20210815,5호선,우장산,5314,5296,10610
20210815,5호선,발산,6574,7084,13658
20210815,5호선,마곡,2728,2806,5534
20210815,5호선,송정,2957,2997,5954
20210815,5호선,김포공항,5997,5543,11540
20210815,5호선,개화산,2338,2381,4719
20210815,5호선,방화,2986,2956,5942
20210821,5호선,하남검단산,3041,3013,6054
20210821,5호선,하남시청,3285,3230,6515
20210821,5호선,하남풍산,1894,1965,3859
20210821,5호선,미사,8272,8322,16594
20210821,5호선,강일,1634,1587,3221
20210821,5호선,마천,3204,3295,6499
20210821,5호선,거여,4333,4121,8454
20210821,5호선,개롱,3419,3604,7023
20210821,5호선,오금,1587,1472,3059
20210821,5호선,방이,4094,3935,8029
20210821,5호선,올림픽공원,2079,1728,3807
20210821,5호선,둔촌동,4737,4751,9488
20210821,5호선,상일동,7206,6805,14011
20210821,5호선,고덕,5347,5057,10404
20210821,5호선,명일,4360,4450,8810
20210821,5호선,굽은다리,5384,5104,10488
20210821,5호선,길동,4685,4787,9472
20210821,5호선,강동,9392,9064,18456
20210821,5호선,천호,11788,11269,23057
20210821,5호선,광나루,6537,6124,12661
20210821,5호선,아차산,8171,7966,16137
20210821,5호선,군자,6125,6802,12927
20210821,5호선,장한평,8397,8251,16648
20210821,5호선,답십리,7643,7006,14649
20210821,5호선,마장,2884,2755,5639
20210821,5호선,왕십리,2596,3054,5650
20210821,5호선,행당,4273,3714,7987
20210821,5호선,신금호,3105,3112,6217
20210821,5호선,청구,1958,1720,3678
20210821,5호선,동대문역사문화공원,791,921,1712
20210821,5호선,을지로4가,2300,2464,4764
20210821,5호선,종로3가,7354,7546,14900
20210821,5호선,광화문,9301,9754,19055
20210821,5호선,서대문,5229,4926,10155
20210821,5호선,충정로,1589,1424,3013
20210821,5호선,애오개,2744,2732,5476
20210821,5호선,공덕,4986,5345,10331
20210821,5호선,마포,5393,5473,10866
20210821,5호선,여의나루,4236,5164,9400
20210821,5호선,여의도,8268,8457,16725
20210821,5호선,신길,1916,2031,3947
20210821,5호선,영등포시장,4895,5038,9933
20210821,5호선,영등포구청,1428,1352,2780
20210821,5호선,양평,2808,2704,5512
20210821,5호선,오목교,11881,12092,23973
20210821,5호선,목동,8387,8622,17009
20210821,5호선,신정,6598,5621,12219
20210821,5호선,까치산,15576,15311,30887
20210821,5호선,화곡,14647,13744,28391
20210821,5호선,우장산,7200,7221,14421
20210821,5호선,발산,9102,9721,18823
20210821,5호선,마곡,3901,3937,7838
20210821,5호선,송정,3671,3649,7320
20210821,5호선,김포공항,5136,4968,10104
20210821,5호선,개화산,2813,2758,5571
20210821,5호선,방화,3473,3339,6812
20210822,5호선,방화,3150,3111,6261
20210822,5호선,개화산,2270,2343,4613
20210822,5호선,김포공항,5890,5153,11043
20210822,5호선,송정,2982,3086,6068
20210822,5호선,마곡,2935,3052,5987
20210822,5호선,발산,6842,7362,14204
20210822,5호선,우장산,5432,5550,10982
20210822,5호선,화곡,11319,10779,22098
20210822,5호선,까치산,12954,12328,25282
20210822,5호선,신정,5175,4637,9812
20210822,5호선,목동,6151,6242,12393
20210822,5호선,오목교,9164,9386,18550
20210822,5호선,양평,2114,2101,4215
20210822,5호선,영등포구청,1121,1067,2188
20210822,5호선,영등포시장,3468,3532,7000
20210822,5호선,신길,1448,1699,3147
20210822,5호선,여의도,5569,5867,11436
20210822,5호선,여의나루,6996,7330,14326
20210822,5호선,마포,3814,3800,7614
20210822,5호선,공덕,3408,3521,6929
20210822,5호선,애오개,2165,2142,4307
20210822,5호선,충정로,1231,1238,2469
20210822,5호선,서대문,4106,4217,8323
20210822,5호선,광화문,8593,8804,17397
20210822,5호선,종로3가,6294,6047,12341
20210822,5호선,을지로4가,1177,1261,2438
20210822,5호선,동대문역사문화공원,534,715,1249
20210822,5호선,청구,1423,1392,2815
20210822,5호선,신금호,2393,2637,5030
20210822,5호선,행당,3327,2957,6284
20210822,5호선,왕십리,1896,2214,4110
20210822,5호선,마장,2453,2369,4822
20210822,5호선,답십리,5898,5460,11358
20210822,5호선,장한평,6103,5999,12102
20210822,5호선,군자,4705,5278,9983
20210822,5호선,아차산,8050,7849,15899
20210822,5호선,광나루,5875,5727,11602
20210822,5호선,천호,9850,9112,18962
20210822,5호선,강동,6870,6998,13868
20210822,5호선,길동,3380,3599,6979
20210822,5호선,굽은다리,4020,3742,7762
20210822,5호선,명일,3585,3604,7189
20210822,5호선,고덕,3476,3366,6842
20210822,5호선,상일동,5487,5372,10859
20210822,5호선,둔촌동,3678,3784,7462
20210822,5호선,올림픽공원,1689,1469,3158
20210822,5호선,방이,3101,2995,6096
20210822,5호선,오금,1378,1244,2622
20210822,5호선,개롱,2449,2749,5198
20210822,5호선,거여,3302,3242,6544
20210822,5호선,마천,2839,2972,5811
20210822,5호선,강일,1456,1386,2842
20210822,5호선,미사,6720,6830,13550
20210822,5호선,하남풍산,1638,1638,3276
20210822,5호선,하남시청,2722,2651,5373
20210822,5호선,하남검단산,3295,3368,6663
20210828,5호선,방화,4107,3889,7996
20210828,5호선,개화산,3300,3267,6567
20210828,5호선,김포공항,6337,6405,12742
20210828,5호선,송정,4487,4250,8737
20210828,5호선,마곡,4598,4606,9204
20210828,5호선,발산,10932,11560,22492
20210828,5호선,우장산,8504,8501,17005
20210828,5호선,화곡,17663,16156,33819
20210828,5호선,까치산,18680,17983,36663
20210828,5호선,신정,7763,6665,14428
20210828,5호선,목동,9806,9911,19717
20210828,5호선,오목교,13862,14438,28300
20210828,5호선,양평,3185,3046,6231
20210828,5호선,영등포구청,1744,1743,3487
20210828,5호선,영등포시장,5989,6156,12145
20210828,5호선,신길,2097,2200,4297
20210828,5호선,여의도,8557,9375,17932
20210828,5호선,여의나루,8877,9379,18256
20210828,5호선,마포,6245,6248,12493
20210828,5호선,공덕,5906,6022,11928
20210828,5호선,애오개,3263,3049,6312
20210828,5호선,충정로,1673,1616,3289
20210828,5호선,서대문,5918,5742,11660
20210828,5호선,광화문,11736,11864,23600
20210828,5호선,종로3가,9337,9800,19137
20210828,5호선,을지로4가,3055,3104,6159
20210828,5호선,동대문역사문화공원,814,1088,1902
20210828,5호선,청구,2193,2050,4243
20210828,5호선,신금호,3625,3761,7386
20210828,5호선,행당,4811,4135,8946
20210828,5호선,왕십리,2968,3555,6523
20210828,5호선,마장,3430,3270,6700
20210828,5호선,답십리,8793,8004,16797
20210828,5호선,장한평,9558,9453,19011
20210828,5호선,군자,7090,7715,14805
20210828,5호선,아차산,10646,10372,21018
20210828,5호선,광나루,8465,8070,16535
20210828,5호선,천호,14036,13424,27460
20210828,5호선,강동,10576,10141,20717
20210828,5호선,길동,5249,5362,10611
20210828,5호선,굽은다리,6262,5795,12057
20210828,5호선,명일,5300,5328,10628
20210828,5호선,고덕,5721,5602,11323
20210828,5호선,상일동,8351,7714,16065
20210828,5호선,둔촌동,5391,5389,10780
20210828,5호선,올림픽공원,2523,2188,4711
20210828,5호선,방이,4564,4451,9015
20210828,5호선,오금,2090,1906,3996
20210828,5호선,개롱,3755,3923,7678
20210828,5호선,거여,5071,4872,9943
20210828,5호선,마천,3976,4059,8035
20210828,5호선,강일,2032,1965,3997
20210828,5호선,미사,9849,9974,19823
20210828,5호선,하남풍산,2294,2316,4610
20210828,5호선,하남시청,4105,3960,8065
20210828,5호선,하남검단산,4275,4298,8573
20210829,5호선,방화,3055,2987,6042
20210829,5호선,개화산,2365,2396,4761
20210829,5호선,김포공항,6160,5445,11605
20210829,5호선,송정,3030,3171,6201
20210829,5호선,마곡,3149,3224,6373
20210829,5호선,발산,7125,7532,14657
20210829,5호선,우장산,5574,5601,11175
20210829,5호선,화곡,11567,11197,22764
20210829,5호선,까치산,13064,12836,25900
20210829,5호선,신정,5218,4819,10037
20210829,5호선,목동,6304,6664,12968
20210829,5호선,오목교,9527,9743,19270
20210829,5호선,양평,2100,2263,4363
20210829,5호선,영등포구청,1166,1136,2302
20210829,5호선,영등포시장,3635,3788,7423
20210829,5호선,신길,1493,1687,3180
20210829,5호선,여의도,5868,6391,12259
20210829,5호선,여의나루,7607,7921,15528
20210829,5호선,마포,4045,4009,8054
20210829,5호선,공덕,3586,3636,7222
20210829,5호선,애오개,2168,2198,4366
20210829,5호선,충정로,1185,1221,2406
20210829,5호선,서대문,4037,4008,8045
20210829,5호선,광화문,8859,9003,17862
20210829,5호선,종로3가,6418,6329,12747
20210829,5호선,을지로4가,1222,1321,2543
20210829,5호선,동대문역사문화공원,530,607,1137
20210829,5호선,청구,1505,1386,2891
20210829,5호선,신금호,2425,2624,5049
20210829,5호선,행당,3364,2947,6311
20210829,5호선,왕십리,2147,2356,4503
20210829,5호선,마장,2471,2391,4862
20210829,5호선,답십리,6148,5736,11884
20210829,5호선,장한평,6308,6270,12578
20210829,5호선,군자,5106,5540,10646
20210829,5호선,아차산,8231,8307,16538
20210829,5호선,광나루,6403,6219,12622
20210829,5호선,천호,10190,9555,19745
20210829,5호선,강동,6910,6900,13810
20210829,5호선,길동,3512,3609,7121
20210829,5호선,굽은다리,4455,4126,8581
20210829,5호선,명일,3696,3647,7343
20210829,5호선,고덕,3649,3745,7394
20210829,5호선,상일동,5580,5413,10993
20210829,5호선,둔촌동,3747,3770,7517
20210829,5호선,올림픽공원,1779,1594,3373
20210829,5호선,방이,3167,3084,6251
20210829,5호선,오금,1353,1237,2590
20210829,5호선,개롱,2445,2756,5201
20210829,5호선,거여,3319,3232,6551
20210829,5호선,마천,2852,3002,5854
20210829,5호선,강일,1566,1481,3047
20210829,5호선,미사,7087,7182,14269
20210829,5호선,하남풍산,1695,1792,3487
20210829,5호선,하남시청,3258,3036,6294
20210829,5호선,하남검단산,3464,3514,6978
20210904,5호선,개화산,3534,3448,6982
20210904,5호선,김포공항,6280,6220,12500
20210904,5호선,송정,4581,4465,9046
20210904,5호선,마곡,4909,4931,9840
20210904,5호선,발산,11896,12770,24666
20210904,5호선,우장산,8874,8776,17650
20210904,5호선,화곡,18326,16751,35077
20210904,5호선,까치산,19212,18519,37731
20210904,5호선,신정,8044,6915,14959
20210904,5호선,목동,10231,10351,20582
20210904,5호선,오목교,14495,15082,29577
20210904,5호선,양평,3254,3111,6365
20210904,5호선,영등포구청,1751,1751,3502
20210904,5호선,영등포시장,5918,6163,12081
20210904,5호선,신길,2180,2386,4566
20210904,5호선,여의도,9222,10264,19486
20210904,5호선,여의나루,13082,13598,26680
20210904,5호선,마포,6467,6439,12906
20210904,5호선,공덕,6051,6086,12137
20210904,5호선,애오개,3239,3069,6308
20210904,5호선,충정로,1764,1584,3348
20210904,5호선,서대문,6251,6244,12495
20210904,5호선,광화문,12711,12541,25252
20210904,5호선,종로3가,10031,10629,20660
20210904,5호선,을지로4가,3221,3452,6673
20210904,5호선,동대문역사문화공원,903,1176,2079
20210904,5호선,청구,2301,2067,4368
20210904,5호선,신금호,3776,3751,7527
20210904,5호선,행당,5096,4458,9554
20210904,5호선,왕십리,3274,3724,6998
20210904,5호선,마장,3581,3406,6987
20210904,5호선,답십리,9166,8388,17554
20210904,5호선,장한평,10302,10024,20326
20210904,5호선,군자,7385,8099,15484
20210904,5호선,아차산,11978,11490,23468
20210904,5호선,광나루,8966,8725,17691
20210904,5호선,천호,14622,14094,28716
20210904,5호선,강동,10850,10390,21240
20210904,5호선,길동,5400,5498,10898
20210904,5호선,굽은다리,6508,6071,12579
20210904,5호선,명일,5427,5431,10858
20210904,5호선,고덕,5866,5710,11576
20210904,5호선,상일동,8698,8231,16929
20210904,5호선,둔촌동,5666,5586,11252
20210904,5호선,올림픽공원,2940,2748,5688
20210904,5호선,방이,4885,4734,9619
20210904,5호선,오금,2257,2034,4291
20210904,5호선,개롱,4075,4437,8512
20210904,5호선,거여,5318,5090,10408
20210904,5호선,마천,4175,4314,8489
20210904,5호선,강일,2344,2157,4501
20210904,5호선,미사,10522,10563,21085
20210904,5호선,하남풍산,2399,2524,4923
20210904,5호선,하남시청,4572,4459,9031
20210904,5호선,하남검단산,4685,4743,9428
20210904,5호선,방화,4408,4156,8564
20210905,5호선,하남검단산,3848,3766,7614
20210905,5호선,하남시청,3182,2975,6157
20210905,5호선,하남풍산,1728,1838,3566
20210905,5호선,미사,7336,7379,14715
20210905,5호선,강일,1633,1565,3198
20210905,5호선,마천,3102,3276,6378
20210905,5호선,거여,3468,3468,6936
20210905,5호선,개롱,2622,2776,5398
20210905,5호선,오금,1366,1331,2697
20210905,5호선,방이,3333,3264,6597
20210905,5호선,올림픽공원,1945,1896,3841
20210905,5호선,둔촌동,3775,3896,7671
20210905,5호선,상일동,6049,5834,11883
20210905,5호선,고덕,3909,3884,7793
20210905,5호선,명일,3823,3894,7717
20210905,5호선,굽은다리,4510,4260,8770
20210905,5호선,길동,3661,3802,7463
20210905,5호선,강동,7416,7456,14872
20210905,5호선,천호,10481,10148,20629
20210905,5호선,광나루,6960,6847,13807
20210905,5호선,아차산,9405,9304,18709
20210905,5호선,군자,5152,5795,10947
20210905,5호선,장한평,6590,6598,13188
20210905,5호선,답십리,6306,5913,12219
20210905,5호선,마장,2571,2451,5022
20210905,5호선,왕십리,2239,2547,4786
20210905,5호선,행당,3477,3156,6633
20210905,5호선,신금호,2636,2880,5516
20210905,5호선,청구,1576,1453,3029
20210905,5호선,동대문역사문화공원,528,658,1186
20210905,5호선,을지로4가,1322,1464,2786
20210905,5호선,종로3가,6888,6604,13492
20210905,5호선,광화문,9932,10040,19972
20210905,5호선,서대문,4783,4814,9597
20210905,5호선,충정로,1229,1285,2514
20210905,5호선,애오개,2220,2250,4470
20210905,5호선,공덕,3820,3905,7725
20210905,5호선,마포,4119,4097,8216
20210905,5호선,여의나루,10642,10599,21241
20210905,5호선,여의도,6331,6921,13252
20210905,5호선,신길,1572,1757,3329
20210905,5호선,영등포시장,3906,4065,7971
20210905,5호선,영등포구청,1250,1220,2470
20210905,5호선,양평,2294,2362,4656
20210905,5호선,오목교,10207,10569,20776
20210905,5호선,목동,6679,6795,13474
20210905,5호선,신정,5603,5011,10614
20210905,5호선,까치산,13843,13469,27312
20210905,5호선,화곡,12488,11791,24279
20210905,5호선,우장산,5803,5933,11736
20210905,5호선,발산,7878,8275,16153
20210905,5호선,마곡,3102,3176,6278
20210905,5호선,송정,3223,3293,6516
20210905,5호선,김포공항,6092,5355,11447
20210905,5호선,개화산,2443,2617,5060
20210905,5호선,방화,3216,3137,6353
20210911,5호선,양평,3381,3303,6684
20210911,5호선,방화,4360,4098,8458
20210911,5호선,개화산,3507,3468,6975
20210911,5호선,김포공항,6497,6463,12960
20210911,5호선,송정,4784,4558,9342
20210911,5호선,마곡,5103,5119,10222
20210911,5호선,발산,12395,13199,25594
20210911,5호선,우장산,9241,9038,18279
20210911,5호선,화곡,18850,17220,36070
20210911,5호선,까치산,19886,19235,39121
20210911,5호선,신정,8206,7152,15358
20210911,5호선,목동,10635,10737,21372
20210911,5호선,오목교,14788,15292,30080
20210911,5호선,영등포구청,1870,1781,3651
20210911,5호선,영등포시장,6388,6572,12960
20210911,5호선,신길,2315,2419,4734
20210911,5호선,여의도,9285,10322,19607
20210911,5호선,여의나루,12715,13299,26014
20210911,5호선,마포,6546,6569,13115
20210911,5호선,공덕,6332,6467,12799
20210911,5호선,애오개,3440,3231,6671
20210911,5호선,충정로,1887,1788,3675
20210911,5호선,서대문,6481,6331,12812
20210911,5호선,광화문,12681,12981,25662
20210911,5호선,종로3가,10584,11016,21600
20210911,5호선,을지로4가,3397,3688,7085
20210911,5호선,동대문역사문화공원,892,1194,2086
20210911,5호선,청구,2408,2229,4637
20210911,5호선,신금호,3960,4090,8050
20210911,5호선,행당,5205,4580,9785
20210911,5호선,왕십리,3251,3745,6996
20210911,5호선,마장,3921,3812,7733
20210911,5호선,답십리,9503,8709,18212
20210911,5호선,장한평,10465,10121,20586
20210911,5호선,군자,7818,8251,16069
20210911,5호선,아차산,11911,11580,23491
20210911,5호선,광나루,9617,9175,18792
20210911,5호선,천호,14989,14558,29547
20210911,5호선,강동,11600,10883,22483
20210911,5호선,길동,5685,5926,11611
20210911,5호선,굽은다리,6895,6320,13215
20210911,5호선,명일,5577,5588,11165
20210911,5호선,고덕,5980,5796,11776
20210911,5호선,상일동,8925,8285,17210
20210911,5호선,둔촌동,6264,6231,12495
20210911,5호선,올림픽공원,2915,2698,5613
20210911,5호선,방이,5222,5043,10265
20210911,5호선,오금,2499,2271,4770
20210911,5호선,개롱,4352,4439,8791
20210911,5호선,거여,5307,5039,10346
20210911,5호선,마천,4258,4321,8579
20210911,5호선,강일,2333,2209,4542
20210911,5호선,미사,10724,10638,21362
20210911,5호선,하남풍산,2398,2501,4899
20210911,5호선,하남시청,4546,4415,8961
20210911,5호선,하남검단산,4645,4776,9421
20210912,5호선,방화,3408,3362,6770
20210912,5호선,개화산,2554,2579,5133
20210912,5호선,김포공항,5991,5292,11283
20210912,5호선,송정,3448,3467,6915
20210912,5호선,마곡,3317,3362,6679
20210912,5호선,발산,7946,8596,16542
20210912,5호선,우장산,6130,6322,12452
20210912,5호선,화곡,12921,12185,25106
20210912,5호선,까치산,14381,13809,28190
20210912,5호선,신정,5745,5186,10931
20210912,5호선,목동,6963,7148,14111
20210912,5호선,오목교,10391,10628,21019
20210912,5호선,양평,2313,2320,4633
20210912,5호선,영등포구청,1196,1127,2323
20210912,5호선,영등포시장,3936,4199,8135
20210912,5호선,신길,1695,1884,3579
20210912,5호선,여의도,6416,7109,13525
20210912,5호선,여의나루,11201,11404,22605
20210912,5호선,마포,4182,4198,8380
20210912,5호선,공덕,3926,3882,7808
20210912,5호선,애오개,2302,2307,4609
20210912,5호선,충정로,1342,1391,2733
20210912,5호선,서대문,5177,5179,10356
20210912,5호선,광화문,9794,9947,19741
20210912,5호선,종로3가,7403,7019,14422
20210912,5호선,을지로4가,1542,1629,3171
20210912,5호선,동대문역사문화공원,584,747,1331
20210912,5호선,청구,1670,1507,3177
20210912,5호선,신금호,2717,2977,5694
20210912,5호선,행당,3750,3325,7075
20210912,5호선,왕십리,2213,2349,4562
20210912,5호선,마장,2845,2716,5561
20210912,5호선,답십리,6540,6157,12697
20210912,5호선,장한평,6756,6711,13467
20210912,5호선,군자,5354,5879,11233
20210912,5호선,아차산,9893,9619,19512
20210912,5호선,광나루,7248,7245,14493
20210912,5호선,천호,10766,10132,20898
20210912,5호선,강동,7881,7900,15781
20210912,5호선,길동,3746,3876,7622
20210912,5호선,굽은다리,4649,4253,8902
20210912,5호선,명일,3973,3949,7922
20210912,5호선,고덕,4057,4058,8115
20210912,5호선,상일동,6306,6081,12387
20210912,5호선,둔촌동,4192,4244,8436
20210912,5호선,올림픽공원,2012,1877,3889
20210912,5호선,방이,3484,3388,6872
20210912,5호선,오금,1520,1422,2942
20210912,5호선,개롱,2656,3007,5663
20210912,5호선,거여,3787,3660,7447
20210912,5호선,마천,3065,3285,6350
20210912,5호선,강일,1698,1607,3305
20210912,5호선,미사,7573,7569,15142
20210912,5호선,하남풍산,1841,1966,3807
20210912,5호선,하남시청,3133,3052,6185
20210912,5호선,하남검단산,4061,3961,8022
20210918,5호선,방화,4012,3832,7844
20210918,5호선,개화산,3359,3235,6594
20210918,5호선,김포공항,6236,7576,13812
20210918,5호선,송정,4443,4140,8583
20210918,5호선,마곡,4450,4412,8862
20210918,5호선,우장산,8839,8794,17633
20210918,5호선,화곡,17600,15525,33125
20210918,5호선,까치산,18816,17143,35959
20210918,5호선,신정,7636,6466,14102
20210918,5호선,목동,9693,9571,19264
20210918,5호선,오목교,13326,13784,27110
20210918,5호선,양평,2994,2654,5648
20210918,5호선,영등포구청,1618,1545,3163
20210918,5호선,영등포시장,5492,5471,10963
20210918,5호선,신길,1968,1875,3843
20210918,5호선,여의도,7751,8597,16348
20210918,5호선,여의나루,11665,12161,23826
20210918,5호선,마포,5770,5748,11518
20210918,5호선,공덕,5390,5439,10829
20210918,5호선,애오개,3050,2819,5869
20210918,5호선,충정로,1559,1417,2976
20210918,5호선,서대문,5716,5443,11159
20210918,5호선,광화문,11632,11546,23178
20210918,5호선,종로3가,9443,9797,19240
20210918,5호선,을지로4가,2701,2959,5660
20210918,5호선,동대문역사문화공원,771,950,1721
20210918,5호선,청구,2240,2048,4288
20210918,5호선,신금호,3435,3479,6914
20210918,5호선,행당,4733,4018,8751
20210918,5호선,왕십리,2890,3473,6363
20210918,5호선,마장,4143,4020,8163
20210918,5호선,답십리,8755,7360,16115
20210918,5호선,장한평,9106,8817,17923
20210918,5호선,군자,6710,6985,13695
20210918,5호선,아차산,10756,10315,21071
20210918,5호선,광나루,7926,7734,15660
20210918,5호선,천호,13788,13210,26998
20210918,5호선,강동,9810,9056,18866
20210918,5호선,길동,5456,5550,11006
20210918,5호선,굽은다리,6084,5781,11865
20210918,5호선,명일,5133,5117,10250
20210918,5호선,고덕,5602,5413,11015
20210918,5호선,상일동,8241,7402,15643
20210918,5호선,둔촌동,5254,5231,10485
20210918,5호선,올림픽공원,2555,2301,4856
20210918,5호선,방이,4437,4221,8658
20210918,5호선,오금,1703,1612,3315
20210918,5호선,개롱,3673,3970,7643
20210918,5호선,거여,4995,4698,9693
20210918,5호선,마천,4079,4204,8283
20210918,5호선,강일,2270,2200,4470
20210918,5호선,미사,9883,9516,19399
20210918,5호선,하남풍산,2377,2417,4794
20210918,5호선,하남시청,4354,4112,8466
20210918,5호선,하남검단산,4417,4571,8988
20210918,5호선,발산,10398,10731,21129
20210919,5호선,하남검단산,3815,3903,7718
20210919,5호선,하남시청,3484,3482,6966
20210919,5호선,하남풍산,1818,1895,3713
20210919,5호선,미사,6920,6813,13733
20210919,5호선,강일,1637,1508,3145
20210919,5호선,마천,2993,3156,6149
20210919,5호선,거여,3305,3108,6413
20210919,5호선,개롱,2561,2710,5271
20210919,5호선,오금,1193,1083,2276
20210919,5호선,방이,3073,2826,5899
20210919,5호선,올림픽공원,1900,1789,3689
20210919,5호선,둔촌동,3719,3725,7444
20210919,5호선,상일동,5790,5259,11049
20210919,5호선,고덕,3629,3525,7154
20210919,5호선,명일,3799,3703,7502
20210919,5호선,굽은다리,4360,3850,8210
20210919,5호선,길동,3810,3840,7650
20210919,5호선,강동,6492,6063,12555
20210919,5호선,천호,9824,9435,19259
20210919,5호선,광나루,5994,5862,11856
20210919,5호선,아차산,8401,7969,16370
20210919,5호선,군자,4627,4706,9333
20210919,5호선,장한평,5867,5572,11439
20210919,5호선,답십리,6034,5193,11227
20210919,5호선,마장,2945,2930,5875
20210919,5호선,왕십리,1966,2269,4235
20210919,5호선,행당,3389,2894,6283
20210919,5호선,신금호,2560,2579,5139
20210919,5호선,청구,1498,1269,2767
20210919,5호선,동대문역사문화공원,512,654,1166
20210919,5호선,을지로4가,1312,1336,2648
20210919,5호선,종로3가,6868,6846,13714
20210919,5호선,광화문,8768,8628,17396
20210919,5호선,서대문,3694,3554,7248
20210919,5호선,충정로,1140,1011,2151
20210919,5호선,애오개,2088,1961,4049
20210919,5호선,공덕,3528,3435,6963
20210919,5호선,마포,3724,3701,7425
20210919,5호선,여의나루,10187,10618,20805
20210919,5호선,여의도,5479,6190,11669
20210919,5호선,신길,1306,1217,2523
20210919,5호선,영등포시장,3509,3349,6858
20210919,5호선,영등포구청,1176,983,2159
20210919,5호선,양평,2176,1876,4052
20210919,5호선,오목교,9236,9466,18702
20210919,5호선,목동,6254,6213,12467
20210919,5호선,신정,5476,4606,10082
20210919,5호선,까치산,13560,12245,25805
20210919,5호선,화곡,12073,10582,22655
20210919,5호선,우장산,5953,6102,12055
20210919,5호선,발산,6567,6870,13437
20210919,5호선,마곡,2924,2877,5801
20210919,5호선,송정,3385,3208,6593
20210919,5호선,김포공항,5481,6247,11728
20210919,5호선,개화산,2388,2329,4717
20210919,5호선,방화,3104,2994,6098
20210925,5호선,하남검단산,4540,4616,9156
20210925,5호선,하남시청,4493,4283,8776
20210925,5호선,하남풍산,2322,2334,4656
20210925,5호선,미사,10369,10448,20817
20210925,5호선,강일,2272,2113,4385
20210925,5호선,마천,4162,4130,8292
20210925,5호선,거여,5102,4903,10005
20210925,5호선,개롱,4030,4143,8173
20210925,5호선,오금,1948,1878,3826
20210925,5호선,방이,4608,4550,9158
20210925,5호선,올림픽공원,2977,2620,5597
20210925,5호선,둔촌동,5438,5551,10989
20210925,5호선,상일동,8406,7873,16279
20210925,5호선,고덕,5748,5588,11336
20210925,5호선,명일,5215,5424,10639
20210925,5호선,굽은다리,6190,5771,11961
20210925,5호선,길동,5365,5437,10802
20210925,5호선,강동,10944,10399,21343
20210925,5호선,천호,14141,13749,27890
20210925,5호선,광나루,8653,8407,17060
20210925,5호선,아차산,11706,11439,23145
20210925,5호선,군자,7417,7963,15380
20210925,5호선,장한평,10090,9897,19987
20210925,5호선,답십리,9200,8458,17658
20210925,5호선,마장,3313,3169,6482
20210925,5호선,왕십리,3127,3605,6732
20210925,5호선,행당,5076,4295,9371
20210925,5호선,신금호,3684,3919,7603
20210925,5호선,청구,2329,2138,4467
20210925,5호선,동대문역사문화공원,856,1098,1954
20210925,5호선,을지로4가,2838,3165,6003
20210925,5호선,종로3가,9955,10366,20321
20210925,5호선,광화문,12141,12266,24407
20210925,5호선,서대문,5926,5973,11899
20210925,5호선,충정로,1714,1580,3294
20210925,5호선,애오개,3374,3188,6562
20210925,5호선,공덕,6199,6233,12432
20210925,5호선,마포,6334,6365,12699
20210925,5호선,여의나루,11979,12679,24658
20210925,5호선,여의도,8848,9934,18782
20210925,5호선,신길,2231,2447,4678
20210925,5호선,영등포시장,6090,6439,12529
20210925,5호선,영등포구청,1866,1826,3692
20210925,5호선,양평,3199,3039,6238
20210925,5호선,오목교,14022,14470,28492
20210925,5호선,목동,10167,10248,20415
20210925,5호선,신정,7864,6891,14755
20210925,5호선,까치산,18761,18250,37011
20210925,5호선,화곡,18083,16592,34675
20210925,5호선,우장산,8618,8604,17222
20210925,5호선,발산,11170,12105,23275
20210925,5호선,마곡,4741,4802,9543
20210925,5호선,송정,4447,4353,8800
20210925,5호선,김포공항,6395,5644,12039
20210925,5호선,개화산,3447,3464,6911
20210925,5호선,방화,4126,4017,8143
20210926,5호선,하남검단산,3940,3986,7926
20210926,5호선,하남시청,3101,3041,6142
20210926,5호선,하남풍산,1863,1868,3731
20210926,5호선,미사,7451,7356,14807
20210926,5호선,강일,1700,1678,3378
20210926,5호선,마천,2915,3234,6149
20210926,5호선,거여,3568,3461,7029
20210926,5호선,개롱,2668,2956,5624
20210926,5호선,오금,1438,1322,2760
20210926,5호선,방이,3577,3390,6967
20210926,5호선,올림픽공원,2222,2219,4441
20210926,5호선,둔촌동,3737,3819,7556
20210926,5호선,상일동,5822,5724,11546
20210926,5호선,고덕,3666,3669,7335
20210926,5호선,명일,3796,3794,7590
20210926,5호선,굽은다리,4249,3960,8209
20210926,5호선,길동,3527,3660,7187
20210926,5호선,강동,7414,7307,14721
20210926,5호선,천호,10310,9735,20045
20210926,5호선,광나루,6902,7055,13957
20210926,5호선,아차산,9903,9530,19433
20210926,5호선,군자,5232,5650,10882
20210926,5호선,장한평,6650,6597,13247
20210926,5호선,답십리,6419,5969,12388
20210926,5호선,마장,2507,2357,4864
20210926,5호선,왕십리,2071,2334,4405
20210926,5호선,행당,3477,3208,6685
20210926,5호선,신금호,2691,2886,5577
20210926,5호선,청구,1572,1546,3118
20210926,5호선,동대문역사문화공원,567,632,1199
20210926,5호선,을지로4가,1222,1228,2450
20210926,5호선,종로3가,7084,6670,13754
20210926,5호선,광화문,9172,9017,18189
20210926,5호선,서대문,4319,4191,8510
20210926,5호선,충정로,1288,1373,2661
20210926,5호선,애오개,2236,2322,4558
20210926,5호선,공덕,3934,3910,7844
20210926,5호선,마포,4231,4100,8331
20210926,5호선,여의나루,11097,11157,22254
20210926,5호선,여의도,6180,6673,12853
20210926,5호선,신길,1616,1899,3515
20210926,5호선,영등포시장,3795,3974,7769
20210926,5호선,영등포구청,1224,1156,2380
20210926,5호선,양평,2214,2207,4421
20210926,5호선,오목교,9411,9652,19063
20210926,5호선,목동,6683,6877,13560
20210926,5호선,신정,5585,5098,10683
20210926,5호선,까치산,13547,13221,26768
20210926,5호선,화곡,12445,11618,24063
20210926,5호선,우장산,5840,6032,11872
20210926,5호선,발산,7688,8035,15723
20210926,5호선,마곡,3084,3151,6235
20210926,5호선,송정,3259,3316,6575
20210926,5호선,김포공항,6114,5121,11235
20210926,5호선,개화산,2490,2534,5024
20210926,5호선,방화,3228,3148,6376
20211002,5호선,하남검단산,4772,4779,9551
20211002,5호선,하남시청,4426,4219,8645
20211002,5호선,하남풍산,2489,2533,5022
20211002,5호선,미사,10847,10773,21620
20211002,5호선,강일,2381,2236,4617
20211002,5호선,마천,4329,4336,8665
20211002,5호선,거여,5618,5262,10880
20211002,5호선,개롱,4089,4268,8357
20211002,5호선,오금,2029,1940,3969
20211002,5호선,방이,4677,4633,9310
20211002,5호선,올림픽공원,3377,3210,6587
20211002,5호선,둔촌동,5901,5827,11728
20211002,5호선,상일동,8985,8324,17309
20211002,5호선,고덕,6078,5957,12035
20211002,5호선,명일,5627,5656,11283
20211002,5호선,굽은다리,6467,6138,12605
20211002,5호선,길동,5441,5588,11029
20211002,5호선,강동,11835,11294,23129
20211002,5호선,천호,15082,14379,29461
20211002,5호선,광나루,9259,8726,17985
20211002,5호선,아차산,12160,11607,23767
20211002,5호선,군자,7912,8539,16451
20211002,5호선,장한평,10513,10194,20707
20211002,5호선,답십리,9403,8462,17865
20211002,5호선,마장,3564,3371,6935
20211002,5호선,왕십리,3120,3702,6822
20211002,5호선,행당,5668,4871,10539
20211002,5호선,신금호,3712,3926,7638
20211002,5호선,청구,2309,2216,4525
20211002,5호선,동대문역사문화공원,873,1134,2007
20211002,5호선,을지로4가,3128,3388,6516
20211002,5호선,종로3가,10801,11367,22168
20211002,5호선,광화문,11884,12761,24645
20211002,5호선,서대문,6594,6276,12870
20211002,5호선,충정로,1912,1736,3648
20211002,5호선,애오개,3349,3069,6418
20211002,5호선,공덕,6537,6597,13134
20211002,5호선,마포,6496,6620,13116
20211002,5호선,여의나루,14030,15139,29169
20211002,5호선,여의도,9574,10484,20058
20211002,5호선,신길,2421,2533,4954
20211002,5호선,영등포시장,6659,6884,13543
20211002,5호선,영등포구청,1882,1805,3687
20211002,5호선,양평,3433,3175,6608
20211002,5호선,오목교,15061,15563,30624
20211002,5호선,목동,10536,10440,20976
20211002,5호선,신정,8281,7042,15323
20211002,5호선,까치산,19736,18888,38624
20211002,5호선,화곡,18762,17113,35875
20211002,5호선,우장산,9005,8977,17982
20211002,5호선,발산,12434,13237,25671
20211002,5호선,마곡,4755,4815,9570
20211002,5호선,송정,4950,4752,9702
20211002,5호선,김포공항,6656,7005,13661
20211002,5호선,개화산,3594,3442,7036
20211002,5호선,방화,4302,3989,8291
20211003,5호선,오금,1510,1376,2886
20211003,5호선,방화,3415,3373,6788
20211003,5호선,개화산,2684,2787,5471
20211003,5호선,김포공항,6028,5911,11939
20211003,5호선,송정,3433,3434,6867
20211003,5호선,마곡,3252,3300,6552
20211003,5호선,발산,8262,8992,17254
20211003,5호선,우장산,6158,6221,12379
20211003,5호선,화곡,13498,12550,26048
20211003,5호선,까치산,14616,14270,28886
20211003,5호선,신정,6063,5316,11379
20211003,5호선,목동,7226,7253,14479
20211003,5호선,오목교,10537,10976,21513
20211003,5호선,양평,2527,2380,4907
20211003,5호선,영등포구청,1275,1259,2534
20211003,5호선,영등포시장,4270,4408,8678
20211003,5호선,신길,1854,1914,3768
20211003,5호선,여의도,7298,7849,15147
20211003,5호선,여의나루,13702,14646,28348
20211003,5호선,마포,4453,4567,9020
20211003,5호선,공덕,4176,4213,8389
20211003,5호선,애오개,2436,2322,4758
20211003,5호선,충정로,1332,1356,2688
20211003,5호선,서대문,4710,4617,9327
20211003,5호선,광화문,10579,10354,20933
20211003,5호선,종로3가,8908,8460,17368
20211003,5호선,을지로4가,1500,1593,3093
20211003,5호선,동대문역사문화공원,601,791,1392
20211003,5호선,청구,1717,1616,3333
20211003,5호선,신금호,2752,3009,5761
20211003,5호선,행당,3640,3214,6854
20211003,5호선,왕십리,2426,2804,5230
20211003,5호선,마장,2673,2581,5254
20211003,5호선,답십리,6939,6299,13238
20211003,5호선,장한평,7179,7033,14212
20211003,5호선,군자,5712,6304,12016
20211003,5호선,아차산,11101,10801,21902
20211003,5호선,광나루,7574,7618,15192
20211003,5호선,천호,11516,10972,22488
20211003,5호선,강동,8172,7878,16050
20211003,5호선,길동,3897,4007,7904
20211003,5호선,굽은다리,4780,4367,9147
20211003,5호선,명일,4126,4184,8310
20211003,5호선,고덕,4159,4138,8297
20211003,5호선,상일동,6656,6217,12873
20211003,5호선,둔촌동,4068,4181,8249
20211003,5호선,올림픽공원,2523,2628,5151
20211003,5호선,방이,3428,3492,6920
20211003,5호선,개롱,2802,2934,5736
20211003,5호선,거여,3866,3589,7455
20211003,5호선,마천,3282,3423,6705
20211003,5호선,강일,1799,1762,3561
20211003,5호선,미사,8227,8357,16584
20211003,5호선,하남풍산,1958,1940,3898
20211003,5호선,하남시청,3429,3203,6632
20211003,5호선,하남검단산,4432,4472,8904
20211009,5호선,방화,4025,3759,7784
20211009,5호선,개화산,3286,3269,6555
20211009,5호선,김포공항,7226,7281,14507
20211009,5호선,송정,4536,4325,8861
20211009,5호선,마곡,4577,4557,9134
20211009,5호선,발산,11538,12101,23639
20211009,5호선,우장산,8057,7953,16010
20211009,5호선,화곡,17245,15523,32768
20211009,5호선,까치산,18665,17523,36188
20211009,5호선,신정,7627,6500,14127
20211009,5호선,목동,9402,9367,18769
20211009,5호선,오목교,13742,14240,27982
20211009,5호선,양평,3154,2987,6141
20211009,5호선,영등포구청,1744,1658,3402
20211009,5호선,영등포시장,6160,6338,12498
20211009,5호선,신길,2256,2231,4487
20211009,5호선,여의도,9408,10551,19959
20211009,5호선,여의나루,13366,14433,27799
20211009,5호선,마포,6202,6238,12440
20211009,5호선,공덕,5673,5906,11579
20211009,5호선,애오개,3064,2832,5896
20211009,5호선,충정로,1661,1543,3204
20211009,5호선,서대문,5725,5579,11304
20211009,5호선,광화문,12116,12489,24605
20211009,5호선,종로3가,10999,11417,22416
20211009,5호선,을지로4가,2949,3142,6091
20211009,5호선,동대문역사문화공원,830,1093,1923
20211009,5호선,청구,2098,2008,4106
20211009,5호선,신금호,3539,3571,7110
20211009,5호선,행당,5286,4592,9878
20211009,5호선,왕십리,3045,3610,6655
20211009,5호선,마장,3288,3087,6375
20211009,5호선,답십리,8877,7771,16648
20211009,5호선,장한평,9659,9362,19021
20211009,5호선,군자,7430,7922,15352
20211009,5호선,아차산,11397,10967,22364
20211009,5호선,광나루,9510,9040,18550
20211009,5호선,천호,14338,13736,28074
20211009,5호선,강동,10801,10296,21097
20211009,5호선,길동,4879,5008,9887
20211009,5호선,굽은다리,6131,5527,11658
20211009,5호선,명일,5368,5274,10642
20211009,5호선,고덕,5735,5556,11291
20211009,5호선,상일동,8333,7641,15974
20211009,5호선,둔촌동,5400,5343,10743
20211009,5호선,올림픽공원,3008,3045,6053
20211009,5호선,방이,4372,4246,8618
20211009,5호선,오금,1892,1746,3638
20211009,5호선,개롱,3645,3847,7492
20211009,5호선,거여,5109,4901,10010
20211009,5호선,마천,4113,4109,8222
20211009,5호선,강일,2338,2087,4425
20211009,5호선,미사,10426,10475,20901
20211009,5호선,하남풍산,2385,2504,4889
20211009,5호선,하남시청,4750,4544,9294
20211009,5호선,하남검단산,4877,4933,9810
20211010,5호선,길동,3560,3729,7289
20211010,5호선,하남검단산,3730,3772,7502
20211010,5호선,하남시청,3188,3065,6253
20211010,5호선,하남풍산,1809,1856,3665
20211010,5호선,미사,7340,7510,14850
20211010,5호선,강일,1657,1550,3207
20211010,5호선,마천,2921,3131,6052
20211010,5호선,거여,3694,3457,7151
20211010,5호선,개롱,2594,2950,5544
20211010,5호선,오금,1428,1321,2749
20211010,5호선,방이,3311,3187,6498
20211010,5호선,올림픽공원,2136,2021,4157
20211010,5호선,둔촌동,3825,3979,7804
20211010,5호선,상일동,5935,5806,11741
20211010,5호선,고덕,3647,3565,7212
20211010,5호선,명일,3832,3964,7796
20211010,5호선,굽은다리,4220,3988,8208
20211010,5호선,강동,7901,7799,15700
20211010,5호선,천호,10721,9922,20643
20211010,5호선,광나루,6413,6143,12556
20211010,5호선,아차산,8337,8129,16466
20211010,5호선,군자,5426,6117,11543
20211010,5호선,장한평,6555,6554,13109
20211010,5호선,답십리,6308,6038,12346
20211010,5호선,마장,2593,2362,4955
20211010,5호선,왕십리,2156,2507,4663
20211010,5호선,행당,3455,3187,6642
20211010,5호선,신금호,2527,2735,5262
20211010,5호선,청구,1497,1433,2930
20211010,5호선,동대문역사문화공원,611,785,1396
20211010,5호선,을지로4가,1203,1416,2619
20211010,5호선,종로3가,8381,8104,16485
20211010,5호선,광화문,9660,9396,19056
20211010,5호선,서대문,4267,4248,8515
20211010,5호선,충정로,1249,1229,2478
20211010,5호선,애오개,2301,2246,4547
20211010,5호선,공덕,4173,4290,8463
20211010,5호선,마포,4209,4271,8480
20211010,5호선,여의나루,5247,7285,12532
20211010,5호선,여의도,8355,8043,16398
20211010,5호선,신길,1669,1813,3482
20211010,5호선,영등포시장,4026,4189,8215
20211010,5호선,영등포구청,1144,1122,2266
20211010,5호선,양평,2234,2347,4581
20211010,5호선,오목교,10043,9974,20017
20211010,5호선,목동,6619,6744,13363
20211010,5호선,신정,5334,4932,10266
20211010,5호선,까치산,13502,13315,26817
20211010,5호선,화곡,11990,11415,23405
20211010,5호선,우장산,5815,5900,11715
20211010,5호선,발산,8357,8939,17296
20211010,5호선,마곡,3016,3084,6100
20211010,5호선,송정,3211,3261,6472
20211010,5호선,김포공항,6179,5775,11954
20211010,5호선,개화산,2449,2406,4855
20211010,5호선,방화,3146,2998,6144
20211016,5호선,강동,12494,11955,24449
20211016,5호선,방화,4600,4430,9030
20211016,5호선,개화산,3679,3583,7262
20211016,5호선,김포공항,7302,7363,14665
20211016,5호선,송정,5034,4798,9832
20211016,5호선,마곡,5348,5308,10656
20211016,5호선,발산,13579,14212,27791
20211016,5호선,우장산,9446,9501,18947
20211016,5호선,화곡,19335,17797,37132
20211016,5호선,까치산,20397,19569,39966
20211016,5호선,신정,8344,7450,15794
20211016,5호선,목동,10618,10814,21432
20211016,5호선,오목교,15623,16199,31822
20211016,5호선,양평,3601,3482,7083
20211016,5호선,영등포구청,1771,1776,3547
20211016,5호선,영등포시장,6805,7262,14067
20211016,5호선,신길,2493,2643,5136
20211016,5호선,여의도,11616,11340,22956
20211016,5호선,여의나루,8624,11067,19691
20211016,5호선,마포,6988,7037,14025
20211016,5호선,공덕,6620,6860,13480
20211016,5호선,애오개,3477,3513,6990
20211016,5호선,충정로,1871,1837,3708
20211016,5호선,서대문,7024,6850,13874
20211016,5호선,광화문,14187,14627,28814
20211016,5호선,종로3가,12174,11825,23999
20211016,5호선,을지로4가,2926,3354,6280
20211016,5호선,동대문역사문화공원,925,1205,2130
20211016,5호선,청구,2451,2322,4773
20211016,5호선,신금호,4219,4250,8469
20211016,5호선,행당,5400,4786,10186
20211016,5호선,왕십리,3450,4035,7485
20211016,5호선,마장,3741,3644,7385
20211016,5호선,답십리,9570,8855,18425
20211016,5호선,장한평,10738,10522,21260
20211016,5호선,군자,8119,8896,17015
20211016,5호선,아차산,12272,11959,24231
20211016,5호선,광나루,9812,9431,19243
20211016,5호선,천호,16196,15242,31438
20211016,5호선,길동,5785,5965,11750
20211016,5호선,굽은다리,6812,6475,13287
20211016,5호선,명일,5924,5909,11833
20211016,5호선,고덕,6724,6489,13213
20211016,5호선,상일동,9163,8718,17881
20211016,5호선,둔촌동,5936,5939,11875
20211016,5호선,올림픽공원,3156,3109,6265
20211016,5호선,방이,5248,5156,10404
20211016,5호선,오금,2444,2339,4783
20211016,5호선,개롱,4171,4392,8563
20211016,5호선,거여,5619,5393,11012
20211016,5호선,마천,4477,4662,9139
20211016,5호선,강일,2613,2442,5055
20211016,5호선,미사,11149,11311,22460
20211016,5호선,하남풍산,2597,2660,5257
20211016,5호선,하남시청,4897,4735,9632
20211016,5호선,하남검단산,4760,4830,9590
20211017,5호선,방화,3159,3216,6375
20211017,5호선,개화산,2377,2437,4814
20211017,5호선,김포공항,6767,6263,13030
20211017,5호선,송정,3464,3568,7032
20211017,5호선,마곡,3110,3222,6332
20211017,5호선,발산,8471,8916,17387
20211017,5호선,우장산,5909,6174,12083
20211017,5호선,화곡,12859,12272,25131
20211017,5호선,까치산,14326,13844,28170
20211017,5호선,신정,5693,5233,10926
20211017,5호선,목동,6895,7115,14010
20211017,5호선,오목교,10687,10954,21641
20211017,5호선,양평,2424,2601,5025
20211017,5호선,영등포구청,1256,1234,2490
20211017,5호선,영등포시장,4450,4647,9097
20211017,5호선,신길,1730,1877,3607
20211017,5호선,여의도,7454,7314,14768
20211017,5호선,여의나루,6888,8035,14923
20211017,5호선,마포,4333,4378,8711
20211017,5호선,공덕,4099,4239,8338
20211017,5호선,애오개,2321,2318,4639
20211017,5호선,충정로,1283,1353,2636
20211017,5호선,서대문,5141,5263,10404
20211017,5호선,광화문,10147,10329,20476
20211017,5호선,종로3가,8020,6918,14938
20211017,5호선,을지로4가,1280,1333,2613
20211017,5호선,동대문역사문화공원,643,768,1411
20211017,5호선,청구,1657,1570,3227
20211017,5호선,신금호,2676,2998,5674
20211017,5호선,행당,3550,3233,6783
20211017,5호선,왕십리,2250,2656,4906
20211017,5호선,마장,2690,2451,5141
20211017,5호선,답십리,6588,6158,12746
20211017,5호선,장한평,6858,6921,13779
20211017,5호선,군자,5692,6053,11745
20211017,5호선,아차산,9102,9049,18151
20211017,5호선,광나루,6759,6690,13449
20211017,5호선,천호,11447,10769,22216
20211017,5호선,강동,8010,8056,16066
20211017,5호선,길동,3889,3921,7810
20211017,5호선,굽은다리,4747,4535,9282
20211017,5호선,명일,3950,3985,7935
20211017,5호선,고덕,4192,4092,8284
20211017,5호선,상일동,6074,5954,12028
20211017,5호선,둔촌동,3985,4143,8128
20211017,5호선,올림픽공원,2260,2249,4509
20211017,5호선,방이,3815,3671,7486
20211017,5호선,오금,1425,1320,2745
20211017,5호선,개롱,2643,2828,5471
20211017,5호선,거여,3589,3525,7114
20211017,5호선,마천,3144,3373,6517
20211017,5호선,강일,1714,1621,3335
20211017,5호선,미사,7830,7776,15606
20211017,5호선,하남풍산,1798,1821,3619
20211017,5호선,하남시청,3365,3211,6576
20211017,5호선,하남검단산,3898,3917,7815
20211023,5호선,하남시청,5112,4912,10024
20211023,5호선,하남풍산,2520,2578,5098
20211023,5호선,미사,11724,11723,23447
20211023,5호선,강일,2627,2463,5090
20211023,5호선,마천,4756,4834,9590
20211023,5호선,거여,5896,5628,11524
20211023,5호선,개롱,4323,4575,8898
20211023,5호선,오금,2108,2033,4141
20211023,5호선,방이,5019,4980,9999
20211023,5호선,올림픽공원,3520,3590,7110
20211023,5호선,둔촌동,6313,6230,12543
20211023,5호선,상일동,9625,8911,18536
20211023,5호선,고덕,6276,6121,12397
20211023,5호선,명일,6126,6055,12181
20211023,5호선,굽은다리,7109,6794,13903
20211023,5호선,길동,5720,5844,11564
20211023,5호선,강동,12580,11928,24508
20211023,5호선,천호,16580,15628,32208
20211023,5호선,광나루,10769,10174,20943
20211023,5호선,아차산,12789,12220,25009
20211023,5호선,군자,8473,9105,17578
20211023,5호선,장한평,11043,10744,21787
20211023,5호선,답십리,10055,9227,19282
20211023,5호선,마장,3851,3669,7520
20211023,5호선,왕십리,3619,4247,7866
20211023,5호선,행당,5820,4992,10812
20211023,5호선,신금호,4066,4227,8293
20211023,5호선,청구,2470,2388,4858
20211023,5호선,동대문역사문화공원,989,1273,2262
20211023,5호선,을지로4가,3445,3929,7374
20211023,5호선,종로3가,12837,12884,25721
20211023,5호선,광화문,15028,15179,30207
20211023,5호선,서대문,7190,7080,14270
20211023,5호선,충정로,1884,1747,3631
20211023,5호선,애오개,3754,3476,7230
20211023,5호선,공덕,7004,7341,14345
20211023,5호선,마포,7177,7118,14295
20211023,5호선,여의나루,12449,13604,26053
20211023,5호선,여의도,10634,11475,22109
20211023,5호선,신길,2509,2686,5195
20211023,5호선,영등포시장,7404,7790,15194
20211023,5호선,영등포구청,1885,1851,3736
20211023,5호선,양평,3730,3456,7186
20211023,5호선,오목교,16380,16861,33241
20211023,5호선,목동,11310,11326,22636
20211023,5호선,신정,8755,7686,16441
20211023,5호선,까치산,20946,19992,40938
20211023,5호선,화곡,20095,18465,38560
20211023,5호선,우장산,9576,9515,19091
20211023,5호선,발산,13850,14725,28575
20211023,5호선,마곡,5193,5294,10487
20211023,5호선,송정,5115,4902,10017
20211023,5호선,김포공항,7539,7479,15018
20211023,5호선,개화산,3695,3593,7288
20211023,5호선,방화,4670,4473,9143
20211023,5호선,하남검단산,5117,5146,10263
20211024,5호선,방화,3538,3457,6995
20211024,5호선,개화산,2688,2727,5415
20211024,5호선,김포공항,6786,6591,13377
20211024,5호선,송정,3590,3557,7147
20211024,5호선,마곡,3349,3411,6760
20211024,5호선,발산,9167,9696,18863
20211024,5호선,우장산,6557,6707,13264
20211024,5호선,화곡,13738,13105,26843
20211024,5호선,까치산,15214,14884,30098
20211024,5호선,신정,6147,5589,11736
20211024,5호선,목동,7406,7744,15150
20211024,5호선,오목교,11321,11611,22932
20211024,5호선,양평,2515,2562,5077
20211024,5호선,영등포구청,1248,1292,2540
20211024,5호선,영등포시장,4704,4839,9543
20211024,5호선,신길,1717,1929,3646
20211024,5호선,여의도,7429,7704,15133
20211024,5호선,여의나루,10962,11209,22171
20211024,5호선,마포,4651,4595,9246
20211024,5호선,공덕,4501,4442,8943
20211024,5호선,애오개,2468,2430,4898
20211024,5호선,충정로,1410,1389,2799
20211024,5호선,서대문,5384,5454,10838
20211024,5호선,광화문,11180,10944,22124
20211024,5호선,종로3가,8855,8069,16924
20211024,5호선,을지로4가,1564,1686,3250
20211024,5호선,동대문역사문화공원,635,796,1431
20211024,5호선,청구,1692,1707,3399
20211024,5호선,신금호,2943,3226,6169
20211024,5호선,행당,4000,3643,7643
20211024,5호선,왕십리,2342,2842,5184
20211024,5호선,마장,2753,2611,5364
20211024,5호선,답십리,7157,6695,13852
20211024,5호선,장한평,7216,7200,14416
20211024,5호선,군자,5832,6350,12182
20211024,5호선,아차산,10835,10724,21559
20211024,5호선,광나루,7516,7280,14796
20211024,5호선,천호,11972,11217,23189
20211024,5호선,강동,8719,8639,17358
20211024,5호선,길동,3987,4186,8173
20211024,5호선,굽은다리,5030,4726,9756
20211024,5호선,명일,4476,4439,8915
20211024,5호선,고덕,4053,4065,8118
20211024,5호선,상일동,6646,6434,13080
20211024,5호선,둔촌동,4265,4408,8673
20211024,5호선,올림픽공원,2684,2821,5505
20211024,5호선,방이,3729,3502,7231
20211024,5호선,오금,1558,1474,3032
20211024,5호선,개롱,2773,3190,5963
20211024,5호선,거여,3963,3872,7835
20211024,5호선,마천,3495,3792,7287
20211024,5호선,강일,1998,1838,3836
20211024,5호선,미사,8634,8746,17380
20211024,5호선,하남풍산,1971,2052,4023
20211024,5호선,하남시청,3913,3667,7580
20211024,5호선,하남검단산,4453,4528,8981
20211030,5호선,하남검단산,5441,5551,10992
20211030,5호선,하남시청,5030,4943,9973
20211030,5호선,하남풍산,2803,2809,5612
20211030,5호선,미사,12301,12071,24372
20211030,5호선,강일,2906,2619,5525
20211030,5호선,마천,4641,4751,9392
20211030,5호선,거여,5848,5554,11402
20211030,5호선,개롱,4551,4728,9279
20211030,5호선,오금,2408,2185,4593
20211030,5호선,방이,5447,5214,10661
20211030,5호선,올림픽공원,4042,3889,7931
20211030,5호선,둔촌동,6453,6428,12881
20211030,5호선,상일동,9861,9058,18919
20211030,5호선,고덕,6766,6657,13423
20211030,5호선,명일,6368,6281,12649
20211030,5호선,굽은다리,7473,6922,14395
20211030,5호선,길동,5910,6171,12081
20211030,5호선,강동,12891,12184,25075
20211030,5호선,천호,17464,16263,33727
20211030,5호선,광나루,11220,10671,21891
20211030,5호선,아차산,13395,13211,26606
20211030,5호선,군자,8405,9126,17531
20211030,5호선,장한평,11138,10859,21997
20211030,5호선,답십리,10286,9214,19500
20211030,5호선,마장,3969,3725,7694
20211030,5호선,왕십리,3667,4341,8008
20211030,5호선,행당,5701,4939,10640
20211030,5호선,신금호,4346,4479,8825
20211030,5호선,청구,2539,2475,5014
20211030,5호선,동대문역사문화공원,968,1289,2257
20211030,5호선,을지로4가,3487,3749,7236
20211030,5호선,종로3가,13606,13835,27441
20211030,5호선,광화문,16447,16672,33119
20211030,5호선,서대문,7379,7101,14480
20211030,5호선,충정로,1905,1708,3613
20211030,5호선,애오개,3647,3361,7008
20211030,5호선,공덕,7161,7356,14517
20211030,5호선,마포,7308,7377,14685
20211030,5호선,여의나루,12980,14206,27186
20211030,5호선,여의도,10886,11658,22544
20211030,5호선,신길,2626,2786,5412
20211030,5호선,영등포시장,7159,7465,14624
20211030,5호선,영등포구청,1990,1947,3937
20211030,5호선,양평,3844,3660,7504
20211030,5호선,오목교,16156,16782,32938
20211030,5호선,목동,11328,11337,22665
20211030,5호선,신정,8911,7724,16635
20211030,5호선,까치산,21221,20280,41501
20211030,5호선,화곡,20460,18949,39409
20211030,5호선,우장산,10083,9732,19815
20211030,5호선,발산,13817,14969,28786
20211030,5호선,마곡,5387,5257,10644
20211030,5호선,송정,5178,4978,10156
20211030,5호선,김포공항,7362,7388,14750
20211030,5호선,개화산,3752,3716,7468
20211030,5호선,방화,4830,4599,9429
20211031,5호선,하남검단산,4327,4437,8764
20211031,5호선,하남시청,3783,3580,7363
20211031,5호선,하남풍산,2273,2247,4520
20211031,5호선,미사,8748,8584,17332
20211031,5호선,강일,2104,1939,4043
20211031,5호선,마천,3570,3921,7491
20211031,5호선,거여,4143,4053,8196
20211031,5호선,개롱,3084,3348,6432
20211031,5호선,오금,1602,1555,3157
20211031,5호선,방이,3982,3899,7881
20211031,5호선,올림픽공원,3256,3301,6557
20211031,5호선,둔촌동,4437,4463,8900
20211031,5호선,상일동,6793,6679,13472
20211031,5호선,고덕,4629,4484,9113
20211031,5호선,명일,4951,4913,9864
20211031,5호선,굽은다리,5417,5253,10670
20211031,5호선,길동,4105,4271,8376
20211031,5호선,강동,8878,8879,17757
20211031,5호선,천호,12944,11914,24858
20211031,5호선,광나루,8560,8615,17175
20211031,5호선,아차산,11118,10944,22062
20211031,5호선,군자,6168,6804,12972
20211031,5호선,장한평,7743,7711,15454
20211031,5호선,답십리,7269,6779,14048
20211031,5호선,마장,2866,2737,5603
20211031,5호선,왕십리,2652,3043,5695
20211031,5호선,행당,3946,3543,7489
20211031,5호선,신금호,2972,3253,6225
20211031,5호선,청구,1746,1711,3457
20211031,5호선,동대문역사문화공원,685,787,1472
20211031,5호선,을지로4가,1533,1634,3167
20211031,5호선,종로3가,9749,8706,18455
20211031,5호선,광화문,12635,12240,24875
20211031,5호선,서대문,5188,5261,10449
20211031,5호선,충정로,1428,1453,2881
20211031,5호선,애오개,2541,2583,5124
20211031,5호선,공덕,4747,4798,9545
20211031,5호선,마포,4610,4579,9189
20211031,5호선,여의나루,11375,11863,23238
20211031,5호선,여의도,7826,7917,15743
20211031,5호선,신길,1819,2058,3877
20211031,5호선,영등포시장,4669,4940,9609
20211031,5호선,영등포구청,1428,1380,2808
20211031,5호선,양평,2619,2619,5238
20211031,5호선,오목교,11451,11805,23256
20211031,5호선,목동,7573,7789,15362
20211031,5호선,신정,6216,5726,11942
20211031,5호선,까치산,15339,14945,30284
20211031,5호선,화곡,14240,13560,27800
20211031,5호선,우장산,6656,6961,13617
20211031,5호선,발산,9196,9560,18756
20211031,5호선,마곡,3471,3505,6976
20211031,5호선,송정,3579,3663,7242
20211031,5호선,김포공항,6891,6565,13456
20211031,5호선,개화산,2762,2898,5660
20211031,5호선,방화,3595,3572,7167
20211106,5호선,방화,4898,4547,9445
20211106,5호선,개화산,3899,3707,7606
20211106,5호선,김포공항,7565,7517,15082
20211106,5호선,송정,5219,4975,10194
20211106,5호선,마곡,5425,5388,10813
20211106,5호선,발산,14278,15723,30001
20211106,5호선,우장산,10277,9741,20018
20211106,5호선,화곡,20914,19070,39984
20211106,5호선,까치산,21745,20101,41846
20211106,5호선,신정,9273,7715,16988
20211106,5호선,목동,11609,11610,23219
20211106,5호선,오목교,17506,18092,35598
20211106,5호선,양평,3705,3451,7156
20211106,5호선,영등포구청,1968,1931,3899
20211106,5호선,영등포시장,8058,8414,16472
20211106,5호선,신길,2614,2761,5375
20211106,5호선,여의도,11045,12172,23217
20211106,5호선,여의나루,13050,14055,27105
20211106,5호선,마포,7688,7775,15463
20211106,5호선,공덕,7599,7799,15398
20211106,5호선,애오개,3732,3546,7278
20211106,5호선,충정로,2089,1943,4032
20211106,5호선,서대문,7803,7656,15459
20211106,5호선,광화문,18647,18696,37343
20211106,5호선,종로3가,13940,14644,28584
20211106,5호선,을지로4가,3626,3949,7575
20211106,5호선,동대문역사문화공원,996,1259,2255
20211106,5호선,청구,2584,2275,4859
20211106,5호선,신금호,4373,4464,8837
20211106,5호선,행당,5821,5083,10904
20211106,5호선,왕십리,3637,4516,8153
20211106,5호선,마장,3955,3752,7707
20211106,5호선,답십리,10503,9356,19859
20211106,5호선,장한평,11626,11104,22730
20211106,5호선,군자,8742,9459,18201
20211106,5호선,아차산,14335,13804,28139
20211106,5호선,광나루,10520,9993,20513
20211106,5호선,천호,17015,16261,33276
20211106,5호선,강동,13365,12657,26022
20211106,5호선,길동,6070,6313,12383
20211106,5호선,굽은다리,7765,7191,14956
20211106,5호선,명일,6586,6484,13070
20211106,5호선,고덕,6904,6589,13493
20211106,5호선,상일동,10267,9387,19654
20211106,5호선,둔촌동,6348,6340,12688
20211106,5호선,올림픽공원,3980,4117,8097
20211106,5호선,방이,5880,5793,11673
20211106,5호선,오금,3054,2748,5802
20211106,5호선,개롱,4536,4634,9170
20211106,5호선,거여,6080,5696,11776
20211106,5호선,마천,4902,4912,9814
20211106,5호선,강일,2796,2579,5375
20211106,5호선,미사,12726,12258,24984
20211106,5호선,하남풍산,2713,2710,5423
20211106,5호선,하남시청,5191,5005,10196
20211106,5호선,하남검단산,5303,5281,10584
20211107,5호선,하남검단산,4544,4430,8974
20211107,5호선,하남시청,3754,3475,7229
20211107,5호선,하남풍산,2192,2161,4353
20211107,5호선,미사,8803,8770,17573
20211107,5호선,강일,2159,2012,4171
20211107,5호선,마천,3754,3991,7745
20211107,5호선,거여,4343,4102,8445
20211107,5호선,개롱,3192,3464,6656
20211107,5호선,오금,1610,1560,3170
20211107,5호선,방이,4011,3878,7889
20211107,5호선,올림픽공원,2997,3114,6111
20211107,5호선,둔촌동,4578,4603,9181
20211107,5호선,상일동,7277,6811,14088
20211107,5호선,고덕,4453,4492,8945
20211107,5호선,명일,4820,4983,9803
20211107,5호선,굽은다리,5568,5279,10847
20211107,5호선,길동,4124,4279,8403
20211107,5호선,강동,9387,9145,18532
20211107,5호선,천호,12755,12182,24937
20211107,5호선,광나루,8294,8037,16331
20211107,5호선,아차산,11736,11739,23475
20211107,5호선,군자,6285,6880,13165
20211107,5호선,장한평,7986,7896,15882
20211107,5호선,답십리,7615,7099,14714
20211107,5호선,마장,3015,2734,5749
20211107,5호선,왕십리,2653,3055,5708
20211107,5호선,행당,4012,3570,7582
20211107,5호선,신금호,3054,3249,6303
20211107,5호선,청구,1811,1672,3483
20211107,5호선,동대문역사문화공원,693,785,1478
20211107,5호선,을지로4가,1600,1740,3340
20211107,5호선,종로3가,9907,8803,18710
20211107,5호선,광화문,12873,12502,25375
20211107,5호선,서대문,5889,5775,11664
20211107,5호선,충정로,1523,1427,2950
20211107,5호선,애오개,2776,2751,5527
20211107,5호선,공덕,4881,4889,9770
20211107,5호선,마포,4981,4848,9829
20211107,5호선,여의나루,10936,11311,22247
20211107,5호선,여의도,7556,8114,15670
20211107,5호선,신길,1921,2060,3981
20211107,5호선,영등포시장,5305,5578,10883
20211107,5호선,영등포구청,1449,1551,3000
20211107,5호선,양평,2679,2729,5408
20211107,5호선,오목교,12125,12631,24756
20211107,5호선,목동,7897,8010,15907
20211107,5호선,신정,6590,5981,12571
20211107,5호선,까치산,15731,15360,31091
20211107,5호선,화곡,14558,13640,28198
20211107,5호선,우장산,7044,7245,14289
20211107,5호선,발산,9468,10154,19622
20211107,5호선,마곡,3588,3638,7226
20211107,5호선,송정,3714,3819,7533
20211107,5호선,김포공항,6987,6739,13726
20211107,5호선,개화산,2912,2937,5849
20211107,5호선,방화,3622,3585,7207
20211113,5호선,하남검단산,5109,5103,10212
20211113,5호선,하남시청,4948,4758,9706
20211113,5호선,하남풍산,2605,2596,5201
20211113,5호선,미사,11792,11561,23353
20211113,5호선,강일,2759,2488,5247
20211113,5호선,마천,4679,4710,9389
20211113,5호선,거여,6055,5506,11561
20211113,5호선,개롱,4615,4818,9433
20211113,5호선,오금,2364,2169,4533
20211113,5호선,방이,5409,5104,10513
20211113,5호선,올림픽공원,3385,3189,6574
20211113,5호선,둔촌동,6457,6373,12830
20211113,5호선,상일동,9956,9082,19038
20211113,5호선,개화산,3845,3727,7572
20211113,5호선,방화,4761,4401,9162
20211113,5호선,고덕,6484,6189,12673
20211113,5호선,명일,6279,6214,12493
20211113,5호선,굽은다리,7194,6683,13877
20211113,5호선,길동,6122,6304,12426
20211113,5호선,강동,13364,12529,25893
20211113,5호선,천호,16910,16378,33288
20211113,5호선,광나루,10797,10185,20982
20211113,5호선,아차산,12596,12039,24635
20211113,5호선,군자,8549,9466,18015
20211113,5호선,장한평,11457,11121,22578
20211113,5호선,답십리,10382,9365,19747
20211113,5호선,마장,3959,3804,7763
20211113,5호선,왕십리,3587,4313,7900
20211113,5호선,행당,5672,4968,10640
20211113,5호선,신금호,4186,4242,8428
20211113,5호선,청구,2574,2319,4893
20211113,5호선,동대문역사문화공원,983,1281,2264
20211113,5호선,을지로4가,3573,3897,7470
20211113,5호선,종로3가,14248,16855,31103
20211113,5호선,광화문,13324,13492,26816
20211113,5호선,서대문,8962,9115,18077
20211113,5호선,충정로,2232,2004,4236
20211113,5호선,애오개,3816,3700,7516
20211113,5호선,공덕,7675,7916,15591
20211113,5호선,마포,7686,7659,15345
20211113,5호선,여의나루,9348,10868,20216
20211113,5호선,여의도,11649,12211,23860
20211113,5호선,신길,2612,2569,5181
20211113,5호선,영등포시장,8099,8629,16728
20211113,5호선,영등포구청,2024,1992,4016
20211113,5호선,양평,3681,3422,7103
20211113,5호선,오목교,16151,16784,32935
20211113,5호선,목동,11317,11149,22466
20211113,5호선,신정,8948,7354,16302
20211113,5호선,까치산,21391,19893,41284
20211113,5호선,화곡,20628,18720,39348
20211113,5호선,우장산,10155,9824,19979
20211113,5호선,발산,14641,15863,30504
20211113,5호선,마곡,5253,5261,10514
20211113,5호선,송정,5187,4988,10175
20211113,5호선,김포공항,7589,7506,15095
20211114,5호선,하남검단산,4461,4418,8879
20211114,5호선,하남시청,3958,3776,7734
20211114,5호선,하남풍산,2089,2110,4199
20211114,5호선,미사,8585,8583,17168
20211114,5호선,강일,2001,1842,3843
20211114,5호선,마천,3525,3870,7395
20211114,5호선,거여,4303,4004,8307
20211114,5호선,개롱,3046,3355,6401
20211114,5호선,오금,1665,1519,3184
20211114,5호선,방이,4152,4015,8167
20211114,5호선,올림픽공원,2585,2380,4965
20211114,5호선,둔촌동,4426,4465,8891
20211114,5호선,상일동,6882,6552,13434
20211114,5호선,고덕,4165,4161,8326
20211114,5호선,명일,4798,4850,9648
20211114,5호선,굽은다리,5113,4747,9860
20211114,5호선,길동,4145,4264,8409
20211114,5호선,강동,9048,9023,18071
20211114,5호선,천호,12436,11688,24124
20211114,5호선,광나루,8063,7752,15815
20211114,5호선,아차산,10415,10341,20756
20211114,5호선,군자,6000,6631,12631
20211114,5호선,장한평,7791,7902,15693
20211114,5호선,답십리,7522,6933,14455
20211114,5호선,마장,2808,2643,5451
20211114,5호선,왕십리,2431,2918,5349
20211114,5호선,행당,3964,3642,7606
20211114,5호선,신금호,2859,3139,5998
20211114,5호선,청구,1775,1631,3406
20211114,5호선,동대문역사문화공원,679,820,1499
20211114,5호선,을지로4가,1605,1663,3268
20211114,5호선,종로3가,9102,8273,17375
20211114,5호선,광화문,12236,12133,24369
20211114,5호선,서대문,5282,5217,10499
20211114,5호선,충정로,1334,1398,2732
20211114,5호선,애오개,2622,2632,5254
20211114,5호선,공덕,4677,4904,9581
20211114,5호선,마포,4896,4852,9748
20211114,5호선,여의나루,8672,9630,18302
20211114,5호선,여의도,7709,8114,15823
20211114,5호선,신길,1774,1993,3767
20211114,5호선,영등포시장,5430,5839,11269
20211114,5호선,영등포구청,1276,1301,2577
20211114,5호선,양평,2543,2550,5093
20211114,5호선,오목교,11237,11693,22930
20211114,5호선,목동,7554,7726,15280
20211114,5호선,신정,6345,5753,12098
20211114,5호선,까치산,15529,15017,30546
20211114,5호선,화곡,14178,13269,27447
20211114,5호선,우장산,6786,6953,13739
20211114,5호선,발산,9686,10576,20262
20211114,5호선,마곡,3553,3674,7227
20211114,5호선,송정,3797,3761,7558
20211114,5호선,김포공항,6879,6374,13253
20211114,5호선,개화산,2758,2805,5563
20211114,5호선,방화,3743,3648,7391
20211120,5호선,하남검단산,4903,4874,9777
20211120,5호선,하남시청,5182,4828,10010
20211120,5호선,하남풍산,2692,2721,5413
20211120,5호선,미사,11971,11670,23641
20211120,5호선,강일,2658,2382,5040
20211120,5호선,마천,4853,5038,9891
20211120,5호선,거여,6402,5892,12294
20211120,5호선,개롱,4372,4491,8863
20211120,5호선,오금,2519,2140,4659
20211120,5호선,방이,5546,5249,10795
20211120,5호선,올림픽공원,3115,2768,5883
20211120,5호선,둔촌동,6186,6222,12408
20211120,5호선,상일동,9739,8764,18503
20211120,5호선,고덕,6633,6390,13023
20211120,5호선,명일,6216,6107,12323
20211120,5호선,굽은다리,6935,6401,13336
20211120,5호선,길동,5793,5913,11706
20211120,5호선,강동,12996,12118,25114
20211120,5호선,천호,16693,16135,32828
20211120,5호선,광나루,10788,10070,20858
20211120,5호선,아차산,12197,11582,23779
20211120,5호선,군자,8537,9273,17810
20211120,5호선,장한평,11670,11302,22972
20211120,5호선,답십리,10380,9304,19684
20211120,5호선,마장,3891,3884,7775
20211120,5호선,왕십리,3537,4434,7971
20211120,5호선,행당,5550,4872,10422
20211120,5호선,신금호,4083,4181,8264
20211120,5호선,청구,2569,2331,4900
20211120,5호선,동대문역사문화공원,1002,1338,2340
20211120,5호선,을지로4가,3319,3628,6947
20211120,5호선,종로3가,12980,13142,26122
20211120,5호선,광화문,15724,16596,32320
20211120,5호선,서대문,7534,7338,14872
20211120,5호선,충정로,1961,1786,3747
20211120,5호선,애오개,3560,3485,7045
20211120,5호선,공덕,7454,7687,15141
20211120,5호선,마포,7424,7549,14973
20211120,5호선,여의나루,9479,11203,20682
20211120,5호선,여의도,11693,12188,23881
20211120,5호선,신길,2592,2557,5149
20211120,5호선,영등포시장,8357,8641,16998
20211120,5호선,영등포구청,1957,1993,3950
20211120,5호선,양평,3743,3446,7189
20211120,5호선,오목교,15968,16925,32893
20211120,5호선,목동,11405,11423,22828
20211120,5호선,신정,9039,7627,16666
20211120,5호선,까치산,21197,19612,40809
20211120,5호선,화곡,20633,18369,39002
20211120,5호선,우장산,9722,9453,19175
20211120,5호선,발산,14107,15294,29401
20211120,5호선,마곡,5428,5549,10977
20211120,5호선,송정,4974,4799,9773
20211120,5호선,김포공항,7689,7390,15079
20211120,5호선,개화산,3709,3499,7208
20211120,5호선,방화,4538,4247,8785
20211121,5호선,방화,3394,3415,6809
20211121,5호선,개화산,2551,2637,5188
20211121,5호선,김포공항,7155,6393,13548
20211121,5호선,송정,3553,3624,7177
20211121,5호선,마곡,3387,3502,6889
20211121,5호선,발산,9306,9642,18948
20211121,5호선,우장산,6504,6735,13239
20211121,5호선,화곡,13868,13289,27157
20211121,5호선,까치산,14971,14965,29936
20211121,5호선,신정,6125,5603,11728
20211121,5호선,목동,7858,8175,16033
20211121,5호선,오목교,11002,11878,22880
20211121,5호선,양평,2548,2641,5189
20211121,5호선,영등포구청,1374,1351,2725
20211121,5호선,영등포시장,4806,4890,9696
20211121,5호선,신길,1775,2087,3862
20211121,5호선,여의도,7904,8147,16051
20211121,5호선,여의나루,6959,8043,15002
20211121,5호선,마포,4658,4666,9324
20211121,5호선,공덕,4643,4911,9554
20211121,5호선,애오개,2587,2624,5211
20211121,5호선,충정로,1388,1386,2774
20211121,5호선,서대문,5073,4985,10058
20211121,5호선,광화문,11152,11459,22611
20211121,5호선,종로3가,8887,7671,16558
20211121,5호선,을지로4가,1424,1464,2888
20211121,5호선,동대문역사문화공원,738,819,1557
20211121,5호선,청구,1683,1544,3227
20211121,5호선,신금호,2816,2968,5784
20211121,5호선,행당,3859,3507,7366
20211121,5호선,왕십리,2490,2968,5458
20211121,5호선,마장,2779,2636,5415
20211121,5호선,답십리,7299,6895,14194
20211121,5호선,장한평,7759,7738,15497
20211121,5호선,군자,6023,6564,12587
20211121,5호선,아차산,9406,9167,18573
20211121,5호선,광나루,7634,7443,15077
20211121,5호선,천호,12276,11409,23685
20211121,5호선,강동,8728,8897,17625
20211121,5호선,길동,3890,4023,7913
20211121,5호선,굽은다리,5062,4806,9868
20211121,5호선,명일,4552,4616,9168
20211121,5호선,고덕,4108,4165,8273
20211121,5호선,상일동,6396,6185,12581
20211121,5호선,둔촌동,4498,4559,9057
20211121,5호선,올림픽공원,2331,2123,4454
20211121,5호선,방이,3952,3750,7702
20211121,5호선,오금,1563,1522,3085
20211121,5호선,개롱,2930,3205,6135
20211121,5호선,거여,4366,4266,8632
20211121,5호선,마천,3545,3872,7417
20211121,5호선,강일,1869,1784,3653
20211121,5호선,미사,8216,8223,16439
20211121,5호선,하남풍산,1937,2008,3945
20211121,5호선,하남시청,3658,3513,7171
20211121,5호선,하남검단산,3882,3861,7743
20211127,5호선,하남검단산,4932,4817,9749
20211127,5호선,을지로4가,3250,3740,6990
20211127,5호선,종로3가,12546,13259,25805
20211127,5호선,광화문,16491,17742,34233
20211127,5호선,서대문,7445,7141,14586
20211127,5호선,충정로,2019,1855,3874
20211127,5호선,애오개,3754,3589,7343
20211127,5호선,공덕,7616,7968,15584
20211127,5호선,마포,7785,7845,15630
20211127,5호선,여의나루,8413,9677,18090
20211127,5호선,여의도,13026,13144,26170
20211127,5호선,신길,2546,2643,5189
20211127,5호선,영등포시장,7885,8231,16116
20211127,5호선,영등포구청,1852,1913,3765
20211127,5호선,오목교,15766,16561,32327
20211127,5호선,목동,11164,11248,22412
20211127,5호선,신정,9073,7488,16561
20211127,5호선,까치산,20990,19938,40928
20211127,5호선,화곡,20270,18331,38601
20211127,5호선,우장산,9998,9613,19611
20211127,5호선,발산,14124,15563,29687
20211127,5호선,마곡,5290,5389,10679
20211127,5호선,송정,5115,4872,9987
20211127,5호선,김포공항,7600,7482,15082
20211127,5호선,개화산,3758,3573,7331
20211127,5호선,방화,4715,4474,9189
20211127,5호선,하남시청,5011,4789,9800
20211127,5호선,동대문역사문화공원,1076,1335,2411
20211127,5호선,청구,2396,2272,4668
20211127,5호선,신금호,4060,4074,8134
20211127,5호선,행당,5925,5199,11124
20211127,5호선,왕십리,3743,4386,8129
20211127,5호선,마장,3948,3794,7742
20211127,5호선,답십리,10266,9133,19399
20211127,5호선,장한평,11295,10967,22262
20211127,5호선,군자,8535,9491,18026
20211127,5호선,아차산,12188,11511,23699
20211127,5호선,광나루,10472,9451,19923
20211127,5호선,천호,16561,15889,32450
20211127,5호선,강동,13112,12115,25227
20211127,5호선,길동,5947,6074,12021
20211127,5호선,굽은다리,6956,6445,13401
20211127,5호선,명일,6269,6136,12405
20211127,5호선,고덕,6176,6047,12223
20211127,5호선,상일동,9828,9018,18846
20211127,5호선,둔촌동,6239,6190,12429
20211127,5호선,올림픽공원,3417,3227,6644
20211127,5호선,방이,5196,5169,10365
20211127,5호선,오금,2091,2023,4114
20211127,5호선,개롱,4321,4455,8776
20211127,5호선,거여,5960,5560,11520
20211127,5호선,마천,4688,4779,9467
20211127,5호선,강일,2750,2459,5209
20211127,5호선,미사,12064,11676,23740
20211127,5호선,하남풍산,2714,2775,5489
20211127,5호선,양평,3711,3470,7181
20211128,5호선,개롱,3131,3291,6422
20211128,5호선,방화,3568,3540,7108
20211128,5호선,개화산,2660,2654,5314
20211128,5호선,김포공항,6776,6390,13166
20211128,5호선,송정,3702,3657,7359
20211128,5호선,마곡,3663,3694,7357
20211128,5호선,발산,9449,10172,19621
20211128,5호선,우장산,6751,6751,13502
20211128,5호선,화곡,13787,13190,26977
20211128,5호선,까치산,15337,14751,30088
20211128,5호선,신정,6288,5782,12070
20211128,5호선,목동,7590,7667,15257
20211128,5호선,오목교,11129,11850,22979
20211128,5호선,양평,2621,2652,5273
20211128,5호선,영등포구청,1323,1278,2601
20211128,5호선,영등포시장,5213,5504,10717
20211128,5호선,신길,1908,2160,4068
20211128,5호선,여의도,8057,8449,16506
20211128,5호선,여의나루,7419,8444,15863
20211128,5호선,마포,4790,4801,9591
20211128,5호선,공덕,4716,4837,9553
20211128,5호선,애오개,2600,2707,5307
20211128,5호선,충정로,1473,1525,2998
20211128,5호선,서대문,5123,4981,10104
20211128,5호선,광화문,12425,12683,25108
20211128,5호선,종로3가,8636,7840,16476
20211128,5호선,을지로4가,1492,1561,3053
20211128,5호선,동대문역사문화공원,688,804,1492
20211128,5호선,청구,1779,1652,3431
20211128,5호선,신금호,3035,3182,6217
20211128,5호선,행당,4000,3597,7597
20211128,5호선,왕십리,2484,2822,5306
20211128,5호선,마장,2897,2739,5636
20211128,5호선,답십리,7209,6757,13966
20211128,5호선,장한평,7821,7811,15632
20211128,5호선,군자,6233,6775,13008
20211128,5호선,아차산,9904,9737,19641
20211128,5호선,광나루,7735,7665,15400
20211128,5호선,천호,12284,11667,23951
20211128,5호선,강동,9044,9148,18192
20211128,5호선,길동,4084,4190,8274
20211128,5호선,굽은다리,4982,4655,9637
20211128,5호선,명일,4627,4755,9382
20211128,5호선,고덕,4108,4165,8273
20211128,5호선,상일동,6679,6540,13219
20211128,5호선,둔촌동,4456,4541,8997
20211128,5호선,올림픽공원,2504,2354,4858
20211128,5호선,방이,4187,3970,8157
20211128,5호선,오금,1572,1502,3074
20211128,5호선,거여,4184,4050,8234
20211128,5호선,마천,3580,3866,7446
20211128,5호선,강일,1897,1784,3681
20211128,5호선,미사,8481,8446,16927
20211128,5호선,하남풍산,1926,2039,3965
20211128,5호선,하남시청,3598,3535,7133
20211128,5호선,하남검단산,4186,4203,8389
20211204,5호선,방화,4533,4338,8871
20211204,5호선,개화산,3672,3414,7086
20211204,5호선,김포공항,7021,6986,14007
20211204,5호선,송정,4749,4633,9382
20211204,5호선,마곡,5241,5159,10400
20211204,5호선,발산,13612,14759,28371
20211204,5호선,우장산,9431,9121,18552
20211204,5호선,화곡,19513,17566,37079
20211204,5호선,까치산,20398,19100,39498
20211204,5호선,신정,8737,7288,16025
20211204,5호선,목동,10847,11073,21920
20211204,5호선,오목교,15174,15943,31117
20211204,5호선,양평,3556,3384,6940
20211204,5호선,영등포구청,1900,1872,3772
20211204,5호선,영등포시장,7955,8208,16163
20211204,5호선,신길,2449,2533,4982
20211204,5호선,여의도,10238,11011,21249
20211204,5호선,여의나루,5613,6724,12337
20211204,5호선,마포,7146,7498,14644
20211204,5호선,공덕,6970,7120,14090
20211204,5호선,애오개,3738,3478,7216
20211204,5호선,충정로,1813,1646,3459
20211204,5호선,서대문,7032,6724,13756
20211204,5호선,광화문,15754,16655,32409
20211204,5호선,종로3가,11360,12100,23460
20211204,5호선,을지로4가,3097,3434,6531
20211204,5호선,동대문역사문화공원,971,1303,2274
20211204,5호선,청구,2435,2246,4681
20211204,5호선,신금호,4039,4060,8099
20211204,5호선,행당,5141,4437,9578
20211204,5호선,왕십리,3386,4115,7501
20211204,5호선,마장,3953,3796,7749
20211204,5호선,답십리,9868,8841,18709
20211204,5호선,장한평,11036,10856,21892
20211204,5호선,군자,8164,8899,17063
20211204,5호선,아차산,11889,11285,23174
20211204,5호선,광나루,9432,8670,18102
20211204,5호선,천호,16171,15561,31732
20211204,5호선,강동,12957,12147,25104
20211204,5호선,길동,5689,5902,11591
20211204,5호선,굽은다리,6847,6379,13226
20211204,5호선,명일,5842,5748,11590
20211204,5호선,고덕,5998,5679,11677
20211204,5호선,상일동,9322,8379,17701
20211204,5호선,둔촌동,6080,5989,12069
20211204,5호선,올림픽공원,3025,2600,5625
20211204,5호선,방이,5067,4907,9974
20211204,5호선,오금,2003,1888,3891
20211204,5호선,개롱,4411,4469,8880
20211204,5호선,거여,5775,5404,11179
20211204,5호선,마천,4557,4692,9249
20211204,5호선,강일,2484,2313,4797
20211204,5호선,미사,11419,11259,22678
20211204,5호선,하남풍산,2623,2599,5222
20211204,5호선,하남시청,5081,4878,9959
20211204,5호선,하남검단산,4651,4647,9298
20211205,5호선,방화,3353,3312,6665
20211205,5호선,개화산,2552,2605,5157
20211205,5호선,김포공항,6426,5730,12156
20211205,5호선,송정,3448,3396,6844
20211205,5호선,마곡,3306,3463,6769
20211205,5호선,발산,9209,9861,19070
20211205,5호선,우장산,6289,6389,12678
20211205,5호선,화곡,13312,12638,25950
20211205,5호선,까치산,14755,14462,29217
20211205,5호선,신정,5882,5339,11221
20211205,5호선,목동,7219,7653,14872
20211205,5호선,오목교,10162,10690,20852
20211205,5호선,양평,2575,2646,5221
20211205,5호선,영등포구청,1259,1232,2491
20211205,5호선,영등포시장,5209,5563,10772
20211205,5호선,신길,1735,1963,3698
20211205,5호선,여의도,7084,7299,14383
20211205,5호선,여의나루,5130,5872,11002
20211205,5호선,마포,4408,4368,8776
20211205,5호선,공덕,4596,4654,9250
20211205,5호선,애오개,2502,2606,5108
20211205,5호선,충정로,1335,1339,2674
20211205,5호선,서대문,4874,4881,9755
20211205,5호선,광화문,11556,11947,23503
20211205,5호선,종로3가,7796,7112,14908
20211205,5호선,을지로4가,1369,1475,2844
20211205,5호선,동대문역사문화공원,639,773,1412
20211205,5호선,청구,1566,1597,3163
20211205,5호선,신금호,2738,2919,5657
20211205,5호선,행당,3843,3540,7383
20211205,5호선,왕십리,2385,2903,5288
20211205,5호선,마장,2925,2761,5686
20211205,5호선,답십리,6889,6415,13304
20211205,5호선,장한평,7358,7339,14697
20211205,5호선,군자,5772,6467,12239
20211205,5호선,아차산,9329,9001,18330
20211205,5호선,광나루,6861,6716,13577
20211205,5호선,천호,11669,11165,22834
20211205,5호선,강동,8283,8315,16598
20211205,5호선,길동,3723,3850,7573
20211205,5호선,굽은다리,5059,4818,9877
20211205,5호선,명일,4497,4575,9072
20211205,5호선,고덕,3987,4056,8043
20211205,5호선,상일동,6304,6168,12472
20211205,5호선,둔촌동,4157,4371,8528
20211205,5호선,올림픽공원,2138,1946,4084
20211205,5호선,방이,3679,3531,7210
20211205,5호선,오금,1553,1419,2972
20211205,5호선,개롱,2845,3110,5955
20211205,5호선,거여,3953,3881,7834
20211205,5호선,마천,3473,3712,7185
20211205,5호선,강일,1836,1734,3570
20211205,5호선,미사,7998,8129,16127
20211205,5호선,하남풍산,1834,2058,3892
20211205,5호선,하남시청,3438,3302,6740
20211205,5호선,하남검단산,4039,3993,8032
20211211,5호선,하남검단산,4514,4458,8972
20211211,5호선,하남시청,4902,4688,9590
20211211,5호선,하남풍산,2393,2395,4788
20211211,5호선,미사,11116,10776,21892
20211211,5호선,강일,2397,2282,4679
20211211,5호선,마천,4581,4769,9350
20211211,5호선,거여,5569,5239,10808
20211211,5호선,개롱,3903,4021,7924
20211211,5호선,오금,1895,1823,3718
20211211,5호선,방이,4794,4846,9640
20211211,5호선,올림픽공원,3393,3239,6632
20211211,5호선,둔촌동,5890,5783,11673
20211211,5호선,상일동,8945,8133,17078
20211211,5호선,고덕,5862,5656,11518
20211211,5호선,명일,5864,5863,11727
20211211,5호선,굽은다리,6858,6368,13226
20211211,5호선,길동,5666,5770,11436
20211211,5호선,강동,12292,11662,23954
20211211,5호선,천호,15476,15117,30593
20211211,5호선,광나루,9466,9091,18557
20211211,5호선,아차산,11734,11031,22765
20211211,5호선,군자,7962,8683,16645
20211211,5호선,장한평,10812,10437,21249
20211211,5호선,답십리,9659,8801,18460
20211211,5호선,마장,3711,3608,7319
20211211,5호선,왕십리,3355,4055,7410
20211211,5호선,행당,5070,4355,9425
20211211,5호선,신금호,3877,3866,7743
20211211,5호선,청구,2370,2179,4549
20211211,5호선,동대문역사문화공원,939,1246,2185
20211211,5호선,을지로4가,3180,3547,6727
20211211,5호선,종로3가,10595,11246,21841
20211211,5호선,광화문,14116,14906,29022
20211211,5호선,서대문,6381,6278,12659
20211211,5호선,충정로,1832,1671,3503
20211211,5호선,애오개,3467,3347,6814
20211211,5호선,공덕,6593,7029,13622
20211211,5호선,마포,7103,7244,14347
20211211,5호선,여의나루,5536,6434,11970
20211211,5호선,여의도,10120,10911,21031
20211211,5호선,신길,2378,2460,4838
20211211,5호선,영등포시장,7464,7859,15323
20211211,5호선,영등포구청,1858,1953,3811
20211211,5호선,양평,3549,3263,6812
20211211,5호선,오목교,14840,15583,30423
20211211,5호선,목동,10826,10900,21726
20211211,5호선,신정,8366,7149,15515
20211211,5호선,까치산,19978,18766,38744
20211211,5호선,화곡,19215,17213,36428
20211211,5호선,우장산,8860,8802,17662
20211211,5호선,발산,13400,14572,27972
20211211,5호선,마곡,5172,5110,10282
20211211,5호선,송정,4832,4674,9506
20211211,5호선,김포공항,6548,6595,13143
20211211,5호선,개화산,3592,3363,6955
20211211,5호선,방화,4326,4134,8460
20211212,5호선,방화,3211,3295,6506
20211212,5호선,개화산,2511,2560,5071
20211212,5호선,김포공항,6416,5719,12135
20211212,5호선,송정,3561,3484,7045
20211212,5호선,마곡,3291,3367,6658
20211212,5호선,발산,9195,9604,18799
20211212,5호선,우장산,6069,6256,12325
20211212,5호선,화곡,12993,12234,25227
20211212,5호선,까치산,14150,14010,28160
20211212,5호선,신정,5681,5308,10989
20211212,5호선,목동,7428,7612,15040
20211212,5호선,오목교,10686,10812,21498
20211212,5호선,양평,2407,2534,4941
20211212,5호선,영등포구청,1194,1253,2447
20211212,5호선,영등포시장,4825,5204,10029
20211212,5호선,신길,1719,2002,3721
20211212,5호선,여의도,7448,7613,15061
20211212,5호선,여의나루,4574,5474,10048
20211212,5호선,마포,4453,4709,9162
20211212,5호선,공덕,4265,4313,8578
20211212,5호선,애오개,2373,2427,4800
20211212,5호선,충정로,1354,1405,2759
20211212,5호선,서대문,4856,4862,9718
20211212,5호선,광화문,9993,9970,19963
20211212,5호선,종로3가,7896,7023,14919
20211212,5호선,을지로4가,1283,1422,2705
20211212,5호선,동대문역사문화공원,645,803,1448
20211212,5호선,청구,1548,1425,2973
20211212,5호선,신금호,2643,2849,5492
20211212,5호선,행당,3514,3365,6879
20211212,5호선,왕십리,2304,2584,4888
20211212,5호선,마장,2563,2557,5120
20211212,5호선,답십리,6908,6431,13339
20211212,5호선,장한평,7067,7229,14296
20211212,5호선,군자,5764,6265,12029
20211212,5호선,아차산,9059,8866,17925
20211212,5호선,광나루,7175,7375,14550
20211212,5호선,천호,11558,10775,22333
20211212,5호선,강동,8608,8548,17156
20211212,5호선,길동,3863,3977,7840
20211212,5호선,굽은다리,4855,4554,9409
20211212,5호선,명일,4302,4386,8688
20211212,5호선,고덕,3859,3715,7574
20211212,5호선,상일동,6002,5822,11824
20211212,5호선,둔촌동,4260,4285,8545
20211212,5호선,올림픽공원,2520,2482,5002
20211212,5호선,방이,3719,3448,7167
20211212,5호선,오금,1371,1293,2664
20211212,5호선,개롱,2866,3111,5977
20211212,5호선,거여,3914,3750,7664
20211212,5호선,마천,3131,3426,6557
20211212,5호선,강일,1728,1608,3336
20211212,5호선,미사,7626,7795,15421
20211212,5호선,하남풍산,1876,1918,3794
20211212,5호선,하남시청,3460,3331,6791
20211212,5호선,하남검단산,4088,4022,8110
20211218,5호선,방화,4291,4167,8458
20211218,5호선,개화산,3314,3320,6634
20211218,5호선,김포공항,7891,7575,15466
20211218,5호선,송정,4620,4643,9263
20211218,5호선,마곡,5219,5199,10418
20211218,5호선,발산,13717,13426,27143
20211218,5호선,우장산,8854,9046,17900
20211218,5호선,화곡,18797,18060,36857
20211218,5호선,까치산,19153,19532,38685
20211218,5호선,신정,8250,7571,15821
20211218,5호선,목동,10897,11355,22252
20211218,5호선,오목교,16476,16916,33392
20211218,5호선,양평,3679,3639,7318
20211218,5호선,영등포구청,1716,1778,3494
20211218,5호선,영등포시장,7540,7754,15294
20211218,5호선,신길,2461,2630,5091
20211218,5호선,여의도,11666,11492,23158
20211218,5호선,여의나루,5038,6002,11040
20211218,5호선,마포,7315,7390,14705
20211218,5호선,공덕,6599,6884,13483
20211218,5호선,애오개,3660,3599,7259
20211218,5호선,을지로4가,2759,2898,5657
20211218,5호선,종로3가,9820,9758,19578
20211218,5호선,광화문,14889,14989,29878
20211218,5호선,서대문,6680,6518,13198
20211218,5호선,하남검단산,4486,4516,9002
20211218,5호선,하남시청,4798,4846,9644
20211218,5호선,하남풍산,2631,2773,5404
20211218,5호선,미사,11721,11787,23508
20211218,5호선,강일,2496,2524,5020
20211218,5호선,마천,4210,4562,8772
20211218,5호선,거여,5417,5276,10693
20211218,5호선,개롱,3952,4220,8172
20211218,5호선,오금,1917,1821,3738
20211218,5호선,방이,4999,4920,9919
20211218,5호선,올림픽공원,4138,3883,8021
20211218,5호선,둔촌동,6108,6130,12238
20211218,5호선,상일동,9236,9046,18282
20211218,5호선,고덕,6239,6006,12245
20211218,5호선,명일,6180,6118,12298
20211218,5호선,굽은다리,7571,7253,14824
20211218,5호선,길동,6136,6169,12305
20211218,5호선,강동,12375,11865,24240
20211218,5호선,천호,16308,14820,31128
20211218,5호선,광나루,9111,8575,17686
20211218,5호선,아차산,10201,10107,20308
20211218,5호선,군자,7843,8983,16826
20211218,5호선,장한평,10486,10861,21347
20211218,5호선,답십리,9692,9349,19041
20211218,5호선,마장,3732,3666,7398
20211218,5호선,왕십리,3562,4044,7606
20211218,5호선,행당,5024,4632,9656
20211218,5호선,신금호,3975,4030,8005
20211218,5호선,청구,2281,2288,4569
20211218,5호선,동대문역사문화공원,1038,1376,2414
20211218,5호선,충정로,1866,1811,3677
20211219,5호선,둔촌동,4359,4464,8823
20211219,5호선,방화,3310,3307,6617
20211219,5호선,개화산,2471,2552,5023
20211219,5호선,김포공항,7214,6834,14048
20211219,5호선,송정,3318,3273,6591
20211219,5호선,마곡,3363,3470,6833
20211219,5호선,발산,8581,8932,17513
20211219,5호선,우장산,6249,6472,12721
20211219,5호선,화곡,13284,12634,25918
20211219,5호선,까치산,14463,14296,28759
20211219,5호선,신정,6039,5427,11466
20211219,5호선,목동,7458,7606,15064
20211219,5호선,오목교,11083,11652,22735
20211219,5호선,양평,2655,2754,5409
20211219,5호선,영등포구청,1192,1257,2449
20211219,5호선,영등포시장,5061,5188,10249
20211219,5호선,신길,1725,2016,3741
20211219,5호선,여의도,7498,7543,15041
20211219,5호선,여의나루,4275,5152,9427
20211219,5호선,마포,4549,4566,9115
20211219,5호선,공덕,4262,4450,8712
20211219,5호선,애오개,2512,2501,5013
20211219,5호선,충정로,1331,1308,2639
20211219,5호선,서대문,4654,4598,9252
20211219,5호선,광화문,10892,11123,22015
20211219,5호선,종로3가,7320,6450,13770
20211219,5호선,을지로4가,1367,1439,2806
20211219,5호선,동대문역사문화공원,697,833,1530
20211219,5호선,청구,1555,1548,3103
20211219,5호선,신금호,2812,2992,5804
20211219,5호선,행당,3692,3384,7076
20211219,5호선,왕십리,2489,2922,5411
20211219,5호선,마장,2638,2470,5108
20211219,5호선,답십리,7014,6652,13666
20211219,5호선,장한평,7466,7403,14869
20211219,5호선,군자,5959,6614,12573
20211219,5호선,아차산,8348,8135,16483
20211219,5호선,광나루,7342,7042,14384
20211219,5호선,천호,12337,11514,23851
20211219,5호선,강동,8796,8779,17575
20211219,5호선,길동,4058,4135,8193
20211219,5호선,굽은다리,5824,5673,11497
20211219,5호선,명일,4599,4595,9194
20211219,5호선,고덕,4205,4421,8626
20211219,5호선,상일동,6981,6597,13578
20211219,5호선,올림픽공원,3023,2994,6017
20211219,5호선,방이,3535,3587,7122
20211219,5호선,오금,1497,1402,2899
20211219,5호선,개롱,2833,3104,5937
20211219,5호선,거여,3964,3858,7822
20211219,5호선,마천,3422,3556,6978
20211219,5호선,강일,1899,1844,3743
20211219,5호선,미사,8594,8598,17192
20211219,5호선,하남풍산,2139,2132,4271
20211219,5호선,하남시청,3719,3643,7362
20211219,5호선,하남검단산,4260,4200,8460
20211225,5호선,하남검단산,4584,4554,9138
20211225,5호선,하남시청,4011,3781,7792
20211225,5호선,하남풍산,2131,2266,4397
20211225,5호선,미사,9139,9120,18259
20211225,5호선,강일,1905,1896,3801
20211225,5호선,마천,3272,3447,6719
20211225,5호선,거여,4152,4009,8161
20211225,5호선,개롱,2701,2990,5691
20211225,5호선,오금,1468,1448,2916
20211225,5호선,방이,3772,3628,7400
20211225,5호선,올림픽공원,2544,2509,5053
20211225,5호선,둔촌동,4517,4612,9129
20211225,5호선,상일동,6683,6507,13190
20211225,5호선,고덕,4436,4460,8896
20211225,5호선,명일,4579,4530,9109
20211225,5호선,굽은다리,6007,5753,11760
20211225,5호선,길동,4635,4870,9505
20211225,5호선,강동,8952,8375,17327
20211225,5호선,천호,13824,12750,26574
20211225,5호선,광나루,6868,6522,13390
20211225,5호선,아차산,9369,8980,18349
20211225,5호선,군자,6360,7061,13421
20211225,5호선,장한평,8085,8172,16257
20211225,5호선,답십리,7804,7496,15300
20211225,5호선,마장,3018,2987,6005
20211225,5호선,왕십리,2621,3367,5988
20211225,5호선,행당,3731,3396,7127
20211225,5호선,신금호,3003,3181,6184
20211225,5호선,청구,1826,1748,3574
20211225,5호선,동대문역사문화공원,960,1302,2262
20211225,5호선,을지로4가,2024,2326,4350
20211225,5호선,종로3가,11883,11140,23023
20211225,5호선,광화문,14635,14199,28834
20211225,5호선,서대문,5038,4929,9967
20211225,5호선,충정로,1558,1505,3063
20211225,5호선,애오개,2517,2595,5112
20211225,5호선,공덕,4597,4844,9441
20211225,5호선,마포,5330,5292,10622
20211225,5호선,여의나루,5434,7402,12836
20211225,5호선,여의도,10065,9742,19807
20211225,5호선,신길,1971,2128,4099
20211225,5호선,영등포시장,5791,6047,11838
20211225,5호선,영등포구청,1321,1270,2591
20211225,5호선,양평,2629,2550,5179
20211225,5호선,오목교,12420,12758,25178
20211225,5호선,목동,7519,7871,15390
20211225,5호선,신정,6609,5767,12376
20211225,5호선,까치산,15959,15731,31690
20211225,5호선,화곡,15404,14321,29725
20211225,5호선,우장산,7005,7109,14114
20211225,5호선,발산,9797,10187,19984
20211225,5호선,마곡,3803,4003,7806
20211225,5호선,송정,3805,3625,7430
20211225,5호선,김포공항,7422,7132,14554
20211225,5호선,개화산,2744,2742,5486
20211225,5호선,방화,3406,3325,6731
20211226,5호선,방화,2718,2816,5534
20211226,5호선,개화산,2154,2209,4363
20211226,5호선,김포공항,6314,6078,12392
20211226,5호선,송정,2849,2997,5846
20211226,5호선,마곡,2788,2840,5628
20211226,5호선,발산,7467,7556,15023
20211226,5호선,우장산,5314,5616,10930
20211226,5호선,화곡,11582,10988,22570
20211226,5호선,까치산,12560,12503,25063
20211226,5호선,신정,5103,4871,9974
20211226,5호선,목동,5869,6192,12061
20211226,5호선,오목교,9497,9885,19382
20211226,5호선,양평,2066,2090,4156
20211226,5호선,영등포구청,944,1007,1951
20211226,5호선,영등포시장,4229,4635,8864
20211226,5호선,신길,1542,1782,3324
20211226,5호선,여의도,6925,7021,13946
20211226,5호선,여의나루,3505,4449,7954
20211226,5호선,마포,3819,3960,7779
20211226,5호선,공덕,3459,3566,7025
20211226,5호선,애오개,2082,2189,4271
20211226,5호선,충정로,1127,1252,2379
20211226,5호선,서대문,4068,3991,8059
20211226,5호선,광화문,9435,9331,18766
20211226,5호선,종로3가,6947,5756,12703
20211226,5호선,을지로4가,1059,1133,2192
20211226,5호선,동대문역사문화공원,762,753,1515
20211226,5호선,청구,1419,1272,2691
20211226,5호선,신금호,2325,2599,4924
20211226,5호선,행당,3049,2886,5935
20211226,5호선,왕십리,2080,2374,4454
20211226,5호선,마장,2279,2180,4459
20211226,5호선,답십리,6262,5968,12230
20211226,5호선,장한평,6239,6431,12670
20211226,5호선,군자,5087,5518,10605
20211226,5호선,아차산,7596,7622,15218
20211226,5호선,광나루,5830,5714,11544
20211226,5호선,천호,10376,9510,19886
20211226,5호선,강동,7263,7241,14504
20211226,5호선,길동,3456,3451,6907
20211226,5호선,굽은다리,4526,4355,8881
20211226,5호선,명일,3713,3778,7491
20211226,5호선,고덕,3242,3262,6504
20211226,5호선,상일동,5317,5372,10689
20211226,5호선,둔촌동,3651,3767,7418
20211226,5호선,올림픽공원,2134,2117,4251
20211226,5호선,방이,3121,3105,6226
20211226,5호선,오금,1257,1229,2486
20211226,5호선,개롱,2405,2733,5138
20211226,5호선,거여,3324,3302,6626
20211226,5호선,마천,2684,2884,5568
20211226,5호선,강일,1480,1496,2976
20211226,5호선,미사,7068,7127,14195
20211226,5호선,하남풍산,1775,1896,3671
20211226,5호선,하남시청,3035,2950,5985
20211226,5호선,하남검단산,3301,3278,6579
