사용일자,호선명,지하철역,승차총승객수,하차총승객수,승하차총승객수
20210102,경원선,소요산,2090,1770,3860
20210102,경원선,동두천,762,937,1699
20210102,경원선,보산,934,900,1834
20210102,경원선,동두천중앙,1499,1503,3002
20210102,경원선,지행,2975,2905,5880
20210102,경원선,덕정,2270,2205,4475
20210102,경원선,덕계,1132,1034,2166
20210102,경원선,양주,3320,3111,6431
20210102,경원선,녹양,1952,1956,3908
20210102,경원선,가능,3054,2896,5950
20210102,경원선,의정부,9693,10142,19835
20210102,경원선,회룡,5137,5195,10332
20210102,경원선,망월사,3158,3235,6393
20210102,경원선,도봉산,5859,3861,9720
20210102,경원선,도봉,2726,2563,5289
20210102,경원선,방학,4326,4290,8616
20210102,경원선,녹천,2035,1729,3764
20210102,경원선,월계,2761,2708,5469
20210102,경원선,광운대,3172,3125,6297
20210102,경원선,석계,3556,3848,7404
20210102,경원선,신이문,3548,3314,6862
20210102,경원선,외대앞,3161,3161,6322
20210102,경원선,청량리,7630,7828,15458
20210102,경원선,왕십리,5792,7150,12942
20210102,경원선,응봉,703,638,1341
20210102,경원선,옥수,29,12,41
20210102,경원선,한남,1500,1417,2917
20210102,경원선,서빙고,707,611,1318
20210102,경원선,이촌,1571,1210,2781
20210103,경원선,소요산,2089,1735,3824
20210103,경원선,동두천,756,861,1617
20210103,경원선,보산,820,669,1489
20210103,경원선,동두천중앙,1250,1168,2418
20210103,경원선,지행,2319,2125,4444
20210103,경원선,덕정,1792,1873,3665
20210103,경원선,덕계,884,827,1711
20210103,경원선,양주,2710,2568,5278
20210103,경원선,녹양,1588,1469,3057
20210103,경원선,가능,2399,2192,4591
20210103,경원선,의정부,7790,7638,15428
20210103,경원선,회룡,3957,3828,7785
20210103,경원선,망월사,2491,2541,5032
20210103,경원선,도봉산,5493,3708,9201
20210103,경원선,도봉,2152,1985,4137
20210103,경원선,방학,3454,3274,6728
20210103,경원선,녹천,1540,1383,2923
20210103,경원선,월계,2244,2141,4385
20210103,경원선,광운대,2489,2600,5089
20210103,경원선,석계,2888,3139,6027
20210103,경원선,신이문,2759,2591,5350
20210103,경원선,외대앞,2584,2647,5231
20210103,경원선,청량리,6894,6628,13522
20210103,경원선,왕십리,4555,5779,10334
20210103,경원선,응봉,554,496,1050
20210103,경원선,옥수,37,12,49
20210103,경원선,한남,1130,1110,2240
20210103,경원선,서빙고,476,514,990
20210103,경원선,이촌,1077,858,1935
20210109,경원선,소요산,1382,1191,2573
20210109,경원선,동두천,883,1019,1902
20210109,경원선,보산,906,919,1825
20210109,경원선,동두천중앙,1381,1459,2840
20210109,경원선,지행,3031,2995,6026
20210109,경원선,덕정,2420,2359,4779
20210109,경원선,덕계,1143,1131,2274
20210109,경원선,양주,3273,3296,6569
20210109,경원선,녹양,2107,2009,4116
20210109,경원선,가능,3157,3127,6284
20210109,경원선,의정부,10443,10907,21350
20210109,경원선,회룡,5363,5504,10867
20210109,경원선,망월사,3393,3437,6830
20210109,경원선,도봉산,4422,2728,7150
20210109,경원선,도봉,2834,2691,5525
20210109,경원선,방학,4597,4534,9131
20210109,경원선,녹천,2206,1970,4176
20210109,경원선,월계,2953,2718,5671
20210109,경원선,광운대,3589,3604,7193
20210109,경원선,석계,4123,4338,8461
20210109,경원선,신이문,4135,3902,8037
20210109,경원선,외대앞,3832,3852,7684
20210109,경원선,청량리,8046,9094,17140
20210109,경원선,왕십리,7411,8676,16087
20210109,경원선,응봉,815,668,1483
20210109,경원선,옥수,20,17,37
20210109,경원선,한남,1828,1696,3524
20210109,경원선,서빙고,762,721,1483
20210109,경원선,이촌,1786,1334,3120
20210110,경원선,소요산,1705,1482,3187
20210110,경원선,동두천,712,814,1526
20210110,경원선,보산,774,697,1471
20210110,경원선,동두천중앙,1187,1169,2356
20210110,경원선,지행,2421,2287,4708
20210110,경원선,덕정,1886,1910,3796
20210110,경원선,덕계,876,768,1644
20210110,경원선,양주,2451,2476,4927
20210110,경원선,녹양,1515,1476,2991
20210110,경원선,가능,2298,2182,4480
20210110,경원선,의정부,8148,8021,16169
20210110,경원선,회룡,3845,3783,7628
20210110,경원선,망월사,2491,2495,4986
20210110,경원선,도봉산,4527,3068,7595
20210110,경원선,도봉,2048,1886,3934
20210110,경원선,방학,3248,3175,6423
20210110,경원선,녹천,1562,1300,2862
20210110,경원선,월계,2066,1919,3985
20210110,경원선,광운대,2580,2585,5165
20210110,경원선,석계,2860,3063,5923
20210110,경원선,신이문,2935,2670,5605
20210110,경원선,외대앞,2840,2704,5544
20210110,경원선,청량리,6799,6746,13545
20210110,경원선,왕십리,5011,5648,10659
20210110,경원선,응봉,568,530,1098
20210110,경원선,옥수,35,17,52
20210110,경원선,한남,1192,1185,2377
20210110,경원선,서빙고,501,510,1011
20210110,경원선,이촌,1093,938,2031
20210116,경원선,양주,4236,4081,8317
20210116,경원선,이촌,2035,1579,3614
20210116,경원선,서빙고,815,735,1550
20210116,경원선,한남,2089,1956,4045
20210116,경원선,옥수,24,16,40
20210116,경원선,응봉,1024,879,1903
20210116,경원선,왕십리,8455,9745,18200
20210116,경원선,청량리,10338,11534,21872
20210116,경원선,외대앞,7964,7669,15633
20210116,경원선,신이문,4792,4463,9255
20210116,경원선,석계,5064,5396,10460
20210116,경원선,광운대,4234,4174,8408
20210116,경원선,월계,3502,3426,6928
20210116,경원선,녹천,2671,2388,5059
20210116,경원선,방학,5589,5615,11204
20210116,경원선,도봉,3400,3418,6818
20210116,경원선,도봉산,6547,4196,10743
20210116,경원선,망월사,4301,4486,8787
20210116,경원선,회룡,6904,6934,13838
20210116,경원선,의정부,12176,12648,24824
20210116,경원선,가능,3803,3749,7552
20210116,경원선,녹양,2477,2406,4883
20210116,경원선,덕계,1507,1415,2922
20210116,경원선,덕정,3054,2864,5918
20210116,경원선,지행,3586,3625,7211
20210116,경원선,동두천중앙,1789,1932,3721
20210116,경원선,보산,1046,1102,2148
20210116,경원선,동두천,995,1236,2231
20210116,경원선,소요산,2183,1977,4160
20210117,경원선,소요산,2066,1792,3858
20210117,경원선,동두천,787,895,1682
20210117,경원선,보산,860,773,1633
20210117,경원선,동두천중앙,1417,1310,2727
20210117,경원선,지행,2630,2534,5164
20210117,경원선,양주,3037,2964,6001
20210117,경원선,덕정,2169,2232,4401
20210117,경원선,덕계,1042,963,2005
20210117,경원선,녹양,1724,1613,3337
20210117,경원선,가능,2701,2580,5281
20210117,경원선,의정부,9354,9243,18597
20210117,경원선,회룡,4564,4533,9097
20210117,경원선,망월사,2887,2931,5818
20210117,경원선,도봉산,5579,3762,9341
20210117,경원선,도봉,2398,2231,4629
20210117,경원선,방학,3867,3768,7635
20210117,경원선,녹천,1712,1479,3191
20210117,경원선,월계,2465,2434,4899
20210117,경원선,광운대,2924,2988,5912
20210117,경원선,석계,3235,3543,6778
20210117,경원선,신이문,3232,3054,6286
20210117,경원선,외대앞,3254,3109,6363
20210117,경원선,청량리,8410,7992,16402
20210117,경원선,왕십리,5685,6748,12433
20210117,경원선,응봉,676,624,1300
20210117,경원선,옥수,37,12,49
20210117,경원선,한남,1347,1362,2709
20210117,경원선,서빙고,564,583,1147
20210117,경원선,이촌,1272,1048,2320
20210123,경원선,이촌,2322,1774,4096
20210123,경원선,서빙고,1015,902,1917
20210123,경원선,한남,2401,2166,4567
20210123,경원선,옥수,24,25,49
20210123,경원선,응봉,1108,978,2086
20210123,경원선,왕십리,9164,10259,19423
20210123,경원선,청량리,11026,12204,23230
20210123,경원선,외대앞,4863,4705,9568
20210123,경원선,신이문,5087,4628,9715
20210123,경원선,석계,5607,5794,11401
20210123,경원선,광운대,4777,4632,9409
20210123,경원선,월계,4111,3756,7867
20210123,경원선,녹천,2825,2448,5273
20210123,경원선,방학,6083,5986,12069
20210123,경원선,도봉,3595,3441,7036
20210123,경원선,도봉산,7504,4991,12495
20210123,경원선,망월사,4293,4490,8783
20210123,경원선,회룡,7698,7743,15441
20210123,경원선,의정부,13347,14021,27368
20210123,경원선,가능,4104,3930,8034
20210123,경원선,녹양,2687,2699,5386
20210123,경원선,양주,4491,4401,8892
20210123,경원선,덕계,1708,1506,3214
20210123,경원선,덕정,3207,3133,6340
20210123,경원선,지행,4005,3971,7976
20210123,경원선,동두천중앙,1940,2019,3959
20210123,경원선,보산,1120,1172,2292
20210123,경원선,동두천,1185,1432,2617
20210123,경원선,소요산,2732,2423,5155
20210124,경원선,이촌,1675,1287,2962
20210124,경원선,서빙고,826,819,1645
20210124,경원선,한남,1568,1545,3113
20210124,경원선,옥수,47,10,57
20210124,경원선,응봉,820,732,1552
20210124,경원선,왕십리,6139,6875,13014
20210124,경원선,청량리,8884,8911,17795
20210124,경원선,외대앞,3554,3407,6961
20210124,경원선,신이문,3700,3479,7179
20210124,경원선,석계,3792,4058,7850
20210124,경원선,광운대,3263,3312,6575
20210124,경원선,월계,2916,2645,5561
20210124,경원선,녹천,2186,1916,4102
20210124,경원선,방학,4507,4382,8889
20210124,경원선,도봉,2765,2605,5370
20210124,경원선,도봉산,7352,5244,12596
20210124,경원선,망월사,3091,3275,6366
20210124,경원선,회룡,5649,5552,11201
20210124,경원선,의정부,10224,10127,20351
20210124,경원선,가능,3158,2919,6077
20210124,경원선,녹양,1977,1896,3873
20210124,경원선,양주,3514,3335,6849
20210124,경원선,덕계,1178,1083,2261
20210124,경원선,덕정,2336,2433,4769
20210124,경원선,지행,3032,2923,5955
20210124,경원선,동두천중앙,1543,1434,2977
20210124,경원선,보산,951,906,1857
20210124,경원선,동두천,929,1100,2029
20210124,경원선,소요산,2985,2603,5588
20210130,경원선,동두천,1149,1375,2524
20210130,경원선,이촌,2366,1739,4105
20210130,경원선,서빙고,977,925,1902
20210130,경원선,한남,2287,2183,4470
20210130,경원선,옥수,27,25,52
20210130,경원선,응봉,1112,911,2023
20210130,경원선,왕십리,9117,10297,19414
20210130,경원선,청량리,11138,12364,23502
20210130,경원선,외대앞,4722,4515,9237
20210130,경원선,신이문,5145,4620,9765
20210130,경원선,석계,5362,5820,11182
20210130,경원선,광운대,4443,4469,8912
20210130,경원선,월계,3833,3623,7456
20210130,경원선,녹천,2648,2269,4917
20210130,경원선,방학,6001,5901,11902
20210130,경원선,도봉,3662,3525,7187
20210130,경원선,도봉산,6413,4190,10603
20210130,경원선,망월사,4276,4526,8802
20210130,경원선,회룡,7528,7458,14986
20210130,경원선,의정부,13499,14248,27747
20210130,경원선,가능,4028,3933,7961
20210130,경원선,녹양,2715,2647,5362
20210130,경원선,양주,4678,4529,9207
20210130,경원선,덕계,1562,1502,3064
20210130,경원선,덕정,3203,3046,6249
20210130,경원선,지행,4060,4029,8089
20210130,경원선,동두천중앙,2062,2153,4215
20210130,경원선,보산,1063,1083,2146
20210130,경원선,소요산,2191,1902,4093
20210130,경원선,창동,1,0,1
20210131,경원선,이촌,1644,1310,2954
20210131,경원선,서빙고,820,848,1668
20210131,경원선,한남,1683,1690,3373
20210131,경원선,옥수,33,16,49
20210131,경원선,응봉,862,764,1626
20210131,경원선,왕십리,6675,7386,14061
20210131,경원선,청량리,9574,9386,18960
20210131,경원선,외대앞,3620,3609,7229
20210131,경원선,신이문,3780,3597,7377
20210131,경원선,석계,3833,4204,8037
20210131,경원선,광운대,3441,3418,6859
20210131,경원선,월계,2969,2748,5717
20210131,경원선,녹천,2216,1904,4120
20210131,경원선,창동,1,0,1
20210131,경원선,방학,4636,4459,9095
20210131,경원선,도봉,2775,2625,5400
20210131,경원선,도봉산,7121,4890,12011
20210131,경원선,망월사,3201,3324,6525
20210131,경원선,회룡,5640,5578,11218
20210131,경원선,의정부,10322,10274,20596
20210131,경원선,가능,3067,2846,5913
20210131,경원선,녹양,2091,1939,4030
20210131,경원선,양주,3640,3472,7112
20210131,경원선,덕계,1195,1119,2314
20210131,경원선,덕정,2396,2397,4793
20210131,경원선,지행,3076,2917,5993
20210131,경원선,동두천중앙,1610,1480,3090
20210131,경원선,보산,956,885,1841
20210131,경원선,동두천,910,1092,2002
20210131,경원선,소요산,2711,2394,5105
20210206,경원선,이촌,2460,1843,4303
20210206,경원선,서빙고,1108,997,2105
20210206,경원선,한남,2440,2311,4751
20210206,경원선,옥수,27,23,50
20210206,경원선,응봉,1201,1052,2253
20210206,경원선,왕십리,9906,11027,20933
20210206,경원선,청량리,12144,13468,25612
20210206,경원선,외대앞,5000,4850,9850
20210206,경원선,신이문,5589,5100,10689
20210206,경원선,석계,5757,6143,11900
20210206,경원선,광운대,4929,4748,9677
20210206,경원선,월계,4133,3828,7961
20210206,경원선,녹천,2995,2499,5494
20210206,경원선,방학,6468,6364,12832
20210206,경원선,도봉,3789,3600,7389
20210206,경원선,도봉산,7186,4824,12010
20210206,경원선,망월사,4678,4827,9505
20210206,경원선,회룡,7999,8241,16240
20210206,경원선,의정부,14315,15029,29344
20210206,경원선,가능,4399,4192,8591
20210206,경원선,녹양,2870,2853,5723
20210206,경원선,양주,4859,4638,9497
20210206,경원선,덕계,1729,1586,3315
20210206,경원선,덕정,3427,3274,6701
20210206,경원선,지행,4214,4251,8465
20210206,경원선,동두천중앙,2126,2075,4201
20210206,경원선,보산,1058,1067,2125
20210206,경원선,동두천,1302,1516,2818
20210206,경원선,소요산,2620,2250,4870
20210207,경원선,소요산,2625,2313,4938
20210207,경원선,동두천,961,1196,2157
20210207,경원선,보산,969,858,1827
20210207,경원선,동두천중앙,1640,1593,3233
20210207,경원선,지행,3274,3171,6445
20210207,경원선,덕정,2570,2630,5200
20210207,경원선,덕계,1255,1146,2401
20210207,경원선,양주,3651,3568,7219
20210207,경원선,녹양,2250,2152,4402
20210207,경원선,가능,3140,2969,6109
20210207,경원선,의정부,11279,11372,22651
20210207,경원선,회룡,5793,5759,11552
20210207,경원선,망월사,3906,4024,7930
20210207,경원선,도봉산,6825,4841,11666
20210207,경원선,도봉,2876,2674,5550
20210207,경원선,방학,4856,4721,9577
20210207,경원선,녹천,2215,1904,4119
20210207,경원선,월계,3224,2979,6203
20210207,경원선,광운대,3596,3585,7181
20210207,경원선,석계,3942,4234,8176
20210207,경원선,신이문,4044,3755,7799
20210207,경원선,외대앞,3658,3647,7305
20210207,경원선,청량리,9849,9797,19646
20210207,경원선,왕십리,7214,7962,15176
20210207,경원선,응봉,787,757,1544
20210207,경원선,옥수,44,21,65
20210207,경원선,한남,1645,1651,3296
20210207,경원선,서빙고,808,826,1634
20210207,경원선,이촌,1697,1382,3079
20210213,경원선,도봉,2896,2682,5578
20210213,경원선,이촌,1716,1377,3093
20210213,경원선,서빙고,739,687,1426
20210213,경원선,한남,1645,1608,3253
20210213,경원선,옥수,35,9,44
20210213,경원선,응봉,956,851,1807
20210213,경원선,왕십리,6664,8087,14751
20210213,경원선,청량리,9356,8965,18321
20210213,경원선,외대앞,3117,3335,6452
20210213,경원선,신이문,3819,3531,7350
20210213,경원선,석계,4038,4517,8555
20210213,경원선,광운대,3344,3544,6888
20210213,경원선,월계,3009,2850,5859
20210213,경원선,녹천,2223,1902,4125
20210213,경원선,창동,1,0,1
20210213,경원선,방학,4618,4515,9133
20210213,경원선,도봉산,8050,5702,13752
20210213,경원선,망월사,3222,3375,6597
20210213,경원선,회룡,5935,5700,11635
20210213,경원선,의정부,12466,13063,25529
20210213,경원선,가능,3271,2960,6231
20210213,경원선,녹양,2267,2037,4304
20210213,경원선,양주,4118,3810,7928
20210213,경원선,덕계,1361,1145,2506
20210213,경원선,덕정,2769,2565,5334
20210213,경원선,지행,3688,3318,7006
20210213,경원선,동두천중앙,1835,1669,3504
20210213,경원선,보산,1119,1030,2149
20210213,경원선,동두천,998,1181,2179
20210213,경원선,소요산,3246,2673,5919
20210214,경원선,창동,1,0,1
20210214,경원선,소요산,3174,2551,5725
20210214,경원선,동두천,988,1166,2154
20210214,경원선,보산,1150,951,2101
20210214,경원선,동두천중앙,1718,1518,3236
20210214,경원선,지행,3555,3257,6812
20210214,경원선,덕정,2572,2555,5127
20210214,경원선,덕계,1283,1167,2450
20210214,경원선,양주,4012,3741,7753
20210214,경원선,녹양,2131,1996,4127
20210214,경원선,가능,3192,2974,6166
20210214,경원선,의정부,11693,11975,23668
20210214,경원선,회룡,5778,5768,11546
20210214,경원선,망월사,3341,3465,6806
20210214,경원선,도봉산,7610,5310,12920
20210214,경원선,도봉,2744,2715,5459
20210214,경원선,방학,4654,4536,9190
20210214,경원선,녹천,2022,1771,3793
20210214,경원선,월계,2838,2589,5427
20210214,경원선,광운대,3088,3326,6414
20210214,경원선,석계,3863,4315,8178
20210214,경원선,신이문,3651,3479,7130
20210214,경원선,외대앞,3156,3385,6541
20210214,경원선,청량리,9153,8565,17718
20210214,경원선,왕십리,6136,7527,13663
20210214,경원선,응봉,767,700,1467
20210214,경원선,옥수,47,12,59
20210214,경원선,한남,1528,1535,3063
20210214,경원선,서빙고,814,847,1661
20210214,경원선,이촌,1695,1391,3086
20210220,경원선,소요산,3293,2908,6201
20210220,경원선,동두천,1387,1630,3017
20210220,경원선,보산,1826,1719,3545
20210220,경원선,동두천중앙,2423,2513,4936
20210220,경원선,지행,4945,4810,9755
20210220,경원선,덕정,3732,3421,7153
20210220,경원선,덕계,1843,1699,3542
20210220,경원선,양주,5475,5341,10816
20210220,경원선,녹양,3197,3082,6279
20210220,경원선,가능,4602,4390,8992
20210220,경원선,의정부,15756,16763,32519
20210220,경원선,회룡,8676,8602,17278
20210220,경원선,망월사,4847,4982,9829
20210220,경원선,도봉산,8849,6061,14910
20210220,경원선,도봉,4178,3968,8146
20210220,경원선,방학,6677,6483,13160
20210220,경원선,녹천,3134,2634,5768
20210220,경원선,월계,4322,3943,8265
20210220,경원선,광운대,5046,5024,10070
20210220,경원선,석계,6031,6562,12593
20210220,경원선,신이문,5776,5161,10937
20210220,경원선,외대앞,5225,5003,10228
20210220,경원선,청량리,12992,14582,27574
20210220,경원선,왕십리,10838,12228,23066
20210220,경원선,응봉,1360,1126,2486
20210220,경원선,옥수,23,31,54
20210220,경원선,한남,2574,2373,4947
20210220,경원선,서빙고,1191,1009,2200
20210220,경원선,이촌,2774,2038,4812
20210220,경원선,창동,1,0,1
20210221,경원선,소요산,3723,3225,6948
20210221,경원선,동두천,1062,1385,2447
20210221,경원선,보산,1413,1191,2604
20210221,경원선,동두천중앙,1771,1663,3434
20210221,경원선,지행,3750,3629,7379
20210221,경원선,덕정,2778,2785,5563
20210221,경원선,덕계,1344,1287,2631
20210221,경원선,양주,4154,4061,8215
20210221,경원선,녹양,2402,2333,4735
20210221,경원선,가능,3321,3143,6464
20210221,경원선,의정부,12429,12539,24968
20210221,경원선,회룡,6366,6306,12672
20210221,경원선,망월사,3704,3816,7520
20210221,경원선,도봉산,8735,6478,15213
20210221,경원선,도봉,3158,2998,6156
20210221,경원선,방학,5220,4957,10177
20210221,경원선,녹천,2318,2019,4337
20210221,경원선,월계,3308,3173,6481
20210221,경원선,광운대,3805,3838,7643
20210221,경원선,석계,4388,4705,9093
20210221,경원선,신이문,4327,3988,8315
20210221,경원선,외대앞,4022,3876,7898
20210221,경원선,청량리,11069,10621,21690
20210221,경원선,왕십리,7816,8636,16452
20210221,경원선,응봉,963,949,1912
20210221,경원선,옥수,37,15,52
20210221,경원선,한남,1762,1728,3490
20210221,경원선,서빙고,1070,1080,2150
20210221,경원선,이촌,2164,1568,3732
20210227,경원선,이촌,3052,2162,5214
20210227,경원선,서빙고,1258,1114,2372
20210227,경원선,한남,2666,2587,5253
20210227,경원선,옥수,46,27,73
20210227,경원선,응봉,1391,1166,2557
20210227,경원선,왕십리,11304,12667,23971
20210227,경원선,청량리,13986,16037,30023
20210227,경원선,외대앞,5513,5243,10756
20210227,경원선,신이문,5849,5373,11222
20210227,경원선,석계,6307,6673,12980
20210227,경원선,광운대,5306,5194,10500
20210227,경원선,월계,4404,4135,8539
20210227,경원선,녹천,3075,2543,5618
20210227,경원선,창동,2,0,2
20210227,경원선,방학,6871,6722,13593
20210227,경원선,도봉,4155,3914,8069
20210227,경원선,도봉산,9503,6359,15862
20210227,경원선,망월사,5111,5272,10383
20210227,경원선,회룡,8962,8926,17888
20210227,경원선,의정부,16498,17311,33809
20210227,경원선,가능,4752,4466,9218
20210227,경원선,녹양,3309,3189,6498
20210227,경원선,양주,5747,5548,11295
20210227,경원선,덕계,2007,1849,3856
20210227,경원선,덕정,3972,3758,7730
20210227,경원선,지행,5007,4873,9880
20210227,경원선,동두천중앙,2316,2282,4598
20210227,경원선,보산,1727,1684,3411
20210227,경원선,동두천,1340,1741,3081
20210227,경원선,소요산,3723,3168,6891
20210228,경원선,이촌,2100,1568,3668
20210228,경원선,서빙고,1054,1133,2187
20210228,경원선,한남,1943,1933,3876
20210228,경원선,옥수,55,37,92
20210228,경원선,응봉,1064,1006,2070
20210228,경원선,왕십리,8193,9128,17321
20210228,경원선,청량리,11890,11744,23634
20210228,경원선,외대앞,4454,4518,8972
20210228,경원선,신이문,4534,4176,8710
20210228,경원선,석계,4768,5079,9847
20210228,경원선,광운대,4182,4206,8388
20210228,경원선,월계,3428,3100,6528
20210228,경원선,녹천,2721,2309,5030
20210228,경원선,방학,5374,5107,10481
20210228,경원선,도봉,3427,3140,6567
20210228,경원선,도봉산,9377,6587,15964
20210228,경원선,망월사,4085,4300,8385
20210228,경원선,회룡,6728,6942,13670
20210228,경원선,의정부,13002,13513,26515
20210228,경원선,가능,3747,3445,7192
20210228,경원선,녹양,2535,2433,4968
20210228,경원선,양주,4514,4457,8971
20210228,경원선,덕계,1523,1417,2940
20210228,경원선,덕정,3019,2984,6003
20210228,경원선,지행,3960,3881,7841
20210228,경원선,동두천중앙,1815,1719,3534
20210228,경원선,보산,1233,1359,2592
20210228,경원선,동두천,1119,1581,2700
20210228,경원선,소요산,3912,3388,7300
20210306,경원선,이촌,2976,2207,5183
20210306,경원선,서빙고,1194,1099,2293
20210306,경원선,한남,2701,2531,5232
20210306,경원선,옥수,40,31,71
20210306,경원선,응봉,1356,1207,2563
20210306,경원선,왕십리,11295,12941,24236
20210306,경원선,청량리,13504,14866,28370
20210306,경원선,외대앞,5993,5604,11597
20210306,경원선,신이문,5897,5488,11385
20210306,경원선,석계,6268,6643,12911
20210306,경원선,광운대,5534,5332,10866
20210306,경원선,월계,4308,4010,8318
20210306,경원선,녹천,3133,2726,5859
20210306,경원선,방학,6806,6818,13624
20210306,경원선,도봉,4362,4135,8497
20210306,경원선,도봉산,9325,6559,15884
20210306,경원선,망월사,5165,5328,10493
20210306,경원선,회룡,8919,9060,17979
20210306,경원선,의정부,15853,16571,32424
20210306,경원선,가능,4628,4470,9098
20210306,경원선,녹양,3245,3108,6353
20210306,경원선,양주,5689,5358,11047
20210306,경원선,덕계,1920,1726,3646
20210306,경원선,덕정,3829,3705,7534
20210306,경원선,지행,4244,4164,8408
20210306,경원선,동두천중앙,2104,2062,4166
20210306,경원선,보산,930,938,1868
20210306,경원선,동두천,1405,1826,3231
20210306,경원선,소요산,3402,2907,6309
20210307,경원선,소요산,3393,2881,6274
20210307,경원선,동두천,1074,1440,2514
20210307,경원선,보산,823,723,1546
20210307,경원선,동두천중앙,1666,1588,3254
20210307,경원선,지행,3375,3299,6674
20210307,경원선,덕정,2877,2874,5751
20210307,경원선,덕계,1467,1385,2852
20210307,경원선,양주,4288,4248,8536
20210307,경원선,녹양,2437,2311,4748
20210307,경원선,가능,3667,3512,7179
20210307,경원선,의정부,11754,11837,23591
20210307,경원선,회룡,6714,6757,13471
20210307,경원선,망월사,4002,4221,8223
20210307,경원선,도봉산,9121,6556,15677
20210307,경원선,도봉,3256,3017,6273
20210307,경원선,방학,5346,5085,10431
20210307,경원선,녹천,2490,2139,4629
20210307,경원선,월계,3790,3487,7277
20210307,경원선,광운대,4069,4173,8242
20210307,경원선,석계,4633,5078,9711
20210307,경원선,신이문,4504,4212,8716
20210307,경원선,외대앞,4506,4495,9001
20210307,경원선,청량리,11304,11274,22578
20210307,경원선,왕십리,8294,9517,17811
20210307,경원선,응봉,1090,1030,2120
20210307,경원선,옥수,50,20,70
20210307,경원선,한남,1809,1827,3636
20210307,경원선,서빙고,1184,1152,2336
20210307,경원선,이촌,2168,1684,3852
20210313,경원선,이촌,2880,2135,5015
20210313,경원선,서빙고,1303,1127,2430
20210313,경원선,한남,2754,2534,5288
20210313,경원선,옥수,30,37,67
20210313,경원선,응봉,1621,1483,3104
20210313,경원선,왕십리,12053,13416,25469
20210313,경원선,청량리,13868,15463,29331
20210313,경원선,외대앞,6046,5790,11836
20210313,경원선,신이문,6106,5571,11677
20210313,경원선,석계,6506,6823,13329
20210313,경원선,광운대,5629,5422,11051
20210313,경원선,월계,4431,4091,8522
20210313,경원선,녹천,3266,2751,6017
20210313,경원선,방학,7023,6689,13712
20210313,경원선,도봉,4236,4038,8274
20210313,경원선,도봉산,9451,6463,15914
20210313,경원선,망월사,5443,5675,11118
20210313,경원선,회룡,9350,9296,18646
20210313,경원선,의정부,16254,16999,33253
20210313,경원선,가능,4735,4646,9381
20210313,경원선,녹양,3411,3285,6696
20210313,경원선,양주,5972,5796,11768
20210313,경원선,덕계,2076,1873,3949
20210313,경원선,덕정,3962,3747,7709
20210313,경원선,지행,4698,4728,9426
20210313,경원선,동두천중앙,2342,2307,4649
20210313,경원선,보산,977,1009,1986
20210313,경원선,동두천,1364,1865,3229
20210313,경원선,소요산,3812,3230,7042
20210314,경원선,소요산,3801,3190,6991
20210314,경원선,동두천,1154,1546,2700
20210314,경원선,보산,883,839,1722
20210314,경원선,동두천중앙,1795,1655,3450
20210314,경원선,지행,3724,3637,7361
20210314,경원선,덕정,2971,2986,5957
20210314,경원선,덕계,1542,1445,2987
20210314,경원선,양주,4408,4396,8804
20210314,경원선,녹양,2530,2481,5011
20210314,경원선,가능,3590,3383,6973
20210314,경원선,의정부,12884,12940,25824
20210314,경원선,회룡,6761,6646,13407
20210314,경원선,망월사,4215,4442,8657
20210314,경원선,도봉산,8898,6424,15322
20210314,경원선,도봉,3314,3037,6351
20210314,경원선,방학,5315,5008,10323
20210314,경원선,녹천,2411,2110,4521
20210314,경원선,월계,3256,2990,6246
20210314,경원선,광운대,4074,4218,8292
20210314,경원선,석계,4656,5140,9796
20210314,경원선,신이문,4438,4230,8668
20210314,경원선,외대앞,4475,4582,9057
20210314,경원선,청량리,11778,11472,23250
20210314,경원선,왕십리,7846,8969,16815
20210314,경원선,응봉,1039,979,2018
20210314,경원선,옥수,43,20,63
20210314,경원선,한남,1886,1874,3760
20210314,경원선,서빙고,1212,1252,2464
20210314,경원선,이촌,2157,1606,3763
20210320,경원선,양주,5301,5048,10349
20210320,경원선,녹양,3027,2911,5938
20210320,경원선,소요산,2300,1886,4186
20210320,경원선,동두천,1362,1684,3046
20210320,경원선,보산,1228,1234,2462
20210320,경원선,동두천중앙,2257,2268,4525
20210320,경원선,지행,4519,4426,8945
20210320,경원선,덕정,3656,3482,7138
20210320,경원선,덕계,1859,1734,3593
20210320,경원선,가능,4411,4252,8663
20210320,경원선,의정부,15045,15888,30933
20210320,경원선,회룡,8303,8400,16703
20210320,경원선,망월사,4723,4795,9518
20210320,경원선,도봉산,5954,3896,9850
20210320,경원선,도봉,3895,3679,7574
20210320,경원선,방학,6363,6290,12653
20210320,경원선,녹천,3092,2565,5657
20210320,경원선,월계,3977,3628,7605
20210320,경원선,광운대,5060,4934,9994
20210320,경원선,석계,5777,6132,11909
20210320,경원선,신이문,5495,5105,10600
20210320,경원선,외대앞,5562,5381,10943
20210320,경원선,청량리,13037,14217,27254
20210320,경원선,왕십리,11155,12695,23850
20210320,경원선,응봉,1185,1019,2204
20210320,경원선,옥수,34,26,60
20210320,경원선,한남,2447,2310,4757
20210320,경원선,서빙고,1078,1006,2084
20210320,경원선,이촌,2536,1919,4455
20210321,경원선,이촌,2102,1648,3750
20210321,경원선,서빙고,1135,1135,2270
20210321,경원선,한남,1809,1805,3614
20210321,경원선,옥수,65,22,87
20210321,경원선,응봉,1244,1341,2585
20210321,경원선,왕십리,8838,9894,18732
20210321,경원선,청량리,11986,11795,23781
20210321,경원선,외대앞,4459,4555,9014
20210321,경원선,신이문,4333,4211,8544
20210321,경원선,석계,4609,5032,9641
20210321,경원선,광운대,4081,4246,8327
20210321,경원선,월계,3460,3264,6724
20210321,경원선,녹천,2405,2032,4437
20210321,경원선,방학,5363,5133,10496
20210321,경원선,도봉,3228,3049,6277
20210321,경원선,도봉산,8592,5952,14544
20210321,경원선,망월사,4097,4309,8406
20210321,경원선,회룡,6730,6631,13361
20210321,경원선,의정부,12794,12837,25631
20210321,경원선,가능,3613,3402,7015
20210321,경원선,녹양,2536,2482,5018
20210321,경원선,양주,4632,4687,9319
20210321,경원선,덕계,1525,1519,3044
20210321,경원선,덕정,2959,2988,5947
20210321,경원선,지행,3807,3751,7558
20210321,경원선,동두천중앙,1831,1726,3557
20210321,경원선,보산,1142,1125,2267
20210321,경원선,동두천,1185,1548,2733
20210321,경원선,소요산,3256,2722,5978
20210327,경원선,월계,4020,3838,7858
20210327,경원선,광운대,5123,5067,10190
20210327,경원선,석계,6118,6198,12316
20210327,경원선,신이문,5557,5180,10737
20210327,경원선,외대앞,5573,5451,11024
20210327,경원선,청량리,13296,14717,28013
20210327,경원선,왕십리,11234,12631,23865
20210327,경원선,응봉,1880,1880,3760
20210327,경원선,소요산,2528,2213,4741
20210327,경원선,동두천,1432,1719,3151
20210327,경원선,보산,1392,1277,2669
20210327,경원선,동두천중앙,2149,2232,4381
20210327,경원선,지행,4613,4558,9171
20210327,경원선,덕정,3871,3694,7565
20210327,경원선,덕계,1993,1778,3771
20210327,경원선,양주,5462,5246,10708
20210327,경원선,녹양,3111,3022,6133
20210327,경원선,가능,4361,4290,8651
20210327,경원선,의정부,15766,16134,31900
20210327,경원선,회룡,8346,8427,16773
20210327,경원선,망월사,4841,4958,9799
20210327,경원선,도봉산,6669,4382,11051
20210327,경원선,도봉,3942,3876,7818
20210327,경원선,옥수,40,21,61
20210327,경원선,한남,2544,2389,4933
20210327,경원선,서빙고,1150,1054,2204
20210327,경원선,이촌,2560,1988,4548
20210327,경원선,방학,6565,6499,13064
20210327,경원선,녹천,2802,2434,5236
20210328,경원선,소요산,2238,1898,4136
20210328,경원선,동두천,1089,1322,2411
20210328,경원선,보산,1141,1152,2293
20210328,경원선,동두천중앙,1676,1604,3280
20210328,경원선,지행,3578,3458,7036
20210328,경원선,덕정,2694,2802,5496
20210328,경원선,덕계,1316,1284,2600
20210328,경원선,양주,3798,3813,7611
20210328,경원선,녹양,2238,2121,4359
20210328,경원선,가능,3341,3173,6514
20210328,경원선,의정부,11865,12026,23891
20210328,경원선,회룡,6198,6045,12243
20210328,경원선,망월사,3517,3699,7216
20210328,경원선,도봉산,5362,3575,8937
20210328,경원선,도봉,2839,2709,5548
20210328,경원선,방학,4632,4374,9006
20210328,경원선,창동,1,0,1
20210328,경원선,녹천,2293,2055,4348
20210328,경원선,월계,3043,2802,5845
20210328,경원선,광운대,3771,3826,7597
20210328,경원선,석계,4130,4567,8697
20210328,경원선,신이문,3996,3786,7782
20210328,경원선,외대앞,4734,4790,9524
20210328,경원선,청량리,10351,10356,20707
20210328,경원선,왕십리,7492,8527,16019
20210328,경원선,응봉,998,1035,2033
20210328,경원선,옥수,50,11,61
20210328,경원선,한남,1667,1620,3287
20210328,경원선,서빙고,1120,1083,2203
20210328,경원선,이촌,1856,1478,3334
20210403,경원선,소요산,1946,1646,3592
20210403,경원선,동두천,1193,1433,2626
20210403,경원선,보산,1287,1329,2616
20210403,경원선,동두천중앙,1924,1987,3911
20210403,경원선,지행,4137,4026,8163
20210403,경원선,덕정,3317,3189,6506
20210403,경원선,덕계,1711,1600,3311
20210403,경원선,양주,4837,4539,9376
20210403,경원선,녹양,2738,2592,5330
20210403,경원선,가능,4150,4012,8162
20210403,경원선,의정부,13541,14514,28055
20210403,경원선,회룡,7689,7579,15268
20210403,경원선,망월사,4376,4545,8921
20210403,경원선,도봉산,4994,3222,8216
20210403,경원선,이촌,2369,1759,4128
20210403,경원선,서빙고,1071,986,2057
20210403,경원선,한남,2191,2149,4340
20210403,경원선,옥수,34,43,77
20210403,경원선,응봉,1380,1268,2648
20210403,경원선,왕십리,10558,11984,22542
20210403,경원선,청량리,12586,13702,26288
20210403,경원선,외대앞,5094,5026,10120
20210403,경원선,신이문,4992,4828,9820
20210403,경원선,석계,5421,5924,11345
20210403,경원선,광운대,4819,4774,9593
20210403,경원선,월계,3756,3477,7233
20210403,경원선,녹천,2610,2305,4915
20210403,경원선,방학,5853,5821,11674
20210403,경원선,도봉,3633,3467,7100
20210404,경원선,이촌,2330,1702,4032
20210404,경원선,서빙고,1245,1259,2504
20210404,경원선,한남,1854,1770,3624
20210404,경원선,옥수,45,27,72
20210404,경원선,응봉,1172,1188,2360
20210404,경원선,왕십리,8255,9662,17917
20210404,경원선,청량리,11736,11627,23363
20210404,경원선,외대앞,4409,4410,8819
20210404,경원선,신이문,4411,4096,8507
20210404,경원선,석계,4659,5026,9685
20210404,경원선,광운대,3973,4204,8177
20210404,경원선,월계,3498,3324,6822
20210404,경원선,녹천,2466,2200,4666
20210404,경원선,방학,5588,5366,10954
20210404,경원선,도봉,3215,2979,6194
20210404,경원선,도봉산,8087,5781,13868
20210404,경원선,망월사,4062,4204,8266
20210404,경원선,회룡,6957,6941,13898
20210404,경원선,의정부,12656,12886,25542
20210404,경원선,가능,3708,3504,7212
20210404,경원선,녹양,2511,2456,4967
20210404,경원선,양주,4592,4541,9133
20210404,경원선,덕계,1482,1434,2916
20210404,경원선,덕정,3159,3204,6363
20210404,경원선,지행,4033,4102,8135
20210404,경원선,동두천중앙,2009,1854,3863
20210404,경원선,보산,1303,1420,2723
20210404,경원선,동두천,1273,1603,2876
20210404,경원선,소요산,3845,3325,7170
20210410,경원선,소요산,4929,4216,9145
20210410,경원선,동두천,1657,2248,3905
20210410,경원선,보산,1808,1705,3513
20210410,경원선,동두천중앙,2847,2817,5664
20210410,경원선,지행,5357,5408,10765
20210410,경원선,덕정,4387,4098,8485
20210410,경원선,덕계,2150,1993,4143
20210410,경원선,양주,6416,6121,12537
20210410,경원선,녹양,3563,3350,6913
20210410,경원선,가능,5093,4908,10001
20210410,경원선,의정부,17018,17723,34741
20210410,경원선,회룡,9665,9780,19445
20210410,경원선,망월사,5569,5745,11314
20210410,경원선,도봉산,10303,7237,17540
20210410,경원선,도봉,4403,4184,8587
20210410,경원선,방학,7418,7278,14696
20210410,경원선,녹천,3434,2830,6264
20210410,경원선,월계,4624,4253,8877
20210410,경원선,광운대,5469,5402,10871
20210410,경원선,석계,6573,7053,13626
20210410,경원선,신이문,6172,5681,11853
20210410,경원선,외대앞,6045,5824,11869
20210410,경원선,청량리,14765,16679,31444
20210410,경원선,왕십리,11359,13080,24439
20210410,경원선,응봉,1704,1524,3228
20210410,경원선,옥수,54,38,92
20210410,경원선,한남,2846,2668,5514
20210410,경원선,서빙고,1423,1276,2699
20210410,경원선,이촌,3353,2296,5649
20210411,경원선,소요산,4868,4307,9175
20210411,경원선,동두천,1447,1888,3335
20210411,경원선,보산,1613,1739,3352
20210411,경원선,동두천중앙,2125,2026,4151
20210411,경원선,지행,4177,4126,8303
20210411,경원선,덕정,3395,3438,6833
20210411,경원선,덕계,1586,1533,3119
20210411,경원선,양주,5165,5069,10234
20210411,경원선,녹양,2677,2591,5268
20210411,경원선,가능,3884,3688,7572
20210411,경원선,의정부,13454,13545,26999
20210411,경원선,회룡,7240,7263,14503
20210411,경원선,망월사,4821,5024,9845
20210411,경원선,도봉산,9782,7127,16909
20210411,경원선,도봉,3529,3218,6747
20210411,경원선,방학,5816,5511,11327
20210411,경원선,녹천,2585,2225,4810
20210411,경원선,월계,3565,3327,6892
20210411,경원선,광운대,4035,4228,8263
20210411,경원선,석계,4668,5260,9928
20210411,경원선,신이문,4599,4334,8933
20210411,경원선,외대앞,4609,4602,9211
20210411,경원선,청량리,12409,11968,24377
20210411,경원선,왕십리,7898,9145,17043
20210411,경원선,응봉,1276,1246,2522
20210411,경원선,옥수,71,30,101
20210411,경원선,한남,1856,1883,3739
20210411,경원선,서빙고,1233,1258,2491
20210411,경원선,이촌,2419,1797,4216
20210417,경원선,이촌,2792,2100,4892
20210417,경원선,서빙고,1225,1070,2295
20210417,경원선,한남,2642,2448,5090
20210417,경원선,옥수,34,30,64
20210417,경원선,응봉,1417,1350,2767
20210417,경원선,왕십리,10861,12512,23373
20210417,경원선,청량리,13897,15575,29472
20210417,경원선,외대앞,5242,5231,10473
20210417,경원선,신이문,5905,5367,11272
20210417,경원선,석계,6260,6730,12990
20210417,경원선,광운대,5265,5063,10328
20210417,경원선,월계,4202,3887,8089
20210417,경원선,녹천,3102,2698,5800
20210417,경원선,방학,6897,6840,13737
20210417,경원선,도봉,4230,3969,8199
20210417,경원선,도봉산,8176,5563,13739
20210417,경원선,망월사,5120,5234,10354
20210417,경원선,회룡,8940,7947,16887
20210417,경원선,의정부,15853,16580,32433
20210417,경원선,가능,4600,4597,9197
20210417,경원선,녹양,3235,3100,6335
20210417,경원선,양주,5776,5565,11341
20210417,경원선,덕계,2099,1939,4038
20210417,경원선,덕정,4005,3875,7880
20210417,경원선,지행,4878,4842,9720
20210417,경원선,동두천중앙,2364,2388,4752
20210417,경원선,보산,2097,1833,3930
20210417,경원선,동두천,1534,2136,3670
20210417,경원선,소요산,3531,2941,6472
20210418,경원선,창동,1,0,1
20210418,경원선,소요산,4886,4124,9010
20210418,경원선,동두천,1374,2016,3390
20210418,경원선,보산,1326,1592,2918
20210418,경원선,동두천중앙,1970,1873,3843
20210418,경원선,지행,4009,4079,8088
20210418,경원선,덕정,3203,3338,6541
20210418,경원선,덕계,1613,1496,3109
20210418,경원선,양주,4844,4827,9671
20210418,경원선,녹양,2543,2484,5027
20210418,경원선,가능,3821,3720,7541
20210418,경원선,의정부,12850,12873,25723
20210418,경원선,회룡,6865,5924,12789
20210418,경원선,망월사,4126,4422,8548
20210418,경원선,도봉산,9931,7158,17089
20210418,경원선,도봉,3367,3277,6644
20210418,경원선,방학,5683,5464,11147
20210418,경원선,녹천,2444,2124,4568
20210418,경원선,월계,3537,3390,6927
20210418,경원선,광운대,3895,4096,7991
20210418,경원선,석계,4637,5114,9751
20210418,경원선,신이문,4577,4303,8880
20210418,경원선,외대앞,4000,3901,7901
20210418,경원선,청량리,12765,12085,24850
20210418,경원선,왕십리,7973,9324,17297
20210418,경원선,응봉,1184,1256,2440
20210418,경원선,옥수,64,25,89
20210418,경원선,한남,1962,1973,3935
20210418,경원선,서빙고,1200,1187,2387
20210418,경원선,이촌,2268,1724,3992
20210424,경원선,소요산,4526,3707,8233
20210424,경원선,동두천,1583,2414,3997
20210424,경원선,보산,1723,1580,3303
20210424,경원선,동두천중앙,2461,2548,5009
20210424,경원선,지행,5229,5126,10355
20210424,경원선,덕정,4207,3971,8178
20210424,경원선,덕계,2134,1959,4093
20210424,경원선,양주,6207,6050,12257
20210424,경원선,녹양,3324,3172,6496
20210424,경원선,가능,5012,4776,9788
20210424,경원선,의정부,16337,17449,33786
20210424,경원선,회룡,9522,9400,18922
20210424,경원선,망월사,5384,5563,10947
20210424,경원선,도봉산,9611,6704,16315
20210424,경원선,도봉,4327,4210,8537
20210424,경원선,방학,7389,7127,14516
20210424,경원선,녹천,3218,2815,6033
20210424,경원선,월계,4602,4262,8864
20210424,경원선,광운대,5537,5386,10923
20210424,경원선,석계,6524,6883,13407
20210424,경원선,신이문,6028,5499,11527
20210424,경원선,외대앞,5538,5218,10756
20210424,경원선,청량리,14493,16508,31001
20210424,경원선,왕십리,11142,12795,23937
20210424,경원선,응봉,1658,1572,3230
20210424,경원선,옥수,52,40,92
20210424,경원선,한남,2919,2718,5637
20210424,경원선,서빙고,1310,1142,2452
20210424,경원선,이촌,3254,2312,5566
20210425,경원선,소요산,4946,4153,9099
20210425,경원선,동두천,1390,1893,3283
20210425,경원선,보산,1266,1413,2679
20210425,경원선,동두천중앙,2124,2208,4332
20210425,경원선,지행,4033,4030,8063
20210425,경원선,덕정,3237,3243,6480
20210425,경원선,덕계,1644,1560,3204
20210425,경원선,양주,4935,4804,9739
20210425,경원선,녹양,2538,2505,5043
20210425,경원선,가능,3933,3734,7667
20210425,경원선,의정부,12580,12636,25216
20210425,경원선,회룡,6975,7131,14106
20210425,경원선,망월사,4589,4787,9376
20210425,경원선,도봉산,9837,7120,16957
20210425,경원선,도봉,3497,3279,6776
20210425,경원선,방학,5420,5327,10747
20210425,경원선,녹천,2713,2341,5054
20210425,경원선,월계,3873,3545,7418
20210425,경원선,광운대,3954,4072,8026
20210425,경원선,석계,4605,5028,9633
20210425,경원선,신이문,4451,4354,8805
20210425,경원선,외대앞,4167,4132,8299
20210425,경원선,청량리,12550,11832,24382
20210425,경원선,왕십리,7576,8574,16150
20210425,경원선,응봉,1157,1146,2303
20210425,경원선,옥수,52,24,76
20210425,경원선,한남,1993,1969,3962
20210425,경원선,서빙고,1333,1305,2638
20210425,경원선,이촌,2583,1824,4407
20210425,경원선,창동,1,0,1
20210501,경원선,이촌,2552,1829,4381
20210501,경원선,서빙고,1085,989,2074
20210501,경원선,한남,2433,2342,4775
20210501,경원선,옥수,26,38,64
20210501,경원선,응봉,1249,1067,2316
20210501,경원선,왕십리,10831,12175,23006
20210501,경원선,청량리,13618,15187,28805
20210501,경원선,외대앞,5265,5154,10419
20210501,경원선,신이문,5520,5057,10577
20210501,경원선,석계,5729,6108,11837
20210501,경원선,광운대,5271,5048,10319
20210501,경원선,월계,3989,3721,7710
20210501,경원선,녹천,2993,2554,5547
20210501,경원선,방학,6203,6124,12327
20210501,경원선,도봉,3758,3568,7326
20210501,경원선,도봉산,6844,4659,11503
20210501,경원선,망월사,4714,4830,9544
20210501,경원선,회룡,8088,8098,16186
20210501,경원선,의정부,15558,16291,31849
20210501,경원선,가능,4462,4265,8727
20210501,경원선,녹양,2886,2853,5739
20210501,경원선,양주,5338,5183,10521
20210501,경원선,덕계,1776,1618,3394
20210501,경원선,덕정,3485,3281,6766
20210501,경원선,지행,4672,4622,9294
20210501,경원선,동두천중앙,2123,2162,4285
20210501,경원선,보산,1803,1718,3521
20210501,경원선,동두천,1349,1715,3064
20210501,경원선,소요산,2796,2464,5260
20210502,경원선,이촌,2483,1874,4357
20210502,경원선,서빙고,1287,1242,2529
20210502,경원선,한남,1984,1904,3888
20210502,경원선,옥수,58,30,88
20210502,경원선,응봉,1283,1194,2477
20210502,경원선,왕십리,8606,10048,18654
20210502,경원선,청량리,13184,12667,25851
20210502,경원선,외대앞,4497,4509,9006
20210502,경원선,신이문,4698,4388,9086
20210502,경원선,석계,4636,5085,9721
20210502,경원선,광운대,4192,4485,8677
20210502,경원선,월계,3573,3455,7028
20210502,경원선,녹천,2587,2248,4835
20210502,경원선,방학,5648,5511,11159
20210502,경원선,도봉,3424,3168,6592
20210502,경원선,도봉산,9595,6999,16594
20210502,경원선,망월사,4193,4339,8532
20210502,경원선,회룡,7180,7173,14353
20210502,경원선,의정부,13017,13057,26074
20210502,경원선,가능,3751,3476,7227
20210502,경원선,녹양,2613,2475,5088
20210502,경원선,양주,4921,4898,9819
20210502,경원선,덕계,1630,1675,3305
20210502,경원선,덕정,3327,3567,6894
20210502,경원선,지행,4173,4164,8337
20210502,경원선,동두천중앙,2031,1924,3955
20210502,경원선,보산,1314,1535,2849
20210502,경원선,동두천,1386,2013,3399
20210502,경원선,소요산,4670,3857,8527
20210508,경원선,이촌,2604,1951,4555
20210508,경원선,서빙고,1171,1003,2174
20210508,경원선,한남,2592,2357,4949
20210508,경원선,옥수,33,38,71
20210508,경원선,응봉,1204,1018,2222
20210508,경원선,왕십리,10013,11266,21279
20210508,경원선,청량리,13152,15098,28250
20210508,경원선,외대앞,5851,5616,11467
20210508,경원선,신이문,5696,5309,11005
20210508,경원선,석계,5668,6098,11766
20210508,경원선,광운대,5274,5008,10282
20210508,경원선,월계,4283,3936,8219
20210508,경원선,녹천,3234,2676,5910
20210508,경원선,창동,3,0,3
20210508,경원선,방학,6692,6573,13265
20210508,경원선,도봉,3808,3756,7564
20210508,경원선,도봉산,7245,4924,12169
20210508,경원선,망월사,4973,5090,10063
20210508,경원선,회룡,8173,8234,16407
20210508,경원선,의정부,15085,15705,30790
20210508,경원선,가능,4632,4490,9122
20210508,경원선,녹양,3107,3025,6132
20210508,경원선,양주,5437,5590,11027
20210508,경원선,덕계,1885,1789,3674
20210508,경원선,덕정,3909,3780,7689
20210508,경원선,지행,4736,4923,9659
20210508,경원선,동두천중앙,2344,2452,4796
20210508,경원선,보산,1741,1631,3372
20210508,경원선,동두천,1417,1964,3381
20210508,경원선,소요산,3308,2908,6216
20210509,경원선,소요산,4646,3770,8416
20210509,경원선,동두천,1372,1756,3128
20210509,경원선,보산,1261,1508,2769
20210509,경원선,동두천중앙,2155,1963,4118
20210509,경원선,지행,4319,4120,8439
20210509,경원선,덕정,3198,3362,6560
20210509,경원선,덕계,1693,1512,3205
20210509,경원선,양주,4980,4642,9622
20210509,경원선,녹양,2788,2612,5400
20210509,경원선,가능,3946,3582,7528
20210509,경원선,의정부,12993,13233,26226
20210509,경원선,회룡,7253,7160,14413
20210509,경원선,망월사,4175,4396,8571
20210509,경원선,도봉산,9712,6962,16674
20210509,경원선,도봉,3477,3233,6710
20210509,경원선,방학,5535,5304,10839
20210509,경원선,창동,1,0,1
20210509,경원선,녹천,2541,2274,4815
20210509,경원선,월계,3618,3314,6932
20210509,경원선,광운대,4144,4423,8567
20210509,경원선,석계,4625,5188,9813
20210509,경원선,신이문,4608,4292,8900
20210509,경원선,외대앞,4344,4504,8848
20210509,경원선,청량리,13153,11925,25078
20210509,경원선,왕십리,8131,9508,17639
20210509,경원선,응봉,1235,1151,2386
20210509,경원선,옥수,91,31,122
20210509,경원선,한남,1957,1963,3920
20210509,경원선,서빙고,1316,1335,2651
20210509,경원선,이촌,2472,1799,4271
20210515,경원선,이촌,2678,1967,4645
20210515,경원선,서빙고,1223,1105,2328
20210515,경원선,한남,2658,2483,5141
20210515,경원선,옥수,30,31,61
20210515,경원선,응봉,1490,1430,2920
20210515,경원선,왕십리,11414,13171,24585
20210515,경원선,청량리,14556,15903,30459
20210515,경원선,외대앞,5594,5482,11076
20210515,경원선,신이문,5738,5364,11102
20210515,경원선,석계,6168,6647,12815
20210515,경원선,광운대,5614,5428,11042
20210515,경원선,월계,4832,4433,9265
20210515,경원선,녹천,3171,2760,5931
20210515,경원선,방학,6976,6760,13736
20210515,경원선,도봉,4199,4099,8298
20210515,경원선,도봉산,7750,5210,12960
20210515,경원선,망월사,5317,5447,10764
20210515,경원선,회룡,9219,9184,18403
20210515,경원선,의정부,16230,17001,33231
20210515,경원선,가능,4815,4624,9439
20210515,경원선,녹양,3246,3179,6425
20210515,경원선,양주,6009,5620,11629
20210515,경원선,덕계,2206,2025,4231
20210515,경원선,덕정,4148,3930,8078
20210515,경원선,지행,5119,5059,10178
20210515,경원선,동두천중앙,2490,2536,5026
20210515,경원선,보산,1617,1613,3230
20210515,경원선,동두천,1471,1893,3364
20210515,경원선,소요산,3471,2891,6362
20210516,경원선,이촌,1576,1280,2856
20210516,경원선,서빙고,1076,1075,2151
20210516,경원선,한남,1461,1457,2918
20210516,경원선,옥수,45,20,65
20210516,경원선,응봉,702,689,1391
20210516,경원선,왕십리,7505,8650,16155
20210516,경원선,청량리,11216,10154,21370
20210516,경원선,외대앞,3950,3868,7818
20210516,경원선,신이문,3746,3526,7272
20210516,경원선,석계,3559,3997,7556
20210516,경원선,광운대,3536,3588,7124
20210516,경원선,월계,2680,2626,5306
20210516,경원선,녹천,2022,1693,3715
20210516,경원선,방학,4360,4321,8681
20210516,경원선,도봉,2553,2450,5003
20210516,경원선,도봉산,3880,2681,6561
20210516,경원선,망월사,3662,3668,7330
20210516,경원선,회룡,5334,5225,10559
20210516,경원선,의정부,10353,10410,20763
20210516,경원선,가능,2948,2847,5795
20210516,경원선,녹양,1971,1936,3907
20210516,경원선,양주,3536,3512,7048
20210516,경원선,덕계,1221,1158,2379
20210516,경원선,덕정,2372,2572,4944
20210516,경원선,지행,3062,3078,6140
20210516,경원선,동두천중앙,1412,1397,2809
20210516,경원선,보산,949,1115,2064
20210516,경원선,동두천,934,1161,2095
20210516,경원선,소요산,1832,1496,3328
20210522,경원선,소요산,4654,4078,8732
20210522,경원선,동두천,1641,2121,3762
20210522,경원선,보산,1823,1696,3519
20210522,경원선,동두천중앙,2492,2516,5008
20210522,경원선,지행,5407,5382,10789
20210522,경원선,덕정,4576,4313,8889
20210522,경원선,덕계,2331,2054,4385
20210522,경원선,양주,6440,6293,12733
20210522,경원선,녹양,3535,3360,6895
20210522,경원선,가능,5266,4932,10198
20210522,경원선,의정부,16808,17888,34696
20210522,경원선,회룡,9776,9673,19449
20210522,경원선,망월사,5644,5830,11474
20210522,경원선,도봉산,10485,7485,17970
20210522,경원선,도봉,4623,4373,8996
20210522,경원선,방학,7462,7156,14618
20210522,경원선,녹천,3480,2833,6313
20210522,경원선,월계,4827,4411,9238
20210522,경원선,광운대,5876,5837,11713
20210522,경원선,석계,6733,7208,13941
20210522,경원선,신이문,6200,5681,11881
20210522,경원선,외대앞,6427,6125,12552
20210522,경원선,청량리,15426,16939,32365
20210522,경원선,왕십리,12008,13519,25527
20210522,경원선,응봉,1552,1341,2893
20210522,경원선,옥수,38,29,67
20210522,경원선,한남,2948,2752,5700
20210522,경원선,서빙고,1426,1316,2742
20210522,경원선,이촌,3542,2380,5922
20210523,경원선,이촌,2400,1726,4126
20210523,경원선,서빙고,1315,1325,2640
20210523,경원선,한남,2000,1917,3917
20210523,경원선,옥수,47,42,89
20210523,경원선,응봉,1130,1062,2192
20210523,경원선,왕십리,7953,9056,17009
20210523,경원선,청량리,12922,12055,24977
20210523,경원선,외대앞,4583,4527,9110
20210523,경원선,신이문,4681,4319,9000
20210523,경원선,석계,4645,5242,9887
20210523,경원선,광운대,4259,4274,8533
20210523,경원선,월계,3577,3268,6845
20210523,경원선,녹천,2512,2244,4756
20210523,경원선,방학,5599,5362,10961
20210523,경원선,도봉,3524,3255,6779
20210523,경원선,도봉산,10053,7244,17297
20210523,경원선,망월사,4267,4488,8755
20210523,경원선,회룡,7379,7342,14721
20210523,경원선,의정부,12833,13023,25856
20210523,경원선,가능,3891,3746,7637
20210523,경원선,녹양,2714,2573,5287
20210523,경원선,양주,5091,4929,10020
20210523,경원선,덕계,1670,1656,3326
20210523,경원선,덕정,3323,3479,6802
20210523,경원선,지행,4153,4128,8281
20210523,경원선,동두천중앙,2034,1961,3995
20210523,경원선,보산,1247,1438,2685
20210523,경원선,동두천,1370,1823,3193
20210523,경원선,소요산,4732,4052,8784
20210529,경원선,석계,6334,6718,13052
20210529,경원선,이촌,2921,2166,5087
20210529,경원선,서빙고,1291,1161,2452
20210529,경원선,한남,2761,2731,5492
20210529,경원선,옥수,37,48,85
20210529,경원선,응봉,1556,1387,2943
20210529,경원선,왕십리,11634,13224,24858
20210529,경원선,청량리,14845,16429,31274
20210529,경원선,외대앞,6150,6009,12159
20210529,경원선,신이문,5947,5429,11376
20210529,경원선,광운대,5612,5420,11032
20210529,경원선,월계,4448,4079,8527
20210529,경원선,녹천,3070,2633,5703
20210529,경원선,방학,7009,6986,13995
20210529,경원선,도봉,4239,3996,8235
20210529,경원선,도봉산,8908,6155,15063
20210529,경원선,망월사,5518,5630,11148
20210529,경원선,회룡,9310,9390,18700
20210529,경원선,의정부,16038,16706,32744
20210529,경원선,가능,4751,4607,9358
20210529,경원선,녹양,3347,3251,6598
20210529,경원선,양주,6105,5860,11965
20210529,경원선,덕계,2107,1940,4047
20210529,경원선,덕정,4184,4058,8242
20210529,경원선,지행,5175,4974,10149
20210529,경원선,동두천중앙,2361,2362,4723
20210529,경원선,보산,1693,1604,3297
20210529,경원선,동두천,1564,2063,3627
20210529,경원선,소요산,3882,3232,7114
20210530,경원선,소요산,4596,3993,8589
20210530,경원선,동두천,1349,1734,3083
20210530,경원선,보산,1454,1513,2967
20210530,경원선,동두천중앙,2164,2122,4286
20210530,경원선,지행,4203,3993,8196
20210530,경원선,덕정,3097,3246,6343
20210530,경원선,덕계,1611,1543,3154
20210530,경원선,양주,4849,4799,9648
20210530,경원선,녹양,2628,2652,5280
20210530,경원선,가능,3910,3810,7720
20210530,경원선,의정부,12976,13022,25998
20210530,경원선,회룡,7104,7145,14249
20210530,경원선,망월사,4240,4433,8673
20210530,경원선,도봉산,9667,7138,16805
20210530,경원선,도봉,3576,3286,6862
20210530,경원선,방학,5752,5545,11297
20210530,경원선,녹천,2748,2434,5182
20210530,경원선,월계,3598,3461,7059
20210530,경원선,광운대,4177,4334,8511
20210530,경원선,석계,4658,5259,9917
20210530,경원선,신이문,4574,4348,8922
20210530,경원선,외대앞,5133,5048,10181
20210530,경원선,청량리,13391,12456,25847
20210530,경원선,왕십리,8723,10076,18799
20210530,경원선,응봉,1170,1099,2269
20210530,경원선,옥수,61,25,86
20210530,경원선,한남,2143,2115,4258
20210530,경원선,서빙고,1250,1300,2550
20210530,경원선,이촌,2275,1778,4053
20210605,경원선,이촌,3207,2284,5491
20210605,경원선,서빙고,1334,1188,2522
20210605,경원선,한남,2794,2609,5403
20210605,경원선,옥수,32,40,72
20210605,경원선,응봉,1741,1581,3322
20210605,경원선,왕십리,11831,13531,25362
20210605,경원선,청량리,15259,16906,32165
20210605,경원선,외대앞,6053,5949,12002
20210605,경원선,신이문,6181,5531,11712
20210605,경원선,석계,6298,6961,13259
20210605,경원선,광운대,5570,5370,10940
20210605,경원선,월계,4698,4351,9049
20210605,경원선,녹천,3468,2854,6322
20210605,경원선,방학,7457,7346,14803
20210605,경원선,도봉,4386,4199,8585
20210605,경원선,도봉산,9623,6551,16174
20210605,경원선,망월사,6021,6134,12155
20210605,경원선,회룡,9527,9540,19067
20210605,경원선,의정부,17162,18121,35283
20210605,경원선,가능,5008,4797,9805
20210605,경원선,녹양,3644,3584,7228
20210605,경원선,양주,6102,5887,11989
20210605,경원선,덕계,2326,2122,4448
20210605,경원선,덕정,4345,4078,8423
20210605,경원선,지행,5354,5334,10688
20210605,경원선,동두천중앙,2892,2914,5806
20210605,경원선,보산,1793,1722,3515
20210605,경원선,동두천,1713,2144,3857
20210605,경원선,소요산,4238,3739,7977
20210606,경원선,이촌,2431,1776,4207
20210606,경원선,서빙고,1267,1252,2519
20210606,경원선,한남,1926,1928,3854
20210606,경원선,옥수,66,17,83
20210606,경원선,응봉,1085,959,2044
20210606,경원선,왕십리,8283,9575,17858
20210606,경원선,청량리,13189,11989,25178
20210606,경원선,외대앞,4141,4103,8244
20210606,경원선,신이문,4476,4202,8678
20210606,경원선,석계,4409,4906,9315
20210606,경원선,광운대,3960,4143,8103
20210606,경원선,월계,3530,3349,6879
20210606,경원선,녹천,2490,2170,4660
20210606,경원선,방학,5472,5378,10850
20210606,경원선,도봉,3264,3156,6420
20210606,경원선,도봉산,9373,6727,16100
20210606,경원선,망월사,4146,4363,8509
20210606,경원선,회룡,7042,7131,14173
20210606,경원선,의정부,12728,12817,25545
20210606,경원선,가능,3832,3574,7406
20210606,경원선,녹양,2785,2662,5447
20210606,경원선,양주,4796,4592,9388
20210606,경원선,덕계,1639,1560,3199
20210606,경원선,덕정,3111,3387,6498
20210606,경원선,지행,4031,4010,8041
20210606,경원선,동두천중앙,2032,1914,3946
20210606,경원선,보산,1350,1552,2902
20210606,경원선,동두천,1328,1664,2992
20210606,경원선,소요산,4457,3837,8294
20210612,경원선,이촌,3150,2258,5408
20210612,경원선,서빙고,1355,1244,2599
20210612,경원선,한남,2774,2610,5384
20210612,경원선,옥수,35,32,67
20210612,경원선,응봉,1366,1180,2546
20210612,경원선,왕십리,11151,12872,24023
20210612,경원선,청량리,14749,16648,31397
20210612,경원선,외대앞,5328,5213,10541
20210612,경원선,신이문,5874,5287,11161
20210612,경원선,석계,6214,6601,12815
20210612,경원선,광운대,5507,5500,11007
20210612,경원선,월계,4422,4027,8449
20210612,경원선,녹천,3282,2711,5993
20210612,경원선,방학,7043,6889,13932
20210612,경원선,도봉,4384,4111,8495
20210612,경원선,도봉산,9171,6415,15586
20210612,경원선,망월사,5551,5731,11282
20210612,경원선,회룡,9366,9403,18769
20210612,경원선,의정부,16515,17342,33857
20210612,경원선,가능,5029,4679,9708
20210612,경원선,녹양,3432,3357,6789
20210612,경원선,양주,5959,5926,11885
20210612,경원선,덕계,2137,2050,4187
20210612,경원선,덕정,4524,4220,8744
20210612,경원선,지행,5098,5118,10216
20210612,경원선,동두천중앙,2421,2536,4957
20210612,경원선,보산,1631,1528,3159
20210612,경원선,동두천,1576,1982,3558
20210612,경원선,소요산,4460,3976,8436
20210613,경원선,이촌,2179,1695,3874
20210613,경원선,서빙고,1246,1281,2527
20210613,경원선,한남,1807,1783,3590
20210613,경원선,옥수,67,29,96
20210613,경원선,응봉,997,902,1899
20210613,경원선,왕십리,7392,8568,15960
20210613,경원선,청량리,12729,11780,24509
20210613,경원선,외대앞,3856,3739,7595
20210613,경원선,신이문,4358,4136,8494
20210613,경원선,석계,4397,4866,9263
20210613,경원선,광운대,3906,3896,7802
20210613,경원선,월계,3148,2935,6083
20210613,경원선,녹천,2357,2003,4360
20210613,경원선,방학,5182,5030,10212
20210613,경원선,도봉,3190,2976,6166
20210613,경원선,도봉산,8778,6247,15025
20210613,경원선,망월사,4137,4375,8512
20210613,경원선,회룡,6793,6754,13547
20210613,경원선,의정부,12319,12668,24987
20210613,경원선,가능,3801,3510,7311
20210613,경원선,녹양,2510,2353,4863
20210613,경원선,양주,4610,4618,9228
20210613,경원선,덕계,1564,1542,3106
20210613,경원선,덕정,3073,3216,6289
20210613,경원선,지행,4023,3977,8000
20210613,경원선,동두천중앙,1974,1907,3881
20210613,경원선,보산,1231,1315,2546
20210613,경원선,동두천,1301,1718,3019
20210613,경원선,소요산,4418,3762,8180
20210619,경원선,이촌,3275,2277,5552
20210619,경원선,서빙고,1396,1177,2573
20210619,경원선,한남,2732,2640,5372
20210619,경원선,옥수,36,41,77
20210619,경원선,응봉,1395,1243,2638
20210619,경원선,왕십리,11958,13652,25610
20210619,경원선,청량리,15625,17425,33050
20210619,경원선,외대앞,5975,5555,11530
20210619,경원선,신이문,6179,5511,11690
20210619,경원선,석계,6484,7052,13536
20210619,경원선,광운대,5805,5580,11385
20210619,경원선,월계,4680,4340,9020
20210619,경원선,녹천,3421,2862,6283
20210619,경원선,방학,7431,7258,14689
20210619,경원선,도봉,4436,4143,8579
20210619,경원선,도봉산,9612,6734,16346
20210619,경원선,망월사,5519,5678,11197
20210619,경원선,회룡,9529,9388,18917
20210619,경원선,의정부,17084,18021,35105
20210619,경원선,가능,5196,4972,10168
20210619,경원선,녹양,3595,3451,7046
20210619,경원선,양주,6296,6018,12314
20210619,경원선,덕계,2236,2113,4349
20210619,경원선,덕정,4378,4027,8405
20210619,경원선,지행,5480,5522,11002
20210619,경원선,동두천중앙,2570,2558,5128
20210619,경원선,보산,1587,1560,3147
20210619,경원선,동두천,1612,2090,3702
20210619,경원선,소요산,4507,4050,8557
20210620,경원선,소요산,4523,3921,8444
20210620,경원선,동두천,1258,1588,2846
20210620,경원선,보산,1283,1275,2558
20210620,경원선,동두천중앙,2186,2166,4352
20210620,경원선,지행,4050,3886,7936
20210620,경원선,덕정,3174,3184,6358
20210620,경원선,덕계,1642,1541,3183
20210620,경원선,양주,4934,4872,9806
20210620,경원선,녹양,2727,2655,5382
20210620,경원선,가능,3824,3776,7600
20210620,경원선,의정부,12818,13054,25872
20210620,경원선,회룡,6985,7150,14135
20210620,경원선,망월사,4244,4402,8646
20210620,경원선,도봉산,9181,6580,15761
20210620,경원선,도봉,3393,3290,6683
20210620,경원선,방학,5607,5380,10987
20210620,경원선,녹천,2489,2214,4703
20210620,경원선,월계,3578,3302,6880
20210620,경원선,광운대,4208,4298,8506
20210620,경원선,석계,4611,5037,9648
20210620,경원선,신이문,4450,4196,8646
20210620,경원선,외대앞,4232,4149,8381
20210620,경원선,청량리,13839,12741,26580
20210620,경원선,왕십리,8697,9980,18677
20210620,경원선,응봉,1041,998,2039
20210620,경원선,옥수,62,26,88
20210620,경원선,한남,1880,1804,3684
20210620,경원선,서빙고,1274,1261,2535
20210620,경원선,이촌,2500,1842,4342
20210626,경원선,양주,5754,5458,11212
20210626,경원선,이촌,3095,2173,5268
20210626,경원선,서빙고,1371,1231,2602
20210626,경원선,한남,2829,2568,5397
20210626,경원선,옥수,32,31,63
20210626,경원선,응봉,1358,1094,2452
20210626,경원선,왕십리,11714,13318,25032
20210626,경원선,청량리,15334,17046,32380
20210626,경원선,외대앞,5835,5352,11187
20210626,경원선,신이문,6038,5419,11457
20210626,경원선,석계,6516,6794,13310
20210626,경원선,광운대,5598,5379,10977
20210626,경원선,월계,4457,4100,8557
20210626,경원선,녹천,3189,2612,5801
20210626,경원선,방학,7226,7019,14245
20210626,경원선,도봉,4263,3954,8217
20210626,경원선,도봉산,7557,5213,12770
20210626,경원선,망월사,5111,5252,10363
20210626,경원선,회룡,8957,8880,17837
20210626,경원선,의정부,15995,16879,32874
20210626,경원선,가능,4762,4599,9361
20210626,경원선,녹양,3360,3341,6701
20210626,경원선,덕계,2089,1921,4010
20210626,경원선,덕정,4105,3829,7934
20210626,경원선,지행,4967,5029,9996
20210626,경원선,동두천중앙,2354,2387,4741
20210626,경원선,보산,1389,1361,2750
20210626,경원선,동두천,1495,1792,3287
20210626,경원선,소요산,3214,2840,6054
20210627,경원선,소요산,4787,4232,9019
20210627,경원선,동두천,1380,1729,3109
20210627,경원선,보산,1224,1363,2587
20210627,경원선,동두천중앙,2051,1966,4017
20210627,경원선,지행,4127,4154,8281
20210627,경원선,덕정,3243,3305,6548
20210627,경원선,덕계,1617,1533,3150
20210627,경원선,양주,4761,4769,9530
20210627,경원선,녹양,2697,2631,5328
20210627,경원선,가능,3957,3827,7784
20210627,경원선,의정부,13234,13176,26410
20210627,경원선,회룡,7179,7061,14240
20210627,경원선,망월사,4299,4417,8716
20210627,경원선,도봉산,9715,6966,16681
20210627,경원선,도봉,3443,3231,6674
20210627,경원선,방학,5608,5525,11133
20210627,경원선,녹천,2788,2501,5289
20210627,경원선,월계,3575,3236,6811
20210627,경원선,광운대,4197,4271,8468
20210627,경원선,석계,4623,5026,9649
20210627,경원선,신이문,4571,4295,8866
20210627,경원선,외대앞,4707,4689,9396
20210627,경원선,청량리,13691,12728,26419
20210627,경원선,왕십리,8189,9152,17341
20210627,경원선,응봉,1021,1009,2030
20210627,경원선,옥수,51,24,75
20210627,경원선,한남,1903,1858,3761
20210627,경원선,서빙고,1309,1339,2648
20210627,경원선,이촌,2239,1747,3986
20210703,경원선,광운대,5140,4988,10128
20210703,경원선,석계,6009,6350,12359
20210703,경원선,신이문,5553,5239,10792
20210703,경원선,외대앞,5327,5186,10513
20210703,경원선,청량리,14466,16028,30494
20210703,경원선,왕십리,10935,12689,23624
20210703,경원선,응봉,1155,1017,2172
20210703,경원선,옥수,46,39,85
20210703,경원선,한남,2511,2445,4956
20210703,경원선,서빙고,1157,1128,2285
20210703,경원선,이촌,2748,2101,4849
20210703,경원선,소요산,3148,2848,5996
20210703,경원선,동두천,1381,1740,3121
20210703,경원선,보산,1285,1337,2622
20210703,경원선,동두천중앙,2296,2315,4611
20210703,경원선,지행,4750,4705,9455
20210703,경원선,덕정,3673,3430,7103
20210703,경원선,덕계,2060,1896,3956
20210703,경원선,양주,5329,5130,10459
20210703,경원선,녹양,3124,3068,6192
20210703,경원선,가능,4582,4487,9069
20210703,경원선,의정부,15350,15858,31208
20210703,경원선,회룡,8546,8462,17008
20210703,경원선,망월사,5073,5263,10336
20210703,경원선,도봉산,7650,5164,12814
20210703,경원선,도봉,4003,3857,7860
20210703,경원선,방학,6586,6526,13112
20210703,경원선,녹천,3130,2727,5857
20210703,경원선,월계,3973,3840,7813
20210704,경원선,이촌,1785,1415,3200
20210704,경원선,서빙고,1131,1081,2212
20210704,경원선,한남,1545,1605,3150
20210704,경원선,옥수,47,22,69
20210704,경원선,응봉,981,868,1849
20210704,경원선,왕십리,7526,8530,16056
20210704,경원선,청량리,11997,10451,22448
20210704,경원선,외대앞,3692,3657,7349
20210704,경원선,신이문,3762,3575,7337
20210704,경원선,석계,3800,4228,8028
20210704,경원선,광운대,3470,3604,7074
20210704,경원선,월계,3192,2929,6121
20210704,경원선,녹천,2045,1806,3851
20210704,경원선,방학,4678,4580,9258
20210704,경원선,도봉,2783,2579,5362
20210704,경원선,도봉산,4489,3059,7548
20210704,경원선,망월사,3430,3510,6940
20210704,경원선,회룡,5641,5614,11255
20210704,경원선,의정부,10668,10782,21450
20210704,경원선,가능,3181,3005,6186
20210704,경원선,녹양,2178,2125,4303
20210704,경원선,양주,3597,3668,7265
20210704,경원선,덕계,1292,1235,2527
20210704,경원선,덕정,2500,2617,5117
20210704,경원선,지행,3406,3431,6837
20210704,경원선,동두천중앙,1685,1597,3282
20210704,경원선,보산,1057,1023,2080
20210704,경원선,동두천,1183,1279,2462
20210704,경원선,소요산,2406,1945,4351
20210710,경원선,왕십리,9780,11309,21089
20210710,경원선,청량리,11997,14026,26023
20210710,경원선,외대앞,4897,4778,9675
20210710,경원선,신이문,5325,4797,10122
20210710,경원선,석계,5350,5667,11017
20210710,경원선,광운대,4747,4575,9322
20210710,경원선,월계,4163,3817,7980
20210710,경원선,녹천,2930,2464,5394
20210710,경원선,방학,6344,6161,12505
20210710,경원선,도봉,3894,3631,7525
20210710,경원선,도봉산,7129,4815,11944
20210710,경원선,망월사,4750,4776,9526
20210710,경원선,회룡,7797,7836,15633
20210710,경원선,의정부,13801,14741,28542
20210710,경원선,가능,4527,4266,8793
20210710,경원선,녹양,2943,2881,5824
20210710,경원선,양주,4913,4715,9628
20210710,경원선,덕계,1901,1813,3714
20210710,경원선,덕정,3476,3413,6889
20210710,경원선,지행,4378,4288,8666
20210710,경원선,동두천중앙,2275,2349,4624
20210710,경원선,보산,1146,1188,2334
20210710,경원선,동두천,1357,1731,3088
20210710,경원선,소요산,3252,2904,6156
20210710,경원선,이촌,2449,1839,4288
20210710,경원선,서빙고,1079,957,2036
20210710,경원선,한남,2414,2184,4598
20210710,경원선,옥수,37,27,64
20210710,경원선,응봉,1116,909,2025
20210711,경원선,이촌,1646,1385,3031
20210711,경원선,서빙고,953,995,1948
20210711,경원선,한남,1472,1516,2988
20210711,경원선,옥수,55,24,79
20210711,경원선,응봉,792,725,1517
20210711,경원선,왕십리,6535,7676,14211
20210711,경원선,청량리,10747,9431,20178
20210711,경원선,외대앞,3772,3701,7473
20210711,경원선,신이문,3639,3454,7093
20210711,경원선,석계,3616,3953,7569
20210711,경원선,광운대,3184,3243,6427
20210711,경원선,월계,2853,2629,5482
20210711,경원선,녹천,2077,1799,3876
20210711,경원선,방학,4552,4388,8940
20210711,경원선,도봉,2688,2515,5203
20210711,경원선,도봉산,5820,4161,9981
20210711,경원선,망월사,3707,3617,7324
20210711,경원선,회룡,5326,5416,10742
20210711,경원선,의정부,10373,10575,20948
20210711,경원선,가능,3178,3025,6203
20210711,경원선,녹양,2092,2088,4180
20210711,경원선,양주,3674,3570,7244
20210711,경원선,덕계,1362,1253,2615
20210711,경원선,덕정,2583,2731,5314
20210711,경원선,지행,3301,3240,6541
20210711,경원선,동두천중앙,1676,1608,3284
20210711,경원선,보산,987,864,1851
20210711,경원선,동두천,1066,1290,2356
20210711,경원선,소요산,3283,2750,6033
20210717,경원선,창동,1,0,1
20210717,경원선,소요산,3947,3573,7520
20210717,경원선,동두천,1280,1661,2941
20210717,경원선,보산,993,985,1978
20210717,경원선,동두천중앙,1958,1991,3949
20210717,경원선,지행,3949,4041,7990
20210717,경원선,덕정,3294,3106,6400
20210717,경원선,덕계,1876,1712,3588
20210717,경원선,양주,4682,4482,9164
20210717,경원선,녹양,2612,2574,5186
20210717,경원선,가능,4050,3900,7950
20210717,경원선,의정부,12760,13288,26048
20210717,경원선,회룡,7271,7371,14642
20210717,경원선,망월사,4280,4504,8784
20210717,경원선,도봉산,7559,5068,12627
20210717,경원선,도봉,3569,3431,7000
20210717,경원선,방학,5946,5768,11714
20210717,경원선,녹천,2731,2273,5004
20210717,경원선,월계,3558,3412,6970
20210717,경원선,광운대,4299,4153,8452
20210717,경원선,석계,4894,5169,10063
20210717,경원선,신이문,4863,4568,9431
20210717,경원선,외대앞,4468,4284,8752
20210717,경원선,청량리,11431,13175,24606
20210717,경원선,왕십리,8756,10185,18941
20210717,경원선,응봉,1302,1170,2472
20210717,경원선,옥수,31,29,60
20210717,경원선,한남,2222,1956,4178
20210717,경원선,서빙고,1011,839,1850
20210717,경원선,이촌,2147,1679,3826
20210718,경원선,소요산,4159,3643,7802
20210718,경원선,동두천,1066,1273,2339
20210718,경원선,보산,880,818,1698
20210718,경원선,동두천중앙,1651,1475,3126
20210718,경원선,지행,3039,2940,5979
20210718,경원선,덕정,2339,2465,4804
20210718,경원선,덕계,1144,1125,2269
20210718,경원선,양주,3485,3496,6981
20210718,경원선,녹양,1860,1894,3754
20210718,경원선,가능,2944,2772,5716
20210718,경원선,의정부,9942,10043,19985
20210718,경원선,회룡,5065,5150,10215
20210718,경원선,망월사,3270,3387,6657
20210718,경원선,도봉산,6986,4927,11913
20210718,경원선,도봉,2631,2453,5084
20210718,경원선,방학,4189,4136,8325
20210718,경원선,창동,1,0,1
20210718,경원선,녹천,1936,1607,3543
20210718,경원선,월계,2669,2537,5206
20210718,경원선,광운대,3092,3179,6271
20210718,경원선,석계,3449,3883,7332
20210718,경원선,신이문,3580,3264,6844
20210718,경원선,외대앞,3146,3214,6360
20210718,경원선,청량리,10871,9226,20097
20210718,경원선,왕십리,6538,7813,14351
20210718,경원선,응봉,771,724,1495
20210718,경원선,옥수,50,11,61
20210718,경원선,한남,1446,1484,2930
20210718,경원선,서빙고,691,676,1367
20210718,경원선,이촌,1415,1129,2544
20210724,경원선,이촌,2107,1618,3725
20210724,경원선,서빙고,956,822,1778
20210724,경원선,한남,2107,1945,4052
20210724,경원선,옥수,37,34,71
20210724,경원선,응봉,1002,808,1810
20210724,경원선,왕십리,8762,10298,19060
20210724,경원선,청량리,11208,12820,24028
20210724,경원선,외대앞,4090,4048,8138
20210724,경원선,신이문,4774,4251,9025
20210724,경원선,석계,4858,5037,9895
20210724,경원선,광운대,4226,4045,8271
20210724,경원선,월계,3689,3371,7060
20210724,경원선,녹천,2515,2100,4615
20210724,경원선,방학,5814,5583,11397
20210724,경원선,도봉,3421,3217,6638
20210724,경원선,도봉산,6213,4722,10935
20210724,경원선,망월사,4409,4398,8807
20210724,경원선,회룡,6880,7073,13953
20210724,경원선,의정부,12790,13405,26195
20210724,경원선,가능,3914,3708,7622
20210724,경원선,녹양,2555,2435,4990
20210724,경원선,양주,4695,4522,9217
20210724,경원선,덕계,1670,1516,3186
20210724,경원선,덕정,3292,3110,6402
20210724,경원선,지행,3908,4016,7924
20210724,경원선,동두천중앙,1912,1978,3890
20210724,경원선,보산,1034,1064,2098
20210724,경원선,동두천,1391,1695,3086
20210724,경원선,소요산,4061,3680,7741
20210725,경원선,창동,1,0,1
20210725,경원선,이촌,1394,1185,2579
20210725,경원선,서빙고,691,652,1343
20210725,경원선,한남,1450,1454,2904
20210725,경원선,옥수,52,17,69
20210725,경원선,응봉,725,703,1428
20210725,경원선,왕십리,6031,7179,13210
20210725,경원선,청량리,10425,9085,19510
20210725,경원선,외대앞,3125,3177,6302
20210725,경원선,신이문,3353,3254,6607
20210725,경원선,석계,3277,3708,6985
20210725,경원선,광운대,2977,2891,5868
20210725,경원선,월계,2437,2328,4765
20210725,경원선,녹천,2012,1682,3694
20210725,경원선,방학,3905,3783,7688
20210725,경원선,도봉,2492,2338,4830
20210725,경원선,도봉산,5773,4539,10312
20210725,경원선,망월사,3166,3221,6387
20210725,경원선,회룡,4963,5003,9966
20210725,경원선,의정부,9609,9546,19155
20210725,경원선,가능,2861,2763,5624
20210725,경원선,녹양,1803,1824,3627
20210725,경원선,양주,3414,3387,6801
20210725,경원선,덕계,1174,1105,2279
20210725,경원선,덕정,2337,2354,4691
20210725,경원선,지행,2919,2887,5806
20210725,경원선,동두천중앙,1699,1603,3302
20210725,경원선,보산,921,846,1767
20210725,경원선,동두천,1148,1321,2469
20210725,경원선,소요산,4292,3812,8104
20210731,경원선,석계,4819,5280,10099
20210731,경원선,광운대,4080,4004,8084
20210731,경원선,월계,3432,3226,6658
20210731,경원선,녹천,2718,2172,4890
20210731,경원선,방학,5657,5479,11136
20210731,경원선,도봉산,6530,4442,10972
20210731,경원선,도봉,3401,3289,6690
20210731,경원선,소요산,3635,3317,6952
20210731,경원선,동두천,1302,1584,2886
20210731,경원선,보산,1010,1079,2089
20210731,경원선,동두천중앙,1962,2067,4029
20210731,경원선,지행,3828,3810,7638
20210731,경원선,덕정,3329,3073,6402
20210731,경원선,덕계,1649,1518,3167
20210731,경원선,양주,4636,4491,9127
20210731,경원선,녹양,2556,2498,5054
20210731,경원선,가능,3838,3761,7599
20210731,경원선,의정부,12677,13148,25825
20210731,경원선,회룡,6891,6963,13854
20210731,경원선,망월사,4203,4204,8407
20210731,경원선,이촌,2175,1649,3824
20210731,경원선,서빙고,972,824,1796
20210731,경원선,한남,2127,2033,4160
20210731,경원선,옥수,39,26,65
20210731,경원선,응봉,944,789,1733
20210731,경원선,왕십리,8678,9916,18594
20210731,경원선,청량리,11320,13138,24458
20210731,경원선,외대앞,4261,4279,8540
20210731,경원선,신이문,4666,4313,8979
20210801,경원선,소요산,3392,2902,6294
20210801,경원선,동두천,1061,1242,2303
20210801,경원선,보산,908,837,1745
20210801,경원선,동두천중앙,1572,1477,3049
20210801,경원선,지행,2699,2777,5476
20210801,경원선,덕정,2287,2235,4522
20210801,경원선,덕계,1136,1110,2246
20210801,경원선,양주,3411,3235,6646
20210801,경원선,녹양,1796,1745,3541
20210801,경원선,가능,2824,2642,5466
20210801,경원선,의정부,9570,9552,19122
20210801,경원선,회룡,4918,4779,9697
20210801,경원선,망월사,3015,3091,6106
20210801,경원선,도봉산,5676,3875,9551
20210801,경원선,도봉,2463,2371,4834
20210801,경원선,방학,3846,3778,7624
20210801,경원선,녹천,1755,1526,3281
20210801,경원선,월계,2629,2453,5082
20210801,경원선,광운대,2984,3005,5989
20210801,경원선,석계,3393,3905,7298
20210801,경원선,신이문,3374,3198,6572
20210801,경원선,외대앞,3105,3138,6243
20210801,경원선,청량리,11070,9598,20668
20210801,경원선,왕십리,6525,7535,14060
20210801,경원선,응봉,681,623,1304
20210801,경원선,옥수,49,18,67
20210801,경원선,한남,1412,1412,2824
20210801,경원선,서빙고,665,659,1324
20210801,경원선,이촌,1281,1107,2388
20210807,경원선,이촌,2268,1704,3972
20210807,경원선,서빙고,1061,923,1984
20210807,경원선,한남,2181,2065,4246
20210807,경원선,옥수,27,39,66
20210807,경원선,응봉,1056,882,1938
20210807,경원선,왕십리,9121,10951,20072
20210807,경원선,청량리,11930,13615,25545
20210807,경원선,외대앞,4531,4332,8863
20210807,경원선,신이문,4910,4536,9446
20210807,경원선,석계,5074,5355,10429
20210807,경원선,광운대,4399,4360,8759
20210807,경원선,월계,3653,3461,7114
20210807,경원선,녹천,2710,2260,4970
20210807,경원선,방학,6180,6009,12189
20210807,경원선,도봉,3624,3390,7014
20210807,경원선,도봉산,7304,5007,12311
20210807,경원선,망월사,4659,4680,9339
20210807,경원선,회룡,7565,7577,15142
20210807,경원선,의정부,13451,14064,27515
20210807,경원선,가능,4142,4040,8182
20210807,경원선,녹양,2728,2694,5422
20210807,경원선,양주,4943,4755,9698
20210807,경원선,덕계,1812,1697,3509
20210807,경원선,덕정,3391,3272,6663
20210807,경원선,지행,4307,4229,8536
20210807,경원선,동두천중앙,2029,2076,4105
20210807,경원선,보산,1066,1103,2169
20210807,경원선,동두천,1388,1823,3211
20210807,경원선,소요산,3898,3574,7472
20210808,경원선,양주,3841,3789,7630
20210808,경원선,이촌,1391,1170,2561
20210808,경원선,서빙고,663,650,1313
20210808,경원선,한남,1431,1443,2874
20210808,경원선,옥수,43,16,59
20210808,경원선,응봉,707,674,1381
20210808,경원선,왕십리,6383,7575,13958
20210808,경원선,청량리,11167,9660,20827
20210808,경원선,외대앞,3279,3311,6590
20210808,경원선,신이문,3571,3416,6987
20210808,경원선,석계,3602,3992,7594
20210808,경원선,광운대,3123,3126,6249
20210808,경원선,월계,2575,2420,4995
20210808,경원선,녹천,2033,1734,3767
20210808,경원선,방학,4139,4092,8231
20210808,경원선,도봉,2600,2492,5092
20210808,경원선,도봉산,6799,4641,11440
20210808,경원선,망월사,3382,3419,6801
20210808,경원선,회룡,5353,5325,10678
20210808,경원선,의정부,10012,10258,20270
20210808,경원선,가능,3061,2917,5978
20210808,경원선,녹양,1987,1968,3955
20210808,경원선,덕계,1186,1183,2369
20210808,경원선,덕정,2429,2527,4956
20210808,경원선,지행,3027,3081,6108
20210808,경원선,동두천중앙,1675,1573,3248
20210808,경원선,보산,966,908,1874
20210808,경원선,동두천,1063,1304,2367
20210808,경원선,소요산,4008,3457,7465
20210814,경원선,소요산,3780,3306,7086
20210814,경원선,동두천,1352,1771,3123
20210814,경원선,보산,1189,1159,2348
20210814,경원선,동두천중앙,2022,2187,4209
20210814,경원선,지행,4331,4339,8670
20210814,경원선,덕정,3513,3284,6797
20210814,경원선,덕계,1845,1735,3580
20210814,경원선,양주,5224,5004,10228
20210814,경원선,녹양,2738,2713,5451
20210814,경원선,가능,4372,4193,8565
20210814,경원선,의정부,13576,14453,28029
20210814,경원선,회룡,7801,7912,15713
20210814,경원선,망월사,4774,4883,9657
20210814,경원선,도봉산,7462,5184,12646
20210814,경원선,도봉,3866,3633,7499
20210814,경원선,방학,6090,5878,11968
20210814,경원선,녹천,2838,2350,5188
20210814,경원선,월계,3669,3541,7210
20210814,경원선,광운대,4567,4350,8917
20210814,경원선,석계,5303,5489,10792
20210814,경원선,신이문,5103,4530,9633
20210814,경원선,외대앞,4550,4535,9085
20210814,경원선,청량리,12553,14793,27346
20210814,경원선,왕십리,9515,10793,20308
20210814,경원선,응봉,1136,899,2035
20210814,경원선,옥수,32,32,64
20210814,경원선,한남,2401,2140,4541
20210814,경원선,서빙고,1129,959,2088
20210814,경원선,이촌,2520,1794,4314
20210815,경원선,소요산,4217,3560,7777
20210815,경원선,동두천,1117,1457,2574
20210815,경원선,보산,936,968,1904
20210815,경원선,동두천중앙,1829,1769,3598
20210815,경원선,지행,3371,3224,6595
20210815,경원선,덕정,2652,2781,5433
20210815,경원선,덕계,1275,1248,2523
20210815,경원선,양주,3933,3931,7864
20210815,경원선,녹양,2207,2111,4318
20210815,경원선,가능,3282,3109,6391
20210815,경원선,의정부,10919,11342,22261
20210815,경원선,회룡,5878,5902,11780
20210815,경원선,망월사,3581,3836,7417
20210815,경원선,도봉산,7760,5480,13240
20210815,경원선,도봉,2867,2684,5551
20210815,경원선,방학,4786,4649,9435
20210815,경원선,녹천,2020,1729,3749
20210815,경원선,월계,3297,2951,6248
20210815,경원선,광운대,3360,3456,6816
20210815,경원선,석계,3874,4293,8167
20210815,경원선,신이문,3754,3520,7274
20210815,경원선,외대앞,3412,3410,6822
20210815,경원선,청량리,11879,10874,22753
20210815,경원선,왕십리,7162,8226,15388
20210815,경원선,응봉,875,794,1669
20210815,경원선,옥수,27,22,49
20210815,경원선,한남,1680,1707,3387
20210815,경원선,서빙고,891,847,1738
20210815,경원선,이촌,1729,1327,3056
20210821,경원선,소요산,2042,1799,3841
20210821,경원선,동두천,1214,1549,2763
20210821,경원선,보산,974,1013,1987
20210821,경원선,동두천중앙,1815,1877,3692
20210821,경원선,지행,3858,3807,7665
20210821,경원선,덕정,2973,2791,5764
20210821,경원선,덕계,1767,1660,3427
20210821,경원선,양주,4540,4249,8789
20210821,경원선,녹양,2530,2479,5009
20210821,경원선,가능,3860,3754,7614
20210821,경원선,의정부,12178,12883,25061
20210821,경원선,회룡,6810,6828,13638
20210821,경원선,망월사,4172,4244,8416
20210821,경원선,도봉산,4821,3237,8058
20210821,경원선,도봉,3425,3191,6616
20210821,경원선,방학,5645,5456,11101
20210821,경원선,녹천,2447,2142,4589
20210821,경원선,월계,3368,3146,6514
20210821,경원선,광운대,4068,4033,8101
20210821,경원선,석계,4713,5010,9723
20210821,경원선,신이문,4666,4330,8996
20210821,경원선,외대앞,4215,4079,8294
20210821,경원선,청량리,10882,12408,23290
20210821,경원선,왕십리,8817,10253,19070
20210821,경원선,응봉,921,768,1689
20210821,경원선,옥수,31,43,74
20210821,경원선,한남,2101,1991,4092
20210821,경원선,서빙고,915,810,1725
20210821,경원선,이촌,2059,1579,3638
20210822,경원선,창동,1,0,1
20210822,경원선,이촌,1803,1540,3343
20210822,경원선,서빙고,930,860,1790
20210822,경원선,한남,1645,1663,3308
20210822,경원선,옥수,51,18,69
20210822,경원선,응봉,897,795,1692
20210822,경원선,왕십리,6789,7937,14726
20210822,경원선,청량리,11680,10478,22158
20210822,경원선,외대앞,3584,3520,7104
20210822,경원선,신이문,4075,3746,7821
20210822,경원선,석계,4068,4341,8409
20210822,경원선,광운대,3539,3495,7034
20210822,경원선,월계,3137,2868,6005
20210822,경원선,녹천,2260,1914,4174
20210822,경원선,방학,4860,4781,9641
20210822,경원선,도봉,2972,2934,5906
20210822,경원선,도봉산,7319,5303,12622
20210822,경원선,망월사,3783,3891,7674
20210822,경원선,회룡,6210,6016,12226
20210822,경원선,의정부,11148,11323,22471
20210822,경원선,가능,3446,3300,6746
20210822,경원선,녹양,2292,2159,4451
20210822,경원선,양주,4261,4214,8475
20210822,경원선,덕계,1419,1337,2756
20210822,경원선,덕정,2827,2776,5603
20210822,경원선,지행,3557,3547,7104
20210822,경원선,동두천중앙,1793,1727,3520
20210822,경원선,보산,979,972,1951
20210822,경원선,동두천,1241,1397,2638
20210822,경원선,소요산,3790,3289,7079
20210828,경원선,이촌,2756,2023,4779
20210828,경원선,서빙고,1267,1055,2322
20210828,경원선,한남,2586,2237,4823
20210828,경원선,옥수,34,39,73
20210828,경원선,응봉,1230,1083,2313
20210828,경원선,왕십리,10162,11601,21763
20210828,경원선,청량리,13600,15425,29025
20210828,경원선,외대앞,5125,4909,10034
20210828,경원선,신이문,5463,5104,10567
20210828,경원선,석계,5857,6253,12110
20210828,경원선,광운대,4940,4773,9713
20210828,경원선,월계,4242,4012,8254
20210828,경원선,녹천,2872,2423,5295
20210828,경원선,방학,6551,6423,12974
20210828,경원선,도봉,4047,3779,7826
20210828,경원선,도봉산,8104,5579,13683
20210828,경원선,망월사,5056,5178,10234
20210828,경원선,회룡,8609,8642,17251
20210828,경원선,의정부,14888,15790,30678
20210828,경원선,가능,4508,4295,8803
20210828,경원선,녹양,3047,2968,6015
20210828,경원선,양주,5803,5471,11274
20210828,경원선,덕계,2113,1926,4039
20210828,경원선,덕정,3718,3647,7365
20210828,경원선,지행,5208,5112,10320
20210828,경원선,동두천중앙,2381,2391,4772
20210828,경원선,보산,2028,1780,3808
20210828,경원선,동두천,1444,1893,3337
20210828,경원선,소요산,3914,3475,7389
20210829,경원선,양주,4332,4305,8637
20210829,경원선,이촌,1870,1536,3406
20210829,경원선,서빙고,937,934,1871
20210829,경원선,한남,1712,1601,3313
20210829,경원선,옥수,56,20,76
20210829,경원선,응봉,940,848,1788
20210829,경원선,왕십리,7723,9013,16736
20210829,경원선,청량리,12179,10977,23156
20210829,경원선,외대앞,3975,4027,8002
20210829,경원선,신이문,4170,3814,7984
20210829,경원선,석계,4297,4706,9003
20210829,경원선,광운대,3669,3766,7435
20210829,경원선,월계,3268,3127,6395
20210829,경원선,녹천,2400,2097,4497
20210829,경원선,창동,1,0,1
20210829,경원선,방학,5076,4939,10015
20210829,경원선,도봉,3079,2913,5992
20210829,경원선,도봉산,7375,5286,12661
20210829,경원선,망월사,3844,3867,7711
20210829,경원선,회룡,6290,6141,12431
20210829,경원선,의정부,11626,11769,23395
20210829,경원선,가능,3416,3194,6610
20210829,경원선,녹양,2253,2246,4499
20210829,경원선,덕계,1505,1428,2933
20210829,경원선,덕정,2857,2916,5773
20210829,경원선,지행,3941,3849,7790
20210829,경원선,동두천중앙,1881,1798,3679
20210829,경원선,보산,1515,1423,2938
20210829,경원선,동두천,1258,1514,2772
20210829,경원선,소요산,3795,3193,6988
20210904,경원선,이촌,3023,2053,5076
20210904,경원선,서빙고,1326,1170,2496
20210904,경원선,한남,2706,2515,5221
20210904,경원선,옥수,43,45,88
20210904,경원선,응봉,1278,1087,2365
20210904,경원선,왕십리,10976,13003,23979
20210904,경원선,청량리,14421,15798,30219
20210904,경원선,외대앞,5432,5255,10687
20210904,경원선,신이문,5600,5159,10759
20210904,경원선,석계,6337,6691,13028
20210904,경원선,광운대,5174,5044,10218
20210904,경원선,월계,4360,4024,8384
20210904,경원선,녹천,3126,2682,5808
20210904,경원선,방학,6861,6701,13562
20210904,경원선,도봉,4211,3978,8189
20210904,경원선,도봉산,8911,6302,15213
20210904,경원선,망월사,5173,5337,10510
20210904,경원선,회룡,9008,8936,17944
20210904,경원선,의정부,15387,16194,31581
20210904,경원선,가능,4753,4578,9331
20210904,경원선,녹양,3319,3187,6506
20210904,경원선,양주,6086,5824,11910
20210904,경원선,덕계,2203,2033,4236
20210904,경원선,덕정,3968,3776,7744
20210904,경원선,지행,5271,5243,10514
20210904,경원선,동두천중앙,2431,2409,4840
20210904,경원선,보산,2024,1909,3933
20210904,경원선,동두천,1545,2051,3596
20210904,경원선,소요산,4221,3708,7929
20210905,경원선,소요산,4046,3490,7536
20210905,경원선,동두천,1261,1589,2850
20210905,경원선,보산,1603,1444,3047
20210905,경원선,동두천중앙,2105,2021,4126
20210905,경원선,지행,4119,4020,8139
20210905,경원선,덕정,3089,3182,6271
20210905,경원선,덕계,1531,1499,3030
20210905,경원선,양주,4758,4642,9400
20210905,경원선,녹양,2507,2376,4883
20210905,경원선,가능,3646,3471,7117
20210905,경원선,의정부,12071,12262,24333
20210905,경원선,회룡,6783,6730,13513
20210905,경원선,망월사,4112,4197,8309
20210905,경원선,도봉산,8877,6225,15102
20210905,경원선,도봉,3217,3063,6280
20210905,경원선,방학,5353,5140,10493
20210905,경원선,녹천,2280,2052,4332
20210905,경원선,월계,3320,3150,6470
20210905,경원선,석계,4543,5054,9597
20210905,경원선,신이문,4220,3980,8200
20210905,경원선,청량리,13032,11846,24878
20210905,경원선,왕십리,8049,9522,17571
20210905,경원선,응봉,1048,949,1997
20210905,경원선,옥수,52,26,78
20210905,경원선,한남,1895,1939,3834
20210905,경원선,서빙고,1025,929,1954
20210905,경원선,이촌,2057,1614,3671
20210905,경원선,외대앞,4820,4788,9608
20210905,경원선,광운대,3872,3908,7780
20210911,경원선,이촌,3010,2210,5220
20210911,경원선,서빙고,1259,1178,2437
20210911,경원선,한남,2649,2437,5086
20210911,경원선,옥수,29,34,63
20210911,경원선,응봉,1742,1381,3123
20210911,경원선,왕십리,11052,13071,24123
20210911,경원선,청량리,15128,16486,31614
20210911,경원선,외대앞,5802,5662,11464
20210911,경원선,신이문,5677,5193,10870
20210911,경원선,석계,6409,6751,13160
20210911,경원선,광운대,5406,5229,10635
20210911,경원선,월계,4345,4215,8560
20210911,경원선,녹천,3169,2780,5949
20210911,경원선,방학,7117,6897,14014
20210911,경원선,도봉,4240,3978,8218
20210911,경원선,도봉산,8876,6096,14972
20210911,경원선,망월사,5804,5850,11654
20210911,경원선,회룡,9303,9362,18665
20210911,경원선,의정부,16070,16762,32832
20210911,경원선,가능,4999,4755,9754
20210911,경원선,녹양,3389,3268,6657
20210911,경원선,양주,6339,6137,12476
20210911,경원선,덕계,2271,2076,4347
20210911,경원선,덕정,4188,3951,8139
20210911,경원선,지행,5421,5478,10899
20210911,경원선,동두천중앙,2439,2440,4879
20210911,경원선,보산,1830,1767,3597
20210911,경원선,동두천,1557,2014,3571
20210911,경원선,소요산,4212,3616,7828
20210912,경원선,소요산,4109,3566,7675
20210912,경원선,동두천,1281,1585,2866
20210912,경원선,보산,1345,1413,2758
20210912,경원선,동두천중앙,2008,1866,3874
20210912,경원선,지행,4048,4138,8186
20210912,경원선,덕정,3136,3334,6470
20210912,경원선,덕계,1715,1595,3310
20210912,경원선,양주,4921,4832,9753
20210912,경원선,녹양,2562,2452,5014
20210912,경원선,가능,3810,3557,7367
20210912,경원선,의정부,12405,12534,24939
20210912,경원선,회룡,6882,6937,13819
20210912,경원선,망월사,4349,4420,8769
20210912,경원선,도봉산,8602,6267,14869
20210912,경원선,도봉,3298,3108,6406
20210912,경원선,방학,5346,5228,10574
20210912,경원선,창동,1,0,1
20210912,경원선,녹천,2320,2060,4380
20210912,경원선,월계,3634,3218,6852
20210912,경원선,광운대,3876,3953,7829
20210912,경원선,석계,4480,4949,9429
20210912,경원선,신이문,4453,4167,8620
20210912,경원선,외대앞,4433,4405,8838
20210912,경원선,청량리,12943,11945,24888
20210912,경원선,왕십리,7652,9137,16789
20210912,경원선,응봉,969,931,1900
20210912,경원선,옥수,50,26,76
20210912,경원선,한남,1784,1700,3484
20210912,경원선,서빙고,969,958,1927
20210912,경원선,이촌,2124,1612,3736
20210918,경원선,이촌,2835,1998,4833
20210918,경원선,서빙고,1192,1078,2270
20210918,경원선,한남,2603,2389,4992
20210918,경원선,옥수,21,20,41
20210918,경원선,응봉,1245,1052,2297
20210918,경원선,왕십리,10296,11154,21450
20210918,경원선,청량리,13219,14483,27702
20210918,경원선,외대앞,5377,4821,10198
20210918,경원선,신이문,5780,5277,11057
20210918,경원선,석계,6041,6248,12289
20210918,경원선,광운대,5194,4860,10054
20210918,경원선,월계,4405,3974,8379
20210918,경원선,녹천,3050,2555,5605
20210918,경원선,창동,1,0,1
20210918,경원선,방학,6951,6570,13521
20210918,경원선,도봉,4232,3938,8170
20210918,경원선,도봉산,8006,5533,13539
20210918,경원선,망월사,5189,5372,10561
20210918,경원선,회룡,8751,8841,17592
20210918,경원선,의정부,16011,16958,32969
20210918,경원선,가능,4753,4477,9230
20210918,경원선,녹양,3200,3146,6346
20210918,경원선,양주,5872,5863,11735
20210918,경원선,덕계,2001,1906,3907
20210918,경원선,덕정,4052,3755,7807
20210918,경원선,지행,4990,5125,10115
20210918,경원선,동두천중앙,2393,2395,4788
20210918,경원선,보산,2065,1727,3792
20210918,경원선,동두천,1525,2117,3642
20210918,경원선,소요산,3508,3180,6688
20210919,경원선,소요산,3306,3077,6383
20210919,경원선,동두천,1306,1728,3034
20210919,경원선,보산,1606,1622,3228
20210919,경원선,동두천중앙,2023,2081,4104
20210919,경원선,지행,3757,4004,7761
20210919,경원선,덕정,3216,2962,6178
20210919,경원선,덕계,1506,1449,2955
20210919,경원선,양주,4789,4758,9547
20210919,경원선,녹양,2351,2329,4680
20210919,경원선,가능,3688,3509,7197
20210919,경원선,의정부,13240,13744,26984
20210919,경원선,회룡,6289,6492,12781
20210919,경원선,망월사,3846,3993,7839
20210919,경원선,도봉산,7301,5113,12414
20210919,경원선,도봉,3317,3131,6448
20210919,경원선,방학,5416,5175,10591
20210919,경원선,녹천,2406,1856,4262
20210919,경원선,월계,3521,3127,6648
20210919,경원선,광운대,3967,3621,7588
20210919,경원선,석계,4566,4739,9305
20210919,경원선,신이문,4531,4066,8597
20210919,경원선,외대앞,4095,3660,7755
20210919,경원선,청량리,10736,11642,22378
20210919,경원선,왕십리,7303,8011,15314
20210919,경원선,응봉,965,816,1781
20210919,경원선,옥수,36,21,57
20210919,경원선,한남,1764,1678,3442
20210919,경원선,서빙고,995,874,1869
20210919,경원선,이촌,2022,1524,3546
20210925,경원선,창동,1,0,1
20210925,경원선,소요산,4298,3594,7892
20210925,경원선,동두천,1615,2183,3798
20210925,경원선,보산,1612,1516,3128
20210925,경원선,동두천중앙,2487,2533,5020
20210925,경원선,지행,4946,4936,9882
20210925,경원선,덕정,3902,3691,7593
20210925,경원선,덕계,2195,2087,4282
20210925,경원선,양주,6430,6111,12541
20210925,경원선,녹양,3344,3228,6572
20210925,경원선,가능,4815,4668,9483
20210925,경원선,의정부,15199,16158,31357
20210925,경원선,회룡,9016,9004,18020
20210925,경원선,망월사,5023,5194,10217
20210925,경원선,도봉산,9356,6745,16101
20210925,경원선,도봉,4334,4157,8491
20210925,경원선,방학,7005,6720,13725
20210925,경원선,녹천,3003,2531,5534
20210925,경원선,월계,4285,4075,8360
20210925,경원선,광운대,5084,4938,10022
20210925,경원선,석계,6157,6497,12654
20210925,경원선,신이문,5546,5103,10649
20210925,경원선,외대앞,5483,5430,10913
20210925,경원선,청량리,13498,14697,28195
20210925,경원선,왕십리,10428,12185,22613
20210925,경원선,응봉,1257,1091,2348
20210925,경원선,옥수,22,36,58
20210925,경원선,한남,2614,2434,5048
20210925,경원선,서빙고,1237,1140,2377
20210925,경원선,이촌,2903,2112,5015
20210926,경원선,소요산,4653,3993,8646
20210926,경원선,동두천,1358,1732,3090
20210926,경원선,보산,1232,1265,2497
20210926,경원선,동두천중앙,1893,1816,3709
20210926,경원선,지행,3768,3839,7607
20210926,경원선,덕정,2958,3181,6139
20210926,경원선,덕계,1585,1489,3074
20210926,경원선,양주,5074,4991,10065
20210926,경원선,녹양,2501,2424,4925
20210926,경원선,가능,3733,3544,7277
20210926,경원선,의정부,11886,12061,23947
20210926,경원선,회룡,6682,6701,13383
20210926,경원선,망월사,4233,4321,8554
20210926,경원선,도봉산,9387,6838,16225
20210926,경원선,도봉,3316,3059,6375
20210926,경원선,방학,5281,5092,10373
20210926,경원선,녹천,2590,2218,4808
20210926,경원선,월계,3165,2896,6061
20210926,경원선,광운대,3657,3725,7382
20210926,경원선,석계,4461,4825,9286
20210926,경원선,신이문,4216,4021,8237
20210926,경원선,외대앞,4110,4177,8287
20210926,경원선,청량리,11728,10818,22546
20210926,경원선,왕십리,7698,8696,16394
20210926,경원선,응봉,967,960,1927
20210926,경원선,옥수,72,31,103
20210926,경원선,한남,1785,1781,3566
20210926,경원선,서빙고,1021,1018,2039
20210926,경원선,이촌,2215,1592,3807
20210926,경원선,창동,1,0,1
20211002,경원선,이촌,3084,2076,5160
20211002,경원선,서빙고,1381,1314,2695
20211002,경원선,한남,2754,2574,5328
20211002,경원선,옥수,33,26,59
20211002,경원선,응봉,1382,1134,2516
20211002,경원선,왕십리,11082,12613,23695
20211002,경원선,청량리,14352,16014,30366
20211002,경원선,외대앞,5784,5502,11286
20211002,경원선,신이문,5794,5249,11043
20211002,경원선,석계,6534,6889,13423
20211002,경원선,광운대,5336,5124,10460
20211002,경원선,월계,4345,4042,8387
20211002,경원선,녹천,3252,2660,5912
20211002,경원선,방학,7064,6861,13925
20211002,경원선,도봉,4271,3990,8261
20211002,경원선,도봉산,9050,6481,15531
20211002,경원선,망월사,5302,5539,10841
20211002,경원선,회룡,9197,9152,18349
20211002,경원선,의정부,15451,16188,31639
20211002,경원선,가능,4835,4615,9450
20211002,경원선,녹양,3376,3324,6700
20211002,경원선,양주,6614,6477,13091
20211002,경원선,덕계,2304,2040,4344
20211002,경원선,덕정,4118,3906,8024
20211002,경원선,지행,5241,5151,10392
20211002,경원선,동두천중앙,2427,2440,4867
20211002,경원선,보산,1657,1535,3192
20211002,경원선,동두천,1574,2254,3828
20211002,경원선,소요산,4316,3629,7945
20211003,경원선,보산,1163,1299,2462
20211003,경원선,동두천,1419,1811,3230
20211003,경원선,소요산,4857,4187,9044
20211003,경원선,도봉산,9810,7204,17014
20211003,경원선,이촌,2438,1699,4137
20211003,경원선,서빙고,1131,1132,2263
20211003,경원선,한남,1964,1967,3931
20211003,경원선,옥수,50,35,85
20211003,경원선,응봉,1134,960,2094
20211003,경원선,왕십리,8397,9632,18029
20211003,경원선,청량리,12832,12650,25482
20211003,경원선,외대앞,4473,4408,8881
20211003,경원선,신이문,4408,4170,8578
20211003,경원선,석계,4907,5205,10112
20211003,경원선,광운대,4117,4101,8218
20211003,경원선,월계,3644,3440,7084
20211003,경원선,녹천,2444,2053,4497
20211003,경원선,방학,5669,5363,11032
20211003,경원선,도봉,3457,3276,6733
20211003,경원선,망월사,4243,4432,8675
20211003,경원선,회룡,7059,7058,14117
20211003,경원선,의정부,12921,13311,26232
20211003,경원선,가능,3908,3722,7630
20211003,경원선,녹양,2561,2474,5035
20211003,경원선,양주,5638,5581,11219
20211003,경원선,덕계,1634,1572,3206
20211003,경원선,덕정,3152,3242,6394
20211003,경원선,지행,3932,4036,7968
20211003,경원선,동두천중앙,1971,1886,3857
20211009,경원선,창동,1,0,1
20211009,경원선,동두천,1480,1943,3423
20211009,경원선,이촌,2723,1924,4647
20211009,경원선,서빙고,1349,1196,2545
20211009,경원선,한남,2557,2289,4846
20211009,경원선,옥수,49,41,90
20211009,경원선,응봉,1472,1122,2594
20211009,경원선,왕십리,10773,12324,23097
20211009,경원선,청량리,14988,16421,31409
20211009,경원선,외대앞,5075,4826,9901
20211009,경원선,신이문,5662,5083,10745
20211009,경원선,석계,6191,6448,12639
20211009,경원선,광운대,5063,4809,9872
20211009,경원선,월계,4159,3844,8003
20211009,경원선,녹천,3002,2522,5524
20211009,경원선,방학,6641,6385,13026
20211009,경원선,도봉,4205,3860,8065
20211009,경원선,도봉산,8515,6023,14538
20211009,경원선,망월사,4894,5087,9981
20211009,경원선,회룡,8692,8552,17244
20211009,경원선,의정부,15251,16000,31251
20211009,경원선,가능,4609,4428,9037
20211009,경원선,녹양,3128,3077,6205
20211009,경원선,양주,6301,6066,12367
20211009,경원선,덕계,2203,2066,4269
20211009,경원선,덕정,3833,3652,7485
20211009,경원선,지행,4741,4906,9647
20211009,경원선,동두천중앙,2226,2246,4472
20211009,경원선,보산,1825,1577,3402
20211009,경원선,소요산,4054,3632,7686
20211010,경원선,소요산,3258,2802,6060
20211010,경원선,동두천,1155,1430,2585
20211010,경원선,보산,1232,1221,2453
20211010,경원선,동두천중앙,1833,1830,3663
20211010,경원선,지행,3538,3462,7000
20211010,경원선,덕정,2733,2826,5559
20211010,경원선,덕계,1450,1410,2860
20211010,경원선,양주,4662,4616,9278
20211010,경원선,녹양,2244,2240,4484
20211010,경원선,가능,3560,3379,6939
20211010,경원선,의정부,11568,12043,23611
20211010,경원선,회룡,6169,6204,12373
20211010,경원선,망월사,3806,3918,7724
20211010,경원선,도봉산,6491,4628,11119
20211010,경원선,도봉,3065,2881,5946
20211010,경원선,방학,4925,4889,9814
20211010,경원선,녹천,2159,1885,4044
20211010,경원선,월계,2979,2670,5649
20211010,경원선,광운대,3566,3636,7202
20211010,경원선,석계,4348,4595,8943
20211010,경원선,신이문,4039,3796,7835
20211010,경원선,외대앞,4045,4044,8089
20211010,경원선,청량리,12514,12065,24579
20211010,경원선,왕십리,7801,9002,16803
20211010,경원선,응봉,880,830,1710
20211010,경원선,옥수,65,42,107
20211010,경원선,한남,1660,1683,3343
20211010,경원선,서빙고,921,914,1835
20211010,경원선,이촌,1788,1483,3271
20211016,경원선,이촌,2819,2236,5055
20211016,경원선,서빙고,1402,1591,2993
20211016,경원선,한남,2668,2495,5163
20211016,경원선,옥수,26,31,57
20211016,경원선,응봉,1367,1212,2579
20211016,경원선,왕십리,12001,13489,25490
20211016,경원선,청량리,15199,16505,31704
20211016,경원선,외대앞,5569,5526,11095
20211016,경원선,신이문,6055,5568,11623
20211016,경원선,석계,6540,7012,13552
20211016,경원선,광운대,5291,5174,10465
20211016,경원선,월계,4603,4204,8807
20211016,경원선,녹천,3355,2758,6113
20211016,경원선,방학,7315,7110,14425
20211016,경원선,도봉,4470,4284,8754
20211016,경원선,도봉산,9719,6726,16445
20211016,경원선,망월사,6858,6913,13771
20211016,경원선,회룡,9613,9456,19069
20211016,경원선,의정부,17023,17916,34939
20211016,경원선,가능,5234,4907,10141
20211016,경원선,녹양,3552,3473,7025
20211016,경원선,양주,6709,6476,13185
20211016,경원선,덕계,2413,2173,4586
20211016,경원선,덕정,4410,4061,8471
20211016,경원선,지행,5471,5308,10779
20211016,경원선,동두천중앙,2544,2621,5165
20211016,경원선,보산,2010,1874,3884
20211016,경원선,동두천,1583,2206,3789
20211016,경원선,소요산,4224,3803,8027
20211017,경원선,이촌,1818,1524,3342
20211017,경원선,서빙고,989,1107,2096
20211017,경원선,한남,1783,1744,3527
20211017,경원선,옥수,45,21,66
20211017,경원선,응봉,971,885,1856
20211017,경원선,왕십리,8548,9604,18152
20211017,경원선,청량리,13068,12132,25200
20211017,경원선,외대앞,4238,4138,8376
20211017,경원선,신이문,4343,4056,8399
20211017,경원선,석계,4569,5018,9587
20211017,경원선,광운대,3772,3800,7572
20211017,경원선,월계,3256,3154,6410
20211017,경원선,녹천,2214,1971,4185
20211017,경원선,방학,5375,5213,10588
20211017,경원선,도봉,3252,3075,6327
20211017,경원선,도봉산,8436,6002,14438
20211017,경원선,망월사,5193,5118,10311
20211017,경원선,회룡,6673,6674,13347
20211017,경원선,의정부,12768,13077,25845
20211017,경원선,가능,3716,3584,7300
20211017,경원선,녹양,2554,2390,4944
20211017,경원선,양주,4962,4815,9777
20211017,경원선,덕계,1557,1550,3107
20211017,경원선,덕정,3139,3391,6530
20211017,경원선,지행,3947,3992,7939
20211017,경원선,동두천중앙,1889,1849,3738
20211017,경원선,보산,1315,1511,2826
20211017,경원선,동두천,1255,1568,2823
20211017,경원선,소요산,3808,3266,7074
20211023,경원선,소요산,5474,4865,10339
20211023,경원선,동두천,1584,2190,3774
20211023,경원선,보산,1988,1937,3925
20211023,경원선,동두천중앙,2634,2633,5267
20211023,경원선,지행,5735,5734,11469
20211023,경원선,덕정,4387,4189,8576
20211023,경원선,덕계,2487,2296,4783
20211023,경원선,양주,6776,6448,13224
20211023,경원선,녹양,3540,3471,7011
20211023,경원선,가능,5322,5111,10433
20211023,경원선,의정부,17978,18783,36761
20211023,경원선,회룡,10064,10182,20246
20211023,경원선,망월사,6704,6860,13564
20211023,경원선,도봉산,10572,7193,17765
20211023,경원선,도봉,4598,4397,8995
20211023,경원선,방학,7742,7373,15115
20211023,경원선,녹천,3371,2781,6152
20211023,경원선,월계,4822,4451,9273
20211023,경원선,광운대,5687,5501,11188
20211023,경원선,석계,6813,7277,14090
20211023,경원선,신이문,6123,5609,11732
20211023,경원선,외대앞,6188,5786,11974
20211023,경원선,청량리,16382,17740,34122
20211023,경원선,왕십리,12319,13956,26275
20211023,경원선,응봉,1456,1253,2709
20211023,경원선,옥수,50,38,88
20211023,경원선,한남,2711,2674,5385
20211023,경원선,서빙고,1950,2489,4439
20211023,경원선,이촌,3116,2246,5362
20211024,경원선,소요산,5848,5159,11007
20211024,경원선,동두천,1406,1772,3178
20211024,경원선,보산,1416,1564,2980
20211024,경원선,동두천중앙,2180,2020,4200
20211024,경원선,지행,4401,4357,8758
20211024,경원선,덕정,3366,3400,6766
20211024,경원선,덕계,1737,1710,3447
20211024,경원선,양주,5258,5116,10374
20211024,경원선,녹양,2758,2696,5454
20211024,경원선,가능,4181,3806,7987
20211024,경원선,의정부,13686,13920,27606
20211024,경원선,회룡,7450,7506,14956
20211024,경원선,망월사,5224,5369,10593
20211024,경원선,도봉산,10540,7733,18273
20211024,경원선,도봉,3558,3304,6862
20211024,경원선,방학,5710,5492,11202
20211024,경원선,녹천,2565,2185,4750
20211024,경원선,이촌,2173,1651,3824
20211024,경원선,서빙고,1179,1279,2458
20211024,경원선,한남,1861,1857,3718
20211024,경원선,옥수,47,25,72
20211024,경원선,응봉,1082,994,2076
20211024,경원선,왕십리,8480,9775,18255
20211024,경원선,청량리,13895,13148,27043
20211024,경원선,외대앞,4396,4255,8651
20211024,경원선,신이문,4612,4401,9013
20211024,경원선,월계,3565,3333,6898
20211024,경원선,석계,4866,5360,10226
20211024,경원선,광운대,4039,4215,8254
20211030,경원선,소요산,6410,5978,12388
20211030,경원선,동두천,1817,2294,4111
20211030,경원선,보산,2103,1889,3992
20211030,경원선,동두천중앙,3036,3028,6064
20211030,경원선,지행,5773,5670,11443
20211030,경원선,덕계,2502,2264,4766
20211030,경원선,양주,6757,6582,13339
20211030,경원선,녹양,3627,3423,7050
20211030,경원선,가능,5233,5001,10234
20211030,경원선,의정부,17409,18581,35990
20211030,경원선,회룡,10107,10227,20334
20211030,경원선,망월사,6009,6212,12221
20211030,경원선,도봉산,10944,7658,18602
20211030,경원선,도봉,4704,4431,9135
20211030,경원선,방학,7693,7409,15102
20211030,경원선,녹천,3312,2771,6083
20211030,경원선,월계,5317,4736,10053
20211030,경원선,광운대,5776,5654,11430
20211030,경원선,석계,7011,7440,14451
20211030,경원선,신이문,6148,5623,11771
20211030,경원선,외대앞,6125,5871,11996
20211030,경원선,청량리,16839,17593,34432
20211030,경원선,왕십리,13274,14632,27906
20211030,경원선,응봉,1572,1347,2919
20211030,경원선,옥수,36,32,68
20211030,경원선,한남,2888,2667,5555
20211030,경원선,서빙고,1960,2495,4455
20211030,경원선,이촌,3126,2300,5426
20211030,경원선,덕정,4579,4302,8881
20211031,경원선,소요산,7960,7218,15178
20211031,경원선,동두천,1375,1724,3099
20211031,경원선,보산,1531,1714,3245
20211031,경원선,동두천중앙,2190,2121,4311
20211031,경원선,지행,4609,4528,9137
20211031,경원선,덕정,3519,3584,7103
20211031,경원선,덕계,1907,1806,3713
20211031,경원선,양주,5477,5373,10850
20211031,경원선,녹양,2742,2660,5402
20211031,경원선,가능,4160,3979,8139
20211031,경원선,의정부,14446,14461,28907
20211031,경원선,회룡,7775,7875,15650
20211031,경원선,망월사,4771,5118,9889
20211031,경원선,도봉산,11472,8230,19702
20211031,경원선,도봉,3849,3592,7441
20211031,경원선,방학,5982,5832,11814
20211031,경원선,녹천,2709,2261,4970
20211031,경원선,월계,3869,3673,7542
20211031,경원선,광운대,4394,4482,8876
20211031,경원선,석계,5175,5582,10757
20211031,경원선,신이문,4774,4611,9385
20211031,경원선,외대앞,5271,5112,10383
20211031,경원선,청량리,14564,14104,28668
20211031,경원선,왕십리,10046,11404,21450
20211031,경원선,응봉,1092,1025,2117
20211031,경원선,옥수,52,22,74
20211031,경원선,한남,1867,1973,3840
20211031,경원선,서빙고,1216,1272,2488
20211031,경원선,이촌,2217,1747,3964
20211106,경원선,이촌,3260,2323,5583
20211106,경원선,서빙고,2190,2806,4996
20211106,경원선,한남,2712,2713,5425
20211106,경원선,옥수,41,37,78
20211106,경원선,응봉,1551,1334,2885
20211106,경원선,왕십리,13350,15012,28362
20211106,경원선,청량리,17545,18469,36014
20211106,경원선,외대앞,6904,6385,13289
20211106,경원선,신이문,6515,5928,12443
20211106,경원선,석계,7201,7800,15001
20211106,경원선,광운대,6544,6228,12772
20211106,경원선,월계,5101,4772,9873
20211106,경원선,녹천,3618,3003,6621
20211106,경원선,방학,7954,7570,15524
20211106,경원선,도봉,4853,4483,9336
20211106,경원선,도봉산,11384,7956,19340
20211106,경원선,망월사,5867,6080,11947
20211106,경원선,회룡,10435,10242,20677
20211106,경원선,의정부,18317,19761,38078
20211106,경원선,가능,5501,5133,10634
20211106,경원선,녹양,4006,3701,7707
20211106,경원선,양주,6892,6522,13414
20211106,경원선,덕계,2636,2362,4998
20211106,경원선,덕정,4763,4450,9213
20211106,경원선,지행,6003,6021,12024
20211106,경원선,동두천중앙,2824,2823,5647
20211106,경원선,보산,1939,1832,3771
20211106,경원선,동두천,1685,2224,3909
20211106,경원선,소요산,7415,6764,14179
20211107,경원선,소요산,8061,7065,15126
20211107,경원선,동두천,1422,1934,3356
20211107,경원선,보산,1417,1559,2976
20211107,경원선,동두천중앙,2316,2153,4469
20211107,경원선,지행,4559,4574,9133
20211107,경원선,덕정,3721,3788,7509
20211107,경원선,덕계,1899,1880,3779
20211107,경원선,양주,5627,5351,10978
20211107,경원선,녹양,2813,2732,5545
20211107,경원선,가능,4320,4202,8522
20211107,경원선,의정부,14259,14361,28620
20211107,경원선,회룡,7918,7849,15767
20211107,경원선,망월사,4828,5139,9967
20211107,경원선,도봉산,11433,8223,19656
20211107,경원선,도봉,3710,3566,7276
20211107,경원선,방학,6249,5963,12212
20211107,경원선,녹천,2700,2342,5042
20211107,경원선,월계,4035,3797,7832
20211107,경원선,광운대,4889,4960,9849
20211107,경원선,석계,5269,5782,11051
20211107,경원선,신이문,4865,4526,9391
20211107,경원선,외대앞,4959,4933,9892
20211107,경원선,청량리,15508,14669,30177
20211107,경원선,왕십리,10677,12114,22791
20211107,경원선,응봉,1236,1153,2389
20211107,경원선,옥수,58,29,87
20211107,경원선,한남,2000,1999,3999
20211107,경원선,서빙고,1444,1588,3032
20211107,경원선,이촌,2446,1890,4336
20211107,경원선,창동,1,0,1
20211113,경원선,소요산,4317,3822,8139
20211113,경원선,동두천,1610,2088,3698
20211113,경원선,보산,1886,1795,3681
20211113,경원선,동두천중앙,2748,2680,5428
20211113,경원선,지행,5639,5659,11298
20211113,경원선,덕정,4612,4272,8884
20211113,경원선,덕계,2416,2247,4663
20211113,경원선,양주,6686,6196,12882
20211113,경원선,녹양,3625,3395,7020
20211113,경원선,가능,5132,4906,10038
20211113,경원선,의정부,17747,18959,36706
20211113,경원선,회룡,10025,9895,19920
20211113,경원선,망월사,6104,6122,12226
20211113,경원선,도봉산,9527,6449,15976
20211113,경원선,도봉,4617,4163,8780
20211113,경원선,방학,7509,7142,14651
20211113,경원선,녹천,3442,2848,6290
20211113,경원선,월계,4944,4463,9407
20211113,경원선,광운대,5723,5689,11412
20211113,경원선,석계,7264,7515,14779
20211113,경원선,신이문,6347,5736,12083
20211113,경원선,외대앞,6764,6258,13022
20211113,경원선,청량리,17143,18209,35352
20211113,경원선,왕십리,12769,14693,27462
20211113,경원선,응봉,1477,1286,2763
20211113,경원선,옥수,28,33,61
20211113,경원선,한남,2656,2674,5330
20211113,경원선,서빙고,1952,2432,4384
20211113,경원선,이촌,2961,2119,5080
20211114,경원선,소요산,4668,4066,8734
20211114,경원선,동두천,1372,1682,3054
20211114,경원선,보산,1299,1623,2922
20211114,경원선,동두천중앙,2108,2054,4162
20211114,경원선,지행,4430,4520,8950
20211114,경원선,덕정,3396,3592,6988
20211114,경원선,덕계,1820,1729,3549
20211114,경원선,양주,5258,5302,10560
20211114,경원선,녹양,2687,2452,5139
20211114,경원선,가능,3922,3767,7689
20211114,경원선,의정부,14086,14310,28396
20211114,경원선,회룡,7551,7595,15146
20211114,경원선,망월사,4971,5052,10023
20211114,경원선,도봉산,9406,6727,16133
20211114,경원선,도봉,3597,3419,7016
20211114,경원선,방학,5926,5728,11654
20211114,경원선,녹천,2616,2316,4932
20211114,경원선,월계,3921,3676,7597
20211114,경원선,광운대,4359,4407,8766
20211114,경원선,석계,5166,5725,10891
20211114,경원선,신이문,4756,4498,9254
20211114,경원선,외대앞,5267,5158,10425
20211114,경원선,청량리,14080,13106,27186
20211114,경원선,왕십리,9556,10767,20323
20211114,경원선,응봉,1094,1011,2105
20211114,경원선,옥수,66,32,98
20211114,경원선,한남,1908,1823,3731
20211114,경원선,서빙고,1380,1428,2808
20211114,경원선,이촌,2150,1703,3853
20211120,경원선,보산,1913,1740,3653
20211120,경원선,동두천,1663,2192,3855
20211120,경원선,소요산,4010,3322,7332
20211120,경원선,동두천중앙,2794,2755,5549
20211120,경원선,지행,5745,5685,11430
20211120,경원선,덕정,4540,4203,8743
20211120,경원선,덕계,2585,2296,4881
20211120,경원선,양주,6711,6175,12886
20211120,경원선,녹양,3645,3505,7150
20211120,경원선,가능,5214,4927,10141
20211120,경원선,의정부,17703,19186,36889
20211120,경원선,회룡,9813,9606,19419
20211120,경원선,망월사,5780,5807,11587
20211120,경원선,도봉산,8777,6101,14878
20211120,경원선,도봉,4471,4227,8698
20211120,경원선,방학,7379,7168,14547
20211120,경원선,녹천,3351,2757,6108
20211120,경원선,월계,4799,4466,9265
20211120,경원선,광운대,5597,5451,11048
20211120,경원선,석계,6854,7343,14197
20211120,경원선,신이문,6279,5619,11898
20211120,경원선,외대앞,6850,6399,13249
20211120,경원선,청량리,16858,17322,34180
20211120,경원선,왕십리,12756,14601,27357
20211120,경원선,응봉,1432,1253,2685
20211120,경원선,옥수,56,47,103
20211120,경원선,한남,2845,2813,5658
20211120,경원선,서빙고,1889,2114,4003
20211120,경원선,이촌,2894,2183,5077
20211121,경원선,이촌,2025,1637,3662
20211121,경원선,서빙고,1332,1378,2710
20211121,경원선,한남,1954,1947,3901
20211121,경원선,옥수,56,31,87
20211121,경원선,응봉,928,912,1840
20211121,경원선,왕십리,10174,11457,21631
20211121,경원선,청량리,14459,13401,27860
20211121,경원선,외대앞,6047,5557,11604
20211121,경원선,신이문,4599,4389,8988
20211121,경원선,석계,5041,5498,10539
20211121,경원선,광운대,4027,4248,8275
20211121,경원선,월계,3630,3385,7015
20211121,경원선,녹천,2504,2225,4729
20211121,경원선,방학,5582,5430,11012
20211121,경원선,도봉,3330,3105,6435
20211121,경원선,도봉산,7787,5396,13183
20211121,경원선,망월사,4362,4513,8875
20211121,경원선,회룡,7241,7169,14410
20211121,경원선,의정부,13696,13783,27479
20211121,경원선,가능,3867,3658,7525
20211121,경원선,녹양,2744,2643,5387
20211121,경원선,양주,4922,4901,9823
20211121,경원선,덕계,1735,1650,3385
20211121,경원선,덕정,3226,3405,6631
20211121,경원선,지행,4222,4248,8470
20211121,경원선,동두천중앙,1970,1897,3867
20211121,경원선,보산,1283,1515,2798
20211121,경원선,동두천,1274,1645,2919
20211121,경원선,소요산,3445,2878,6323
20211127,경원선,이촌,2796,2143,4939
20211127,경원선,서빙고,1794,2048,3842
20211127,경원선,한남,2716,2735,5451
20211127,경원선,옥수,41,33,74
20211127,경원선,응봉,1594,1346,2940
20211127,경원선,왕십리,13288,14400,27688
20211127,경원선,청량리,16567,17418,33985
20211127,경원선,외대앞,9458,8951,18409
20211127,경원선,신이문,6324,5739,12063
20211127,경원선,석계,6975,7282,14257
20211127,경원선,광운대,6659,6386,13045
20211127,경원선,월계,4700,4342,9042
20211127,경원선,녹천,3136,2640,5776
20211127,경원선,방학,7380,7085,14465
20211127,경원선,도봉,4473,4086,8559
20211127,경원선,도봉산,8613,5873,14486
20211127,경원선,망월사,5605,5682,11287
20211127,경원선,회룡,9656,9513,19169
20211127,경원선,의정부,17729,18697,36426
20211127,경원선,가능,5276,4955,10231
20211127,경원선,녹양,3501,3394,6895
20211127,경원선,양주,6507,6078,12585
20211127,경원선,덕계,2516,2253,4769
20211127,경원선,덕정,4685,4272,8957
20211127,경원선,지행,5581,5548,11129
20211127,경원선,동두천중앙,2526,2465,4991
20211127,경원선,보산,1690,1663,3353
20211127,경원선,동두천,1572,2015,3587
20211127,경원선,소요산,3535,3014,6549
20211128,경원선,창동,1,0,1
20211128,경원선,이촌,2069,1688,3757
20211128,경원선,서빙고,1361,1462,2823
20211128,경원선,한남,1942,1931,3873
20211128,경원선,옥수,63,20,83
20211128,경원선,응봉,1057,1037,2094
20211128,경원선,왕십리,10376,10907,21283
20211128,경원선,청량리,14367,13090,27457
20211128,경원선,외대앞,9423,8549,17972
20211128,경원선,신이문,5045,4587,9632
20211128,경원선,석계,4990,5620,10610
20211128,경원선,광운대,5561,5269,10830
20211128,경원선,월계,3691,3362,7053
20211128,경원선,녹천,2625,2326,4951
20211128,경원선,방학,5703,5620,11323
20211128,경원선,도봉,3420,3269,6689
20211128,경원선,도봉산,8779,6298,15077
20211128,경원선,망월사,4382,4646,9028
20211128,경원선,회룡,7436,7318,14754
20211128,경원선,의정부,13421,13911,27332
20211128,경원선,가능,3850,3699,7549
20211128,경원선,녹양,2797,2688,5485
20211128,경원선,양주,4945,4838,9783
20211128,경원선,덕계,1715,1666,3381
20211128,경원선,덕정,3243,3370,6613
20211128,경원선,지행,4220,4281,8501
20211128,경원선,동두천중앙,2067,1949,4016
20211128,경원선,보산,1244,1527,2771
20211128,경원선,동두천,1298,1753,3051
20211128,경원선,소요산,3862,3219,7081
20211204,경원선,이촌,2692,1948,4640
20211204,경원선,서빙고,1504,1588,3092
20211204,경원선,한남,2660,2661,5321
20211204,경원선,옥수,34,47,81
20211204,경원선,응봉,1334,1077,2411
20211204,경원선,왕십리,11813,13280,25093
20211204,경원선,청량리,14650,15963,30613
20211204,경원선,외대앞,6057,5827,11884
20211204,경원선,신이문,5908,5308,11216
20211204,경원선,석계,6505,6971,13476
20211204,경원선,광운대,5641,5575,11216
20211204,경원선,월계,4587,4202,8789
20211204,경원선,녹천,3148,2651,5799
20211204,경원선,방학,7011,6754,13765
20211204,경원선,도봉,4331,4150,8481
20211204,경원선,도봉산,8282,5532,13814
20211204,경원선,망월사,5412,5524,10936
20211204,경원선,회룡,9347,9075,18422
20211204,경원선,의정부,16744,17814,34558
20211204,경원선,가능,4731,4540,9271
20211204,경원선,녹양,3365,3158,6523
20211204,경원선,양주,6042,5570,11612
20211204,경원선,덕계,2277,2063,4340
20211204,경원선,덕정,4322,3867,8189
20211204,경원선,지행,5229,5189,10418
20211204,경원선,동두천중앙,2415,2403,4818
20211204,경원선,보산,1622,1578,3200
20211204,경원선,동두천,1555,1833,3388
20211204,경원선,소요산,3016,2658,5674
20211205,경원선,이촌,1953,1564,3517
20211205,경원선,서빙고,1177,1282,2459
20211205,경원선,한남,1733,1728,3461
20211205,경원선,옥수,46,14,60
20211205,경원선,응봉,944,880,1824
20211205,경원선,왕십리,9025,10285,19310
20211205,경원선,청량리,13355,12174,25529
20211205,경원선,외대앞,4546,4502,9048
20211205,경원선,신이문,4374,4052,8426
20211205,경원선,석계,4637,5075,9712
20211205,경원선,광운대,3980,4148,8128
20211205,경원선,월계,3762,3491,7253
20211205,경원선,녹천,2353,2087,4440
20211205,경원선,방학,5483,5350,10833
20211205,경원선,도봉,3291,3048,6339
20211205,경원선,도봉산,8023,5667,13690
20211205,경원선,망월사,4150,4261,8411
20211205,경원선,회룡,6936,7087,14023
20211205,경원선,의정부,12928,13101,26029
20211205,경원선,가능,3789,3571,7360
20211205,경원선,녹양,2497,2305,4802
20211205,경원선,양주,4649,4666,9315
20211205,경원선,덕계,1646,1589,3235
20211205,경원선,덕정,3112,3221,6333
20211205,경원선,지행,3972,4006,7978
20211205,경원선,동두천중앙,2124,2081,4205
20211205,경원선,보산,1252,1338,2590
20211205,경원선,동두천,1221,1519,2740
20211205,경원선,소요산,3250,2732,5982
20211211,경원선,이촌,2586,1897,4483
20211211,경원선,서빙고,1381,1233,2614
20211211,경원선,한남,2537,2525,5062
20211211,경원선,옥수,42,26,68
20211211,경원선,응봉,1240,1068,2308
20211211,경원선,왕십리,11047,12573,23620
20211211,경원선,청량리,14106,15272,29378
20211211,경원선,외대앞,5513,5274,10787
20211211,경원선,신이문,5736,5210,10946
20211211,경원선,석계,6203,6618,12821
20211211,경원선,광운대,5056,5078,10134
20211211,경원선,월계,4497,4045,8542
20211211,경원선,녹천,2992,2479,5471
20211211,경원선,방학,6948,6672,13620
20211211,경원선,도봉,4173,3903,8076
20211211,경원선,도봉산,7834,5266,13100
20211211,경원선,망월사,5213,5236,10449
20211211,경원선,회룡,8724,8650,17374
20211211,경원선,의정부,16405,17363,33768
20211211,경원선,가능,4964,4745,9709
20211211,경원선,녹양,3337,3167,6504
20211211,경원선,양주,5781,5425,11206
20211211,경원선,덕계,2212,2003,4215
20211211,경원선,덕정,4266,3943,8209
20211211,경원선,지행,5142,4990,10132
20211211,경원선,동두천중앙,2398,2350,4748
20211211,경원선,보산,1523,1468,2991
20211211,경원선,동두천,1556,1852,3408
20211211,경원선,소요산,3140,2741,5881
20211211,경원선,창동,1,0,1
20211212,경원선,이촌,1822,1446,3268
20211212,경원선,서빙고,1155,1039,2194
20211212,경원선,한남,1575,1740,3315
20211212,경원선,옥수,44,28,72
20211212,경원선,응봉,842,814,1656
20211212,경원선,도봉산,7758,5409,13167
20211212,경원선,왕십리,8298,9031,17329
20211212,경원선,청량리,12944,11198,24142
20211212,경원선,광운대,3405,3648,7053
20211212,경원선,월계,3132,2945,6077
20211212,경원선,녹천,2172,1876,4048
20211212,경원선,방학,5350,5095,10445
20211212,경원선,도봉,3155,3053,6208
20211212,경원선,망월사,3976,4172,8148
20211212,경원선,회룡,6676,6615,13291
20211212,경원선,의정부,12921,13056,25977
20211212,경원선,가능,3525,3359,6884
20211212,경원선,녹양,2433,2293,4726
20211212,경원선,양주,4492,4365,8857
20211212,경원선,덕계,1487,1434,2921
20211212,경원선,덕정,3026,3122,6148
20211212,경원선,지행,4032,4006,8038
20211212,경원선,동두천중앙,1903,1815,3718
20211212,경원선,보산,1229,1247,2476
20211212,경원선,동두천,1232,1535,2767
20211212,경원선,소요산,3095,2572,5667
20211212,경원선,외대앞,3975,3853,7828
20211212,경원선,신이문,4093,3997,8090
20211212,경원선,석계,4434,4762,9196
20211218,경원선,월계,3933,3740,7673
20211218,경원선,소요산,1991,1746,3737
20211218,경원선,동두천,1290,1535,2825
20211218,경원선,보산,1682,1666,3348
20211218,경원선,동두천중앙,2092,2154,4246
20211218,경원선,지행,4904,5017,9921
20211218,경원선,덕정,3919,3762,7681
20211218,경원선,덕계,2089,1897,3986
20211218,경원선,양주,5347,5288,10635
20211218,경원선,녹양,2997,2989,5986
20211218,경원선,가능,4428,4344,8772
20211218,경원선,의정부,16972,17384,34356
20211218,경원선,회룡,8225,8125,16350
20211218,경원선,망월사,4717,5046,9763
20211218,경원선,도봉산,5736,3878,9614
20211218,경원선,도봉,3819,3649,7468
20211218,경원선,방학,6269,6316,12585
20211218,경원선,창동,1,0,1
20211218,경원선,녹천,2831,2387,5218
20211218,경원선,광운대,4815,4795,9610
20211218,경원선,석계,5540,6148,11688
20211218,경원선,신이문,5376,5056,10432
20211218,경원선,외대앞,5341,5199,10540
20211218,경원선,청량리,14261,15346,29607
20211218,경원선,왕십리,11697,13403,25100
20211218,경원선,응봉,1146,1008,2154
20211218,경원선,옥수,33,31,64
20211218,경원선,한남,2617,2370,4987
20211218,경원선,서빙고,1324,1261,2585
20211218,경원선,이촌,2562,2023,4585
20211219,경원선,이촌,1882,1474,3356
20211219,경원선,서빙고,1134,1213,2347
20211219,경원선,한남,1848,1831,3679
20211219,경원선,옥수,48,20,68
20211219,경원선,응봉,935,856,1791
20211219,경원선,왕십리,9361,10385,19746
20211219,경원선,청량리,13251,12022,25273
20211219,경원선,외대앞,4143,3998,8141
20211219,경원선,신이문,4169,3874,8043
20211219,경원선,석계,4298,4705,9003
20211219,경원선,광운대,3668,3817,7485
20211219,경원선,월계,3356,3199,6555
20211219,경원선,녹천,2177,1967,4144
20211219,경원선,방학,5156,5058,10214
20211219,경원선,도봉,3009,2854,5863
20211219,경원선,도봉산,5905,4460,10365
20211219,경원선,망월사,4047,4105,8152
20211219,경원선,회룡,6449,6362,12811
20211219,경원선,의정부,13405,13574,26979
20211219,경원선,가능,3626,3325,6951
20211219,경원선,녹양,2747,2567,5314
20211219,경원선,양주,4223,4110,8333
20211219,경원선,덕계,1480,1419,2899
20211219,경원선,덕정,2957,3123,6080
20211219,경원선,지행,3997,3965,7962
20211219,경원선,동두천중앙,1789,1684,3473
20211219,경원선,보산,1315,1517,2832
20211219,경원선,동두천,1056,1317,2373
20211219,경원선,소요산,2659,2206,4865
20211225,경원선,이촌,1814,1432,3246
20211225,경원선,창동,1,0,1
20211225,경원선,동두천,1167,1410,2577
20211225,경원선,소요산,1939,1551,3490
20211225,경원선,보산,1086,1152,2238
20211225,경원선,동두천중앙,1958,1950,3908
20211225,경원선,지행,4364,4444,8808
20211225,경원선,덕정,3294,3152,6446
20211225,경원선,덕계,1661,1535,3196
20211225,경원선,양주,4756,4454,9210
20211225,경원선,녹양,2519,2420,4939
20211225,경원선,가능,3607,3578,7185
20211225,경원선,의정부,15537,15921,31458
20211225,경원선,회룡,6949,7037,13986
20211225,경원선,망월사,4060,4086,8146
20211225,경원선,도봉산,5165,3339,8504
20211225,경원선,도봉,3143,3082,6225
20211225,경원선,방학,5419,5275,10694
20211225,경원선,녹천,2140,1879,4019
20211225,경원선,월계,3374,3177,6551
20211225,경원선,광운대,4282,4346,8628
20211225,경원선,석계,4886,5065,9951
20211225,경원선,신이문,4535,4241,8776
20211225,경원선,외대앞,5074,4868,9942
20211225,경원선,청량리,12498,13427,25925
20211225,경원선,왕십리,10767,11877,22644
20211225,경원선,응봉,847,738,1585
20211225,경원선,옥수,24,36,60
20211225,경원선,한남,1873,1955,3828
20211225,경원선,서빙고,1088,1137,2225
20211226,경원선,소요산,1667,1373,3040
20211226,경원선,동두천,981,1204,2185
20211226,경원선,보산,1045,1009,2054
20211226,경원선,동두천중앙,1507,1448,2955
20211226,경원선,지행,3327,3280,6607
20211226,경원선,덕정,2464,2715,5179
20211226,경원선,덕계,1236,1243,2479
20211226,경원선,양주,3560,3664,7224
20211226,경원선,녹양,2098,1969,4067
20211226,경원선,가능,2789,2729,5518
20211226,경원선,의정부,11757,11495,23252
20211226,경원선,회룡,5307,5233,10540
20211226,경원선,망월사,3390,3439,6829
20211226,경원선,도봉산,4614,3202,7816
20211226,경원선,도봉,2435,2320,4755
20211226,경원선,방학,4319,4228,8547
20211226,경원선,녹천,1977,1766,3743
20211226,경원선,월계,2559,2299,4858
20211226,경원선,광운대,3094,3202,6296
20211226,경원선,석계,3567,3949,7516
20211226,경원선,신이문,3553,3450,7003
20211226,경원선,외대앞,3892,3731,7623
20211226,경원선,청량리,11802,10373,22175
20211226,경원선,왕십리,7916,8630,16546
20211226,경원선,응봉,688,651,1339
20211226,경원선,옥수,63,20,83
20211226,경원선,한남,1404,1418,2822
20211226,경원선,서빙고,969,1060,2029
20211226,경원선,이촌,1588,1266,2854
